"prov_code","muni_code","censo","votantes","validos","blancos","nulos","siglas","votos"
38,"38040",5482,3094,3060,14,34,"AHORA CANARIAS",7
35,"35016",300581,181532,179831,1458,1701,"AHORA CANARIAS",375
35,"35031",7456,4938,4868,39,70,"AHORA CANARIAS",13
38,"38018",4466,2867,2821,21,46,"AHORA CANARIAS",4
38,"38901",1466,908,894,4,14,"AHORA CANARIAS",0
35,"35027",10502,6831,6750,67,81,"AHORA CANARIAS",15
35,"35026",83172,48751,48109,449,642,"AHORA CANARIAS",97
38,"38036",6857,4170,4090,37,80,"AHORA CANARIAS",12
38,"38013",3011,1850,1829,14,21,"AHORA CANARIAS",1
38,"38011",21655,13974,13831,106,143,"AHORA CANARIAS",33
38,"38023",126137,79423,78706,605,717,"AHORA CANARIAS",179
35,"35020",5941,3740,3702,27,38,"AHORA CANARIAS",7
38,"38007",1619,1053,1043,3,10,"AHORA CANARIAS",0
38,"38021",1609,900,876,2,24,"AHORA CANARIAS",3
35,"35017",27498,15513,15240,121,273,"AHORA CANARIAS",34
38,"38028",22144,14312,14174,89,138,"AHORA CANARIAS",38
38,"38024",15316,9131,9005,60,126,"AHORA CANARIAS",15
38,"38010",3969,2463,2418,11,45,"AHORA CANARIAS",2
35,"35007",517,347,345,2,2,"AHORA CANARIAS",0
38,"38027",5581,3577,3533,22,44,"AHORA CANARIAS",9
38,"38003",1517,899,890,5,9,"AHORA CANARIAS",0
35,"35019",32830,18390,18243,87,147,"AHORA CANARIAS",39
38,"38044",2215,1270,1257,5,13,"AHORA CANARIAS",0
35,"35009",20229,13378,13201,95,177,"AHORA CANARIAS",30
38,"38052",1283,806,794,3,12,"AHORA CANARIAS",0
35,"35013",6593,4596,4516,47,80,"AHORA CANARIAS",8
35,"35008",6214,4193,4143,33,50,"AHORA CANARIAS",2
35,"35024",14323,8360,8289,81,71,"AHORA CANARIAS",21
38,"38042",3778,2410,2386,11,24,"AHORA CANARIAS",4
38,"38006",41593,20823,20624,127,199,"AHORA CANARIAS",52
35,"35022",51765,29309,29034,184,275,"AHORA CANARIAS",134
38,"38026",33585,24091,23889,170,202,"AHORA CANARIAS",36
38,"38019",13884,7888,7809,49,79,"AHORA CANARIAS",16
35,"35004",41975,20773,20602,156,171,"AHORA CANARIAS",27
38,"38004",4536,2914,2887,28,27,"AHORA CANARIAS",4
35,"35018",13153,7742,7674,80,68,"AHORA CANARIAS",15
38,"38025",7065,4657,4590,34,67,"AHORA CANARIAS",12
35,"35005",1009,680,668,2,12,"AHORA CANARIAS",1
38,"38017",30964,16228,16102,108,126,"AHORA CANARIAS",21
35,"35032",3331,2293,2252,23,41,"AHORA CANARIAS",0
38,"38051",7328,5017,4969,32,48,"AHORA CANARIAS",4
38,"38038",165135,101564,100807,709,757,"AHORA CANARIAS",224
38,"38014",1342,943,930,6,13,"AHORA CANARIAS",1
38,"38030",1962,1332,1318,9,14,"AHORA CANARIAS",2
38,"38037",12817,7582,7494,55,88,"AHORA CANARIAS",7
38,"38048",3952,2543,2519,22,24,"AHORA CANARIAS",3
38,"38008",5699,3719,3669,26,50,"AHORA CANARIAS",6
38,"38053",3768,2275,2244,16,31,"AHORA CANARIAS",3
35,"35002",24229,15311,15133,101,178,"AHORA CANARIAS",60
35,"35028",10156,5483,5425,56,58,"AHORA CANARIAS",8
35,"35003",5644,2987,2943,20,44,"AHORA CANARIAS",7
35,"35023",11742,7787,7651,95,136,"AHORA CANARIAS",25
38,"38033",3593,2277,2242,15,35,"AHORA CANARIAS",3
38,"38032",13579,8941,8880,92,61,"AHORA CANARIAS",10
38,"38009",4315,2846,2817,27,29,"AHORA CANARIAS",4
38,"38035",10518,5870,5819,37,51,"AHORA CANARIAS",10
35,"35015",10752,5289,5222,39,67,"AHORA CANARIAS",16
35,"35014",11962,5994,5888,60,106,"AHORA CANARIAS",10
35,"35025",1752,1113,1095,5,18,"AHORA CANARIAS",0
38,"38047",1755,1132,1110,9,22,"AHORA CANARIAS",1
35,"35012",10862,5617,5568,40,49,"AHORA CANARIAS",20
35,"35033",6393,4147,4072,38,75,"AHORA CANARIAS",7
35,"35001",4566,3148,3105,18,43,"AHORA CANARIAS",7
38,"38043",19365,12355,12212,126,143,"AHORA CANARIAS",26
38,"38001",21069,10844,10777,63,67,"AHORA CANARIAS",15
38,"38020",16057,9921,9809,66,112,"AHORA CANARIAS",20
38,"38041",7025,4729,4684,42,45,"AHORA CANARIAS",6
38,"38005",5646,3302,3283,24,19,"AHORA CANARIAS",20
38,"38016",1174,595,589,2,6,"AHORA CANARIAS",2
38,"38031",29301,20926,20701,157,225,"AHORA CANARIAS",26
35,"35030",10046,5584,5505,44,79,"AHORA CANARIAS",7
38,"38046",9267,6652,6594,55,58,"AHORA CANARIAS",4
38,"38039",11149,7375,7326,68,49,"AHORA CANARIAS",8
38,"38045",3542,1825,1801,7,24,"AHORA CANARIAS",3
38,"38050",2417,1288,1273,9,15,"AHORA CANARIAS",8
35,"35034",8392,3946,3908,27,38,"AHORA CANARIAS",10
35,"35006",31373,20764,20476,189,288,"AHORA CANARIAS",52
35,"35029",4415,2498,2472,29,26,"AHORA CANARIAS",7
38,"38002",971,577,570,8,7,"AHORA CANARIAS",0
38,"38049",2690,1406,1389,27,17,"AHORA CANARIAS",4
38,"38015",4055,2635,2601,16,34,"AHORA CANARIAS",14
35,"35011",24859,15025,14833,149,192,"AHORA CANARIAS",39
38,"38012",2286,1520,1510,8,10,"AHORA CANARIAS",8
35,"35010",3853,2224,2194,18,30,"AHORA CANARIAS",2
38,"38029",1475,752,744,10,8,"AHORA CANARIAS",4
35,"35021",15072,9791,9696,80,95,"AHORA CANARIAS",9
38,"38034",3997,2687,2648,19,39,"AHORA CANARIAS",5
38,"38022",18630,11420,11284,87,136,"AHORA CANARIAS",13
33,"33033",9381,5848,5770,88,78,"ANDECHA",14
33,"33030",876,632,630,8,2,"ANDECHA",1
33,"33055",1485,992,966,14,26,"ANDECHA",0
33,"33073",8096,4377,4320,59,57,"ANDECHA",6
33,"33021",4304,2643,2610,32,33,"ANDECHA",7
33,"33023",3249,2127,2097,30,30,"ANDECHA",0
33,"33038",2218,1501,1477,17,24,"ANDECHA",6
33,"33022",802,460,452,4,8,"ANDECHA",0
33,"33061",344,174,174,1,0,"ANDECHA",1
33,"33054",1601,1025,1010,17,15,"ANDECHA",3
33,"33051",6787,4318,4268,48,50,"ANDECHA",4
33,"33041",7101,4564,4513,58,51,"ANDECHA",6
33,"33019",2844,1702,1680,11,22,"ANDECHA",4
33,"33017",2969,1787,1768,38,19,"ANDECHA",0
33,"33014",8735,5744,5689,67,55,"ANDECHA",9
33,"33070",3267,2211,2185,27,26,"ANDECHA",0
33,"33043",656,408,401,2,7,"ANDECHA",0
33,"33010",1722,1085,1069,15,16,"ANDECHA",0
33,"33035",11214,7359,7303,102,56,"ANDECHA",10
33,"33002",9403,5920,5839,69,81,"ANDECHA",10
33,"33011",10563,5646,5578,92,68,"ANDECHA",3
33,"33076",12115,7519,7456,76,63,"ANDECHA",18
33,"33063",375,269,267,5,2,"ANDECHA",0
33,"33052",681,418,416,3,2,"ANDECHA",2
33,"33001",1475,758,753,15,5,"ANDECHA",0
33,"33028",1143,519,518,7,1,"ANDECHA",0
33,"33068",1031,518,510,5,8,"ANDECHA",0
33,"33016",18848,12845,12737,173,108,"ANDECHA",12
33,"33053",1078,602,599,10,3,"ANDECHA",1
33,"33025",8956,5493,5453,81,40,"ANDECHA",9
33,"33040",4556,2837,2784,58,53,"ANDECHA",5
33,"33050",548,316,314,1,2,"ANDECHA",0
33,"33024",224741,151660,150461,1597,1199,"ANDECHA",253
33,"33066",42818,27780,27466,425,314,"ANDECHA",47
33,"33056",4850,3068,3044,25,24,"ANDECHA",1
33,"33007",1382,804,795,4,9,"ANDECHA",2
33,"33003",603,322,317,7,5,"ANDECHA",0
33,"33067",751,543,538,7,5,"ANDECHA",0
33,"33026",8201,5014,4974,74,40,"ANDECHA",5
33,"33071",546,385,383,7,2,"ANDECHA",0
33,"33015",1396,849,842,7,7,"ANDECHA",4
33,"33006",1476,862,857,9,5,"ANDECHA",5
33,"33059",4359,2651,2625,33,26,"ANDECHA",5
33,"33060",13991,8629,8481,109,148,"ANDECHA",18
33,"33078",127,81,81,0,0,"ANDECHA",0
33,"33029",315,145,142,1,3,"ANDECHA",0
33,"33044",177059,121380,120421,1543,959,"ANDECHA",182
33,"33062",385,194,187,4,7,"ANDECHA",1
33,"33032",11056,7052,6905,109,147,"ANDECHA",13
33,"33005",1357,832,825,11,7,"ANDECHA",3
33,"33009",878,545,542,4,3,"ANDECHA",0
33,"33031",33775,20484,20184,276,300,"ANDECHA",45
33,"33046",480,334,329,0,5,"ANDECHA",0
33,"33020",12981,8550,8453,120,97,"ANDECHA",10
33,"33037",33074,20693,20412,259,281,"ANDECHA",41
33,"33072",1443,816,814,8,2,"ANDECHA",1
33,"33057",1525,1005,988,17,17,"ANDECHA",1
33,"33034",9979,5937,5873,64,64,"ANDECHA",6
33,"33049",5973,3569,3518,48,51,"ANDECHA",12
33,"33069",3379,2249,2231,41,18,"ANDECHA",1
33,"33064",240,151,151,0,0,"ANDECHA",1
33,"33065",1077,670,657,11,13,"ANDECHA",2
33,"33047",1068,771,759,9,12,"ANDECHA",1
33,"33075",244,125,122,3,3,"ANDECHA",0
33,"33045",4359,2819,2787,32,32,"ANDECHA",2
33,"33058",1668,1050,1035,13,15,"ANDECHA",4
33,"33042",4237,2862,2816,49,46,"ANDECHA",7
33,"33048",132,86,85,1,1,"ANDECHA",0
33,"33012",5085,3158,3142,27,16,"ANDECHA",1
33,"33027",752,412,405,11,7,"ANDECHA",1
33,"33018",2804,1830,1806,30,24,"ANDECHA",2
33,"33077",1097,688,683,4,5,"ANDECHA",0
33,"33036",11281,7240,7153,96,87,"ANDECHA",6
33,"33074",3366,2042,2011,35,31,"ANDECHA",0
33,"33013",430,294,292,1,2,"ANDECHA",0
33,"33039",1646,1118,1110,8,8,"ANDECHA",4
33,"33008",1679,1140,1133,10,7,"ANDECHA",0
33,"33004",65304,43473,43153,563,320,"ANDECHA",52
46,"46086",80,66,65,1,1,"AUNACV",0
46,"46063",1786,1270,1255,8,15,"AUNACV",0
44,"44096",155,115,114,1,1,"AUNACV",0
46,"46257",5436,3972,3933,28,39,"AUNACV",0
44,"44085",49,29,29,0,0,"AUNACV",0
46,"46240",200,167,155,1,12,"AUNACV",0
44,"44084",54,46,46,1,0,"AUNACV",0
44,"44152",70,46,46,0,0,"AUNACV",0
46,"46154",795,619,608,5,11,"AUNACV",0
44,"44173",103,81,79,0,2,"AUNACV",0
46,"46083",15372,10939,10815,78,124,"AUNACV",3
46,"46005",23129,16610,16437,148,173,"AUNACV",6
46,"46187",1292,924,920,4,4,"AUNACV",0
44,"44182",203,160,158,0,2,"AUNACV",0
44,"44130",28,23,23,0,0,"AUNACV",0
46,"46230",14116,10038,9946,63,92,"AUNACV",6
46,"46101",819,670,663,8,7,"AUNACV",0
12,"12079",414,310,305,2,5,"AUNACV",0
44,"44055",75,52,50,0,2,"AUNACV",0
46,"46025",2445,1875,1853,16,22,"AUNACV",0
44,"44129",35,29,29,1,0,"AUNACV",0
46,"46058",1734,1245,1230,8,15,"AUNACV",0
46,"46099",744,539,535,2,4,"AUNACV",0
12,"12061",374,263,261,4,2,"AUNACV",0
12,"12040",119116,85613,84993,620,620,"AUNACV",33
46,"46002",1253,946,940,4,6,"AUNACV",0
44,"44147",401,264,256,7,8,"AUNACV",0
44,"44260",137,93,93,1,0,"AUNACV",0
46,"46189",469,374,367,2,7,"AUNACV",0
44,"44171",176,115,115,0,0,"AUNACV",0
46,"46177",4832,3592,3539,20,53,"AUNACV",3
46,"46193",8959,6880,6824,66,56,"AUNACV",0
44,"44215",167,113,113,2,0,"AUNACV",0
46,"46245",527,407,404,2,3,"AUNACV",0
46,"46126",5580,4361,4328,36,33,"AUNACV",1
46,"46125",852,660,650,5,10,"AUNACV",0
12,"12090",102,79,78,1,1,"AUNACV",0
46,"46024",454,343,339,1,4,"AUNACV",0
44,"44169",298,216,216,0,0,"AUNACV",0
12,"12131",97,87,87,0,0,"AUNACV",0
12,"12011",4583,3228,3177,24,51,"AUNACV",0
46,"46048",3504,2609,2576,17,33,"AUNACV",0
46,"46049",268,221,217,2,4,"AUNACV",0
46,"46102",19696,14700,14579,125,121,"AUNACV",7
46,"46166",8214,6093,6031,38,62,"AUNACV",3
46,"46026",1220,974,965,7,9,"AUNACV",0
12,"12027",17506,11776,11649,84,127,"AUNACV",8
12,"12064",80,71,69,0,2,"AUNACV",0
46,"46131",49805,35527,35231,298,296,"AUNACV",4
44,"44005",48,36,36,0,0,"AUNACV",0
12,"12139",299,202,200,3,2,"AUNACV",0
44,"44185",88,69,69,2,0,"AUNACV",0
46,"46164",12145,8373,8248,44,125,"AUNACV",1
12,"12024",138,107,107,1,0,"AUNACV",0
12,"12101",354,274,270,5,4,"AUNACV",0
46,"46181",16967,11951,11835,98,116,"AUNACV",5
12,"12091",171,110,108,4,2,"AUNACV",0
46,"46139",4520,3486,3457,18,29,"AUNACV",0
44,"44056",446,327,325,1,2,"AUNACV",0
46,"46040",993,745,733,3,12,"AUNACV",0
44,"44045",360,271,271,0,0,"AUNACV",0
44,"44196",121,88,88,0,0,"AUNACV",0
46,"46018",562,442,436,2,6,"AUNACV",0
46,"46217",900,672,667,7,5,"AUNACV",0
44,"44241",500,361,357,0,4,"AUNACV",0
44,"44094",127,103,103,0,0,"AUNACV",0
44,"44033",243,165,165,3,0,"AUNACV",0
46,"46117",493,386,380,2,6,"AUNACV",0
44,"44143",388,298,298,2,0,"AUNACV",0
46,"46011",7523,5154,5077,34,77,"AUNACV",0
44,"44247",291,207,206,4,1,"AUNACV",0
44,"44109",99,64,64,0,0,"AUNACV",0
44,"44049",784,539,532,3,7,"AUNACV",0
44,"44090",66,49,49,0,0,"AUNACV",0
46,"46039",2111,1657,1640,16,17,"AUNACV",1
44,"44114",233,161,159,0,2,"AUNACV",0
46,"46034",1826,1345,1335,3,10,"AUNACV",0
12,"12142",142,113,113,0,0,"AUNACV",0
12,"12020",118,104,103,1,1,"AUNACV",0
12,"12036",541,401,395,6,6,"AUNACV",0
44,"44164",19,16,16,1,0,"AUNACV",0
44,"44213",68,47,47,0,0,"AUNACV",0
46,"46242",326,260,257,3,3,"AUNACV",0
46,"46070",17824,12888,12802,106,86,"AUNACV",1
44,"44179",324,201,201,2,0,"AUNACV",0
44,"44066",85,62,62,0,0,"AUNACV",0
44,"44208",27,17,17,0,0,"AUNACV",0
46,"46098",2405,1778,1751,7,27,"AUNACV",1
44,"44100",177,136,135,1,1,"AUNACV",0
46,"46010",943,691,681,7,10,"AUNACV",3
44,"44012",303,215,215,2,0,"AUNACV",0
46,"46207",6761,4966,4909,46,57,"AUNACV",1
12,"12088",57,53,53,0,0,"AUNACV",0
12,"12033",1953,1391,1368,6,23,"AUNACV",0
12,"12051",437,297,295,3,2,"AUNACV",0
44,"44050",3113,2173,2154,14,19,"AUNACV",1
44,"44199",39,37,37,2,0,"AUNACV",0
46,"46140",383,321,321,2,0,"AUNACV",0
46,"46151",757,560,552,2,8,"AUNACV",0
44,"44059",562,411,407,2,4,"AUNACV",0
44,"44224",21,14,14,2,0,"AUNACV",0
44,"44191",714,509,500,5,9,"AUNACV",0
44,"44244",67,40,40,0,0,"AUNACV",0
12,"12068",41,22,21,0,1,"AUNACV",0
12,"12077",4828,3395,3357,28,38,"AUNACV",6
12,"12080",1883,1472,1438,8,34,"AUNACV",0
46,"46064",532,395,387,3,8,"AUNACV",0
12,"12025",116,82,79,1,3,"AUNACV",0
12,"12071",1272,936,925,3,11,"AUNACV",0
44,"44209",799,584,573,2,11,"AUNACV",0
12,"12108",443,354,352,4,2,"AUNACV",0
44,"44200",39,26,26,0,0,"AUNACV",0
46,"46904",812,615,605,2,10,"AUNACV",0
46,"46209",1903,1406,1383,5,23,"AUNACV",0
12,"12081",606,454,446,2,8,"AUNACV",0
44,"44257",149,92,91,0,1,"AUNACV",0
44,"44267",70,47,46,0,1,"AUNACV",0
44,"44141",122,88,85,0,3,"AUNACV",0
12,"12008",228,195,194,1,1,"AUNACV",0
46,"46253",112,84,84,0,0,"AUNACV",0
12,"12078",334,224,221,2,3,"AUNACV",0
46,"46067",1753,1356,1341,8,15,"AUNACV",0
12,"12014",164,111,111,0,0,"AUNACV",0
46,"46204",6625,4946,4882,52,64,"AUNACV",1
12,"12092",123,95,95,0,0,"AUNACV",0
46,"46902",352,283,283,0,0,"AUNACV",0
44,"44195",82,58,57,0,1,"AUNACV",0
44,"44120",219,147,145,3,2,"AUNACV",0
46,"46215",1407,1088,1068,10,20,"AUNACV",0
12,"12106",1151,928,908,9,20,"AUNACV",0
12,"12112",102,79,79,1,0,"AUNACV",0
12,"12037",17,13,13,1,0,"AUNACV",0
12,"12107",350,299,295,3,4,"AUNACV",0
46,"46073",1066,823,817,11,6,"AUNACV",0
44,"44201",477,399,395,1,4,"AUNACV",0
44,"44218",28,24,24,3,0,"AUNACV",0
46,"46046",901,623,609,2,14,"AUNACV",0
46,"46228",2426,1819,1802,19,17,"AUNACV",0
44,"44048",52,47,47,0,0,"AUNACV",0
44,"44036",22,20,20,0,0,"AUNACV",0
44,"44122",1277,939,934,5,5,"AUNACV",0
46,"46213",15499,10610,10482,173,128,"AUNACV",86
46,"46147",17186,11507,11399,72,108,"AUNACV",0
46,"46203",3546,2717,2689,28,28,"AUNACV",0
44,"44256",36,30,30,2,0,"AUNACV",0
46,"46250",582242,437146,434438,3315,2708,"AUNACV",129
12,"12044",442,371,368,1,3,"AUNACV",0
12,"12056",257,205,199,1,6,"AUNACV",0
46,"46221",348,292,290,1,2,"AUNACV",0
44,"44204",27,18,18,0,0,"AUNACV",0
12,"12089",4555,3070,3045,22,25,"AUNACV",1
46,"46214",16637,12113,12014,84,99,"AUNACV",2
46,"46130",862,633,625,6,8,"AUNACV",0
46,"46186",19689,14688,14576,118,112,"AUNACV",2
44,"44068",634,497,493,2,4,"AUNACV",0
12,"12016",1549,1244,1234,9,10,"AUNACV",1
12,"12015",115,94,94,0,0,"AUNACV",0
44,"44226",123,85,84,0,1,"AUNACV",0
12,"12098",529,417,413,3,4,"AUNACV",1
46,"46029",20448,14673,14556,99,117,"AUNACV",7
12,"12002",114,96,94,1,2,"AUNACV",0
44,"44189",44,35,35,0,0,"AUNACV",0
44,"44158",1153,879,872,6,7,"AUNACV",0
12,"12003",954,710,702,6,8,"AUNACV",0
46,"46227",893,687,675,6,12,"AUNACV",0
46,"46210",338,256,251,0,5,"AUNACV",0
46,"46197",1930,1430,1411,11,19,"AUNACV",2
46,"46035",6828,5155,5089,33,66,"AUNACV",1
46,"46113",2558,1791,1773,7,18,"AUNACV",0
46,"46174",942,746,736,1,10,"AUNACV",0
44,"44136",48,43,43,1,0,"AUNACV",0
44,"44144",319,225,223,0,2,"AUNACV",0
44,"44002",47,41,41,0,0,"AUNACV",0
44,"44236",60,38,38,0,0,"AUNACV",0
44,"44103",122,96,96,3,0,"AUNACV",0
44,"44221",386,307,304,1,3,"AUNACV",0
46,"46182",1312,908,904,5,4,"AUNACV",3
44,"44011",47,34,34,0,0,"AUNACV",0
46,"46190",50042,35290,35066,284,224,"AUNACV",12
46,"46162",1168,839,832,3,7,"AUNACV",0
46,"46243",124,93,90,1,3,"AUNACV",0
46,"46152",90,63,63,0,0,"AUNACV",0
46,"46218",1043,842,829,6,13,"AUNACV",1
46,"46178",5001,3513,3477,26,36,"AUNACV",0
12,"12102",518,424,417,4,7,"AUNACV",0
46,"46246",1049,808,793,3,15,"AUNACV",0
12,"12043",570,405,397,1,8,"AUNACV",0
44,"44065",55,33,32,0,1,"AUNACV",0
46,"46170",3417,2618,2577,11,41,"AUNACV",0
46,"46004",1932,1530,1512,10,18,"AUNACV",0
44,"44228",96,75,74,0,1,"AUNACV",5
12,"12127",63,45,44,1,1,"AUNACV",0
12,"12119",139,97,94,3,3,"AUNACV",0
12,"12095",950,723,712,5,11,"AUNACV",0
46,"46009",3144,2473,2449,22,24,"AUNACV",2
12,"12100",1273,1069,1052,5,17,"AUNACV",1
46,"46105",16126,10958,10847,76,111,"AUNACV",2
46,"46047",540,428,420,1,8,"AUNACV",0
46,"46234",317,247,245,1,2,"AUNACV",0
46,"46052",515,423,419,4,4,"AUNACV",0
12,"12103",87,61,60,0,1,"AUNACV",0
44,"44265",175,138,136,1,2,"AUNACV",0
44,"44246",1599,1012,1001,11,11,"AUNACV",1
12,"12076",72,54,54,0,0,"AUNACV",0
12,"12120",149,125,121,3,4,"AUNACV",1
46,"46007",12333,8890,8803,79,87,"AUNACV",5
46,"46108",420,328,324,1,4,"AUNACV",0
44,"44268",32,30,30,0,0,"AUNACV",0
46,"46116",13606,10262,10200,87,62,"AUNACV",2
44,"44047",225,103,103,0,0,"AUNACV",0
46,"46169",32403,23890,23698,222,192,"AUNACV",6
46,"46121",106,91,90,1,1,"AUNACV",0
44,"44250",20,15,15,0,0,"AUNACV",0
12,"12104",6843,5181,5111,32,70,"AUNACV",1
46,"46124",786,638,625,1,13,"AUNACV",0
44,"44237",367,267,262,0,5,"AUNACV",0
46,"46114",552,417,412,6,5,"AUNACV",0
46,"46056",176,142,142,0,0,"AUNACV",0
46,"46008",2617,1954,1931,17,23,"AUNACV",0
44,"44180",74,56,56,0,0,"AUNACV",0
44,"44029",585,454,451,2,3,"AUNACV",0
12,"12031",3960,2913,2869,13,44,"AUNACV",0
44,"44076",2089,1577,1565,8,12,"AUNACV",0
46,"46155",972,731,716,3,15,"AUNACV",0
44,"44131",26,22,22,0,0,"AUNACV",0
44,"44146",164,133,133,2,0,"AUNACV",0
46,"46231",2403,1670,1652,11,18,"AUNACV",2
12,"12140",1147,849,841,5,8,"AUNACV",1
12,"12129",1783,1207,1184,16,23,"AUNACV",0
46,"46229",903,715,708,5,7,"AUNACV",0
46,"46072",3522,2792,2741,25,51,"AUNACV",0
46,"46148",1515,1131,1113,5,18,"AUNACV",0
12,"12026",828,577,566,11,11,"AUNACV",0
46,"46258",2617,1925,1914,5,11,"AUNACV",0
46,"46077",7338,5447,5356,44,91,"AUNACV",2
44,"44019",70,42,42,0,0,"AUNACV",0
12,"12097",62,53,51,0,2,"AUNACV",0
44,"44060",32,25,25,0,0,"AUNACV",0
44,"44080",281,202,199,0,3,"AUNACV",0
44,"44102",26,19,19,0,0,"AUNACV",0
44,"44106",151,107,106,0,1,"AUNACV",0
46,"46161",1467,1129,1113,5,16,"AUNACV",0
12,"12109",646,489,482,4,7,"AUNACV",0
12,"12042",574,459,446,9,13,"AUNACV",0
46,"46149",350,252,249,3,3,"AUNACV",0
12,"12096",732,526,519,4,7,"AUNACV",0
12,"12115",205,161,161,1,0,"AUNACV",0
46,"46050",185,141,141,1,0,"AUNACV",0
46,"46232",853,661,648,7,13,"AUNACV",0
46,"46259",457,374,371,2,3,"AUNACV",0
46,"46141",433,340,337,6,3,"AUNACV",0
46,"46093",2151,1652,1640,10,12,"AUNACV",0
44,"44020",22,21,21,0,0,"AUNACV",0
46,"46157",2959,2145,2126,11,19,"AUNACV",1
44,"44150",28,17,17,0,0,"AUNACV",0
46,"46043",135,119,118,0,1,"AUNACV",0
44,"44262",141,104,103,0,1,"AUNACV",0
44,"44014",2506,1828,1818,8,10,"AUNACV",1
46,"46185",361,301,299,5,2,"AUNACV",0
46,"46252",125,89,86,1,3,"AUNACV",0
46,"46081",9999,7486,7412,47,74,"AUNACV",3
44,"44125",63,41,41,0,0,"AUNACV",0
12,"12001",1028,783,768,6,15,"AUNACV",0
46,"46112",533,435,432,7,3,"AUNACV",0
46,"46211",1862,1395,1381,12,14,"AUNACV",0
12,"12121",1043,878,856,5,22,"AUNACV",0
46,"46150",1794,1276,1272,8,4,"AUNACV",0
44,"44187",193,147,146,0,1,"AUNACV",0
46,"46074",2687,2033,2020,18,13,"AUNACV",1
44,"44261",713,553,549,3,4,"AUNACV",0
46,"46054",11389,8266,8190,54,76,"AUNACV",3
44,"44168",181,119,117,1,2,"AUNACV",0
46,"46001",771,562,560,3,2,"AUNACV",1
46,"46092",262,176,174,2,2,"AUNACV",0
46,"46239",446,357,352,1,5,"AUNACV",0
12,"12010",232,191,187,3,4,"AUNACV",0
44,"44264",254,170,170,0,0,"AUNACV",0
46,"46219",125,107,104,0,3,"AUNACV",0
12,"12093",161,111,109,2,2,"AUNACV",0
44,"44099",644,422,421,2,1,"AUNACV",0
46,"46128",1569,1216,1179,7,37,"AUNACV",0
46,"46090",1631,1360,1339,6,21,"AUNACV",0
46,"46146",1647,1241,1229,12,12,"AUNACV",0
46,"46261",1708,1259,1237,12,22,"AUNACV",0
44,"44118",154,109,106,1,3,"AUNACV",0
44,"44239",21,19,19,0,0,"AUNACV",0
44,"44223",73,48,48,0,0,"AUNACV",0
44,"44205",619,420,415,5,5,"AUNACV",0
46,"46136",2598,1875,1851,14,24,"AUNACV",1
44,"44156",47,31,31,0,0,"AUNACV",0
46,"46030",810,641,625,7,16,"AUNACV",0
46,"46045",1245,984,961,3,23,"AUNACV",0
44,"44088",24,23,23,0,0,"AUNACV",0
46,"46192",786,534,519,7,15,"AUNACV",0
44,"44229",141,99,98,1,1,"AUNACV",0
12,"12049",415,317,305,4,12,"AUNACV",0
46,"46205",14237,10641,10533,77,108,"AUNACV",5
46,"46076",610,500,494,1,6,"AUNACV",0
44,"44127",57,43,43,0,0,"AUNACV",0
46,"46038",302,221,220,1,1,"AUNACV",0
46,"46167",342,240,239,0,1,"AUNACV",0
44,"44159",37,27,27,1,0,"AUNACV",0
12,"12118",78,64,63,0,1,"AUNACV",0
44,"44148",74,56,54,0,2,"AUNACV",0
44,"44117",327,258,258,0,0,"AUNACV",0
44,"44037",447,288,288,1,0,"AUNACV",0
46,"46903",6306,4762,4743,44,19,"AUNACV",0
12,"12052",537,409,398,5,11,"AUNACV",0
46,"46226",29,20,19,0,1,"AUNACV",0
44,"44227",72,58,58,0,0,"AUNACV",0
12,"12105",825,602,598,6,4,"AUNACV",1
44,"44172",296,216,216,1,0,"AUNACV",0
46,"46080",979,720,712,2,8,"AUNACV",0
46,"46236",929,723,716,2,7,"AUNACV",0
44,"44177",101,68,68,1,0,"AUNACV",0
12,"12060",434,366,360,1,6,"AUNACV",0
12,"12136",2603,2151,2119,20,32,"AUNACV",0
46,"46138",361,289,287,1,2,"AUNACV",0
44,"44077",68,52,51,0,1,"AUNACV",0
44,"44149",99,74,73,4,1,"AUNACV",0
46,"46123",1926,1392,1368,11,24,"AUNACV",0
44,"44053",103,87,85,1,2,"AUNACV",0
44,"44028",171,136,136,0,0,"AUNACV",0
46,"46237",7172,5199,5146,53,53,"AUNACV",1
46,"46060",9278,6796,6724,49,72,"AUNACV",0
44,"44038",101,85,83,1,2,"AUNACV",0
44,"44245",240,177,174,0,3,"AUNACV",0
46,"46078",28484,19694,19520,173,174,"AUNACV",7
44,"44198",182,138,135,0,3,"AUNACV",0
44,"44210",750,577,572,2,5,"AUNACV",0
46,"46184",26514,19610,19399,180,211,"AUNACV",2
44,"44163",115,79,78,0,1,"AUNACV",0
12,"12134",135,95,95,1,0,"AUNACV",0
46,"46088",152,114,110,1,4,"AUNACV",0
44,"44042",114,82,81,0,1,"AUNACV",0
46,"46111",11367,7995,7908,66,87,"AUNACV",2
46,"46071",471,355,349,1,6,"AUNACV",0
44,"44093",78,62,61,0,1,"AUNACV",0
44,"44082",84,66,66,0,0,"AUNACV",0
46,"46119",761,587,580,6,7,"AUNACV",0
44,"44121",52,42,42,1,0,"AUNACV",0
44,"44031",83,50,50,0,0,"AUNACV",0
44,"44105",68,53,53,0,0,"AUNACV",0
44,"44003",17,15,15,0,0,"AUNACV",0
12,"12034",1389,1022,1002,5,20,"AUNACV",0
44,"44108",306,209,205,1,4,"AUNACV",0
44,"44135",99,73,73,1,0,"AUNACV",0
44,"44157",61,37,37,0,0,"AUNACV",0
44,"44062",31,20,20,0,0,"AUNACV",0
12,"12013",135,106,106,1,0,"AUNACV",0
46,"46263",235,182,180,2,2,"AUNACV",0
44,"44249",40,30,30,0,0,"AUNACV",0
46,"46087",109,94,94,2,0,"AUNACV",0
44,"44074",440,314,308,2,6,"AUNACV",0
46,"46044",4159,3062,2997,26,65,"AUNACV",1
12,"12018",279,233,231,3,2,"AUNACV",0
12,"12045",333,243,235,2,8,"AUNACV",0
12,"12123",40,32,32,0,0,"AUNACV",0
12,"12073",133,97,97,0,0,"AUNACV",0
44,"44112",400,265,265,2,0,"AUNACV",0
44,"44035",102,82,80,1,2,"AUNACV",0
44,"44044",82,65,65,2,0,"AUNACV",0
46,"46085",11089,7581,7503,60,78,"AUNACV",1
44,"44153",1733,1131,1125,0,6,"AUNACV",0
46,"46103",1354,993,978,8,15,"AUNACV",0
46,"46118",3649,2730,2701,20,29,"AUNACV",0
12,"12138",19207,13018,12891,87,127,"AUNACV",3
44,"44022",464,330,325,1,5,"AUNACV",0
44,"44123",95,68,68,0,0,"AUNACV",0
46,"46212",1620,1130,1112,12,18,"AUNACV",0
44,"44176",152,114,113,1,1,"AUNACV",0
44,"44232",364,255,255,3,0,"AUNACV",0
46,"46020",3757,2834,2783,16,51,"AUNACV",0
12,"12126",24374,17741,17553,111,188,"AUNACV",7
44,"44061",77,60,58,1,2,"AUNACV",0
46,"46066",1274,972,970,4,2,"AUNACV",0
46,"46195",2000,1540,1532,3,8,"AUNACV",0
44,"44216",27003,19997,19909,80,88,"AUNACV",1
44,"44145",974,698,697,3,1,"AUNACV",0
44,"44190",63,45,45,0,0,"AUNACV",0
44,"44240",151,119,117,0,2,"AUNACV",0
44,"44212",41,29,29,0,0,"AUNACV",0
46,"46127",2748,2035,2009,6,26,"AUNACV",2
46,"46084",1487,1136,1123,4,13,"AUNACV",0
44,"44137",187,139,139,0,0,"AUNACV",0
46,"46006",4454,3527,3486,27,41,"AUNACV",1
46,"46168",2004,1463,1447,12,16,"AUNACV",0
12,"12032",23728,16870,16726,121,144,"AUNACV",5
12,"12007",724,622,614,2,8,"AUNACV",0
12,"12122",754,608,600,3,8,"AUNACV",0
44,"44197",51,35,35,1,0,"AUNACV",0
12,"12117",3532,2512,2479,12,33,"AUNACV",2
12,"12113",90,59,59,1,0,"AUNACV",0
12,"12070",505,407,398,2,9,"AUNACV",0
46,"46115",330,219,213,0,6,"AUNACV",0
46,"46135",9817,7596,7558,58,38,"AUNACV",2
12,"12057",572,456,437,1,19,"AUNACV",0
46,"46037",1120,891,879,7,12,"AUNACV",0
44,"44087",67,52,50,0,2,"AUNACV",0
46,"46017",33041,23469,23277,173,192,"AUNACV",7
46,"46055",1298,992,977,9,15,"AUNACV",1
12,"12009",17943,12389,12292,102,97,"AUNACV",2
46,"46075",144,125,122,2,3,"AUNACV",0
46,"46256",7280,4996,4940,32,56,"AUNACV",0
12,"12039",792,665,659,2,6,"AUNACV",0
12,"12058",59,47,45,1,2,"AUNACV",0
46,"46027",924,746,737,2,9,"AUNACV",0
46,"46095",580,445,438,5,7,"AUNACV",0
12,"12901",3339,2583,2561,25,22,"AUNACV",0
46,"46069",152,112,111,1,1,"AUNACV",0
12,"12072",1083,852,827,10,25,"AUNACV",0
46,"46041",313,229,228,1,1,"AUNACV",0
46,"46235",21229,15171,15011,126,160,"AUNACV",1
44,"44023",18,15,14,0,1,"AUNACV",0
44,"44243",25,19,19,0,0,"AUNACV",0
46,"46091",110,100,100,0,0,"AUNACV",0
44,"44113",74,51,51,0,0,"AUNACV",0
44,"44211",33,22,22,0,0,"AUNACV",0
44,"44160",438,287,285,4,2,"AUNACV",0
46,"46143",4274,3027,2995,19,32,"AUNACV",0
46,"46153",443,353,349,2,4,"AUNACV",0
46,"46100",281,190,187,1,3,"AUNACV",0
46,"46199",5878,4217,4182,21,35,"AUNACV",1
44,"44234",71,49,49,0,0,"AUNACV",0
44,"44203",9,9,9,0,0,"AUNACV",0
46,"46165",7349,5460,5412,39,48,"AUNACV",9
46,"46206",555,417,408,0,9,"AUNACV",0
46,"46183",6036,4276,4213,21,63,"AUNACV",1
46,"46031",10574,7233,7158,58,75,"AUNACV",2
46,"46173",1309,1029,1010,13,19,"AUNACV",0
46,"46196",134,111,110,0,1,"AUNACV",0
44,"44041",60,48,48,0,0,"AUNACV",0
46,"46079",314,244,240,0,4,"AUNACV",0
44,"44219",173,118,115,1,3,"AUNACV",0
46,"46180",659,509,500,7,9,"AUNACV",0
12,"12902",2250,1557,1532,16,25,"AUNACV",0
12,"12083",88,69,67,9,2,"AUNACV",0
46,"46022",15392,10624,10546,69,78,"AUNACV",6
44,"44007",149,112,111,1,1,"AUNACV",0
44,"44207",125,98,97,2,1,"AUNACV",0
46,"46179",2136,1624,1596,17,28,"AUNACV",0
44,"44115",102,91,91,0,0,"AUNACV",0
46,"46222",402,329,326,0,3,"AUNACV",0
44,"44032",17,13,13,0,0,"AUNACV",0
44,"44263",373,267,267,2,0,"AUNACV",0
12,"12028",13004,9801,9732,74,69,"AUNACV",0
12,"12029",670,524,514,5,10,"AUNACV",0
44,"44194",103,67,64,0,3,"AUNACV",0
46,"46094",20805,15353,15211,122,142,"AUNACV",7
44,"44064",62,46,46,0,0,"AUNACV",0
46,"46096",263,204,202,0,2,"AUNACV",0
46,"46033",196,155,153,0,2,"AUNACV",0
46,"46200",1840,1475,1455,5,20,"AUNACV",0
12,"12082",9602,7323,7248,53,75,"AUNACV",2
44,"44142",29,21,21,0,0,"AUNACV",0
46,"46238",13117,9172,9088,50,84,"AUNACV",2
46,"46014",3156,2324,2294,13,30,"AUNACV",0
44,"44165",168,125,125,2,0,"AUNACV",0
46,"46013",17761,13652,13548,144,104,"AUNACV",3
44,"44251",239,187,183,1,4,"AUNACV",0
44,"44220",113,82,82,1,0,"AUNACV",0
44,"44004",379,275,275,2,0,"AUNACV",0
46,"46107",1857,1421,1402,4,19,"AUNACV",0
12,"12005",8049,5643,5552,71,91,"AUNACV",0
46,"46036",558,339,331,6,8,"AUNACV",0
12,"12067",514,381,373,3,8,"AUNACV",0
46,"46163",1883,1471,1460,8,11,"AUNACV",0
44,"44089",49,41,41,0,0,"AUNACV",0
46,"46057",463,308,304,1,4,"AUNACV",0
46,"46201",62,40,40,0,0,"AUNACV",0
44,"44222",125,92,92,0,0,"AUNACV",0
46,"46244",59910,42120,41826,338,294,"AUNACV",11
46,"46137",248,201,197,3,4,"AUNACV",0
44,"44167",34,26,26,0,0,"AUNACV",0
12,"12087",26,16,16,0,0,"AUNACV",0
44,"44258",53,46,46,0,0,"AUNACV",0
44,"44010",185,144,143,0,1,"AUNACV",0
12,"12114",200,144,140,0,4,"AUNACV",0
44,"44063",63,52,52,0,0,"AUNACV",0
46,"46032",5719,4297,4262,35,35,"AUNACV",5
46,"46171",16446,11616,11499,94,117,"AUNACV",3
44,"44092",70,53,52,0,1,"AUNACV",0
46,"46042",3335,2655,2620,12,35,"AUNACV",0
46,"46159",23038,16719,16596,127,123,"AUNACV",8
46,"46208",1071,854,845,2,9,"AUNACV",0
46,"46097",948,670,663,1,7,"AUNACV",0
46,"46120",1179,903,880,5,23,"AUNACV",0
44,"44230",149,111,110,2,1,"AUNACV",0
12,"12099",597,444,436,6,8,"AUNACV",0
12,"12004",4149,2945,2910,25,35,"AUNACV",0
46,"46202",17801,13010,12906,87,104,"AUNACV",7
46,"46248",4868,3434,3374,16,60,"AUNACV",0
46,"46254",944,673,661,6,12,"AUNACV",0
46,"46172",5488,3724,3674,26,50,"AUNACV",0
12,"12063",41,31,31,1,0,"AUNACV",0
12,"12021",4398,3314,3277,32,37,"AUNACV",1
46,"46158",1047,771,763,7,8,"AUNACV",0
12,"12124",1842,1343,1328,13,15,"AUNACV",0
46,"46061",351,276,272,6,4,"AUNACV",0
46,"46109",6248,4516,4440,37,76,"AUNACV",0
44,"44235",87,65,64,1,1,"AUNACV",0
12,"12074",756,611,601,3,10,"AUNACV",0
46,"46059",1244,1007,995,5,12,"AUNACV",0
44,"44178",52,34,34,0,0,"AUNACV",0
46,"46191",1956,1439,1414,8,25,"AUNACV",0
44,"44266",102,81,79,0,2,"AUNACV",0
12,"12135",36287,25912,25655,184,257,"AUNACV",18
46,"46194",15852,11124,11009,86,115,"AUNACV",6
12,"12048",243,159,155,4,4,"AUNACV",0
46,"46053",525,433,428,2,5,"AUNACV",0
44,"44206",100,73,73,3,0,"AUNACV",0
12,"12038",157,101,100,3,1,"AUNACV",0
46,"46249",9136,6538,6439,73,99,"AUNACV",1
44,"44067",106,75,71,0,4,"AUNACV",0
44,"44126",314,222,221,0,1,"AUNACV",0
46,"46176",2077,1362,1348,14,14,"AUNACV",0
44,"44070",55,49,49,0,0,"AUNACV",0
44,"44252",73,56,55,0,1,"AUNACV",0
44,"44001",65,43,43,1,0,"AUNACV",0
46,"46012",965,689,675,4,14,"AUNACV",0
44,"44026",100,73,72,0,1,"AUNACV",0
12,"12055",103,77,76,2,1,"AUNACV",0
44,"44225",105,82,81,2,1,"AUNACV",0
46,"46015",7519,5575,5532,34,43,"AUNACV",2
46,"46122",2726,1957,1934,13,23,"AUNACV",0
12,"12137",40,28,28,0,0,"AUNACV",0
44,"44046",44,33,33,0,0,"AUNACV",0
46,"46175",429,362,355,3,7,"AUNACV",0
44,"44075",321,255,252,1,3,"AUNACV",0
46,"46134",2419,1697,1678,14,19,"AUNACV",0
44,"44018",16,16,16,0,0,"AUNACV",0
44,"44054",95,82,81,0,1,"AUNACV",0
44,"44151",180,134,134,1,0,"AUNACV",0
46,"46216",5277,4146,4111,42,35,"AUNACV",0
44,"44124",71,57,57,0,0,"AUNACV",0
46,"46110",21364,15132,15019,120,113,"AUNACV",1
12,"12046",188,135,135,4,0,"AUNACV",0
44,"44006",220,152,151,1,1,"AUNACV",0
44,"44155",1063,779,778,3,1,"AUNACV",0
44,"44181",65,57,57,0,0,"AUNACV",0
12,"12094",871,671,661,1,10,"AUNACV",0
44,"44128",58,39,37,0,2,"AUNACV",0
46,"46104",1906,1422,1409,5,13,"AUNACV",0
44,"44154",240,164,161,1,3,"AUNACV",0
44,"44097",126,76,73,0,3,"AUNACV",0
12,"12130",414,329,327,0,2,"AUNACV",0
12,"12065",167,142,141,0,1,"AUNACV",0
46,"46068",345,283,279,2,4,"AUNACV",0
46,"46133",462,359,352,1,7,"AUNACV",0
46,"46145",22215,15688,15538,127,150,"AUNACV",2
12,"12125",215,179,179,2,0,"AUNACV",0
46,"46082",4981,3547,3523,29,24,"AUNACV",2
46,"46188",693,565,560,2,5,"AUNACV",1
44,"44192",341,274,272,2,2,"AUNACV",0
12,"12084",17785,12557,12422,108,135,"AUNACV",5
12,"12006",177,133,133,2,0,"AUNACV",0
12,"12053",2040,1587,1579,8,8,"AUNACV",0
44,"44071",585,419,418,6,1,"AUNACV",0
46,"46062",4552,3402,3362,27,40,"AUNACV",1
44,"44138",120,92,92,0,0,"AUNACV",0
46,"46144",628,483,478,4,5,"AUNACV",0
12,"12111",327,259,255,8,4,"AUNACV",0
46,"46089",2182,1590,1576,9,14,"AUNACV",0
44,"44231",35,30,30,0,0,"AUNACV",0
44,"44025",5804,4024,3991,11,33,"AUNACV",2
44,"44021",104,77,77,1,0,"AUNACV",0
44,"44034",124,90,90,0,0,"AUNACV",0
46,"46262",206,136,134,1,2,"AUNACV",0
46,"46225",351,267,262,1,5,"AUNACV",0
46,"46106",1471,1033,1028,8,5,"AUNACV",0
46,"46016",1070,827,814,10,13,"AUNACV",0
12,"12012",2622,2084,2056,12,28,"AUNACV",0
46,"46224",156,125,124,0,1,"AUNACV",0
44,"44183",61,47,47,1,0,"AUNACV",0
46,"46220",49112,33766,33424,312,342,"AUNACV",9
44,"44043",86,60,60,0,0,"AUNACV",0
12,"12059",220,183,183,2,0,"AUNACV",0
46,"46132",2176,1725,1708,5,17,"AUNACV",0
44,"44184",44,37,37,0,0,"AUNACV",0
46,"46247",972,649,646,3,3,"AUNACV",0
44,"44051",2579,1924,1901,10,23,"AUNACV",0
12,"12050",1226,904,891,3,13,"AUNACV",0
44,"44111",78,61,61,0,0,"AUNACV",0
44,"44017",269,217,216,0,1,"AUNACV",0
44,"44016",424,299,297,1,2,"AUNACV",0
46,"46023",322,254,252,1,2,"AUNACV",0
46,"46019",8932,6721,6647,40,74,"AUNACV",3
44,"44009",798,593,589,4,4,"AUNACV",0
12,"12132",477,391,385,3,6,"AUNACV",0
12,"12085",5081,3271,3235,17,36,"AUNACV",2
12,"12075",110,85,83,3,2,"AUNACV",0
46,"46003",948,770,757,8,13,"AUNACV",0
46,"46233",3766,2688,2650,14,38,"AUNACV",0
44,"44217",32,25,25,0,0,"AUNACV",0
12,"12041",92,69,69,2,0,"AUNACV",0
46,"46065",1584,1199,1183,11,16,"AUNACV",1
12,"12017",145,111,110,2,1,"AUNACV",0
12,"12128",1365,990,972,16,18,"AUNACV",1
46,"46160",1922,1395,1381,4,14,"AUNACV",0
44,"44107",212,135,135,0,0,"AUNACV",0
46,"46028",383,305,299,8,6,"AUNACV",0
46,"46142",778,536,524,3,12,"AUNACV",0
12,"12069",50,38,38,0,0,"AUNACV",0
46,"46241",388,288,283,5,5,"AUNACV",0
12,"12133",59,46,45,0,1,"AUNACV",0
12,"12116",61,49,49,0,0,"AUNACV",0
44,"44039",204,144,143,1,1,"AUNACV",0
44,"44110",37,30,30,0,0,"AUNACV",0
46,"46129",511,389,379,9,10,"AUNACV",0
44,"44024",31,26,25,0,1,"AUNACV",0
44,"44008",1556,1109,1100,7,9,"AUNACV",0
46,"46156",2017,1538,1524,9,14,"AUNACV",0
44,"44174",402,289,288,1,1,"AUNACV",0
44,"44133",15,12,12,0,0,"AUNACV",0
44,"44175",112,76,75,1,1,"AUNACV",0
12,"12022",323,257,254,5,3,"AUNACV",0
46,"46198",862,670,660,3,10,"AUNACV",0
44,"44132",54,49,49,0,0,"AUNACV",0
46,"46251",2465,1938,1903,19,35,"AUNACV",0
44,"44101",55,41,40,1,1,"AUNACV",0
44,"44027",144,113,113,2,0,"AUNACV",0
12,"12110",222,156,155,3,1,"AUNACV",0
44,"44013",11232,7872,7801,64,71,"AUNACV",1
44,"44193",73,60,60,1,0,"AUNACV",0
44,"44086",410,302,298,3,4,"AUNACV",0
44,"44238",2278,1630,1620,3,10,"AUNACV",0
44,"44119",116,80,79,1,1,"AUNACV",0
46,"46051",8469,6120,6070,40,50,"AUNACV",2
46,"46223",7776,5848,5798,36,50,"AUNACV",6
46,"46021",24053,17331,17194,159,137,"AUNACV",4
44,"44040",189,153,150,1,3,"AUNACV",0
44,"44161",428,294,292,2,2,"AUNACV",0
46,"46260",2685,2072,2053,14,19,"AUNACV",1
44,"44052",75,54,54,0,0,"AUNACV",0
46,"46255",3220,2361,2340,20,21,"AUNACV",0
12,"12141",92,72,72,0,0,"AUNACV",0
44,"44116",75,58,58,0,0,"AUNACV",0
46,"46073",1066,823,817,11,6,"AVANT ADELANTE LOS VERDES",0
46,"46207",6761,4966,4909,46,57,"AVANT ADELANTE LOS VERDES",5
46,"46202",17801,13010,12906,87,104,"AVANT ADELANTE LOS VERDES",20
46,"46179",2136,1624,1596,17,28,"AVANT ADELANTE LOS VERDES",0
46,"46221",348,292,290,1,2,"AVANT ADELANTE LOS VERDES",0
46,"46164",12145,8373,8248,44,125,"AVANT ADELANTE LOS VERDES",20
46,"46223",7776,5848,5798,36,50,"AVANT ADELANTE LOS VERDES",11
46,"46078",28484,19694,19520,173,174,"AVANT ADELANTE LOS VERDES",58
46,"46259",457,374,371,2,3,"AVANT ADELANTE LOS VERDES",1
46,"46032",5719,4297,4262,35,35,"AVANT ADELANTE LOS VERDES",11
46,"46017",33041,23469,23277,173,192,"AVANT ADELANTE LOS VERDES",30
46,"46035",6828,5155,5089,33,66,"AVANT ADELANTE LOS VERDES",3
46,"46251",2465,1938,1903,19,35,"AVANT ADELANTE LOS VERDES",1
46,"46050",185,141,141,1,0,"AVANT ADELANTE LOS VERDES",0
46,"46083",15372,10939,10815,78,124,"AVANT ADELANTE LOS VERDES",24
46,"46130",862,633,625,6,8,"AVANT ADELANTE LOS VERDES",1
46,"46161",1467,1129,1113,5,16,"AVANT ADELANTE LOS VERDES",0
46,"46020",3757,2834,2783,16,51,"AVANT ADELANTE LOS VERDES",4
46,"46230",14116,10038,9946,63,92,"AVANT ADELANTE LOS VERDES",28
46,"46187",1292,924,920,4,4,"AVANT ADELANTE LOS VERDES",2
46,"46037",1120,891,879,7,12,"AVANT ADELANTE LOS VERDES",0
46,"46231",2403,1670,1652,11,18,"AVANT ADELANTE LOS VERDES",2
46,"46093",2151,1652,1640,10,12,"AVANT ADELANTE LOS VERDES",0
46,"46055",1298,992,977,9,15,"AVANT ADELANTE LOS VERDES",2
46,"46151",757,560,552,2,8,"AVANT ADELANTE LOS VERDES",1
46,"46141",433,340,337,6,3,"AVANT ADELANTE LOS VERDES",0
46,"46232",853,661,648,7,13,"AVANT ADELANTE LOS VERDES",2
46,"46098",2405,1778,1751,7,27,"AVANT ADELANTE LOS VERDES",2
46,"46121",106,91,90,1,1,"AVANT ADELANTE LOS VERDES",0
46,"46005",23129,16610,16437,148,173,"AVANT ADELANTE LOS VERDES",40
46,"46210",338,256,251,0,5,"AVANT ADELANTE LOS VERDES",0
46,"46111",11367,7995,7908,66,87,"AVANT ADELANTE LOS VERDES",23
46,"46204",6625,4946,4882,52,64,"AVANT ADELANTE LOS VERDES",10
46,"46146",1647,1241,1229,12,12,"AVANT ADELANTE LOS VERDES",1
46,"46184",26514,19610,19399,180,211,"AVANT ADELANTE LOS VERDES",36
46,"46217",900,672,667,7,5,"AVANT ADELANTE LOS VERDES",1
46,"46201",62,40,40,0,0,"AVANT ADELANTE LOS VERDES",0
46,"46072",3522,2792,2741,25,51,"AVANT ADELANTE LOS VERDES",4
46,"46233",3766,2688,2650,14,38,"AVANT ADELANTE LOS VERDES",2
46,"46060",9278,6796,6724,49,72,"AVANT ADELANTE LOS VERDES",13
46,"46128",1569,1216,1179,7,37,"AVANT ADELANTE LOS VERDES",0
46,"46219",125,107,104,0,3,"AVANT ADELANTE LOS VERDES",0
46,"46261",1708,1259,1237,12,22,"AVANT ADELANTE LOS VERDES",0
46,"46237",7172,5199,5146,53,53,"AVANT ADELANTE LOS VERDES",15
46,"46215",1407,1088,1068,10,20,"AVANT ADELANTE LOS VERDES",1
46,"46059",1244,1007,995,5,12,"AVANT ADELANTE LOS VERDES",0
46,"46070",17824,12888,12802,106,86,"AVANT ADELANTE LOS VERDES",26
46,"46012",965,689,675,4,14,"AVANT ADELANTE LOS VERDES",4
46,"46103",1354,993,978,8,15,"AVANT ADELANTE LOS VERDES",0
46,"46125",852,660,650,5,10,"AVANT ADELANTE LOS VERDES",1
46,"46135",9817,7596,7558,58,38,"AVANT ADELANTE LOS VERDES",10
46,"46191",1956,1439,1414,8,25,"AVANT ADELANTE LOS VERDES",1
46,"46108",420,328,324,1,4,"AVANT ADELANTE LOS VERDES",0
46,"46174",942,746,736,1,10,"AVANT ADELANTE LOS VERDES",1
46,"46139",4520,3486,3457,18,29,"AVANT ADELANTE LOS VERDES",4
46,"46134",2419,1697,1678,14,19,"AVANT ADELANTE LOS VERDES",4
46,"46085",11089,7581,7503,60,78,"AVANT ADELANTE LOS VERDES",4
46,"46256",7280,4996,4940,32,56,"AVANT ADELANTE LOS VERDES",13
46,"46058",1734,1245,1230,8,15,"AVANT ADELANTE LOS VERDES",2
46,"46001",771,562,560,3,2,"AVANT ADELANTE LOS VERDES",1
46,"46189",469,374,367,2,7,"AVANT ADELANTE LOS VERDES",0
46,"46034",1826,1345,1335,3,10,"AVANT ADELANTE LOS VERDES",8
46,"46022",15392,10624,10546,69,78,"AVANT ADELANTE LOS VERDES",29
46,"46065",1584,1199,1183,11,16,"AVANT ADELANTE LOS VERDES",1
46,"46156",2017,1538,1524,9,14,"AVANT ADELANTE LOS VERDES",1
46,"46227",893,687,675,6,12,"AVANT ADELANTE LOS VERDES",1
46,"46148",1515,1131,1113,5,18,"AVANT ADELANTE LOS VERDES",0
46,"46014",3156,2324,2294,13,30,"AVANT ADELANTE LOS VERDES",3
46,"46166",8214,6093,6031,38,62,"AVANT ADELANTE LOS VERDES",11
46,"46225",351,267,262,1,5,"AVANT ADELANTE LOS VERDES",0
46,"46010",943,691,681,7,10,"AVANT ADELANTE LOS VERDES",0
46,"46042",3335,2655,2620,12,35,"AVANT ADELANTE LOS VERDES",0
46,"46206",555,417,408,0,9,"AVANT ADELANTE LOS VERDES",0
46,"46247",972,649,646,3,3,"AVANT ADELANTE LOS VERDES",0
46,"46168",2004,1463,1447,12,16,"AVANT ADELANTE LOS VERDES",4
46,"46248",4868,3434,3374,16,60,"AVANT ADELANTE LOS VERDES",3
46,"46023",322,254,252,1,2,"AVANT ADELANTE LOS VERDES",1
46,"46238",13117,9172,9088,50,84,"AVANT ADELANTE LOS VERDES",7
46,"46063",1786,1270,1255,8,15,"AVANT ADELANTE LOS VERDES",0
46,"46240",200,167,155,1,12,"AVANT ADELANTE LOS VERDES",0
46,"46090",1631,1360,1339,6,21,"AVANT ADELANTE LOS VERDES",2
46,"46075",144,125,122,2,3,"AVANT ADELANTE LOS VERDES",0
46,"46214",16637,12113,12014,84,99,"AVANT ADELANTE LOS VERDES",20
46,"46101",819,670,663,8,7,"AVANT ADELANTE LOS VERDES",1
46,"46126",5580,4361,4328,36,33,"AVANT ADELANTE LOS VERDES",7
46,"46064",532,395,387,3,8,"AVANT ADELANTE LOS VERDES",0
46,"46222",402,329,326,0,3,"AVANT ADELANTE LOS VERDES",0
46,"46163",1883,1471,1460,8,11,"AVANT ADELANTE LOS VERDES",0
46,"46077",7338,5447,5356,44,91,"AVANT ADELANTE LOS VERDES",7
46,"46120",1179,903,880,5,23,"AVANT ADELANTE LOS VERDES",2
46,"46057",463,308,304,1,4,"AVANT ADELANTE LOS VERDES",0
46,"46024",454,343,339,1,4,"AVANT ADELANTE LOS VERDES",1
46,"46181",16967,11951,11835,98,116,"AVANT ADELANTE LOS VERDES",13
46,"46124",786,638,625,1,13,"AVANT ADELANTE LOS VERDES",2
46,"46025",2445,1875,1853,16,22,"AVANT ADELANTE LOS VERDES",3
46,"46053",525,433,428,2,5,"AVANT ADELANTE LOS VERDES",0
46,"46246",1049,808,793,3,15,"AVANT ADELANTE LOS VERDES",0
46,"46080",979,720,712,2,8,"AVANT ADELANTE LOS VERDES",0
46,"46115",330,219,213,0,6,"AVANT ADELANTE LOS VERDES",0
46,"46027",924,746,737,2,9,"AVANT ADELANTE LOS VERDES",0
46,"46007",12333,8890,8803,79,87,"AVANT ADELANTE LOS VERDES",16
46,"46242",326,260,257,3,3,"AVANT ADELANTE LOS VERDES",0
46,"46252",125,89,86,1,3,"AVANT ADELANTE LOS VERDES",0
46,"46132",2176,1725,1708,5,17,"AVANT ADELANTE LOS VERDES",4
46,"46113",2558,1791,1773,7,18,"AVANT ADELANTE LOS VERDES",1
46,"46158",1047,771,763,7,8,"AVANT ADELANTE LOS VERDES",1
46,"46105",16126,10958,10847,76,111,"AVANT ADELANTE LOS VERDES",16
46,"46216",5277,4146,4111,42,35,"AVANT ADELANTE LOS VERDES",7
46,"46904",812,615,605,2,10,"AVANT ADELANTE LOS VERDES",2
46,"46153",443,353,349,2,4,"AVANT ADELANTE LOS VERDES",0
46,"46177",4832,3592,3539,20,53,"AVANT ADELANTE LOS VERDES",6
46,"46118",3649,2730,2701,20,29,"AVANT ADELANTE LOS VERDES",2
46,"46051",8469,6120,6070,40,50,"AVANT ADELANTE LOS VERDES",12
46,"46195",2000,1540,1532,3,8,"AVANT ADELANTE LOS VERDES",4
46,"46119",761,587,580,6,7,"AVANT ADELANTE LOS VERDES",0
46,"46092",262,176,174,2,2,"AVANT ADELANTE LOS VERDES",0
46,"46039",2111,1657,1640,16,17,"AVANT ADELANTE LOS VERDES",1
46,"46018",562,442,436,2,6,"AVANT ADELANTE LOS VERDES",0
46,"46169",32403,23890,23698,222,192,"AVANT ADELANTE LOS VERDES",50
46,"46096",263,204,202,0,2,"AVANT ADELANTE LOS VERDES",0
46,"46245",527,407,404,2,3,"AVANT ADELANTE LOS VERDES",0
46,"46154",795,619,608,5,11,"AVANT ADELANTE LOS VERDES",1
46,"46089",2182,1590,1576,9,14,"AVANT ADELANTE LOS VERDES",0
46,"46188",693,565,560,2,5,"AVANT ADELANTE LOS VERDES",1
46,"46127",2748,2035,2009,6,26,"AVANT ADELANTE LOS VERDES",1
46,"46263",235,182,180,2,2,"AVANT ADELANTE LOS VERDES",1
46,"46258",2617,1925,1914,5,11,"AVANT ADELANTE LOS VERDES",1
46,"46038",302,221,220,1,1,"AVANT ADELANTE LOS VERDES",0
46,"46162",1168,839,832,3,7,"AVANT ADELANTE LOS VERDES",0
46,"46178",5001,3513,3477,26,36,"AVANT ADELANTE LOS VERDES",6
46,"46186",19689,14688,14576,118,112,"AVANT ADELANTE LOS VERDES",21
46,"46143",4274,3027,2995,19,32,"AVANT ADELANTE LOS VERDES",5
46,"46149",350,252,249,3,3,"AVANT ADELANTE LOS VERDES",0
46,"46021",24053,17331,17194,159,137,"AVANT ADELANTE LOS VERDES",45
46,"46150",1794,1276,1272,8,4,"AVANT ADELANTE LOS VERDES",1
46,"46004",1932,1530,1512,10,18,"AVANT ADELANTE LOS VERDES",3
46,"46110",21364,15132,15019,120,113,"AVANT ADELANTE LOS VERDES",37
46,"46224",156,125,124,0,1,"AVANT ADELANTE LOS VERDES",0
46,"46171",16446,11616,11499,94,117,"AVANT ADELANTE LOS VERDES",41
46,"46176",2077,1362,1348,14,14,"AVANT ADELANTE LOS VERDES",2
46,"46069",152,112,111,1,1,"AVANT ADELANTE LOS VERDES",0
46,"46087",109,94,94,2,0,"AVANT ADELANTE LOS VERDES",0
46,"46185",361,301,299,5,2,"AVANT ADELANTE LOS VERDES",0
46,"46002",1253,946,940,4,6,"AVANT ADELANTE LOS VERDES",3
46,"46212",1620,1130,1112,12,18,"AVANT ADELANTE LOS VERDES",3
46,"46052",515,423,419,4,4,"AVANT ADELANTE LOS VERDES",0
46,"46199",5878,4217,4182,21,35,"AVANT ADELANTE LOS VERDES",5
46,"46173",1309,1029,1010,13,19,"AVANT ADELANTE LOS VERDES",1
46,"46045",1245,984,961,3,23,"AVANT ADELANTE LOS VERDES",1
46,"46048",3504,2609,2576,17,33,"AVANT ADELANTE LOS VERDES",3
46,"46182",1312,908,904,5,4,"AVANT ADELANTE LOS VERDES",1
46,"46066",1274,972,970,4,2,"AVANT ADELANTE LOS VERDES",2
46,"46114",552,417,412,6,5,"AVANT ADELANTE LOS VERDES",2
46,"46194",15852,11124,11009,86,115,"AVANT ADELANTE LOS VERDES",26
46,"46071",471,355,349,1,6,"AVANT ADELANTE LOS VERDES",1
46,"46081",9999,7486,7412,47,74,"AVANT ADELANTE LOS VERDES",12
46,"46109",6248,4516,4440,37,76,"AVANT ADELANTE LOS VERDES",10
46,"46068",345,283,279,2,4,"AVANT ADELANTE LOS VERDES",1
46,"46088",152,114,110,1,4,"AVANT ADELANTE LOS VERDES",0
46,"46175",429,362,355,3,7,"AVANT ADELANTE LOS VERDES",0
46,"46183",6036,4276,4213,21,63,"AVANT ADELANTE LOS VERDES",6
46,"46236",929,723,716,2,7,"AVANT ADELANTE LOS VERDES",1
46,"46255",3220,2361,2340,20,21,"AVANT ADELANTE LOS VERDES",8
46,"46155",972,731,716,3,15,"AVANT ADELANTE LOS VERDES",0
46,"46257",5436,3972,3933,28,39,"AVANT ADELANTE LOS VERDES",8
46,"46112",533,435,432,7,3,"AVANT ADELANTE LOS VERDES",0
46,"46190",50042,35290,35066,284,224,"AVANT ADELANTE LOS VERDES",83
46,"46249",9136,6538,6439,73,99,"AVANT ADELANTE LOS VERDES",6
46,"46234",317,247,245,1,2,"AVANT ADELANTE LOS VERDES",0
46,"46029",20448,14673,14556,99,117,"AVANT ADELANTE LOS VERDES",31
46,"46107",1857,1421,1402,4,19,"AVANT ADELANTE LOS VERDES",0
46,"46054",11389,8266,8190,54,76,"AVANT ADELANTE LOS VERDES",14
46,"46123",1926,1392,1368,11,24,"AVANT ADELANTE LOS VERDES",0
46,"46009",3144,2473,2449,22,24,"AVANT ADELANTE LOS VERDES",4
46,"46015",7519,5575,5532,34,43,"AVANT ADELANTE LOS VERDES",9
46,"46133",462,359,352,1,7,"AVANT ADELANTE LOS VERDES",1
46,"46160",1922,1395,1381,4,14,"AVANT ADELANTE LOS VERDES",1
46,"46200",1840,1475,1455,5,20,"AVANT ADELANTE LOS VERDES",1
46,"46028",383,305,299,8,6,"AVANT ADELANTE LOS VERDES",0
46,"46228",2426,1819,1802,19,17,"AVANT ADELANTE LOS VERDES",2
46,"46046",901,623,609,2,14,"AVANT ADELANTE LOS VERDES",0
46,"46100",281,190,187,1,3,"AVANT ADELANTE LOS VERDES",0
46,"46196",134,111,110,0,1,"AVANT ADELANTE LOS VERDES",0
46,"46192",786,534,519,7,15,"AVANT ADELANTE LOS VERDES",0
46,"46144",628,483,478,4,5,"AVANT ADELANTE LOS VERDES",0
46,"46145",22215,15688,15538,127,150,"AVANT ADELANTE LOS VERDES",24
46,"46076",610,500,494,1,6,"AVANT ADELANTE LOS VERDES",2
46,"46262",206,136,134,1,2,"AVANT ADELANTE LOS VERDES",0
46,"46074",2687,2033,2020,18,13,"AVANT ADELANTE LOS VERDES",8
46,"46091",110,100,100,0,0,"AVANT ADELANTE LOS VERDES",0
46,"46041",313,229,228,1,1,"AVANT ADELANTE LOS VERDES",0
46,"46097",948,670,663,1,7,"AVANT ADELANTE LOS VERDES",0
46,"46244",59910,42120,41826,338,294,"AVANT ADELANTE LOS VERDES",104
46,"46040",993,745,733,3,12,"AVANT ADELANTE LOS VERDES",1
46,"46116",13606,10262,10200,87,62,"AVANT ADELANTE LOS VERDES",14
46,"46084",1487,1136,1123,4,13,"AVANT ADELANTE LOS VERDES",2
46,"46049",268,221,217,2,4,"AVANT ADELANTE LOS VERDES",0
46,"46102",19696,14700,14579,125,121,"AVANT ADELANTE LOS VERDES",29
46,"46062",4552,3402,3362,27,40,"AVANT ADELANTE LOS VERDES",5
46,"46250",582242,437146,434438,3315,2708,"AVANT ADELANTE LOS VERDES",917
46,"46104",1906,1422,1409,5,13,"AVANT ADELANTE LOS VERDES",1
46,"46180",659,509,500,7,9,"AVANT ADELANTE LOS VERDES",0
46,"46172",5488,3724,3674,26,50,"AVANT ADELANTE LOS VERDES",8
46,"46167",342,240,239,0,1,"AVANT ADELANTE LOS VERDES",0
46,"46033",196,155,153,0,2,"AVANT ADELANTE LOS VERDES",0
46,"46239",446,357,352,1,5,"AVANT ADELANTE LOS VERDES",0
46,"46016",1070,827,814,10,13,"AVANT ADELANTE LOS VERDES",0
46,"46047",540,428,420,1,8,"AVANT ADELANTE LOS VERDES",0
46,"46209",1903,1406,1383,5,23,"AVANT ADELANTE LOS VERDES",1
46,"46019",8932,6721,6647,40,74,"AVANT ADELANTE LOS VERDES",5
46,"46165",7349,5460,5412,39,48,"AVANT ADELANTE LOS VERDES",11
46,"46026",1220,974,965,7,9,"AVANT ADELANTE LOS VERDES",1
46,"46260",2685,2072,2053,14,19,"AVANT ADELANTE LOS VERDES",2
46,"46208",1071,854,845,2,9,"AVANT ADELANTE LOS VERDES",1
46,"46220",49112,33766,33424,312,342,"AVANT ADELANTE LOS VERDES",64
46,"46106",1471,1033,1028,8,5,"AVANT ADELANTE LOS VERDES",2
46,"46159",23038,16719,16596,127,123,"AVANT ADELANTE LOS VERDES",42
46,"46226",29,20,19,0,1,"AVANT ADELANTE LOS VERDES",0
46,"46082",4981,3547,3523,29,24,"AVANT ADELANTE LOS VERDES",6
46,"46902",352,283,283,0,0,"AVANT ADELANTE LOS VERDES",0
46,"46131",49805,35527,35231,298,296,"AVANT ADELANTE LOS VERDES",64
46,"46031",10574,7233,7158,58,75,"AVANT ADELANTE LOS VERDES",7
46,"46229",903,715,708,5,7,"AVANT ADELANTE LOS VERDES",1
46,"46011",7523,5154,5077,34,77,"AVANT ADELANTE LOS VERDES",3
46,"46079",314,244,240,0,4,"AVANT ADELANTE LOS VERDES",0
46,"46193",8959,6880,6824,66,56,"AVANT ADELANTE LOS VERDES",10
46,"46203",3546,2717,2689,28,28,"AVANT ADELANTE LOS VERDES",5
46,"46142",778,536,524,3,12,"AVANT ADELANTE LOS VERDES",2
46,"46197",1930,1430,1411,11,19,"AVANT ADELANTE LOS VERDES",1
46,"46056",176,142,142,0,0,"AVANT ADELANTE LOS VERDES",0
46,"46211",1862,1395,1381,12,14,"AVANT ADELANTE LOS VERDES",2
46,"46044",4159,3062,2997,26,65,"AVANT ADELANTE LOS VERDES",2
46,"46140",383,321,321,2,0,"AVANT ADELANTE LOS VERDES",0
46,"46117",493,386,380,2,6,"AVANT ADELANTE LOS VERDES",0
46,"46122",2726,1957,1934,13,23,"AVANT ADELANTE LOS VERDES",3
46,"46903",6306,4762,4743,44,19,"AVANT ADELANTE LOS VERDES",7
46,"46213",15499,10610,10482,173,128,"AVANT ADELANTE LOS VERDES",18
46,"46030",810,641,625,7,16,"AVANT ADELANTE LOS VERDES",1
46,"46129",511,389,379,9,10,"AVANT ADELANTE LOS VERDES",0
46,"46235",21229,15171,15011,126,160,"AVANT ADELANTE LOS VERDES",12
46,"46205",14237,10641,10533,77,108,"AVANT ADELANTE LOS VERDES",11
46,"46086",80,66,65,1,1,"AVANT ADELANTE LOS VERDES",0
46,"46147",17186,11507,11399,72,108,"AVANT ADELANTE LOS VERDES",27
46,"46253",112,84,84,0,0,"AVANT ADELANTE LOS VERDES",0
46,"46095",580,445,438,5,7,"AVANT ADELANTE LOS VERDES",1
46,"46198",862,670,660,3,10,"AVANT ADELANTE LOS VERDES",0
46,"46099",744,539,535,2,4,"AVANT ADELANTE LOS VERDES",0
46,"46243",124,93,90,1,3,"AVANT ADELANTE LOS VERDES",0
46,"46008",2617,1954,1931,17,23,"AVANT ADELANTE LOS VERDES",0
46,"46241",388,288,283,5,5,"AVANT ADELANTE LOS VERDES",0
46,"46013",17761,13652,13548,144,104,"AVANT ADELANTE LOS VERDES",31
46,"46036",558,339,331,6,8,"AVANT ADELANTE LOS VERDES",0
46,"46157",2959,2145,2126,11,19,"AVANT ADELANTE LOS VERDES",1
46,"46136",2598,1875,1851,14,24,"AVANT ADELANTE LOS VERDES",3
46,"46043",135,119,118,0,1,"AVANT ADELANTE LOS VERDES",0
46,"46006",4454,3527,3486,27,41,"AVANT ADELANTE LOS VERDES",2
46,"46061",351,276,272,6,4,"AVANT ADELANTE LOS VERDES",1
46,"46170",3417,2618,2577,11,41,"AVANT ADELANTE LOS VERDES",2
46,"46067",1753,1356,1341,8,15,"AVANT ADELANTE LOS VERDES",3
46,"46138",361,289,287,1,2,"AVANT ADELANTE LOS VERDES",0
46,"46003",948,770,757,8,13,"AVANT ADELANTE LOS VERDES",3
46,"46218",1043,842,829,6,13,"AVANT ADELANTE LOS VERDES",0
46,"46094",20805,15353,15211,122,142,"AVANT ADELANTE LOS VERDES",36
46,"46152",90,63,63,0,0,"AVANT ADELANTE LOS VERDES",0
46,"46254",944,673,661,6,12,"AVANT ADELANTE LOS VERDES",1
46,"46137",248,201,197,3,4,"AVANT ADELANTE LOS VERDES",0
3,"3032",97,82,82,0,0,"AVANT ADELANTE LOS VERDES",0
3,"3084",501,413,413,1,0,"AVANT ADELANTE LOS VERDES",0
3,"3038",330,260,254,3,6,"AVANT ADELANTE LOS VERDES",0
3,"3124",459,360,358,0,2,"AVANT ADELANTE LOS VERDES",0
3,"3131",176,129,126,1,3,"AVANT ADELANTE LOS VERDES",0
3,"3101",4933,3502,3462,16,40,"AVANT ADELANTE LOS VERDES",8
3,"3081",1492,1070,1044,12,26,"AVANT ADELANTE LOS VERDES",1
3,"3109",3003,2186,2151,14,35,"AVANT ADELANTE LOS VERDES",4
3,"3139",23126,14650,14522,127,128,"AVANT ADELANTE LOS VERDES",52
3,"3120",2433,1688,1652,13,36,"AVANT ADELANTE LOS VERDES",2
3,"3096",5786,4355,4281,38,74,"AVANT ADELANTE LOS VERDES",3
3,"3075",154,117,115,1,2,"AVANT ADELANTE LOS VERDES",0
3,"3138",3190,2244,2207,9,37,"AVANT ADELANTE LOS VERDES",1
3,"3042",1475,1053,1043,7,10,"AVANT ADELANTE LOS VERDES",1
3,"3037",340,261,255,3,6,"AVANT ADELANTE LOS VERDES",0
3,"3011",8014,5278,5212,50,66,"AVANT ADELANTE LOS VERDES",10
3,"3025",1304,944,934,4,10,"AVANT ADELANTE LOS VERDES",0
3,"3013",1063,809,794,3,15,"AVANT ADELANTE LOS VERDES",0
3,"3111",5579,3777,3737,23,40,"AVANT ADELANTE LOS VERDES",6
3,"3056",8588,6219,6135,29,84,"AVANT ADELANTE LOS VERDES",14
3,"3070",2115,1399,1376,9,23,"AVANT ADELANTE LOS VERDES",2
3,"3095",4807,3453,3410,31,43,"AVANT ADELANTE LOS VERDES",9
3,"3140",26036,18637,18267,237,370,"AVANT ADELANTE LOS VERDES",51
3,"3029",236,174,172,2,2,"AVANT ADELANTE LOS VERDES",0
3,"3094",9795,6528,6481,37,47,"AVANT ADELANTE LOS VERDES",20
3,"3005",7937,5907,5869,40,38,"AVANT ADELANTE LOS VERDES",8
3,"3103",238,196,194,2,2,"AVANT ADELANTE LOS VERDES",0
3,"3066",41762,28723,28388,358,335,"AVANT ADELANTE LOS VERDES",111
3,"3046",1636,1073,1061,7,12,"AVANT ADELANTE LOS VERDES",4
3,"3089",9496,6617,6484,51,133,"AVANT ADELANTE LOS VERDES",16
3,"3001",337,260,258,0,2,"AVANT ADELANTE LOS VERDES",0
3,"3092",6712,4924,4858,35,66,"AVANT ADELANTE LOS VERDES",10
3,"3023",1377,1138,1122,9,16,"AVANT ADELANTE LOS VERDES",2
3,"3088",5895,4030,3961,29,69,"AVANT ADELANTE LOS VERDES",15
3,"3079",18422,13560,13378,152,182,"AVANT ADELANTE LOS VERDES",39
3,"3019",15501,11261,11106,86,155,"AVANT ADELANTE LOS VERDES",38
3,"3069",3329,2102,2077,11,25,"AVANT ADELANTE LOS VERDES",8
3,"3006",493,365,360,2,5,"AVANT ADELANTE LOS VERDES",1
3,"3018",12433,8582,8502,54,80,"AVANT ADELANTE LOS VERDES",24
3,"3060",105,78,77,0,1,"AVANT ADELANTE LOS VERDES",0
3,"3043",2906,2360,2334,27,26,"AVANT ADELANTE LOS VERDES",3
3,"3119",17253,12346,12258,81,88,"AVANT ADELANTE LOS VERDES",39
3,"3035",627,485,485,2,0,"AVANT ADELANTE LOS VERDES",0
3,"3063",27209,18236,18101,164,135,"AVANT ADELANTE LOS VERDES",55
3,"3067",91,78,78,0,0,"AVANT ADELANTE LOS VERDES",0
3,"3036",82,73,71,1,2,"AVANT ADELANTE LOS VERDES",0
3,"3118",2446,1617,1598,8,19,"AVANT ADELANTE LOS VERDES",3
3,"3083",5479,3736,3674,39,62,"AVANT ADELANTE LOS VERDES",8
3,"3104",27072,19732,19477,218,255,"AVANT ADELANTE LOS VERDES",75
3,"3016",88,66,66,0,0,"AVANT ADELANTE LOS VERDES",0
3,"3027",167,142,138,1,4,"AVANT ADELANTE LOS VERDES",1
3,"3061",1060,793,787,5,6,"AVANT ADELANTE LOS VERDES",0
3,"3902",10640,7024,6952,36,72,"AVANT ADELANTE LOS VERDES",8
3,"3121",21997,14689,14572,103,117,"AVANT ADELANTE LOS VERDES",26
3,"3054",334,248,245,2,3,"AVANT ADELANTE LOS VERDES",0
3,"3071",4000,2858,2813,27,45,"AVANT ADELANTE LOS VERDES",2
3,"3044",4608,3437,3391,13,46,"AVANT ADELANTE LOS VERDES",7
3,"3129",1224,934,923,4,11,"AVANT ADELANTE LOS VERDES",0
3,"3010",332,275,268,1,7,"AVANT ADELANTE LOS VERDES",0
3,"3072",352,281,277,3,4,"AVANT ADELANTE LOS VERDES",5
3,"3009",46125,33613,33319,315,294,"AVANT ADELANTE LOS VERDES",85
3,"3052",959,747,735,4,12,"AVANT ADELANTE LOS VERDES",1
3,"3033",101,82,78,0,4,"AVANT ADELANTE LOS VERDES",3
3,"3024",3937,2992,2952,19,40,"AVANT ADELANTE LOS VERDES",2
3,"3050",19420,13210,13116,70,94,"AVANT ADELANTE LOS VERDES",65
3,"3098",523,382,378,1,4,"AVANT ADELANTE LOS VERDES",4
3,"3065",169894,121210,120342,1045,868,"AVANT ADELANTE LOS VERDES",338
3,"3041",6132,4204,4167,22,37,"AVANT ADELANTE LOS VERDES",9
3,"3062",228,173,172,3,1,"AVANT ADELANTE LOS VERDES",0
3,"3040",264,227,221,1,6,"AVANT ADELANTE LOS VERDES",1
3,"3110",312,258,258,0,0,"AVANT ADELANTE LOS VERDES",1
3,"3904",1434,1032,1022,8,10,"AVANT ADELANTE LOS VERDES",2
3,"3064",5015,3514,3461,15,53,"AVANT ADELANTE LOS VERDES",9
3,"3057",174,138,136,0,2,"AVANT ADELANTE LOS VERDES",0
3,"3133",41333,24527,24340,146,187,"AVANT ADELANTE LOS VERDES",43
3,"3074",1766,1347,1336,4,11,"AVANT ADELANTE LOS VERDES",1
3,"3090",18095,12539,12412,75,127,"AVANT ADELANTE LOS VERDES",34
3,"3115",255,213,213,3,0,"AVANT ADELANTE LOS VERDES",0
3,"3901",1137,783,776,9,7,"AVANT ADELANTE LOS VERDES",0
3,"3076",8846,6105,6029,40,76,"AVANT ADELANTE LOS VERDES",16
3,"3004",603,425,423,2,2,"AVANT ADELANTE LOS VERDES",3
3,"3112",650,503,497,3,6,"AVANT ADELANTE LOS VERDES",2
3,"3015",12818,9127,9017,46,110,"AVANT ADELANTE LOS VERDES",14
3,"3134",139,107,107,0,0,"AVANT ADELANTE LOS VERDES",0
3,"3085",271,229,227,5,2,"AVANT ADELANTE LOS VERDES",0
3,"3007",173,141,139,0,2,"AVANT ADELANTE LOS VERDES",1
3,"3073",222,178,178,0,0,"AVANT ADELANTE LOS VERDES",1
3,"3055",5265,3741,3697,16,44,"AVANT ADELANTE LOS VERDES",4
3,"3048",4993,3549,3502,13,47,"AVANT ADELANTE LOS VERDES",4
3,"3028",959,780,767,7,13,"AVANT ADELANTE LOS VERDES",0
3,"3903",2612,1838,1814,7,24,"AVANT ADELANTE LOS VERDES",5
3,"3114",1593,1158,1142,4,16,"AVANT ADELANTE LOS VERDES",1
3,"3106",559,469,465,3,4,"AVANT ADELANTE LOS VERDES",1
3,"3078",468,340,336,0,4,"AVANT ADELANTE LOS VERDES",1
3,"3022",140,125,121,1,4,"AVANT ADELANTE LOS VERDES",0
3,"3047",9768,6220,6144,41,76,"AVANT ADELANTE LOS VERDES",19
3,"3002",3649,2568,2542,11,26,"AVANT ADELANTE LOS VERDES",6
3,"3125",332,226,226,2,0,"AVANT ADELANTE LOS VERDES",0
3,"3017",379,320,314,4,6,"AVANT ADELANTE LOS VERDES",1
3,"3132",512,376,373,2,3,"AVANT ADELANTE LOS VERDES",1
3,"3122",43774,30060,29834,230,226,"AVANT ADELANTE LOS VERDES",121
3,"3026",1331,987,975,7,12,"AVANT ADELANTE LOS VERDES",3
3,"3107",2785,1766,1746,13,20,"AVANT ADELANTE LOS VERDES",6
3,"3020",94,84,84,1,0,"AVANT ADELANTE LOS VERDES",0
3,"3058",4976,3733,3669,20,64,"AVANT ADELANTE LOS VERDES",2
3,"3105",5510,3879,3792,27,87,"AVANT ADELANTE LOS VERDES",11
3,"3003",449,368,367,1,1,"AVANT ADELANTE LOS VERDES",0
3,"3093",19702,13903,13728,113,175,"AVANT ADELANTE LOS VERDES",33
3,"3086",169,140,140,2,0,"AVANT ADELANTE LOS VERDES",0
3,"3130",28,19,19,0,0,"AVANT ADELANTE LOS VERDES",1
3,"3008",158,120,118,1,2,"AVANT ADELANTE LOS VERDES",0
3,"3014",238937,161861,160809,1308,1052,"AVANT ADELANTE LOS VERDES",480
3,"3039",89,65,65,0,0,"AVANT ADELANTE LOS VERDES",0
3,"3099",43101,30222,29885,196,337,"AVANT ADELANTE LOS VERDES",58
3,"3045",216,176,172,1,4,"AVANT ADELANTE LOS VERDES",0
3,"3135",195,134,131,1,3,"AVANT ADELANTE LOS VERDES",0
3,"3102",7181,5126,5073,36,53,"AVANT ADELANTE LOS VERDES",7
3,"3091",244,194,193,2,1,"AVANT ADELANTE LOS VERDES",1
3,"3128",4285,2849,2819,18,30,"AVANT ADELANTE LOS VERDES",7
3,"3034",1404,1028,1010,5,18,"AVANT ADELANTE LOS VERDES",1
3,"3012",1138,863,846,4,17,"AVANT ADELANTE LOS VERDES",0
3,"3097",1014,778,764,5,14,"AVANT ADELANTE LOS VERDES",6
3,"3049",12103,8872,8785,57,87,"AVANT ADELANTE LOS VERDES",7
3,"3080",1330,1040,1032,4,8,"AVANT ADELANTE LOS VERDES",2
3,"3030",559,442,433,2,9,"AVANT ADELANTE LOS VERDES",1
3,"3136",399,302,301,3,1,"AVANT ADELANTE LOS VERDES",0
3,"3031",42046,25035,24819,168,216,"AVANT ADELANTE LOS VERDES",81
3,"3116",1155,819,805,5,14,"AVANT ADELANTE LOS VERDES",0
3,"3113",4339,2978,2935,23,43,"AVANT ADELANTE LOS VERDES",6
3,"3077",1391,1052,1032,10,20,"AVANT ADELANTE LOS VERDES",1
3,"3059",20710,14788,14685,89,103,"AVANT ADELANTE LOS VERDES",18
3,"3053",7568,5551,5468,40,83,"AVANT ADELANTE LOS VERDES",18
3,"3137",654,449,443,7,6,"AVANT ADELANTE LOS VERDES",1
3,"3123",7579,5491,5416,50,75,"AVANT ADELANTE LOS VERDES",8
3,"3100",499,384,378,0,6,"AVANT ADELANTE LOS VERDES",2
3,"3021",5573,4423,4343,23,80,"AVANT ADELANTE LOS VERDES",3
3,"3117",377,306,302,2,4,"AVANT ADELANTE LOS VERDES",1
3,"3051",342,288,286,4,2,"AVANT ADELANTE LOS VERDES",0
3,"3082",12941,8399,8304,51,95,"AVANT ADELANTE LOS VERDES",16
3,"3127",350,260,255,1,5,"AVANT ADELANTE LOS VERDES",1
3,"3068",41,38,37,0,1,"AVANT ADELANTE LOS VERDES",0
12,"12001",1028,783,768,6,15,"AVANT LOS VERDES",0
12,"12139",299,202,200,3,2,"AVANT LOS VERDES",1
12,"12084",17785,12557,12422,108,135,"AVANT LOS VERDES",18
12,"12029",670,524,514,5,10,"AVANT LOS VERDES",0
12,"12070",505,407,398,2,9,"AVANT LOS VERDES",1
12,"12085",5081,3271,3235,17,36,"AVANT LOS VERDES",2
12,"12079",414,310,305,2,5,"AVANT LOS VERDES",0
12,"12027",17506,11776,11649,84,127,"AVANT LOS VERDES",21
12,"12080",1883,1472,1438,8,34,"AVANT LOS VERDES",1
12,"12138",19207,13018,12891,87,127,"AVANT LOS VERDES",21
12,"12065",167,142,141,0,1,"AVANT LOS VERDES",0
12,"12091",171,110,108,4,2,"AVANT LOS VERDES",0
12,"12073",133,97,97,0,0,"AVANT LOS VERDES",0
12,"12105",825,602,598,6,4,"AVANT LOS VERDES",0
12,"12058",59,47,45,1,2,"AVANT LOS VERDES",0
12,"12072",1083,852,827,10,25,"AVANT LOS VERDES",1
12,"12124",1842,1343,1328,13,15,"AVANT LOS VERDES",0
12,"12037",17,13,13,1,0,"AVANT LOS VERDES",0
12,"12064",80,71,69,0,2,"AVANT LOS VERDES",0
12,"12099",597,444,436,6,8,"AVANT LOS VERDES",0
12,"12055",103,77,76,2,1,"AVANT LOS VERDES",0
12,"12016",1549,1244,1234,9,10,"AVANT LOS VERDES",0
12,"12113",90,59,59,1,0,"AVANT LOS VERDES",0
12,"12031",3960,2913,2869,13,44,"AVANT LOS VERDES",3
12,"12131",97,87,87,0,0,"AVANT LOS VERDES",0
12,"12033",1953,1391,1368,6,23,"AVANT LOS VERDES",0
12,"12112",102,79,79,1,0,"AVANT LOS VERDES",0
12,"12063",41,31,31,1,0,"AVANT LOS VERDES",0
12,"12121",1043,878,856,5,22,"AVANT LOS VERDES",0
12,"12034",1389,1022,1002,5,20,"AVANT LOS VERDES",1
12,"12096",732,526,519,4,7,"AVANT LOS VERDES",0
12,"12126",24374,17741,17553,111,188,"AVANT LOS VERDES",13
12,"12104",6843,5181,5111,32,70,"AVANT LOS VERDES",8
12,"12111",327,259,255,8,4,"AVANT LOS VERDES",0
12,"12116",61,49,49,0,0,"AVANT LOS VERDES",0
12,"12129",1783,1207,1184,16,23,"AVANT LOS VERDES",1
12,"12114",200,144,140,0,4,"AVANT LOS VERDES",0
12,"12057",572,456,437,1,19,"AVANT LOS VERDES",1
12,"12051",437,297,295,3,2,"AVANT LOS VERDES",0
12,"12128",1365,990,972,16,18,"AVANT LOS VERDES",1
12,"12107",350,299,295,3,4,"AVANT LOS VERDES",0
12,"12082",9602,7323,7248,53,75,"AVANT LOS VERDES",7
12,"12115",205,161,161,1,0,"AVANT LOS VERDES",0
12,"12007",724,622,614,2,8,"AVANT LOS VERDES",1
12,"12059",220,183,183,2,0,"AVANT LOS VERDES",0
12,"12004",4149,2945,2910,25,35,"AVANT LOS VERDES",3
12,"12077",4828,3395,3357,28,38,"AVANT LOS VERDES",5
12,"12021",4398,3314,3277,32,37,"AVANT LOS VERDES",3
12,"12141",92,72,72,0,0,"AVANT LOS VERDES",0
12,"12122",754,608,600,3,8,"AVANT LOS VERDES",0
12,"12044",442,371,368,1,3,"AVANT LOS VERDES",0
12,"12024",138,107,107,1,0,"AVANT LOS VERDES",0
12,"12074",756,611,601,3,10,"AVANT LOS VERDES",0
12,"12135",36287,25912,25655,184,257,"AVANT LOS VERDES",30
12,"12068",41,22,21,0,1,"AVANT LOS VERDES",0
12,"12049",415,317,305,4,12,"AVANT LOS VERDES",0
12,"12026",828,577,566,11,11,"AVANT LOS VERDES",0
12,"12008",228,195,194,1,1,"AVANT LOS VERDES",0
12,"12036",541,401,395,6,6,"AVANT LOS VERDES",0
12,"12078",334,224,221,2,3,"AVANT LOS VERDES",0
12,"12100",1273,1069,1052,5,17,"AVANT LOS VERDES",1
12,"12025",116,82,79,1,3,"AVANT LOS VERDES",0
12,"12053",2040,1587,1579,8,8,"AVANT LOS VERDES",0
12,"12003",954,710,702,6,8,"AVANT LOS VERDES",2
12,"12134",135,95,95,1,0,"AVANT LOS VERDES",0
12,"12039",792,665,659,2,6,"AVANT LOS VERDES",0
12,"12142",142,113,113,0,0,"AVANT LOS VERDES",0
12,"12012",2622,2084,2056,12,28,"AVANT LOS VERDES",6
12,"12088",57,53,53,0,0,"AVANT LOS VERDES",1
12,"12117",3532,2512,2479,12,33,"AVANT LOS VERDES",3
12,"12043",570,405,397,1,8,"AVANT LOS VERDES",0
12,"12040",119116,85613,84993,620,620,"AVANT LOS VERDES",146
12,"12130",414,329,327,0,2,"AVANT LOS VERDES",0
12,"12050",1226,904,891,3,13,"AVANT LOS VERDES",1
12,"12902",2250,1557,1532,16,25,"AVANT LOS VERDES",2
12,"12011",4583,3228,3177,24,51,"AVANT LOS VERDES",3
12,"12118",78,64,63,0,1,"AVANT LOS VERDES",0
12,"12042",574,459,446,9,13,"AVANT LOS VERDES",0
12,"12097",62,53,51,0,2,"AVANT LOS VERDES",0
12,"12095",950,723,712,5,11,"AVANT LOS VERDES",0
12,"12014",164,111,111,0,0,"AVANT LOS VERDES",0
12,"12017",145,111,110,2,1,"AVANT LOS VERDES",0
12,"12140",1147,849,841,5,8,"AVANT LOS VERDES",4
12,"12081",606,454,446,2,8,"AVANT LOS VERDES",0
12,"12127",63,45,44,1,1,"AVANT LOS VERDES",0
12,"12005",8049,5643,5552,71,91,"AVANT LOS VERDES",7
12,"12132",477,391,385,3,6,"AVANT LOS VERDES",1
12,"12041",92,69,69,2,0,"AVANT LOS VERDES",0
12,"12075",110,85,83,3,2,"AVANT LOS VERDES",0
12,"12020",118,104,103,1,1,"AVANT LOS VERDES",0
12,"12015",115,94,94,0,0,"AVANT LOS VERDES",0
12,"12093",161,111,109,2,2,"AVANT LOS VERDES",0
12,"12018",279,233,231,3,2,"AVANT LOS VERDES",0
12,"12076",72,54,54,0,0,"AVANT LOS VERDES",0
12,"12006",177,133,133,2,0,"AVANT LOS VERDES",0
12,"12060",434,366,360,1,6,"AVANT LOS VERDES",1
12,"12071",1272,936,925,3,11,"AVANT LOS VERDES",1
12,"12048",243,159,155,4,4,"AVANT LOS VERDES",0
12,"12120",149,125,121,3,4,"AVANT LOS VERDES",0
12,"12069",50,38,38,0,0,"AVANT LOS VERDES",0
12,"12901",3339,2583,2561,25,22,"AVANT LOS VERDES",2
12,"12102",518,424,417,4,7,"AVANT LOS VERDES",0
12,"12119",139,97,94,3,3,"AVANT LOS VERDES",0
12,"12133",59,46,45,0,1,"AVANT LOS VERDES",0
12,"12103",87,61,60,0,1,"AVANT LOS VERDES",0
12,"12136",2603,2151,2119,20,32,"AVANT LOS VERDES",2
12,"12032",23728,16870,16726,121,144,"AVANT LOS VERDES",27
12,"12110",222,156,155,3,1,"AVANT LOS VERDES",0
12,"12094",871,671,661,1,10,"AVANT LOS VERDES",1
12,"12046",188,135,135,4,0,"AVANT LOS VERDES",0
12,"12098",529,417,413,3,4,"AVANT LOS VERDES",0
12,"12108",443,354,352,4,2,"AVANT LOS VERDES",0
12,"12092",123,95,95,0,0,"AVANT LOS VERDES",0
12,"12045",333,243,235,2,8,"AVANT LOS VERDES",0
12,"12028",13004,9801,9732,74,69,"AVANT LOS VERDES",19
12,"12013",135,106,106,1,0,"AVANT LOS VERDES",0
12,"12137",40,28,28,0,0,"AVANT LOS VERDES",0
12,"12038",157,101,100,3,1,"AVANT LOS VERDES",0
12,"12125",215,179,179,2,0,"AVANT LOS VERDES",0
12,"12089",4555,3070,3045,22,25,"AVANT LOS VERDES",5
12,"12061",374,263,261,4,2,"AVANT LOS VERDES",0
12,"12010",232,191,187,3,4,"AVANT LOS VERDES",0
12,"12087",26,16,16,0,0,"AVANT LOS VERDES",0
12,"12123",40,32,32,0,0,"AVANT LOS VERDES",0
12,"12009",17943,12389,12292,102,97,"AVANT LOS VERDES",14
12,"12109",646,489,482,4,7,"AVANT LOS VERDES",0
12,"12056",257,205,199,1,6,"AVANT LOS VERDES",0
12,"12052",537,409,398,5,11,"AVANT LOS VERDES",0
12,"12022",323,257,254,5,3,"AVANT LOS VERDES",0
12,"12067",514,381,373,3,8,"AVANT LOS VERDES",0
12,"12101",354,274,270,5,4,"AVANT LOS VERDES",0
12,"12090",102,79,78,1,1,"AVANT LOS VERDES",0
12,"12083",88,69,67,9,2,"AVANT LOS VERDES",0
12,"12106",1151,928,908,9,20,"AVANT LOS VERDES",0
12,"12002",114,96,94,1,2,"AVANT LOS VERDES",0
4,"4074",2910,1813,1789,15,24,"AxSÍ",1
29,"29028",1215,803,779,9,24,"AxSÍ",2
18,"18916",1815,1093,1086,6,7,"AxSÍ",1
29,"29066",357,248,246,1,2,"AxSÍ",0
11,"11902",3664,2123,2094,46,29,"AxSÍ",7
14,"14069",7340,5100,5000,69,100,"AxSÍ",3
21,"21032",1827,1337,1314,13,23,"AxSÍ",0
29,"29048",1364,1053,1039,8,14,"AxSÍ",0
4,"4069",4742,3364,3325,46,39,"AxSÍ",3
18,"18901",489,323,322,5,1,"AxSÍ",2
11,"11020",166773,111205,109956,1580,1249,"AxSÍ",441
14,"14061",687,536,523,1,13,"AxSÍ",1
18,"18159",989,765,762,2,3,"AxSÍ",0
18,"18040",237,146,145,0,1,"AxSÍ",0
29,"29074",771,561,555,1,6,"AxSÍ",0
29,"29038",18908,12122,11931,197,191,"AxSÍ",21
21,"21001",621,431,418,0,13,"AxSÍ",2
41,"41057",258,174,170,3,4,"AxSÍ",0
23,"23047",1558,1203,1186,8,17,"AxSÍ",0
23,"23062",1410,1094,1076,0,18,"AxSÍ",0
18,"18171",2098,1521,1460,11,61,"AxSÍ",3
23,"23007",3015,2252,2229,14,23,"AxSÍ",6
21,"21035",9766,6114,5998,92,116,"AxSÍ",11
18,"18154",982,668,668,4,0,"AxSÍ",0
21,"21065",259,178,175,0,3,"AxSÍ",0
29,"29071",980,580,564,11,16,"AxSÍ",2
41,"41102",14773,10377,10028,174,349,"AxSÍ",64
4,"4058",342,238,236,3,2,"AxSÍ",0
21,"21005",15754,9502,9340,84,162,"AxSÍ",21
18,"18070",287,216,216,3,0,"AxSÍ",0
41,"41075",10320,7159,6972,88,187,"AxSÍ",17
41,"41096",6178,4739,4655,60,84,"AxSÍ",16
4,"4051",404,323,319,2,4,"AxSÍ",1
41,"41076",2134,1246,1230,11,16,"AxSÍ",4
29,"29100",2379,1582,1551,22,31,"AxSÍ",4
14,"14005",6298,3905,3828,71,77,"AxSÍ",7
18,"18145",10909,7925,7780,67,145,"AxSÍ",9
41,"41901",2692,2101,2051,47,50,"AxSÍ",3
23,"23060",19210,13677,13495,145,182,"AxSÍ",30
18,"18170",317,212,209,0,3,"AxSÍ",0
29,"29016",253,196,194,0,2,"AxSÍ",0
41,"41010",4586,3218,3157,42,61,"AxSÍ",19
21,"21031",1166,773,736,11,37,"AxSÍ",4
4,"4062",4457,3241,3197,22,44,"AxSÍ",3
18,"18046",1738,1042,1023,7,19,"AxSÍ",0
4,"4003",17583,11062,10941,77,121,"AxSÍ",7
23,"23099",4824,3523,3435,35,88,"AxSÍ",6
4,"4004",405,282,272,2,10,"AxSÍ",0
41,"41030",501,376,366,9,10,"AxSÍ",0
21,"21062",1403,849,838,10,11,"AxSÍ",2
29,"29094",59795,39350,38854,454,496,"AxSÍ",241
4,"4103",1432,1003,993,10,10,"AxSÍ",1
41,"41001",1558,1129,1104,6,25,"AxSÍ",0
4,"4049",5711,3766,3732,25,34,"AxSÍ",2
29,"29070",43686,27672,27323,290,349,"AxSÍ",68
21,"21011",3500,2371,2314,23,57,"AxSÍ",4
23,"23096",2543,2029,1986,16,43,"AxSÍ",6
18,"18034",484,345,342,3,3,"AxSÍ",0
18,"18116",2856,2027,1979,13,48,"AxSÍ",4
41,"41085",4182,3258,3181,43,77,"AxSÍ",7
4,"4096",285,222,222,0,0,"AxSÍ",0
29,"29903",485,326,324,2,2,"AxSÍ",4
18,"18059",4265,2960,2886,23,74,"AxSÍ",1
23,"23029",798,595,590,0,5,"AxSÍ",0
4,"4038",3105,2020,1984,17,36,"AxSÍ",1
18,"18141",382,240,237,0,3,"AxSÍ",0
14,"14011",580,444,443,3,1,"AxSÍ",0
18,"18030",566,382,380,2,2,"AxSÍ",0
29,"29090",1649,1138,1124,10,14,"AxSÍ",3
18,"18177",375,235,231,5,4,"AxSÍ",0
41,"41069",29669,20316,19848,381,468,"AxSÍ",128
29,"29045",1679,1162,1144,5,18,"AxSÍ",0
18,"18021",17929,12165,11949,139,216,"AxSÍ",12
21,"21022",187,121,116,0,5,"AxSÍ",0
4,"4903",4320,2907,2873,18,34,"AxSÍ",0
11,"11003",1230,802,787,9,15,"AxSÍ",3
21,"21058",2567,1806,1766,32,40,"AxSÍ",3
21,"21014",4066,3089,3029,30,60,"AxSÍ",10
21,"21033",569,410,405,3,5,"AxSÍ",3
41,"41009",1148,750,732,5,18,"AxSÍ",3
21,"21012",285,224,221,0,3,"AxSÍ",0
18,"18089",14504,9854,9746,100,108,"AxSÍ",10
41,"41035",1051,733,722,10,11,"AxSÍ",0
14,"14033",1239,875,856,8,19,"AxSÍ",4
18,"18149",5408,3926,3859,42,67,"AxSÍ",1
4,"4085",360,291,289,0,2,"AxSÍ",0
14,"14042",18695,13788,13514,206,274,"AxSÍ",39
4,"4026",57,38,37,0,1,"AxSÍ",0
11,"11013",2352,1564,1522,13,42,"AxSÍ",2
18,"18157",1148,843,827,7,16,"AxSÍ",2
29,"29029",383,256,254,4,2,"AxSÍ",1
41,"41036",3903,2708,2645,35,63,"AxSÍ",3
14,"14060",3715,2714,2641,41,73,"AxSÍ",10
18,"18049",588,418,415,4,3,"AxSÍ",0
11,"11017",3198,2054,2004,37,50,"AxSÍ",2
29,"29057",330,222,218,2,4,"AxSÍ",0
18,"18105",3827,2436,2392,22,44,"AxSÍ",1
41,"41092",7681,5408,5299,79,109,"AxSÍ",22
18,"18906",903,641,639,2,2,"AxSÍ",1
18,"18123",284,202,200,5,2,"AxSÍ",0
29,"29073",1657,1082,1069,15,13,"AxSÍ",1
41,"41065",22527,14684,14463,205,221,"AxSÍ",28
18,"18163",311,206,204,0,2,"AxSÍ",0
18,"18146",930,645,629,10,16,"AxSÍ",3
11,"11025",4374,2808,2759,30,49,"AxSÍ",51
14,"14067",3842,2863,2800,42,63,"AxSÍ",4
14,"14001",3423,2563,2515,11,48,"AxSÍ",4
29,"29902",2593,1561,1533,15,28,"AxSÍ",1
41,"41100",954,670,635,7,35,"AxSÍ",3
14,"14002",10895,7599,7479,109,120,"AxSÍ",12
21,"21015",645,361,356,8,5,"AxSÍ",0
4,"4052",12882,8400,8322,93,78,"AxSÍ",11
18,"18095",2054,1475,1433,14,42,"AxSÍ",0
21,"21056",2914,2148,2046,29,102,"AxSÍ",4
23,"23048",817,605,599,4,6,"AxSÍ",1
23,"23003",8639,6296,6226,41,70,"AxSÍ",9
11,"11033",21804,13361,13133,213,228,"AxSÍ",49
14,"14014",2496,1962,1907,20,55,"AxSÍ",4
41,"41053",21693,15843,15379,171,464,"AxSÍ",48
14,"14054",13775,10464,10165,105,299,"AxSÍ",14
23,"23085",2171,1587,1575,7,12,"AxSÍ",51
41,"41095",40187,27090,26680,512,410,"AxSÍ",105
11,"11023",9386,6363,6248,116,115,"AxSÍ",5
41,"41066",1307,927,898,7,29,"AxSÍ",1
41,"41093",19064,14867,14700,151,167,"AxSÍ",46
14,"14029",4001,2855,2821,30,34,"AxSÍ",5
41,"41003",2373,1747,1708,18,39,"AxSÍ",3
18,"18907",1762,1358,1351,4,7,"AxSÍ",0
18,"18043",129,74,71,0,3,"AxSÍ",0
4,"4082",275,185,182,2,3,"AxSÍ",0
41,"41019",4931,3323,3251,39,72,"AxSÍ",9
29,"29020",3278,2329,2260,22,69,"AxSÍ",5
29,"29001",4207,3002,2959,40,43,"AxSÍ",1
23,"23903",3498,2633,2601,28,32,"AxSÍ",0
18,"18079",3466,2391,2333,22,58,"AxSÍ",2
14,"14070",1280,911,902,4,9,"AxSÍ",0
18,"18111",2863,2038,2001,29,37,"AxSÍ",1
41,"41054",719,562,546,3,16,"AxSÍ",0
18,"18180",636,410,401,2,9,"AxSÍ",0
18,"18011",4403,3002,2947,24,55,"AxSÍ",2
21,"21045",231,177,174,4,3,"AxSÍ",4
18,"18010",527,398,394,5,4,"AxSÍ",3
23,"23052",1094,920,896,6,24,"AxSÍ",0
41,"41099",3961,2448,2413,14,35,"AxSÍ",66
14,"14050",2350,1774,1720,20,54,"AxSÍ",1
4,"4027",218,130,130,0,0,"AxSÍ",0
11,"11037",5656,4374,4273,24,101,"AxSÍ",5
41,"41081",30061,21488,21059,331,429,"AxSÍ",70
41,"41083",1145,821,814,6,7,"AxSÍ",5
4,"4014",152,105,103,1,2,"AxSÍ",0
29,"29084",27199,18102,17800,268,302,"AxSÍ",55
14,"14041",3113,2234,2160,43,74,"AxSÍ",3
14,"14053",5918,4054,3968,92,86,"AxSÍ",33
21,"21052",4403,2688,2631,26,57,"AxSÍ",9
4,"4099",4930,3526,3462,22,64,"AxSÍ",5
29,"29091",9490,6428,6304,61,124,"AxSÍ",11
23,"23097",6346,4243,4194,31,49,"AxSÍ",5
29,"29099",969,688,669,11,19,"AxSÍ",1
4,"4901",490,343,343,2,0,"AxSÍ",0
18,"18032",247,164,163,1,1,"AxSÍ",0
14,"14026",2000,1294,1253,20,41,"AxSÍ",0
18,"18071",5636,3909,3807,45,102,"AxSÍ",7
11,"11021",4914,3187,3069,61,118,"AxSÍ",13
41,"41063",2735,1855,1797,30,58,"AxSÍ",2
41,"41082",3354,2545,2507,11,38,"AxSÍ",11
41,"41020",13012,8148,7999,135,149,"AxSÍ",18
23,"23038",3786,2934,2900,21,34,"AxSÍ",2
29,"29004",283,222,218,3,4,"AxSÍ",0
11,"11005",4508,2978,2900,34,78,"AxSÍ",6
18,"18126",1436,1024,1002,9,22,"AxSÍ",0
18,"18112",104,68,66,2,2,"AxSÍ",0
18,"18016",297,200,198,3,2,"AxSÍ",0
14,"14010",3992,2786,2723,14,63,"AxSÍ",5
4,"4008",466,374,371,3,3,"AxSÍ",1
23,"23016",386,313,305,4,8,"AxSÍ",1
21,"21055",7326,5395,5309,43,86,"AxSÍ",7
18,"18188",1646,1224,1202,10,22,"AxSÍ",2
11,"11011",1726,1124,1084,8,40,"AxSÍ",15
21,"21073",1902,1073,1043,13,30,"AxSÍ",0
41,"41056",3687,2836,2779,37,57,"AxSÍ",8
18,"18023",15717,10964,10751,132,213,"AxSÍ",20
14,"14039",2577,1858,1801,29,57,"AxSÍ",5
23,"23015",1316,979,973,18,6,"AxSÍ",1
41,"41007",12488,7657,7421,126,236,"AxSÍ",22
29,"29026",1021,703,698,15,5,"AxSÍ",0
14,"14013",16619,11968,11719,153,249,"AxSÍ",72
4,"4047",2224,1649,1627,13,22,"AxSÍ",0
14,"14045",2997,2329,2287,30,42,"AxSÍ",2
21,"21028",370,265,259,2,6,"AxSÍ",1
21,"21027",49,32,32,0,0,"AxSÍ",0
21,"21075",338,243,235,3,8,"AxSÍ",0
21,"21069",1681,1073,1056,9,17,"AxSÍ",3
18,"18192",1462,1125,1103,3,22,"AxSÍ",0
18,"18135",4385,2882,2798,24,84,"AxSÍ",4
23,"23039",2170,1502,1460,10,42,"AxSÍ",2
18,"18050",1649,1113,1095,5,18,"AxSÍ",1
23,"23002",17427,12837,12542,126,295,"AxSÍ",30
21,"21034",1155,768,748,5,20,"AxSÍ",5
29,"29069",87188,54019,53240,633,779,"AxSÍ",93
14,"14902",1113,877,851,15,26,"AxSÍ",1
14,"14058",7866,5451,5334,69,117,"AxSÍ",7
29,"29056",1047,708,696,5,12,"AxSÍ",2
14,"14051",1323,975,951,7,24,"AxSÍ",0
21,"21048",318,234,229,3,5,"AxSÍ",0
14,"14064",296,211,208,6,3,"AxSÍ",1
18,"18176",242,164,161,2,3,"AxSÍ",0
29,"29063",305,244,242,2,2,"AxSÍ",1
11,"11010",6327,3998,3928,112,70,"AxSÍ",15
29,"29040",1933,1260,1235,11,25,"AxSÍ",4
21,"21066",490,394,389,4,5,"AxSÍ",0
4,"4037",1212,890,875,17,15,"AxSÍ",2
4,"4095",687,462,457,4,5,"AxSÍ",2
4,"4088",2444,1587,1574,17,13,"AxSÍ",1
41,"41041",9765,7172,6943,63,229,"AxSÍ",60
18,"18161",245,199,196,0,3,"AxSÍ",0
41,"41002",1421,938,911,7,27,"AxSÍ",14
41,"41033",4958,3299,3250,38,49,"AxSÍ",19
23,"23902",2219,1813,1770,6,43,"AxSÍ",2
18,"18909",514,403,403,0,0,"AxSÍ",0
41,"41047",10449,7884,7770,119,114,"AxSÍ",118
18,"18189",785,598,592,9,6,"AxSÍ",0
21,"21002",16070,11301,11137,132,164,"AxSÍ",33
18,"18039",3343,2293,2252,22,41,"AxSÍ",9
23,"23035",1111,877,856,2,21,"AxSÍ",0
11,"11030",22999,14858,14586,207,272,"AxSÍ",62
18,"18093",2751,1693,1674,18,19,"AxSÍ",0
18,"18063",1232,687,678,9,9,"AxSÍ",0
21,"21021",12545,7816,7696,104,120,"AxSÍ",15
18,"18103",714,500,498,3,2,"AxSÍ",1
14,"14007",15016,10248,10043,99,205,"AxSÍ",24
14,"14066",5748,4116,4035,59,81,"AxSÍ",9
41,"41072",4031,2969,2933,15,36,"AxSÍ",3
18,"18178",664,474,467,1,7,"AxSÍ",0
41,"41048",2195,1445,1400,13,45,"AxSÍ",6
23,"23005",29876,20565,20268,254,297,"AxSÍ",149
29,"29017",6404,4575,4468,48,107,"AxSÍ",13
41,"41055",14791,10197,10000,125,197,"AxSÍ",36
41,"41022",4255,2735,2667,32,68,"AxSÍ",1
18,"18074",265,205,205,0,0,"AxSÍ",0
23,"23009",12849,9722,9572,99,150,"AxSÍ",9
21,"21039",303,211,210,6,1,"AxSÍ",1
18,"18065",588,464,451,2,13,"AxSÍ",0
11,"11039",9957,6134,6043,152,91,"AxSÍ",23
4,"4093",1916,1143,1130,5,13,"AxSÍ",1
18,"18038",1042,782,760,5,22,"AxSÍ",0
23,"23012",4004,2726,2689,21,37,"AxSÍ",0
29,"29046",2494,1727,1693,13,34,"AxSÍ",2
23,"23032",529,427,419,5,8,"AxSÍ",0
4,"4010",587,421,409,5,12,"AxSÍ",0
29,"29053",1717,1133,1116,12,17,"AxSÍ",36
29,"29061",1043,803,773,9,30,"AxSÍ",5
23,"23101",351,238,238,3,0,"AxSÍ",0
23,"23028",6103,4369,4286,26,83,"AxSÍ",11
18,"18164",1790,1135,1108,11,27,"AxSÍ",2
14,"14048",1199,883,866,4,17,"AxSÍ",27
21,"21044",18061,11170,11003,123,167,"AxSÍ",24
23,"23051",2736,2066,2021,16,45,"AxSÍ",8
29,"29047",1082,860,846,0,14,"AxSÍ",0
21,"21017",2302,1469,1452,18,17,"AxSÍ",4
4,"4098",1424,890,885,0,5,"AxSÍ",0
18,"18084",4533,3233,3178,35,55,"AxSÍ",1
4,"4904",1900,1308,1299,4,9,"AxSÍ",1
4,"4084",337,238,232,0,6,"AxSÍ",1
14,"14019",6380,4933,4831,71,102,"AxSÍ",12
14,"14057",6157,4773,4707,59,66,"AxSÍ",6
41,"41070",6451,4715,4632,70,83,"AxSÍ",16
14,"14025",2834,2352,2299,9,53,"AxSÍ",0
23,"23040",1438,1175,1159,3,16,"AxSÍ",0
41,"41078",2445,1722,1689,12,33,"AxSÍ",3
23,"23006",4582,3536,3461,43,75,"AxSÍ",3
18,"18062",11226,7969,7777,88,192,"AxSÍ",10
23,"23074",2984,2271,2236,20,35,"AxSÍ",4
29,"29032",6655,4900,4775,36,125,"AxSÍ",5
18,"18903",852,544,537,9,7,"AxSÍ",0
29,"29018",2009,1421,1362,17,59,"AxSÍ",5
14,"14004",1963,1465,1437,15,28,"AxSÍ",2
41,"41008",1044,788,766,3,22,"AxSÍ",0
4,"4059",1000,676,666,3,10,"AxSÍ",0
41,"41026",4302,3355,3288,26,67,"AxSÍ",4
4,"4022",356,237,236,5,1,"AxSÍ",0
23,"23082",1850,1292,1279,13,13,"AxSÍ",0
18,"18138",2470,1597,1573,25,24,"AxSÍ",0
14,"14036",3677,2619,2555,39,64,"AxSÍ",11
21,"21036",204,128,121,1,7,"AxSÍ",1
18,"18051",1092,735,718,8,17,"AxSÍ",0
18,"18114",585,425,424,7,1,"AxSÍ",0
29,"29054",42538,28080,27814,225,266,"AxSÍ",57
23,"23084",902,627,621,4,6,"AxSÍ",0
4,"4053",12545,8864,8744,67,120,"AxSÍ",13
4,"4006",7192,4389,4335,39,54,"AxSÍ",5
18,"18078",714,546,538,5,8,"AxSÍ",1
29,"29093",2150,1543,1520,8,23,"AxSÍ",0
29,"29013",1613,1191,1154,9,37,"AxSÍ",1
4,"4015",113,81,81,0,0,"AxSÍ",0
14,"14023",1999,1629,1593,11,36,"AxSÍ",3
14,"14006",1319,1088,1057,8,31,"AxSÍ",0
29,"29086",770,479,476,5,3,"AxSÍ",1
21,"21047",1878,1144,1112,12,32,"AxSÍ",0
11,"11029",5442,2826,2765,44,61,"AxSÍ",3
29,"29006",679,461,452,4,9,"AxSÍ",1
14,"14059",679,527,521,11,6,"AxSÍ",0
23,"23011",2138,1536,1507,17,29,"AxSÍ",2
4,"4080",196,148,147,2,1,"AxSÍ",0
4,"4056",165,120,120,0,0,"AxSÍ",0
23,"23054",375,280,272,1,8,"AxSÍ",1
23,"23071",1704,1278,1258,10,20,"AxSÍ",1
29,"29010",1637,1263,1187,2,76,"AxSÍ",1
41,"41050",5173,3954,3878,36,76,"AxSÍ",43
11,"11009",579,399,390,0,9,"AxSÍ",1
21,"21051",222,171,168,3,3,"AxSÍ",2
18,"18132",3101,2418,2382,23,36,"AxSÍ",0
18,"18910",710,439,434,1,5,"AxSÍ",0
4,"4030",1052,690,678,6,12,"AxSÍ",0
14,"14052",9039,5579,5478,79,101,"AxSÍ",5
18,"18047",6103,3992,3922,61,70,"AxSÍ",5
21,"21054",8175,6014,5887,41,127,"AxSÍ",15
23,"23027",711,547,539,5,8,"AxSÍ",0
18,"18187",510,350,350,2,0,"AxSÍ",0
23,"23046",2334,1880,1855,9,25,"AxSÍ",1
41,"41005",9285,6637,6497,83,140,"AxSÍ",26
4,"4078",1127,725,718,8,7,"AxSÍ",2
41,"41017",15907,11486,11302,158,184,"AxSÍ",33
18,"18066",2095,1401,1378,12,23,"AxSÍ",0
23,"23904",2570,1583,1562,10,21,"AxSÍ",3
29,"29097",4160,2872,2800,56,72,"AxSÍ",3
11,"11041",9869,6438,6295,100,143,"AxSÍ",130
23,"23024",12215,8702,8447,69,255,"AxSÍ",18
18,"18912",1352,926,912,7,14,"AxSÍ",0
29,"29901",44757,29291,28960,307,331,"AxSÍ",28
23,"23059",5736,4245,4119,51,126,"AxSÍ",17
18,"18035",1179,882,870,7,12,"AxSÍ",1
18,"18127",17005,11790,11583,150,207,"AxSÍ",12
18,"18137",968,733,731,3,2,"AxSÍ",1
18,"18183",623,380,376,0,4,"AxSÍ",0
21,"21072",10233,7374,7183,116,191,"AxSÍ",12
4,"4091",318,251,250,0,1,"AxSÍ",0
14,"14047",1644,1198,1183,14,15,"AxSÍ",0
23,"23014",2535,1890,1861,28,29,"AxSÍ",1
4,"4072",311,212,211,0,1,"AxSÍ",0
14,"14043",7406,5323,5211,63,112,"AxSÍ",10
29,"29068",7833,4897,4806,50,91,"AxSÍ",4
41,"41029",13520,9849,9663,134,186,"AxSÍ",31
23,"23061",7711,5357,5231,44,126,"AxSÍ",6
21,"21024",464,328,312,1,16,"AxSÍ",1
23,"23058",8832,6528,6407,57,121,"AxSÍ",6
23,"23010",14264,9801,9635,120,166,"AxSÍ",16
41,"41025",2031,1409,1349,11,60,"AxSÍ",3
4,"4018",245,202,197,2,5,"AxSÍ",0
21,"21007",6379,4268,4178,66,90,"AxSÍ",28
29,"29025",41540,27170,26897,271,273,"AxSÍ",45
41,"41062",2151,1619,1589,12,30,"AxSÍ",2
29,"29019",853,604,588,2,16,"AxSÍ",0
41,"41045",5873,3901,3802,53,99,"AxSÍ",9
14,"14056",23477,15826,15470,177,356,"AxSÍ",38
21,"21037",462,320,313,1,7,"AxSÍ",1
14,"14028",302,241,240,3,1,"AxSÍ",0
23,"23057",727,582,572,7,10,"AxSÍ",0
18,"18028",898,723,718,3,5,"AxSÍ",0
14,"14038",32742,23345,22974,242,371,"AxSÍ",57
21,"21042",15610,8112,8011,164,101,"AxSÍ",105
23,"23037",518,403,398,10,5,"AxSÍ",0
11,"11034",2319,1520,1487,17,33,"AxSÍ",32
14,"14020",336,227,225,0,2,"AxSÍ",0
41,"41064",5602,3520,3417,56,103,"AxSÍ",9
18,"18006",4062,2765,2711,25,54,"AxSÍ",3
11,"11038",13632,10047,9812,99,235,"AxSÍ",76
41,"41051",2317,1715,1688,4,27,"AxSÍ",2
29,"29044",749,477,473,1,4,"AxSÍ",0
23,"23025",2725,1894,1870,11,24,"AxSÍ",3
21,"21025",3886,2489,2431,31,58,"AxSÍ",10
29,"29065",191,145,143,3,2,"AxSÍ",0
41,"41013",4836,3174,3124,41,50,"AxSÍ",3
41,"41031",1204,780,769,5,11,"AxSÍ",5
4,"4073",327,224,223,0,1,"AxSÍ",0
41,"41028",2108,1652,1632,22,20,"AxSÍ",3
23,"23087",11169,8193,8045,79,148,"AxSÍ",5
18,"18148",787,618,605,5,13,"AxSÍ",0
23,"23064",1669,1311,1296,9,15,"AxSÍ",1
23,"23077",604,482,477,2,5,"AxSÍ",0
18,"18036",3986,2956,2917,22,39,"AxSÍ",4
23,"23050",90664,65260,64519,581,741,"AxSÍ",100
29,"29024",371,216,204,3,12,"AxSÍ",1
18,"18915",726,474,467,4,7,"AxSÍ",0
18,"18179",493,315,309,8,6,"AxSÍ",0
4,"4068",170,129,128,0,1,"AxSÍ",0
11,"11019",1757,1233,1172,13,61,"AxSÍ",11
23,"23095",8571,6159,6101,37,58,"AxSÍ",8
4,"4033",121,78,77,3,1,"AxSÍ",0
18,"18107",920,643,626,1,17,"AxSÍ",0
41,"41004",57692,38578,37814,696,764,"AxSÍ",397
21,"21008",2604,1663,1626,10,37,"AxSÍ",3
41,"41059",35358,26408,26052,346,356,"AxSÍ",100
29,"29031",1555,1015,986,6,29,"AxSÍ",0
18,"18913",771,530,514,2,16,"AxSÍ",2
4,"4070",1529,1088,1076,8,12,"AxSÍ",1
18,"18088",1526,1000,993,10,7,"AxSÍ",0
14,"14008",2758,1880,1836,21,44,"AxSÍ",2
21,"21029",1514,1036,1003,14,33,"AxSÍ",0
18,"18054",820,573,569,2,4,"AxSÍ",0
14,"14032",388,302,293,0,9,"AxSÍ",0
11,"11027",68774,45571,45137,567,434,"AxSÍ",285
18,"18902",752,589,568,3,21,"AxSÍ",3
18,"18076",789,534,532,2,2,"AxSÍ",0
11,"11024",6550,4500,4402,67,98,"AxSÍ",9
41,"41086",16199,10227,10105,137,122,"AxSÍ",40
18,"18905",15688,10406,10200,122,206,"AxSÍ",12
4,"4079",54675,35691,35365,328,326,"AxSÍ",50
18,"18025",277,198,197,0,1,"AxSÍ",0
29,"29022",177,137,136,1,1,"AxSÍ",0
18,"18115",2635,1766,1738,13,28,"AxSÍ",2
11,"11002",4218,3176,3149,16,27,"AxSÍ",3
41,"41101",6025,4299,4213,53,86,"AxSÍ",8
41,"41032",3842,2800,2704,24,96,"AxSÍ",5
11,"11035",13751,8535,8396,125,139,"AxSÍ",72
23,"23018",2243,1606,1584,17,22,"AxSÍ",2
4,"4016",2136,1486,1467,13,19,"AxSÍ",3
4,"4029",8830,5546,5482,43,64,"AxSÍ",5
41,"41044",7753,5636,5547,55,89,"AxSÍ",22
21,"21071",206,148,144,4,4,"AxSÍ",0
11,"11012",97338,67120,66466,861,654,"AxSÍ",253
23,"23030",1207,998,977,7,21,"AxSÍ",1
29,"29030",770,618,611,4,7,"AxSÍ",1
21,"21030",1887,1493,1458,12,35,"AxSÍ",0
18,"18015",424,331,330,4,1,"AxSÍ",0
4,"4032",5716,3727,3696,43,31,"AxSÍ",2
41,"41006",2733,1776,1742,17,34,"AxSÍ",2
41,"41058",17956,12890,12553,200,337,"AxSÍ",116
41,"41068",13963,9596,9407,96,189,"AxSÍ",15
29,"29035",1478,1054,1040,3,14,"AxSÍ",4
18,"18013",4154,2892,2812,28,80,"AxSÍ",2
29,"29077",207,135,134,1,1,"AxSÍ",0
21,"21038",1082,688,676,4,12,"AxSÍ",2
14,"14016",1273,936,922,5,14,"AxSÍ",2
4,"4055",361,298,290,3,8,"AxSÍ",0
41,"41014",2476,1852,1799,10,53,"AxSÍ",7
18,"18057",5584,4042,3958,51,84,"AxSÍ",4
4,"4034",169,91,91,1,0,"AxSÍ",1
4,"4011",2744,2010,1984,20,26,"AxSÍ",1
11,"11040",396,332,324,3,8,"AxSÍ",2
4,"4019",236,174,172,0,2,"AxSÍ",2
18,"18083",232,181,179,1,2,"AxSÍ",0
18,"18151",261,167,166,4,1,"AxSÍ",0
18,"18120",266,204,204,4,0,"AxSÍ",0
18,"18144",816,592,582,3,10,"AxSÍ",1
29,"29014",218,122,121,3,1,"AxSÍ",0
14,"14030",7761,5711,5588,84,123,"AxSÍ",11
18,"18914",1660,1255,1227,11,28,"AxSÍ",0
14,"14031",556,462,456,5,6,"AxSÍ",2
41,"41074",2994,2154,2105,19,49,"AxSÍ",2
14,"14068",517,388,378,3,10,"AxSÍ",0
21,"21074",2736,1826,1790,19,36,"AxSÍ",1
11,"11032",54731,31560,31284,492,276,"AxSÍ",90
11,"11901",5739,3759,3686,99,73,"AxSÍ",44
14,"14065",1820,1374,1352,13,22,"AxSÍ",2
18,"18037",535,417,410,2,7,"AxSÍ",0
4,"4021",179,132,129,2,3,"AxSÍ",0
29,"29037",215,156,153,1,3,"AxSÍ",0
18,"18018",542,384,377,2,7,"AxSÍ",0
29,"29049",2890,2069,2034,12,35,"AxSÍ",1
14,"14075",552,413,391,5,22,"AxSÍ",0
11,"11008",17923,11702,11464,192,238,"AxSÍ",62
23,"23017",1498,1153,1129,11,24,"AxSÍ",0
18,"18045",1065,720,690,11,30,"AxSÍ",0
18,"18001",222,147,146,0,1,"AxSÍ",0
41,"41080",1231,832,815,14,17,"AxSÍ",0
41,"41049",9515,6961,6843,115,118,"AxSÍ",16
23,"23033",1325,1008,989,11,19,"AxSÍ",2
18,"18004",669,467,466,6,1,"AxSÍ",0
23,"23043",517,360,360,1,0,"AxSÍ",0
29,"29076",2354,1498,1444,21,54,"AxSÍ",1
11,"11036",683,401,395,15,6,"AxSÍ",0
18,"18098",5959,3816,3749,33,67,"AxSÍ",2
18,"18904",741,500,498,1,2,"AxSÍ",0
18,"18122",15994,11009,10773,109,236,"AxSÍ",20
29,"29060",665,454,450,1,4,"AxSÍ",0
14,"14063",994,731,719,8,12,"AxSÍ",2
18,"18184",2193,1542,1511,16,31,"AxSÍ",2
4,"4045",1696,1268,1254,17,14,"AxSÍ",2
18,"18087",182877,131811,130184,1106,1627,"AxSÍ",101
21,"21078",2641,1718,1670,10,48,"AxSÍ",1
21,"21023",2033,1215,1193,10,22,"AxSÍ",8
41,"41061",2141,1661,1621,7,40,"AxSÍ",4
14,"14017",10953,7929,7791,84,138,"AxSÍ",18
41,"41027",4007,2628,2546,33,82,"AxSÍ",10
4,"4035",8439,5822,5768,45,54,"AxSÍ",2
4,"4101",4356,2818,2768,32,50,"AxSÍ",1
18,"18911",7933,5464,5348,53,116,"AxSÍ",5
14,"14027",7890,5841,5726,78,115,"AxSÍ",20
18,"18124",355,232,231,1,1,"AxSÍ",0
4,"4013",143819,93083,92383,893,700,"AxSÍ",102
21,"21003",684,476,452,4,24,"AxSÍ",0
18,"18173",8999,5958,5871,50,87,"AxSÍ",6
21,"21050",12567,8522,8392,89,130,"AxSÍ",13
18,"18182",1926,1222,1204,8,18,"AxSÍ",1
41,"41084",2799,2029,1937,9,92,"AxSÍ",2
29,"29021",155,111,109,1,2,"AxSÍ",0
14,"14071",874,551,540,5,11,"AxSÍ",0
18,"18067",682,442,437,2,5,"AxSÍ",0
23,"23086",11427,7984,7735,81,249,"AxSÍ",16
23,"23049",1740,1215,1183,12,32,"AxSÍ",0
29,"29098",1228,902,876,11,26,"AxSÍ",2
23,"23081",1494,1084,1061,9,23,"AxSÍ",2
29,"29043",2463,1508,1460,20,48,"AxSÍ",2
4,"4048",1499,964,957,4,7,"AxSÍ",0
29,"29041",3697,2406,2361,47,45,"AxSÍ",4
18,"18133",2101,1496,1477,6,19,"AxSÍ",0
18,"18101",9449,6688,6568,77,120,"AxSÍ",3
23,"23066",4274,3517,3460,16,57,"AxSÍ",8
18,"18174",435,324,320,3,4,"AxSÍ",0
18,"18194",2038,1373,1348,12,25,"AxSÍ",1
18,"18175",11793,8099,7943,62,156,"AxSÍ",10
4,"4077",296,270,268,3,2,"AxSÍ",0
29,"29007",28907,20371,20129,254,242,"AxSÍ",39
18,"18005",363,232,230,3,2,"AxSÍ",0
21,"21063",2611,1948,1891,23,57,"AxSÍ",1
4,"4081",351,264,263,0,1,"AxSÍ",0
23,"23001",912,723,712,2,11,"AxSÍ",0
4,"4002",1013,711,699,1,12,"AxSÍ",0
11,"11015",64414,39635,39220,776,415,"AxSÍ",153
23,"23070",3813,2384,2354,11,30,"AxSÍ",2
18,"18097",947,633,631,0,2,"AxSÍ",0
18,"18096",340,227,226,0,1,"AxSÍ",0
23,"23063",3784,2699,2664,22,35,"AxSÍ",7
18,"18020",489,318,310,2,8,"AxSÍ",0
14,"14049",16185,11561,11323,145,238,"AxSÍ",39
29,"29036",614,393,387,1,6,"AxSÍ",0
29,"29052",213,129,128,0,1,"AxSÍ",0
18,"18121",119,79,79,1,0,"AxSÍ",0
41,"41038",102752,71545,70538,980,1007,"AxSÍ",344
18,"18109",597,430,422,5,8,"AxSÍ",0
29,"29011",2893,1763,1736,12,27,"AxSÍ",2
21,"21077",1739,1266,1235,13,31,"AxSÍ",2
21,"21019",592,397,389,6,8,"AxSÍ",0
18,"18024",837,651,639,11,12,"AxSÍ",1
18,"18165",4265,2870,2820,22,50,"AxSÍ",2
18,"18134",6104,4049,3972,39,77,"AxSÍ",4
41,"41904",1789,1125,1109,31,16,"AxSÍ",1
41,"41040",11183,8351,8253,71,98,"AxSÍ",31
29,"29904",418,328,322,1,6,"AxSÍ",0
18,"18147",3655,2273,2241,16,32,"AxSÍ",4
29,"29058",1542,994,979,5,15,"AxSÍ",1
21,"21068",973,562,556,11,6,"AxSÍ",2
18,"18152",928,663,660,3,3,"AxSÍ",0
4,"4089",687,484,479,2,5,"AxSÍ",2
29,"29067",431757,290824,287855,3289,2969,"AxSÍ",611
18,"18007",730,490,478,3,12,"AxSÍ",0
4,"4036",239,178,176,0,2,"AxSÍ",0
21,"21009",834,527,508,4,19,"AxSÍ",1
18,"18099",1582,1184,1156,13,28,"AxSÍ",2
11,"11042",1158,806,793,6,13,"AxSÍ",0
23,"23044",4697,3495,3400,31,95,"AxSÍ",4
14,"14055",18411,13054,12798,192,256,"AxSÍ",79
21,"21018",1719,1048,1029,12,19,"AxSÍ",2
11,"11006",24558,15334,15113,231,221,"AxSÍ",44
29,"29050",392,229,227,3,2,"AxSÍ",0
4,"4061",625,489,479,5,10,"AxSÍ",0
41,"41037",3201,2306,2260,22,46,"AxSÍ",5
4,"4094",215,156,156,0,0,"AxSÍ",0
18,"18072",655,452,445,4,7,"AxSÍ",0
23,"23055",46314,30950,30506,279,444,"AxSÍ",167
41,"41016",7820,5523,5407,57,116,"AxSÍ",20
29,"29083",2063,1471,1444,14,27,"AxSÍ",1
18,"18143",945,661,651,2,10,"AxSÍ",0
18,"18022",13875,8948,8764,98,184,"AxSÍ",12
41,"41034",23576,15461,15214,264,247,"AxSÍ",453
29,"29005",4507,3012,2965,29,47,"AxSÍ",3
4,"4023",118,84,82,2,2,"AxSÍ",0
18,"18048",2494,1708,1657,18,51,"AxSÍ",0
29,"29089",3138,2262,2186,13,76,"AxSÍ",4
29,"29095",3285,2313,2224,39,89,"AxSÍ",2
4,"4092",2791,2058,2023,4,35,"AxSÍ",2
41,"41088",515,368,358,2,10,"AxSÍ",0
11,"11022",48785,24758,24422,398,336,"AxSÍ",112
29,"29023",2330,1441,1429,11,12,"AxSÍ",1
18,"18086",338,253,247,1,6,"AxSÍ",0
4,"4043",517,398,395,1,3,"AxSÍ",1
41,"41073",1684,1100,1074,7,26,"AxSÍ",3
4,"4100",9433,5599,5556,48,43,"AxSÍ",8
4,"4046",849,617,612,6,5,"AxSÍ",0
41,"41098",5161,3792,3732,33,60,"AxSÍ",10
18,"18068",1638,1197,1167,12,30,"AxSÍ",1
14,"14901",932,753,750,6,3,"AxSÍ",0
23,"23073",4363,3214,3176,24,38,"AxSÍ",4
14,"14012",6046,4215,4120,56,95,"AxSÍ",10
29,"29012",9718,6664,6553,85,111,"AxSÍ",2
18,"18002",529,387,384,1,3,"AxSÍ",0
29,"29027",2325,1543,1516,13,27,"AxSÍ",2
14,"14035",5774,4076,4017,35,59,"AxSÍ",4
18,"18064",366,289,286,0,3,"AxSÍ",0
21,"21010",15011,8812,8694,174,118,"AxSÍ",49
4,"4075",5462,3714,3676,19,38,"AxSÍ",2
29,"29081",250,185,182,2,3,"AxSÍ",0
18,"18027",2598,1730,1706,12,24,"AxSÍ",1
23,"23008",1422,1042,1020,9,22,"AxSÍ",2
21,"21064",6674,4503,4426,68,77,"AxSÍ",17
21,"21070",6294,4232,4124,64,108,"AxSÍ",9
29,"29087",363,249,243,4,6,"AxSÍ",0
14,"14022",3881,2888,2853,15,35,"AxSÍ",3
21,"21059",221,169,163,1,6,"AxSÍ",0
41,"41060",15058,10551,10302,122,249,"AxSÍ",53
11,"11903",1769,1116,1101,22,15,"AxSÍ",3
29,"29088",2689,1817,1747,15,70,"AxSÍ",4
41,"41089",6621,4650,4549,64,101,"AxSÍ",88
14,"14003",1245,925,907,5,18,"AxSÍ",0
4,"4071",362,286,281,2,5,"AxSÍ",0
18,"18108",822,604,599,2,5,"AxSÍ",1
14,"14015",2045,1465,1418,16,47,"AxSÍ",3
23,"23901",1125,905,895,3,10,"AxSÍ",0
11,"11026",4700,3387,3293,17,94,"AxSÍ",25
23,"23020",1510,1263,1253,16,10,"AxSÍ",0
23,"23019",1466,1117,1090,5,27,"AxSÍ",1
41,"41091",539590,389351,384943,4676,4408,"AxSÍ",1574
21,"21004",1586,994,964,23,30,"AxSÍ",4
18,"18119",1708,1264,1240,7,24,"AxSÍ",0
18,"18100",7997,5523,5367,66,156,"AxSÍ",2
18,"18056",3382,2397,2350,30,47,"AxSÍ",2
23,"23092",27717,19749,19490,217,259,"AxSÍ",32
41,"41012",3375,2259,2214,26,45,"AxSÍ",5
11,"11018",1434,1001,977,8,24,"AxSÍ",5
18,"18003",14454,10162,9935,105,227,"AxSÍ",9
14,"14073",2768,1934,1880,33,54,"AxSÍ",4
41,"41024",22819,14767,14455,169,312,"AxSÍ",40
18,"18085",690,440,432,1,8,"AxSÍ",1
41,"41018",9432,6463,6368,86,95,"AxSÍ",21
4,"4063",1058,766,750,6,16,"AxSÍ",0
21,"21061",5083,3325,3255,36,70,"AxSÍ",2
14,"14044",1613,1186,1164,10,22,"AxSÍ",1
4,"4007",735,514,509,3,5,"AxSÍ",0
41,"41042",5872,4477,4424,42,53,"AxSÍ",10
21,"21053",3306,2161,2106,11,55,"AxSÍ",2
41,"41903",6776,4616,4494,72,122,"AxSÍ",9
4,"4041",344,227,222,4,5,"AxSÍ",0
23,"23045",2054,1423,1412,10,11,"AxSÍ",0
18,"18136",1778,1320,1284,14,36,"AxSÍ",1
41,"41015",5426,3778,3639,41,139,"AxSÍ",21
4,"4066",13438,8615,8519,78,96,"AxSÍ",2
41,"41087",10557,7217,7029,67,188,"AxSÍ",21
29,"29092",576,375,366,7,9,"AxSÍ",2
21,"21020",349,230,228,2,2,"AxSÍ",1
29,"29008",15249,10396,10234,108,162,"AxSÍ",9
21,"21043",1853,1354,1325,23,29,"AxSÍ",5
4,"4050",742,465,464,0,1,"AxSÍ",0
18,"18014",6938,4864,4742,64,122,"AxSÍ",5
4,"4087",157,115,113,0,2,"AxSÍ",0
14,"14009",2653,1658,1631,24,27,"AxSÍ",2
18,"18042",417,332,330,4,2,"AxSÍ",2
23,"23067",2405,1765,1724,14,41,"AxSÍ",1
18,"18167",1839,1243,1224,9,19,"AxSÍ",2
4,"4083",1727,1265,1250,8,15,"AxSÍ",0
21,"21060",12287,7761,7638,134,123,"AxSÍ",22
23,"23080",1720,1313,1294,6,19,"AxSÍ",0
29,"29082",34683,24751,24495,263,256,"AxSÍ",39
29,"29072",3291,2360,2307,19,53,"AxSÍ",1
11,"11016",15079,9353,9192,137,161,"AxSÍ",26
14,"14021",260521,185270,183300,2192,1970,"AxSÍ",338
23,"23091",675,516,512,1,4,"AxSÍ",0
29,"29080",6940,4676,4617,36,59,"AxSÍ",10
21,"21026",262,172,168,2,4,"AxSÍ",0
21,"21076",2153,1459,1426,31,33,"AxSÍ",3
41,"41079",9285,6591,6446,101,145,"AxSÍ",48
23,"23090",1204,953,938,6,15,"AxSÍ",1
23,"23093",3119,2264,2216,24,48,"AxSÍ",1
21,"21046",1729,1212,1187,14,25,"AxSÍ",3
4,"4086",1631,1128,1114,3,14,"AxSÍ",1
29,"29042",14586,9793,9649,95,144,"AxSÍ",75
23,"23098",847,704,700,0,4,"AxSÍ",0
21,"21067",406,274,271,3,3,"AxSÍ",0
21,"21079",678,428,417,2,11,"AxSÍ",2
4,"4044",1542,1092,1080,8,12,"AxSÍ",0
23,"23905",1828,1320,1302,12,18,"AxSÍ",3
4,"4065",365,273,271,1,2,"AxSÍ",0
14,"14018",3617,2632,2568,31,64,"AxSÍ",8
23,"23053",9451,6038,5975,60,63,"AxSÍ",4
29,"29051",42179,27231,26724,282,507,"AxSÍ",43
21,"21902",1136,744,739,2,5,"AxSÍ",2
18,"18017",18201,11500,11358,94,142,"AxSÍ",12
4,"4031",2238,1649,1645,15,4,"AxSÍ",0
41,"41067",7273,5114,5036,59,78,"AxSÍ",13
14,"14037",3161,2233,2158,22,75,"AxSÍ",5
18,"18029",1812,1104,1065,7,39,"AxSÍ",2
23,"23031",764,660,640,6,20,"AxSÍ",0
23,"23079",3624,2661,2630,19,31,"AxSÍ",2
18,"18094",2299,1712,1652,20,60,"AxSÍ",0
29,"29096",2757,1847,1790,19,57,"AxSÍ",2
14,"14062",945,700,693,2,7,"AxSÍ",0
18,"18117",497,360,354,1,6,"AxSÍ",0
18,"18033",279,179,174,0,5,"AxSÍ",0
23,"23004",407,321,315,2,6,"AxSÍ",0
11,"11014",17203,10923,10805,222,118,"AxSÍ",218
23,"23042",292,219,219,0,0,"AxSÍ",0
23,"23056",3052,2279,2207,26,72,"AxSÍ",9
18,"18061",999,781,770,5,11,"AxSÍ",0
4,"4902",45571,29423,29169,272,254,"AxSÍ",31
18,"18053",1554,1001,985,9,16,"AxSÍ",0
21,"21041",113074,73295,72313,1063,982,"AxSÍ",317
21,"21057",995,600,590,8,10,"AxSÍ",2
23,"23034",2480,1923,1882,15,41,"AxSÍ",2
23,"23072",1879,1389,1363,3,26,"AxSÍ",4
4,"4102",14202,9264,9139,57,125,"AxSÍ",2
41,"41021",21410,14369,14139,195,230,"AxSÍ",58
29,"29015",32093,22044,21716,253,328,"AxSÍ",38
14,"14034",302,222,215,1,7,"AxSÍ",0
29,"29085",138,98,93,1,5,"AxSÍ",0
29,"29064",423,291,285,2,6,"AxSÍ",0
4,"4060",416,286,282,2,4,"AxSÍ",0
41,"41043",669,447,436,11,11,"AxSÍ",0
18,"18158",7978,4861,4771,43,90,"AxSÍ",1
29,"29003",916,677,666,4,11,"AxSÍ",0
4,"4012",184,151,150,3,1,"AxSÍ",0
14,"14072",983,692,680,6,12,"AxSÍ",2
29,"29062",658,557,551,2,6,"AxSÍ",1
23,"23094",3739,2920,2876,29,44,"AxSÍ",9
4,"4009",140,109,106,2,3,"AxSÍ",0
41,"41052",3032,2162,2092,6,70,"AxSÍ",7
14,"14024",1849,1417,1391,5,26,"AxSÍ",5
29,"29075",12886,8292,8191,63,101,"AxSÍ",10
18,"18044",161,91,91,0,0,"AxSÍ",0
21,"21006",3321,2197,2125,19,72,"AxSÍ",9
4,"4020",302,207,206,2,1,"AxSÍ",0
18,"18102",8233,5424,5266,46,158,"AxSÍ",1
11,"11031",76427,49773,49248,654,525,"AxSÍ",320
41,"41071",5571,3608,3516,64,92,"AxSÍ",6
29,"29055",1892,1425,1394,3,31,"AxSÍ",1
41,"41902",4599,2906,2868,50,38,"AxSÍ",7
23,"23069",5240,4153,4065,26,88,"AxSÍ",9
4,"4076",1209,873,850,7,23,"AxSÍ",1
4,"4090",298,229,225,1,4,"AxSÍ",0
11,"11004",89919,55211,54544,830,667,"AxSÍ",195
4,"4028",207,175,171,1,4,"AxSÍ",0
21,"21016",985,703,680,5,23,"AxSÍ",1
18,"18150",6964,4717,4622,51,95,"AxSÍ",4
29,"29009",1435,971,957,17,14,"AxSÍ",0
11,"11007",18032,9872,9745,213,127,"AxSÍ",388
41,"41097",3131,2197,2140,13,57,"AxSÍ",0
4,"4005",534,422,419,3,3,"AxSÍ",1
29,"29034",461,333,332,2,1,"AxSÍ",1
18,"18128",332,263,260,1,3,"AxSÍ",0
18,"18185",545,434,424,5,10,"AxSÍ",1
4,"4001",1002,717,710,3,7,"AxSÍ",0
23,"23076",774,606,595,6,11,"AxSÍ",0
4,"4057",1261,886,872,6,14,"AxSÍ",2
23,"23088",6017,4529,4427,61,102,"AxSÍ",9
29,"29039",2759,1900,1860,23,40,"AxSÍ",5
4,"4067",504,340,330,4,10,"AxSÍ",1
14,"14074",2225,1775,1743,17,32,"AxSÍ",2
18,"18069",484,356,356,5,0,"AxSÍ",0
21,"21013",10626,6990,6807,99,183,"AxSÍ",10
4,"4054",363,279,278,2,1,"AxSÍ",2
23,"23021",512,406,399,2,7,"AxSÍ",0
18,"18162",919,664,652,3,12,"AxSÍ",1
18,"18168",783,566,561,11,5,"AxSÍ",0
4,"4017",1276,833,818,4,15,"AxSÍ",0
18,"18077",471,350,343,1,7,"AxSÍ",0
4,"4064",2878,1937,1924,16,13,"AxSÍ",1
18,"18153",8834,6174,6063,54,111,"AxSÍ",6
23,"23026",3431,2430,2375,25,55,"AxSÍ",1
41,"41023",7999,5500,5435,60,65,"AxSÍ",14
23,"23041",489,378,376,1,2,"AxSÍ",13
41,"41011",15462,11019,10696,183,323,"AxSÍ",31
14,"14040",3749,2905,2845,53,60,"AxSÍ",0
11,"11028",32829,21934,21654,310,280,"AxSÍ",220
4,"4024",3241,2315,2290,34,25,"AxSÍ",6
41,"41090",3489,2560,2467,27,93,"AxSÍ",6
29,"29033",1084,733,722,5,11,"AxSÍ",1
41,"41046",3005,2241,2198,11,43,"AxSÍ",9
29,"29059",2662,1950,1895,16,55,"AxSÍ",3
23,"23065",1530,1068,1054,7,14,"AxSÍ",1
18,"18908",776,553,528,3,25,"AxSÍ",0
21,"21040",3193,2219,2123,32,96,"AxSÍ",8
18,"18012",2114,1519,1492,9,27,"AxSÍ",2
41,"41077",8631,5788,5598,51,190,"AxSÍ",9
18,"18140",42474,26967,26648,225,319,"AxSÍ",179
29,"29079",2326,1609,1582,12,27,"AxSÍ",1
18,"18082",810,503,500,3,3,"AxSÍ",0
18,"18106",413,270,261,3,9,"AxSÍ",0
18,"18181",194,134,133,0,1,"AxSÍ",0
41,"41094",6496,4733,4628,47,105,"AxSÍ",13
11,"11001",4360,2810,2744,32,66,"AxSÍ",13
41,"41039",31538,22078,21717,278,361,"AxSÍ",301
23,"23075",3222,2513,2475,19,38,"AxSÍ",5
18,"18193",14934,10301,10127,116,174,"AxSÍ",10
14,"14046",4442,3283,3190,34,93,"AxSÍ",5
4,"4097",231,173,173,1,0,"AxSÍ",0
21,"21049",3262,2028,1977,15,51,"AxSÍ",4
29,"29002",1143,777,766,6,11,"AxSÍ",2
27,"27017",952,568,562,3,6,"BNG",31
15,"15053",7469,4622,4579,44,43,"BNG",581
36,"36007",1610,1047,1016,5,31,"BNG",52
15,"15032",3430,2243,2197,12,46,"BNG",188
36,"36040",2505,1597,1563,15,34,"BNG",125
27,"27066",12588,8116,7954,109,162,"BNG",676
27,"27007",2723,1822,1776,23,46,"BNG",87
32,"32034",1062,763,753,6,10,"BNG",78
15,"15042",2928,1879,1853,11,26,"BNG",144
36,"36060",30431,19909,19673,206,236,"BNG",1386
15,"15084",3039,2002,1981,12,21,"BNG",151
36,"36039",15609,10562,10341,102,221,"BNG",686
15,"15033",2421,1673,1655,6,18,"BNG",233
36,"36032",3527,2407,2369,24,38,"BNG",210
36,"36020",2172,1435,1418,19,17,"BNG",99
32,"32083",805,498,494,3,4,"BNG",26
27,"27052",860,564,558,7,6,"BNG",17
36,"36053",5783,3955,3899,39,56,"BNG",669
36,"36029",16126,10936,10771,96,165,"BNG",1297
32,"32010",364,271,267,2,4,"BNG",11
27,"27004",1143,640,625,2,15,"BNG",23
32,"32026",2655,1762,1731,17,31,"BNG",66
32,"32014",1028,719,708,6,11,"BNG",43
27,"27034",1010,565,558,3,7,"BNG",36
32,"32073",1273,863,857,6,6,"BNG",29
15,"15901",3334,1948,1928,27,20,"BNG",176
15,"15014",3836,2191,2158,27,33,"BNG",213
36,"36003",10023,6877,6789,66,88,"BNG",407
36,"36042",18125,11975,11775,126,200,"BNG",987
27,"27003",1743,1161,1134,18,27,"BNG",52
27,"27055",1191,773,764,7,9,"BNG",36
32,"32050",2254,1630,1612,15,18,"BNG",81
27,"27002",1535,990,968,13,22,"BNG",56
27,"27030",3117,1945,1898,19,47,"BNG",174
15,"15018",1087,680,670,13,10,"BNG",80
27,"27015",3995,2518,2460,25,58,"BNG",150
32,"32006",1418,986,970,14,16,"BNG",26
32,"32071",1351,821,814,6,7,"BNG",34
32,"32046",1089,679,670,4,9,"BNG",32
15,"15011",15501,9988,9846,78,142,"BNG",990
27,"27027",1791,1198,1167,17,31,"BNG",101
15,"15077",8103,4893,4818,61,75,"BNG",326
36,"36902",5028,3453,3396,19,57,"BNG",196
27,"27048",1992,1317,1285,21,32,"BNG",73
32,"32001",5100,3377,3333,32,44,"BNG",1042
36,"36026",19890,13041,12891,169,150,"BNG",723
15,"15074",3902,2629,2589,23,40,"BNG",218
32,"32058",5247,3547,3489,30,58,"BNG",143
27,"27061",1018,704,683,12,21,"BNG",44
36,"36025",2127,1235,1221,5,14,"BNG",62
15,"15040",2647,1779,1762,15,17,"BNG",141
27,"27011",2341,1387,1362,7,25,"BNG",89
32,"32002",2028,1349,1340,4,9,"BNG",46
27,"27014",3144,2009,1985,24,24,"BNG",157
15,"15004",4924,3333,3292,38,41,"BNG",320
27,"27059",2035,1356,1322,7,34,"BNG",69
15,"15028",1392,944,936,4,8,"BNG",166
15,"15005",25347,15441,15211,226,230,"BNG",1160
15,"15092",6220,3810,3756,30,54,"BNG",278
32,"32012",708,448,440,2,8,"BNG",22
15,"15023",6277,4021,3968,34,53,"BNG",387
36,"36031",563,426,420,7,6,"BNG",56
32,"32054",86117,56997,56376,581,621,"BNG",3414
32,"32009",10558,6621,6549,50,72,"BNG",227
15,"15067",7933,5329,5282,43,47,"BNG",510
32,"32038",387,253,251,4,2,"BNG",5
15,"15017",19866,13497,13344,195,153,"BNG",1046
15,"15029",5354,3082,3050,46,32,"BNG",269
36,"36010",2825,1983,1947,19,36,"BNG",262
36,"36056",4932,3368,3310,24,58,"BNG",217
15,"15013",6324,4132,4083,35,49,"BNG",406
15,"15059",10229,6900,6734,85,166,"BNG",777
27,"27058",3283,2275,2241,12,34,"BNG",101
15,"15066",3995,2746,2695,29,51,"BNG",207
15,"15090",1115,711,701,19,10,"BNG",105
27,"27023",2453,1674,1644,25,30,"BNG",56
32,"32052",1817,1278,1268,12,10,"BNG",40
27,"27033",591,334,328,0,6,"BNG",37
32,"32011",916,512,507,3,5,"BNG",9
32,"32005",810,576,568,9,8,"BNG",17
32,"32062",784,557,550,1,7,"BNG",26
32,"32063",1795,1135,1119,16,16,"BNG",44
15,"15091",1097,705,686,17,19,"BNG",39
36,"36043",4696,3038,3003,21,35,"BNG",306
15,"15064",2103,1458,1447,20,11,"BNG",104
32,"32091",1695,1163,1156,2,7,"BNG",54
32,"32076",1935,1320,1306,15,14,"BNG",70
15,"15012",3603,2484,2422,20,62,"BNG",153
15,"15021",5254,3473,3422,58,51,"BNG",303
15,"15052",4070,2512,2488,18,24,"BNG",178
36,"36046",4073,2887,2818,31,69,"BNG",159
36,"36035",14615,10011,9880,103,131,"BNG",463
32,"32029",441,286,283,2,3,"BNG",3
36,"36023",8258,5504,5384,44,120,"BNG",562
32,"32067",1189,696,692,4,4,"BNG",54
27,"27056",1218,787,778,6,9,"BNG",40
15,"15082",15446,10821,10687,130,134,"BNG",1229
27,"27064",1505,972,951,9,21,"BNG",38
32,"32049",683,375,372,3,3,"BNG",18
32,"32024",4817,3064,3014,34,50,"BNG",195
27,"27040",3008,2071,2046,21,25,"BNG",82
15,"15076",2490,1539,1517,25,22,"BNG",319
27,"27045",926,588,583,6,5,"BNG",14
15,"15069",6604,4587,4520,55,67,"BNG",569
32,"32082",1164,736,728,11,8,"BNG",45
27,"27046",1444,945,921,7,24,"BNG",81
27,"27051",7986,5324,5241,58,83,"BNG",447
15,"15056",5615,3697,3646,31,51,"BNG",289
32,"32078",1099,715,707,4,8,"BNG",28
32,"32022",1238,840,835,10,5,"BNG",93
27,"27062",583,403,400,2,3,"BNG",11
32,"32037",679,454,446,6,8,"BNG",15
32,"32030",945,642,641,8,1,"BNG",18
15,"15070",8778,5802,5656,131,146,"BNG",948
27,"27016",6958,4697,4616,50,81,"BNG",321
32,"32013",1985,1242,1230,16,12,"BNG",44
15,"15038",2126,1312,1296,12,16,"BNG",133
32,"32035",1352,782,768,6,14,"BNG",27
27,"27044",2703,1495,1463,15,32,"BNG",167
15,"15016",4558,2747,2705,16,42,"BNG",187
36,"36013",2216,1298,1290,18,8,"BNG",75
32,"32075",4362,3117,3077,30,40,"BNG",109
32,"32055",1216,781,764,10,17,"BNG",29
36,"36008",21845,14553,14373,138,180,"BNG",1476
36,"36057",238417,165843,164264,1641,1579,"BNG",9983
27,"27039",4467,3179,3121,47,58,"BNG",238
36,"36050",7645,5137,5049,48,88,"BNG",435
36,"36033",12305,8759,8597,67,162,"BNG",574
32,"32031",997,684,680,5,4,"BNG",22
32,"32065",633,422,419,8,3,"BNG",14
32,"32036",1242,856,838,14,18,"BNG",59
27,"27013",3690,2811,2766,30,45,"BNG",277
32,"32060",753,520,515,5,5,"BNG",26
32,"32070",495,247,238,4,9,"BNG",7
15,"15048",5087,3426,3383,40,43,"BNG",229
27,"27065",12055,7566,7379,119,187,"BNG",462
36,"36009",4401,2712,2649,33,63,"BNG",83
32,"32045",2346,1604,1579,20,25,"BNG",49
32,"32081",2057,1466,1445,17,21,"BNG",41
32,"32007",1413,873,862,2,11,"BNG",148
32,"32061",1078,777,770,5,7,"BNG",31
36,"36055",13585,9177,8986,115,191,"BNG",746
36,"36052",7266,4772,4685,43,87,"BNG",387
32,"32025",1014,731,718,5,13,"BNG",32
15,"15075",12871,8751,8637,129,114,"BNG",698
36,"36002",3049,1994,1968,22,26,"BNG",245
27,"27025",2731,2047,2006,18,41,"BNG",211
15,"15081",976,713,695,4,18,"BNG",44
27,"27041",2216,1463,1445,19,18,"BNG",100
15,"15080",1637,1009,992,11,17,"BNG",66
36,"36049",6990,4877,4787,40,90,"BNG",372
32,"32042",1487,1010,1001,12,9,"BNG",25
32,"32086",2531,1348,1332,11,16,"BNG",154
15,"15001",4697,3069,3022,45,47,"BNG",226
27,"27038",923,624,619,8,5,"BNG",17
36,"36001",2397,1674,1651,6,23,"BNG",83
36,"36041",13691,9022,8916,85,106,"BNG",579
15,"15020",3568,2226,2217,19,9,"BNG",291
15,"15055",4446,2829,2762,50,67,"BNG",264
32,"32008",8647,5570,5495,56,75,"BNG",357
27,"27006",2441,1479,1460,11,19,"BNG",72
15,"15049",1068,752,747,7,5,"BNG",191
15,"15050",1732,931,917,15,14,"BNG",91
32,"32059",1686,1099,1082,20,17,"BNG",36
15,"15902",4507,2885,2837,34,48,"BNG",188
36,"36047",2248,1379,1363,11,16,"BNG",100
27,"27024",1447,1048,1032,6,16,"BNG",50
15,"15036",56053,36487,36175,501,312,"BNG",2443
32,"32085",10584,6687,6611,58,76,"BNG",549
36,"36021",12180,8188,8058,115,130,"BNG",463
15,"15003",1675,1029,1020,9,9,"BNG",72
27,"27001",2187,1111,1102,17,9,"BNG",59
15,"15034",2712,1605,1585,15,20,"BNG",101
27,"27050",2821,1980,1954,11,26,"BNG",79
15,"15031",23868,16113,15954,207,159,"BNG",1273
32,"32090",734,448,441,2,7,"BNG",77
32,"32057",505,334,328,3,6,"BNG",8
15,"15061",5149,3221,3168,44,53,"BNG",297
15,"15010",1805,1047,1031,19,16,"BNG",108
27,"27901",2249,1373,1360,22,13,"BNG",56
32,"32092",491,280,275,0,5,"BNG",37
15,"15024",4314,2859,2790,44,69,"BNG",245
36,"36022",9046,5834,5720,37,114,"BNG",509
36,"36005",8105,5258,5152,54,106,"BNG",388
27,"27029",1425,925,910,11,15,"BNG",81
36,"36015",4079,2653,2606,29,47,"BNG",193
15,"15085",3176,2073,2047,29,26,"BNG",200
15,"15044",1194,806,788,7,18,"BNG",50
36,"36006",11502,8057,7927,53,130,"BNG",773
32,"32041",752,462,458,4,4,"BNG",11
15,"15093",4012,2413,2386,24,27,"BNG",311
36,"36018",3033,1951,1926,9,25,"BNG",130
32,"32066",547,396,396,0,0,"BNG",5
27,"27902",7122,4472,4385,43,87,"BNG",461
32,"32018",1181,883,871,5,12,"BNG",20
27,"27049",1324,847,829,8,18,"BNG",45
32,"32077",1104,703,700,9,3,"BNG",44
15,"15045",3610,2057,2044,15,13,"BNG",241
15,"15088",3396,2047,2022,22,25,"BNG",117
15,"15079",1437,887,868,8,19,"BNG",77
27,"27012",1264,658,650,6,8,"BNG",24
32,"32033",667,439,436,4,3,"BNG",7
15,"15086",2760,1829,1810,26,19,"BNG",109
32,"32044",794,547,540,2,7,"BNG",30
36,"36016",1069,639,633,5,6,"BNG",48
36,"36036",2546,1763,1742,14,21,"BNG",109
27,"27020",3365,2544,2500,42,44,"BNG",99
27,"27057",11047,7078,6941,64,137,"BNG",491
32,"32056",1490,1009,1003,10,6,"BNG",6
27,"27026",2299,1385,1368,9,17,"BNG",80
32,"32039",1154,801,790,11,11,"BNG",44
32,"32088",1636,955,944,17,11,"BNG",25
15,"15022",5580,3508,3472,47,36,"BNG",554
32,"32072",3664,2387,2355,24,32,"BNG",120
27,"27035",183,110,110,3,0,"BNG",9
15,"15062",5597,3406,3360,16,46,"BNG",409
36,"36059",4641,2844,2796,29,48,"BNG",313
32,"32069",4223,3064,3023,31,41,"BNG",205
15,"15019",25981,15866,15672,207,194,"BNG",2229
15,"15009",10605,7245,7133,101,112,"BNG",631
32,"32074",977,642,631,2,11,"BNG",33
15,"15087",5710,3436,3392,31,44,"BNG",298
15,"15008",5646,3859,3836,52,23,"BNG",285
15,"15039",1224,802,785,9,17,"BNG",55
32,"32087",1669,1158,1136,14,22,"BNG",37
27,"27008",1326,865,853,5,12,"BNG",49
32,"32028",1537,1012,1004,5,8,"BNG",29
32,"32053",1362,1001,989,10,12,"BNG",52
32,"32084",878,532,527,8,5,"BNG",44
32,"32003",863,632,619,3,13,"BNG",24
36,"36045",24459,16966,16735,124,231,"BNG",1220
27,"27009",2005,1324,1303,11,21,"BNG",62
32,"32020",2428,1728,1714,10,14,"BNG",107
27,"27021",1632,962,935,23,27,"BNG",75
36,"36004",10109,6611,6502,79,109,"BNG",597
36,"36024",16335,11431,11256,99,175,"BNG",1036
36,"36048",5248,3429,3378,25,51,"BNG",426
36,"36017",17364,11771,11598,123,173,"BNG",1111
15,"15065",7134,4869,4785,53,84,"BNG",420
15,"15046",6157,3965,3865,23,100,"BNG",428
27,"27047",1517,955,940,12,15,"BNG",125
32,"32089",1206,740,726,8,14,"BNG",88
27,"27037",1001,714,707,11,7,"BNG",14
15,"15037",4026,2375,2349,10,26,"BNG",224
15,"15071",7780,4937,4848,34,89,"BNG",560
27,"27042",1639,1120,1107,8,13,"BNG",24
27,"27060",2434,1458,1434,17,24,"BNG",105
15,"15006",5159,3008,2960,44,48,"BNG",380
32,"32079",1280,880,869,13,11,"BNG",25
15,"15041",9569,6362,6269,104,93,"BNG",502
15,"15030",199701,137611,136590,1540,1021,"BNG",11352
32,"32040",1400,1001,990,10,11,"BNG",42
36,"36054",11107,7027,6894,57,133,"BNG",732
15,"15058",28761,20250,20098,261,152,"BNG",1430
15,"15054",31805,19579,19321,335,258,"BNG",1563
36,"36051",14358,9408,9255,86,153,"BNG",588
15,"15007",3164,2081,2060,24,21,"BNG",162
32,"32048",846,460,458,1,2,"BNG",68
32,"32023",1130,787,782,2,5,"BNG",23
32,"32017",1193,735,724,3,11,"BNG",10
32,"32043",2497,1607,1582,14,25,"BNG",110
27,"27022",4654,2760,2696,20,64,"BNG",216
36,"36037",2538,1650,1625,12,25,"BNG",133
32,"32080",284,209,209,1,0,"BNG",13
15,"15025",986,529,517,6,12,"BNG",47
32,"32051",1369,1062,1058,13,4,"BNG",32
27,"27028",78725,52642,51965,642,677,"BNG",4083
32,"32004",1608,835,824,5,11,"BNG",7
27,"27019",8188,5478,5395,88,83,"BNG",499
36,"36014",1867,1265,1243,16,22,"BNG",49
32,"32032",7900,5186,5091,48,95,"BNG",405
36,"36019",1462,916,908,8,8,"BNG",51
27,"27010",4378,2719,2670,49,49,"BNG",194
15,"15051",4545,2978,2945,47,33,"BNG",267
15,"15072",9434,6304,6228,48,76,"BNG",1006
36,"36044",2527,1535,1499,12,36,"BNG",121
15,"15068",4824,2976,2937,54,39,"BNG",330
27,"27063",1699,1131,1109,7,22,"BNG",105
36,"36058",4957,3043,2994,55,49,"BNG",290
15,"15089",4299,2924,2887,41,37,"BNG",265
36,"36061",8613,5822,5718,56,104,"BNG",324
15,"15002",24040,16302,16117,183,185,"BNG",1797
32,"32021",872,555,550,6,5,"BNG",39
15,"15015",2877,1845,1821,26,24,"BNG",193
15,"15078",78810,55693,55183,569,510,"BNG",7062
27,"27053",497,342,334,2,8,"BNG",15
15,"15083",1029,627,614,5,13,"BNG",52
27,"27054",1135,807,782,5,25,"BNG",60
32,"32027",989,670,660,5,10,"BNG",20
36,"36901",4154,3094,3029,21,65,"BNG",313
15,"15047",2256,1429,1405,25,24,"BNG",119
27,"27005",2560,1691,1662,19,29,"BNG",259
32,"32015",817,454,452,2,2,"BNG",12
32,"32068",1401,882,878,4,4,"BNG",46
15,"15027",1563,1159,1140,23,19,"BNG",65
36,"36034",3299,2155,2132,15,23,"BNG",178
15,"15073",21725,13008,12820,126,188,"BNG",1072
36,"36027",4401,2940,2781,20,159,"BNG",179
36,"36038",66807,46235,45781,493,454,"BNG",4065
15,"15043",4944,3184,3117,27,67,"BNG",362
15,"15060",5871,4044,3978,58,66,"BNG",411
32,"32019",11469,7336,7225,98,111,"BNG",349
27,"27043",1222,746,737,12,9,"BNG",38
27,"27031",15107,9759,9593,87,166,"BNG",498
32,"32047",1761,1192,1175,10,17,"BNG",61
27,"27018",3211,1830,1800,17,30,"BNG",125
32,"32016",714,494,493,12,1,"BNG",7
15,"15035",11189,7256,7165,104,91,"BNG",959
15,"15057",12077,8109,8018,83,91,"BNG",821
36,"36028",4049,2783,2739,22,44,"BNG",189
32,"32064",453,304,302,0,2,"BNG",8
27,"27032",3197,1979,1956,30,23,"BNG",130
36,"36030",3921,2516,2484,31,32,"BNG",246
27,"27009",2005,1324,1303,11,21,"C 21",0
27,"27062",583,403,400,2,3,"C 21",0
27,"27058",3283,2275,2241,12,34,"C 21",1
27,"27027",1791,1198,1167,17,31,"C 21",0
27,"27013",3690,2811,2766,30,45,"C 21",2
27,"27055",1191,773,764,7,9,"C 21",10
27,"27014",3144,2009,1985,24,24,"C 21",2
27,"27057",11047,7078,6941,64,137,"C 21",4
27,"27020",3365,2544,2500,42,44,"C 21",0
27,"27017",952,568,562,3,6,"C 21",0
27,"27037",1001,714,707,11,7,"C 21",1
27,"27039",4467,3179,3121,47,58,"C 21",0
27,"27007",2723,1822,1776,23,46,"C 21",0
27,"27052",860,564,558,7,6,"C 21",0
27,"27005",2560,1691,1662,19,29,"C 21",0
27,"27010",4378,2719,2670,49,49,"C 21",1
27,"27065",12055,7566,7379,119,187,"C 21",4
27,"27042",1639,1120,1107,8,13,"C 21",0
27,"27046",1444,945,921,7,24,"C 21",0
27,"27022",4654,2760,2696,20,64,"C 21",0
27,"27008",1326,865,853,5,12,"C 21",0
27,"27051",7986,5324,5241,58,83,"C 21",0
27,"27901",2249,1373,1360,22,13,"C 21",0
27,"27045",926,588,583,6,5,"C 21",0
27,"27028",78725,52642,51965,642,677,"C 21",22
27,"27063",1699,1131,1109,7,22,"C 21",0
27,"27050",2821,1980,1954,11,26,"C 21",0
27,"27015",3995,2518,2460,25,58,"C 21",0
27,"27006",2441,1479,1460,11,19,"C 21",1
27,"27048",1992,1317,1285,21,32,"C 21",0
27,"27902",7122,4472,4385,43,87,"C 21",1
27,"27016",6958,4697,4616,50,81,"C 21",1
27,"27011",2341,1387,1362,7,25,"C 21",0
27,"27026",2299,1385,1368,9,17,"C 21",0
27,"27033",591,334,328,0,6,"C 21",0
27,"27044",2703,1495,1463,15,32,"C 21",0
27,"27001",2187,1111,1102,17,9,"C 21",0
27,"27023",2453,1674,1644,25,30,"C 21",0
27,"27031",15107,9759,9593,87,166,"C 21",6
27,"27018",3211,1830,1800,17,30,"C 21",1
27,"27021",1632,962,935,23,27,"C 21",0
27,"27061",1018,704,683,12,21,"C 21",0
27,"27025",2731,2047,2006,18,41,"C 21",1
27,"27049",1324,847,829,8,18,"C 21",0
27,"27004",1143,640,625,2,15,"C 21",0
27,"27035",183,110,110,3,0,"C 21",0
27,"27019",8188,5478,5395,88,83,"C 21",1
27,"27038",923,624,619,8,5,"C 21",0
27,"27002",1535,990,968,13,22,"C 21",0
27,"27064",1505,972,951,9,21,"C 21",1
27,"27054",1135,807,782,5,25,"C 21",0
27,"27029",1425,925,910,11,15,"C 21",0
27,"27056",1218,787,778,6,9,"C 21",0
27,"27032",3197,1979,1956,30,23,"C 21",1
27,"27030",3117,1945,1898,19,47,"C 21",1
27,"27041",2216,1463,1445,19,18,"C 21",0
27,"27043",1222,746,737,12,9,"C 21",0
27,"27047",1517,955,940,12,15,"C 21",0
27,"27059",2035,1356,1322,7,34,"C 21",1
27,"27012",1264,658,650,6,8,"C 21",0
27,"27060",2434,1458,1434,17,24,"C 21",0
27,"27024",1447,1048,1032,6,16,"C 21",0
27,"27003",1743,1161,1134,18,27,"C 21",0
27,"27053",497,342,334,2,8,"C 21",0
27,"27066",12588,8116,7954,109,162,"C 21",1
27,"27040",3008,2071,2046,21,25,"C 21",0
27,"27034",1010,565,558,3,7,"C 21",0
18,"18914",1660,1255,1227,11,28,"CAnda",1
18,"18049",588,418,415,4,3,"CAnda",0
18,"18126",1436,1024,1002,9,22,"CAnda",1
18,"18094",2299,1712,1652,20,60,"CAnda",0
18,"18170",317,212,209,0,3,"CAnda",0
18,"18189",785,598,592,9,6,"CAnda",0
18,"18158",7978,4861,4771,43,90,"CAnda",0
18,"18070",287,216,216,3,0,"CAnda",0
18,"18039",3343,2293,2252,22,41,"CAnda",0
18,"18115",2635,1766,1738,13,28,"CAnda",1
18,"18083",232,181,179,1,2,"CAnda",0
18,"18103",714,500,498,3,2,"CAnda",0
18,"18903",852,544,537,9,7,"CAnda",0
18,"18020",489,318,310,2,8,"CAnda",0
18,"18144",816,592,582,3,10,"CAnda",0
18,"18033",279,179,174,0,5,"CAnda",0
18,"18093",2751,1693,1674,18,19,"CAnda",1
18,"18137",968,733,731,3,2,"CAnda",0
18,"18124",355,232,231,1,1,"CAnda",0
18,"18106",413,270,261,3,9,"CAnda",0
18,"18146",930,645,629,10,16,"CAnda",0
18,"18134",6104,4049,3972,39,77,"CAnda",4
18,"18915",726,474,467,4,7,"CAnda",0
18,"18909",514,403,403,0,0,"CAnda",0
18,"18182",1926,1222,1204,8,18,"CAnda",0
18,"18012",2114,1519,1492,9,27,"CAnda",1
18,"18029",1812,1104,1065,7,39,"CAnda",0
18,"18007",730,490,478,3,12,"CAnda",0
18,"18045",1065,720,690,11,30,"CAnda",1
18,"18072",655,452,445,4,7,"CAnda",0
18,"18180",636,410,401,2,9,"CAnda",0
18,"18018",542,384,377,2,7,"CAnda",0
18,"18054",820,573,569,2,4,"CAnda",0
18,"18185",545,434,424,5,10,"CAnda",0
18,"18150",6964,4717,4622,51,95,"CAnda",1
18,"18063",1232,687,678,9,9,"CAnda",0
18,"18127",17005,11790,11583,150,207,"CAnda",7
18,"18906",903,641,639,2,2,"CAnda",0
18,"18123",284,202,200,5,2,"CAnda",0
18,"18028",898,723,718,3,5,"CAnda",0
18,"18193",14934,10301,10127,116,174,"CAnda",5
18,"18022",13875,8948,8764,98,184,"CAnda",2
18,"18001",222,147,146,0,1,"CAnda",0
18,"18044",161,91,91,0,0,"CAnda",0
18,"18004",669,467,466,6,1,"CAnda",0
18,"18168",783,566,561,11,5,"CAnda",0
18,"18102",8233,5424,5266,46,158,"CAnda",1
18,"18051",1092,735,718,8,17,"CAnda",0
18,"18117",497,360,354,1,6,"CAnda",0
18,"18194",2038,1373,1348,12,25,"CAnda",0
18,"18173",8999,5958,5871,50,87,"CAnda",4
18,"18096",340,227,226,0,1,"CAnda",0
18,"18188",1646,1224,1202,10,22,"CAnda",0
18,"18183",623,380,376,0,4,"CAnda",0
18,"18157",1148,843,827,7,16,"CAnda",0
18,"18043",129,74,71,0,3,"CAnda",0
18,"18078",714,546,538,5,8,"CAnda",0
18,"18024",837,651,639,11,12,"CAnda",0
18,"18122",15994,11009,10773,109,236,"CAnda",2
18,"18911",7933,5464,5348,53,116,"CAnda",5
18,"18036",3986,2956,2917,22,39,"CAnda",0
18,"18161",245,199,196,0,3,"CAnda",0
18,"18047",6103,3992,3922,61,70,"CAnda",1
18,"18061",999,781,770,5,11,"CAnda",0
18,"18167",1839,1243,1224,9,19,"CAnda",0
18,"18025",277,198,197,0,1,"CAnda",0
18,"18053",1554,1001,985,9,16,"CAnda",0
18,"18097",947,633,631,0,2,"CAnda",0
18,"18904",741,500,498,1,2,"CAnda",0
18,"18177",375,235,231,5,4,"CAnda",0
18,"18913",771,530,514,2,16,"CAnda",0
18,"18112",104,68,66,2,2,"CAnda",0
18,"18034",484,345,342,3,3,"CAnda",0
18,"18042",417,332,330,4,2,"CAnda",0
18,"18030",566,382,380,2,2,"CAnda",0
18,"18109",597,430,422,5,8,"CAnda",2
18,"18079",3466,2391,2333,22,58,"CAnda",0
18,"18140",42474,26967,26648,225,319,"CAnda",22
18,"18084",4533,3233,3178,35,55,"CAnda",0
18,"18901",489,323,322,5,1,"CAnda",0
18,"18095",2054,1475,1433,14,42,"CAnda",0
18,"18003",14454,10162,9935,105,227,"CAnda",7
18,"18071",5636,3909,3807,45,102,"CAnda",2
18,"18016",297,200,198,3,2,"CAnda",0
18,"18002",529,387,384,1,3,"CAnda",0
18,"18133",2101,1496,1477,6,19,"CAnda",0
18,"18087",182877,131811,130184,1106,1627,"CAnda",73
18,"18121",119,79,79,1,0,"CAnda",0
18,"18912",1352,926,912,7,14,"CAnda",0
18,"18050",1649,1113,1095,5,18,"CAnda",0
18,"18187",510,350,350,2,0,"CAnda",0
18,"18010",527,398,394,5,4,"CAnda",1
18,"18179",493,315,309,8,6,"CAnda",0
18,"18101",9449,6688,6568,77,120,"CAnda",2
18,"18017",18201,11500,11358,94,142,"CAnda",339
18,"18038",1042,782,760,5,22,"CAnda",0
18,"18062",11226,7969,7777,88,192,"CAnda",2
18,"18141",382,240,237,0,3,"CAnda",0
18,"18192",1462,1125,1103,3,22,"CAnda",0
18,"18176",242,164,161,2,3,"CAnda",0
18,"18082",810,503,500,3,3,"CAnda",0
18,"18085",690,440,432,1,8,"CAnda",0
18,"18056",3382,2397,2350,30,47,"CAnda",0
18,"18149",5408,3926,3859,42,67,"CAnda",1
18,"18159",989,765,762,2,3,"CAnda",0
18,"18059",4265,2960,2886,23,74,"CAnda",1
18,"18184",2193,1542,1511,16,31,"CAnda",1
18,"18032",247,164,163,1,1,"CAnda",0
18,"18006",4062,2765,2711,25,54,"CAnda",0
18,"18014",6938,4864,4742,64,122,"CAnda",0
18,"18015",424,331,330,4,1,"CAnda",0
18,"18074",265,205,205,0,0,"CAnda",0
18,"18163",311,206,204,0,2,"CAnda",0
18,"18902",752,589,568,3,21,"CAnda",0
18,"18120",266,204,204,4,0,"CAnda",0
18,"18145",10909,7925,7780,67,145,"CAnda",1
18,"18069",484,356,356,5,0,"CAnda",0
18,"18164",1790,1135,1108,11,27,"CAnda",0
18,"18077",471,350,343,1,7,"CAnda",0
18,"18100",7997,5523,5367,66,156,"CAnda",1
18,"18152",928,663,660,3,3,"CAnda",0
18,"18108",822,604,599,2,5,"CAnda",0
18,"18048",2494,1708,1657,18,51,"CAnda",0
18,"18174",435,324,320,3,4,"CAnda",0
18,"18089",14504,9854,9746,100,108,"CAnda",0
18,"18148",787,618,605,5,13,"CAnda",1
18,"18066",2095,1401,1378,12,23,"CAnda",0
18,"18908",776,553,528,3,25,"CAnda",0
18,"18035",1179,882,870,7,12,"CAnda",0
18,"18116",2856,2027,1979,13,48,"CAnda",0
18,"18128",332,263,260,1,3,"CAnda",0
18,"18013",4154,2892,2812,28,80,"CAnda",0
18,"18175",11793,8099,7943,62,156,"CAnda",1
18,"18068",1638,1197,1167,12,30,"CAnda",0
18,"18151",261,167,166,4,1,"CAnda",0
18,"18023",15717,10964,10751,132,213,"CAnda",6
18,"18910",710,439,434,1,5,"CAnda",0
18,"18153",8834,6174,6063,54,111,"CAnda",1
18,"18088",1526,1000,993,10,7,"CAnda",0
18,"18065",588,464,451,2,13,"CAnda",0
18,"18076",789,534,532,2,2,"CAnda",0
18,"18105",3827,2436,2392,22,44,"CAnda",0
18,"18907",1762,1358,1351,4,7,"CAnda",0
18,"18111",2863,2038,2001,29,37,"CAnda",0
18,"18905",15688,10406,10200,122,206,"CAnda",1
18,"18136",1778,1320,1284,14,36,"CAnda",0
18,"18143",945,661,651,2,10,"CAnda",0
18,"18067",682,442,437,2,5,"CAnda",0
18,"18162",919,664,652,3,12,"CAnda",0
18,"18107",920,643,626,1,17,"CAnda",0
18,"18021",17929,12165,11949,139,216,"CAnda",3
18,"18011",4403,3002,2947,24,55,"CAnda",3
18,"18147",3655,2273,2241,16,32,"CAnda",2
18,"18171",2098,1521,1460,11,61,"CAnda",0
18,"18086",338,253,247,1,6,"CAnda",0
18,"18064",366,289,286,0,3,"CAnda",0
18,"18057",5584,4042,3958,51,84,"CAnda",1
18,"18132",3101,2418,2382,23,36,"CAnda",0
18,"18181",194,134,133,0,1,"CAnda",0
18,"18027",2598,1730,1706,12,24,"CAnda",0
18,"18099",1582,1184,1156,13,28,"CAnda",0
18,"18178",664,474,467,1,7,"CAnda",0
18,"18916",1815,1093,1086,6,7,"CAnda",0
18,"18114",585,425,424,7,1,"CAnda",0
18,"18046",1738,1042,1023,7,19,"CAnda",0
18,"18119",1708,1264,1240,7,24,"CAnda",0
18,"18098",5959,3816,3749,33,67,"CAnda",1
18,"18037",535,417,410,2,7,"CAnda",0
18,"18135",4385,2882,2798,24,84,"CAnda",1
18,"18040",237,146,145,0,1,"CAnda",0
18,"18154",982,668,668,4,0,"CAnda",0
18,"18165",4265,2870,2820,22,50,"CAnda",0
18,"18138",2470,1597,1573,25,24,"CAnda",1
18,"18005",363,232,230,3,2,"CAnda",0
38,"38043",19365,12355,12212,126,143,"CCa-PNC-NC",2118
38,"38036",6857,4170,4090,37,80,"CCa-PNC-NC",564
38,"38027",5581,3577,3533,22,44,"CCa-PNC-NC",1032
38,"38041",7025,4729,4684,42,45,"CCa-PNC-NC",1378
38,"38046",9267,6652,6594,55,58,"CCa-PNC-NC",1090
38,"38023",126137,79423,78706,605,717,"CCa-PNC-NC",11948
38,"38018",4466,2867,2821,21,46,"CCa-PNC-NC",607
38,"38012",2286,1520,1510,8,10,"CCa-PNC-NC",247
38,"38029",1475,752,744,10,8,"CCa-PNC-NC",80
38,"38017",30964,16228,16102,108,126,"CCa-PNC-NC",2360
38,"38010",3969,2463,2418,11,45,"CCa-PNC-NC",233
38,"38034",3997,2687,2648,19,39,"CCa-PNC-NC",549
38,"38032",13579,8941,8880,92,61,"CCa-PNC-NC",1108
38,"38004",4536,2914,2887,28,27,"CCa-PNC-NC",437
38,"38030",1962,1332,1318,9,14,"CCa-PNC-NC",361
38,"38038",165135,101564,100807,709,757,"CCa-PNC-NC",14611
38,"38050",2417,1288,1273,9,15,"CCa-PNC-NC",173
38,"38052",1283,806,794,3,12,"CCa-PNC-NC",138
38,"38039",11149,7375,7326,68,49,"CCa-PNC-NC",1461
38,"38002",971,577,570,8,7,"CCa-PNC-NC",81
38,"38021",1609,900,876,2,24,"CCa-PNC-NC",168
38,"38006",41593,20823,20624,127,199,"CCa-PNC-NC",2153
38,"38005",5646,3302,3283,24,19,"CCa-PNC-NC",708
38,"38001",21069,10844,10777,63,67,"CCa-PNC-NC",1078
38,"38019",13884,7888,7809,49,79,"CCa-PNC-NC",1176
38,"38044",2215,1270,1257,5,13,"CCa-PNC-NC",248
38,"38051",7328,5017,4969,32,48,"CCa-PNC-NC",1113
38,"38901",1466,908,894,4,14,"CCa-PNC-NC",207
38,"38008",5699,3719,3669,26,50,"CCa-PNC-NC",839
38,"38040",5482,3094,3060,14,34,"CCa-PNC-NC",569
38,"38014",1342,943,930,6,13,"CCa-PNC-NC",359
38,"38042",3778,2410,2386,11,24,"CCa-PNC-NC",284
38,"38047",1755,1132,1110,9,22,"CCa-PNC-NC",281
38,"38025",7065,4657,4590,34,67,"CCa-PNC-NC",608
38,"38020",16057,9921,9809,66,112,"CCa-PNC-NC",1793
38,"38033",3593,2277,2242,15,35,"CCa-PNC-NC",411
38,"38003",1517,899,890,5,9,"CCa-PNC-NC",86
38,"38024",15316,9131,9005,60,126,"CCa-PNC-NC",1494
38,"38031",29301,20926,20701,157,225,"CCa-PNC-NC",2667
38,"38048",3952,2543,2519,22,24,"CCa-PNC-NC",532
38,"38037",12817,7582,7494,55,88,"CCa-PNC-NC",1052
38,"38011",21655,13974,13831,106,143,"CCa-PNC-NC",1873
38,"38015",4055,2635,2601,16,34,"CCa-PNC-NC",809
38,"38026",33585,24091,23889,170,202,"CCa-PNC-NC",7282
38,"38013",3011,1850,1829,14,21,"CCa-PNC-NC",404
38,"38009",4315,2846,2817,27,29,"CCa-PNC-NC",504
38,"38007",1619,1053,1043,3,10,"CCa-PNC-NC",141
38,"38028",22144,14312,14174,89,138,"CCa-PNC-NC",1539
38,"38045",3542,1825,1801,7,24,"CCa-PNC-NC",349
38,"38016",1174,595,589,2,6,"CCa-PNC-NC",98
38,"38022",18630,11420,11284,87,136,"CCa-PNC-NC",2705
38,"38053",3768,2275,2244,16,31,"CCa-PNC-NC",469
38,"38035",10518,5870,5819,37,51,"CCa-PNC-NC",1205
38,"38049",2690,1406,1389,27,17,"CCa-PNC-NC",239
40,"40083",73,52,52,1,0,"centrados",3
40,"40036",496,395,380,8,15,"centrados",2
40,"40028",103,88,87,2,1,"centrados",0
40,"40077",966,718,704,10,14,"centrados",3
40,"40053",79,56,56,1,0,"centrados",0
40,"40154",22,18,18,1,0,"centrados",0
40,"40100",262,208,204,4,4,"centrados",0
40,"40069",68,59,59,0,0,"centrados",0
40,"40211",66,54,54,1,0,"centrados",0
40,"40136",102,79,77,3,2,"centrados",0
40,"40041",966,729,716,8,13,"centrados",0
40,"40188",83,63,60,0,3,"centrados",0
40,"40218",80,56,55,0,1,"centrados",0
40,"40216",785,633,621,9,12,"centrados",3
40,"40206",162,126,123,0,3,"centrados",2
40,"40156",272,194,190,4,4,"centrados",0
40,"40092",105,75,75,2,0,"centrados",0
40,"40048",35,27,27,0,0,"centrados",0
40,"40019",29,23,23,1,0,"centrados",0
40,"40200",38,28,28,0,0,"centrados",0
40,"40110",316,237,234,4,3,"centrados",0
40,"40132",45,26,25,0,1,"centrados",0
40,"40127",36,25,23,0,2,"centrados",0
40,"40145",1098,824,820,4,4,"centrados",0
40,"40022",195,144,141,2,3,"centrados",1
40,"40034",74,59,58,0,1,"centrados",0
40,"40068",22,21,21,0,0,"centrados",0
40,"40233",399,279,273,0,6,"centrados",1
40,"40012",241,160,156,7,4,"centrados",0
40,"40165",73,53,52,0,1,"centrados",0
40,"40138",2102,1585,1565,13,20,"centrados",4
40,"40109",69,51,50,3,1,"centrados",0
40,"40158",15,11,11,0,0,"centrados",0
40,"40007",68,55,55,1,0,"centrados",0
40,"40052",72,55,55,0,0,"centrados",0
40,"40080",51,31,31,0,0,"centrados",0
40,"40057",1397,1081,1067,15,14,"centrados",2
40,"40190",43,37,35,0,2,"centrados",0
40,"40210",97,69,69,1,0,"centrados",0
40,"40026",112,101,99,0,2,"centrados",0
40,"40223",235,177,174,1,3,"centrados",0
40,"40101",918,672,665,11,7,"centrados",0
40,"40902",113,78,76,1,2,"centrados",0
40,"40113",404,308,304,2,4,"centrados",1
40,"40176",372,288,287,2,1,"centrados",0
40,"40193",219,156,155,3,1,"centrados",0
40,"40046",83,67,67,1,0,"centrados",0
40,"40060",67,40,40,1,0,"centrados",0
40,"40095",453,341,329,2,12,"centrados",0
40,"40189",471,344,329,1,15,"centrados",0
40,"40122",524,398,392,2,6,"centrados",0
40,"40203",987,753,740,13,13,"centrados",1
40,"40118",46,32,32,1,0,"centrados",0
40,"40906",2149,1701,1662,18,39,"centrados",12
40,"40106",179,140,139,2,1,"centrados",2
40,"40089",209,155,148,2,7,"centrados",0
40,"40196",30,24,24,0,0,"centrados",0
40,"40093",74,62,62,1,0,"centrados",0
40,"40082",104,84,84,2,0,"centrados",0
40,"40229",26,22,22,0,0,"centrados",0
40,"40212",26,19,19,1,0,"centrados",0
40,"40161",32,24,23,1,1,"centrados",0
40,"40186",35,29,29,0,0,"centrados",0
40,"40081",117,80,76,1,4,"centrados",1
40,"40014",56,39,38,0,1,"centrados",0
40,"40039",180,133,133,0,0,"centrados",0
40,"40135",277,212,210,3,2,"centrados",0
40,"40006",22,19,19,0,0,"centrados",0
40,"40087",85,70,70,0,0,"centrados",0
40,"40040",2489,1766,1744,26,22,"centrados",0
40,"40159",130,94,93,2,1,"centrados",2
40,"40172",47,33,32,0,1,"centrados",0
40,"40002",32,22,21,0,1,"centrados",0
40,"40234",375,278,269,3,9,"centrados",0
40,"40047",37,23,23,0,0,"centrados",0
40,"40148",231,165,163,4,2,"centrados",0
40,"40021",18,15,15,0,0,"centrados",0
40,"40013",57,47,47,0,0,"centrados",0
40,"40179",620,500,490,3,10,"centrados",0
40,"40125",76,48,46,0,2,"centrados",1
40,"40180",276,215,210,2,5,"centrados",0
40,"40134",692,522,509,10,13,"centrados",5
40,"40010",108,83,82,0,1,"centrados",0
40,"40903",75,61,59,0,2,"centrados",0
40,"40031",546,410,406,3,4,"centrados",0
40,"40056",31,21,20,0,1,"centrados",0
40,"40174",319,229,227,3,2,"centrados",2
40,"40224",18,15,15,0,0,"centrados",0
40,"40221",50,38,35,0,3,"centrados",0
40,"40107",90,67,67,0,0,"centrados",0
40,"40049",37,27,27,0,0,"centrados",0
40,"40037",30,17,17,0,0,"centrados",0
40,"40126",67,44,42,0,2,"centrados",1
40,"40192",134,106,105,1,1,"centrados",1
40,"40018",73,50,50,0,0,"centrados",0
40,"40901",413,320,315,7,5,"centrados",0
40,"40171",40,32,32,1,0,"centrados",0
40,"40173",140,120,118,2,2,"centrados",0
40,"40142",52,39,37,0,2,"centrados",0
40,"40182",169,112,112,1,0,"centrados",0
40,"40058",306,244,240,1,4,"centrados",0
40,"40178",85,61,60,0,1,"centrados",0
40,"40072",224,175,171,1,4,"centrados",2
40,"40074",246,193,189,2,4,"centrados",0
40,"40078",150,123,123,6,0,"centrados",2
40,"40073",387,327,323,1,4,"centrados",0
40,"40168",27,20,20,0,0,"centrados",0
40,"40033",70,55,52,1,3,"centrados",0
40,"40071",39,32,26,0,6,"centrados",0
40,"40207",802,593,590,11,3,"centrados",4
40,"40198",24,20,19,0,1,"centrados",0
40,"40150",60,42,42,0,0,"centrados",0
40,"40024",823,582,575,8,7,"centrados",0
40,"40119",166,133,132,2,1,"centrados",1
40,"40143",82,68,67,2,1,"centrados",0
40,"40059",109,92,91,2,1,"centrados",1
40,"40181",4182,3102,3038,35,64,"centrados",8
40,"40104",283,203,200,0,3,"centrados",0
40,"40140",76,54,54,0,0,"centrados",0
40,"40035",135,110,110,2,0,"centrados",2
40,"40086",656,513,496,7,17,"centrados",0
40,"40230",93,66,64,0,2,"centrados",0
40,"40025",129,109,107,1,2,"centrados",0
40,"40020",149,112,111,1,1,"centrados",0
40,"40017",83,71,68,2,3,"centrados",0
40,"40141",822,584,568,9,16,"centrados",1
40,"40166",251,201,201,0,0,"centrados",0
40,"40088",272,192,192,0,0,"centrados",0
40,"40155",3897,2920,2880,56,40,"centrados",11
40,"40015",23,19,19,0,0,"centrados",0
40,"40144",16,15,15,0,0,"centrados",0
40,"40201",42,37,37,0,0,"centrados",0
40,"40044",134,101,101,3,0,"centrados",1
40,"40128",123,88,87,1,1,"centrados",0
40,"40205",228,159,157,1,2,"centrados",0
40,"40170",1302,962,948,6,14,"centrados",1
40,"40051",34,25,25,0,0,"centrados",0
40,"40184",245,196,194,0,2,"centrados",2
40,"40003",116,82,79,3,3,"centrados",0
40,"40191",198,143,138,0,5,"centrados",0
40,"40152",732,575,565,10,10,"centrados",1
40,"40065",467,338,329,1,9,"centrados",0
40,"40030",419,317,314,3,3,"centrados",0
40,"40199",101,76,72,2,4,"centrados",0
40,"40005",25,23,23,1,0,"centrados",0
40,"40131",51,45,45,0,0,"centrados",0
40,"40115",142,100,100,0,0,"centrados",0
40,"40214",198,160,154,0,6,"centrados",0
40,"40139",255,194,192,2,2,"centrados",1
40,"40108",109,85,85,2,0,"centrados",0
40,"40084",52,41,41,2,0,"centrados",0
40,"40204",145,102,101,0,1,"centrados",0
40,"40151",43,31,31,0,0,"centrados",0
40,"40215",79,66,66,2,0,"centrados",0
40,"40070",143,94,92,1,2,"centrados",0
40,"40029",25,21,19,0,2,"centrados",0
40,"40904",344,286,284,8,2,"centrados",0
40,"40062",56,43,42,0,1,"centrados",0
40,"40177",139,106,105,0,1,"centrados",0
40,"40120",195,169,163,0,6,"centrados",0
40,"40079",229,160,159,2,1,"centrados",0
40,"40225",1085,822,809,5,13,"centrados",3
40,"40202",56,33,33,0,0,"centrados",0
40,"40183",117,105,99,1,6,"centrados",0
40,"40094",353,265,263,3,2,"centrados",0
40,"40112",2813,2126,2087,26,39,"centrados",7
40,"40222",161,134,131,1,3,"centrados",0
40,"40149",479,345,338,3,7,"centrados",1
40,"40124",234,169,164,0,5,"centrados",0
40,"40164",186,131,130,0,1,"centrados",0
40,"40105",43,35,35,0,0,"centrados",0
40,"40009",41,35,34,0,1,"centrados",0
40,"40219",573,382,366,5,16,"centrados",3
40,"40160",93,65,62,0,3,"centrados",0
40,"40103",139,113,113,0,0,"centrados",1
40,"40008",42,36,36,1,0,"centrados",0
40,"40146",260,206,204,0,2,"centrados",1
40,"40075",152,116,116,0,0,"centrados",0
40,"40129",159,119,117,2,2,"centrados",0
40,"40016",55,44,43,1,1,"centrados",0
40,"40054",108,79,78,3,1,"centrados",0
40,"40045",119,93,93,1,0,"centrados",1
40,"40220",64,46,45,0,1,"centrados",0
40,"40194",39173,28641,28260,353,381,"centrados",98
40,"40061",63,47,44,0,3,"centrados",0
40,"40004",436,330,319,2,11,"centrados",0
40,"40043",1773,1376,1345,21,31,"centrados",4
40,"40905",130,95,95,0,0,"centrados",0
40,"40076",6576,4700,4607,32,93,"centrados",3
40,"40185",800,560,553,4,7,"centrados",0
40,"40195",776,573,565,4,8,"centrados",1
40,"40055",31,26,26,0,0,"centrados",0
40,"40111",50,39,39,0,0,"centrados",0
40,"40163",42,35,35,1,0,"centrados",0
40,"40213",93,78,78,1,0,"centrados",0
40,"40091",109,87,85,0,2,"centrados",0
40,"40208",724,546,543,5,3,"centrados",0
40,"40228",493,362,361,3,1,"centrados",0
40,"40001",708,544,536,3,8,"centrados",1
40,"40032",368,247,244,5,3,"centrados",0
40,"40130",127,95,87,1,8,"centrados",0
40,"40063",6913,4948,4838,57,110,"centrados",20
40,"40099",54,44,42,0,2,"centrados",0
40,"40097",130,103,102,5,1,"centrados",0
40,"40157",39,30,30,0,0,"centrados",1
40,"40123",141,98,94,4,4,"centrados",0
40,"40162",380,273,265,1,8,"centrados",0
40,"40121",249,188,178,1,10,"centrados",0
40,"40231",100,79,76,0,3,"centrados",0
22,"22165",449,305,300,3,5,"CHA",1
22,"22057",364,253,248,4,5,"CHA",6
22,"22234",743,498,491,5,7,"CHA",2
22,"22227",200,140,140,2,0,"CHA",1
22,"22225",2606,1638,1612,20,26,"CHA",32
22,"22156",289,216,213,1,3,"CHA",4
22,"22052",874,660,652,7,8,"CHA",3
22,"22125",39530,27358,27075,344,283,"CHA",504
22,"22160",207,149,149,1,0,"CHA",0
22,"22043",93,53,53,0,0,"CHA",1
22,"22037",112,87,87,2,0,"CHA",4
22,"22094",102,69,69,3,0,"CHA",1
22,"22017",826,613,608,2,5,"CHA",5
22,"22232",88,61,61,2,0,"CHA",2
22,"22018",303,216,215,3,1,"CHA",0
22,"22064",155,100,100,2,0,"CHA",1
22,"22151",85,60,60,0,0,"CHA",2
22,"22086",194,137,137,1,0,"CHA",5
22,"22907",1463,1016,1006,21,10,"CHA",30
22,"22212",69,52,52,1,0,"CHA",1
22,"22119",1267,880,871,4,9,"CHA",12
22,"22217",370,274,269,4,5,"CHA",7
22,"22046",713,555,549,9,6,"CHA",8
22,"22004",123,83,83,0,0,"CHA",1
22,"22247",28,18,18,0,0,"CHA",0
22,"22036",84,71,71,1,0,"CHA",0
22,"22144",255,192,190,2,2,"CHA",6
22,"22115",348,263,261,3,2,"CHA",8
22,"22208",192,150,147,1,3,"CHA",16
22,"22901",714,433,423,6,10,"CHA",19
22,"22229",107,70,70,2,0,"CHA",1
22,"22220",147,106,105,1,1,"CHA",1
22,"22009",581,387,386,7,1,"CHA",6
22,"22172",520,373,369,5,4,"CHA",9
22,"22213",2918,2084,2062,20,22,"CHA",106
22,"22027",311,210,209,1,1,"CHA",2
22,"22040",149,119,119,3,0,"CHA",1
22,"22016",558,384,382,5,2,"CHA",0
22,"22228",532,371,364,4,7,"CHA",2
22,"22007",751,527,520,1,7,"CHA",3
22,"22199",6884,4438,4384,71,54,"CHA",108
22,"22139",80,57,57,1,0,"CHA",0
22,"22164",42,28,28,0,0,"CHA",0
22,"22205",448,294,292,0,2,"CHA",2
22,"22066",755,529,520,8,9,"CHA",10
22,"22023",385,293,283,2,10,"CHA",4
22,"22099",490,349,343,2,6,"CHA",1
22,"22130",10146,6505,6436,57,69,"CHA",188
22,"22003",135,107,107,0,0,"CHA",1
22,"22235",88,69,68,1,1,"CHA",0
22,"22905",287,217,217,1,0,"CHA",8
22,"22195",238,190,186,0,4,"CHA",0
22,"22079",118,85,84,1,1,"CHA",1
22,"22215",127,81,81,0,0,"CHA",0
22,"22049",73,62,62,0,0,"CHA",0
22,"22058",193,141,141,0,0,"CHA",1
22,"22214",117,92,89,0,3,"CHA",0
22,"22207",121,66,65,0,1,"CHA",2
22,"22109",261,184,183,1,1,"CHA",2
22,"22041",145,116,116,2,0,"CHA",1
22,"22184",167,132,130,4,2,"CHA",0
22,"22243",43,32,31,0,1,"CHA",0
22,"22176",171,140,138,2,2,"CHA",1
22,"22128",188,145,143,3,2,"CHA",0
22,"22048",12635,8889,8807,98,82,"CHA",155
22,"22908",190,135,134,0,1,"CHA",5
22,"22250",346,241,241,0,0,"CHA",2
22,"22068",64,41,41,1,0,"CHA",2
22,"22020",115,83,80,3,3,"CHA",1
22,"22168",22,20,19,0,1,"CHA",0
22,"22142",94,72,70,0,2,"CHA",1
22,"22055",305,242,235,2,7,"CHA",1
22,"22082",288,217,214,0,3,"CHA",5
22,"22051",90,72,72,2,0,"CHA",2
22,"22090",86,61,61,1,0,"CHA",0
22,"22178",105,89,89,1,0,"CHA",0
22,"22088",143,98,97,1,1,"CHA",1
22,"22083",447,360,355,6,5,"CHA",7
22,"22246",63,43,43,0,0,"CHA",2
22,"22111",143,96,95,2,1,"CHA",2
22,"22200",239,165,164,2,1,"CHA",2
22,"22204",1117,728,723,14,5,"CHA",12
22,"22248",103,73,73,0,0,"CHA",0
22,"22904",751,516,511,3,5,"CHA",5
22,"22230",291,209,207,4,2,"CHA",2
22,"22002",99,81,81,0,0,"CHA",1
22,"22061",6567,4446,4410,48,36,"CHA",58
22,"22129",162,110,110,0,0,"CHA",1
22,"22158",11994,8115,8049,79,66,"CHA",110
22,"22226",761,537,530,13,7,"CHA",15
22,"22014",227,164,162,5,2,"CHA",3
22,"22188",75,50,50,1,0,"CHA",0
22,"22095",66,52,51,1,1,"CHA",0
22,"22006",268,167,164,4,3,"CHA",7
22,"22223",77,60,59,2,1,"CHA",0
22,"22193",272,199,194,4,5,"CHA",0
22,"22042",116,91,89,1,2,"CHA",2
22,"22239",85,67,65,0,2,"CHA",0
22,"22167",465,358,356,8,2,"CHA",2
22,"22162",125,94,94,0,0,"CHA",2
22,"22117",2384,1606,1596,18,10,"CHA",19
22,"22141",115,94,93,0,1,"CHA",5
22,"22012",102,75,75,2,0,"CHA",0
22,"22110",700,476,473,3,3,"CHA",20
22,"22189",175,142,142,1,0,"CHA",3
22,"22149",301,211,210,1,1,"CHA",3
22,"22252",118,95,91,1,4,"CHA",0
22,"22174",462,352,350,0,2,"CHA",1
22,"22222",516,379,377,6,2,"CHA",2
22,"22029",118,85,83,1,2,"CHA",2
22,"22201",264,188,186,3,2,"CHA",3
22,"22245",303,222,213,3,9,"CHA",0
22,"22062",154,107,107,1,0,"CHA",2
22,"22137",1009,671,665,1,6,"CHA",16
22,"22019",176,128,126,1,2,"CHA",3
22,"22242",60,41,40,0,1,"CHA",1
22,"22124",183,119,119,0,0,"CHA",1
22,"22135",173,123,121,0,2,"CHA",5
22,"22150",459,325,321,8,4,"CHA",5
22,"22015",299,218,215,1,3,"CHA",2
22,"22085",94,78,76,0,2,"CHA",2
22,"22143",190,118,115,1,3,"CHA",3
22,"22133",108,71,71,3,0,"CHA",0
22,"22080",263,188,184,3,4,"CHA",4
22,"22032",102,69,68,1,1,"CHA",2
22,"22078",431,285,285,4,0,"CHA",8
22,"22024",220,159,158,1,1,"CHA",4
22,"22028",358,237,233,1,4,"CHA",7
22,"22206",179,138,137,0,1,"CHA",0
22,"22157",181,122,121,2,1,"CHA",3
22,"22077",362,280,272,5,8,"CHA",1
22,"22089",274,195,193,2,2,"CHA",0
22,"22236",232,190,188,2,2,"CHA",1
22,"22114",124,75,72,1,3,"CHA",3
22,"22102",180,137,136,3,1,"CHA",2
22,"22035",225,153,152,1,1,"CHA",3
22,"22136",749,524,518,5,6,"CHA",11
22,"22251",327,259,256,0,3,"CHA",4
22,"22173",219,147,141,3,6,"CHA",3
22,"22254",1084,744,735,10,9,"CHA",3
22,"22044",234,166,164,1,2,"CHA",4
22,"22122",69,52,50,2,2,"CHA",0
22,"22087",60,46,46,0,0,"CHA",1
22,"22203",77,62,62,2,0,"CHA",0
22,"22013",271,200,197,3,3,"CHA",0
22,"22074",303,209,208,5,1,"CHA",2
22,"22047",248,202,201,1,1,"CHA",3
22,"22233",81,53,53,0,0,"CHA",0
22,"22011",98,80,79,0,1,"CHA",1
22,"22076",285,207,203,4,4,"CHA",3
22,"22001",212,147,146,0,1,"CHA",1
22,"22163",426,338,335,0,3,"CHA",0
22,"22221",92,56,55,0,1,"CHA",1
22,"22209",161,121,121,3,0,"CHA",3
22,"22067",70,52,52,0,0,"CHA",0
22,"22060",1167,817,808,14,9,"CHA",8
22,"22182",227,132,131,3,1,"CHA",0
22,"22022",542,405,403,2,2,"CHA",9
22,"22105",102,65,65,0,0,"CHA",1
22,"22039",813,635,634,4,1,"CHA",11
22,"22059",1135,765,752,2,13,"CHA",20
22,"22202",147,128,128,3,0,"CHA",3
22,"22909",307,219,217,0,2,"CHA",1
22,"22187",288,220,220,2,0,"CHA",3
22,"22253",56,40,40,1,0,"CHA",0
22,"22021",1884,1331,1319,26,12,"CHA",16
22,"22131",84,62,58,5,4,"CHA",1
22,"22175",184,129,128,0,1,"CHA",0
22,"22902",206,147,144,1,3,"CHA",4
22,"22053",783,494,492,6,2,"CHA",5
22,"22903",618,484,482,5,2,"CHA",4
22,"22069",423,296,294,4,2,"CHA",12
22,"22112",9525,6317,6245,91,72,"CHA",35
22,"22084",571,400,391,5,9,"CHA",9
22,"22054",1614,1029,1009,19,20,"CHA",15
22,"22081",247,173,171,3,2,"CHA",2
22,"22072",197,127,126,1,1,"CHA",5
22,"22127",521,353,352,5,1,"CHA",3
22,"22106",20,13,13,2,0,"CHA",0
22,"22155",66,52,52,0,0,"CHA",1
22,"22126",89,64,64,0,0,"CHA",0
22,"22190",123,77,77,1,0,"CHA",3
22,"22249",125,93,92,1,1,"CHA",1
22,"22244",42,33,32,1,1,"CHA",0
22,"22906",177,123,122,6,1,"CHA",2
22,"22096",332,248,241,10,7,"CHA",4
22,"22103",664,489,489,4,0,"CHA",7
22,"22025",1022,705,694,14,11,"CHA",10
22,"22008",144,113,112,2,1,"CHA",8
22,"22075",116,71,69,1,2,"CHA",9
22,"22050",93,77,77,0,0,"CHA",1
22,"22177",96,69,68,0,1,"CHA",2
22,"22197",436,327,325,3,2,"CHA",7
22,"22107",102,53,53,0,0,"CHA",2
22,"22063",161,128,126,0,2,"CHA",8
22,"22181",86,55,54,2,1,"CHA",1
22,"22113",478,335,333,6,2,"CHA",6
22,"22170",672,460,456,5,4,"CHA",4
22,"22186",189,148,145,3,3,"CHA",2
22,"22116",1342,915,905,11,10,"CHA",7
22,"22218",39,34,34,0,0,"CHA",0
22,"22045",65,52,52,0,0,"CHA",1
37,"37375",678,539,523,8,16,"CONTIGO",0
46,"46007",12333,8890,8803,79,87,"CONTIGO",8
46,"46149",350,252,249,3,3,"CONTIGO",0
46,"46015",7519,5575,5532,34,43,"CONTIGO",1
37,"37291",269,186,185,1,1,"CONTIGO",0
37,"37226",152,113,113,2,0,"CONTIGO",0
37,"37250",325,212,211,0,1,"CONTIGO",0
37,"37190",189,141,139,1,2,"CONTIGO",0
37,"37215",133,93,90,1,3,"CONTIGO",1
46,"46903",6306,4762,4743,44,19,"CONTIGO",2
37,"37155",68,48,48,0,0,"CONTIGO",0
37,"37225",97,78,74,0,4,"CONTIGO",0
46,"46116",13606,10262,10200,87,62,"CONTIGO",6
37,"37109",178,127,126,0,1,"CONTIGO",0
37,"37280",70,47,46,0,1,"CONTIGO",0
37,"37129",248,181,181,1,0,"CONTIGO",0
46,"46902",352,283,283,0,0,"CONTIGO",27
37,"37270",184,139,136,2,3,"CONTIGO",0
30,"30029",12122,8231,8125,54,106,"CONTIGO",2
46,"46020",3757,2834,2783,16,51,"CONTIGO",0
37,"37268",106,62,61,1,1,"CONTIGO",0
37,"37089",60,44,43,0,1,"CONTIGO",1
46,"46018",562,442,436,2,6,"CONTIGO",1
46,"46072",3522,2792,2741,25,51,"CONTIGO",1
46,"46237",7172,5199,5146,53,53,"CONTIGO",1
46,"46089",2182,1590,1576,9,14,"CONTIGO",2
37,"37202",1004,773,763,12,10,"CONTIGO",0
37,"37143",384,273,273,2,0,"CONTIGO",0
46,"46135",9817,7596,7558,58,38,"CONTIGO",2
37,"37026",180,148,147,5,1,"CONTIGO",0
38,"38031",29301,20926,20701,157,225,"CONTIGO",11
37,"37047",215,89,89,0,0,"CONTIGO",0
46,"46060",9278,6796,6724,49,72,"CONTIGO",1
46,"46058",1734,1245,1230,8,15,"CONTIGO",0
46,"46115",330,219,213,0,6,"CONTIGO",1
37,"37101",138,101,100,1,1,"CONTIGO",0
37,"37342",250,190,189,3,1,"CONTIGO",0
46,"46223",7776,5848,5798,36,50,"CONTIGO",3
46,"46077",7338,5447,5356,44,91,"CONTIGO",0
46,"46240",200,167,155,1,12,"CONTIGO",0
37,"37040",376,291,288,0,3,"CONTIGO",1
37,"37160",597,380,370,3,10,"CONTIGO",0
46,"46096",263,204,202,0,2,"CONTIGO",0
37,"37253",135,109,109,1,0,"CONTIGO",0
30,"30901",10556,7862,7775,58,87,"CONTIGO",5
37,"37120",98,78,76,0,2,"CONTIGO",0
35,"35022",51765,29309,29034,184,275,"CONTIGO",10
46,"46191",1956,1439,1414,8,25,"CONTIGO",1
46,"46216",5277,4146,4111,42,35,"CONTIGO",3
46,"46150",1794,1276,1272,8,4,"CONTIGO",0
37,"37044",431,309,308,3,1,"CONTIGO",0
46,"46081",9999,7486,7412,47,74,"CONTIGO",2
46,"46066",1274,972,970,4,2,"CONTIGO",0
37,"37223",106,75,74,0,1,"CONTIGO",0
46,"46039",2111,1657,1640,16,17,"CONTIGO",0
46,"46102",19696,14700,14579,125,121,"CONTIGO",19
35,"35004",41975,20773,20602,156,171,"CONTIGO",9
46,"46100",281,190,187,1,3,"CONTIGO",1
37,"37123",159,124,123,2,1,"CONTIGO",1
37,"37019",138,111,109,0,2,"CONTIGO",0
46,"46263",235,182,180,2,2,"CONTIGO",0
37,"37185",539,372,363,2,9,"CONTIGO",1
46,"46059",1244,1007,995,5,12,"CONTIGO",0
37,"37352",209,157,155,3,2,"CONTIGO",0
37,"37171",396,272,270,2,2,"CONTIGO",0
37,"37245",331,221,220,4,1,"CONTIGO",0
35,"35028",10156,5483,5425,56,58,"CONTIGO",1
35,"35032",3331,2293,2252,23,41,"CONTIGO",0
38,"38032",13579,8941,8880,92,61,"CONTIGO",1
30,"30014",1587,1150,1134,4,16,"CONTIGO",0
37,"37237",296,212,204,1,8,"CONTIGO",0
46,"46219",125,107,104,0,3,"CONTIGO",0
46,"46105",16126,10958,10847,76,111,"CONTIGO",5
30,"30038",15752,10987,10904,39,83,"CONTIGO",2
46,"46108",420,328,324,1,4,"CONTIGO",0
46,"46056",176,142,142,0,0,"CONTIGO",0
37,"37224",189,156,153,2,3,"CONTIGO",0
35,"35019",32830,18390,18243,87,147,"CONTIGO",10
37,"37186",94,68,68,0,0,"CONTIGO",0
37,"37057",208,151,149,0,2,"CONTIGO",0
37,"37278",793,570,567,6,3,"CONTIGO",0
46,"46033",196,155,153,0,2,"CONTIGO",0
37,"37097",42,29,29,0,0,"CONTIGO",0
46,"46155",972,731,716,3,15,"CONTIGO",0
46,"46187",1292,924,920,4,4,"CONTIGO",0
46,"46075",144,125,122,2,3,"CONTIGO",0
37,"37373",692,451,442,4,9,"CONTIGO",0
37,"37247",171,129,128,0,1,"CONTIGO",0
37,"37083",181,155,153,1,2,"CONTIGO",0
46,"46170",3417,2618,2577,11,41,"CONTIGO",0
37,"37054",233,190,186,2,4,"CONTIGO",0
37,"37152",400,268,261,4,7,"CONTIGO",0
30,"30037",19407,13252,13120,99,132,"CONTIGO",4
37,"37296",297,215,210,0,5,"CONTIGO",0
38,"38050",2417,1288,1273,9,15,"CONTIGO",1
38,"38017",30964,16228,16102,108,126,"CONTIGO",14
37,"37049",125,76,76,0,0,"CONTIGO",0
37,"37249",37,28,28,0,0,"CONTIGO",0
46,"46047",540,428,420,1,8,"CONTIGO",1
46,"46146",1647,1241,1229,12,12,"CONTIGO",0
46,"46078",28484,19694,19520,173,174,"CONTIGO",13
30,"30006",833,699,695,1,4,"CONTIGO",0
37,"37276",125,92,92,0,0,"CONTIGO",0
38,"38001",21069,10844,10777,63,67,"CONTIGO",6
37,"37333",203,125,124,2,1,"CONTIGO",0
46,"46034",1826,1345,1335,3,10,"CONTIGO",2
46,"46073",1066,823,817,11,6,"CONTIGO",0
30,"30041",14040,8999,8876,94,123,"CONTIGO",6
35,"35027",10502,6831,6750,67,81,"CONTIGO",7
37,"37125",231,154,148,1,6,"CONTIGO",0
46,"46164",12145,8373,8248,44,125,"CONTIGO",6
37,"37065",276,167,167,2,0,"CONTIGO",0
37,"37271",349,262,258,2,4,"CONTIGO",0
37,"37166",196,134,133,1,1,"CONTIGO",0
38,"38049",2690,1406,1389,27,17,"CONTIGO",2
37,"37372",133,99,98,0,1,"CONTIGO",0
46,"46259",457,374,371,2,3,"CONTIGO",0
30,"30009",12728,9487,9365,46,122,"CONTIGO",1
37,"37258",134,92,92,1,0,"CONTIGO",0
37,"37031",329,241,238,3,3,"CONTIGO",0
37,"37261",213,153,149,0,4,"CONTIGO",0
35,"35025",1752,1113,1095,5,18,"CONTIGO",1
37,"37018",106,75,75,0,0,"CONTIGO",0
46,"46064",532,395,387,3,8,"CONTIGO",0
37,"37259",39,28,28,1,0,"CONTIGO",0
46,"46016",1070,827,814,10,13,"CONTIGO",0
30,"30013",7421,5171,5094,32,77,"CONTIGO",1
37,"37353",122,82,80,0,2,"CONTIGO",0
38,"38041",7025,4729,4684,42,45,"CONTIGO",2
46,"46147",17186,11507,11399,72,108,"CONTIGO",15
46,"46157",2959,2145,2126,11,19,"CONTIGO",0
37,"37188",158,107,105,3,2,"CONTIGO",0
37,"37336",56,45,43,2,2,"CONTIGO",0
37,"37325",88,63,63,0,0,"CONTIGO",0
37,"37356",84,58,58,0,0,"CONTIGO",0
37,"37363",104,81,80,0,1,"CONTIGO",0
38,"38045",3542,1825,1801,7,24,"CONTIGO",0
37,"37189",114,75,74,1,1,"CONTIGO",0
37,"37346",251,208,207,1,1,"CONTIGO",0
37,"37381",138,98,93,0,5,"CONTIGO",0
46,"46222",402,329,326,0,3,"CONTIGO",0
46,"46226",29,20,19,0,1,"CONTIGO",0
37,"37208",71,49,49,0,0,"CONTIGO",0
46,"46136",2598,1875,1851,14,24,"CONTIGO",0
37,"37013",104,72,70,2,2,"CONTIGO",0
37,"37347",463,349,345,9,4,"CONTIGO",0
37,"37024",89,60,60,0,0,"CONTIGO",0
37,"37200",190,132,131,0,1,"CONTIGO",0
35,"35029",4415,2498,2472,29,26,"CONTIGO",2
46,"46083",15372,10939,10815,78,124,"CONTIGO",6
37,"37344",229,157,147,2,10,"CONTIGO",0
46,"46134",2419,1697,1678,14,19,"CONTIGO",0
38,"38051",7328,5017,4969,32,48,"CONTIGO",1
38,"38048",3952,2543,2519,22,24,"CONTIGO",1
37,"37257",51,36,36,1,0,"CONTIGO",0
46,"46114",552,417,412,6,5,"CONTIGO",1
30,"30042",2218,1645,1625,10,20,"CONTIGO",0
35,"35030",10046,5584,5505,44,79,"CONTIGO",4
37,"37118",117,86,86,3,0,"CONTIGO",0
30,"30021",9498,6251,6193,36,58,"CONTIGO",4
37,"37321",150,118,115,0,3,"CONTIGO",0
46,"46026",1220,974,965,7,9,"CONTIGO",0
46,"46049",268,221,217,2,4,"CONTIGO",1
38,"38009",4315,2846,2817,27,29,"CONTIGO",0
46,"46201",62,40,40,0,0,"CONTIGO",0
46,"46024",454,343,339,1,4,"CONTIGO",0
46,"46112",533,435,432,7,3,"CONTIGO",0
37,"37090",68,47,47,0,0,"CONTIGO",0
37,"37307",146,94,91,1,3,"CONTIGO",0
46,"46145",22215,15688,15538,127,150,"CONTIGO",11
37,"37235",214,163,159,2,4,"CONTIGO",0
46,"46054",11389,8266,8190,54,76,"CONTIGO",9
37,"37255",43,33,31,1,2,"CONTIGO",0
46,"46229",903,715,708,5,7,"CONTIGO",0
37,"37297",394,298,297,0,1,"CONTIGO",0
37,"37150",34,31,31,0,0,"CONTIGO",0
46,"46009",3144,2473,2449,22,24,"CONTIGO",0
37,"37023",1624,1233,1211,15,22,"CONTIGO",0
37,"37179",197,167,165,0,2,"CONTIGO",0
37,"37191",102,57,57,1,0,"CONTIGO",1
46,"46245",527,407,404,2,3,"CONTIGO",0
46,"46131",49805,35527,35231,298,296,"CONTIGO",6
37,"37151",142,109,109,1,0,"CONTIGO",0
37,"37131",175,125,125,0,0,"CONTIGO",0
37,"37371",252,156,155,0,1,"CONTIGO",0
37,"37309",36,21,21,0,0,"CONTIGO",0
46,"46002",1253,946,940,4,6,"CONTIGO",0
46,"46207",6761,4966,4909,46,57,"CONTIGO",4
35,"35017",27498,15513,15240,121,273,"CONTIGO",24
37,"37222",78,55,55,2,0,"CONTIGO",0
37,"37302",262,161,161,2,0,"CONTIGO",0
37,"37183",377,267,267,5,0,"CONTIGO",0
37,"37086",107,86,85,2,1,"CONTIGO",0
30,"30023",3874,2831,2788,18,43,"CONTIGO",0
46,"46228",2426,1819,1802,19,17,"CONTIGO",0
46,"46124",786,638,625,1,13,"CONTIGO",0
30,"30031",497,387,382,1,5,"CONTIGO",0
46,"46200",1840,1475,1455,5,20,"CONTIGO",0
37,"37234",314,194,192,3,2,"CONTIGO",0
46,"46041",313,229,228,1,1,"CONTIGO",0
37,"37133",101,73,69,1,4,"CONTIGO",0
35,"35003",5644,2987,2943,20,44,"CONTIGO",6
46,"46175",429,362,355,3,7,"CONTIGO",0
46,"46117",493,386,380,2,6,"CONTIGO",0
46,"46107",1857,1421,1402,4,19,"CONTIGO",0
37,"37228",324,262,262,1,0,"CONTIGO",1
46,"46140",383,321,321,2,0,"CONTIGO",0
46,"46250",582242,437146,434438,3315,2708,"CONTIGO",199
35,"35018",13153,7742,7674,80,68,"CONTIGO",63
37,"37216",294,234,227,5,7,"CONTIGO",0
37,"37009",197,145,144,1,1,"CONTIGO",0
37,"37029",186,125,124,1,1,"CONTIGO",0
37,"37343",66,44,43,1,1,"CONTIGO",0
46,"46258",2617,1925,1914,5,11,"CONTIGO",0
46,"46232",853,661,648,7,13,"CONTIGO",0
37,"37182",75,47,47,1,0,"CONTIGO",0
35,"35024",14323,8360,8289,81,71,"CONTIGO",1
37,"37098",290,197,197,1,0,"CONTIGO",0
37,"37114",74,58,55,1,3,"CONTIGO",0
38,"38039",11149,7375,7326,68,49,"CONTIGO",5
46,"46153",443,353,349,2,4,"CONTIGO",0
46,"46118",3649,2730,2701,20,29,"CONTIGO",0
37,"37196",70,50,50,0,0,"CONTIGO",0
46,"46065",1584,1199,1183,11,16,"CONTIGO",0
30,"30001",4507,3357,3331,17,26,"CONTIGO",0
37,"37206",87,65,54,0,11,"CONTIGO",0
46,"46035",6828,5155,5089,33,66,"CONTIGO",0
37,"37313",535,395,394,1,1,"CONTIGO",0
37,"37038",756,531,517,4,14,"CONTIGO",0
37,"37290",130,106,106,0,0,"CONTIGO",0
46,"46177",4832,3592,3539,20,53,"CONTIGO",3
46,"46048",3504,2609,2576,17,33,"CONTIGO",0
37,"37061",195,136,136,1,0,"CONTIGO",0
38,"38003",1517,899,890,5,9,"CONTIGO",0
37,"37112",158,110,109,2,1,"CONTIGO",0
46,"46172",5488,3724,3674,26,50,"CONTIGO",3
37,"37207",336,244,240,4,4,"CONTIGO",1
46,"46119",761,587,580,6,7,"CONTIGO",0
37,"37163",34,24,24,0,0,"CONTIGO",0
37,"37122",203,162,161,3,1,"CONTIGO",0
46,"46079",314,244,240,0,4,"CONTIGO",0
37,"37205",212,157,155,1,2,"CONTIGO",0
37,"37087",911,675,665,5,10,"CONTIGO",2
37,"37329",38,29,28,1,1,"CONTIGO",0
37,"37051",79,58,58,0,0,"CONTIGO",0
37,"37091",161,104,104,0,0,"CONTIGO",0
38,"38012",2286,1520,1510,8,10,"CONTIGO",0
37,"37376",2130,1446,1423,18,23,"CONTIGO",0
30,"30035",19432,13174,13013,114,161,"CONTIGO",4
35,"35021",15072,9791,9696,80,95,"CONTIGO",3
46,"46211",1862,1395,1381,12,14,"CONTIGO",0
46,"46196",134,111,110,0,1,"CONTIGO",0
37,"37221",391,259,257,2,2,"CONTIGO",0
46,"46128",1569,1216,1179,7,37,"CONTIGO",0
46,"46014",3156,2324,2294,13,30,"CONTIGO",3
37,"37092",1933,1342,1327,13,15,"CONTIGO",0
37,"37242",82,59,59,1,0,"CONTIGO",0
37,"37340",141,97,97,1,0,"CONTIGO",0
37,"37085",5060,3732,3689,52,43,"CONTIGO",7
37,"37060",283,205,202,1,3,"CONTIGO",0
37,"37337",137,104,103,0,1,"CONTIGO",0
37,"37377",215,174,173,0,1,"CONTIGO",0
37,"37106",248,161,160,4,1,"CONTIGO",0
46,"46022",15392,10624,10546,69,78,"CONTIGO",7
38,"38021",1609,900,876,2,24,"CONTIGO",0
30,"30020",6503,4521,4484,35,37,"CONTIGO",0
37,"37148",399,295,291,0,4,"CONTIGO",0
46,"46235",21229,15171,15011,126,160,"CONTIGO",3
46,"46225",351,267,262,1,5,"CONTIGO",0
38,"38005",5646,3302,3283,24,19,"CONTIGO",4
37,"37078",781,626,603,9,23,"CONTIGO",1
37,"37021",66,45,44,0,1,"CONTIGO",0
37,"37334",71,30,30,0,0,"CONTIGO",0
35,"35010",3853,2224,2194,18,30,"CONTIGO",1
35,"35020",5941,3740,3702,27,38,"CONTIGO",2
46,"46076",610,500,494,1,6,"CONTIGO",0
46,"46023",322,254,252,1,2,"CONTIGO",0
38,"38022",18630,11420,11284,87,136,"CONTIGO",12
37,"37058",56,38,38,1,0,"CONTIGO",0
30,"30902",8294,5235,5174,29,61,"CONTIGO",0
37,"37184",289,178,177,1,1,"CONTIGO",0
37,"37132",317,211,207,0,4,"CONTIGO",0
37,"37028",131,96,93,2,3,"CONTIGO",0
37,"37195",39,31,31,0,0,"CONTIGO",0
37,"37201",238,170,168,0,2,"CONTIGO",0
46,"46069",152,112,111,1,1,"CONTIGO",0
46,"46001",771,562,560,3,2,"CONTIGO",1
37,"37181",265,158,158,0,0,"CONTIGO",0
37,"37275",98,67,67,0,0,"CONTIGO",0
46,"46244",59910,42120,41826,338,294,"CONTIGO",33
37,"37140",630,395,393,0,2,"CONTIGO",0
37,"37036",55,36,34,0,2,"CONTIGO",0
46,"46163",1883,1471,1460,8,11,"CONTIGO",2
37,"37016",563,419,411,4,8,"CONTIGO",0
35,"35016",300581,181532,179831,1458,1701,"CONTIGO",84
46,"46199",5878,4217,4182,21,35,"CONTIGO",0
37,"37273",85,58,58,2,0,"CONTIGO",0
37,"37162",212,139,137,3,2,"CONTIGO",0
37,"37246",5146,3791,3737,42,54,"CONTIGO",1
38,"38007",1619,1053,1043,3,10,"CONTIGO",0
37,"37236",123,85,82,1,3,"CONTIGO",0
37,"37351",268,229,226,0,3,"CONTIGO",0
46,"46017",33041,23469,23277,173,192,"CONTIGO",6
38,"38024",15316,9131,9005,60,126,"CONTIGO",4
37,"37037",108,72,72,0,0,"CONTIGO",0
35,"35001",4566,3148,3105,18,43,"CONTIGO",4
46,"46230",14116,10038,9946,63,92,"CONTIGO",5
37,"37050",66,52,52,1,0,"CONTIGO",0
37,"37110",104,81,79,1,2,"CONTIGO",0
46,"46071",471,355,349,1,6,"CONTIGO",0
38,"38030",1962,1332,1318,9,14,"CONTIGO",0
46,"46139",4520,3486,3457,18,29,"CONTIGO",1
37,"37070",523,371,365,4,6,"CONTIGO",0
37,"37277",74,55,55,0,0,"CONTIGO",0
37,"37288",281,220,218,4,2,"CONTIGO",0
46,"46257",5436,3972,3933,28,39,"CONTIGO",0
46,"46162",1168,839,832,3,7,"CONTIGO",0
37,"37332",65,49,49,0,0,"CONTIGO",0
30,"30007",6474,4354,4317,26,37,"CONTIGO",0
46,"46132",2176,1725,1708,5,17,"CONTIGO",1
37,"37362",4783,3469,3420,44,49,"CONTIGO",10
37,"37161",123,86,86,0,0,"CONTIGO",0
37,"37008",4213,3092,3046,21,46,"CONTIGO",4
37,"37164",232,176,175,3,1,"CONTIGO",0
37,"37300",540,355,352,7,3,"CONTIGO",0
30,"30016",153034,101232,100202,776,1030,"CONTIGO",72
46,"46193",8959,6880,6824,66,56,"CONTIGO",3
46,"46246",1049,808,793,3,15,"CONTIGO",0
37,"37175",412,298,293,4,5,"CONTIGO",0
46,"46125",852,660,650,5,10,"CONTIGO",0
35,"35033",6393,4147,4072,38,75,"CONTIGO",3
37,"37012",144,111,111,0,0,"CONTIGO",0
46,"46239",446,357,352,1,5,"CONTIGO",1
46,"46087",109,94,94,2,0,"CONTIGO",1
37,"37088",199,135,133,0,2,"CONTIGO",0
37,"37360",206,135,135,1,0,"CONTIGO",0
30,"30022",17108,11041,10851,100,190,"CONTIGO",4
37,"37229",138,103,101,0,2,"CONTIGO",0
37,"37322",2462,1580,1537,14,43,"CONTIGO",1
46,"46247",972,649,646,3,3,"CONTIGO",0
30,"30025",5016,3663,3623,22,40,"CONTIGO",1
38,"38034",3997,2687,2648,19,39,"CONTIGO",7
46,"46050",185,141,141,1,0,"CONTIGO",0
30,"30017",11428,8196,8113,44,83,"CONTIGO",2
46,"46217",900,672,667,7,5,"CONTIGO",0
37,"37374",1138,889,872,2,17,"CONTIGO",0
46,"46202",17801,13010,12906,87,104,"CONTIGO",74
46,"46088",152,114,110,1,4,"CONTIGO",1
35,"35034",8392,3946,3908,27,38,"CONTIGO",2
35,"35012",10862,5617,5568,40,49,"CONTIGO",1
38,"38016",1174,595,589,2,6,"CONTIGO",0
37,"37156",4261,2928,2869,23,59,"CONTIGO",4
37,"37173",1412,951,937,15,14,"CONTIGO",1
37,"37197",88,53,53,1,0,"CONTIGO",0
37,"37067",3278,2568,2529,30,39,"CONTIGO",0
38,"38043",19365,12355,12212,126,143,"CONTIGO",4
37,"37167",174,147,144,2,3,"CONTIGO",0
46,"46252",125,89,86,1,3,"CONTIGO",0
37,"37126",30,25,25,0,0,"CONTIGO",0
37,"37324",333,247,242,3,5,"CONTIGO",0
37,"37142",554,396,394,5,2,"CONTIGO",0
37,"37194",229,161,160,0,1,"CONTIGO",0
46,"46260",2685,2072,2053,14,19,"CONTIGO",0
37,"37002",125,64,63,0,1,"CONTIGO",0
37,"37292",91,65,65,0,0,"CONTIGO",0
37,"37314",81,65,65,0,0,"CONTIGO",0
30,"30027",50067,36417,36074,242,343,"CONTIGO",14
37,"37146",106,82,76,0,6,"CONTIGO",0
37,"37282",193,132,131,3,1,"CONTIGO",0
46,"46082",4981,3547,3523,29,24,"CONTIGO",1
46,"46158",1047,771,763,7,8,"CONTIGO",0
46,"46221",348,292,290,1,2,"CONTIGO",0
46,"46120",1179,903,880,5,23,"CONTIGO",0
46,"46067",1753,1356,1341,8,15,"CONTIGO",3
37,"37117",1572,1103,1092,12,11,"CONTIGO",1
46,"46090",1631,1360,1339,6,21,"CONTIGO",0
37,"37287",297,204,202,2,2,"CONTIGO",0
37,"37199",128,92,92,2,0,"CONTIGO",0
38,"38053",3768,2275,2244,16,31,"CONTIGO",0
30,"30011",4702,3390,3324,8,66,"CONTIGO",3
46,"46113",2558,1791,1773,7,18,"CONTIGO",0
46,"46189",469,374,367,2,7,"CONTIGO",0
30,"30036",15432,10030,9879,64,151,"CONTIGO",2
37,"37233",53,39,39,1,0,"CONTIGO",2
35,"35006",31373,20764,20476,189,288,"CONTIGO",20
46,"46151",757,560,552,2,8,"CONTIGO",0
37,"37305",219,177,175,2,2,"CONTIGO",0
46,"46174",942,746,736,1,10,"CONTIGO",0
46,"46220",49112,33766,33424,312,342,"CONTIGO",14
37,"37096",203,144,144,2,0,"CONTIGO",0
30,"30034",1067,818,801,8,17,"CONTIGO",0
37,"37128",235,169,168,0,1,"CONTIGO",0
37,"37108",98,75,75,3,0,"CONTIGO",0
37,"37212",104,76,76,0,0,"CONTIGO",0
37,"37285",360,271,270,0,1,"CONTIGO",0
37,"37149",60,50,50,0,0,"CONTIGO",0
37,"37211",208,148,148,0,0,"CONTIGO",0
37,"37379",169,133,132,0,1,"CONTIGO",0
46,"46038",302,221,220,1,1,"CONTIGO",0
46,"46021",24053,17331,17194,159,137,"CONTIGO",23
35,"35002",24229,15311,15133,101,178,"CONTIGO",9
37,"37025",245,198,196,5,2,"CONTIGO",0
37,"37035",162,115,115,1,0,"CONTIGO",0
46,"46031",10574,7233,7158,58,75,"CONTIGO",3
30,"30005",30268,20979,20778,148,201,"CONTIGO",3
46,"46183",6036,4276,4213,21,63,"CONTIGO",2
37,"37100",74,59,58,1,1,"CONTIGO",0
38,"38006",41593,20823,20624,127,199,"CONTIGO",4
46,"46206",555,417,408,0,9,"CONTIGO",1
46,"46092",262,176,174,2,2,"CONTIGO",0
46,"46011",7523,5154,5077,34,77,"CONTIGO",2
37,"37311",201,157,156,1,1,"CONTIGO",0
35,"35031",7456,4938,4868,39,70,"CONTIGO",2
38,"38015",4055,2635,2601,16,34,"CONTIGO",3
37,"37006",116,71,70,3,1,"CONTIGO",0
37,"37283",116,83,83,0,0,"CONTIGO",0
46,"46055",1298,992,977,9,15,"CONTIGO",0
46,"46085",11089,7581,7503,60,78,"CONTIGO",0
38,"38047",1755,1132,1110,9,22,"CONTIGO",1
37,"37380",55,41,40,2,1,"CONTIGO",1
35,"35009",20229,13378,13201,95,177,"CONTIGO",4
46,"46184",26514,19610,19399,180,211,"CONTIGO",11
37,"37330",314,227,223,2,4,"CONTIGO",1
37,"37214",120,70,68,2,2,"CONTIGO",0
37,"37141",149,101,100,0,1,"CONTIGO",0
46,"46101",819,670,663,8,7,"CONTIGO",0
30,"30039",20442,13299,13167,84,132,"CONTIGO",12
46,"46169",32403,23890,23698,222,192,"CONTIGO",12
38,"38040",5482,3094,3060,14,34,"CONTIGO",0
37,"37203",151,114,113,1,1,"CONTIGO",0
37,"37027",239,182,179,2,3,"CONTIGO",0
46,"46215",1407,1088,1068,10,20,"CONTIGO",1
46,"46238",13117,9172,9088,50,84,"CONTIGO",1
37,"37017",226,169,168,4,1,"CONTIGO",0
46,"46086",80,66,65,1,1,"CONTIGO",0
38,"38008",5699,3719,3669,26,50,"CONTIGO",1
46,"46109",6248,4516,4440,37,76,"CONTIGO",2
37,"37382",162,127,124,0,3,"CONTIGO",0
46,"46094",20805,15353,15211,122,142,"CONTIGO",7
46,"46003",948,770,757,8,13,"CONTIGO",1
30,"30032",2864,2154,2129,18,25,"CONTIGO",0
37,"37154",129,97,94,1,3,"CONTIGO",0
37,"37074",136,93,90,1,3,"CONTIGO",0
46,"46231",2403,1670,1652,11,18,"CONTIGO",0
37,"37251",108,75,75,0,0,"CONTIGO",0
46,"46208",1071,854,845,2,9,"CONTIGO",0
30,"30024",60389,42200,41831,281,369,"CONTIGO",15
30,"30040",686,564,560,1,4,"CONTIGO",0
37,"37303",179,118,117,1,1,"CONTIGO",0
38,"38020",16057,9921,9809,66,112,"CONTIGO",5
46,"46133",462,359,352,1,7,"CONTIGO",0
37,"37113",404,286,285,13,1,"CONTIGO",1
46,"46186",19689,14688,14576,118,112,"CONTIGO",5
46,"46214",16637,12113,12014,84,99,"CONTIGO",5
46,"46156",2017,1538,1524,9,14,"CONTIGO",0
38,"38026",33585,24091,23889,170,202,"CONTIGO",12
35,"35026",83172,48751,48109,449,642,"CONTIGO",27
38,"38002",971,577,570,8,7,"CONTIGO",0
46,"46194",15852,11124,11009,86,115,"CONTIGO",6
37,"37020",431,320,314,3,6,"CONTIGO",1
37,"37124",195,137,137,2,0,"CONTIGO",0
37,"37240",928,648,637,2,11,"CONTIGO",1
37,"37354",5479,3969,3905,37,64,"CONTIGO",3
38,"38018",4466,2867,2821,21,46,"CONTIGO",0
46,"46111",11367,7995,7908,66,87,"CONTIGO",2
37,"37030",82,60,60,0,0,"CONTIGO",0
46,"46251",2465,1938,1903,19,35,"CONTIGO",2
37,"37135",1146,849,837,5,12,"CONTIGO",0
37,"37260",137,110,109,0,1,"CONTIGO",0
37,"37323",474,335,325,5,10,"CONTIGO",1
37,"37176",128,99,98,1,1,"CONTIGO",0
46,"46005",23129,16610,16437,148,173,"CONTIGO",13
37,"37230",220,169,168,1,1,"CONTIGO",0
38,"38019",13884,7888,7809,49,79,"CONTIGO",2
37,"37041",71,53,53,0,0,"CONTIGO",0
46,"46036",558,339,331,6,8,"CONTIGO",0
37,"37157",76,64,63,1,1,"CONTIGO",0
35,"35013",6593,4596,4516,47,80,"CONTIGO",7
38,"38028",22144,14312,14174,89,138,"CONTIGO",6
38,"38004",4536,2914,2887,28,27,"CONTIGO",4
38,"38036",6857,4170,4090,37,80,"CONTIGO",2
46,"46074",2687,2033,2020,18,13,"CONTIGO",0
37,"37032",553,388,388,2,0,"CONTIGO",0
46,"46122",2726,1957,1934,13,23,"CONTIGO",1
37,"37252",99,65,65,1,0,"CONTIGO",0
35,"35023",11742,7787,7651,95,136,"CONTIGO",4
37,"37147",184,126,124,1,2,"CONTIGO",0
37,"37279",713,488,480,4,8,"CONTIGO",0
35,"35015",10752,5289,5222,39,67,"CONTIGO",18
37,"37158",230,149,149,1,0,"CONTIGO",0
37,"37178",98,70,70,0,0,"CONTIGO",0
37,"37293",102,68,68,1,0,"CONTIGO",0
30,"30019",25911,17485,17264,157,221,"CONTIGO",6
46,"46253",112,84,84,0,0,"CONTIGO",0
46,"46143",4274,3027,2995,19,32,"CONTIGO",0
46,"46204",6625,4946,4882,52,64,"CONTIGO",2
37,"37357",248,193,192,1,1,"CONTIGO",0
46,"46261",1708,1259,1237,12,22,"CONTIGO",0
30,"30028",6390,4054,3973,25,81,"CONTIGO",0
46,"46166",8214,6093,6031,38,62,"CONTIGO",2
37,"37159",74,59,59,0,0,"CONTIGO",0
38,"38013",3011,1850,1829,14,21,"CONTIGO",0
37,"37033",94,67,67,0,0,"CONTIGO",0
46,"46212",1620,1130,1112,12,18,"CONTIGO",0
37,"37243",89,66,66,0,0,"CONTIGO",0
37,"37069",981,669,657,3,12,"CONTIGO",1
46,"46159",23038,16719,16596,127,123,"CONTIGO",23
37,"37264",56,39,39,0,0,"CONTIGO",0
46,"46197",1930,1430,1411,11,19,"CONTIGO",0
37,"37368",17,12,11,0,1,"CONTIGO",0
38,"38029",1475,752,744,10,8,"CONTIGO",1
37,"37294",11750,8395,8280,88,115,"CONTIGO",9
37,"37284",317,229,222,2,7,"CONTIGO",0
35,"35007",517,347,345,2,2,"CONTIGO",0
37,"37244",129,97,97,1,0,"CONTIGO",0
46,"46262",206,136,134,1,2,"CONTIGO",0
46,"46046",901,623,609,2,14,"CONTIGO",0
37,"37071",76,64,62,1,2,"CONTIGO",0
37,"37082",733,468,456,7,12,"CONTIGO",0
46,"46152",90,63,63,0,0,"CONTIGO",0
37,"37339",295,219,219,5,0,"CONTIGO",0
37,"37130",173,135,134,2,1,"CONTIGO",0
37,"37139",189,150,148,1,2,"CONTIGO",0
37,"37198",202,147,144,2,3,"CONTIGO",0
37,"37039",279,202,197,2,5,"CONTIGO",0
37,"37174",975,716,705,2,11,"CONTIGO",0
46,"46255",3220,2361,2340,20,21,"CONTIGO",1
37,"37366",40,34,33,2,1,"CONTIGO",0
30,"30002",9701,6794,6717,27,77,"CONTIGO",12
37,"37165",31,22,22,0,0,"CONTIGO",0
37,"37248",150,116,116,1,0,"CONTIGO",0
37,"37192",361,200,198,3,2,"CONTIGO",0
46,"46168",2004,1463,1447,12,16,"CONTIGO",0
37,"37319",88,68,64,2,4,"CONTIGO",0
46,"46032",5719,4297,4262,35,35,"CONTIGO",2
37,"37072",144,121,118,5,3,"CONTIGO",0
30,"30030",321454,235061,233183,1744,1878,"CONTIGO",116
46,"46138",361,289,287,1,2,"CONTIGO",0
46,"46095",580,445,438,5,7,"CONTIGO",0
46,"46209",1903,1406,1383,5,23,"CONTIGO",0
37,"37010",925,645,638,5,7,"CONTIGO",1
46,"46256",7280,4996,4940,32,56,"CONTIGO",2
46,"46093",2151,1652,1640,10,12,"CONTIGO",0
46,"46161",1467,1129,1113,5,16,"CONTIGO",1
37,"37298",170,109,109,0,0,"CONTIGO",1
37,"37310",166,116,115,3,1,"CONTIGO",0
46,"46040",993,745,733,3,12,"CONTIGO",0
37,"37267",177,130,129,0,1,"CONTIGO",0
46,"46010",943,691,681,7,10,"CONTIGO",0
37,"37073",613,448,440,4,8,"CONTIGO",0
37,"37193",362,253,252,4,1,"CONTIGO",0
37,"37121",536,413,403,4,10,"CONTIGO",0
38,"38027",5581,3577,3533,22,44,"CONTIGO",2
37,"37331",186,115,114,2,1,"CONTIGO",0
37,"37299",230,148,147,0,1,"CONTIGO",0
37,"37103",409,295,294,2,1,"CONTIGO",1
37,"37007",391,289,281,7,8,"CONTIGO",0
37,"37204",253,176,173,2,3,"CONTIGO",0
46,"46185",361,301,299,5,2,"CONTIGO",0
37,"37355",159,121,120,1,1,"CONTIGO",0
30,"30015",19344,13502,13347,107,155,"CONTIGO",2
38,"38033",3593,2277,2242,15,35,"CONTIGO",0
37,"37345",150,117,113,0,4,"CONTIGO",0
46,"46213",15499,10610,10482,173,128,"CONTIGO",4
30,"30010",6852,5161,5106,25,55,"CONTIGO",3
35,"35005",1009,680,668,2,12,"CONTIGO",0
37,"37213",83,64,64,0,0,"CONTIGO",0
38,"38038",165135,101564,100807,709,757,"CONTIGO",44
46,"46044",4159,3062,2997,26,65,"CONTIGO",1
46,"46178",5001,3513,3477,26,36,"CONTIGO",5
37,"37144",327,233,233,2,0,"CONTIGO",0
46,"46110",21364,15132,15019,120,113,"CONTIGO",5
37,"37102",375,260,260,4,0,"CONTIGO",0
35,"35011",24859,15025,14833,149,192,"CONTIGO",10
46,"46042",3335,2655,2620,12,35,"CONTIGO",0
37,"37169",177,122,122,0,0,"CONTIGO",0
37,"37056",39,28,28,0,0,"CONTIGO",0
37,"37315",89,65,64,0,1,"CONTIGO",0
37,"37239",203,175,174,2,1,"CONTIGO",1
46,"46012",965,689,675,4,14,"CONTIGO",0
37,"37301",84,64,64,1,0,"CONTIGO",0
46,"46037",1120,891,879,7,12,"CONTIGO",0
37,"37134",209,143,141,3,2,"CONTIGO",0
46,"46121",106,91,90,1,1,"CONTIGO",0
37,"37107",10444,6997,6884,76,113,"CONTIGO",1
37,"37145",236,173,170,3,3,"CONTIGO",0
37,"37338",77,58,58,0,0,"CONTIGO",0
37,"37365",162,125,121,0,4,"CONTIGO",0
37,"37281",39,28,27,0,1,"CONTIGO",0
46,"46167",342,240,239,0,1,"CONTIGO",0
37,"37011",100,78,78,3,0,"CONTIGO",0
37,"37378",92,54,54,0,0,"CONTIGO",1
38,"38046",9267,6652,6594,55,58,"CONTIGO",2
30,"30026",16345,10049,9914,84,135,"CONTIGO",1
37,"37219",169,88,85,1,3,"CONTIGO",0
46,"46241",388,288,283,5,5,"CONTIGO",0
46,"46084",1487,1136,1123,4,13,"CONTIGO",0
37,"37001",165,120,120,0,0,"CONTIGO",0
37,"37104",24,16,16,0,0,"CONTIGO",0
37,"37265",198,167,163,1,4,"CONTIGO",0
46,"46180",659,509,500,7,9,"CONTIGO",0
38,"38901",1466,908,894,4,14,"CONTIGO",1
37,"37238",105,83,80,0,3,"CONTIGO",0
46,"46028",383,305,299,8,6,"CONTIGO",0
37,"37055",117,97,93,0,4,"CONTIGO",0
46,"46097",948,670,663,1,7,"CONTIGO",0
37,"37062",78,59,59,0,0,"CONTIGO",0
37,"37209",415,276,275,2,1,"CONTIGO",0
46,"46029",20448,14673,14556,99,117,"CONTIGO",5
46,"46173",1309,1029,1010,13,19,"CONTIGO",0
46,"46052",515,423,419,4,4,"CONTIGO",2
46,"46234",317,247,245,1,2,"CONTIGO",0
37,"37367",179,147,143,2,4,"CONTIGO",0
37,"37232",377,303,303,2,0,"CONTIGO",0
46,"46176",2077,1362,1348,14,14,"CONTIGO",0
46,"46103",1354,993,978,8,15,"CONTIGO",0
37,"37217",59,43,43,3,0,"CONTIGO",0
37,"37052",287,192,191,2,1,"CONTIGO",0
46,"46106",1471,1033,1028,8,5,"CONTIGO",0
37,"37081",879,680,674,2,6,"CONTIGO",2
46,"46242",326,260,257,3,3,"CONTIGO",0
46,"46098",2405,1778,1751,7,27,"CONTIGO",0
46,"46025",2445,1875,1853,16,22,"CONTIGO",0
37,"37341",47,29,29,0,0,"CONTIGO",0
37,"37320",85,65,64,1,1,"CONTIGO",0
37,"37045",27,19,19,0,0,"CONTIGO",0
46,"46144",628,483,478,4,5,"CONTIGO",0
38,"38011",21655,13974,13831,106,143,"CONTIGO",3
37,"37316",711,546,541,7,5,"CONTIGO",0
37,"37187",548,407,399,0,8,"CONTIGO",0
37,"37034",77,63,62,0,1,"CONTIGO",0
37,"37170",1361,909,884,9,25,"CONTIGO",1
37,"37348",100,76,76,0,0,"CONTIGO",0
46,"46061",351,276,272,6,4,"CONTIGO",0
46,"46104",1906,1422,1409,5,13,"CONTIGO",0
37,"37349",100,61,58,0,3,"CONTIGO",0
46,"46203",3546,2717,2689,28,28,"CONTIGO",2
37,"37119",99,78,78,1,0,"CONTIGO",0
37,"37241",167,121,119,3,2,"CONTIGO",0
46,"46233",3766,2688,2650,14,38,"CONTIGO",1
46,"46142",778,536,524,3,12,"CONTIGO",0
37,"37168",397,271,266,3,5,"CONTIGO",0
37,"37312",244,191,189,1,2,"CONTIGO",0
37,"37364",760,502,500,0,2,"CONTIGO",0
46,"46006",4454,3527,3486,27,41,"CONTIGO",2
38,"38025",7065,4657,4590,34,67,"CONTIGO",0
46,"46130",862,633,625,6,8,"CONTIGO",1
37,"37266",68,44,44,0,0,"CONTIGO",0
37,"37172",846,530,524,6,6,"CONTIGO",0
46,"46062",4552,3402,3362,27,40,"CONTIGO",0
37,"37350",403,281,274,1,7,"CONTIGO",0
37,"37318",196,132,132,0,0,"CONTIGO",0
46,"46027",924,746,737,2,9,"CONTIGO",2
38,"38010",3969,2463,2418,11,45,"CONTIGO",2
37,"37115",108,67,65,0,2,"CONTIGO",0
37,"37358",159,124,124,0,0,"CONTIGO",0
37,"37306",238,140,136,3,4,"CONTIGO",0
46,"46070",17824,12888,12802,106,86,"CONTIGO",11
46,"46141",433,340,337,6,3,"CONTIGO",0
46,"46192",786,534,519,7,15,"CONTIGO",0
37,"37263",339,215,210,0,5,"CONTIGO",0
38,"38037",12817,7582,7494,55,88,"CONTIGO",2
37,"37003",104,75,75,2,0,"CONTIGO",0
46,"46179",2136,1624,1596,17,28,"CONTIGO",0
46,"46063",1786,1270,1255,8,15,"CONTIGO",1
37,"37361",84,55,54,1,1,"CONTIGO",0
46,"46243",124,93,90,1,3,"CONTIGO",0
37,"37369",126,83,81,0,2,"CONTIGO",1
46,"46004",1932,1530,1512,10,18,"CONTIGO",0
37,"37218",51,25,23,0,2,"CONTIGO",0
46,"46205",14237,10641,10533,77,108,"CONTIGO",94
46,"46043",135,119,118,0,1,"CONTIGO",0
46,"46188",693,565,560,2,5,"CONTIGO",0
37,"37015",198,127,125,2,2,"CONTIGO",0
46,"46218",1043,842,829,6,13,"CONTIGO",1
46,"46127",2748,2035,2009,6,26,"CONTIGO",0
46,"46236",929,723,716,2,7,"CONTIGO",0
46,"46165",7349,5460,5412,39,48,"CONTIGO",5
46,"46198",862,670,660,3,10,"CONTIGO",0
46,"46160",1922,1395,1381,4,14,"CONTIGO",0
37,"37304",156,97,96,1,1,"CONTIGO",0
37,"37317",287,211,209,1,2,"CONTIGO",0
37,"37063",58,47,47,0,0,"CONTIGO",0
30,"30004",1129,838,833,1,5,"CONTIGO",0
37,"37262",69,51,51,0,0,"CONTIGO",0
37,"37068",337,240,236,1,4,"CONTIGO",0
38,"38044",2215,1270,1257,5,13,"CONTIGO",0
30,"30008",14560,9974,9840,79,134,"CONTIGO",5
38,"38042",3778,2410,2386,11,24,"CONTIGO",1
46,"46171",16446,11616,11499,94,117,"CONTIGO",8
46,"46080",979,720,712,2,8,"CONTIGO",0
46,"46148",1515,1131,1113,5,18,"CONTIGO",0
37,"37137",98,60,59,2,1,"CONTIGO",0
37,"37099",63,46,46,1,0,"CONTIGO",0
46,"46248",4868,3434,3374,16,60,"CONTIGO",1
37,"37014",1140,747,737,7,10,"CONTIGO",1
46,"46126",5580,4361,4328,36,33,"CONTIGO",0
46,"46254",944,673,661,6,12,"CONTIGO",0
30,"30003",25200,16249,16120,159,129,"CONTIGO",3
37,"37177",259,198,197,3,1,"CONTIGO",0
37,"37328",159,112,110,1,2,"CONTIGO",0
46,"46227",893,687,675,6,12,"CONTIGO",0
37,"37004",25,18,18,0,0,"CONTIGO",0
35,"35014",11962,5994,5888,60,106,"CONTIGO",6
46,"46045",1245,984,961,3,23,"CONTIGO",0
37,"37042",36,27,27,1,0,"CONTIGO",0
46,"46224",156,125,124,0,1,"CONTIGO",0
46,"46008",2617,1954,1931,17,23,"CONTIGO",1
46,"46053",525,433,428,2,5,"CONTIGO",0
46,"46182",1312,908,904,5,4,"CONTIGO",0
46,"46904",812,615,605,2,10,"CONTIGO",1
37,"37327",179,148,147,2,1,"CONTIGO",0
46,"46210",338,256,251,0,5,"CONTIGO",0
37,"37127",205,139,139,1,0,"CONTIGO",0
38,"38014",1342,943,930,6,13,"CONTIGO",0
37,"37231",236,185,183,5,2,"CONTIGO",0
37,"37180",68,45,44,1,1,"CONTIGO",0
37,"37116",70,50,50,0,0,"CONTIGO",0
37,"37059",117,95,95,3,0,"CONTIGO",0
37,"37138",222,163,159,3,4,"CONTIGO",0
46,"46013",17761,13652,13548,144,104,"CONTIGO",11
37,"37274",118296,84144,83280,880,864,"CONTIGO",142
46,"46154",795,619,608,5,11,"CONTIGO",0
37,"37254",174,140,135,0,5,"CONTIGO",1
46,"46091",110,100,100,0,0,"CONTIGO",0
37,"37286",204,140,137,2,3,"CONTIGO",0
46,"46181",16967,11951,11835,98,116,"CONTIGO",6
46,"46123",1926,1392,1368,11,24,"CONTIGO",0
37,"37080",221,164,163,1,1,"CONTIGO",0
30,"30043",25449,18839,18477,180,362,"CONTIGO",3
37,"37289",210,147,144,0,3,"CONTIGO",0
46,"46030",810,641,625,7,16,"CONTIGO",3
37,"37359",165,105,103,0,2,"CONTIGO",0
46,"46068",345,283,279,2,4,"CONTIGO",0
46,"46137",248,201,197,3,4,"CONTIGO",0
30,"30018",8399,6226,6148,28,78,"CONTIGO",3
46,"46195",2000,1540,1532,3,8,"CONTIGO",0
37,"37335",384,282,279,1,3,"CONTIGO",0
37,"37046",10648,7396,7241,62,155,"CONTIGO",5
37,"37005",65,44,44,1,0,"CONTIGO",0
46,"46019",8932,6721,6647,40,74,"CONTIGO",3
37,"37272",132,97,95,0,2,"CONTIGO",0
38,"38052",1283,806,794,3,12,"CONTIGO",1
37,"37079",77,59,59,1,0,"CONTIGO",0
37,"37022",242,191,190,0,1,"CONTIGO",0
37,"37136",625,388,387,7,1,"CONTIGO",0
37,"37256",191,123,123,1,0,"CONTIGO",0
30,"30012",9085,6704,6599,46,105,"CONTIGO",0
38,"38023",126137,79423,78706,605,717,"CONTIGO",54
46,"46099",744,539,535,2,4,"CONTIGO",0
46,"46057",463,308,304,1,4,"CONTIGO",0
46,"46190",50042,35290,35066,284,224,"CONTIGO",24
37,"37077",251,206,204,1,2,"CONTIGO",0
46,"46051",8469,6120,6070,40,50,"CONTIGO",3
46,"46129",511,389,379,9,10,"CONTIGO",0
38,"38035",10518,5870,5819,37,51,"CONTIGO",3
46,"46249",9136,6538,6439,73,99,"CONTIGO",3
30,"30033",10377,7330,7215,59,115,"CONTIGO",2
35,"35008",6214,4193,4143,33,50,"CONTIGO",9
37,"37370",316,238,237,2,1,"CONTIGO",0
37,"37269",424,280,277,2,3,"CONTIGO",0
52,"52001",54293,31015,30776,185,239,"CpM",8927
40,"40174",319,229,227,3,2,"Cs",13
9,"9130",64,39,39,2,0,"Cs",3
5,"5064",101,77,77,0,0,"Cs",3
37,"37376",2130,1446,1423,18,23,"Cs",121
5,"5197",100,82,79,1,3,"Cs",5
37,"37122",203,162,161,3,1,"Cs",12
37,"37070",523,371,365,4,6,"Cs",12
6,"6033",1276,986,972,5,14,"Cs",35
50,"50249",283,202,200,0,2,"Cs",41
24,"24037",330,189,189,1,0,"Cs",6
9,"9117",71,58,58,0,0,"Cs",2
27,"27056",1218,787,778,6,9,"Cs",22
14,"14058",7866,5451,5334,69,117,"Cs",489
19,"19168",265,182,175,4,7,"Cs",9
46,"46252",125,89,86,1,3,"Cs",2
11,"11031",76427,49773,49248,654,525,"Cs",4543
34,"34019",111,87,86,1,1,"Cs",11
47,"47145",583,430,426,6,4,"Cs",24
35,"35028",10156,5483,5425,56,58,"Cs",306
13,"13053",14031,9930,9796,97,134,"Cs",779
12,"12901",3339,2583,2561,25,22,"Cs",215
49,"49225",122,68,68,0,0,"Cs",7
45,"45037",1520,1072,1055,5,17,"Cs",47
20,"20018",11231,7640,7611,33,29,"Cs",31
26,"26132",106,73,70,2,3,"Cs",6
46,"46147",17186,11507,11399,72,108,"Cs",776
49,"49145",208,113,113,1,0,"Cs",4
40,"40094",353,265,263,3,2,"Cs",17
40,"40215",79,66,66,2,0,"Cs",5
29,"29025",41540,27170,26897,271,273,"Cs",2705
42,"42111",274,183,181,0,2,"Cs",9
22,"22090",86,61,61,1,0,"Cs",3
42,"42183",102,74,74,1,0,"Cs",7
3,"3120",2433,1688,1652,13,36,"Cs",103
47,"47123",461,360,358,2,2,"Cs",29
47,"47086",3818,2835,2784,36,51,"Cs",205
6,"6092",558,438,426,2,12,"Cs",29
5,"5264",54,32,31,4,1,"Cs",1
9,"9178",39,24,24,0,0,"Cs",2
22,"22226",761,537,530,13,7,"Cs",44
47,"47144",72,54,53,2,1,"Cs",3
5,"5014",5263,3699,3648,35,51,"Cs",203
45,"45051",1678,1238,1209,13,29,"Cs",57
28,"28047",42984,30772,30486,270,286,"Cs",2909
5,"5218",104,81,79,0,2,"Cs",3
26,"26168",5584,3757,3696,35,61,"Cs",325
46,"46244",59910,42120,41826,338,294,"Cs",3464
18,"18023",15717,10964,10751,132,213,"Cs",1186
40,"40035",135,110,110,2,0,"Cs",11
34,"34018",199,151,149,4,2,"Cs",11
34,"34182",746,558,553,9,5,"Cs",19
13,"13059",193,150,150,0,0,"Cs",5
42,"42088",62,45,44,0,1,"Cs",1
24,"24009",274,136,135,1,1,"Cs",2
37,"37268",106,62,61,1,1,"Cs",9
49,"49191",265,192,188,2,4,"Cs",10
14,"14057",6157,4773,4707,59,66,"Cs",366
22,"22163",426,338,335,0,3,"Cs",30
22,"22107",102,53,53,0,0,"Cs",4
50,"50015",81,57,56,0,1,"Cs",4
21,"21043",1853,1354,1325,23,29,"Cs",79
18,"18119",1708,1264,1240,7,24,"Cs",81
44,"44116",75,58,58,0,0,"Cs",8
10,"10093",387,278,253,4,25,"Cs",8
40,"40205",228,159,157,1,2,"Cs",10
24,"24222",14499,10219,10076,99,143,"Cs",786
26,"26119",178,132,132,0,0,"Cs",6
29,"29017",6404,4575,4468,48,107,"Cs",293
19,"19132",86,65,63,0,2,"Cs",9
48,"48012",2057,1610,1600,1,10,"Cs",9
22,"22189",175,142,142,1,0,"Cs",12
42,"42070",31,23,23,1,0,"Cs",1
12,"12012",2622,2084,2056,12,28,"Cs",112
5,"5132",857,548,539,7,9,"Cs",26
34,"34059",411,304,292,6,12,"Cs",10
18,"18910",710,439,434,1,5,"Cs",19
47,"47094",120,100,100,0,0,"Cs",3
10,"10075",238,150,148,0,2,"Cs",6
9,"9442",368,265,262,1,3,"Cs",11
19,"19008",36,30,30,0,0,"Cs",0
50,"50040",82,66,66,1,0,"Cs",3
4,"4051",404,323,319,2,4,"Cs",28
35,"35015",10752,5289,5222,39,67,"Cs",227
46,"46124",786,638,625,1,13,"Cs",44
50,"50254",179,115,113,0,2,"Cs",10
32,"32085",10584,6687,6611,58,76,"Cs",244
3,"3064",5015,3514,3461,15,53,"Cs",253
44,"44206",100,73,73,3,0,"Cs",2
44,"44027",144,113,113,2,0,"Cs",3
5,"5149",101,72,71,2,1,"Cs",4
24,"24229",376,275,269,2,6,"Cs",15
15,"15031",23868,16113,15954,207,159,"Cs",948
21,"21063",2611,1948,1891,23,57,"Cs",125
21,"21001",621,431,418,0,13,"Cs",12
18,"18149",5408,3926,3859,42,67,"Cs",368
22,"22209",161,121,121,3,0,"Cs",5
16,"16096",278,219,217,1,2,"Cs",4
37,"37039",279,202,197,2,5,"Cs",19
10,"10146",1494,924,903,1,21,"Cs",42
1,"1042",911,680,671,8,9,"Cs",1
40,"40099",54,44,42,0,2,"Cs",2
46,"46006",4454,3527,3486,27,41,"Cs",217
9,"9044",55,46,44,1,2,"Cs",8
16,"16085",131,106,106,0,0,"Cs",6
45,"45136",5827,3908,3864,22,44,"Cs",253
46,"46255",3220,2361,2340,20,21,"Cs",124
49,"49149",368,270,266,1,4,"Cs",11
34,"34157",2353,1697,1669,18,28,"Cs",75
14,"14002",10895,7599,7479,109,120,"Cs",491
37,"37177",259,198,197,3,1,"Cs",31
49,"49055",91,72,72,3,0,"Cs",5
40,"40015",23,19,19,0,0,"Cs",0
32,"32020",2428,1728,1714,10,14,"Cs",24
9,"9306",94,69,69,1,0,"Cs",6
11,"11033",21804,13361,13133,213,228,"Cs",1166
45,"45107",3463,2621,2585,23,36,"Cs",225
9,"9027",47,38,34,1,4,"Cs",1
28,"28005",136518,101397,100485,871,912,"Cs",9359
50,"50113",587,471,461,2,10,"Cs",16
40,"40219",573,382,366,5,16,"Cs",45
40,"40089",209,155,148,2,7,"Cs",10
12,"12089",4555,3070,3045,22,25,"Cs",164
44,"44200",39,26,26,0,0,"Cs",0
49,"49075",130,100,97,1,3,"Cs",1
42,"42117",129,98,95,1,3,"Cs",6
16,"16115",49,32,32,0,0,"Cs",3
16,"16158",513,371,366,5,5,"Cs",18
47,"47117",287,199,197,6,2,"Cs",15
49,"49066",437,276,272,2,4,"Cs",8
41,"41088",515,368,358,2,10,"Cs",14
42,"42052",16,14,14,0,0,"Cs",0
4,"4059",1000,676,666,3,10,"Cs",37
46,"46241",388,288,283,5,5,"Cs",13
45,"45205",7438,4772,4701,27,71,"Cs",378
37,"37296",297,215,210,0,5,"Cs",8
22,"22106",20,13,13,2,0,"Cs",0
9,"9011",70,42,40,0,2,"Cs",3
22,"22117",2384,1606,1596,18,10,"Cs",126
32,"32064",453,304,302,0,2,"Cs",13
34,"34096",48,39,38,0,1,"Cs",2
30,"30042",2218,1645,1625,10,20,"Cs",71
28,"28174",1858,1284,1273,1,11,"Cs",108
24,"24014",7152,4494,4448,47,46,"Cs",258
47,"47065",820,608,602,2,6,"Cs",28
42,"42184",55,36,33,0,3,"Cs",1
44,"44168",181,119,117,1,2,"Cs",3
27,"27002",1535,990,968,13,22,"Cs",24
18,"18030",566,382,380,2,2,"Cs",32
9,"9454",41,34,33,1,1,"Cs",3
50,"50160",2140,1421,1394,14,27,"Cs",69
29,"29031",1555,1015,986,6,29,"Cs",49
28,"28049",57814,44977,44559,385,418,"Cs",4018
37,"37113",404,286,285,13,1,"Cs",10
47,"47080",33,25,24,0,1,"Cs",2
24,"24057",1295,909,891,7,18,"Cs",61
16,"16205",106,73,73,1,0,"Cs",3
36,"36044",2527,1535,1499,12,36,"Cs",74
9,"9043",172,112,111,1,1,"Cs",9
47,"47218",981,728,723,4,5,"Cs",39
21,"21062",1403,849,838,10,11,"Cs",98
4,"4904",1900,1308,1299,4,9,"Cs",64
18,"18034",484,345,342,3,3,"Cs",9
20,"20904",87,56,55,1,1,"Cs",0
48,"48003",14518,10375,10310,49,65,"Cs",63
24,"24025",283,190,185,3,5,"Cs",9
32,"32067",1189,696,692,4,4,"Cs",19
49,"49134",158,100,99,1,1,"Cs",5
3,"3115",255,213,213,3,0,"Cs",8
34,"34081",60,45,44,0,1,"Cs",0
41,"41029",13520,9849,9663,134,186,"Cs",778
19,"19286",772,585,575,3,10,"Cs",42
20,"20055",17300,11784,11725,43,59,"Cs",78
19,"19009",263,186,184,0,2,"Cs",7
37,"37041",71,53,53,0,0,"Cs",5
42,"42084",20,15,15,0,0,"Cs",0
19,"19270",14,13,13,0,0,"Cs",0
23,"23902",2219,1813,1770,6,43,"Cs",58
48,"48908",250,212,210,1,2,"Cs",2
42,"42207",48,42,41,0,1,"Cs",3
16,"16019",187,141,141,1,0,"Cs",6
5,"5035",92,68,68,0,0,"Cs",6
47,"47022",59,52,48,1,4,"Cs",3
5,"5063",31,26,26,0,0,"Cs",2
19,"19038",19,16,15,0,1,"Cs",0
46,"46066",1274,972,970,4,2,"Cs",57
16,"16195",458,343,338,0,5,"Cs",15
37,"37032",553,388,388,2,0,"Cs",42
37,"37065",276,167,167,2,0,"Cs",5
29,"29003",916,677,666,4,11,"Cs",45
45,"45100",178,141,138,0,3,"Cs",3
37,"37184",289,178,177,1,1,"Cs",15
22,"22027",311,210,209,1,1,"Cs",15
42,"42196",7,7,7,1,0,"Cs",0
50,"50296",385,240,235,3,5,"Cs",32
9,"9337",113,80,77,2,3,"Cs",4
12,"12069",50,38,38,0,0,"Cs",4
2,"2021",1013,806,798,6,8,"Cs",31
28,"28117",99,87,86,0,1,"Cs",7
33,"33034",9979,5937,5873,64,64,"Cs",363
41,"41032",3842,2800,2704,24,96,"Cs",241
2,"2003",134196,96374,95521,913,853,"Cs",8711
16,"16142",119,90,90,0,0,"Cs",1
50,"50030",197,124,124,1,0,"Cs",3
41,"41035",1051,733,722,10,11,"Cs",30
44,"44003",17,15,15,0,0,"Cs",1
37,"37311",201,157,156,1,1,"Cs",13
4,"4062",4457,3241,3197,22,44,"Cs",174
40,"40019",29,23,23,1,0,"Cs",3
22,"22133",108,71,71,3,0,"Cs",2
15,"15048",5087,3426,3383,40,43,"Cs",151
47,"47045",732,558,549,3,9,"Cs",14
23,"23095",8571,6159,6101,37,58,"Cs",338
42,"42177",61,42,41,0,1,"Cs",1
37,"37272",132,97,95,0,2,"Cs",7
9,"9174",768,536,522,6,14,"Cs",51
44,"44107",212,135,135,0,0,"Cs",7
2,"2040",548,476,474,1,2,"Cs",27
48,"48027",22745,16240,16158,74,82,"Cs",149
44,"44156",47,31,31,0,0,"Cs",1
42,"42089",57,44,43,0,1,"Cs",1
3,"3022",140,125,121,1,4,"Cs",5
3,"3039",89,65,65,0,0,"Cs",5
24,"24162",1753,1259,1245,12,14,"Cs",91
37,"37157",76,64,63,1,1,"Cs",8
22,"22050",93,77,77,0,0,"Cs",4
34,"34245",307,212,212,0,0,"Cs",18
19,"19117",1632,1187,1167,12,20,"Cs",81
1,"1056",202,107,107,0,0,"Cs",0
6,"6041",456,329,321,2,8,"Cs",15
9,"9366",76,55,55,2,0,"Cs",6
18,"18108",822,604,599,2,5,"Cs",29
27,"27028",78725,52642,51965,642,677,"Cs",2112
45,"45066",7815,5540,5447,25,93,"Cs",313
13,"13013",7056,5041,4945,52,96,"Cs",342
40,"40906",2149,1701,1662,18,39,"Cs",194
9,"9326",156,111,110,1,1,"Cs",14
9,"9104",49,35,34,0,1,"Cs",1
9,"9229",178,127,127,1,0,"Cs",8
36,"36020",2172,1435,1418,19,17,"Cs",60
24,"24081",121,72,72,0,0,"Cs",1
49,"49236",71,54,54,0,0,"Cs",9
26,"26145",239,194,187,3,7,"Cs",10
28,"28163",429,332,326,0,6,"Cs",19
44,"44173",103,81,79,0,2,"Cs",9
18,"18036",3986,2956,2917,22,39,"Cs",252
19,"19059",73,47,47,0,0,"Cs",6
34,"34067",129,80,78,1,2,"Cs",4
23,"23059",5736,4245,4119,51,126,"Cs",289
50,"50102",815,594,584,7,10,"Cs",43
50,"50151",607,450,449,12,1,"Cs",30
45,"45072",653,469,462,1,7,"Cs",20
24,"24064",1501,1030,1012,2,18,"Cs",53
5,"5253",75,54,54,0,0,"Cs",4
49,"49012",70,34,34,0,0,"Cs",2
9,"9332",137,93,91,2,2,"Cs",13
20,"20016",1529,887,883,3,4,"Cs",6
37,"37025",245,198,196,5,2,"Cs",11
2,"2032",259,183,178,2,5,"Cs",4
41,"41087",10557,7217,7029,67,188,"Cs",551
6,"6119",674,516,511,1,5,"Cs",35
5,"5182",721,457,436,3,21,"Cs",23
27,"27057",11047,7078,6941,64,137,"Cs",257
2,"2039",945,745,734,8,11,"Cs",31
24,"24080",207,155,154,1,1,"Cs",13
9,"9110",77,50,50,0,0,"Cs",0
39,"39072",325,184,182,0,2,"Cs",4
12,"12120",149,125,121,3,4,"Cs",3
10,"10177",1702,1241,1186,10,55,"Cs",143
15,"15001",4697,3069,3022,45,47,"Cs",170
5,"5017",84,70,67,2,3,"Cs",0
50,"50143",541,373,367,2,6,"Cs",29
37,"37129",248,181,181,1,0,"Cs",13
40,"40120",195,169,163,0,6,"Cs",12
30,"30024",60389,42200,41831,281,369,"Cs",2535
46,"46121",106,91,90,1,1,"Cs",10
35,"35021",15072,9791,9696,80,95,"Cs",707
18,"18053",1554,1001,985,9,16,"Cs",68
46,"46105",16126,10958,10847,76,111,"Cs",805
47,"47182",1328,940,934,8,6,"Cs",104
44,"44093",78,62,61,0,1,"Cs",3
45,"45050",505,338,332,2,6,"Cs",20
39,"39050",260,164,164,1,0,"Cs",6
6,"6143",3389,2430,2371,24,59,"Cs",128
45,"45185",7573,5422,5320,31,102,"Cs",389
2,"2005",554,426,419,8,7,"Cs",23
40,"40001",708,544,536,3,8,"Cs",41
7,"7024",7283,3574,3538,36,36,"Cs",221
9,"9463",246,174,174,4,0,"Cs",8
9,"9190",86,58,54,2,4,"Cs",2
41,"41904",1789,1125,1109,31,16,"Cs",31
49,"49011",214,147,146,5,1,"Cs",9
47,"47098",567,452,446,4,6,"Cs",33
19,"19232",56,40,40,0,0,"Cs",3
28,"28132",12197,8622,8537,75,85,"Cs",661
3,"3096",5786,4355,4281,38,74,"Cs",344
2,"2030",2949,2158,2122,16,36,"Cs",110
20,"20056",4077,2796,2781,12,15,"Cs",9
2,"2036",93,66,66,0,0,"Cs",1
26,"26170",423,303,301,2,2,"Cs",17
33,"33057",1525,1005,988,17,17,"Cs",55
26,"26175",47,40,38,1,2,"Cs",2
9,"9439",1061,801,790,2,11,"Cs",78
19,"19309",20,15,14,0,1,"Cs",1
24,"24146",254,202,201,1,1,"Cs",2
7,"7039",5019,3066,3017,23,49,"Cs",217
9,"9281",136,97,97,2,0,"Cs",14
22,"22018",303,216,215,3,1,"Cs",12
37,"37131",175,125,125,0,0,"Cs",9
7,"7010",5078,3353,3318,30,35,"Cs",218
46,"46093",2151,1652,1640,10,12,"Cs",88
44,"44133",15,12,12,0,0,"Cs",0
19,"19293",1945,1402,1388,19,14,"Cs",123
42,"42075",78,50,50,1,0,"Cs",0
12,"12072",1083,852,827,10,25,"Cs",32
45,"45062",1075,816,808,11,8,"Cs",40
47,"47225",73,61,59,1,2,"Cs",2
2,"2077",52,41,41,0,0,"Cs",1
47,"47059",94,64,64,0,0,"Cs",10
33,"33044",177059,121380,120421,1543,959,"Cs",9789
47,"47168",30,26,26,1,0,"Cs",0
40,"40234",375,278,269,3,9,"Cs",24
2,"2028",111,81,81,0,0,"Cs",0
39,"39053",212,133,133,4,0,"Cs",3
10,"10164",707,391,382,4,9,"Cs",21
40,"40194",39173,28641,28260,353,381,"Cs",2296
13,"13003",448,329,319,1,10,"Cs",8
44,"44239",21,19,19,0,0,"Cs",0
18,"18040",237,146,145,0,1,"Cs",7
2,"2024",3361,2444,2411,24,33,"Cs",161
44,"44039",204,144,143,1,1,"Cs",7
5,"5201",497,404,401,0,3,"Cs",28
6,"6090",827,570,553,3,17,"Cs",45
24,"24058",189,115,114,1,1,"Cs",0
39,"39036",965,707,703,4,4,"Cs",31
10,"10125",859,561,546,3,15,"Cs",26
5,"5145",43,28,28,0,0,"Cs",2
12,"12057",572,456,437,1,19,"Cs",27
6,"6902",1651,1198,1174,19,24,"Cs",98
9,"9253",101,77,76,0,1,"Cs",9
10,"10069",786,566,554,3,12,"Cs",24
46,"46225",351,267,262,1,5,"Cs",11
5,"5177",136,117,116,0,1,"Cs",5
2,"2081",18287,12910,12675,130,235,"Cs",813
37,"37271",349,262,258,2,4,"Cs",14
44,"44218",28,24,24,3,0,"Cs",0
15,"15901",3334,1948,1928,27,20,"Cs",60
26,"26081",15,14,14,1,0,"Cs",0
37,"37218",51,25,23,0,2,"Cs",1
5,"5265",83,59,58,1,1,"Cs",2
47,"47157",490,398,397,2,1,"Cs",19
33,"33037",33074,20693,20412,259,281,"Cs",923
16,"16051",128,96,96,3,0,"Cs",1
50,"50150",624,387,384,2,3,"Cs",30
26,"26141",98,70,70,0,0,"Cs",6
18,"18074",265,205,205,0,0,"Cs",12
30,"30009",12728,9487,9365,46,122,"Cs",537
23,"23006",4582,3536,3461,43,75,"Cs",192
18,"18134",6104,4049,3972,39,77,"Cs",301
47,"47204",235,159,157,3,2,"Cs",0
34,"34181",422,289,285,0,4,"Cs",9
37,"37058",56,38,38,1,0,"Cs",1
20,"20078",1143,819,816,1,3,"Cs",1
40,"40173",140,120,118,2,2,"Cs",14
32,"32043",2497,1607,1582,14,25,"Cs",72
42,"42008",54,41,41,0,0,"Cs",0
47,"47162",70,57,57,2,0,"Cs",6
13,"13041",236,155,155,3,0,"Cs",7
21,"21038",1082,688,676,4,12,"Cs",27
3,"3023",1377,1138,1122,9,16,"Cs",66
48,"48906",736,550,548,2,2,"Cs",4
9,"9100",55,33,33,0,0,"Cs",0
3,"3057",174,138,136,0,2,"Cs",11
37,"37171",396,272,270,2,2,"Cs",13
46,"46069",152,112,111,1,1,"Cs",3
13,"13058",4026,2822,2766,29,56,"Cs",128
24,"24190",146,103,103,2,0,"Cs",2
40,"40901",413,320,315,7,5,"Cs",27
19,"19031",8,8,8,0,0,"Cs",0
37,"37293",102,68,68,1,0,"Cs",2
49,"49209",451,274,269,7,5,"Cs",11
50,"50273",33,24,24,1,0,"Cs",0
10,"10155",1073,735,717,6,18,"Cs",34
44,"44215",167,113,113,2,0,"Cs",8
24,"24129",114,79,78,2,1,"Cs",6
10,"10117",238,133,130,0,3,"Cs",2
12,"12104",6843,5181,5111,32,70,"Cs",336
47,"47126",42,35,35,1,0,"Cs",1
28,"28113",36951,27912,27604,241,308,"Cs",2603
46,"46035",6828,5155,5089,33,66,"Cs",314
37,"37121",536,413,403,4,10,"Cs",27
37,"37017",226,169,168,4,1,"Cs",18
44,"44085",49,29,29,0,0,"Cs",0
27,"27034",1010,565,558,3,7,"Cs",7
45,"45022",395,292,292,2,0,"Cs",10
42,"42193",14,7,7,0,0,"Cs",0
19,"19032",145,94,93,2,1,"Cs",2
44,"44048",52,47,47,0,0,"Cs",1
12,"12121",1043,878,856,5,22,"Cs",21
37,"37038",756,531,517,4,14,"Cs",32
26,"26109",73,68,68,0,0,"Cs",0
9,"9415",275,178,178,3,0,"Cs",23
19,"19231",10,6,6,0,0,"Cs",0
34,"34091",118,82,82,1,0,"Cs",3
27,"27046",1444,945,921,7,24,"Cs",28
19,"19136",11,10,10,0,0,"Cs",0
9,"9068",23,16,16,0,0,"Cs",0
47,"47051",324,261,258,6,3,"Cs",14
40,"40078",150,123,123,6,0,"Cs",9
11,"11012",97338,67120,66466,861,654,"Cs",5331
9,"9105",95,65,64,1,1,"Cs",5
24,"24054",410,275,271,0,4,"Cs",10
32,"32012",708,448,440,2,8,"Cs",11
24,"24201",1029,683,676,9,7,"Cs",37
47,"47081",39,32,32,0,0,"Cs",2
19,"19067",68,46,44,0,2,"Cs",0
46,"46221",348,292,290,1,2,"Cs",15
24,"24002",224,165,162,1,3,"Cs",11
22,"22019",176,128,126,1,2,"Cs",7
50,"50092",290,218,214,0,4,"Cs",17
29,"29029",383,256,254,4,2,"Cs",4
37,"37008",4213,3092,3046,21,46,"Cs",218
19,"19106",77,57,57,0,0,"Cs",4
28,"28038",5213,3801,3753,24,48,"Cs",303
12,"12061",374,263,261,4,2,"Cs",15
44,"44121",52,42,42,1,0,"Cs",1
33,"33062",385,194,187,4,7,"Cs",8
50,"50276",118,91,91,0,0,"Cs",6
49,"49243",107,74,74,0,0,"Cs",10
32,"32022",1238,840,835,10,5,"Cs",24
7,"7053",1209,870,864,10,6,"Cs",40
21,"21078",2641,1718,1670,10,48,"Cs",91
39,"39009",3325,2306,2293,7,13,"Cs",112
4,"4017",1276,833,818,4,15,"Cs",75
19,"19279",54,42,42,0,0,"Cs",1
35,"35027",10502,6831,6750,67,81,"Cs",342
50,"50019",63,46,46,0,0,"Cs",1
22,"22217",370,274,269,4,5,"Cs",24
9,"9270",157,112,109,2,3,"Cs",14
22,"22250",346,241,241,0,0,"Cs",28
28,"28041",4805,3666,3634,38,32,"Cs",466
44,"44203",9,9,9,0,0,"Cs",0
33,"33025",8956,5493,5453,81,40,"Cs",369
34,"34230",16,11,11,0,0,"Cs",1
47,"47116",396,304,302,2,2,"Cs",20
45,"45042",172,122,121,0,1,"Cs",1
46,"46248",4868,3434,3374,16,60,"Cs",214
2,"2051",1654,1115,1101,13,14,"Cs",77
3,"3063",27209,18236,18101,164,135,"Cs",1517
5,"5193",179,140,139,2,1,"Cs",4
50,"50902",77,65,62,0,3,"Cs",4
49,"49244",46,23,23,0,0,"Cs",1
5,"5904",108,70,69,5,1,"Cs",2
29,"29077",207,135,134,1,1,"Cs",4
3,"3045",216,176,172,1,4,"Cs",5
9,"9239",47,31,31,0,0,"Cs",3
16,"16212",233,186,184,0,2,"Cs",6
26,"26128",94,71,71,1,0,"Cs",2
37,"37282",193,132,131,3,1,"Cs",11
46,"46021",24053,17331,17194,159,137,"Cs",1411
46,"46219",125,107,104,0,3,"Cs",5
9,"9265",38,31,31,1,0,"Cs",0
46,"46902",352,283,283,0,0,"Cs",16
49,"49174",127,86,85,1,1,"Cs",7
50,"50041",16,10,10,0,0,"Cs",0
16,"16149",147,105,105,2,0,"Cs",5
46,"46108",420,328,324,1,4,"Cs",15
6,"6056",447,351,340,2,11,"Cs",3
19,"19179",74,64,64,3,0,"Cs",1
50,"50053",643,476,466,3,10,"Cs",24
3,"3021",5573,4423,4343,23,80,"Cs",278
7,"7061",9451,5735,5666,60,69,"Cs",399
23,"23073",4363,3214,3176,24,38,"Cs",216
39,"39018",4284,3211,3177,22,34,"Cs",175
37,"37361",84,55,54,1,1,"Cs",5
46,"46235",21229,15171,15011,126,160,"Cs",974
34,"34071",158,128,128,2,0,"Cs",3
35,"35022",51765,29309,29034,184,275,"Cs",1497
42,"42162",2298,1493,1462,18,31,"Cs",92
47,"47181",165,136,135,1,1,"Cs",11
24,"24170",1806,1232,1220,9,12,"Cs",59
39,"39093",297,216,214,1,2,"Cs",4
33,"33047",1068,771,759,9,12,"Cs",12
37,"37014",1140,747,737,7,10,"Cs",58
10,"10005",527,325,301,1,24,"Cs",24
30,"30902",8294,5235,5174,29,61,"Cs",339
15,"15081",976,713,695,4,18,"Cs",10
44,"44177",101,68,68,1,0,"Cs",1
40,"40086",656,513,496,7,17,"Cs",27
28,"28131",13510,9647,9544,89,103,"Cs",831
5,"5263",162,117,115,1,2,"Cs",6
22,"22187",288,220,220,2,0,"Cs",18
44,"44148",74,56,54,0,2,"Cs",1
19,"19334",43,35,35,0,0,"Cs",0
37,"37150",34,31,31,0,0,"Cs",1
6,"6139",498,402,395,4,7,"Cs",11
18,"18028",898,723,718,3,5,"Cs",26
16,"16056",442,275,270,4,5,"Cs",14
37,"37178",98,70,70,0,0,"Cs",2
40,"40055",31,26,26,0,0,"Cs",0
18,"18054",820,573,569,2,4,"Cs",31
5,"5135",399,294,292,2,2,"Cs",12
10,"10104",5123,3470,3396,21,74,"Cs",237
45,"45134",1622,1187,1177,8,10,"Cs",64
22,"22047",248,202,201,1,1,"Cs",15
14,"14022",3881,2888,2853,15,35,"Cs",130
2,"2001",687,513,505,1,8,"Cs",13
33,"33006",1476,862,857,9,5,"Cs",26
40,"40132",45,26,25,0,1,"Cs",2
16,"16141",131,98,96,1,2,"Cs",2
50,"50129",212,129,127,0,2,"Cs",25
44,"44005",48,36,36,0,0,"Cs",3
5,"5199",37,31,31,0,0,"Cs",1
13,"13097",2186,1592,1574,5,18,"Cs",85
26,"26174",134,100,99,3,1,"Cs",1
28,"28048",514,386,384,4,2,"Cs",20
9,"9021",50,30,30,3,0,"Cs",4
50,"50244",192,131,130,1,1,"Cs",17
36,"36040",2505,1597,1563,15,34,"Cs",58
5,"5189",397,293,291,3,2,"Cs",7
24,"24123",709,461,457,2,4,"Cs",22
45,"45038",3528,2556,2521,26,35,"Cs",245
24,"24173",896,590,583,2,7,"Cs",27
34,"34107",73,47,46,1,1,"Cs",2
39,"39097",666,342,335,2,7,"Cs",8
50,"50128",26,23,23,0,0,"Cs",2
2,"2058",300,186,177,1,9,"Cs",7
9,"9345",111,87,86,2,1,"Cs",3
22,"22079",118,85,84,1,1,"Cs",3
12,"12007",724,622,614,2,8,"Cs",19
41,"41039",31538,22078,21717,278,361,"Cs",1925
26,"26136",90,65,64,2,1,"Cs",2
37,"37373",692,451,442,4,9,"Cs",29
9,"9216",370,245,241,3,4,"Cs",10
19,"19262",125,98,98,0,0,"Cs",5
24,"24125",416,233,231,3,2,"Cs",20
19,"19006",755,506,494,4,12,"Cs",30
34,"34242",91,65,62,2,3,"Cs",4
20,"20023",441,254,251,1,3,"Cs",0
29,"29069",87188,54019,53240,633,779,"Cs",4608
5,"5038",114,83,82,0,1,"Cs",4
42,"42154",103,76,76,1,0,"Cs",9
5,"5232",104,86,83,1,3,"Cs",0
45,"45122",5605,4321,4288,33,33,"Cs",346
2,"2078",891,650,642,4,8,"Cs",25
18,"18906",903,641,639,2,2,"Cs",24
3,"3077",1391,1052,1032,10,20,"Cs",64
13,"13081",584,412,405,0,7,"Cs",17
24,"24198",541,346,344,6,2,"Cs",22
33,"33049",5973,3569,3518,48,51,"Cs",177
47,"47079",55,44,43,1,1,"Cs",4
19,"19274",953,693,676,9,17,"Cs",45
4,"4021",179,132,129,2,3,"Cs",7
10,"10136",274,205,202,1,3,"Cs",19
12,"12123",40,32,32,0,0,"Cs",0
41,"41040",11183,8351,8253,71,98,"Cs",793
45,"45114",549,400,394,1,6,"Cs",23
1,"1031",1136,844,830,1,14,"Cs",15
50,"50204",2396,1723,1712,17,11,"Cs",120
39,"39099",3193,2363,2346,10,17,"Cs",83
5,"5085",31,27,27,0,0,"Cs",2
47,"47158",859,618,608,4,10,"Cs",28
41,"41004",57692,38578,37814,696,764,"Cs",3276
44,"44163",115,79,78,0,1,"Cs",0
19,"19023",119,87,85,0,2,"Cs",7
12,"12074",756,611,601,3,10,"Cs",21
38,"38011",21655,13974,13831,106,143,"Cs",784
48,"48074",3275,2308,2295,11,13,"Cs",15
33,"33035",11214,7359,7303,102,56,"Cs",523
40,"40093",74,62,62,1,0,"Cs",9
6,"6118",155,114,112,0,2,"Cs",3
36,"36024",16335,11431,11256,99,175,"Cs",511
41,"41005",9285,6637,6497,83,140,"Cs",507
24,"24168",430,325,322,6,3,"Cs",10
9,"9013",42,32,32,0,0,"Cs",1
34,"34163",46,37,37,0,0,"Cs",0
42,"42053",21,17,17,0,0,"Cs",0
10,"10016",329,242,232,2,10,"Cs",15
48,"48037",696,497,485,0,12,"Cs",1
37,"37283",116,83,83,0,0,"Cs",5
36,"36060",30431,19909,19673,206,236,"Cs",899
12,"12052",537,409,398,5,11,"Cs",15
34,"34155",122,95,95,0,0,"Cs",5
44,"44010",185,144,143,0,1,"Cs",10
49,"49031",148,107,105,2,2,"Cs",6
13,"13091",537,466,464,3,2,"Cs",16
10,"10096",3311,2248,2201,15,47,"Cs",136
42,"42032",138,96,96,0,0,"Cs",4
48,"48073",6827,4614,4591,38,23,"Cs",9
30,"30001",4507,3357,3331,17,26,"Cs",148
50,"50027",223,166,161,2,5,"Cs",13
47,"47089",133,111,111,2,0,"Cs",9
23,"23027",711,547,539,5,8,"Cs",29
48,"48049",543,415,414,1,1,"Cs",1
19,"19088",91,67,66,0,1,"Cs",5
27,"27020",3365,2544,2500,42,44,"Cs",39
9,"9133",38,33,33,0,0,"Cs",1
33,"33028",1143,519,518,7,1,"Cs",23
9,"9077",26,21,21,0,0,"Cs",4
35,"35007",517,347,345,2,2,"Cs",12
46,"46083",15372,10939,10815,78,124,"Cs",685
23,"23070",3813,2384,2354,11,30,"Cs",147
34,"34116",54,35,35,0,0,"Cs",1
2,"2043",1165,872,858,6,14,"Cs",41
10,"10182",122,81,81,0,0,"Cs",1
40,"40162",380,273,265,1,8,"Cs",17
40,"40063",6913,4948,4838,57,110,"Cs",345
9,"9243",73,50,49,1,1,"Cs",2
46,"46213",15499,10610,10482,173,128,"Cs",887
24,"24061",1753,1234,1223,10,11,"Cs",81
5,"5123",106,78,78,0,0,"Cs",8
9,"9302",96,66,66,0,0,"Cs",6
12,"12041",92,69,69,2,0,"Cs",5
24,"24148",1602,1152,1140,11,12,"Cs",61
22,"22054",1614,1029,1009,19,20,"Cs",93
37,"37097",42,29,29,0,0,"Cs",3
37,"37379",169,133,132,0,1,"Cs",10
26,"26106",79,67,67,0,0,"Cs",2
22,"22076",285,207,203,4,4,"Cs",12
34,"34904",300,188,186,0,2,"Cs",8
44,"44087",67,52,50,0,2,"Cs",2
38,"38016",1174,595,589,2,6,"Cs",10
2,"2079",2807,2000,1978,17,22,"Cs",78
22,"22239",85,67,65,0,2,"Cs",2
38,"38024",15316,9131,9005,60,126,"Cs",495
50,"50286",75,54,53,0,1,"Cs",2
22,"22125",39530,27358,27075,344,283,"Cs",2302
50,"50278",175,133,131,2,2,"Cs",11
33,"33058",1668,1050,1035,13,15,"Cs",53
46,"46032",5719,4297,4262,35,35,"Cs",295
9,"9228",155,129,129,0,0,"Cs",8
47,"47187",71,49,49,0,0,"Cs",3
48,"48054",25063,17705,17597,122,108,"Cs",245
50,"50209",2785,1893,1865,24,28,"Cs",160
24,"24112",288,188,186,2,2,"Cs",10
9,"9137",187,129,127,0,2,"Cs",14
24,"24224",564,381,375,5,6,"Cs",19
44,"44092",70,53,52,0,1,"Cs",3
3,"3069",3329,2102,2077,11,25,"Cs",156
11,"11901",5739,3759,3686,99,73,"Cs",234
12,"12043",570,405,397,1,8,"Cs",6
19,"19150",116,89,89,0,0,"Cs",4
15,"15002",24040,16302,16117,183,185,"Cs",984
19,"19054",161,136,135,3,1,"Cs",3
16,"16111",168,114,111,2,3,"Cs",7
5,"5256",110,88,86,1,2,"Cs",5
50,"50236",95,77,75,0,2,"Cs",1
2,"2069",11401,8055,7975,30,80,"Cs",587
37,"37362",4783,3469,3420,44,49,"Cs",424
20,"20073",4707,3272,3260,14,12,"Cs",20
19,"19020",46,31,31,0,0,"Cs",4
28,"28102",880,639,621,7,18,"Cs",30
6,"6159",2329,1297,1273,22,24,"Cs",67
44,"44105",68,53,53,0,0,"Cs",2
19,"19021",978,678,662,3,16,"Cs",35
19,"19055",44,32,31,2,1,"Cs",2
34,"34093",83,61,60,0,1,"Cs",4
10,"10161",81,50,50,0,0,"Cs",1
46,"46186",19689,14688,14576,118,112,"Cs",1190
32,"32049",683,375,372,3,3,"Cs",5
9,"9352",102,74,74,0,0,"Cs",10
48,"48075",2066,1524,1508,9,16,"Cs",3
27,"27038",923,624,619,8,5,"Cs",12
45,"45049",419,303,295,1,8,"Cs",18
49,"49069",337,210,201,0,9,"Cs",14
34,"34185",69,36,35,0,1,"Cs",1
7,"7060",2713,1796,1772,17,24,"Cs",75
40,"40123",141,98,94,4,4,"Cs",11
23,"23005",29876,20565,20268,254,297,"Cs",1443
36,"36053",5783,3955,3899,39,56,"Cs",134
34,"34159",375,221,214,4,7,"Cs",9
45,"45196",1382,1029,1005,7,24,"Cs",54
22,"22200",239,165,164,2,1,"Cs",13
40,"40092",105,75,75,2,0,"Cs",6
34,"34127",80,62,62,0,0,"Cs",2
46,"46187",1292,924,920,4,4,"Cs",48
34,"34129",168,118,118,1,0,"Cs",6
9,"9143",28,17,17,0,0,"Cs",0
5,"5259",99,80,79,2,1,"Cs",2
28,"28001",70,48,47,1,1,"Cs",3
13,"13051",336,253,249,1,4,"Cs",17
5,"5096",76,62,62,0,0,"Cs",0
45,"45127",775,510,502,1,8,"Cs",23
19,"19058",7458,5705,5663,40,42,"Cs",501
46,"46119",761,587,580,6,7,"Cs",27
21,"21058",2567,1806,1766,32,40,"Cs",94
45,"45103",363,286,283,0,3,"Cs",5
42,"42051",15,9,9,0,0,"Cs",0
5,"5030",40,32,32,0,0,"Cs",1
29,"29013",1613,1191,1154,9,37,"Cs",62
49,"49033",655,440,434,4,6,"Cs",30
18,"18065",588,464,451,2,13,"Cs",25
34,"34161",22,12,12,0,0,"Cs",0
44,"44097",126,76,73,0,3,"Cs",17
45,"45080",3,3,3,0,0,"Cs",0
19,"19245",1138,798,778,6,20,"Cs",46
34,"34006",79,73,69,2,4,"Cs",4
14,"14008",2758,1880,1836,21,44,"Cs",126
18,"18911",7933,5464,5348,53,116,"Cs",519
16,"16081",50,37,36,0,1,"Cs",3
13,"13902",449,329,326,4,3,"Cs",25
42,"42026",28,25,25,0,0,"Cs",2
22,"22023",385,293,283,2,10,"Cs",22
24,"24007",735,500,496,8,4,"Cs",19
28,"28144",6525,5032,4987,39,45,"Cs",472
2,"2049",778,506,496,1,10,"Cs",16
1,"1010",2315,1705,1688,6,17,"Cs",7
2,"2016",528,353,352,4,1,"Cs",18
34,"34074",690,502,490,13,12,"Cs",30
21,"21044",18061,11170,11003,123,167,"Cs",727
50,"50134",120,85,82,4,3,"Cs",6
16,"16038",27,20,20,0,0,"Cs",0
26,"26068",78,61,61,0,0,"Cs",4
37,"37348",100,76,76,0,0,"Cs",3
18,"18089",14504,9854,9746,100,108,"Cs",616
10,"10059",329,202,201,1,1,"Cs",2
15,"15091",1097,705,686,17,19,"Cs",21
47,"47213",104,78,78,0,0,"Cs",2
7,"7057",7471,4430,4392,41,38,"Cs",205
9,"9151",446,352,346,3,6,"Cs",24
45,"45095",663,496,492,2,4,"Cs",26
10,"10073",733,513,499,8,14,"Cs",17
3,"3056",8588,6219,6135,29,84,"Cs",381
35,"35014",11962,5994,5888,60,106,"Cs",290
10,"10114",964,644,637,6,7,"Cs",41
16,"16119",175,117,115,0,2,"Cs",3
34,"34133",101,75,73,0,2,"Cs",1
50,"50116",169,124,123,0,1,"Cs",6
22,"22124",183,119,119,0,0,"Cs",9
46,"46084",1487,1136,1123,4,13,"Cs",62
2,"2054",375,288,283,0,5,"Cs",17
45,"45168",62836,46917,46353,424,564,"Cs",3960
40,"40109",69,51,50,3,1,"Cs",8
11,"11010",6327,3998,3928,112,70,"Cs",301
21,"21022",187,121,116,0,5,"Cs",7
45,"45132",2387,1765,1754,13,11,"Cs",139
44,"44019",70,42,42,0,0,"Cs",7
23,"23048",817,605,599,4,6,"Cs",27
34,"34169",371,263,259,5,4,"Cs",13
34,"34031",26,26,26,1,0,"Cs",3
36,"36048",5248,3429,3378,25,51,"Cs",166
40,"40107",90,67,67,0,0,"Cs",5
40,"40100",262,208,204,4,4,"Cs",6
49,"49255",387,304,298,3,6,"Cs",11
26,"26069",230,166,166,0,0,"Cs",8
9,"9347",140,111,107,1,4,"Cs",24
22,"22066",755,529,520,8,9,"Cs",28
44,"44096",155,115,114,1,1,"Cs",1
24,"24176",302,232,226,0,6,"Cs",13
34,"34036",230,159,158,0,1,"Cs",15
42,"42209",134,86,84,4,2,"Cs",6
19,"19022",592,423,420,6,3,"Cs",27
18,"18083",232,181,179,1,2,"Cs",5
9,"9323",57,37,36,0,1,"Cs",3
22,"22136",749,524,518,5,6,"Cs",35
48,"48060",3625,2429,2418,12,11,"Cs",6
49,"49039",324,249,239,3,10,"Cs",21
33,"33021",4304,2643,2610,32,33,"Cs",150
16,"16010",134,92,88,0,4,"Cs",5
9,"9195",57,40,40,0,0,"Cs",5
1,"1011",213,162,160,3,2,"Cs",4
50,"50260",35,31,31,0,0,"Cs",6
3,"3059",20710,14788,14685,89,103,"Cs",806
46,"46048",3504,2609,2576,17,33,"Cs",141
9,"9160",83,63,63,1,0,"Cs",5
34,"34092",257,189,189,1,0,"Cs",9
9,"9215",359,217,216,2,1,"Cs",17
22,"22103",664,489,489,4,0,"Cs",68
24,"24139",2071,1371,1346,15,25,"Cs",63
48,"48061",789,602,601,2,1,"Cs",3
22,"22137",1009,671,665,1,6,"Cs",39
29,"29094",59795,39350,38854,454,496,"Cs",3328
50,"50293",392,257,255,2,2,"Cs",13
16,"16012",76,66,66,0,0,"Cs",0
26,"26010",85,66,63,1,3,"Cs",3
22,"22214",117,92,89,0,3,"Cs",5
26,"26164",50,36,35,0,1,"Cs",0
29,"29085",138,98,93,1,5,"Cs",3
19,"19161",212,158,157,3,1,"Cs",11
9,"9382",27,22,22,0,0,"Cs",2
23,"23016",386,313,305,4,8,"Cs",18
19,"19189",114,87,84,0,3,"Cs",3
11,"11002",4218,3176,3149,16,27,"Cs",64
13,"13096",7526,5212,5131,25,81,"Cs",343
16,"16009",54,44,44,2,0,"Cs",3
50,"50237",100,75,75,2,0,"Cs",3
32,"32082",1164,736,728,11,8,"Cs",15
18,"18039",3343,2293,2252,22,41,"Cs",200
42,"42192",36,22,22,2,0,"Cs",0
29,"29002",1143,777,766,6,11,"Cs",55
40,"40111",50,39,39,0,0,"Cs",0
23,"23091",675,516,512,1,4,"Cs",11
19,"19162",67,41,41,0,0,"Cs",5
14,"14072",983,692,680,6,12,"Cs",64
10,"10095",317,245,239,0,6,"Cs",37
37,"37176",128,99,98,1,1,"Cs",2
45,"45102",3613,2495,2464,27,31,"Cs",139
34,"34143",161,115,112,2,3,"Cs",5
24,"24203",88,62,62,1,0,"Cs",3
48,"48036",24015,16501,16425,83,76,"Cs",169
18,"18151",261,167,166,4,1,"Cs",7
13,"13067",334,279,271,2,8,"Cs",5
34,"34243",323,243,239,1,4,"Cs",6
37,"37001",165,120,120,0,0,"Cs",15
47,"47198",64,43,43,0,0,"Cs",1
39,"39044",3921,2805,2783,18,22,"Cs",138
49,"49222",369,250,247,2,3,"Cs",9
39,"39006",1729,1207,1192,1,15,"Cs",44
12,"12056",257,205,199,1,6,"Cs",6
28,"28042",1261,918,908,9,10,"Cs",72
37,"37355",159,121,120,1,1,"Cs",9
42,"42160",246,177,175,3,2,"Cs",2
10,"10151",189,145,142,2,3,"Cs",9
10,"10165",252,204,201,3,3,"Cs",2
4,"4078",1127,725,718,8,7,"Cs",22
18,"18133",2101,1496,1477,6,19,"Cs",53
24,"24105",1512,1054,1047,10,7,"Cs",94
16,"16130",533,407,404,0,3,"Cs",12
15,"15016",4558,2747,2705,16,42,"Cs",74
24,"24094",1320,866,852,11,14,"Cs",43
19,"19074",67,57,57,1,0,"Cs",4
48,"48029",8681,6057,6027,41,30,"Cs",98
4,"4065",365,273,271,1,2,"Cs",11
50,"50288",3440,2513,2486,26,27,"Cs",240
49,"49154",111,63,59,0,4,"Cs",3
11,"11001",4360,2810,2744,32,66,"Cs",189
46,"46042",3335,2655,2620,12,35,"Cs",120
30,"30033",10377,7330,7215,59,115,"Cs",435
12,"12033",1953,1391,1368,6,23,"Cs",69
38,"38005",5646,3302,3283,24,19,"Cs",99
37,"37089",60,44,43,0,1,"Cs",3
26,"26029",34,26,26,1,0,"Cs",0
9,"9242",66,53,52,3,1,"Cs",0
3,"3047",9768,6220,6144,41,76,"Cs",446
16,"16215",237,162,158,1,4,"Cs",5
42,"42041",31,23,23,0,0,"Cs",2
46,"46015",7519,5575,5532,34,43,"Cs",387
37,"37200",190,132,131,0,1,"Cs",7
34,"34101",48,36,36,1,0,"Cs",3
46,"46030",810,641,625,7,16,"Cs",50
39,"39037",2033,1431,1420,3,11,"Cs",48
5,"5208",39,32,32,0,0,"Cs",1
46,"46167",342,240,239,0,1,"Cs",7
37,"37082",733,468,456,7,12,"Cs",28
6,"6001",664,474,460,3,14,"Cs",24
16,"16018",376,290,290,2,0,"Cs",12
12,"12058",59,47,45,1,2,"Cs",3
37,"37211",208,148,148,0,0,"Cs",12
22,"22044",234,166,164,1,2,"Cs",6
49,"49272",73,49,46,2,3,"Cs",1
37,"37245",331,221,220,4,1,"Cs",9
6,"6048",821,666,653,1,13,"Cs",27
5,"5113",62,42,42,0,0,"Cs",4
13,"13073",501,392,385,2,7,"Cs",13
18,"18059",4265,2960,2886,23,74,"Cs",178
5,"5012",117,88,88,1,0,"Cs",6
49,"49160",42,27,27,0,0,"Cs",0
40,"40122",524,398,392,2,6,"Cs",26
39,"39095",2266,1637,1619,8,18,"Cs",53
19,"19178",27,17,16,0,1,"Cs",1
50,"50073",2122,1559,1540,14,19,"Cs",119
4,"4045",1696,1268,1254,17,14,"Cs",62
47,"47212",356,289,287,4,2,"Cs",7
9,"9321",1576,1151,1135,10,16,"Cs",91
46,"46138",361,289,287,1,2,"Cs",14
15,"15004",4924,3333,3292,38,41,"Cs",127
47,"47075",4772,3557,3512,34,45,"Cs",317
40,"40155",3897,2920,2880,56,40,"Cs",316
10,"10026",647,464,452,6,12,"Cs",22
21,"21013",10626,6990,6807,99,183,"Cs",434
34,"34060",133,109,107,0,2,"Cs",8
42,"42087",51,45,42,1,3,"Cs",1
40,"40088",272,192,192,0,0,"Cs",8
45,"45146",101,79,79,0,0,"Cs",0
49,"49163",203,139,138,3,1,"Cs",5
11,"11022",48785,24758,24422,398,336,"Cs",2420
42,"42135",69,40,40,1,0,"Cs",2
35,"35001",4566,3148,3105,18,43,"Cs",93
19,"19269",86,61,61,0,0,"Cs",1
44,"44171",176,115,115,0,0,"Cs",1
22,"22225",2606,1638,1612,20,26,"Cs",128
49,"49007",361,241,233,7,8,"Cs",16
27,"27024",1447,1048,1032,6,16,"Cs",4
22,"22113",478,335,333,6,2,"Cs",22
11,"11023",9386,6363,6248,116,115,"Cs",451
5,"5243",80,57,56,1,1,"Cs",4
6,"6098",530,379,376,4,3,"Cs",11
28,"28124",73,51,50,0,1,"Cs",10
2,"2025",7345,5388,5278,51,110,"Cs",400
24,"24213",158,127,126,1,1,"Cs",6
50,"50228",249,207,207,3,0,"Cs",12
29,"29074",771,561,555,1,6,"Cs",38
15,"15022",5580,3508,3472,47,36,"Cs",107
24,"24174",457,294,289,3,5,"Cs",12
5,"5244",39,29,29,0,0,"Cs",2
34,"34211",171,154,153,2,1,"Cs",9
40,"40091",109,87,85,0,2,"Cs",4
42,"42022",206,147,146,6,1,"Cs",6
39,"39032",1420,1032,1027,7,5,"Cs",31
49,"49230",84,69,69,0,0,"Cs",4
14,"14061",687,536,523,1,13,"Cs",28
30,"30040",686,564,560,1,4,"Cs",18
18,"18170",317,212,209,0,3,"Cs",8
37,"37217",59,43,43,3,0,"Cs",1
45,"45039",201,157,157,0,0,"Cs",14
44,"44178",52,34,34,0,0,"Cs",2
41,"41055",14791,10197,10000,125,197,"Cs",632
45,"45200",4471,3351,3269,25,82,"Cs",198
28,"28007",127491,96937,96102,810,835,"Cs",8394
42,"42049",108,71,71,1,0,"Cs",4
4,"4028",207,175,171,1,4,"Cs",6
16,"16002",192,160,158,2,2,"Cs",12
5,"5214",28,18,18,0,0,"Cs",2
26,"26060",78,51,50,2,1,"Cs",3
40,"40136",102,79,77,3,2,"Cs",3
28,"28031",2129,1501,1486,8,15,"Cs",77
18,"18097",947,633,631,0,2,"Cs",44
50,"50155",95,65,65,0,0,"Cs",8
9,"9180",132,94,91,1,3,"Cs",5
19,"19183",70,59,58,0,1,"Cs",1
41,"41069",29669,20316,19848,381,468,"Cs",1843
9,"9348",131,103,101,0,2,"Cs",6
9,"9025",110,61,58,0,3,"Cs",4
3,"3131",176,129,126,1,3,"Cs",2
9,"9272",251,166,166,1,0,"Cs",10
49,"49232",85,64,64,0,0,"Cs",3
24,"24044",150,91,89,2,2,"Cs",8
5,"5140",99,83,81,0,2,"Cs",10
37,"37021",66,45,44,0,1,"Cs",0
13,"13083",2382,1623,1587,12,36,"Cs",112
3,"3072",352,281,277,3,4,"Cs",15
16,"16027",691,500,495,1,5,"Cs",16
5,"5237",153,125,123,0,2,"Cs",9
3,"3073",222,178,178,0,0,"Cs",1
45,"45116",666,492,489,4,3,"Cs",18
5,"5120",33,26,26,0,0,"Cs",1
45,"45068",179,129,127,0,2,"Cs",12
10,"10112",1495,1071,1049,7,22,"Cs",25
6,"6013",261,209,204,4,5,"Cs",8
21,"21070",6294,4232,4124,64,108,"Cs",284
45,"45043",776,608,598,3,10,"Cs",19
37,"37221",391,259,257,2,2,"Cs",10
42,"42148",9,9,9,0,0,"Cs",1
20,"20006",261,154,153,1,1,"Cs",1
1,"1034",152,107,107,1,0,"Cs",0
45,"45040",1247,727,715,3,12,"Cs",27
34,"34003",147,104,103,0,1,"Cs",4
44,"44165",168,125,125,2,0,"Cs",8
16,"16074",30,25,25,0,0,"Cs",0
50,"50289",53,42,42,1,0,"Cs",0
6,"6153",20252,14183,13924,154,259,"Cs",1194
46,"46220",49112,33766,33424,312,342,"Cs",2602
26,"26144",187,147,143,1,4,"Cs",1
5,"5045",81,58,58,0,0,"Cs",2
34,"34027",1049,677,665,15,12,"Cs",42
46,"46106",1471,1033,1028,8,5,"Cs",80
46,"46007",12333,8890,8803,79,87,"Cs",764
9,"9441",94,76,76,0,0,"Cs",5
23,"23034",2480,1923,1882,15,41,"Cs",106
47,"47096",127,94,93,1,1,"Cs",4
40,"40224",18,15,15,0,0,"Cs",0
24,"24107",206,147,147,1,0,"Cs",3
14,"14019",6380,4933,4831,71,102,"Cs",343
9,"9189",123,83,78,0,5,"Cs",3
1,"1036",14698,10207,10131,51,76,"Cs",93
23,"23035",1111,877,856,2,21,"Cs",68
7,"7025",443,313,310,5,3,"Cs",21
40,"40097",130,103,102,5,1,"Cs",5
18,"18904",741,500,498,1,2,"Cs",31
49,"49063",303,228,227,3,1,"Cs",11
33,"33009",878,545,542,4,3,"Cs",31
16,"16031",35,26,26,0,0,"Cs",0
24,"24182",410,273,270,7,3,"Cs",17
16,"16237",98,82,82,1,0,"Cs",4
50,"50133",98,76,76,0,0,"Cs",1
50,"50282",55,38,38,1,0,"Cs",0
46,"46107",1857,1421,1402,4,19,"Cs",55
2,"2011",556,429,427,1,2,"Cs",13
40,"40002",32,22,21,0,1,"Cs",1
45,"45120",113,86,86,0,0,"Cs",9
49,"49064",478,297,296,6,1,"Cs",19
37,"37202",1004,773,763,12,10,"Cs",74
6,"6080",1898,1336,1307,6,29,"Cs",84
5,"5134",47,40,40,0,0,"Cs",0
3,"3068",41,38,37,0,1,"Cs",2
44,"44102",26,19,19,0,0,"Cs",1
46,"46009",3144,2473,2449,22,24,"Cs",195
50,"50210",37,26,26,0,0,"Cs",0
40,"40003",116,82,79,3,3,"Cs",2
9,"9395",121,74,74,1,0,"Cs",0
50,"50008",5187,3334,3288,37,46,"Cs",276
23,"23001",912,723,712,2,11,"Cs",34
32,"32070",495,247,238,4,9,"Cs",7
4,"4061",625,489,479,5,10,"Cs",86
18,"18103",714,500,498,3,2,"Cs",26
41,"41046",3005,2241,2198,11,43,"Cs",130
34,"34032",38,30,30,0,0,"Cs",5
50,"50058",63,45,43,0,2,"Cs",5
16,"16034",155,116,113,0,3,"Cs",4
22,"22015",299,218,215,1,3,"Cs",12
41,"41019",4931,3323,3251,39,72,"Cs",245
37,"37132",317,211,207,0,4,"Cs",4
29,"29084",27199,18102,17800,268,302,"Cs",1703
28,"28058",141836,104142,103011,896,1131,"Cs",8758
28,"28134",63936,48022,47631,421,391,"Cs",4969
22,"22165",449,305,300,3,5,"Cs",23
46,"46086",80,66,65,1,1,"Cs",1
16,"16903",992,750,732,8,18,"Cs",27
21,"21035",9766,6114,5998,92,116,"Cs",292
2,"2047",110,83,81,0,2,"Cs",0
36,"36030",3921,2516,2484,31,32,"Cs",98
5,"5126",60,47,45,0,2,"Cs",1
34,"34034",112,82,82,1,0,"Cs",6
21,"21015",645,361,356,8,5,"Cs",25
10,"10147",1277,873,837,6,36,"Cs",28
6,"6068",427,298,294,5,4,"Cs",16
41,"41076",2134,1246,1230,11,16,"Cs",57
42,"42034",41,25,25,0,0,"Cs",1
28,"28029",576,443,443,4,0,"Cs",32
48,"48053",926,704,702,6,2,"Cs",5
26,"26124",768,603,590,4,13,"Cs",10
7,"7041",2090,1454,1434,17,20,"Cs",60
9,"9217",342,240,237,1,3,"Cs",14
5,"5040",64,47,46,0,1,"Cs",7
5,"5171",67,49,47,0,2,"Cs",3
34,"34140",93,57,57,1,0,"Cs",1
50,"50154",114,92,92,1,0,"Cs",12
15,"15024",4314,2859,2790,44,69,"Cs",83
24,"24067",602,327,324,6,3,"Cs",22
42,"42157",10,9,9,0,0,"Cs",0
9,"9127",52,36,35,0,1,"Cs",0
12,"12037",17,13,13,1,0,"Cs",0
37,"37134",209,143,141,3,2,"Cs",10
35,"35034",8392,3946,3908,27,38,"Cs",190
49,"49167",180,131,131,2,0,"Cs",10
42,"42050",27,17,17,0,0,"Cs",0
48,"48082",37358,25328,25167,125,161,"Cs",273
37,"37323",474,335,325,5,10,"Cs",7
39,"39081",440,330,327,1,3,"Cs",7
6,"6026",804,578,562,5,16,"Cs",25
46,"46020",3757,2834,2783,16,51,"Cs",177
39,"39024",1802,1325,1314,7,11,"Cs",49
49,"49032",282,196,196,0,0,"Cs",14
22,"22059",1135,765,752,2,13,"Cs",66
50,"50164",381,245,243,3,2,"Cs",9
45,"45164",166,143,142,1,1,"Cs",4
19,"19331",2677,1892,1841,18,51,"Cs",120
9,"9074",844,610,609,12,1,"Cs",58
15,"15006",5159,3008,2960,44,48,"Cs",128
42,"42202",19,11,10,0,1,"Cs",0
26,"26113",29,28,28,0,0,"Cs",2
4,"4066",13438,8615,8519,78,96,"Cs",389
26,"26101",31,18,17,0,1,"Cs",2
18,"18014",6938,4864,4742,64,122,"Cs",434
16,"16040",91,76,76,2,0,"Cs",9
18,"18076",789,534,532,2,2,"Cs",16
9,"9183",42,32,32,0,0,"Cs",0
45,"45177",1998,1557,1525,10,32,"Cs",93
9,"9148",77,58,58,3,0,"Cs",4
24,"24082",847,615,608,16,7,"Cs",39
24,"24191",106,70,69,2,1,"Cs",3
10,"10152",444,312,309,2,3,"Cs",9
5,"5261",32,25,25,0,0,"Cs",0
5,"5227",341,230,228,1,2,"Cs",11
9,"9314",90,75,75,2,0,"Cs",1
3,"3902",10640,7024,6952,36,72,"Cs",505
41,"41097",3131,2197,2140,13,57,"Cs",124
9,"9390",554,455,450,6,5,"Cs",51
39,"39027",3045,2231,2199,23,32,"Cs",80
46,"46204",6625,4946,4882,52,64,"Cs",379
5,"5100",260,193,192,3,1,"Cs",12
11,"11029",5442,2826,2765,44,61,"Cs",151
24,"24001",165,93,93,0,0,"Cs",15
5,"5112",95,59,58,0,1,"Cs",9
37,"37107",10444,6997,6884,76,113,"Cs",564
7,"7013",7353,4725,4639,43,86,"Cs",268
7,"7035",1595,1095,1078,13,17,"Cs",40
5,"5251",56,35,34,0,1,"Cs",2
15,"15029",5354,3082,3050,46,32,"Cs",96
48,"48058",947,682,679,2,3,"Cs",8
42,"42069",1483,896,878,2,18,"Cs",39
22,"22174",462,352,350,0,2,"Cs",14
47,"47106",44,30,30,0,0,"Cs",2
42,"42028",75,57,56,0,1,"Cs",2
44,"44137",187,139,139,0,0,"Cs",8
3,"3114",1593,1158,1142,4,16,"Cs",51
26,"26004",69,47,46,0,1,"Cs",0
36,"36005",8105,5258,5152,54,106,"Cs",218
22,"22063",161,128,126,0,2,"Cs",5
45,"45059",1702,1315,1303,1,12,"Cs",88
5,"5102",1681,1252,1228,8,24,"Cs",64
26,"26160",731,539,533,4,6,"Cs",22
32,"32080",284,209,209,1,0,"Cs",1
16,"16008",80,63,63,1,0,"Cs",1
9,"9209",4404,2997,2950,31,47,"Cs",255
4,"4070",1529,1088,1076,8,12,"Cs",49
33,"33019",2844,1702,1680,11,22,"Cs",114
40,"40142",52,39,37,0,2,"Cs",3
19,"19103",247,205,202,1,3,"Cs",7
10,"10034",337,244,240,0,4,"Cs",19
5,"5037",210,135,135,0,0,"Cs",6
45,"45133",2798,1957,1922,11,35,"Cs",91
44,"44207",125,98,97,2,1,"Cs",4
26,"26007",482,360,348,0,12,"Cs",15
42,"42071",159,92,92,2,0,"Cs",3
34,"34184",49,37,35,0,2,"Cs",0
50,"50291",95,76,76,0,0,"Cs",5
22,"22234",743,498,491,5,7,"Cs",63
49,"49185",156,120,116,0,4,"Cs",4
49,"49028",108,90,89,1,1,"Cs",0
41,"41028",2108,1652,1632,22,20,"Cs",194
48,"48088",134,95,95,0,0,"Cs",0
44,"44080",281,202,199,0,3,"Cs",10
4,"4902",45571,29423,29169,272,254,"Cs",2240
19,"19135",90,71,69,1,2,"Cs",6
37,"37236",123,85,82,1,3,"Cs",4
50,"50243",307,227,224,2,3,"Cs",20
11,"11042",1158,806,793,6,13,"Cs",43
32,"32083",805,498,494,3,4,"Cs",13
15,"15074",3902,2629,2589,23,40,"Cs",98
15,"15011",15501,9988,9846,78,142,"Cs",492
47,"47207",256,198,195,3,3,"Cs",7
18,"18020",489,318,310,2,8,"Cs",22
14,"14032",388,302,293,0,9,"Cs",25
7,"7006",5393,3257,3220,34,37,"Cs",166
50,"50017",1773,1283,1265,13,18,"Cs",140
44,"44142",29,21,21,0,0,"Cs",1
47,"47175",6755,4950,4870,49,80,"Cs",447
18,"18915",726,474,467,4,7,"Cs",18
10,"10078",365,271,263,7,8,"Cs",17
24,"24017",532,375,374,1,1,"Cs",17
24,"24124",338,196,195,2,1,"Cs",14
6,"6128",4457,2996,2934,28,62,"Cs",173
9,"9381",28,19,19,0,0,"Cs",2
3,"3089",9496,6617,6484,51,133,"Cs",436
49,"49265",110,79,78,2,1,"Cs",3
18,"18181",194,134,133,0,1,"Cs",2
21,"21056",2914,2148,2046,29,102,"Cs",74
18,"18021",17929,12165,11949,139,216,"Cs",1209
24,"24018",172,129,128,0,1,"Cs",5
45,"45161",15469,10281,10167,68,114,"Cs",891
50,"50269",287,172,167,2,5,"Cs",7
19,"19171",5380,3964,3919,22,45,"Cs",296
18,"18022",13875,8948,8764,98,184,"Cs",736
18,"18096",340,227,226,0,1,"Cs",9
3,"3130",28,19,19,0,0,"Cs",2
50,"50018",883,622,616,5,6,"Cs",29
42,"42200",74,49,46,0,3,"Cs",4
7,"7030",1598,1127,1098,14,29,"Cs",68
15,"15003",1675,1029,1020,9,9,"Cs",27
9,"9363",906,660,655,5,5,"Cs",59
4,"4064",2878,1937,1924,16,13,"Cs",137
18,"18182",1926,1222,1204,8,18,"Cs",91
1,"1059",189597,128849,127910,688,939,"Cs",2071
22,"22168",22,20,19,0,1,"Cs",1
47,"47197",875,659,656,9,3,"Cs",37
39,"39090",773,557,553,2,4,"Cs",28
9,"9109",1072,575,558,0,17,"Cs",31
50,"50093",87,66,64,1,2,"Cs",0
44,"44144",319,225,223,0,2,"Cs",24
26,"26125",2665,1885,1853,21,32,"Cs",123
40,"40049",37,27,27,0,0,"Cs",1
18,"18183",623,380,376,0,4,"Cs",31
42,"42173",29860,19581,19206,337,375,"Cs",1118
35,"35019",32830,18390,18243,87,147,"Cs",1012
44,"44145",974,698,697,3,1,"Cs",32
37,"37230",220,169,168,1,1,"Cs",12
40,"40007",68,55,55,1,0,"Cs",7
47,"47052",6781,5213,5156,50,57,"Cs",607
50,"50247",852,600,594,8,6,"Cs",58
42,"42217",33,25,25,0,0,"Cs",2
28,"28149",6298,4751,4699,35,52,"Cs",503
48,"48083",6934,4800,4765,21,35,"Cs",35
40,"40118",46,32,32,1,0,"Cs",1
32,"32089",1206,740,726,8,14,"Cs",24
50,"50148",304,213,211,2,2,"Cs",11
48,"48093",891,669,666,5,3,"Cs",2
23,"23904",2570,1583,1562,10,21,"Cs",88
42,"42174",174,121,118,4,3,"Cs",10
33,"33026",8201,5014,4974,74,40,"Cs",279
37,"37042",36,27,27,1,0,"Cs",1
6,"6135",1101,860,849,2,11,"Cs",51
37,"37336",56,45,43,2,2,"Cs",2
47,"47149",46,33,32,1,1,"Cs",3
47,"47053",123,101,97,3,4,"Cs",5
39,"39064",1352,1007,990,3,17,"Cs",34
12,"12020",118,104,103,1,1,"Cs",4
19,"19060",157,123,122,0,1,"Cs",10
39,"39083",1063,619,611,2,8,"Cs",11
45,"45130",294,222,222,1,0,"Cs",7
28,"28140",3156,2359,2331,16,28,"Cs",206
16,"16197",67,44,43,0,1,"Cs",1
47,"47203",54,40,40,0,0,"Cs",2
28,"28183",1162,823,813,9,10,"Cs",52
2,"2065",441,368,361,0,7,"Cs",9
50,"50233",96,78,78,0,0,"Cs",7
9,"9275",167,114,114,1,0,"Cs",3
2,"2064",371,288,283,2,5,"Cs",16
4,"4033",121,78,77,3,1,"Cs",6
42,"42176",27,21,21,0,0,"Cs",1
3,"3009",46125,33613,33319,315,294,"Cs",2205
14,"14038",32742,23345,22974,242,371,"Cs",2120
13,"13026",413,333,331,2,2,"Cs",22
16,"16017",336,276,270,1,6,"Cs",4
16,"16095",82,70,70,1,0,"Cs",2
3,"3066",41762,28723,28388,358,335,"Cs",2450
26,"26171",155,109,107,2,2,"Cs",9
29,"29053",1717,1133,1116,12,17,"Cs",94
28,"28153",816,547,544,3,3,"Cs",33
48,"48011",9640,6753,6722,41,31,"Cs",51
34,"34057",464,308,302,4,6,"Cs",20
49,"49194",331,198,197,0,1,"Cs",18
16,"16266",356,269,265,4,4,"Cs",8
9,"9392",49,28,28,0,0,"Cs",2
9,"9226",54,45,45,2,0,"Cs",1
24,"24210",524,353,353,1,0,"Cs",26
14,"14039",2577,1858,1801,29,57,"Cs",104
16,"16057",62,45,45,0,0,"Cs",2
13,"13028",10230,7682,7559,65,123,"Cs",405
30,"30021",9498,6251,6193,36,58,"Cs",345
12,"12135",36287,25912,25655,184,257,"Cs",1991
5,"5080",42,30,30,0,0,"Cs",0
7,"7037",3448,1875,1856,18,19,"Cs",115
28,"28037",1570,1135,1123,4,12,"Cs",43
37,"37276",125,92,92,0,0,"Cs",15
49,"49275",51064,34471,34017,475,454,"Cs",2717
24,"24015",2193,1532,1500,12,32,"Cs",130
9,"9340",74,49,49,1,0,"Cs",12
22,"22223",77,60,59,2,1,"Cs",2
41,"41083",1145,821,814,6,7,"Cs",51
37,"37340",141,97,97,1,0,"Cs",4
46,"46237",7172,5199,5146,53,53,"Cs",400
44,"44179",324,201,201,2,0,"Cs",9
35,"35024",14323,8360,8289,81,71,"Cs",512
2,"2034",1323,1024,1018,6,6,"Cs",46
33,"33030",876,632,630,8,2,"Cs",41
15,"15052",4070,2512,2488,18,24,"Cs",95
29,"29902",2593,1561,1533,15,28,"Cs",109
45,"45036",638,455,449,1,6,"Cs",22
33,"33031",33775,20484,20184,276,300,"Cs",899
45,"45110",1685,1288,1274,5,14,"Cs",30
2,"2068",323,239,239,3,0,"Cs",47
49,"49018",277,197,190,2,7,"Cs",8
44,"44151",180,134,134,1,0,"Cs",3
42,"42046",46,32,32,0,0,"Cs",2
3,"3041",6132,4204,4167,22,37,"Cs",204
50,"50100",304,215,212,1,3,"Cs",15
2,"2035",1946,1494,1473,5,21,"Cs",76
47,"47058",199,126,125,3,1,"Cs",3
10,"10173",558,389,385,5,4,"Cs",18
32,"32023",1130,787,782,2,5,"Cs",16
6,"6007",1418,984,968,13,16,"Cs",40
22,"22155",66,52,52,0,0,"Cs",6
22,"22190",123,77,77,1,0,"Cs",6
9,"9398",73,52,52,0,0,"Cs",2
9,"9070",33,28,27,0,1,"Cs",4
35,"35025",1752,1113,1095,5,18,"Cs",46
3,"3070",2115,1399,1376,9,23,"Cs",85
37,"37155",68,48,48,0,0,"Cs",4
44,"44094",127,103,103,0,0,"Cs",6
13,"13018",774,625,622,0,3,"Cs",24
10,"10094",220,167,165,0,2,"Cs",7
46,"46049",268,221,217,2,4,"Cs",10
22,"22048",12635,8889,8807,98,82,"Cs",837
6,"6130",185,152,149,0,3,"Cs",3
50,"50171",99,69,69,2,0,"Cs",4
10,"10135",1240,834,826,3,8,"Cs",26
19,"19294",26,18,18,0,0,"Cs",1
7,"7052",4853,2765,2743,33,22,"Cs",191
16,"16140",18,14,14,1,0,"Cs",0
7,"7020",3707,2522,2493,40,29,"Cs",152
33,"33005",1357,832,825,11,7,"Cs",22
39,"39042",5910,4354,4315,14,39,"Cs",232
22,"22049",73,62,62,0,0,"Cs",1
22,"22157",181,122,121,2,1,"Cs",9
37,"37206",87,65,54,0,11,"Cs",5
29,"29059",2662,1950,1895,16,55,"Cs",71
6,"6146",1039,764,752,7,12,"Cs",21
24,"24142",24715,16839,16616,159,223,"Cs",1225
9,"9406",239,165,162,2,3,"Cs",10
48,"48904",3547,2563,2541,18,22,"Cs",23
6,"6011",24731,16786,16538,167,248,"Cs",1502
47,"47061",237,185,184,0,1,"Cs",13
28,"28159",589,455,447,4,8,"Cs",28
30,"30026",16345,10049,9914,84,135,"Cs",648
47,"47147",103,86,82,0,4,"Cs",7
15,"15015",2877,1845,1821,26,24,"Cs",66
50,"50130",354,225,222,1,3,"Cs",19
49,"49168",89,68,68,0,0,"Cs",8
40,"40222",161,134,131,1,3,"Cs",7
12,"12065",167,142,141,0,1,"Cs",8
46,"46127",2748,2035,2009,6,26,"Cs",95
47,"47062",155,128,128,0,0,"Cs",8
10,"10015",630,429,424,1,5,"Cs",47
37,"37219",169,88,85,1,3,"Cs",4
16,"16143",15,10,10,1,0,"Cs",0
19,"19175",29,18,17,1,1,"Cs",0
50,"50255",199,152,147,3,5,"Cs",6
9,"9408",40,29,29,0,0,"Cs",1
40,"40030",419,317,314,3,3,"Cs",28
12,"12141",92,72,72,0,0,"Cs",4
5,"5154",31,23,23,0,0,"Cs",1
40,"40128",123,88,87,1,1,"Cs",4
26,"26102",6076,4276,4205,52,71,"Cs",303
50,"50005",228,185,184,2,1,"Cs",13
5,"5034",15,14,13,0,1,"Cs",0
9,"9223",42,36,36,0,0,"Cs",5
18,"18045",1065,720,690,11,30,"Cs",21
4,"4079",54675,35691,35365,328,326,"Cs",3056
16,"16053",388,306,303,3,3,"Cs",22
37,"37233",53,39,39,1,0,"Cs",2
42,"42054",18,12,12,0,0,"Cs",0
34,"34165",57,45,44,1,1,"Cs",4
37,"37316",711,546,541,7,5,"Cs",40
19,"19166",154,110,108,0,2,"Cs",4
18,"18005",363,232,230,3,2,"Cs",19
37,"37024",89,60,60,0,0,"Cs",5
22,"22253",56,40,40,1,0,"Cs",4
37,"37096",203,144,144,2,0,"Cs",9
37,"37378",92,54,54,0,0,"Cs",2
48,"48076",288,211,211,1,0,"Cs",0
16,"16067",123,91,90,1,1,"Cs",4
24,"24036",252,146,146,1,0,"Cs",4
37,"37057",208,151,149,0,2,"Cs",7
41,"41016",7820,5523,5407,57,116,"Cs",472
28,"28162",2784,2143,2131,20,12,"Cs",253
29,"29007",28907,20371,20129,254,242,"Cs",2097
50,"50106",123,78,78,0,0,"Cs",5
5,"5186",1564,1140,1125,5,15,"Cs",80
44,"44244",67,40,40,0,0,"Cs",0
46,"46129",511,389,379,9,10,"Cs",11
19,"19017",56,47,47,0,0,"Cs",5
45,"45083",568,433,429,2,4,"Cs",21
19,"19188",36,31,31,0,0,"Cs",2
42,"42056",28,25,24,0,1,"Cs",0
27,"27063",1699,1131,1109,7,22,"Cs",17
50,"50007",51,34,34,1,0,"Cs",1
44,"44065",55,33,32,0,1,"Cs",1
12,"12013",135,106,106,1,0,"Cs",5
37,"37026",180,148,147,5,1,"Cs",6
50,"50081",487,355,349,5,6,"Cs",20
18,"18905",15688,10406,10200,122,206,"Cs",944
4,"4082",275,185,182,2,3,"Cs",9
3,"3125",332,226,226,2,0,"Cs",2
18,"18082",810,503,500,3,3,"Cs",28
46,"46024",454,343,339,1,4,"Cs",16
39,"39011",1587,1178,1178,6,0,"Cs",45
50,"50185",140,93,92,1,1,"Cs",8
29,"29083",2063,1471,1444,14,27,"Cs",59
49,"49138",205,141,140,2,1,"Cs",5
15,"15062",5597,3406,3360,16,46,"Cs",159
44,"44158",1153,879,872,6,7,"Cs",53
41,"41018",9432,6463,6368,86,95,"Cs",346
35,"35032",3331,2293,2252,23,41,"Cs",95
10,"10062",389,303,299,2,4,"Cs",16
27,"27065",12055,7566,7379,119,187,"Cs",186
9,"9358",247,165,161,3,4,"Cs",7
16,"16190",4930,3747,3688,26,59,"Cs",215
15,"15032",3430,2243,2197,12,46,"Cs",75
22,"22055",305,242,235,2,7,"Cs",12
19,"19282",138,107,106,0,1,"Cs",1
13,"13001",1188,865,858,4,7,"Cs",36
22,"22126",89,64,64,0,0,"Cs",4
40,"40134",692,522,509,10,13,"Cs",38
30,"30031",497,387,382,1,5,"Cs",23
10,"10186",951,756,735,6,21,"Cs",42
22,"22087",60,46,46,0,0,"Cs",1
34,"34171",928,572,562,2,10,"Cs",21
16,"16191",850,664,653,11,11,"Cs",34
40,"40199",101,76,72,2,4,"Cs",8
9,"9138",84,67,66,1,1,"Cs",6
18,"18105",3827,2436,2392,22,44,"Cs",98
15,"15065",7134,4869,4785,53,84,"Cs",237
38,"38025",7065,4657,4590,34,67,"Cs",228
19,"19190",2284,1632,1613,16,19,"Cs",110
3,"3051",342,288,286,4,2,"Cs",15
47,"47165",6823,4999,4906,48,93,"Cs",433
45,"45198",1808,1442,1428,6,14,"Cs",46
45,"45125",2256,1711,1689,16,22,"Cs",67
19,"19283",29,26,26,0,0,"Cs",0
5,"5061",257,193,189,1,4,"Cs",7
6,"6023",4138,2811,2749,12,62,"Cs",162
10,"10107",1019,766,755,12,11,"Cs",24
16,"16113",3065,2142,2108,13,34,"Cs",89
9,"9179",39,30,30,1,0,"Cs",1
42,"42185",24,20,20,0,0,"Cs",1
26,"26111",250,191,187,3,4,"Cs",10
5,"5181",46,34,34,0,0,"Cs",1
37,"37229",138,103,101,0,2,"Cs",7
40,"40233",399,279,273,0,6,"Cs",18
19,"19096",105,72,70,0,2,"Cs",6
49,"49107",115,70,70,0,0,"Cs",3
15,"15066",3995,2746,2695,29,51,"Cs",92
50,"50111",181,130,130,1,0,"Cs",15
5,"5258",107,80,80,1,0,"Cs",5
37,"37280",70,47,46,0,1,"Cs",1
45,"45053",7820,5814,5712,56,102,"Cs",386
36,"36032",3527,2407,2369,24,38,"Cs",82
9,"9419",67,52,49,0,3,"Cs",3
37,"37196",70,50,50,0,0,"Cs",3
37,"37197",88,53,53,1,0,"Cs",5
23,"23043",517,360,360,1,0,"Cs",14
47,"47230",285,209,206,1,3,"Cs",13
50,"50011",117,90,89,3,1,"Cs",3
34,"34229",58,47,47,1,0,"Cs",1
50,"50263",171,110,108,1,2,"Cs",4
12,"12017",145,111,110,2,1,"Cs",4
46,"46104",1906,1422,1409,5,13,"Cs",43
37,"37261",213,153,149,0,4,"Cs",8
38,"38051",7328,5017,4969,32,48,"Cs",183
46,"46134",2419,1697,1678,14,19,"Cs",137
37,"37167",174,147,144,2,3,"Cs",10
1,"1002",8014,5838,5786,24,52,"Cs",27
36,"36034",3299,2155,2132,15,23,"Cs",93
19,"19225",851,618,611,2,7,"Cs",68
44,"44164",19,16,16,1,0,"Cs",0
50,"50239",63,46,45,1,1,"Cs",7
13,"13038",1589,1162,1136,21,26,"Cs",45
22,"22094",102,69,69,3,0,"Cs",6
42,"42113",510,370,366,2,4,"Cs",17
6,"6028",4098,3457,3350,22,107,"Cs",215
14,"14055",18411,13054,12798,192,256,"Cs",1155
9,"9423",27,24,24,1,0,"Cs",3
2,"2052",466,371,370,6,1,"Cs",10
37,"37232",377,303,303,2,0,"Cs",25
6,"6074",4720,3355,3271,24,84,"Cs",273
21,"21902",1136,744,739,2,5,"Cs",23
14,"14037",3161,2233,2158,22,75,"Cs",136
16,"16082",272,194,192,1,2,"Cs",4
38,"38053",3768,2275,2244,16,31,"Cs",87
29,"29089",3138,2262,2186,13,76,"Cs",50
23,"23081",1494,1084,1061,9,23,"Cs",66
45,"45020",1240,905,900,5,5,"Cs",44
48,"48085",10716,7707,7679,51,28,"Cs",74
24,"24060",561,297,296,2,1,"Cs",19
50,"50115",3279,2170,2131,27,39,"Cs",159
29,"29043",2463,1508,1460,20,48,"Cs",95
50,"50006",913,670,654,13,16,"Cs",44
49,"49036",503,319,316,5,3,"Cs",14
41,"41081",30061,21488,21059,331,429,"Cs",1529
49,"49003",860,534,530,5,4,"Cs",26
32,"32079",1280,880,869,13,11,"Cs",44
33,"33018",2804,1830,1806,30,24,"Cs",109
34,"34042",294,224,221,1,3,"Cs",24
10,"10195",7514,5243,5148,47,95,"Cs",342
5,"5101",266,206,205,1,1,"Cs",13
37,"37264",56,39,39,0,0,"Cs",4
6,"6031",462,285,280,2,5,"Cs",19
26,"26157",283,222,217,0,5,"Cs",15
50,"50265",74,54,54,1,0,"Cs",2
14,"14029",4001,2855,2821,30,34,"Cs",167
37,"37139",189,150,148,1,2,"Cs",18
9,"9375",42,35,35,0,0,"Cs",5
6,"6124",1635,1158,1119,10,39,"Cs",80
24,"24159",1716,1238,1216,6,22,"Cs",76
9,"9427",1363,854,842,7,12,"Cs",55
19,"19324",164,122,120,4,2,"Cs",12
34,"34087",125,99,99,2,0,"Cs",10
45,"45096",987,748,725,9,23,"Cs",20
41,"41026",4302,3355,3288,26,67,"Cs",152
40,"40044",134,101,101,3,0,"Cs",6
49,"49038",88,63,58,1,5,"Cs",7
16,"16280",163,122,119,2,3,"Cs",2
47,"47078",157,114,107,0,7,"Cs",10
42,"42165",414,246,237,4,9,"Cs",14
34,"34015",37,24,24,0,0,"Cs",0
37,"37060",283,205,202,1,3,"Cs",16
37,"37360",206,135,135,1,0,"Cs",13
15,"15073",21725,13008,12820,126,188,"Cs",665
47,"47173",879,627,622,9,5,"Cs",47
3,"3116",1155,819,805,5,14,"Cs",61
44,"44258",53,46,46,0,0,"Cs",0
9,"9378",31,20,19,0,1,"Cs",1
36,"36039",15609,10562,10341,102,221,"Cs",540
7,"7038",2046,1416,1406,12,10,"Cs",60
49,"49228",53,36,36,0,0,"Cs",2
16,"16203",10221,6960,6883,42,77,"Cs",344
23,"23050",90664,65260,64519,581,741,"Cs",5189
10,"10077",626,444,441,5,3,"Cs",58
24,"24088",996,750,745,9,5,"Cs",69
50,"50194",80,51,51,0,0,"Cs",3
10,"10199",154,99,99,2,0,"Cs",10
46,"46139",4520,3486,3457,18,29,"Cs",196
24,"24053",398,250,248,1,2,"Cs",11
26,"26122",115,81,80,4,1,"Cs",5
22,"22004",123,83,83,0,0,"Cs",7
12,"12025",116,82,79,1,3,"Cs",2
42,"42212",57,45,45,2,0,"Cs",2
37,"37074",136,93,90,1,3,"Cs",1
11,"11013",2352,1564,1522,13,42,"Cs",140
12,"12105",825,602,598,6,4,"Cs",25
10,"10200",336,243,242,0,1,"Cs",6
24,"24163",4076,2979,2954,35,25,"Cs",231
19,"19036",242,202,200,1,2,"Cs",15
5,"5105",330,247,242,2,5,"Cs",20
49,"49008",423,263,259,1,4,"Cs",8
46,"46117",493,386,380,2,6,"Cs",25
50,"50195",53,42,38,0,4,"Cs",2
20,"20902",14282,9670,9618,52,52,"Cs",175
9,"9432",170,125,123,0,2,"Cs",9
33,"33051",6787,4318,4268,48,50,"Cs",245
13,"13064",1845,1314,1298,10,16,"Cs",96
28,"28080",49866,39769,39583,346,186,"Cs",4347
10,"10080",353,243,238,1,5,"Cs",12
47,"47229",221,150,149,0,1,"Cs",5
46,"46072",3522,2792,2741,25,51,"Cs",124
10,"10202",583,457,453,1,4,"Cs",105
9,"9433",52,40,40,0,0,"Cs",3
47,"47209",32,23,23,0,0,"Cs",1
46,"46004",1932,1530,1512,10,18,"Cs",102
12,"12130",414,329,327,0,2,"Cs",5
32,"32087",1669,1158,1136,14,22,"Cs",33
26,"26165",336,248,242,3,6,"Cs",15
45,"45138",1058,813,802,5,11,"Cs",28
4,"4098",1424,890,885,0,5,"Cs",91
21,"21057",995,600,590,8,10,"Cs",21
16,"16128",50,38,38,0,0,"Cs",0
45,"45028",3613,2675,2647,22,28,"Cs",132
50,"50196",101,73,73,0,0,"Cs",4
12,"12107",350,299,295,3,4,"Cs",11
10,"10204",423,289,287,1,2,"Cs",25
49,"49010",350,260,256,8,4,"Cs",19
26,"26126",29,27,27,0,0,"Cs",0
47,"47082",805,641,630,3,11,"Cs",28
44,"44051",2579,1924,1901,10,23,"Cs",73
33,"33053",1078,602,599,10,3,"Cs",20
50,"50036",100,76,76,1,0,"Cs",4
27,"27049",1324,847,829,8,18,"Cs",28
6,"6042",984,644,629,5,15,"Cs",20
26,"26167",50,34,33,1,1,"Cs",1
50,"50271",246,179,173,4,6,"Cs",20
41,"41903",6776,4616,4494,72,122,"Cs",356
39,"39035",9142,6574,6517,24,57,"Cs",260
21,"21059",221,169,163,1,6,"Cs",4
18,"18184",2193,1542,1511,16,31,"Cs",75
9,"9273",48,40,39,0,1,"Cs",2
19,"19203",29,25,25,0,0,"Cs",1
38,"38036",6857,4170,4090,37,80,"Cs",179
9,"9388",31,26,25,0,1,"Cs",2
15,"15079",1437,887,868,8,19,"Cs",36
12,"12028",13004,9801,9732,74,69,"Cs",893
9,"9113",453,321,315,8,6,"Cs",44
49,"49121",372,239,233,1,6,"Cs",18
40,"40083",73,52,52,1,0,"Cs",6
6,"6044",29258,19865,19594,205,271,"Cs",1786
26,"26051",213,165,165,1,0,"Cs",9
28,"28074",141137,106626,105602,885,1024,"Cs",8418
42,"42161",136,99,99,0,0,"Cs",6
5,"5195",199,125,125,1,0,"Cs",7
5,"5077",154,113,110,0,3,"Cs",9
19,"19322",26,20,19,1,1,"Cs",0
34,"34232",725,505,492,13,13,"Cs",32
22,"22908",190,135,134,0,1,"Cs",8
23,"23905",1828,1320,1302,12,18,"Cs",72
21,"21040",3193,2219,2123,32,96,"Cs",141
49,"49014",116,83,83,1,0,"Cs",3
49,"49270",139,93,92,0,1,"Cs",6
46,"46212",1620,1130,1112,12,18,"Cs",66
26,"26016",28,20,18,0,2,"Cs",4
32,"32018",1181,883,871,5,12,"Cs",12
22,"22221",92,56,55,0,1,"Cs",5
14,"14065",1820,1374,1352,13,22,"Cs",102
46,"46144",628,483,478,4,5,"Cs",27
10,"10208",122,85,83,0,2,"Cs",0
37,"37368",17,12,11,0,1,"Cs",1
22,"22149",301,211,210,1,1,"Cs",20
45,"45144",736,562,557,1,5,"Cs",23
33,"33056",4850,3068,3044,25,24,"Cs",204
42,"42130",51,42,40,1,2,"Cs",2
36,"36047",2248,1379,1363,11,16,"Cs",26
22,"22111",143,96,95,2,1,"Cs",7
14,"14066",5748,4116,4035,59,81,"Cs",329
12,"12110",222,156,155,3,1,"Cs",13
34,"34102",197,158,156,1,2,"Cs",13
10,"10088",198,112,112,1,0,"Cs",1
50,"50250",54,44,44,2,0,"Cs",4
2,"2066",222,165,163,1,2,"Cs",3
26,"26054",291,225,223,3,2,"Cs",0
26,"26018",10443,7664,7538,80,126,"Cs",537
47,"47026",50,37,37,1,0,"Cs",2
9,"9394",668,432,429,6,3,"Cs",32
26,"26172",25,16,15,0,1,"Cs",0
42,"42006",154,105,103,0,2,"Cs",10
47,"47087",362,272,268,1,4,"Cs",15
41,"41036",3903,2708,2645,35,63,"Cs",120
32,"32009",10558,6621,6549,50,72,"Cs",322
26,"26120",1441,1027,1011,11,16,"Cs",45
34,"34154",77,48,48,1,0,"Cs",2
3,"3067",91,78,78,0,0,"Cs",0
50,"50201",449,345,344,4,1,"Cs",33
37,"37246",5146,3791,3737,42,54,"Cs",398
42,"42007",108,80,80,1,0,"Cs",5
28,"28078",40,38,38,0,0,"Cs",3
39,"39039",540,355,355,1,0,"Cs",6
4,"4083",1727,1265,1250,8,15,"Cs",71
24,"24063",362,247,245,2,2,"Cs",24
50,"50125",340,230,229,2,1,"Cs",12
39,"39096",669,451,450,1,1,"Cs",17
26,"26173",8,8,8,1,0,"Cs",0
46,"46078",28484,19694,19520,173,174,"Cs",1559
6,"6051",1523,1147,1137,5,10,"Cs",43
10,"10091",351,275,271,2,4,"Cs",24
18,"18158",7978,4861,4771,43,90,"Cs",309
18,"18061",999,781,770,5,11,"Cs",28
50,"50202",124,76,74,0,2,"Cs",0
15,"15053",7469,4622,4579,44,43,"Cs",163
37,"37086",107,86,85,2,1,"Cs",8
9,"9123",42,36,36,0,0,"Cs",1
45,"45111",56,47,47,1,0,"Cs",1
46,"46010",943,691,681,7,10,"Cs",63
6,"6052",3962,2728,2642,26,86,"Cs",211
29,"29073",1657,1082,1069,15,13,"Cs",51
47,"47185",82,62,61,1,1,"Cs",5
37,"37051",79,58,58,0,0,"Cs",2
49,"49241",235,178,177,1,1,"Cs",17
44,"44180",74,56,56,0,0,"Cs",7
9,"9124",1405,946,928,6,18,"Cs",52
46,"46079",314,244,240,0,4,"Cs",9
24,"24029",686,430,428,6,2,"Cs",10
21,"21005",15754,9502,9340,84,162,"Cs",682
46,"46216",5277,4146,4111,42,35,"Cs",357
34,"34108",499,391,384,3,7,"Cs",15
5,"5117",191,155,153,1,2,"Cs",12
24,"24175",1821,1316,1305,15,11,"Cs",92
26,"26138",4504,2982,2930,32,52,"Cs",183
37,"37077",251,206,204,1,2,"Cs",16
29,"29075",12886,8292,8191,63,101,"Cs",578
46,"46148",1515,1131,1113,5,18,"Cs",121
46,"46034",1826,1345,1335,3,10,"Cs",97
45,"45187",3967,3133,3074,16,59,"Cs",176
49,"49056",285,191,190,3,1,"Cs",11
40,"40126",67,44,42,0,2,"Cs",2
28,"28158",694,501,495,2,6,"Cs",43
46,"46080",979,720,712,2,8,"Cs",39
15,"15087",5710,3436,3392,31,44,"Cs",149
9,"9289",1353,873,861,4,12,"Cs",44
34,"34022",1022,813,798,7,15,"Cs",33
47,"47092",101,81,79,0,2,"Cs",14
49,"49130",155,116,112,1,4,"Cs",8
44,"44182",203,160,158,0,2,"Cs",10
42,"42011",16,11,11,0,0,"Cs",1
46,"46217",900,672,667,7,5,"Cs",40
23,"23064",1669,1311,1296,9,15,"Cs",52
50,"50205",72,51,49,0,2,"Cs",3
10,"10217",506,378,377,3,1,"Cs",10
45,"45005",225,170,167,3,3,"Cs",5
41,"41013",4836,3174,3124,41,50,"Cs",75
28,"28179",1451,1043,1033,6,10,"Cs",104
18,"18098",5959,3816,3749,33,67,"Cs",317
10,"10137",394,297,296,3,1,"Cs",27
5,"5183",123,103,100,0,3,"Cs",5
37,"37314",81,65,65,0,0,"Cs",4
19,"19153",22,20,20,2,0,"Cs",0
49,"49022",282,230,229,2,1,"Cs",7
42,"42144",419,302,298,6,4,"Cs",15
39,"39100",849,567,565,5,2,"Cs",24
14,"14073",2768,1934,1880,33,54,"Cs",110
10,"10219",1184,698,686,9,12,"Cs",38
22,"22229",107,70,70,2,0,"Cs",10
49,"49023",899,627,620,3,7,"Cs",36
28,"28094",988,711,707,5,4,"Cs",44
16,"16185",36,31,31,0,0,"Cs",1
37,"37252",99,65,65,1,0,"Cs",6
44,"44241",500,361,357,0,4,"Cs",15
14,"14074",2225,1775,1743,17,32,"Cs",109
26,"26180",221,164,162,4,2,"Cs",9
28,"28023",5159,4052,4019,27,33,"Cs",371
36,"36055",13585,9177,8986,115,191,"Cs",503
19,"19040",53,43,42,1,1,"Cs",2
24,"24131",684,416,415,2,1,"Cs",26
3,"3074",1766,1347,1336,4,11,"Cs",168
16,"16169",49,28,28,0,0,"Cs",0
44,"44136",48,43,43,1,0,"Cs",0
15,"15038",2126,1312,1296,12,16,"Cs",29
41,"41024",22819,14767,14455,169,312,"Cs",1075
50,"50038",1404,1024,1007,15,17,"Cs",57
37,"37023",1624,1233,1211,15,22,"Cs",166
28,"28130",28569,22050,21799,187,251,"Cs",2072
22,"22907",1463,1016,1006,21,10,"Cs",75
49,"49135",576,368,366,3,2,"Cs",24
9,"9353",74,56,54,1,2,"Cs",13
26,"26104",10,9,9,1,0,"Cs",0
42,"42097",14,9,9,1,0,"Cs",0
37,"37190",189,141,139,1,2,"Cs",4
20,"20007",337,223,221,2,2,"Cs",0
16,"16236",857,615,608,1,7,"Cs",29
29,"29006",679,461,452,4,9,"Cs",18
45,"45008",144,112,110,1,2,"Cs",4
22,"22122",69,52,50,2,2,"Cs",8
49,"49247",412,255,252,2,3,"Cs",22
19,"19156",917,686,679,2,7,"Cs",38
47,"47192",89,78,76,3,2,"Cs",1
42,"42017",131,99,96,1,3,"Cs",1
6,"6062",564,394,391,0,3,"Cs",9
46,"46152",90,63,63,0,0,"Cs",4
15,"15092",6220,3810,3756,30,54,"Cs",138
14,"14901",932,753,750,6,3,"Cs",17
22,"22233",81,53,53,0,0,"Cs",2
23,"23037",518,403,398,10,5,"Cs",21
26,"26066",263,201,194,5,7,"Cs",15
49,"49026",199,134,134,0,0,"Cs",7
6,"6063",2924,2141,2108,8,33,"Cs",110
3,"3076",8846,6105,6029,40,76,"Cs",467
24,"24074",97,70,70,1,0,"Cs",5
16,"16032",284,220,220,1,0,"Cs",13
38,"38023",126137,79423,78706,605,717,"Cs",3978
42,"42194",144,101,100,2,1,"Cs",4
12,"12032",23728,16870,16726,121,144,"Cs",1189
26,"26031",95,83,83,0,0,"Cs",5
46,"46062",4552,3402,3362,27,40,"Cs",180
4,"4024",3241,2315,2290,34,25,"Cs",212
26,"26108",309,240,231,2,9,"Cs",17
1,"1041",150,103,102,1,1,"Cs",1
16,"16239",118,88,87,0,1,"Cs",3
9,"9304",198,152,149,1,3,"Cs",17
9,"9083",26,21,21,0,0,"Cs",2
20,"20010",1524,1057,1053,5,4,"Cs",6
28,"28100",4482,3146,3113,21,33,"Cs",263
46,"46085",11089,7581,7503,60,78,"Cs",406
19,"19159",87,73,72,1,1,"Cs",4
49,"49250",1191,844,824,8,20,"Cs",95
46,"46222",402,329,326,0,3,"Cs",20
48,"48051",220,151,150,0,1,"Cs",1
22,"22086",194,137,137,1,0,"Cs",11
16,"16035",224,177,174,2,3,"Cs",10
47,"47100",118,93,87,2,6,"Cs",2
50,"50284",129,98,98,0,0,"Cs",2
28,"28028",1836,1374,1363,3,11,"Cs",70
34,"34124",60,45,45,0,0,"Cs",4
16,"16240",98,71,69,0,2,"Cs",3
40,"40198",24,20,19,0,1,"Cs",3
44,"44130",28,23,23,0,0,"Cs",1
10,"10024",672,492,480,6,12,"Cs",30
23,"23074",2984,2271,2236,20,35,"Cs",119
19,"19250",16,12,12,0,0,"Cs",2
24,"24040",416,293,292,2,1,"Cs",20
44,"44160",438,287,285,4,2,"Cs",17
32,"32072",3664,2387,2355,24,32,"Cs",102
9,"9307",102,76,74,1,2,"Cs",3
47,"47101",1634,1278,1262,7,16,"Cs",82
45,"45124",2080,1628,1595,15,33,"Cs",90
5,"5190",53,44,43,0,1,"Cs",3
46,"46155",972,731,716,3,15,"Cs",31
4,"4027",218,130,130,0,0,"Cs",12
9,"9308",58,34,34,1,0,"Cs",2
47,"47009",98,84,84,0,0,"Cs",5
48,"48072",965,730,724,3,6,"Cs",0
10,"10188",483,354,340,0,14,"Cs",13
32,"32037",679,454,446,6,8,"Cs",53
18,"18072",655,452,445,4,7,"Cs",31
16,"16193",55,50,49,0,1,"Cs",2
22,"22088",143,98,97,1,1,"Cs",5
46,"46019",8932,6721,6647,40,74,"Cs",320
46,"46087",109,94,94,2,0,"Cs",1
24,"24079",861,601,595,9,6,"Cs",28
9,"9309",293,198,193,5,5,"Cs",12
5,"5062",163,121,119,3,2,"Cs",10
22,"22205",448,294,292,0,2,"Cs",17
20,"20013",5433,3906,3893,24,13,"Cs",28
5,"5225",355,276,273,6,3,"Cs",27
42,"42158",97,73,73,1,0,"Cs",6
49,"49143",201,119,118,1,1,"Cs",6
23,"23077",604,482,477,2,5,"Cs",20
40,"40170",1302,962,948,6,14,"Cs",79
15,"15067",7933,5329,5282,43,47,"Cs",212
45,"45016",4486,3288,3251,19,37,"Cs",300
6,"6071",238,192,187,2,5,"Cs",15
7,"7032",21005,12039,11928,114,111,"Cs",825
29,"29087",363,249,243,4,6,"Cs",11
15,"15005",25347,15441,15211,226,230,"Cs",721
4,"4030",1052,690,678,6,12,"Cs",20
33,"33072",1443,816,814,8,2,"Cs",23
6,"6072",2211,1610,1586,11,24,"Cs",109
22,"22028",358,237,233,1,4,"Cs",14
28,"28032",5090,3716,3675,22,41,"Cs",386
40,"40008",42,36,36,1,0,"Cs",1
22,"22129",162,110,110,0,0,"Cs",7
44,"44108",306,209,205,1,4,"Cs",15
45,"45165",62598,43750,43259,329,491,"Cs",3489
18,"18044",161,91,91,0,0,"Cs",4
28,"28033",4177,2972,2936,20,36,"Cs",235
3,"3082",12941,8399,8304,51,95,"Cs",620
29,"29088",2689,1817,1747,15,70,"Cs",112
6,"6073",703,451,441,6,10,"Cs",27
46,"46226",29,20,19,0,1,"Cs",0
9,"9480",105,84,84,0,0,"Cs",7
35,"35013",6593,4596,4516,47,80,"Cs",200
11,"11038",13632,10047,9812,99,235,"Cs",1029
16,"16005",234,163,160,1,3,"Cs",6
19,"19130",61556,45926,45388,408,538,"Cs",3572
40,"40203",987,753,740,13,13,"Cs",59
22,"22208",192,150,147,1,3,"Cs",9
50,"50903",2268,1685,1670,16,15,"Cs",139
45,"45057",224,177,173,0,4,"Cs",10
50,"50223",906,702,693,9,9,"Cs",25
6,"6060",5696,4006,3900,37,106,"Cs",258
9,"9149",36,29,29,0,0,"Cs",3
49,"49035",220,180,180,4,0,"Cs",14
44,"44017",269,217,216,0,1,"Cs",13
2,"2901",2196,1441,1419,10,22,"Cs",75
5,"5066",435,344,341,2,3,"Cs",21
9,"9425",472,311,309,3,2,"Cs",10
12,"12049",415,317,305,4,12,"Cs",14
28,"28109",1651,1131,1116,8,15,"Cs",84
44,"44224",21,14,14,2,0,"Cs",0
41,"41099",3961,2448,2413,14,35,"Cs",138
40,"40204",145,102,101,0,1,"Cs",6
24,"24084",153,105,102,2,3,"Cs",6
41,"41053",21693,15843,15379,171,464,"Cs",1354
45,"45131",259,219,216,1,3,"Cs",4
33,"33075",244,125,122,3,3,"Cs",7
41,"41054",719,562,546,3,16,"Cs",26
50,"50192",227,182,181,0,1,"Cs",13
5,"5166",155,108,104,1,4,"Cs",4
47,"47172",135,114,113,0,1,"Cs",8
40,"40076",6576,4700,4607,32,93,"Cs",342
24,"24086",258,197,196,1,1,"Cs",8
37,"37201",238,170,168,0,2,"Cs",9
37,"37005",65,44,44,1,0,"Cs",3
6,"6078",500,363,359,1,4,"Cs",35
10,"10115",3460,2584,2503,15,81,"Cs",192
47,"47109",161,120,120,1,0,"Cs",5
49,"49005",125,80,80,1,0,"Cs",4
16,"16084",48,34,30,1,4,"Cs",0
40,"40110",316,237,234,4,3,"Cs",26
16,"16250",67,52,52,1,0,"Cs",4
42,"42118",21,11,11,0,0,"Cs",0
47,"47205",355,248,244,2,4,"Cs",20
16,"16122",244,184,182,1,2,"Cs",10
18,"18179",493,315,309,8,6,"Cs",12
21,"21023",2033,1215,1193,10,22,"Cs",62
28,"28112",160,129,129,0,0,"Cs",16
47,"47110",445,335,327,1,8,"Cs",30
13,"13060",274,205,202,3,3,"Cs",10
12,"12128",1365,990,972,16,18,"Cs",62
49,"49006",139,98,95,3,3,"Cs",8
44,"44198",182,138,135,0,3,"Cs",5
4,"4002",1013,711,699,1,12,"Cs",45
11,"11011",1726,1124,1084,8,40,"Cs",90
38,"38007",1619,1053,1043,3,10,"Cs",47
33,"33077",1097,688,683,4,5,"Cs",21
37,"37203",151,114,113,1,1,"Cs",5
5,"5266",100,79,79,1,0,"Cs",2
50,"50218",112,88,88,1,0,"Cs",5
16,"16123",66,42,41,0,1,"Cs",1
27,"27014",3144,2009,1985,24,24,"Cs",74
9,"9003",182,134,132,1,2,"Cs",9
6,"6036",4930,3492,3394,20,98,"Cs",247
38,"38008",5699,3719,3669,26,50,"Cs",162
40,"40014",56,39,38,0,1,"Cs",4
32,"32047",1761,1192,1175,10,17,"Cs",46
9,"9380",71,42,41,0,1,"Cs",2
34,"34048",62,51,51,1,0,"Cs",1
5,"5039",47,43,43,0,0,"Cs",3
22,"22039",813,635,634,4,1,"Cs",31
47,"47208",53,35,35,1,0,"Cs",3
5,"5233",223,174,173,0,1,"Cs",2
6,"6083",46577,31113,30748,338,365,"Cs",3286
47,"47113",134,110,110,0,0,"Cs",8
37,"37300",540,355,352,7,3,"Cs",25
9,"9162",130,102,100,1,2,"Cs",9
10,"10120",153,97,97,0,0,"Cs",2
15,"15013",6324,4132,4083,35,49,"Cs",215
12,"12053",2040,1587,1579,8,8,"Cs",69
11,"11014",17203,10923,10805,222,118,"Cs",1250
24,"24091",575,368,362,5,6,"Cs",23
28,"28040",16741,10717,10604,79,113,"Cs",809
16,"16255",132,99,99,0,0,"Cs",6
34,"34001",39,27,27,1,0,"Cs",1
42,"42171",111,72,71,1,1,"Cs",2
46,"46163",1883,1471,1460,8,11,"Cs",114
5,"5235",141,97,97,2,0,"Cs",5
22,"22139",80,57,57,1,0,"Cs",6
10,"10203",4421,2810,2764,15,46,"Cs",163
28,"28010",10649,8167,8098,76,69,"Cs",771
10,"10122",219,159,157,2,2,"Cs",2
24,"24055",674,484,482,8,2,"Cs",30
47,"47114",3900,2549,2514,18,35,"Cs",216
49,"49267",96,67,63,2,4,"Cs",10
14,"14034",302,222,215,1,7,"Cs",19
40,"40211",66,54,54,1,0,"Cs",2
22,"22041",145,116,116,2,0,"Cs",18
44,"44201",477,399,395,1,4,"Cs",18
3,"3091",244,194,193,2,1,"Cs",4
38,"38010",3969,2463,2418,11,45,"Cs",72
50,"50270",38,26,25,0,1,"Cs",1
34,"34141",176,149,146,0,3,"Cs",6
50,"50044",224,159,159,2,0,"Cs",6
49,"49043",256,191,189,1,2,"Cs",8
6,"6087",1999,1472,1455,13,17,"Cs",69
36,"36043",4696,3038,3003,21,35,"Cs",108
47,"47115",276,212,211,1,1,"Cs",13
16,"16259",28,22,22,0,0,"Cs",0
19,"19073",16,15,15,1,0,"Cs",0
42,"42037",28,13,13,2,0,"Cs",0
3,"3007",173,141,139,0,2,"Cs",5
3,"3092",6712,4924,4858,35,66,"Cs",312
45,"45140",1075,788,772,10,16,"Cs",39
6,"6088",12527,8326,8198,89,128,"Cs",746
48,"48009",774,585,578,0,7,"Cs",0
24,"24022",304,198,195,2,3,"Cs",7
28,"28181",20801,16353,16243,97,110,"Cs",1636
37,"37116",70,50,50,0,0,"Cs",2
34,"34146",53,43,43,0,0,"Cs",0
28,"28043",6190,4031,3969,33,62,"Cs",235
49,"49046",246,174,169,0,5,"Cs",8
49,"49269",218,126,124,1,2,"Cs",13
27,"27019",8188,5478,5395,88,83,"Cs",196
40,"40213",93,78,78,1,0,"Cs",21
49,"49157",188,136,133,2,3,"Cs",13
12,"12133",59,46,45,0,1,"Cs",3
37,"37273",85,58,58,2,0,"Cs",2
50,"50174",80,58,57,0,1,"Cs",2
9,"9170",207,151,150,1,1,"Cs",12
45,"45204",630,453,449,1,4,"Cs",28
12,"12101",354,274,270,5,4,"Cs",14
27,"27010",4378,2719,2670,49,49,"Cs",48
22,"22011",98,80,79,0,1,"Cs",6
48,"48067",1133,810,805,0,5,"Cs",1
20,"20907",118,82,82,0,0,"Cs",0
5,"5143",59,52,51,1,1,"Cs",1
1,"1019",148,112,112,0,0,"Cs",2
16,"16094",121,86,84,0,2,"Cs",8
6,"6091",3669,2581,2525,20,56,"Cs",103
19,"19176",227,172,172,0,0,"Cs",11
15,"15018",1087,680,670,13,10,"Cs",20
9,"9172",131,88,88,1,0,"Cs",3
50,"50224",61,44,44,2,0,"Cs",5
6,"6046",1250,983,959,6,24,"Cs",64
37,"37369",126,83,81,0,2,"Cs",6
44,"44119",116,80,79,1,1,"Cs",1
24,"24096",105,56,54,1,2,"Cs",1
21,"21031",1166,773,736,11,37,"Cs",35
4,"4047",2224,1649,1627,13,22,"Cs",92
47,"47024",223,170,168,1,2,"Cs",12
3,"3095",4807,3453,3410,31,43,"Cs",218
42,"42178",99,71,71,0,0,"Cs",3
39,"39038",1512,992,983,5,9,"Cs",46
39,"39094",840,611,611,2,0,"Cs",20
27,"27022",4654,2760,2696,20,64,"Cs",56
40,"40121",249,188,178,1,10,"Cs",8
19,"19238",43,30,28,0,2,"Cs",0
44,"44235",87,65,64,1,1,"Cs",2
6,"6094",1457,868,858,5,10,"Cs",53
18,"18188",1646,1224,1202,10,22,"Cs",58
47,"47025",114,85,85,3,0,"Cs",3
26,"26093",48,34,33,0,1,"Cs",0
40,"40216",785,633,621,9,12,"Cs",49
37,"37120",98,78,76,0,2,"Cs",11
9,"9175",120,78,76,1,2,"Cs",0
5,"5013",834,658,653,2,5,"Cs",29
4,"4050",742,465,464,0,1,"Cs",19
5,"5242",679,571,562,9,9,"Cs",9
1,"1023",262,193,190,1,3,"Cs",0
29,"29055",1892,1425,1394,3,31,"Cs",68
9,"9445",41,28,27,1,1,"Cs",2
6,"6004",1561,1130,1111,7,19,"Cs",63
28,"28017",1280,975,963,10,12,"Cs",67
7,"7049",1479,935,918,5,17,"Cs",40
47,"47216",111,94,91,0,3,"Cs",7
5,"5048",107,89,88,2,1,"Cs",7
16,"16270",154,123,122,1,1,"Cs",5
40,"40218",80,56,55,0,1,"Cs",1
16,"16271",612,482,481,3,1,"Cs",12
50,"50252",5019,3486,3456,53,30,"Cs",228
41,"41037",3201,2306,2260,22,46,"Cs",95
24,"24212",983,693,684,10,9,"Cs",41
12,"12034",1389,1022,1002,5,20,"Cs",36
10,"10132",360,251,243,1,8,"Cs",9
3,"3012",1138,863,846,4,17,"Cs",66
49,"49054",847,576,569,8,7,"Cs",39
39,"39041",1753,1285,1269,7,16,"Cs",35
24,"24100",737,506,502,9,4,"Cs",28
16,"16272",201,149,147,2,2,"Cs",8
44,"44031",83,50,50,0,0,"Cs",2
24,"24101",370,219,213,4,6,"Cs",9
22,"22903",618,484,482,5,2,"Cs",37
19,"19181",50,34,34,0,0,"Cs",2
5,"5049",403,261,253,1,8,"Cs",20
15,"15023",6277,4021,3968,34,53,"Cs",157
23,"23101",351,238,238,3,0,"Cs",4
26,"26022",177,130,128,0,2,"Cs",11
4,"4085",360,291,289,0,2,"Cs",12
33,"33032",11056,7052,6905,109,147,"Cs",326
4,"4015",113,81,81,0,0,"Cs",1
47,"47156",150,117,117,0,0,"Cs",4
36,"36052",7266,4772,4685,43,87,"Cs",187
27,"27026",2299,1385,1368,9,17,"Cs",46
18,"18001",222,147,146,0,1,"Cs",4
44,"44123",95,68,68,0,0,"Cs",0
30,"30025",5016,3663,3623,22,40,"Cs",203
16,"16024",121,85,84,0,1,"Cs",2
6,"6100",845,626,624,2,2,"Cs",13
50,"50229",65,46,46,1,0,"Cs",3
32,"32062",784,557,550,1,7,"Cs",8
10,"10012",553,427,421,1,6,"Cs",20
34,"34020",49,37,37,1,0,"Cs",1
26,"26099",1220,956,931,7,25,"Cs",50
33,"33061",344,174,174,1,0,"Cs",2
37,"37020",431,320,314,3,6,"Cs",28
47,"47030",935,680,669,5,11,"Cs",46
26,"26100",54,43,43,0,0,"Cs",1
22,"22156",289,216,213,1,3,"Cs",20
11,"11025",4374,2808,2759,30,49,"Cs",140
19,"19272",66,55,55,2,0,"Cs",5
46,"46240",200,167,155,1,12,"Cs",9
50,"50077",201,140,140,1,0,"Cs",7
21,"21037",462,320,313,1,7,"Cs",16
42,"42188",46,35,35,1,0,"Cs",2
3,"3044",4608,3437,3391,13,46,"Cs",249
23,"23031",764,660,640,6,20,"Cs",40
49,"49097",67,44,44,0,0,"Cs",4
2,"2073",4825,3433,3394,35,39,"Cs",195
37,"37125",231,154,148,1,6,"Cs",14
24,"24104",243,167,166,0,1,"Cs",4
11,"11026",4700,3387,3293,17,94,"Cs",262
9,"9350",421,316,311,5,5,"Cs",28
9,"9026",377,288,288,1,0,"Cs",17
9,"9182",74,54,54,0,0,"Cs",2
44,"44212",41,29,29,0,0,"Cs",1
50,"50004",475,360,356,2,4,"Cs",17
23,"23903",3498,2633,2601,28,32,"Cs",83
5,"5153",86,58,56,3,2,"Cs",6
29,"29005",4507,3012,2965,29,47,"Cs",191
11,"11027",68774,45571,45137,567,434,"Cs",4060
24,"24069",37,26,25,0,1,"Cs",0
19,"19277",15,10,10,0,0,"Cs",0
42,"42190",94,61,61,1,0,"Cs",5
47,"47128",53,45,43,0,2,"Cs",1
16,"16104",53,42,42,0,0,"Cs",1
21,"21009",834,527,508,4,19,"Cs",27
9,"9409",117,80,80,0,0,"Cs",1
33,"33036",11281,7240,7153,96,87,"Cs",424
45,"45007",656,502,497,0,5,"Cs",9
34,"34202",28,23,23,2,0,"Cs",1
47,"47150",253,193,187,3,6,"Cs",16
49,"49087",476,246,244,0,2,"Cs",10
4,"4057",1261,886,872,6,14,"Cs",70
26,"26103",814,617,603,10,14,"Cs",23
9,"9030",116,81,81,1,0,"Cs",8
26,"26064",2335,1617,1584,28,33,"Cs",93
38,"38021",1609,900,876,2,24,"Cs",36
37,"37254",174,140,135,0,5,"Cs",8
18,"18067",682,442,437,2,5,"Cs",19
50,"50281",68,52,50,0,2,"Cs",4
41,"41072",4031,2969,2933,15,36,"Cs",93
3,"3018",12433,8582,8502,54,80,"Cs",638
5,"5155",46,33,31,1,2,"Cs",2
45,"45155",311,240,240,0,0,"Cs",8
3,"3104",27072,19732,19477,218,255,"Cs",1789
16,"16146",85,49,49,0,0,"Cs",1
19,"19187",42,32,32,0,0,"Cs",2
46,"46038",302,221,220,1,1,"Cs",5
24,"24108",348,247,246,4,1,"Cs",17
22,"22162",125,94,94,0,0,"Cs",12
44,"44216",27003,19997,19909,80,88,"Cs",734
2,"2010",1784,1374,1349,12,25,"Cs",72
5,"5252",56,46,45,0,1,"Cs",5
14,"14020",336,227,225,0,2,"Cs",11
10,"10904",714,487,473,8,14,"Cs",23
44,"44128",58,39,37,0,2,"Cs",8
7,"7059",3074,1973,1948,17,25,"Cs",131
9,"9356",43,31,30,0,1,"Cs",6
37,"37224",189,156,153,2,3,"Cs",3
5,"5157",227,146,146,3,0,"Cs",6
7,"7026",31129,17489,17342,178,147,"Cs",1416
3,"3105",5510,3879,3792,27,87,"Cs",256
47,"47036",204,159,156,1,3,"Cs",12
16,"16148",544,452,451,2,1,"Cs",13
9,"9034",291,227,224,1,3,"Cs",22
50,"50234",242,159,154,4,5,"Cs",14
44,"44066",85,62,62,0,0,"Cs",2
19,"19249",29,26,26,0,0,"Cs",1
33,"33012",5085,3158,3142,27,16,"Cs",165
47,"47037",161,128,125,1,3,"Cs",3
42,"42058",103,74,72,1,2,"Cs",3
12,"12042",574,459,446,9,13,"Cs",16
24,"24110",1158,784,773,1,11,"Cs",20
37,"37319",88,68,64,2,4,"Cs",5
49,"49173",335,165,163,4,2,"Cs",3
20,"20040",15771,10549,10481,54,68,"Cs",79
23,"23002",17427,12837,12542,126,295,"Cs",1060
10,"10145",123,90,84,0,6,"Cs",5
19,"19091",23,17,17,0,0,"Cs",0
46,"46040",993,745,733,3,12,"Cs",33
21,"21075",338,243,235,3,8,"Cs",14
47,"47133",2776,2096,2073,28,23,"Cs",221
16,"16150",98,66,66,2,0,"Cs",7
20,"20041",241,143,142,2,1,"Cs",2
40,"40230",93,66,64,0,2,"Cs",3
28,"28133",6146,4245,4180,25,65,"Cs",263
45,"45160",1097,838,824,4,14,"Cs",56
9,"9037",105,94,93,0,1,"Cs",5
10,"10023",842,597,589,2,8,"Cs",28
27,"27035",183,110,110,3,0,"Cs",0
40,"40135",277,212,210,3,2,"Cs",4
40,"40103",139,113,113,0,0,"Cs",6
5,"5159",224,133,132,3,1,"Cs",7
40,"40036",496,395,380,8,15,"Cs",22
29,"29038",18908,12122,11931,197,191,"Cs",1137
26,"26110",149,116,114,0,2,"Cs",4
37,"37133",101,73,69,1,4,"Cs",9
6,"6114",127,105,105,0,0,"Cs",2
3,"3109",3003,2186,2151,14,35,"Cs",131
50,"50010",67,52,52,1,0,"Cs",8
21,"21046",1729,1212,1187,14,25,"Cs",60
18,"18908",776,553,528,3,25,"Cs",57
3,"3139",23126,14650,14522,127,128,"Cs",1272
40,"40168",27,20,20,0,0,"Cs",0
16,"16001",62,45,45,0,0,"Cs",0
3,"3110",312,258,258,0,0,"Cs",6
39,"39051",73,64,64,1,0,"Cs",6
44,"44041",60,48,48,0,0,"Cs",4
3,"3080",1330,1040,1032,4,8,"Cs",46
46,"46110",21364,15132,15019,120,113,"Cs",1140
45,"45162",630,448,438,1,10,"Cs",24
15,"15035",11189,7256,7165,104,91,"Cs",257
47,"47040",56,42,41,0,1,"Cs",2
39,"39080",3477,2404,2388,4,16,"Cs",74
40,"40200",38,28,28,0,0,"Cs",3
24,"24227",1527,1036,1032,13,4,"Cs",65
20,"20044",355,261,261,1,0,"Cs",1
19,"19192",1762,1251,1240,5,11,"Cs",53
33,"33043",656,408,401,2,7,"Cs",7
19,"19285",20,16,16,0,0,"Cs",0
40,"40201",42,37,37,0,0,"Cs",3
50,"50138",45,37,37,3,0,"Cs",4
7,"7065",2319,1429,1411,15,18,"Cs",67
6,"6117",1388,982,958,11,24,"Cs",68
42,"42201",23,21,21,0,0,"Cs",0
24,"24228",619,370,364,2,6,"Cs",9
49,"49071",716,432,429,6,3,"Cs",33
2,"2017",760,498,493,1,5,"Cs",14
46,"46043",135,119,118,0,1,"Cs",2
15,"15036",56053,36487,36175,501,312,"Cs",1509
22,"22170",672,460,456,5,4,"Cs",21
34,"34037",301,206,204,1,2,"Cs",17
3,"3112",650,503,497,3,6,"Cs",12
41,"41079",9285,6591,6446,101,145,"Cs",482
44,"44042",114,82,81,0,1,"Cs",3
45,"45128",2569,1676,1652,6,24,"Cs",107
50,"50139",318,237,237,1,0,"Cs",15
15,"15037",4026,2375,2349,10,26,"Cs",101
37,"37104",24,16,16,0,0,"Cs",0
19,"19287",134,100,98,2,2,"Cs",8
33,"33017",2969,1787,1768,38,19,"Cs",69
16,"16155",490,389,388,7,1,"Cs",9
50,"50165",1768,1255,1222,20,33,"Cs",123
28,"28138",60,43,42,0,1,"Cs",7
2,"2085",306,232,226,2,6,"Cs",6
9,"9202",22,16,16,2,0,"Cs",0
27,"27009",2005,1324,1303,11,21,"Cs",33
47,"47105",169,138,137,2,1,"Cs",7
9,"9257",85,67,67,2,0,"Cs",3
46,"46067",1753,1356,1341,8,15,"Cs",77
50,"50063",64,49,49,0,0,"Cs",1
41,"41052",3032,2162,2092,6,70,"Cs",172
9,"9372",204,175,169,2,6,"Cs",10
22,"22061",6567,4446,4410,48,36,"Cs",375
42,"42205",77,59,57,3,2,"Cs",2
28,"28064",125,98,95,3,3,"Cs",3
42,"42027",72,48,47,1,1,"Cs",0
49,"49147",250,164,162,1,2,"Cs",15
24,"24193",363,264,264,1,0,"Cs",7
11,"11039",9957,6134,6043,152,91,"Cs",418
40,"40903",75,61,59,0,2,"Cs",4
22,"22131",84,62,58,5,4,"Cs",4
9,"9316",104,80,80,0,0,"Cs",9
4,"4069",4742,3364,3325,46,39,"Cs",215
50,"50241",582,414,406,2,8,"Cs",25
16,"16043",88,60,60,3,0,"Cs",2
21,"21051",222,171,168,3,3,"Cs",6
38,"38030",1962,1332,1318,9,14,"Cs",40
29,"29044",749,477,473,1,4,"Cs",17
19,"19289",23,16,16,0,0,"Cs",2
9,"9259",230,178,176,2,2,"Cs",11
6,"6077",319,234,229,2,5,"Cs",8
44,"44197",51,35,35,1,0,"Cs",0
32,"32007",1413,873,862,2,11,"Cs",17
46,"46046",901,623,609,2,14,"Cs",49
20,"20049",4195,2918,2901,12,17,"Cs",22
47,"47141",112,90,89,0,1,"Cs",7
18,"18017",18201,11500,11358,94,142,"Cs",1020
44,"44225",105,82,81,2,1,"Cs",7
10,"10156",97,71,69,0,2,"Cs",2
34,"34045",72,62,62,0,0,"Cs",2
1,"1054",998,701,700,4,1,"Cs",5
36,"36038",66807,46235,45781,493,454,"Cs",2322
20,"20019",9892,6740,6717,40,23,"Cs",40
5,"5069",73,59,59,0,0,"Cs",4
11,"11041",9869,6438,6295,100,143,"Cs",592
23,"23011",2138,1536,1507,17,29,"Cs",95
44,"44226",123,85,84,0,1,"Cs",0
37,"37140",630,395,393,0,2,"Cs",25
46,"46047",540,428,420,1,8,"Cs",20
10,"10157",246,163,161,0,2,"Cs",7
50,"50016",44,31,31,0,0,"Cs",3
3,"3030",559,442,433,2,9,"Cs",30
4,"4072",311,212,211,0,1,"Cs",8
9,"9159",62,49,47,0,2,"Cs",3
27,"27045",926,588,583,6,5,"Cs",13
19,"19105",2550,1913,1889,10,24,"Cs",161
5,"5070",30,29,29,0,0,"Cs",0
46,"46184",26514,19610,19399,180,211,"Cs",1310
50,"50066",2903,2095,2078,19,17,"Cs",185
34,"34047",1711,1275,1248,18,27,"Cs",88
24,"24016",488,244,243,0,1,"Cs",3
46,"46116",13606,10262,10200,87,62,"Cs",882
44,"44227",72,58,58,0,0,"Cs",1
12,"12079",414,310,305,2,5,"Cs",18
37,"37331",186,115,114,2,1,"Cs",7
3,"3031",42046,25035,24819,168,216,"Cs",1750
21,"21055",7326,5395,5309,43,86,"Cs",282
13,"13063",3648,2464,2406,28,58,"Cs",167
4,"4903",4320,2907,2873,18,34,"Cs",184
38,"38033",3593,2277,2242,15,35,"Cs",53
10,"10037",76966,54717,53914,546,803,"Cs",5196
16,"16161",51,44,44,1,0,"Cs",2
23,"23015",1316,979,973,18,6,"Cs",47
45,"45172",640,475,462,6,13,"Cs",27
37,"37238",105,83,80,0,3,"Cs",7
45,"45063",375,268,264,0,4,"Cs",4
40,"40047",37,23,23,0,0,"Cs",2
30,"30016",153034,101232,100202,776,1030,"Cs",8260
40,"40145",1098,824,820,4,4,"Cs",61
49,"49082",341,273,270,12,3,"Cs",12
27,"27047",1517,955,940,12,15,"Cs",25
18,"18916",1815,1093,1086,6,7,"Cs",72
22,"22178",105,89,89,1,0,"Cs",8
39,"39060",6704,4959,4887,23,72,"Cs",203
14,"14033",1239,875,856,8,19,"Cs",78
42,"42213",25,17,16,1,1,"Cs",1
11,"11902",3664,2123,2094,46,29,"Cs",169
28,"28070",105,80,80,3,0,"Cs",1
19,"19037",131,109,108,0,1,"Cs",3
29,"29095",3285,2313,2224,39,89,"Cs",109
37,"37114",74,58,55,1,3,"Cs",4
19,"19329",58,46,46,0,0,"Cs",1
29,"29021",155,111,109,1,2,"Cs",10
27,"27017",952,568,562,3,6,"Cs",22
15,"15077",8103,4893,4818,61,75,"Cs",198
40,"40016",55,44,43,1,1,"Cs",2
5,"5074",668,540,537,5,3,"Cs",55
41,"41003",2373,1747,1708,18,39,"Cs",92
5,"5902",286,214,211,1,3,"Cs",13
36,"36013",2216,1298,1290,18,8,"Cs",49
24,"24127",263,183,181,1,2,"Cs",12
9,"9386",55,43,43,0,0,"Cs",4
45,"45175",603,476,473,1,3,"Cs",19
34,"34004",5517,3819,3769,36,50,"Cs",252
22,"22069",423,296,294,4,2,"Cs",33
40,"40148",231,165,163,4,2,"Cs",18
16,"16050",218,172,169,2,3,"Cs",3
49,"49190",50,42,42,3,0,"Cs",2
9,"9059",136870,99937,98641,1416,1296,"Cs",8285
23,"23018",2243,1606,1584,17,22,"Cs",83
26,"26013",330,243,242,2,1,"Cs",14
29,"29050",392,229,227,3,2,"Cs",26
3,"3035",627,485,485,2,0,"Cs",16
9,"9060",126,104,104,2,0,"Cs",0
5,"5173",60,54,54,0,0,"Cs",8
9,"9330",1481,1050,1037,17,13,"Cs",80
14,"14036",3677,2619,2555,39,64,"Cs",181
23,"23093",3119,2264,2216,24,48,"Cs",111
40,"40051",34,25,25,0,0,"Cs",1
46,"46188",693,565,560,2,5,"Cs",36
19,"19109",33,26,26,2,0,"Cs",0
13,"13023",8944,6251,6165,50,86,"Cs",319
50,"50095",12149,8322,8239,91,83,"Cs",530
5,"5174",62,51,51,1,0,"Cs",4
19,"19110",51,39,39,0,0,"Cs",3
9,"9061",147,119,119,0,0,"Cs",2
29,"29052",213,129,128,0,1,"Cs",11
33,"33027",752,412,405,11,7,"Cs",11
22,"22184",167,132,130,4,2,"Cs",12
20,"20057",198,148,147,1,1,"Cs",0
42,"42219",40,34,34,1,0,"Cs",2
28,"28151",3274,2344,2310,16,34,"Cs",202
47,"47054",599,465,460,1,5,"Cs",39
12,"12134",135,95,95,1,0,"Cs",3
19,"19237",39,34,34,0,0,"Cs",4
3,"3094",9795,6528,6481,37,47,"Cs",601
18,"18153",8834,6174,6063,54,111,"Cs",507
34,"34902",123,91,91,0,0,"Cs",4
9,"9016",85,54,54,0,0,"Cs",3
44,"44053",103,87,85,1,2,"Cs",11
40,"40151",43,31,31,0,0,"Cs",4
34,"34204",50,35,35,0,0,"Cs",1
4,"4080",196,148,147,2,1,"Cs",10
2,"2031",535,406,401,4,5,"Cs",21
7,"7046",16884,9184,9097,97,87,"Cs",543
9,"9063",215,184,181,2,3,"Cs",20
45,"45070",1412,1158,1136,7,22,"Cs",53
37,"37338",77,58,58,0,0,"Cs",4
47,"47055",188,147,147,2,0,"Cs",5
37,"37149",60,50,50,0,0,"Cs",2
39,"39066",866,616,606,6,10,"Cs",13
48,"48096",6516,4862,4816,33,46,"Cs",28
3,"3038",330,260,254,3,6,"Cs",7
19,"19300",782,591,588,5,3,"Cs",50
49,"49090",190,135,134,3,1,"Cs",10
47,"47056",81,57,57,0,0,"Cs",5
46,"46122",2726,1957,1934,13,23,"Cs",110
28,"28088",296,196,191,1,5,"Cs",21
47,"47152",67,59,59,0,0,"Cs",2
19,"19209",40,30,29,0,1,"Cs",0
2,"2033",1864,1352,1315,12,37,"Cs",56
12,"12005",8049,5643,5552,71,91,"Cs",319
45,"45182",996,760,754,5,6,"Cs",25
24,"24026",1085,724,712,14,12,"Cs",43
15,"15051",4545,2978,2945,47,33,"Cs",97
42,"42044",53,37,35,1,2,"Cs",2
34,"34104",231,164,162,2,2,"Cs",9
10,"10211",446,303,300,0,3,"Cs",15
47,"47027",2799,2059,2025,12,34,"Cs",190
7,"7016",2970,1891,1865,22,26,"Cs",139
23,"23098",847,704,700,0,4,"Cs",23
14,"14068",517,388,378,3,10,"Cs",30
16,"16022",76,63,63,0,0,"Cs",6
45,"45183",2378,1555,1525,16,30,"Cs",132
45,"45184",204,123,122,0,1,"Cs",4
44,"44150",28,17,17,0,0,"Cs",1
30,"30022",17108,11041,10851,100,190,"Cs",835
21,"21064",6674,4503,4426,68,77,"Cs",249
9,"9396",149,121,121,4,0,"Cs",6
34,"34106",110,92,92,3,0,"Cs",3
48,"48901",5160,3705,3684,16,21,"Cs",42
48,"48042",1359,1055,1045,7,10,"Cs",13
42,"42045",273,175,174,4,1,"Cs",12
3,"3128",4285,2849,2819,18,30,"Cs",219
37,"37050",66,52,52,1,0,"Cs",1
41,"41010",4586,3218,3157,42,61,"Cs",225
20,"20061",4427,3073,3053,13,20,"Cs",8
48,"48014",1229,845,843,8,2,"Cs",7
4,"4084",337,238,232,0,6,"Cs",10
30,"30023",3874,2831,2788,18,43,"Cs",132
5,"5179",199,176,172,1,4,"Cs",10
37,"37154",129,97,94,1,3,"Cs",8
49,"49094",210,111,111,0,0,"Cs",3
5,"5082",491,379,369,2,10,"Cs",17
48,"48015",33077,22441,22295,145,146,"Cs",278
10,"10174",171,112,110,0,2,"Cs",6
10,"10215",438,266,262,2,4,"Cs",5
39,"39013",517,359,356,1,3,"Cs",6
47,"47091",76,60,59,2,1,"Cs",1
45,"45076",574,361,357,1,4,"Cs",14
9,"9287",191,144,143,2,1,"Cs",10
2,"2037",22963,14737,14588,68,149,"Cs",996
44,"44152",70,46,46,0,0,"Cs",5
37,"37249",37,28,28,0,0,"Cs",2
19,"19116",12,10,10,0,0,"Cs",0
47,"47219",39,31,28,1,3,"Cs",1
18,"18032",247,164,163,1,1,"Cs",10
20,"20033",858,644,638,1,6,"Cs",2
12,"12138",19207,13018,12891,87,127,"Cs",703
3,"3014",238937,161861,160809,1308,1052,"Cs",15191
45,"45077",546,413,409,0,4,"Cs",18
40,"40158",15,11,11,0,0,"Cs",1
23,"23901",1125,905,895,3,10,"Cs",72
19,"19047",55,47,47,1,0,"Cs",2
37,"37344",229,157,147,2,10,"Cs",14
18,"18033",279,179,174,0,5,"Cs",3
36,"36023",8258,5504,5384,44,120,"Cs",275
6,"6147",329,234,234,1,0,"Cs",12
13,"13036",752,552,546,1,6,"Cs",31
19,"19305",139,104,103,1,1,"Cs",6
44,"44153",1733,1131,1125,0,6,"Cs",46
45,"45078",1333,1084,1077,6,7,"Cs",37
49,"49096",155,113,112,2,1,"Cs",5
27,"27059",2035,1356,1322,7,34,"Cs",42
47,"47221",97,85,84,1,1,"Cs",4
15,"15088",3396,2047,2022,22,25,"Cs",84
9,"9181",276,194,191,7,3,"Cs",14
29,"29060",665,454,450,1,4,"Cs",23
5,"5086",76,58,58,1,0,"Cs",3
48,"48018",854,563,560,5,3,"Cs",0
22,"22195",238,190,186,0,4,"Cs",14
10,"10055",697,488,473,3,15,"Cs",30
41,"41014",2476,1852,1799,10,53,"Cs",61
10,"10056",533,377,371,2,6,"Cs",9
26,"26142",789,572,564,6,8,"Cs",25
44,"44062",31,20,20,0,0,"Cs",2
23,"23032",529,427,419,5,8,"Cs",13
19,"19216",127,88,88,0,0,"Cs",6
47,"47159",825,672,661,0,11,"Cs",44
19,"19087",17,16,16,0,0,"Cs",0
34,"34217",1269,999,983,14,16,"Cs",78
42,"42095",1909,1345,1326,32,19,"Cs",90
37,"37127",205,139,139,1,0,"Cs",6
47,"47190",95,75,75,1,0,"Cs",5
46,"46014",3156,2324,2294,13,30,"Cs",171
24,"24070",3886,2677,2625,18,52,"Cs",86
37,"37056",39,28,28,0,0,"Cs",6
10,"10099",563,369,358,3,11,"Cs",22
2,"2042",810,581,577,1,4,"Cs",27
26,"26181",15,14,14,0,0,"Cs",0
44,"44063",63,52,52,0,0,"Cs",5
22,"22083",447,360,355,6,5,"Cs",30
12,"12142",142,113,113,0,0,"Cs",11
6,"6105",592,367,363,1,4,"Cs",18
18,"18903",852,544,537,9,7,"Cs",30
9,"9298",72,52,52,1,0,"Cs",4
19,"19278",24,20,20,0,0,"Cs",0
47,"47034",75,58,58,2,0,"Cs",0
9,"9410",3019,1924,1898,21,26,"Cs",49
26,"26028",135,111,110,3,1,"Cs",2
48,"48020",272771,184893,183922,1227,971,"Cs",2384
38,"38046",9267,6652,6594,55,58,"Cs",374
27,"27062",583,403,400,2,3,"Cs",5
20,"20068",179,119,119,2,0,"Cs",0
45,"45082",1145,904,893,7,11,"Cs",29
12,"12094",871,671,661,1,10,"Cs",34
50,"50183",316,227,223,1,4,"Cs",21
6,"6017",250,202,198,0,4,"Cs",28
13,"13042",880,638,626,2,12,"Cs",39
5,"5089",455,342,324,0,18,"Cs",11
15,"15060",5871,4044,3978,58,66,"Cs",182
22,"22084",571,400,391,5,9,"Cs",23
34,"34072",145,125,123,1,2,"Cs",4
29,"29063",305,244,242,2,2,"Cs",20
50,"50107",988,758,755,8,3,"Cs",62
45,"45084",2103,1533,1508,7,25,"Cs",89
24,"24038",3024,2121,2071,25,50,"Cs",118
26,"26146",84,56,55,0,1,"Cs",2
47,"47131",167,122,120,2,2,"Cs",10
47,"47066",1482,1096,1086,14,10,"Cs",75
9,"9413",405,267,263,0,4,"Cs",27
13,"13044",2582,1838,1804,13,34,"Cs",104
14,"14049",16185,11561,11323,145,238,"Cs",914
28,"28164",3230,2371,2345,28,26,"Cs",201
47,"47163",277,208,205,3,3,"Cs",10
5,"5125",56,47,46,0,1,"Cs",4
22,"22202",147,128,128,3,0,"Cs",12
44,"44245",240,177,174,0,3,"Cs",12
13,"13045",622,459,451,0,8,"Cs",16
40,"40229",26,22,22,0,0,"Cs",1
36,"36028",4049,2783,2739,22,44,"Cs",112
40,"40068",22,21,21,0,0,"Cs",0
30,"30030",321454,235061,233183,1744,1878,"Cs",19344
33,"33040",4556,2837,2784,58,53,"Cs",146
49,"49104",326,218,216,0,2,"Cs",8
50,"50108",50,37,37,0,0,"Cs",0
24,"24039",1949,1420,1412,33,8,"Cs",105
50,"50033",61,44,44,1,0,"Cs",0
2,"2013",125,90,88,0,2,"Cs",4
28,"28166",357,281,276,1,5,"Cs",26
38,"38048",3952,2543,2519,22,24,"Cs",78
26,"26148",154,125,122,3,3,"Cs",4
34,"34224",39,25,25,0,0,"Cs",2
4,"4095",687,462,457,4,5,"Cs",35
45,"45087",8180,5737,5628,41,109,"Cs",404
12,"12097",62,53,51,0,2,"Cs",4
34,"34076",532,443,438,1,5,"Cs",24
5,"5093",362,251,249,0,2,"Cs",12
14,"14051",1323,975,951,7,24,"Cs",48
9,"9248",80,62,61,1,1,"Cs",6
37,"37062",78,59,59,0,0,"Cs",3
9,"9085",481,349,342,2,7,"Cs",34
21,"21076",2153,1459,1426,31,33,"Cs",78
50,"50110",340,248,238,1,10,"Cs",7
30,"30032",2864,2154,2129,18,25,"Cs",101
34,"34225",5016,3708,3650,41,58,"Cs",232
5,"5027",258,209,203,5,6,"Cs",13
27,"27901",2249,1373,1360,22,13,"Cs",35
34,"34079",1729,1296,1275,19,21,"Cs",83
26,"26150",97,77,77,1,0,"Cs",1
26,"26071",8644,5668,5591,53,77,"Cs",365
21,"21016",985,703,680,5,23,"Cs",36
33,"33014",8735,5744,5689,67,55,"Cs",317
50,"50261",201,154,151,0,3,"Cs",7
14,"14052",9039,5579,5478,79,101,"Cs",370
44,"44249",40,30,30,0,0,"Cs",3
27,"27037",1001,714,707,11,7,"Cs",9
45,"45199",3188,2077,2055,20,22,"Cs",157
10,"10066",161,121,120,1,1,"Cs",3
13,"13050",475,348,345,1,3,"Cs",19
3,"3024",3937,2992,2952,19,40,"Cs",170
38,"38026",33585,24091,23889,170,202,"Cs",1045
14,"14053",5918,4054,3968,92,86,"Cs",233
34,"34080",5231,3207,3161,35,46,"Cs",227
40,"40071",39,32,26,0,6,"Cs",3
9,"9473",85,68,64,0,4,"Cs",5
26,"26036",16989,11463,11260,101,203,"Cs",848
28,"28169",1577,1214,1209,7,5,"Cs",130
46,"46179",2136,1624,1596,17,28,"Cs",82
32,"32038",387,253,251,4,2,"Cs",9
37,"37354",5479,3969,3905,37,64,"Cs",406
20,"20075",4312,2848,2845,8,3,"Cs",17
3,"3053",7568,5551,5468,40,83,"Cs",489
24,"24155",441,340,334,2,6,"Cs",18
19,"19127",88,60,60,1,0,"Cs",2
2,"2050",85,66,66,1,0,"Cs",2
40,"40072",224,175,171,1,4,"Cs",17
10,"10191",511,374,365,5,9,"Cs",21
14,"14054",13775,10464,10165,105,299,"Cs",797
6,"6901",2125,1549,1520,28,29,"Cs",99
46,"46203",3546,2717,2689,28,28,"Cs",158
12,"12100",1273,1069,1052,5,17,"Cs",47
37,"37136",625,388,387,7,1,"Cs",51
5,"5163",1702,1258,1233,5,25,"Cs",78
45,"45202",3963,2806,2771,10,35,"Cs",140
19,"19129",25,21,21,0,0,"Cs",5
24,"24046",893,595,583,6,12,"Cs",24
18,"18143",945,661,651,2,10,"Cs",48
44,"44251",239,187,183,1,4,"Cs",4
1,"1003",1166,843,837,6,6,"Cs",0
33,"33045",4359,2819,2787,32,32,"Cs",161
26,"26115",23,22,21,3,1,"Cs",1
40,"40073",387,327,323,1,4,"Cs",27
28,"28171",4410,2921,2889,8,32,"Cs",175
40,"40172",47,33,32,0,1,"Cs",2
15,"15007",3164,2081,2060,24,21,"Cs",47
24,"24083",997,659,647,9,12,"Cs",33
50,"50166",235,186,186,0,0,"Cs",19
4,"4068",170,129,128,0,1,"Cs",3
45,"45093",147,115,114,0,1,"Cs",13
34,"34084",158,125,125,1,0,"Cs",11
4,"4101",4356,2818,2768,32,50,"Cs",153
22,"22095",66,52,51,1,1,"Cs",2
37,"37138",222,163,159,3,4,"Cs",7
40,"40041",966,729,716,8,13,"Cs",76
9,"9047",52,42,41,1,1,"Cs",4
10,"10072",837,545,539,5,6,"Cs",21
33,"33046",480,334,329,0,5,"Cs",6
19,"19288",21,20,20,2,0,"Cs",2
2,"2020",425,336,332,4,4,"Cs",10
26,"26041",109,67,65,0,2,"Cs",1
40,"40075",152,116,116,0,0,"Cs",12
28,"28004",6618,4502,4457,28,45,"Cs",332
46,"46068",345,283,279,2,4,"Cs",15
48,"48030",591,449,447,2,2,"Cs",0
46,"46205",14237,10641,10533,77,108,"Cs",824
5,"5196",57,43,43,0,0,"Cs",3
11,"11040",396,332,324,3,8,"Cs",21
26,"26118",71,54,53,1,1,"Cs",1
13,"13012",381,265,261,1,4,"Cs",2
44,"44257",149,92,91,0,1,"Cs",5
49,"49226",240,200,198,2,2,"Cs",13
44,"44167",34,26,26,0,0,"Cs",0
26,"26158",242,184,181,1,3,"Cs",4
32,"32044",794,547,540,2,7,"Cs",24
39,"39001",2063,1474,1467,5,7,"Cs",50
22,"22002",99,81,81,0,0,"Cs",2
45,"45901",779,542,534,5,8,"Cs",27
6,"6079",649,451,445,3,6,"Cs",22
9,"9901",334,228,226,4,2,"Cs",20
22,"22099",490,349,343,2,6,"Cs",19
42,"42030",91,69,69,2,0,"Cs",4
37,"37266",68,44,44,0,0,"Cs",2
9,"9428",102,73,73,1,0,"Cs",3
12,"12022",323,257,254,5,3,"Cs",10
1,"1009",1258,839,833,2,6,"Cs",2
5,"5198",70,53,51,0,2,"Cs",6
10,"10076",791,537,525,10,12,"Cs",35
41,"41027",4007,2628,2546,33,82,"Cs",150
39,"39086",358,236,235,2,1,"Cs",3
33,"33048",132,86,85,1,1,"Cs",1
19,"19033",47,38,37,1,1,"Cs",0
6,"6035",851,630,620,0,10,"Cs",18
9,"9430",25,21,21,0,0,"Cs",1
20,"20081",7690,5382,5363,31,19,"Cs",22
26,"26161",8,8,8,0,0,"Cs",0
19,"19230",558,409,406,1,3,"Cs",35
9,"9103",200,168,166,1,2,"Cs",8
28,"28176",13980,10765,10701,72,64,"Cs",1149
7,"7005",6956,4042,3996,35,46,"Cs",345
22,"22102",180,137,136,3,1,"Cs",8
45,"45098",2090,1488,1469,7,19,"Cs",71
5,"5104",33,21,19,0,2,"Cs",1
2,"2057",1947,1358,1333,15,25,"Cs",62
28,"28008",2008,1333,1323,7,10,"Cs",76
22,"22177",96,69,68,0,1,"Cs",7
5,"5169",218,171,171,1,0,"Cs",12
19,"19034",25,22,21,0,1,"Cs",2
46,"46071",471,355,349,1,6,"Cs",19
49,"49117",431,294,289,0,5,"Cs",18
46,"46257",5436,3972,3933,28,39,"Cs",182
26,"26046",1552,1056,1027,11,29,"Cs",76
28,"28177",10851,8550,8485,89,65,"Cs",918
9,"9267",117,95,93,1,2,"Cs",8
6,"6038",785,561,550,5,11,"Cs",49
10,"10201",178,142,141,2,1,"Cs",8
44,"44172",296,216,216,1,0,"Cs",6
3,"3060",105,78,77,0,1,"Cs",3
49,"49118",193,151,151,2,0,"Cs",5
1,"1013",710,469,465,2,4,"Cs",2
12,"12106",1151,928,908,9,20,"Cs",63
9,"9268",89,62,62,0,0,"Cs",2
46,"46140",383,321,321,2,0,"Cs",30
37,"37363",104,81,80,0,1,"Cs",2
41,"41030",501,376,366,9,10,"Cs",20
37,"37269",424,280,277,2,3,"Cs",15
28,"28115",62612,50619,50431,399,188,"Cs",5438
49,"49009",382,251,251,0,0,"Cs",13
50,"50146",189,149,149,3,0,"Cs",1
18,"18085",690,440,432,1,8,"Cs",31
46,"46118",3649,2730,2701,20,29,"Cs",160
19,"19172",51,38,38,0,0,"Cs",4
40,"40115",142,100,100,0,0,"Cs",4
49,"49231",288,208,203,0,5,"Cs",8
1,"1016",428,194,192,4,2,"Cs",1
10,"10082",1793,1333,1305,11,28,"Cs",67
2,"2060",1268,953,939,7,14,"Cs",70
50,"50120",55,42,42,1,0,"Cs",3
33,"33052",681,418,416,3,2,"Cs",14
23,"23054",375,280,272,1,8,"Cs",7
7,"7009",737,495,488,3,7,"Cs",26
28,"28011",417,295,292,6,3,"Cs",19
40,"40180",276,215,210,2,5,"Cs",19
4,"4006",7192,4389,4335,39,54,"Cs",378
24,"24166",1346,929,916,14,13,"Cs",66
29,"29067",431757,290824,287855,3289,2969,"Cs",27287
40,"40081",117,80,76,1,4,"Cs",4
46,"46005",23129,16610,16437,148,173,"Cs",1274
9,"9112",102,73,73,0,0,"Cs",6
26,"26049",156,120,115,0,5,"Cs",7
46,"46260",2685,2072,2053,14,19,"Cs",135
5,"5205",81,59,58,2,1,"Cs",5
40,"40181",4182,3102,3038,35,64,"Cs",277
44,"44086",410,302,298,3,4,"Cs",29
5,"5206",26,17,17,0,0,"Cs",1
27,"27050",2821,1980,1954,11,26,"Cs",45
36,"36045",24459,16966,16735,124,231,"Cs",517
6,"6043",677,493,488,5,5,"Cs",36
20,"20905",160,123,123,2,0,"Cs",0
19,"19235",98,77,76,1,1,"Cs",2
13,"13069",613,438,419,2,19,"Cs",10
16,"16093",54,45,45,0,0,"Cs",1
46,"46211",1862,1395,1381,12,14,"Cs",101
32,"32052",1817,1278,1268,12,10,"Cs",29
20,"20906",128,87,87,0,0,"Cs",0
34,"34901",1053,762,759,10,3,"Cs",35
33,"33054",1601,1025,1010,17,15,"Cs",58
16,"16213",34,27,26,0,1,"Cs",2
10,"10044",1405,968,955,11,13,"Cs",75
28,"28182",203,167,163,1,4,"Cs",15
26,"26015",185,140,138,2,2,"Cs",3
19,"19145",40,32,32,0,0,"Cs",3
18,"18025",277,198,197,0,1,"Cs",16
34,"34056",1926,1335,1311,10,24,"Cs",100
26,"26089",111981,80365,79216,893,1149,"Cs",6221
11,"11018",1434,1001,977,8,24,"Cs",69
50,"50046",162,125,125,6,0,"Cs",8
19,"19333",96,68,67,0,1,"Cs",2
4,"4009",140,109,106,2,3,"Cs",5
3,"3065",169894,121210,120342,1045,868,"Cs",9985
10,"10087",1588,1105,1093,10,12,"Cs",50
22,"22110",700,476,473,3,3,"Cs",22
9,"9276",390,256,244,4,12,"Cs",6
18,"18057",5584,4042,3958,51,84,"Cs",358
6,"6047",829,618,605,1,13,"Cs",30
23,"23058",8832,6528,6407,57,121,"Cs",382
28,"28015",20885,16237,16104,134,133,"Cs",1881
28,"28087",3301,2539,2519,20,20,"Cs",194
37,"37180",68,45,44,1,1,"Cs",2
7,"7014",7885,3934,3893,43,41,"Cs",255
42,"42004",2290,1595,1565,30,30,"Cs",107
40,"40184",245,196,194,0,2,"Cs",19
9,"9277",103,84,82,1,2,"Cs",2
22,"22222",516,379,377,6,2,"Cs",39
29,"29071",980,580,564,11,16,"Cs",37
32,"32056",1490,1009,1003,10,6,"Cs",21
33,"33029",315,145,142,1,3,"Cs",1
37,"37181",265,158,158,0,0,"Cs",9
34,"34103",96,79,76,0,3,"Cs",4
9,"9119",42,24,24,0,0,"Cs",1
24,"24062",126,79,79,0,0,"Cs",3
37,"37083",181,155,153,1,2,"Cs",10
7,"7015",22248,12375,12286,202,89,"Cs",932
28,"28902",521,394,389,3,5,"Cs",16
50,"50048",33,25,25,0,0,"Cs",0
9,"9019",146,105,103,4,2,"Cs",6
48,"48069",13131,9211,9162,55,49,"Cs",75
47,"47088",101,79,79,0,0,"Cs",5
2,"2067",1137,808,794,2,14,"Cs",44
19,"19211",350,272,269,0,3,"Cs",8
49,"49273",165,90,90,0,0,"Cs",3
19,"19113",454,327,322,4,5,"Cs",30
42,"42134",2651,1875,1836,21,39,"Cs",117
37,"37371",252,156,155,0,1,"Cs",2
19,"19901",35,27,27,0,0,"Cs",0
22,"22112",9525,6317,6245,91,72,"Cs",555
49,"49239",599,393,384,6,9,"Cs",13
4,"4013",143819,93083,92383,893,700,"Cs",7848
26,"26056",404,312,301,2,11,"Cs",7
44,"44268",32,30,30,0,0,"Cs",5
49,"49127",2402,1640,1604,18,36,"Cs",104
5,"5115",509,350,344,0,6,"Cs",19
41,"41009",1148,750,732,5,18,"Cs",97
28,"28018",4121,3174,3151,22,23,"Cs",225
33,"33059",4359,2651,2625,33,26,"Cs",113
13,"13077",3383,2050,1997,20,53,"Cs",139
46,"46215",1407,1088,1068,10,20,"Cs",47
18,"18159",989,765,762,2,3,"Cs",15
12,"12113",90,59,59,1,0,"Cs",2
37,"37278",793,570,567,6,3,"Cs",86
16,"16219",81,58,58,0,0,"Cs",0
46,"46903",6306,4762,4743,44,19,"Cs",584
16,"16099",179,108,105,0,3,"Cs",9
49,"49240",185,125,123,3,2,"Cs",7
1,"1028",1091,735,728,5,7,"Cs",9
15,"15085",3176,2073,2047,29,26,"Cs",63
20,"20062",941,688,683,1,5,"Cs",6
15,"15054",31805,19579,19321,335,258,"Cs",945
3,"3042",1475,1053,1043,7,10,"Cs",82
44,"44181",65,57,57,0,0,"Cs",0
9,"9403",103,79,78,1,1,"Cs",10
26,"26176",56,43,43,0,0,"Cs",8
12,"12114",200,144,140,0,4,"Cs",14
15,"15086",2760,1829,1810,26,19,"Cs",72
28,"28092",153631,112460,111341,913,1119,"Cs",9476
19,"19151",1077,703,693,8,10,"Cs",47
49,"49020",253,189,187,0,2,"Cs",10
23,"23029",798,595,590,0,5,"Cs",12
23,"23030",1207,998,977,7,21,"Cs",21
18,"18128",332,263,260,1,3,"Cs",4
26,"26177",306,233,229,2,4,"Cs",5
9,"9449",91,78,76,1,2,"Cs",13
46,"46904",812,615,605,2,10,"Cs",53
5,"5016",6355,4677,4584,28,93,"Cs",291
50,"50003",117,89,89,1,0,"Cs",2
4,"4016",2136,1486,1467,13,19,"Cs",116
6,"6055",1976,1343,1313,11,30,"Cs",68
37,"37186",94,68,68,0,0,"Cs",11
42,"42142",42,36,36,1,0,"Cs",1
23,"23065",1530,1068,1054,7,14,"Cs",53
38,"38018",4466,2867,2821,21,46,"Cs",113
9,"9450",23,18,18,1,0,"Cs",0
22,"22017",826,613,608,2,5,"Cs",36
41,"41041",9765,7172,6943,63,229,"Cs",502
9,"9073",964,713,706,3,7,"Cs",69
49,"49204",58,44,43,1,1,"Cs",1
16,"16026",91,69,68,0,1,"Cs",3
45,"45189",633,462,459,7,3,"Cs",23
10,"10097",107,84,80,0,4,"Cs",6
2,"2072",1528,981,958,7,23,"Cs",51
33,"33063",375,269,267,5,2,"Cs",9
9,"9294",99,81,78,0,3,"Cs",4
6,"6057",530,409,400,0,9,"Cs",15
1,"1032",498,363,353,1,10,"Cs",2
40,"40191",198,143,138,0,5,"Cs",10
41,"41042",5872,4477,4424,42,53,"Cs",225
39,"39016",23850,17235,17106,70,129,"Cs",966
46,"46218",1043,842,829,6,13,"Cs",33
42,"42013",34,22,22,2,0,"Cs",0
37,"37091",161,104,104,0,0,"Cs",7
19,"19119",76,65,65,0,0,"Cs",4
47,"47189",151,128,122,1,6,"Cs",5
16,"16234",23,17,17,0,0,"Cs",0
5,"5019",44865,32917,32586,282,331,"Cs",2515
49,"49245",251,174,171,1,3,"Cs",5
27,"27029",1425,925,910,11,15,"Cs",22
47,"47033",205,151,150,2,1,"Cs",15
50,"50182",3657,2499,2485,23,14,"Cs",227
26,"26063",118,88,88,2,0,"Cs",5
45,"45081",19268,13690,13516,104,174,"Cs",1255
50,"50055",3635,2298,2244,36,54,"Cs",188
19,"19217",43,36,36,0,0,"Cs",1
9,"9132",170,121,120,0,1,"Cs",16
24,"24180",1086,767,759,9,8,"Cs",51
33,"33008",1679,1140,1133,10,7,"Cs",42
49,"49246",214,183,180,3,3,"Cs",9
11,"11028",32829,21934,21654,310,280,"Cs",1425
10,"10017",775,554,545,1,9,"Cs",12
49,"49100",281,164,157,2,7,"Cs",8
19,"19016",57,40,40,0,0,"Cs",3
29,"29080",6940,4676,4617,36,59,"Cs",294
19,"19050",15,13,13,0,0,"Cs",0
13,"13087",23255,15400,15127,213,273,"Cs",1289
41,"41044",7753,5636,5547,55,89,"Cs",500
50,"50132",780,549,538,7,11,"Cs",41
42,"42016",20,13,13,0,0,"Cs",1
10,"10100",783,494,447,5,47,"Cs",33
47,"47191",111,81,81,0,0,"Cs",6
34,"34120",63790,46117,45597,464,520,"Cs",2878
13,"13088",585,413,409,3,4,"Cs",26
1,"1037",589,378,374,1,4,"Cs",2
39,"39019",2232,1628,1603,10,25,"Cs",69
5,"5122",118,91,89,1,2,"Cs",6
47,"47097",305,239,237,0,2,"Cs",13
21,"21011",3500,2371,2314,23,57,"Cs",134
12,"12118",78,64,63,0,1,"Cs",5
37,"37285",360,271,270,0,1,"Cs",11
50,"50056",399,296,296,3,0,"Cs",22
47,"47193",1625,1251,1236,10,15,"Cs",97
44,"44187",193,147,146,0,1,"Cs",15
49,"49136",313,218,217,5,1,"Cs",9
42,"42018",127,94,94,1,0,"Cs",5
37,"37130",173,135,134,2,1,"Cs",12
49,"49027",125,82,81,0,1,"Cs",8
10,"10143",141,109,105,0,4,"Cs",3
34,"34122",83,56,56,0,0,"Cs",3
33,"33067",751,543,538,7,5,"Cs",25
50,"50283",69,46,46,0,0,"Cs",4
19,"19123",37,30,28,0,2,"Cs",2
5,"5188",39,33,33,0,0,"Cs",1
44,"44189",44,35,35,0,0,"Cs",2
3,"3049",12103,8872,8785,57,87,"Cs",518
37,"37381",138,98,93,0,5,"Cs",3
47,"47006",182,149,145,1,4,"Cs",10
24,"24076",1283,926,913,10,13,"Cs",59
16,"16110",90,70,70,1,0,"Cs",3
39,"39021",464,370,364,1,6,"Cs",9
49,"49137",167,123,121,0,2,"Cs",7
37,"37287",297,204,202,2,2,"Cs",16
23,"23039",2170,1502,1460,10,42,"Cs",86
22,"22235",88,69,68,1,1,"Cs",3
5,"5221",322,231,231,0,0,"Cs",7
44,"44011",47,34,34,0,0,"Cs",4
9,"9466",113,84,83,1,1,"Cs",2
37,"37288",281,220,218,4,2,"Cs",15
39,"39022",970,673,668,2,5,"Cs",21
24,"24184",177,106,105,0,1,"Cs",5
49,"49251",159,116,109,2,7,"Cs",4
37,"37382",162,127,124,0,3,"Cs",2
10,"10106",126,102,102,0,0,"Cs",5
40,"40101",918,672,665,11,7,"Cs",77
41,"41048",2195,1445,1400,13,45,"Cs",72
18,"18071",5636,3909,3807,45,102,"Cs",295
42,"42021",65,46,45,2,1,"Cs",3
50,"50136",532,366,361,3,5,"Cs",22
47,"47196",29,21,21,0,0,"Cs",3
3,"3079",18422,13560,13378,152,182,"Cs",1211
2,"2048",1173,912,901,9,11,"Cs",27
16,"16112",1466,972,957,12,15,"Cs",25
12,"12044",442,371,368,1,3,"Cs",6
37,"37289",210,147,144,0,3,"Cs",14
22,"22025",1022,705,694,14,11,"Cs",54
24,"24187",834,559,549,11,10,"Cs",45
4,"4097",231,173,173,1,0,"Cs",7
38,"38001",21069,10844,10777,63,67,"Cs",596
34,"34126",248,177,176,3,1,"Cs",5
44,"44192",341,274,272,2,2,"Cs",12
18,"18042",417,332,330,4,2,"Cs",25
26,"26072",287,239,235,3,4,"Cs",6
45,"45015",656,449,438,2,11,"Cs",40
19,"19251",39,30,30,0,0,"Cs",0
46,"46224",156,125,124,0,1,"Cs",1
42,"42061",270,188,186,5,2,"Cs",12
9,"9418",73,54,51,0,3,"Cs",5
40,"40104",283,203,200,0,3,"Cs",10
11,"11005",4508,2978,2900,34,78,"Cs",202
49,"49142",244,163,160,0,3,"Cs",8
12,"12045",333,243,235,2,8,"Cs",12
7,"7031",24972,14866,14757,127,109,"Cs",1201
37,"37102",375,260,260,4,0,"Cs",22
16,"16194",219,169,161,0,8,"Cs",5
32,"32075",4362,3117,3077,30,40,"Cs",99
33,"33071",546,385,383,7,2,"Cs",12
4,"4029",8830,5546,5482,43,64,"Cs",252
47,"47103",252,195,192,1,3,"Cs",14
21,"21017",2302,1469,1452,18,17,"Cs",74
5,"5129",111,70,69,0,1,"Cs",2
41,"41050",5173,3954,3878,36,76,"Cs",280
1,"1047",982,653,642,6,11,"Cs",26
38,"38003",1517,899,890,5,9,"Cs",34
9,"9478",45,34,34,1,0,"Cs",1
32,"32076",1935,1320,1306,15,14,"Cs",40
47,"47104",2816,2153,2099,20,54,"Cs",189
37,"37103",409,295,294,2,1,"Cs",23
48,"48055",2603,1833,1820,14,13,"Cs",7
23,"23079",3624,2661,2630,19,31,"Cs",84
7,"7033",28539,15238,15070,187,168,"Cs",900
13,"13901",875,628,619,1,9,"Cs",27
34,"34130",195,154,153,5,1,"Cs",7
47,"47012",100,72,71,0,1,"Cs",3
5,"5130",94,77,77,1,0,"Cs",5
16,"16117",1018,723,715,9,8,"Cs",28
10,"10111",1297,888,872,11,16,"Cs",49
19,"19165",45,39,39,0,0,"Cs",1
28,"28108",3736,2681,2652,21,29,"Cs",244
26,"26075",315,234,229,1,5,"Cs",9
34,"34131",56,46,46,0,0,"Cs",1
42,"42115",89,68,66,0,2,"Cs",0
26,"26155",145,120,119,0,1,"Cs",6
24,"24047",708,462,459,1,3,"Cs",20
24,"24157",2542,1846,1809,16,37,"Cs",131
37,"37106",248,161,160,4,1,"Cs",6
20,"20017",8462,5944,5917,11,27,"Cs",22
50,"50215",20,14,14,0,0,"Cs",0
7,"7034",1074,796,779,9,17,"Cs",32
16,"16118",1351,1022,1009,13,13,"Cs",39
22,"22244",42,33,32,1,1,"Cs",1
4,"4102",14202,9264,9139,57,125,"Cs",599
9,"9315",384,245,242,3,3,"Cs",25
37,"37003",104,75,75,2,0,"Cs",2
37,"37004",25,18,18,0,0,"Cs",0
11,"11008",17923,11702,11464,192,238,"Cs",1108
40,"40108",109,85,85,2,0,"Cs",7
21,"21021",12545,7816,7696,104,120,"Cs",601
34,"34132",106,73,72,0,1,"Cs",6
50,"50141",104,80,78,0,2,"Cs",3
28,"28110",2029,1498,1478,9,20,"Cs",93
19,"19167",129,104,103,1,1,"Cs",2
3,"3084",501,413,413,1,0,"Cs",19
3,"3903",2612,1838,1814,7,24,"Cs",152
49,"49004",110,74,71,3,3,"Cs",5
50,"50039",462,339,333,1,6,"Cs",20
44,"44110",37,30,30,0,0,"Cs",3
46,"46228",2426,1819,1802,19,17,"Cs",118
37,"37108",98,75,75,3,0,"Cs",3
9,"9154",123,90,90,7,0,"Cs",9
39,"39029",629,476,469,1,7,"Cs",23
49,"49261",1504,1044,1026,7,18,"Cs",65
9,"9317",20,18,18,0,0,"Cs",0
19,"19064",64,56,56,0,0,"Cs",5
22,"22212",69,52,52,1,0,"Cs",0
5,"5133",61,44,43,0,1,"Cs",4
16,"16202",733,533,526,4,7,"Cs",26
32,"32081",2057,1466,1445,17,21,"Cs",50
40,"40206",162,126,123,0,3,"Cs",9
28,"28036",2699,1977,1957,20,20,"Cs",151
46,"46229",903,715,708,5,7,"Cs",26
33,"33076",12115,7519,7456,76,63,"Cs",438
50,"50217",426,333,333,1,0,"Cs",23
9,"9155",25,23,23,0,0,"Cs",5
3,"3086",169,140,140,2,0,"Cs",8
42,"42031",25,17,17,1,0,"Cs",2
45,"45024",1034,742,733,1,9,"Cs",22
14,"14003",1245,925,907,5,18,"Cs",77
1,"1055",839,557,552,11,5,"Cs",6
27,"27013",3690,2811,2766,30,45,"Cs",73
23,"23086",11427,7984,7735,81,249,"Cs",606
37,"37298",170,109,109,0,0,"Cs",4
37,"37237",296,212,204,1,8,"Cs",21
12,"12051",437,297,295,3,2,"Cs",6
9,"9054",89,65,63,4,2,"Cs",5
16,"16046",213,142,142,0,0,"Cs",12
34,"34136",143,89,89,1,0,"Cs",9
15,"15012",3603,2484,2422,20,62,"Cs",114
37,"37007",391,289,281,7,8,"Cs",20
37,"37110",104,81,79,1,2,"Cs",2
9,"9266",97,71,68,1,3,"Cs",3
6,"6037",1656,1033,1018,8,15,"Cs",63
42,"42168",108,73,73,0,0,"Cs",1
16,"16124",1807,1367,1347,14,20,"Cs",27
47,"47112",2561,1960,1933,13,27,"Cs",137
49,"49264",529,334,329,2,5,"Cs",18
40,"40112",2813,2126,2087,26,39,"Cs",229
23,"23087",11169,8193,8045,79,148,"Cs",579
27,"27015",3995,2518,2460,25,58,"Cs",74
42,"42033",50,48,48,2,0,"Cs",0
40,"40208",724,546,543,5,3,"Cs",43
49,"49152",474,289,282,2,7,"Cs",18
23,"23088",6017,4529,4427,61,102,"Cs",232
24,"24199",398,263,256,4,7,"Cs",14
40,"40210",97,69,69,1,0,"Cs",4
41,"41058",17956,12890,12553,200,337,"Cs",1022
37,"37009",197,145,144,1,1,"Cs",7
49,"49153",150,110,107,2,3,"Cs",5
9,"9009",158,127,124,5,3,"Cs",10
9,"9906",1185,883,877,16,6,"Cs",64
9,"9327",26,20,20,0,0,"Cs",0
44,"44049",784,539,532,3,7,"Cs",30
50,"50068",1943,1299,1287,10,12,"Cs",55
45,"45101",3671,2842,2808,13,34,"Cs",179
22,"22105",102,65,65,0,0,"Cs",2
10,"10081",176,121,119,0,2,"Cs",1
18,"18051",1092,735,718,8,17,"Cs",30
49,"49119",217,158,156,2,2,"Cs",7
50,"50294",65,45,45,0,0,"Cs",1
46,"46232",853,661,648,7,13,"Cs",42
48,"48063",354,256,252,1,4,"Cs",0
11,"11015",64414,39635,39220,776,415,"Cs",3955
21,"21027",49,32,32,0,0,"Cs",1
49,"49155",81,60,59,0,1,"Cs",7
48,"48064",608,461,461,0,0,"Cs",0
28,"28116",748,576,569,2,7,"Cs",54
9,"9329",113,76,75,5,1,"Cs",3
9,"9908",423,254,253,4,1,"Cs",17
26,"26086",15,15,15,0,0,"Cs",0
47,"47210",399,278,275,3,3,"Cs",10
9,"9012",93,70,68,0,2,"Cs",3
34,"34005",786,601,593,3,8,"Cs",55
50,"50295",48,41,41,0,0,"Cs",2
5,"5042",141,111,111,0,0,"Cs",9
37,"37011",100,78,78,3,0,"Cs",5
18,"18086",338,253,247,1,6,"Cs",6
22,"22251",327,259,256,0,3,"Cs",37
16,"16015",349,242,239,6,3,"Cs",14
12,"12132",477,391,385,3,6,"Cs",22
19,"19174",90,65,64,0,1,"Cs",5
32,"32088",1636,955,944,17,11,"Cs",27
9,"9168",270,211,210,5,1,"Cs",8
50,"50222",1574,1024,1008,12,16,"Cs",69
1,"1061",155,116,116,1,0,"Cs",1
45,"45141",848,626,615,0,11,"Cs",25
45,"45030",471,346,334,4,12,"Cs",18
42,"42038",33,22,22,1,0,"Cs",0
41,"41061",2141,1661,1621,7,40,"Cs",39
29,"29023",2330,1441,1429,11,12,"Cs",152
42,"42175",22,16,16,0,0,"Cs",0
37,"37117",1572,1103,1092,12,11,"Cs",162
10,"10126",1455,966,948,9,18,"Cs",47
22,"22252",118,95,91,1,4,"Cs",9
28,"28044",6266,4693,4642,36,51,"Cs",439
3,"3122",43774,30060,29834,230,226,"Cs",2917
28,"28013",41661,29431,29168,241,263,"Cs",2151
48,"48094",3121,2201,2188,7,13,"Cs",5
10,"10086",304,228,225,4,3,"Cs",24
29,"29070",43686,27672,27323,290,349,"Cs",2778
40,"40053",79,56,56,1,0,"Cs",4
12,"12029",670,524,514,5,10,"Cs",14
44,"44118",154,109,106,1,3,"Cs",13
32,"32091",1695,1163,1156,2,7,"Cs",25
37,"37118",117,86,86,3,0,"Cs",7
26,"26091",147,115,114,0,1,"Cs",5
49,"49158",206,159,155,0,4,"Cs",9
37,"37243",89,66,66,0,0,"Cs",3
29,"29099",969,688,669,11,19,"Cs",36
11,"11019",1757,1233,1172,13,61,"Cs",85
22,"22144",255,192,190,2,2,"Cs",4
34,"34011",379,290,284,2,6,"Cs",16
28,"28045",35523,26213,25966,212,247,"Cs",2478
49,"49271",176,128,127,3,1,"Cs",7
20,"20058",740,523,522,3,1,"Cs",8
28,"28120",1220,910,897,5,13,"Cs",77
18,"18187",510,350,350,2,0,"Cs",9
37,"37212",104,76,76,0,0,"Cs",6
49,"49050",498,305,305,2,0,"Cs",36
18,"18093",2751,1693,1674,18,19,"Cs",106
46,"46236",929,723,716,2,7,"Cs",34
50,"50072",183,131,129,0,2,"Cs",6
46,"46008",2617,1954,1931,17,23,"Cs",90
19,"19177",60,45,45,0,0,"Cs",2
19,"19078",47,37,36,0,1,"Cs",0
7,"7048",18455,9929,9858,116,71,"Cs",719
49,"49052",183,120,117,2,3,"Cs",5
42,"42043",3816,2602,2540,23,62,"Cs",130
5,"5046",38,35,35,0,0,"Cs",0
16,"16020",9,5,5,1,0,"Cs",0
44,"44090",66,49,49,0,0,"Cs",1
50,"50275",111,50,50,0,0,"Cs",3
5,"5241",3062,2011,1977,21,34,"Cs",136
45,"45035",286,206,204,2,2,"Cs",7
47,"47183",135,100,100,1,0,"Cs",11
14,"14040",3749,2905,2845,53,60,"Cs",185
21,"21002",16070,11301,11137,132,164,"Cs",1237
37,"37309",36,21,21,0,0,"Cs",2
5,"5147",144,101,99,0,2,"Cs",10
19,"19079",7,6,6,0,0,"Cs",0
24,"24211",259,199,198,3,1,"Cs",11
3,"3097",1014,778,764,5,14,"Cs",30
20,"20030",21147,14598,14521,92,77,"Cs",97
42,"42182",49,39,39,1,0,"Cs",0
9,"9176",58,46,45,2,1,"Cs",2
46,"46169",32403,23890,23698,222,192,"Cs",1894
22,"22902",206,147,144,1,3,"Cs",15
40,"40124",234,169,164,0,5,"Cs",16
41,"41065",22527,14684,14463,205,221,"Cs",952
33,"33003",603,322,317,7,5,"Cs",15
22,"22151",85,60,60,0,0,"Cs",8
49,"49164",141,95,92,1,3,"Cs",5
20,"20031",185,113,112,3,1,"Cs",0
47,"47217",1984,1460,1437,11,23,"Cs",135
50,"50075",70,55,55,1,0,"Cs",0
5,"5148",22,19,19,0,0,"Cs",0
50,"50153",914,683,675,9,8,"Cs",38
23,"23028",6103,4369,4286,26,83,"Cs",291
26,"26096",257,198,193,2,5,"Cs",9
10,"10133",1159,914,893,4,21,"Cs",30
37,"37215",133,93,90,1,3,"Cs",1
14,"14014",2496,1962,1907,20,55,"Cs",100
47,"47090",2447,1823,1784,15,39,"Cs",127
5,"5116",96,68,68,0,0,"Cs",2
27,"27025",2731,2047,2006,18,41,"Cs",54
12,"12036",541,401,395,6,6,"Cs",8
38,"38017",30964,16228,16102,108,126,"Cs",844
37,"37019",138,111,109,0,2,"Cs",5
19,"19081",27,21,21,0,0,"Cs",0
26,"26098",92,63,63,1,0,"Cs",3
40,"40026",112,101,99,0,2,"Cs",14
47,"47029",50,37,35,1,2,"Cs",1
41,"41067",7273,5114,5036,59,78,"Cs",288
34,"34158",283,170,167,0,3,"Cs",13
34,"34109",60,34,34,0,0,"Cs",0
37,"37312",244,191,189,1,2,"Cs",11
14,"14015",2045,1465,1418,16,47,"Cs",98
29,"29904",418,328,322,1,6,"Cs",9
29,"29030",770,618,611,4,7,"Cs",19
18,"18064",366,289,286,0,3,"Cs",20
22,"22904",751,516,511,3,5,"Cs",30
16,"16274",97,76,75,1,1,"Cs",2
22,"22905",287,217,217,1,0,"Cs",19
24,"24216",666,453,445,4,8,"Cs",19
22,"22080",263,188,184,3,4,"Cs",13
4,"4054",363,279,278,2,1,"Cs",14
28,"28051",1644,1231,1220,9,11,"Cs",100
20,"20034",3200,2193,2180,8,13,"Cs",16
45,"45151",544,413,409,0,4,"Cs",17
40,"40127",36,25,23,0,2,"Cs",1
20,"20065",2921,1983,1970,16,13,"Cs",25
9,"9129",91,74,74,0,0,"Cs",5
2,"2006",573,425,424,1,1,"Cs",20
18,"18901",489,323,322,5,1,"Cs",12
34,"34023",5103,3585,3543,45,42,"Cs",247
16,"16275",12,12,12,1,0,"Cs",0
45,"45152",545,402,393,1,9,"Cs",18
12,"12140",1147,849,841,5,8,"Cs",49
5,"5247",231,132,131,1,1,"Cs",9
28,"28052",3961,2700,2659,14,41,"Cs",160
3,"3101",4933,3502,3462,16,40,"Cs",191
3,"3102",7181,5126,5073,36,53,"Cs",291
14,"14017",10953,7929,7791,84,138,"Cs",575
38,"38020",16057,9921,9809,66,112,"Cs",422
24,"24217",135,93,93,0,0,"Cs",7
19,"19185",26,15,15,1,0,"Cs",0
16,"16029",104,76,74,0,2,"Cs",6
28,"28053",6956,5475,5414,44,61,"Cs",602
5,"5249",96,63,63,0,0,"Cs",1
12,"12038",157,101,100,3,1,"Cs",2
35,"35006",31373,20764,20476,189,288,"Cs",1262
29,"29079",2326,1609,1582,12,27,"Cs",98
28,"28129",8589,6397,6338,46,59,"Cs",760
16,"16106",2701,2029,2001,6,28,"Cs",63
24,"24179",287,207,207,2,0,"Cs",6
44,"44184",44,37,37,0,0,"Cs",13
22,"22052",874,660,652,7,8,"Cs",39
50,"50232",160,93,92,1,1,"Cs",3
15,"15028",1392,944,936,4,8,"Cs",34
3,"3103",238,196,194,2,2,"Cs",11
18,"18164",1790,1135,1108,11,27,"Cs",52
10,"10902",744,514,498,4,16,"Cs",21
39,"39102",2229,1524,1514,10,10,"Cs",49
5,"5021",1861,1323,1304,22,19,"Cs",82
10,"10018",1605,974,948,16,26,"Cs",67
35,"35029",4415,2498,2472,29,26,"Cs",101
37,"37222",78,55,55,2,0,"Cs",4
50,"50080",34,27,27,0,0,"Cs",1
24,"24219",489,334,329,7,5,"Cs",10
18,"18100",7997,5523,5367,66,156,"Cs",328
34,"34167",110,84,83,0,1,"Cs",1
42,"42055",158,113,113,1,0,"Cs",2
45,"45046",2369,1679,1651,11,28,"Cs",57
40,"40032",368,247,244,5,3,"Cs",28
24,"24221",738,492,485,9,7,"Cs",37
47,"47224",93,75,75,1,0,"Cs",6
26,"26105",2188,1564,1536,24,28,"Cs",121
5,"5156",242,145,145,1,0,"Cs",7
16,"16279",173,109,108,0,1,"Cs",3
38,"38022",18630,11420,11284,87,136,"Cs",574
16,"16147",54,34,33,0,1,"Cs",5
49,"49172",474,278,271,1,7,"Cs",13
22,"22909",307,219,217,0,2,"Cs",11
39,"39047",1998,1408,1392,8,16,"Cs",65
10,"10020",1571,1135,1117,2,18,"Cs",36
29,"29036",614,393,387,1,6,"Cs",15
9,"9135",41,28,28,0,0,"Cs",2
6,"6109",3821,2943,2813,16,130,"Cs",129
20,"20039",2126,1623,1618,9,5,"Cs",5
45,"45048",360,276,271,2,5,"Cs",9
40,"40131",51,45,45,0,0,"Cs",7
4,"4060",416,286,282,2,4,"Cs",24
22,"22201",264,188,186,3,2,"Cs",9
22,"22085",94,78,76,0,2,"Cs",4
28,"28027",1215,836,826,8,10,"Cs",65
2,"2012",1835,1462,1420,9,42,"Cs",79
37,"37286",204,140,137,2,3,"Cs",2
11,"11032",54731,31560,31284,492,276,"Cs",3228
39,"39049",304,198,195,2,3,"Cs",5
3,"3106",559,469,465,3,4,"Cs",16
24,"24223",2533,1727,1705,40,22,"Cs",89
5,"5158",346,263,261,0,2,"Cs",10
18,"18137",968,733,731,3,2,"Cs",40
12,"12070",505,407,398,2,9,"Cs",14
47,"47132",39,32,32,1,0,"Cs",0
45,"45159",83,71,69,0,2,"Cs",2
9,"9036",31,24,24,4,0,"Cs",3
46,"46245",527,407,404,2,3,"Cs",24
18,"18010",527,398,394,5,4,"Cs",20
3,"3107",2785,1766,1746,13,20,"Cs",140
47,"47038",100,61,61,0,0,"Cs",4
22,"22057",364,253,248,4,5,"Cs",11
41,"41075",10320,7159,6972,88,187,"Cs",403
19,"19092",395,286,279,2,7,"Cs",10
37,"37028",131,96,93,2,3,"Cs",7
44,"44246",1599,1012,1001,11,11,"Cs",69
18,"18907",1762,1358,1351,4,7,"Cs",60
30,"30007",6474,4354,4317,26,37,"Cs",249
2,"2014",354,254,252,3,2,"Cs",4
44,"44219",173,118,115,1,3,"Cs",10
50,"50009",97,61,61,1,0,"Cs",3
24,"24113",346,240,240,2,0,"Cs",21
16,"16151",61,51,51,1,0,"Cs",1
24,"24225",979,678,668,5,10,"Cs",34
37,"37321",150,118,115,0,3,"Cs",9
22,"22167",465,358,356,8,2,"Cs",28
37,"37228",324,262,262,1,0,"Cs",19
9,"9038",109,87,86,1,1,"Cs",9
50,"50298",5439,4053,4007,41,46,"Cs",335
13,"13095",66,56,56,3,0,"Cs",0
44,"44220",113,82,82,1,0,"Cs",3
44,"44040",189,153,150,1,3,"Cs",4
13,"13004",976,698,694,6,4,"Cs",22
12,"12073",133,97,97,0,0,"Cs",7
34,"34175",87,67,66,1,1,"Cs",5
47,"47135",82,65,65,3,0,"Cs",3
16,"16152",32,26,26,3,0,"Cs",0
21,"21047",1878,1144,1112,12,32,"Cs",33
44,"44161",428,294,292,2,2,"Cs",7
16,"16244",698,598,585,7,13,"Cs",17
28,"28061",22757,17091,16965,115,126,"Cs",1570
34,"34035",97,76,75,3,1,"Cs",1
18,"18107",920,643,626,1,17,"Cs",17
26,"26112",218,152,148,1,4,"Cs",9
45,"45054",3798,2612,2587,10,25,"Cs",161
46,"46111",11367,7995,7908,66,87,"Cs",625
2,"2083",209,181,181,0,0,"Cs",8
44,"44221",386,307,304,1,3,"Cs",21
34,"34177",178,149,149,1,0,"Cs",11
38,"38027",5581,3577,3533,22,44,"Cs",115
18,"18013",4154,2892,2812,28,80,"Cs",200
29,"29040",1933,1260,1235,11,25,"Cs",69
49,"49178",748,520,505,7,15,"Cs",37
29,"29041",3697,2406,2361,47,45,"Cs",194
13,"13007",1219,871,852,4,19,"Cs",31
47,"47231",4439,3359,3323,36,36,"Cs",374
22,"22060",1167,817,808,14,9,"Cs",77
45,"45055",1004,768,755,4,13,"Cs",19
23,"23007",3015,2252,2229,14,23,"Cs",225
49,"49179",337,210,209,3,1,"Cs",15
27,"27039",4467,3179,3121,47,58,"Cs",115
10,"10028",83,62,61,1,1,"Cs",1
26,"26114",72,61,61,0,0,"Cs",2
27,"27040",3008,2071,2046,21,25,"Cs",33
44,"44135",99,73,73,1,0,"Cs",4
42,"42204",53,37,35,1,2,"Cs",1
14,"14026",2000,1294,1253,20,41,"Cs",74
22,"22172",520,373,369,5,4,"Cs",34
39,"39054",4541,3271,3252,30,19,"Cs",145
34,"34179",25,18,16,0,2,"Cs",1
49,"49180",135,82,81,5,1,"Cs",4
24,"24010",8251,5357,5275,40,82,"Cs",386
45,"45056",2341,1315,1295,11,20,"Cs",90
5,"5131",96,64,64,1,0,"Cs",4
49,"49146",265,183,181,4,2,"Cs",5
45,"45129",98,77,77,1,0,"Cs",4
40,"40009",41,35,34,0,1,"Cs",3
5,"5065",452,339,337,2,2,"Cs",29
20,"20047",455,314,314,1,0,"Cs",1
50,"50087",28,19,19,0,0,"Cs",1
16,"16910",75,44,44,1,0,"Cs",2
18,"18109",597,430,422,5,8,"Cs",25
49,"49181",333,197,195,2,2,"Cs",4
46,"46022",15392,10624,10546,69,78,"Cs",738
23,"23009",12849,9722,9572,99,150,"Cs",621
37,"37327",179,148,147,2,1,"Cs",14
10,"10031",162,128,124,0,4,"Cs",6
46,"46045",1245,984,961,3,23,"Cs",37
22,"22062",154,107,107,1,0,"Cs",8
22,"22173",219,147,141,3,6,"Cs",4
19,"19102",88,75,73,0,2,"Cs",0
3,"3028",959,780,767,7,13,"Cs",30
48,"48086",2024,1371,1358,5,13,"Cs",11
10,"10154",177,117,116,0,1,"Cs",7
37,"37234",314,194,192,3,2,"Cs",9
40,"40904",344,286,284,8,2,"Cs",24
27,"27042",1639,1120,1107,8,13,"Cs",20
38,"38006",41593,20823,20624,127,199,"Cs",996
18,"18913",771,530,514,2,16,"Cs",36
6,"6123",4502,2989,2894,29,95,"Cs",227
37,"37035",162,115,115,1,0,"Cs",3
28,"28066",7575,5771,5718,58,53,"Cs",527
40,"40043",1773,1376,1345,21,31,"Cs",101
9,"9050",57,38,38,1,0,"Cs",1
24,"24120",305,182,181,1,1,"Cs",7
37,"37329",38,29,28,1,1,"Cs",0
42,"42164",1580,1043,1029,8,14,"Cs",77
47,"47046",124,99,99,1,0,"Cs",10
10,"10116",3737,2579,2507,34,72,"Cs",165
20,"20050",275,174,174,2,0,"Cs",0
49,"49079",104,79,76,0,3,"Cs",1
19,"19290",851,551,550,4,1,"Cs",30
22,"22064",155,100,100,2,0,"Cs",7
46,"46115",330,219,213,0,6,"Cs",9
19,"19198",17,14,14,0,0,"Cs",0
36,"36006",11502,8057,7927,53,130,"Cs",353
22,"22175",184,129,128,0,1,"Cs",11
16,"16045",180,128,127,0,1,"Cs",0
5,"5168",3503,2536,2511,29,25,"Cs",218
2,"2023",504,419,412,0,7,"Cs",18
44,"44047",225,103,103,0,0,"Cs",2
19,"19291",1143,803,794,2,9,"Cs",47
19,"19199",19,15,15,0,0,"Cs",0
30,"30014",1587,1150,1134,4,16,"Cs",33
50,"50117",123,93,93,4,0,"Cs",4
39,"39059",7518,5327,5287,23,40,"Cs",164
18,"18049",588,418,415,4,3,"Cs",30
32,"32046",1089,679,670,4,9,"Cs",19
10,"10036",304,194,192,4,2,"Cs",1
32,"32010",364,271,267,2,4,"Cs",4
26,"26008",1821,1310,1290,15,20,"Cs",77
30,"30015",19344,13502,13347,107,155,"Cs",881
42,"42211",84,67,67,0,0,"Cs",5
37,"37142",554,396,394,5,2,"Cs",31
3,"3117",377,306,302,2,4,"Cs",13
26,"26009",394,282,278,1,4,"Cs",4
28,"28146",1806,1232,1218,3,14,"Cs",67
12,"12080",1883,1472,1438,8,34,"Cs",53
9,"9055",47,33,32,0,1,"Cs",0
42,"42076",200,149,143,2,6,"Cs",8
15,"15043",4944,3184,3117,27,67,"Cs",125
47,"47049",91,58,58,0,0,"Cs",4
41,"41001",1558,1129,1104,6,25,"Cs",35
36,"36008",21845,14553,14373,138,180,"Cs",655
3,"3118",2446,1617,1598,8,19,"Cs",118
16,"16048",404,300,298,2,2,"Cs",11
26,"26123",128,110,110,0,0,"Cs",9
34,"34049",329,229,227,1,2,"Cs",14
19,"19201",60,44,44,0,0,"Cs",8
47,"47146",275,215,214,1,1,"Cs",15
41,"41086",16199,10227,10105,137,122,"Cs",816
15,"15044",1194,806,788,7,18,"Cs",18
37,"37175",412,298,293,4,5,"Cs",19
40,"40179",620,500,490,3,10,"Cs",38
28,"28082",6110,4622,4581,41,41,"Cs",358
5,"5139",71,59,58,1,1,"Cs",3
10,"10121",7882,5294,5183,42,111,"Cs",321
37,"37010",925,645,638,5,7,"Cs",53
4,"4041",344,227,222,4,5,"Cs",10
12,"12055",103,77,76,2,1,"Cs",0
42,"42215",723,468,452,10,16,"Cs",22
32,"32014",1028,719,708,6,11,"Cs",20
24,"24019",338,259,256,4,3,"Cs",13
44,"44229",141,99,98,1,1,"Cs",2
50,"50246",37,24,24,0,0,"Cs",2
22,"22181",86,55,54,2,1,"Cs",3
5,"5172",111,83,83,1,0,"Cs",3
34,"34051",91,72,70,0,2,"Cs",8
42,"42216",26,20,20,0,0,"Cs",0
49,"49084",266,197,195,11,2,"Cs",10
34,"34052",164,127,125,1,2,"Cs",12
28,"28072",6176,4716,4673,44,43,"Cs",468
24,"24020",436,230,228,0,2,"Cs",26
10,"10041",1022,720,706,2,14,"Cs",30
5,"5075",96,76,76,0,0,"Cs",0
24,"24021",1595,1037,1025,7,12,"Cs",41
14,"14035",5774,4076,4017,35,59,"Cs",235
50,"50173",156,114,114,0,0,"Cs",6
44,"44230",149,111,110,2,1,"Cs",5
28,"28073",12707,9198,9080,94,118,"Cs",786
32,"32015",817,454,452,2,2,"Cs",9
2,"2029",3333,2363,2320,13,43,"Cs",220
37,"37146",106,82,76,0,6,"Cs",4
9,"9220",69,52,52,3,0,"Cs",0
12,"12083",88,69,67,9,2,"Cs",5
37,"37241",167,121,119,3,2,"Cs",5
23,"23055",46314,30950,30506,279,444,"Cs",2507
6,"6134",526,306,301,1,5,"Cs",16
44,"44146",164,133,133,2,0,"Cs",6
16,"16167",288,225,217,0,8,"Cs",7
13,"13024",875,587,577,7,10,"Cs",38
40,"40150",60,42,42,0,0,"Cs",4
19,"19204",150,105,104,3,1,"Cs",2
44,"44231",35,30,30,0,0,"Cs",0
24,"24023",264,188,185,1,3,"Cs",6
37,"37242",82,59,59,1,0,"Cs",6
37,"37179",197,167,165,0,2,"Cs",6
50,"50248",501,344,328,3,16,"Cs",20
45,"45179",493,362,357,5,5,"Cs",10
46,"46189",469,374,367,2,7,"Cs",27
13,"13025",290,233,231,0,2,"Cs",11
28,"28086",5446,3643,3600,19,43,"Cs",310
37,"37305",219,177,175,2,2,"Cs",11
49,"49088",80,51,51,0,0,"Cs",4
9,"9224",147,113,112,0,1,"Cs",7
45,"45180",2850,2044,2023,15,21,"Cs",111
39,"39065",222,166,163,0,3,"Cs",3
19,"19005",91,63,62,0,1,"Cs",0
10,"10004",692,482,473,8,9,"Cs",13
5,"5175",144,109,109,0,0,"Cs",13
37,"37244",129,97,97,1,0,"Cs",14
12,"12004",4149,2945,2910,25,35,"Cs",181
26,"26130",205,153,150,1,3,"Cs",6
12,"12085",5081,3271,3235,17,36,"Cs",261
41,"41007",12488,7657,7421,126,236,"Cs",520
4,"4010",587,421,409,5,12,"Cs",35
3,"3124",459,360,358,0,2,"Cs",6
38,"38038",165135,101564,100807,709,757,"Cs",5577
27,"27053",497,342,334,2,8,"Cs",3
50,"50175",907,638,632,11,6,"Cs",57
10,"10047",938,710,694,1,16,"Cs",34
42,"42085",179,107,106,2,1,"Cs",4
5,"5079",66,53,52,0,1,"Cs",2
50,"50176",220,142,142,3,0,"Cs",13
24,"24134",3287,2278,2226,18,52,"Cs",123
18,"18123",284,202,200,5,2,"Cs",8
40,"40087",85,70,70,0,0,"Cs",2
36,"36017",17364,11771,11598,123,173,"Cs",369
20,"20059",8892,6505,6490,18,15,"Cs",19
6,"6003",768,579,557,4,22,"Cs",52
37,"37307",146,94,91,1,3,"Cs",6
44,"44028",171,136,136,0,0,"Cs",5
9,"9444",63,40,40,1,0,"Cs",0
23,"23060",19210,13677,13495,145,182,"Cs",1104
26,"26094",67,51,51,0,0,"Cs",1
44,"44001",65,43,43,1,0,"Cs",3
29,"29027",2325,1543,1516,13,27,"Cs",107
23,"23026",3431,2430,2375,25,55,"Cs",130
49,"49199",236,159,157,3,2,"Cs",7
13,"13029",89,67,65,0,2,"Cs",2
26,"26020",449,319,313,1,6,"Cs",29
19,"19302",52,42,42,1,0,"Cs",4
46,"46055",1298,992,977,9,15,"Cs",69
18,"18029",1812,1104,1065,7,39,"Cs",70
16,"16058",94,71,71,1,0,"Cs",1
24,"24027",1214,841,828,6,13,"Cs",48
34,"34210",98,82,82,1,0,"Cs",1
14,"14069",7340,5100,5000,69,100,"Cs",217
22,"22078",431,285,285,4,0,"Cs",17
9,"9067",399,232,230,3,2,"Cs",20
10,"10049",3752,2949,2864,25,85,"Cs",164
37,"37247",171,129,128,0,1,"Cs",9
50,"50178",269,165,163,6,2,"Cs",11
39,"39069",1934,1475,1458,2,17,"Cs",47
18,"18126",1436,1024,1002,9,22,"Cs",36
20,"20001",253,163,163,1,0,"Cs",0
21,"21065",259,178,175,0,3,"Cs",8
44,"44059",562,411,407,2,4,"Cs",14
24,"24028",367,275,273,5,2,"Cs",12
9,"9400",307,225,224,4,1,"Cs",11
9,"9230",33,26,26,0,0,"Cs",2
19,"19212",678,501,491,1,10,"Cs",25
14,"14042",18695,13788,13514,206,274,"Cs",1158
40,"40157",39,30,30,0,0,"Cs",0
9,"9231",57,35,35,2,0,"Cs",2
9,"9071",39,29,29,1,0,"Cs",0
42,"42090",83,65,64,1,1,"Cs",5
48,"48016",5471,3964,3935,31,29,"Cs",44
13,"13034",58768,42473,42028,359,445,"Cs",3421
16,"16176",29,20,20,0,0,"Cs",4
19,"19010",9,9,9,0,0,"Cs",0
4,"4086",1631,1128,1114,3,14,"Cs",72
19,"19182",37,32,32,0,0,"Cs",2
49,"49095",282,202,201,6,1,"Cs",21
18,"18127",17005,11790,11583,150,207,"Cs",904
2,"2038",262,197,193,0,4,"Cs",7
42,"42092",61,40,39,0,1,"Cs",2
45,"45150",428,322,319,3,3,"Cs",11
34,"34066",54,47,47,1,0,"Cs",2
3,"3043",2906,2360,2334,27,26,"Cs",143
32,"32026",2655,1762,1731,17,31,"Cs",63
15,"15056",5615,3697,3646,31,51,"Cs",154
46,"46126",5580,4361,4328,36,33,"Cs",301
26,"26178",72,56,56,1,0,"Cs",1
19,"19214",74,51,51,0,0,"Cs",0
24,"24031",207,160,158,0,2,"Cs",10
37,"37054",233,190,186,2,4,"Cs",4
42,"42093",36,28,28,1,0,"Cs",3
26,"26025",84,69,65,2,4,"Cs",1
34,"34160",133,107,106,0,1,"Cs",5
19,"19184",59,47,47,0,0,"Cs",0
34,"34215",161,126,125,6,1,"Cs",4
50,"50181",999,748,732,3,16,"Cs",37
18,"18132",3101,2418,2382,23,36,"Cs",146
10,"10178",724,499,494,3,5,"Cs",23
49,"49205",359,252,251,7,1,"Cs",13
12,"12010",232,191,187,3,4,"Cs",16
48,"48905",2496,1778,1766,12,12,"Cs",8
37,"37055",117,97,93,0,4,"Cs",9
20,"20066",437,288,286,1,2,"Cs",0
22,"22197",436,327,325,3,2,"Cs",29
28,"28160",8709,6507,6460,62,47,"Cs",566
3,"3132",512,376,373,2,3,"Cs",20
46,"46150",1794,1276,1272,8,4,"Cs",60
5,"5184",238,163,160,2,3,"Cs",3
46,"46059",1244,1007,995,5,12,"Cs",15
22,"22082",288,217,214,0,3,"Cs",0
40,"40223",235,177,174,1,3,"Cs",15
47,"47222",85,70,70,1,0,"Cs",5
49,"49169",38,33,32,0,1,"Cs",4
27,"27061",1018,704,683,12,21,"Cs",16
18,"18035",1179,882,870,7,12,"Cs",39
6,"6151",1049,746,741,5,5,"Cs",61
39,"39046",1342,910,902,3,8,"Cs",17
34,"34070",131,98,96,0,2,"Cs",2
19,"19308",57,49,49,0,0,"Cs",1
4,"4090",298,229,225,1,4,"Cs",13
6,"6015",118127,79482,78553,855,929,"Cs",7113
47,"47223",148,105,102,4,3,"Cs",5
46,"46242",326,260,257,3,3,"Cs",11
46,"46037",1120,891,879,7,12,"Cs",56
47,"47129",855,660,648,7,12,"Cs",58
50,"50257",159,128,125,2,3,"Cs",7
29,"29062",658,557,551,2,6,"Cs",25
48,"48907",343,274,273,0,1,"Cs",0
16,"16187",55,38,38,3,0,"Cs",4
6,"6152",1273,888,867,7,21,"Cs",92
10,"10903",806,555,545,8,10,"Cs",58
36,"36026",19890,13041,12891,169,150,"Cs",570
45,"45193",586,478,469,0,9,"Cs",10
4,"4091",318,251,250,0,1,"Cs",7
24,"24071",947,618,611,6,7,"Cs",27
49,"49208",352,223,214,1,9,"Cs",25
6,"6016",2937,2042,1978,12,64,"Cs",112
32,"32031",997,684,680,5,4,"Cs",16
21,"21072",10233,7374,7183,116,191,"Cs",422
19,"19121",265,205,204,0,1,"Cs",7
4,"4092",2791,2058,2023,4,35,"Cs",226
42,"42098",8,7,7,0,0,"Cs",0
3,"3135",195,134,131,1,3,"Cs",4
40,"40163",42,35,35,1,0,"Cs",3
13,"13043",205,163,162,1,1,"Cs",10
18,"18037",535,417,410,2,7,"Cs",25
9,"9412",750,484,482,4,2,"Cs",39
44,"44217",32,25,25,0,0,"Cs",0
32,"32032",7900,5186,5091,48,95,"Cs",238
42,"42100",30,24,24,1,0,"Cs",1
16,"16070",29,27,27,0,0,"Cs",1
5,"5092",145,111,107,1,4,"Cs",11
6,"6155",1810,1172,1140,23,32,"Cs",98
10,"10184",734,520,511,4,9,"Cs",27
19,"19220",2608,1673,1653,10,20,"Cs",144
34,"34073",180,123,120,3,3,"Cs",4
9,"9035",284,191,190,2,1,"Cs",24
42,"42103",543,383,374,2,9,"Cs",34
9,"9082",36,32,32,0,0,"Cs",0
47,"47067",153,112,112,3,0,"Cs",2
37,"37256",191,123,123,1,0,"Cs",20
24,"24150",226,163,162,0,1,"Cs",12
12,"12902",2250,1557,1532,16,25,"Cs",93
12,"12014",164,111,111,0,0,"Cs",4
41,"41092",7681,5408,5299,79,109,"Cs",341
2,"2046",1125,892,870,12,22,"Cs",43
12,"12096",732,526,519,4,7,"Cs",21
16,"16071",20,16,16,0,0,"Cs",0
22,"22203",77,62,62,2,0,"Cs",6
36,"36029",16126,10936,10771,96,165,"Cs",534
48,"48023",579,451,448,0,3,"Cs",1
32,"32035",1352,782,768,6,14,"Cs",24
47,"47068",29,21,21,0,0,"Cs",0
50,"50211",236,174,173,0,1,"Cs",7
37,"37352",209,157,155,3,2,"Cs",13
19,"19317",124,83,82,0,1,"Cs",3
44,"44247",291,207,206,4,1,"Cs",14
50,"50109",95,65,62,2,3,"Cs",7
10,"10064",1400,998,972,3,26,"Cs",41
20,"20072",4762,3175,3153,21,22,"Cs",39
34,"34077",395,282,278,7,4,"Cs",28
41,"41020",13012,8148,7999,135,149,"Cs",498
26,"26149",42,34,34,0,0,"Cs",2
24,"24041",513,312,305,4,7,"Cs",18
39,"39079",8850,6247,6175,28,72,"Cs",277
24,"24153",228,171,171,3,0,"Cs",8
37,"37165",31,22,22,0,0,"Cs",2
46,"46133",462,359,352,1,7,"Cs",7
6,"6160",3005,2083,2056,9,27,"Cs",85
41,"41094",6496,4733,4628,47,105,"Cs",324
38,"38050",2417,1288,1273,9,15,"Cs",45
50,"50035",74,57,57,0,0,"Cs",1
34,"34228",77,59,59,1,0,"Cs",1
6,"6024",1123,876,849,3,27,"Cs",45
26,"26151",412,317,317,4,0,"Cs",10
44,"44070",55,49,49,0,0,"Cs",2
11,"11004",89919,55211,54544,830,667,"Cs",4764
5,"5161",545,395,395,0,0,"Cs",12
19,"19318",26,18,18,0,0,"Cs",0
46,"46065",1584,1199,1183,11,16,"Cs",82
24,"24042",60,47,47,2,0,"Cs",3
9,"9090",49,41,39,2,2,"Cs",8
22,"22089",274,195,193,2,2,"Cs",10
23,"23042",292,219,219,0,0,"Cs",4
37,"37260",137,110,109,0,1,"Cs",5
49,"49221",233,122,120,2,2,"Cs",10
18,"18043",129,74,71,0,3,"Cs",6
37,"37166",196,134,133,1,1,"Cs",5
24,"24154",952,625,618,5,7,"Cs",42
36,"36033",12305,8759,8597,67,162,"Cs",337
42,"42110",54,43,43,0,0,"Cs",4
16,"16078",41384,28809,28500,322,309,"Cs",1695
32,"32039",1154,801,790,11,11,"Cs",17
9,"9091",686,479,467,4,12,"Cs",25
13,"13052",6288,4360,4278,36,82,"Cs",198
9,"9421",240,180,180,3,0,"Cs",21
19,"19321",34,28,28,0,0,"Cs",0
22,"22207",121,66,65,0,1,"Cs",3
9,"9255",83,58,58,0,0,"Cs",6
28,"28002",3250,2261,2243,14,18,"Cs",219
16,"16079",28,16,16,0,0,"Cs",1
30,"30035",19432,13174,13013,114,161,"Cs",953
9,"9422",19,13,13,0,0,"Cs",1
48,"48915",339,245,243,0,2,"Cs",0
37,"37262",69,51,51,0,0,"Cs",1
5,"5194",132,105,104,1,1,"Cs",5
36,"36035",14615,10011,9880,103,131,"Cs",497
34,"34083",1647,1089,1080,2,9,"Cs",93
37,"37356",84,58,58,0,0,"Cs",5
9,"9256",330,221,219,0,2,"Cs",12
23,"23045",2054,1423,1412,10,11,"Cs",46
13,"13055",616,445,444,3,1,"Cs",13
21,"21050",12567,8522,8392,89,130,"Cs",510
6,"6029",1174,873,865,5,8,"Cs",36
3,"3055",5265,3741,3697,16,44,"Cs",248
19,"19027",129,97,95,1,2,"Cs",5
10,"10071",126,78,71,0,7,"Cs",6
46,"46090",1631,1360,1339,6,21,"Cs",72
37,"37357",248,193,192,1,1,"Cs",8
34,"34180",68,54,54,1,0,"Cs",6
6,"6030",168,131,128,1,3,"Cs",9
44,"44075",321,255,252,1,3,"Cs",6
49,"49002",58,43,40,0,3,"Cs",11
19,"19323",36,26,26,0,0,"Cs",2
39,"39084",868,608,605,3,3,"Cs",15
28,"28172",9915,7715,7652,60,63,"Cs",861
49,"49112",118,72,72,2,0,"Cs",0
12,"12021",4398,3314,3277,32,37,"Cs",159
23,"23047",1558,1203,1186,8,17,"Cs",44
34,"34233",128,104,104,0,0,"Cs",3
41,"41025",2031,1409,1349,11,60,"Cs",54
14,"14056",23477,15826,15470,177,356,"Cs",1379
21,"21052",4403,2688,2631,26,57,"Cs",132
6,"6032",80,68,68,1,0,"Cs",12
46,"46137",248,201,197,3,4,"Cs",2
28,"28173",523,384,381,1,3,"Cs",22
26,"26042",795,578,572,8,6,"Cs",24
49,"49113",162,131,131,2,0,"Cs",11
44,"44076",2089,1577,1565,8,12,"Cs",37
10,"10196",294,208,206,3,2,"Cs",9
18,"18146",930,645,629,10,16,"Cs",53
37,"37265",198,167,163,1,4,"Cs",8
47,"47142",121,85,85,0,0,"Cs",7
10,"10197",106,74,74,0,0,"Cs",2
49,"49227",317,245,244,4,1,"Cs",19
46,"46001",771,562,560,3,2,"Cs",24
9,"9429",53,34,34,1,0,"Cs",3
49,"49115",167,121,121,2,0,"Cs",8
34,"34088",265,195,191,1,4,"Cs",9
50,"50267",565,380,375,4,5,"Cs",20
23,"23049",1740,1215,1183,12,32,"Cs",73
9,"9102",33,22,22,0,0,"Cs",1
24,"24161",294,208,204,3,4,"Cs",12
32,"32045",2346,1604,1579,20,25,"Cs",45
10,"10198",1053,897,889,4,8,"Cs",34
26,"26044",51,38,36,0,2,"Cs",3
18,"18147",3655,2273,2241,16,32,"Cs",122
48,"48032",5762,4287,4262,14,25,"Cs",28
46,"46070",17824,12888,12802,106,86,"Cs",1317
36,"36007",1610,1047,1016,5,31,"Cs",33
47,"47174",271,215,213,4,2,"Cs",13
18,"18115",2635,1766,1738,13,28,"Cs",98
23,"23014",2535,1890,1861,28,29,"Cs",90
46,"46002",1253,946,940,4,6,"Cs",40
48,"48033",217,162,162,1,0,"Cs",1
44,"44082",84,66,66,0,0,"Cs",2
49,"49116",356,239,234,4,5,"Cs",9
4,"4003",17583,11062,10941,77,121,"Cs",574
33,"33050",548,316,314,1,2,"Cs",11
23,"23051",2736,2066,2021,16,45,"Cs",127
26,"26163",126,104,104,1,0,"Cs",6
19,"19327",385,313,308,2,5,"Cs",6
50,"50118",2101,1484,1477,17,7,"Cs",69
49,"49229",109,80,77,1,3,"Cs",4
46,"46208",1071,854,845,2,9,"Cs",31
10,"10079",848,641,632,2,9,"Cs",46
50,"50042",19,17,17,1,0,"Cs",1
15,"15075",12871,8751,8637,129,114,"Cs",503
40,"40178",85,61,60,0,1,"Cs",0
48,"48034",12623,8789,8711,76,78,"Cs",211
44,"44084",54,46,46,1,0,"Cs",2
50,"50119",876,633,625,11,8,"Cs",55
39,"39004",1479,1050,1031,5,19,"Cs",17
12,"12026",828,577,566,11,11,"Cs",25
45,"45137",1541,1007,998,8,9,"Cs",55
16,"16206",184,126,125,4,1,"Cs",2
6,"6084",1061,780,769,11,11,"Cs",28
5,"5234",45,38,38,0,0,"Cs",0
46,"46095",580,445,438,5,7,"Cs",58
34,"34094",61,45,45,2,0,"Cs",6
3,"3061",1060,793,787,5,6,"Cs",78
19,"19138",215,158,154,4,4,"Cs",4
16,"16165",56,45,45,0,0,"Cs",1
16,"16089",381,292,289,8,3,"Cs",16
14,"14062",945,700,693,2,7,"Cs",30
47,"47177",104,78,78,0,0,"Cs",4
19,"19233",79,65,65,2,0,"Cs",8
23,"23053",9451,6038,5975,60,63,"Cs",184
24,"24165",317,202,199,1,3,"Cs",23
13,"13066",2621,2029,1998,12,31,"Cs",93
24,"24056",2726,1803,1772,21,31,"Cs",99
2,"2061",605,464,458,3,6,"Cs",15
46,"46259",457,374,371,2,3,"Cs",24
46,"46073",1066,823,817,11,6,"Cs",37
37,"37207",336,244,240,4,4,"Cs",24
6,"6086",1174,767,750,6,17,"Cs",47
28,"28083",9836,7278,7206,64,72,"Cs",761
42,"42125",71,55,55,0,0,"Cs",9
22,"22008",144,113,112,2,1,"Cs",12
47,"47083",81,63,61,0,2,"Cs",2
32,"32051",1369,1062,1058,13,4,"Cs",13
47,"47178",170,128,124,2,4,"Cs",8
29,"29068",7833,4897,4806,50,91,"Cs",489
15,"15078",78810,55693,55183,569,510,"Cs",2613
49,"49233",85,51,51,0,0,"Cs",3
46,"46074",2687,2033,2020,18,13,"Cs",160
45,"45104",419,328,324,1,4,"Cs",12
9,"9438",562,447,437,6,10,"Cs",30
42,"42127",37,26,26,1,0,"Cs",1
5,"5007",109,73,72,0,1,"Cs",1
18,"18087",182877,131811,130184,1106,1627,"Cs",11219
34,"34246",68,52,52,0,0,"Cs",1
19,"19142",263,179,179,1,0,"Cs",16
18,"18152",928,663,660,3,3,"Cs",14
1,"1018",1399,953,947,1,6,"Cs",9
39,"39007",386,265,264,0,1,"Cs",5
14,"14064",296,211,208,6,3,"Cs",9
47,"47180",57,41,41,1,0,"Cs",4
39,"39008",13900,9814,9734,63,80,"Cs",721
9,"9440",80,61,61,0,0,"Cs",1
37,"37044",431,309,308,3,1,"Cs",30
18,"18056",3382,2397,2350,30,47,"Cs",166
50,"50021",25,21,21,0,0,"Cs",0
23,"23057",727,582,572,7,10,"Cs",22
46,"46098",2405,1778,1751,7,27,"Cs",85
5,"5905",214,148,142,1,6,"Cs",9
24,"24169",2777,1908,1880,10,28,"Cs",65
44,"44176",152,114,113,1,1,"Cs",23
42,"42001",250,172,172,3,0,"Cs",8
41,"41034",23576,15461,15214,264,247,"Cs",1096
49,"49235",415,300,290,4,10,"Cs",28
16,"16170",646,451,449,5,2,"Cs",19
50,"50123",430,304,297,3,7,"Cs",25
32,"32055",1216,781,764,10,17,"Cs",8
1,"1020",323,228,224,1,4,"Cs",0
49,"49123",519,384,383,4,1,"Cs",9
34,"34151",148,98,96,1,2,"Cs",2
41,"41063",2735,1855,1797,30,58,"Cs",88
47,"47151",26,22,22,0,0,"Cs",0
50,"50047",38,24,24,0,0,"Cs",3
37,"37274",118296,84144,83280,880,864,"Cs",7511
42,"42131",50,39,39,2,0,"Cs",0
49,"49124",238,170,164,2,6,"Cs",15
26,"26053",191,144,140,2,4,"Cs",5
49,"49237",142,78,78,0,0,"Cs",4
19,"19042",22,18,17,0,1,"Cs",0
49,"49015",198,156,155,0,1,"Cs",7
5,"5010",142,102,100,2,2,"Cs",8
37,"37119",99,78,78,1,0,"Cs",3
42,"42132",140,102,101,2,1,"Cs",2
5,"5209",74,58,58,1,0,"Cs",4
19,"19268",50,37,35,0,2,"Cs",0
13,"13074",943,759,749,5,10,"Cs",39
10,"10210",489,314,313,2,1,"Cs",12
45,"45109",2791,2123,2072,20,51,"Cs",99
26,"26055",39,30,30,0,0,"Cs",1
40,"40185",800,560,553,4,7,"Cs",33
22,"22046",713,555,549,9,6,"Cs",28
44,"44120",219,147,145,3,2,"Cs",8
24,"24172",389,208,202,1,6,"Cs",7
46,"46100",281,190,187,1,3,"Cs",7
40,"40056",31,21,20,0,1,"Cs",0
13,"13075",196,147,146,2,1,"Cs",2
18,"18094",2299,1712,1652,20,60,"Cs",60
10,"10090",489,307,302,1,5,"Cs",11
46,"46146",1647,1241,1229,12,12,"Cs",73
29,"29072",3291,2360,2307,19,53,"Cs",147
16,"16218",184,134,133,1,1,"Cs",9
16,"16098",521,418,415,2,3,"Cs",11
19,"19148",42,29,28,1,1,"Cs",5
49,"49017",247,176,176,1,0,"Cs",6
9,"9122",86,55,55,0,0,"Cs",3
16,"16137",37,27,25,0,2,"Cs",0
34,"34156",51,42,42,0,0,"Cs",2
23,"23061",7711,5357,5231,44,126,"Cs",313
1,"1027",444,273,271,0,2,"Cs",1
28,"28903",35555,28875,28671,341,204,"Cs",3423
4,"4014",152,105,103,1,2,"Cs",6
37,"37277",74,55,55,0,0,"Cs",6
10,"10092",260,201,200,1,1,"Cs",10
42,"42009",77,58,58,0,0,"Cs",4
50,"50050",87,62,62,1,0,"Cs",4
40,"40188",83,63,60,0,3,"Cs",7
32,"32060",753,520,515,5,5,"Cs",11
48,"48043",4591,3337,3325,20,12,"Cs",24
24,"24065",2164,1524,1492,12,32,"Cs",98
37,"37087",911,675,665,5,10,"Cs",80
5,"5212",197,117,117,0,0,"Cs",2
35,"35003",5644,2987,2943,20,44,"Cs",177
47,"47186",244314,182449,180833,1818,1616,"Cs",15658
28,"28019",1272,926,914,6,12,"Cs",48
9,"9125",555,386,382,4,4,"Cs",26
26,"26059",1109,801,791,6,10,"Cs",53
37,"37088",199,135,133,0,2,"Cs",6
32,"32061",1078,777,770,5,7,"Cs",21
19,"19242",74,53,53,1,0,"Cs",2
14,"14071",874,551,540,5,11,"Cs",31
24,"24066",439,274,273,3,1,"Cs",4
6,"6145",900,683,669,7,14,"Cs",33
44,"44004",379,275,275,2,0,"Cs",8
49,"49129",810,541,527,4,14,"Cs",17
28,"28020",193,96,93,0,3,"Cs",3
22,"22115",348,263,261,3,2,"Cs",12
3,"3071",4000,2858,2813,27,45,"Cs",150
40,"40190",43,37,35,0,2,"Cs",3
13,"13080",316,226,225,0,1,"Cs",3
45,"45003",554,398,393,2,5,"Cs",17
16,"16227",109,78,76,0,2,"Cs",1
12,"12115",205,161,161,1,0,"Cs",7
46,"46103",1354,993,978,8,15,"Cs",35
45,"45041",3967,2723,2689,18,34,"Cs",204
50,"50230",1140,771,767,11,4,"Cs",42
48,"48045",5207,3851,3817,9,34,"Cs",24
19,"19243",34,32,31,1,1,"Cs",3
45,"45004",546,400,398,2,2,"Cs",20
9,"9235",144,107,105,0,2,"Cs",6
50,"50180",107,85,85,1,0,"Cs",2
21,"21007",6379,4268,4178,66,90,"Cs",312
7,"7021",229,154,150,3,4,"Cs",10
47,"47188",98,73,70,0,3,"Cs",6
37,"37281",39,28,27,0,1,"Cs",1
26,"26179",39,27,27,0,0,"Cs",2
21,"21008",2604,1663,1626,10,37,"Cs",115
24,"24177",467,265,263,2,2,"Cs",11
5,"5215",156,120,113,0,7,"Cs",2
46,"46081",9999,7486,7412,47,74,"Cs",518
20,"20005",1274,822,822,1,0,"Cs",5
48,"48046",12626,9300,9250,31,50,"Cs",55
1,"1033",654,476,476,0,0,"Cs",8
42,"42145",129,105,104,1,1,"Cs",6
6,"6104",648,470,459,2,11,"Cs",38
45,"45006",1334,866,858,1,8,"Cs",49
16,"16231",45,38,38,0,0,"Cs",2
6,"6059",1724,1084,1067,6,17,"Cs",75
50,"50206",457,349,345,5,4,"Cs",31
13,"13084",841,652,644,6,8,"Cs",49
49,"49133",287,206,203,1,3,"Cs",15
47,"47002",18,18,18,0,0,"Cs",1
19,"19154",58,45,45,0,0,"Cs",0
28,"28095",1719,1236,1226,5,10,"Cs",82
28,"28161",52164,38607,38193,306,414,"Cs",3869
9,"9131",485,390,388,7,2,"Cs",29
19,"19049",8,8,7,0,1,"Cs",0
2,"2075",1700,1357,1347,6,10,"Cs",79
7,"7023",3776,2425,2386,34,39,"Cs",167
13,"13086",158,122,120,0,2,"Cs",2
44,"44185",88,69,69,2,0,"Cs",0
45,"45192",2380,1890,1854,8,36,"Cs",90
21,"21010",15011,8812,8694,174,118,"Cs",658
44,"44008",1556,1109,1100,7,9,"Cs",42
15,"15090",1115,711,701,19,10,"Cs",17
12,"12040",119116,85613,84993,620,620,"Cs",6868
9,"9456",130,86,86,1,0,"Cs",8
29,"29034",461,333,332,2,1,"Cs",22
18,"18165",4265,2870,2820,22,50,"Cs",217
28,"28097",126,87,87,2,0,"Cs",6
42,"42149",386,273,270,2,3,"Cs",14
40,"40130",127,95,87,1,8,"Cs",9
20,"20008",713,424,424,5,0,"Cs",1
9,"9301",658,497,488,5,9,"Cs",49
49,"49025",157,121,118,0,3,"Cs",4
19,"19247",140,103,102,1,1,"Cs",8
22,"22021",1884,1331,1319,26,12,"Cs",103
41,"41045",5873,3901,3802,53,99,"Cs",261
33,"33066",42818,27780,27466,425,314,"Cs",2053
9,"9134",217,142,138,1,4,"Cs",10
45,"45009",455,277,274,2,3,"Cs",9
23,"23071",1704,1278,1258,10,20,"Cs",43
18,"18167",1839,1243,1224,9,19,"Cs",71
13,"13089",1609,1248,1228,10,20,"Cs",49
19,"19248",73,54,54,0,0,"Cs",5
20,"20009",11369,7402,7355,32,47,"Cs",91
40,"40195",776,573,565,4,8,"Cs",45
50,"50057",1331,933,922,10,11,"Cs",70
9,"9303",73,58,58,0,0,"Cs",3
19,"19157",53,37,37,0,0,"Cs",4
45,"45121",7345,4949,4899,24,50,"Cs",319
29,"29008",15249,10396,10234,108,162,"Cs",691
21,"21012",285,224,221,0,3,"Cs",7
9,"9246",599,381,372,2,9,"Cs",27
3,"3136",399,302,301,3,1,"Cs",16
18,"18069",484,356,356,5,0,"Cs",11
35,"35009",20229,13378,13201,95,177,"Cs",615
5,"5024",193,127,125,2,2,"Cs",8
9,"9464",33,24,24,0,0,"Cs",0
40,"40034",74,59,58,0,1,"Cs",7
4,"4094",215,156,156,0,0,"Cs",4
50,"50082",82,57,57,0,0,"Cs",5
46,"46154",795,619,608,5,11,"Cs",62
41,"41047",10449,7884,7770,119,114,"Cs",712
47,"47194",295,228,227,1,1,"Cs",14
34,"34123",1634,1274,1258,4,16,"Cs",60
29,"29009",1435,971,957,17,14,"Cs",48
3,"3078",468,340,336,0,4,"Cs",21
10,"10105",2442,1541,1515,11,26,"Cs",95
29,"29010",1637,1263,1187,2,76,"Cs",47
48,"48052",1562,1220,1210,5,10,"Cs",3
44,"44190",63,45,45,0,0,"Cs",2
48,"48911",381,303,302,1,1,"Cs",0
2,"2080",498,358,352,0,6,"Cs",16
44,"44103",122,96,96,3,0,"Cs",0
49,"49139",149,112,112,0,0,"Cs",4
46,"46018",562,442,436,2,6,"Cs",16
1,"1043",2340,1487,1468,11,19,"Cs",42
37,"37194",229,161,160,0,1,"Cs",8
35,"35010",3853,2224,2194,18,30,"Cs",56
37,"37195",39,31,31,0,0,"Cs",0
34,"34125",105,80,80,2,0,"Cs",3
22,"22127",521,353,352,5,1,"Cs",42
12,"12122",754,608,600,3,8,"Cs",29
9,"9139",98,79,79,2,0,"Cs",2
13,"13094",294,216,215,1,1,"Cs",22
23,"23075",3222,2513,2475,19,38,"Cs",126
39,"39023",6563,4788,4753,14,35,"Cs",230
28,"28104",15528,12342,12234,103,108,"Cs",1758
28,"28030",1832,1319,1297,13,22,"Cs",90
16,"16243",376,316,309,4,7,"Cs",12
42,"42023",57,48,48,0,0,"Cs",1
44,"44106",151,107,106,0,1,"Cs",2
41,"41049",9515,6961,6843,115,118,"Cs",401
15,"15034",2712,1605,1585,15,20,"Cs",38
9,"9039",54,38,37,0,1,"Cs",1
19,"19126",1701,1223,1207,6,16,"Cs",107
35,"35011",24859,15025,14833,149,192,"Cs",782
45,"45126",234,146,144,2,2,"Cs",7
29,"29086",770,479,476,5,3,"Cs",22
6,"6070",7668,5404,5228,59,176,"Cs",441
32,"32001",5100,3377,3333,32,44,"Cs",100
44,"44013",11232,7872,7801,64,71,"Cs",480
35,"35012",10862,5617,5568,40,49,"Cs",274
42,"42024",84,64,62,1,2,"Cs",3
36,"36902",5028,3453,3396,19,57,"Cs",100
24,"24188",3795,2877,2825,40,52,"Cs",155
50,"50287",253,189,188,11,1,"Cs",10
47,"47010",14718,11521,11392,137,129,"Cs",1359
46,"46088",152,114,110,1,4,"Cs",8
47,"47011",554,466,462,7,4,"Cs",23
19,"19163",60,49,49,0,0,"Cs",5
20,"20014",1161,699,693,0,6,"Cs",0
13,"13098",1946,1404,1361,13,43,"Cs",88
16,"16245",396,304,298,1,6,"Cs",14
46,"46157",2959,2145,2126,11,19,"Cs",126
21,"21018",1719,1048,1029,12,19,"Cs",63
37,"37198",202,147,144,2,3,"Cs",10
44,"44194",103,67,64,0,3,"Cs",5
20,"20015",1245,880,876,5,4,"Cs",2
18,"18175",11793,8099,7943,62,156,"Cs",571
48,"48056",980,731,728,3,3,"Cs",3
22,"22243",43,32,31,0,1,"Cs",5
22,"22130",10146,6505,6436,57,69,"Cs",528
50,"50214",18,18,14,1,4,"Cs",0
9,"9312",89,68,68,1,0,"Cs",3
4,"4031",2238,1649,1645,15,4,"Cs",91
16,"16908",166,133,132,2,1,"Cs",3
49,"49258",111,93,93,2,0,"Cs",7
19,"19255",74,37,37,0,0,"Cs",0
46,"46044",4159,3062,2997,26,65,"Cs",198
1,"1051",3569,2259,2244,3,15,"Cs",18
11,"11007",18032,9872,9745,213,127,"Cs",854
9,"9094",53,42,42,0,0,"Cs",0
23,"23080",1720,1313,1294,6,19,"Cs",64
5,"5228",168,99,98,0,1,"Cs",2
50,"50140",153,96,95,1,1,"Cs",5
16,"16247",63,51,50,1,1,"Cs",1
36,"36003",10023,6877,6789,66,88,"Cs",372
9,"9482",34,22,22,0,0,"Cs",2
21,"21020",349,230,228,2,2,"Cs",12
12,"12125",215,179,179,2,0,"Cs",6
3,"3083",5479,3736,3674,39,62,"Cs",277
46,"46227",893,687,675,6,12,"Cs",26
9,"9483",189,156,155,2,1,"Cs",12
47,"47014",48,39,39,1,0,"Cs",2
48,"48057",5730,4126,4115,14,11,"Cs",7
39,"39028",3892,2905,2878,20,27,"Cs",158
29,"29016",253,196,194,0,2,"Cs",15
13,"13904",496,353,342,5,11,"Cs",16
40,"40010",108,83,82,0,1,"Cs",5
23,"23082",1850,1292,1279,13,13,"Cs",59
45,"45021",2639,1798,1755,22,43,"Cs",135
44,"44196",121,88,88,0,0,"Cs",2
7,"7003",12521,6457,6381,60,76,"Cs",481
22,"22245",303,222,213,3,9,"Cs",17
16,"16249",1938,1422,1406,6,16,"Cs",49
14,"14001",3423,2563,2515,11,48,"Cs",130
1,"1053",596,364,362,1,2,"Cs",3
4,"4034",169,91,91,1,0,"Cs",7
9,"9485",55,41,41,0,0,"Cs",1
49,"49037",174,139,136,1,3,"Cs",11
3,"3001",337,260,258,0,2,"Cs",10
44,"44111",78,61,61,0,0,"Cs",4
23,"23084",902,627,621,4,6,"Cs",21
40,"40012",241,160,156,7,4,"Cs",10
26,"26079",633,503,499,2,4,"Cs",28
46,"46092",262,176,174,2,2,"Cs",7
12,"12127",63,45,44,1,1,"Cs",1
47,"47016",65,55,55,0,0,"Cs",5
24,"24196",1907,1322,1299,4,23,"Cs",66
49,"49262",367,263,261,1,2,"Cs",12
22,"22036",84,71,71,1,0,"Cs",4
9,"9902",439,334,326,10,8,"Cs",30
45,"45023",2300,1700,1685,19,15,"Cs",137
35,"35016",300581,181532,179831,1458,1701,"Cs",11663
47,"47206",79,66,66,0,0,"Cs",1
49,"49150",123,95,92,3,3,"Cs",4
41,"41056",3687,2836,2779,37,57,"Cs",206
20,"20020",114,64,64,0,0,"Cs",0
26,"26080",451,347,344,0,3,"Cs",17
47,"47111",1001,738,732,5,6,"Cs",60
5,"5103",63,44,44,1,0,"Cs",4
45,"45170",194,146,140,0,6,"Cs",14
37,"37141",149,101,100,0,1,"Cs",4
21,"21054",8175,6014,5887,41,127,"Cs",276
40,"40046",83,67,67,1,0,"Cs",4
49,"49263",44,32,32,1,0,"Cs",2
6,"6082",399,295,291,6,4,"Cs",20
49,"49151",591,389,388,3,1,"Cs",16
44,"44021",104,77,77,1,0,"Cs",1
16,"16011",20,14,14,0,0,"Cs",3
21,"21024",464,328,312,1,16,"Cs",15
44,"44113",74,51,51,0,0,"Cs",0
19,"19170",189,115,115,1,0,"Cs",3
1,"1057",235,196,194,0,2,"Cs",1
32,"32084",878,532,527,8,5,"Cs",12
41,"41057",258,174,170,3,4,"Cs",9
10,"10119",574,417,414,2,3,"Cs",24
38,"38009",4315,2846,2817,27,29,"Cs",111
46,"46094",20805,15353,15211,122,142,"Cs",1335
24,"24090",323,200,200,2,0,"Cs",9
45,"45026",219,166,164,1,2,"Cs",5
18,"18084",4533,3233,3178,35,55,"Cs",276
16,"16125",1607,1166,1150,11,16,"Cs",60
20,"20022",849,574,571,8,3,"Cs",0
4,"4038",3105,2020,1984,17,36,"Cs",155
21,"21026",262,172,168,2,4,"Cs",12
18,"18116",2856,2027,1979,13,48,"Cs",123
9,"9163",573,436,432,7,4,"Cs",33
5,"5901",247,154,152,3,2,"Cs",10
5,"5001",182,139,138,1,1,"Cs",5
26,"26047",1852,1449,1434,6,15,"Cs",65
16,"16126",720,552,545,3,7,"Cs",15
22,"22040",149,119,119,3,0,"Cs",3
44,"44114",233,161,159,0,2,"Cs",10
26,"26048",21,21,21,0,0,"Cs",4
9,"9907",1526,1140,1119,18,21,"Cs",99
15,"15014",3836,2191,2158,27,33,"Cs",118
6,"6085",3429,2439,2382,21,57,"Cs",220
49,"49266",66,46,45,1,1,"Cs",6
27,"27016",6958,4697,4616,50,81,"Cs",146
9,"9328",70,37,37,3,0,"Cs",2
14,"14006",1319,1088,1057,8,31,"Cs",56
24,"24202",7504,4607,4538,51,69,"Cs",233
7,"7042",10846,6354,6299,77,55,"Cs",379
46,"46027",924,746,737,2,9,"Cs",29
4,"4043",517,398,395,1,3,"Cs",13
37,"37334",71,30,30,0,0,"Cs",1
38,"38035",10518,5870,5819,37,51,"Cs",324
20,"20024",395,245,245,4,0,"Cs",0
44,"44115",102,91,91,0,0,"Cs",2
27,"27018",3211,1830,1800,17,30,"Cs",34
29,"29096",2757,1847,1790,19,57,"Cs",83
37,"37115",108,67,65,0,2,"Cs",0
7,"7043",3431,2196,2166,21,30,"Cs",111
24,"24093",342,214,212,2,2,"Cs",6
22,"22042",116,91,89,1,2,"Cs",11
9,"9167",53,36,36,0,0,"Cs",3
44,"44024",31,26,25,0,1,"Cs",1
26,"26087",180,123,123,3,0,"Cs",10
46,"46028",383,305,299,8,6,"Cs",21
20,"20025",1110,791,788,4,3,"Cs",2
5,"5141",95,79,78,1,1,"Cs",2
18,"18024",837,651,639,11,12,"Cs",30
35,"35020",5941,3740,3702,27,38,"Cs",112
22,"22142",94,72,70,0,2,"Cs",1
40,"40018",73,50,50,0,0,"Cs",4
16,"16263",967,724,721,3,3,"Cs",31
26,"26088",39,35,34,0,1,"Cs",0
6,"6089",610,470,463,2,7,"Cs",27
46,"46097",948,670,663,1,7,"Cs",93
9,"9169",97,72,70,1,2,"Cs",8
37,"37304",156,97,96,1,1,"Cs",3
28,"28118",61,52,50,0,2,"Cs",0
40,"40119",166,133,132,2,1,"Cs",15
49,"49234",394,282,277,0,5,"Cs",15
22,"22109",261,184,183,1,1,"Cs",22
41,"41090",3489,2560,2467,27,93,"Cs",130
9,"9062",40,34,33,0,1,"Cs",1
9,"9115",90,65,63,3,2,"Cs",0
21,"21030",1887,1493,1458,12,35,"Cs",57
46,"46166",8214,6093,6031,38,62,"Cs",413
24,"24207",276,215,215,2,0,"Cs",17
5,"5239",215,163,163,3,0,"Cs",7
34,"34010",550,407,399,7,8,"Cs",40
40,"40183",117,105,99,1,6,"Cs",5
15,"15049",1068,752,747,7,5,"Cs",17
16,"16132",33,25,25,1,0,"Cs",0
20,"20027",2761,1866,1861,10,5,"Cs",3
47,"47214",1349,1036,1019,5,17,"Cs",39
22,"22186",189,148,145,3,3,"Cs",14
18,"18122",15994,11009,10773,109,236,"Cs",835
45,"45143",1192,877,865,9,12,"Cs",36
48,"48095",2324,1568,1555,13,13,"Cs",17
44,"44266",102,81,79,0,2,"Cs",4
14,"14010",3992,2786,2723,14,63,"Cs",147
9,"9335",86,66,66,3,0,"Cs",2
26,"26092",104,82,81,3,1,"Cs",6
7,"7047",2399,1504,1477,20,27,"Cs",79
22,"22045",65,52,52,0,0,"Cs",1
10,"10129",340,234,227,2,7,"Cs",13
5,"5144",65,47,46,1,1,"Cs",1
34,"34206",810,608,602,5,6,"Cs",32
3,"3010",332,275,268,1,7,"Cs",20
34,"34152",124,99,94,0,5,"Cs",4
34,"34205",55,38,38,0,0,"Cs",2
47,"47215",48,43,43,0,0,"Cs",5
20,"20029",4264,3116,3104,14,12,"Cs",12
49,"49091",246,168,167,1,1,"Cs",6
1,"1902",723,485,478,8,7,"Cs",11
11,"11021",4914,3187,3069,61,118,"Cs",311
19,"19147",42,32,32,0,0,"Cs",2
5,"5114",1257,989,968,5,21,"Cs",38
33,"33002",9403,5920,5839,69,81,"Cs",242
37,"37049",125,76,76,0,0,"Cs",2
6,"6049",956,625,604,8,21,"Cs",37
5,"5047",4105,3004,2936,23,68,"Cs",209
50,"50024",543,400,397,3,3,"Cs",23
22,"22901",714,433,423,6,10,"Cs",24
12,"12136",2603,2151,2119,20,32,"Cs",100
10,"10130",1754,1199,1189,10,10,"Cs",38
12,"12060",434,366,360,1,6,"Cs",11
44,"44208",27,17,17,0,0,"Cs",0
15,"15021",5254,3473,3422,58,51,"Cs",162
28,"28123",62178,49883,49515,397,368,"Cs",4992
2,"2002",427,340,337,2,3,"Cs",12
44,"44056",446,327,325,1,2,"Cs",16
28,"28156",1082,788,784,3,4,"Cs",53
18,"18189",785,598,592,9,6,"Cs",46
41,"41066",1307,927,898,7,29,"Cs",38
37,"37214",120,70,68,2,2,"Cs",3
10,"10010",2206,1308,1281,8,27,"Cs",74
9,"9177",1140,790,780,7,10,"Cs",59
23,"23099",4824,3523,3435,35,88,"Cs",190
16,"16023",513,367,367,3,0,"Cs",24
18,"18095",2054,1475,1433,14,42,"Cs",103
44,"44237",367,267,262,0,5,"Cs",5
46,"46238",13117,9172,9088,50,84,"Cs",576
37,"37018",106,75,75,0,0,"Cs",5
45,"45186",2943,2142,2121,12,21,"Cs",94
12,"12137",40,28,28,0,0,"Cs",2
47,"47124",383,302,300,3,2,"Cs",30
37,"37216",294,234,227,5,7,"Cs",17
50,"50001",89,68,68,0,0,"Cs",1
7,"7051",5484,3133,3094,43,39,"Cs",202
4,"4052",12882,8400,8322,93,78,"Cs",759
40,"40125",76,48,46,0,2,"Cs",6
28,"28050",4406,3202,3167,29,35,"Cs",312
21,"21036",204,128,121,1,7,"Cs",3
45,"45149",517,400,393,2,7,"Cs",18
37,"37343",66,44,43,1,1,"Cs",3
40,"40220",64,46,45,0,1,"Cs",3
49,"49165",55,52,52,1,0,"Cs",1
46,"46239",446,357,352,1,5,"Cs",17
44,"44210",750,577,572,2,5,"Cs",28
24,"24102",587,403,399,7,4,"Cs",17
4,"4053",12545,8864,8744,67,120,"Cs",746
13,"13035",947,704,690,6,14,"Cs",31
9,"9072",331,261,260,4,1,"Cs",24
6,"6101",437,355,346,1,9,"Cs",12
5,"5151",83,60,60,0,0,"Cs",0
35,"35026",83172,48751,48109,449,642,"Cs",2905
42,"42187",58,44,39,1,5,"Cs",2
37,"37250",325,212,211,0,1,"Cs",6
38,"38042",3778,2410,2386,11,24,"Cs",87
4,"4087",157,115,113,0,2,"Cs",4
28,"28126",50,36,36,0,0,"Cs",0
5,"5246",48,35,35,0,0,"Cs",0
27,"27027",1791,1198,1167,17,31,"Cs",32
19,"19086",1371,1003,996,9,7,"Cs",47
34,"34112",39,31,31,0,0,"Cs",5
5,"5152",644,498,496,3,2,"Cs",25
44,"44124",71,57,57,0,0,"Cs",3
40,"40029",25,21,19,0,2,"Cs",1
45,"45079",355,250,250,0,0,"Cs",10
47,"47031",191,141,140,0,1,"Cs",4
28,"28127",66793,53258,53009,458,249,"Cs",6319
46,"46172",5488,3724,3674,26,50,"Cs",224
10,"10014",1816,1285,1254,13,31,"Cs",49
40,"40060",67,40,40,1,0,"Cs",0
50,"50231",253,199,195,4,4,"Cs",10
42,"42189",57,43,43,0,0,"Cs",5
46,"46036",558,339,331,6,8,"Cs",19
34,"34024",25,14,14,0,0,"Cs",0
47,"47063",86,68,68,0,0,"Cs",4
28,"28128",453,334,331,1,3,"Cs",29
49,"49059",84,61,58,0,3,"Cs",4
39,"39045",352,238,234,0,4,"Cs",1
5,"5054",1192,871,856,6,15,"Cs",41
37,"37022",242,191,190,0,1,"Cs",7
9,"9351",61,46,45,1,1,"Cs",3
12,"12067",514,381,373,3,8,"Cs",18
18,"18099",1582,1184,1156,13,28,"Cs",94
10,"10139",92,66,65,1,1,"Cs",4
19,"19246",42,27,27,1,0,"Cs",0
49,"49061",143,98,97,1,1,"Cs",12
27,"27030",3117,1945,1898,19,47,"Cs",36
14,"14018",3617,2632,2568,31,64,"Cs",176
24,"24218",451,310,308,3,2,"Cs",17
10,"10140",1109,778,769,7,9,"Cs",36
4,"4020",302,207,206,2,1,"Cs",13
49,"49207",215,144,143,1,1,"Cs",7
47,"47003",206,167,166,5,1,"Cs",6
42,"42191",183,116,114,5,2,"Cs",8
37,"37347",463,349,345,9,4,"Cs",26
34,"34218",437,313,309,3,4,"Cs",17
46,"46060",9278,6796,6724,49,72,"Cs",491
6,"6107",1555,980,969,8,11,"Cs",48
16,"16278",61,45,45,0,0,"Cs",0
18,"18006",4062,2765,2711,25,54,"Cs",146
37,"37284",317,229,222,2,7,"Cs",12
28,"28055",944,636,627,4,9,"Cs",32
35,"35030",10046,5584,5505,44,79,"Cs",222
9,"9355",85,67,67,1,0,"Cs",4
9,"9032",103,62,62,3,0,"Cs",5
44,"44037",447,288,288,1,0,"Cs",11
28,"28056",946,664,660,2,4,"Cs",37
47,"47130",94,64,63,0,1,"Cs",8
9,"9191",33,23,23,1,0,"Cs",0
48,"48077",3366,2483,2467,9,16,"Cs",15
37,"37223",106,75,74,0,1,"Cs",4
45,"45157",2288,1490,1472,5,18,"Cs",73
19,"19090",90,69,68,1,1,"Cs",4
33,"33010",1722,1085,1069,15,16,"Cs",55
34,"34029",665,524,518,1,6,"Cs",9
12,"12095",950,723,712,5,11,"Cs",31
21,"21042",15610,8112,8011,164,101,"Cs",647
2,"2044",1040,665,656,5,9,"Cs",40
16,"16189",264,196,194,4,2,"Cs",17
32,"32033",667,439,436,4,3,"Cs",5
9,"9192",54,46,45,1,1,"Cs",4
42,"42057",145,70,70,0,0,"Cs",0
37,"37098",290,197,197,1,0,"Cs",10
27,"27003",1743,1161,1134,18,27,"Cs",22
28,"28057",1556,1155,1141,7,14,"Cs",108
37,"37027",239,182,179,2,3,"Cs",8
29,"29037",215,156,153,1,3,"Cs",4
26,"26107",86,65,64,1,1,"Cs",3
37,"37350",403,281,274,1,7,"Cs",35
10,"10021",4987,3574,3475,31,99,"Cs",258
6,"6020",1752,1330,1296,6,34,"Cs",97
32,"32034",1062,763,753,6,10,"Cs",11
44,"44129",35,29,29,1,0,"Cs",0
50,"50032",243,167,164,3,3,"Cs",8
9,"9194",1970,1376,1359,15,17,"Cs",119
5,"5254",184,149,147,1,2,"Cs",8
6,"6112",379,295,293,0,2,"Cs",18
24,"24004",495,387,384,10,3,"Cs",7
50,"50161",98,75,74,2,1,"Cs",4
16,"16902",124,86,86,1,0,"Cs",3
19,"19124",378,230,229,2,1,"Cs",14
19,"19314",44,33,33,0,0,"Cs",1
4,"4026",57,38,37,0,1,"Cs",3
37,"37257",51,36,36,1,0,"Cs",2
6,"6113",2649,1889,1862,16,27,"Cs",170
23,"23003",8639,6296,6226,41,70,"Cs",379
42,"42059",20,14,14,0,0,"Cs",2
40,"40231",100,79,76,0,3,"Cs",8
19,"19095",11,7,6,0,1,"Cs",0
47,"47134",150,120,116,2,4,"Cs",5
9,"9196",133,95,95,2,0,"Cs",6
35,"35033",6393,4147,4072,38,75,"Cs",253
42,"42060",28,16,14,0,2,"Cs",1
47,"47039",162,119,117,0,2,"Cs",6
24,"24226",194,118,118,1,0,"Cs",5
28,"28060",1585,1160,1146,5,14,"Cs",55
16,"16904",453,348,345,11,3,"Cs",14
14,"14024",1849,1417,1391,5,26,"Cs",82
9,"9197",144,105,103,2,2,"Cs",6
49,"49176",605,360,353,0,7,"Cs",15
45,"45052",3132,2433,2416,29,17,"Cs",216
22,"22058",193,141,141,0,0,"Cs",8
24,"24114",2866,1753,1742,15,11,"Cs",60
2,"2015",1432,1163,1148,8,15,"Cs",74
9,"9250",264,195,193,3,2,"Cs",5
20,"20074",11520,8379,8357,19,22,"Cs",37
48,"48025",874,667,662,2,5,"Cs",4
21,"21077",1739,1266,1235,13,31,"Cs",60
6,"6116",1500,1015,998,7,17,"Cs",42
10,"10148",33054,21731,21379,231,352,"Cs",1854
34,"34176",127,95,90,3,5,"Cs",7
50,"50137",958,740,731,8,9,"Cs",56
10,"10149",432,284,280,2,4,"Cs",13
37,"37135",1146,849,837,5,12,"Cs",54
11,"11035",13751,8535,8396,125,139,"Cs",726
9,"9365",26,17,17,0,0,"Cs",3
16,"16905",1302,951,934,10,17,"Cs",56
24,"24008",8931,6291,6214,79,77,"Cs",370
49,"49177",255,145,144,1,1,"Cs",5
19,"19097",14,14,13,0,1,"Cs",0
24,"24115",53159,35203,34784,410,419,"Cs",2306
50,"50238",84,65,65,0,0,"Cs",4
36,"36001",2397,1674,1651,6,23,"Cs",62
24,"24116",387,227,226,3,1,"Cs",15
20,"20045",47031,30933,30787,172,146,"Cs",500
21,"21048",318,234,229,3,5,"Cs",19
47,"47041",147,105,103,3,2,"Cs",6
47,"47138",224,169,166,0,3,"Cs",8
40,"40039",180,133,133,0,0,"Cs",6
44,"44222",125,92,92,0,0,"Cs",1
28,"28062",306,232,227,0,5,"Cs",11
11,"11037",5656,4374,4273,24,101,"Cs",106
44,"44043",86,60,60,0,0,"Cs",7
12,"12075",110,85,83,3,2,"Cs",1
19,"19194",91,69,69,0,0,"Cs",8
5,"5164",18,12,12,0,0,"Cs",0
30,"30010",6852,5161,5106,25,55,"Cs",231
3,"3054",334,248,245,2,3,"Cs",14
4,"4067",504,340,330,4,10,"Cs",9
46,"46249",9136,6538,6439,73,99,"Cs",531
10,"10193",1392,1045,1025,6,20,"Cs",78
16,"16156",84,64,64,0,0,"Cs",2
40,"40140",76,54,54,0,0,"Cs",4
39,"39026",1702,1160,1151,11,9,"Cs",33
6,"6120",3370,2507,2460,11,47,"Cs",155
26,"26003",379,311,306,1,5,"Cs",5
24,"24011",182,104,102,3,2,"Cs",1
13,"13009",1383,1081,1070,3,11,"Cs",69
47,"47013",91,77,77,1,0,"Cs",2
44,"44044",82,65,65,2,0,"Cs",5
42,"42068",77,58,57,0,1,"Cs",2
9,"9046",23,17,17,0,0,"Cs",0
47,"47044",323,273,270,4,3,"Cs",20
5,"5262",318,238,235,1,3,"Cs",6
24,"24012",278,182,180,0,2,"Cs",16
14,"14028",302,241,240,3,1,"Cs",3
24,"24902",331,239,239,0,0,"Cs",16
45,"45058",344,245,236,1,9,"Cs",10
36,"36004",10109,6611,6502,79,109,"Cs",278
9,"9208",176,121,120,4,1,"Cs",7
13,"13011",4439,2762,2694,16,68,"Cs",185
5,"5067",73,56,54,0,2,"Cs",5
9,"9048",1373,937,911,10,26,"Cs",87
46,"46114",552,417,412,6,5,"Cs",25
28,"28143",77,58,58,0,0,"Cs",4
23,"23010",14264,9801,9635,120,166,"Cs",586
12,"12077",4828,3395,3357,28,38,"Cs",212
50,"50167",208,166,163,1,3,"Cs",12
45,"45169",179,114,111,1,3,"Cs",5
44,"44138",120,92,92,0,0,"Cs",3
9,"9261",446,279,271,2,8,"Cs",15
50,"50088",274,195,191,2,4,"Cs",8
26,"26078",86,63,63,0,0,"Cs",2
50,"50064",439,348,346,1,2,"Cs",10
19,"19197",28,22,22,1,0,"Cs",0
16,"16159",198,135,135,2,0,"Cs",4
27,"27044",2703,1495,1463,15,32,"Cs",28
13,"13014",472,361,352,4,9,"Cs",17
32,"32008",8647,5570,5495,56,75,"Cs",252
16,"16044",43,29,28,0,1,"Cs",0
50,"50242",99,74,74,0,0,"Cs",3
21,"21053",3306,2161,2106,11,55,"Cs",196
45,"45060",152,109,109,1,0,"Cs",2
9,"9051",164,125,125,0,0,"Cs",16
44,"44077",68,52,51,0,1,"Cs",5
6,"6125",1644,1251,1222,7,29,"Cs",49
40,"40905",130,95,95,0,0,"Cs",7
39,"39058",806,556,554,2,2,"Cs",7
14,"14031",556,462,456,5,6,"Cs",27
26,"26121",30,19,19,0,0,"Cs",0
47,"47047",199,136,135,4,1,"Cs",6
46,"46161",1467,1129,1113,5,16,"Cs",78
24,"24122",1292,818,810,7,8,"Cs",43
23,"23012",4004,2726,2689,21,37,"Cs",162
29,"29046",2494,1727,1693,13,34,"Cs",148
50,"50268",41,32,32,1,0,"Cs",4
28,"28068",11740,8615,8543,72,72,"Cs",697
12,"12024",138,107,107,1,0,"Cs",6
41,"41084",2799,2029,1937,9,92,"Cs",110
28,"28145",2671,1927,1895,21,32,"Cs",167
20,"20051",6736,4829,4804,22,25,"Cs",33
29,"29047",1082,860,846,0,14,"Cs",31
9,"9214",632,409,407,2,2,"Cs",13
42,"42120",131,87,86,1,1,"Cs",3
10,"10159",314,207,207,2,0,"Cs",8
47,"47048",175,124,122,0,2,"Cs",11
34,"34189",53,33,33,0,0,"Cs",0
46,"46185",361,301,299,5,2,"Cs",11
33,"33022",802,460,452,4,8,"Cs",18
29,"29048",1364,1053,1039,8,14,"Cs",32
37,"37332",65,49,49,0,0,"Cs",6
16,"16047",214,154,148,3,6,"Cs",11
3,"3032",97,82,82,0,0,"Cs",4
5,"5073",282,210,207,1,3,"Cs",11
6,"6129",577,438,416,1,22,"Cs",33
49,"49188",111,75,73,0,2,"Cs",3
36,"36009",4401,2712,2649,33,63,"Cs",116
24,"24164",351,175,174,0,1,"Cs",14
33,"33023",3249,2127,2097,30,30,"Cs",102
37,"37205",212,157,155,1,2,"Cs",3
48,"48062",295,236,236,0,0,"Cs",0
1,"1058",1414,893,884,1,9,"Cs",6
6,"6039",1802,1375,1343,9,32,"Cs",73
48,"48007",389,243,243,0,0,"Cs",0
30,"30017",11428,8196,8113,44,83,"Cs",607
40,"40113",404,308,304,2,4,"Cs",20
34,"34050",187,136,136,1,0,"Cs",9
22,"22068",64,41,41,1,0,"Cs",1
9,"9218",350,254,252,5,2,"Cs",23
11,"11903",1769,1116,1101,22,15,"Cs",84
15,"15045",3610,2057,2044,15,13,"Cs",78
20,"20054",461,294,294,1,0,"Cs",1
39,"39062",1864,1395,1376,3,19,"Cs",64
36,"36010",2825,1983,1947,19,36,"Cs",77
19,"19108",95,78,78,0,0,"Cs",7
6,"6132",823,543,533,4,10,"Cs",22
9,"9058",394,286,284,6,2,"Cs",45
37,"37078",781,626,603,9,23,"Cs",49
19,"19071",8277,5838,5763,53,75,"Cs",576
41,"41059",35358,26408,26052,346,356,"Cs",2591
42,"42080",153,108,108,1,0,"Cs",3
19,"19202",16,13,13,1,0,"Cs",1
13,"13021",412,325,320,1,5,"Cs",9
49,"49085",904,583,579,5,4,"Cs",32
9,"9219",27097,17874,17629,192,245,"Cs",1188
12,"12001",1028,783,768,6,15,"Cs",31
19,"19297",32,28,28,0,0,"Cs",2
28,"28150",3191,2423,2401,13,22,"Cs",189
37,"37335",384,282,279,1,3,"Cs",11
3,"3121",21997,14689,14572,103,117,"Cs",1166
36,"36014",1867,1265,1243,16,22,"Cs",36
12,"12002",114,96,94,1,2,"Cs",3
22,"22072",197,127,126,1,1,"Cs",9
14,"14063",994,731,719,8,12,"Cs",48
2,"2062",382,261,256,2,5,"Cs",16
40,"40149",479,345,338,3,7,"Cs",21
37,"37147",184,126,124,1,2,"Cs",3
29,"29051",42179,27231,26724,282,507,"Cs",2371
30,"30019",25911,17485,17264,157,221,"Cs",1068
44,"44052",75,54,54,0,0,"Cs",2
36,"36015",4079,2653,2606,29,47,"Cs",110
18,"18120",266,204,204,4,0,"Cs",12
19,"19298",53,43,41,0,2,"Cs",2
6,"6136",1489,1086,1060,11,26,"Cs",59
46,"46052",515,423,419,4,4,"Cs",28
34,"34201",171,131,130,1,1,"Cs",8
18,"18121",119,79,79,1,0,"Cs",2
44,"44088",24,23,23,0,0,"Cs",1
28,"28014",34522,25016,24748,229,268,"Cs",2091
18,"18185",545,434,424,5,10,"Cs",18
26,"26052",146,106,105,0,1,"Cs",6
50,"50022",504,373,369,12,4,"Cs",27
37,"37045",27,19,19,0,0,"Cs",2
10,"10167",301,198,198,0,0,"Cs",2
42,"42083",26,20,20,0,0,"Cs",0
40,"40020",149,112,111,1,1,"Cs",8
49,"49048",113,88,88,0,0,"Cs",5
41,"41006",2733,1776,1742,17,34,"Cs",107
10,"10168",320,210,206,1,4,"Cs",13
27,"27052",860,564,558,7,6,"Cs",15
18,"18154",982,668,668,4,0,"Cs",19
20,"20028",2254,1442,1441,6,1,"Cs",11
24,"24024",636,407,403,6,4,"Cs",24
28,"28075",6020,4521,4469,37,52,"Cs",393
9,"9391",347,247,246,2,1,"Cs",16
19,"19112",53,35,34,0,1,"Cs",2
26,"26017",364,274,269,2,5,"Cs",11
50,"50023",199,145,143,2,2,"Cs",16
4,"4081",351,264,263,0,1,"Cs",10
34,"34058",182,152,152,0,0,"Cs",9
16,"16171",1728,1334,1313,10,21,"Cs",32
45,"45071",1779,1374,1342,7,32,"Cs",77
27,"27021",1632,962,935,23,27,"Cs",24
44,"44054",95,82,81,0,1,"Cs",4
23,"23025",2725,1894,1870,11,24,"Cs",77
45,"45108",465,343,341,0,2,"Cs",14
16,"16217",91,72,72,0,0,"Cs",2
12,"12087",26,16,16,0,0,"Cs",0
37,"37275",98,67,67,0,0,"Cs",1
46,"46054",11389,8266,8190,54,76,"Cs",600
38,"38039",11149,7375,7326,68,49,"Cs",428
40,"40022",195,144,141,2,3,"Cs",6
35,"35023",11742,7787,7651,95,136,"Cs",416
37,"37085",5060,3732,3689,52,43,"Cs",453
9,"9280",26,18,18,0,0,"Cs",1
16,"16135",115,76,76,0,0,"Cs",2
46,"46123",1926,1392,1368,11,24,"Cs",60
16,"16134",4368,3143,3102,22,41,"Cs",170
50,"50177",288,196,193,0,3,"Cs",13
32,"32021",872,555,550,6,5,"Cs",8
19,"19240",49,36,36,0,0,"Cs",1
27,"27055",1191,773,764,7,9,"Cs",13
24,"24136",495,347,344,1,3,"Cs",25
44,"44236",60,38,38,0,0,"Cs",2
12,"12006",177,133,133,2,0,"Cs",4
28,"28155",487,374,369,0,5,"Cs",8
45,"45147",592,449,443,2,6,"Cs",23
50,"50074",6156,4100,4022,33,78,"Cs",409
10,"10172",696,447,443,5,4,"Cs",14
16,"16174",166,130,129,2,1,"Cs",1
34,"34061",91,70,69,1,1,"Cs",3
37,"37152",400,268,261,4,7,"Cs",17
10,"10050",987,707,704,4,3,"Cs",26
19,"19303",41,32,32,0,0,"Cs",1
6,"6006",4479,2991,2934,27,57,"Cs",213
26,"26135",152,115,114,0,1,"Cs",13
37,"37372",133,99,98,0,1,"Cs",5
45,"45075",120,77,74,0,3,"Cs",4
16,"16175",5071,3807,3732,43,75,"Cs",140
42,"42139",21,16,16,2,0,"Cs",0
46,"46056",176,142,142,0,0,"Cs",4
34,"34062",148,94,93,0,1,"Cs",2
46,"46193",8959,6880,6824,66,56,"Cs",552
37,"37248",150,116,116,1,0,"Cs",6
5,"5083",137,92,91,0,1,"Cs",9
47,"47155",3454,2445,2405,26,40,"Cs",234
20,"20063",8023,5611,5597,19,14,"Cs",17
13,"13033",1544,1231,1196,5,35,"Cs",44
19,"19304",224,169,166,3,3,"Cs",13
44,"44060",32,25,25,0,0,"Cs",1
9,"9447",43,37,36,0,1,"Cs",3
12,"12008",228,195,194,1,1,"Cs",3
49,"49203",280,218,212,1,6,"Cs",18
10,"10052",172,114,113,3,1,"Cs",17
19,"19213",67,53,52,1,1,"Cs",1
45,"45113",1770,1189,1171,5,18,"Cs",47
6,"6009",221,166,166,2,0,"Cs",7
22,"22193",272,199,194,4,5,"Cs",13
20,"20003",549,360,355,1,5,"Cs",0
39,"39098",1381,1088,1080,5,8,"Cs",14
21,"21067",406,274,271,3,3,"Cs",14
33,"33033",9381,5848,5770,88,78,"Cs",206
10,"10176",344,223,213,2,10,"Cs",17
24,"24103",274,134,134,0,0,"Cs",8
37,"37374",1138,889,872,2,17,"Cs",49
40,"40028",103,88,87,2,1,"Cs",3
38,"38043",19365,12355,12212,126,143,"Cs",761
5,"5053",76,48,48,0,0,"Cs",6
26,"26140",239,180,177,1,3,"Cs",6
44,"44061",77,60,58,1,2,"Cs",0
6,"6102",1027,834,815,3,19,"Cs",38
37,"37156",4261,2928,2869,23,59,"Cs",250
16,"16102",1159,815,767,9,48,"Cs",42
4,"4088",2444,1587,1574,17,13,"Cs",101
24,"24068",430,289,281,0,8,"Cs",5
24,"24032",99,70,66,1,4,"Cs",1
19,"19013",111,89,89,0,0,"Cs",4
22,"22081",247,173,171,3,2,"Cs",14
14,"14045",2997,2329,2287,30,42,"Cs",150
47,"47001",52,43,42,1,1,"Cs",0
34,"34068",29,25,24,0,1,"Cs",1
38,"38044",2215,1270,1257,5,13,"Cs",56
40,"40159",130,94,93,2,1,"Cs",3
12,"12092",123,95,95,0,0,"Cs",6
49,"49132",310,220,215,2,5,"Cs",8
44,"44183",61,47,47,1,0,"Cs",1
6,"6149",10177,7582,7455,64,127,"Cs",961
19,"19307",25,23,23,0,0,"Cs",1
24,"24144",621,419,412,4,7,"Cs",23
15,"15058",28761,20250,20098,261,152,"Cs",1189
34,"34069",2184,1555,1517,17,38,"Cs",106
40,"40061",63,47,44,0,3,"Cs",2
39,"39073",10260,7537,7482,42,55,"Cs",462
10,"10179",272,209,209,2,0,"Cs",8
40,"40161",32,24,23,1,1,"Cs",1
41,"41015",5426,3778,3639,41,139,"Cs",298
32,"32029",441,286,283,2,3,"Cs",5
22,"22199",6884,4438,4384,71,54,"Cs",335
26,"26143",260,197,192,1,5,"Cs",13
12,"12011",4583,3228,3177,24,51,"Cs",178
42,"42015",30,20,20,0,0,"Cs",1
22,"22020",115,83,80,3,3,"Cs",7
45,"45045",1338,926,915,9,11,"Cs",51
33,"33065",1077,670,657,11,13,"Cs",47
15,"15059",10229,6900,6734,85,166,"Cs",258
30,"30028",6390,4054,3973,25,81,"Cs",225
23,"23069",5240,4153,4065,26,88,"Cs",753
28,"28096",20022,14440,14238,115,202,"Cs",1380
37,"37253",135,109,109,1,0,"Cs",10
44,"44100",177,136,135,1,1,"Cs",0
46,"46197",1930,1430,1411,11,19,"Cs",82
44,"44064",62,46,46,0,0,"Cs",1
49,"49171",603,433,427,4,6,"Cs",26
50,"50207",87,58,58,1,0,"Cs",6
34,"34220",152,133,132,1,1,"Cs",17
21,"21071",206,148,144,4,4,"Cs",12
26,"26065",63,46,43,0,3,"Cs",5
3,"3134",139,107,107,0,0,"Cs",1
27,"27001",2187,1111,1102,17,9,"Cs",27
14,"14048",1199,883,866,4,17,"Cs",57
9,"9411",153,105,104,0,1,"Cs",5
39,"39075",136789,95707,95089,478,618,"Cs",5178
39,"39076",3512,2517,2491,13,26,"Cs",109
48,"48909",201,158,157,0,1,"Cs",0
50,"50258",53,25,25,1,0,"Cs",5
40,"40065",467,338,329,1,9,"Cs",32
19,"19310",7,7,7,0,0,"Cs",0
5,"5219",33,23,23,0,0,"Cs",1
6,"6018",727,483,476,0,7,"Cs",11
10,"10905",636,443,433,7,10,"Cs",41
28,"28099",1950,1409,1404,16,5,"Cs",97
32,"32069",4223,3064,3023,31,41,"Cs",100
24,"24149",149,123,123,0,0,"Cs",4
6,"6019",2010,1367,1330,23,37,"Cs",76
19,"19311",85,60,59,0,1,"Cs",4
47,"47226",148,115,115,1,0,"Cs",5
50,"50259",82,55,55,2,0,"Cs",5
45,"45085",1535,1061,1052,11,9,"Cs",47
23,"23038",3786,2934,2900,21,34,"Cs",195
46,"46199",5878,4217,4182,21,35,"Cs",371
6,"6111",487,318,314,2,4,"Cs",35
26,"26147",34,26,25,0,1,"Cs",0
10,"10144",915,618,614,0,4,"Cs",42
26,"26032",43,36,35,0,1,"Cs",1
29,"29065",191,145,143,3,2,"Cs",13
9,"9414",180,137,135,1,2,"Cs",12
13,"13046",686,524,521,6,3,"Cs",55
39,"39077",237,151,148,1,3,"Cs",3
6,"6021",898,628,617,16,11,"Cs",24
42,"42105",47,40,40,2,0,"Cs",3
3,"3050",19420,13210,13116,70,94,"Cs",1215
47,"47164",349,283,281,1,2,"Cs",12
47,"47007",4051,2987,2954,27,33,"Cs",290
46,"46063",1786,1270,1255,8,15,"Cs",67
6,"6158",13367,9319,9131,90,188,"Cs",864
47,"47008",22,13,13,0,0,"Cs",1
44,"44067",106,75,71,0,4,"Cs",2
18,"18138",2470,1597,1573,25,24,"Cs",69
16,"16192",42,28,28,0,0,"Cs",0
6,"6022",2635,1920,1862,15,58,"Cs",135
33,"33041",7101,4564,4513,58,51,"Cs",240
16,"16072",132,84,84,1,0,"Cs",5
16,"16073",190,153,153,1,0,"Cs",5
49,"49216",147,115,109,0,6,"Cs",6
3,"3138",3190,2244,2207,9,37,"Cs",149
45,"45088",2366,1526,1501,8,25,"Cs",109
44,"44068",634,497,493,2,4,"Cs",26
37,"37258",134,92,92,1,0,"Cs",12
40,"40070",143,94,92,1,2,"Cs",6
5,"5095",236,181,177,1,4,"Cs",11
19,"19125",45,23,23,0,0,"Cs",2
47,"47070",29,24,24,0,0,"Cs",0
33,"33042",4237,2862,2816,49,46,"Cs",224
48,"48912",2321,1684,1670,8,14,"Cs",15
28,"28168",1347,933,918,6,15,"Cs",48
3,"3052",959,747,735,4,12,"Cs",37
44,"44012",303,215,215,2,0,"Cs",12
46,"46178",5001,3513,3477,26,36,"Cs",306
9,"9088",63,31,30,0,1,"Cs",1
45,"45089",1432,1076,1064,10,12,"Cs",48
49,"49220",146,102,98,3,4,"Cs",4
5,"5191",121,99,99,0,0,"Cs",7
27,"27902",7122,4472,4385,43,87,"Cs",172
4,"4005",534,422,419,3,3,"Cs",17
45,"45090",370,262,261,2,1,"Cs",16
46,"46251",2465,1938,1903,19,35,"Cs",102
6,"6025",5083,3543,3469,28,74,"Cs",220
47,"47167",245,198,198,1,0,"Cs",18
5,"5192",92,75,72,1,3,"Cs",3
6,"6162",2885,2067,2032,19,35,"Cs",188
10,"10190",513,334,325,10,9,"Cs",11
1,"1001",2020,1385,1372,5,13,"Cs",22
47,"47071",396,321,316,5,5,"Cs",36
50,"50262",1161,849,832,11,17,"Cs",49
26,"26152",27,20,20,1,0,"Cs",3
4,"4099",4930,3526,3462,22,64,"Cs",287
44,"44250",20,15,15,0,0,"Cs",0
12,"12099",597,444,436,6,8,"Cs",18
19,"19224",106,83,83,1,0,"Cs",1
12,"12124",1842,1343,1328,13,15,"Cs",81
37,"37067",3278,2568,2529,30,39,"Cs",277
22,"22206",179,138,137,0,1,"Cs",10
23,"23044",4697,3495,3400,31,95,"Cs",200
45,"45092",223,193,190,1,3,"Cs",7
5,"5097",464,309,305,0,4,"Cs",17
26,"26038",76,52,52,0,0,"Cs",3
49,"49223",701,498,494,7,4,"Cs",11
48,"48028",682,551,548,3,3,"Cs",0
16,"16004",228,175,174,0,1,"Cs",1
15,"15069",6604,4587,4520,55,67,"Cs",146
46,"46135",9817,7596,7558,58,38,"Cs",704
47,"47139",997,728,719,4,9,"Cs",62
6,"6903",2011,1443,1416,18,27,"Cs",107
47,"47170",43,36,30,0,6,"Cs",6
28,"28003",167,133,131,4,2,"Cs",7
44,"44252",73,56,55,0,1,"Cs",2
40,"40074",246,193,189,2,4,"Cs",19
50,"50114",132,108,108,0,0,"Cs",16
49,"49111",119,84,84,3,0,"Cs",4
47,"47043",306,241,240,4,1,"Cs",10
19,"19256",46,36,36,0,0,"Cs",5
4,"4032",5716,3727,3696,43,31,"Cs",292
9,"9095",103,54,53,3,1,"Cs",3
24,"24049",1417,983,975,14,8,"Cs",45
7,"7001",3647,2430,2383,26,47,"Cs",130
16,"16198",1281,938,928,6,10,"Cs",55
22,"22001",212,147,146,0,1,"Cs",11
2,"2053",2888,2086,2042,14,44,"Cs",156
9,"9098",470,318,309,3,9,"Cs",31
46,"46254",944,673,661,6,12,"Cs",30
12,"12102",518,424,417,4,7,"Cs",16
42,"42116",37,30,29,2,1,"Cs",1
18,"18046",1738,1042,1023,7,19,"Cs",64
15,"15070",8778,5802,5656,131,146,"Cs",130
15,"15071",7780,4937,4848,34,89,"Cs",235
44,"44256",36,30,30,2,0,"Cs",8
13,"13057",1099,858,849,2,9,"Cs",32
30,"30037",19407,13252,13120,99,132,"Cs",1048
22,"22096",332,248,241,10,7,"Cs",24
24,"24050",105,77,77,2,0,"Cs",2
34,"34234",66,48,45,0,3,"Cs",2
1,"1008",808,546,536,6,10,"Cs",3
24,"24194",267,178,177,1,1,"Cs",4
50,"50089",8616,6420,6364,50,56,"Cs",756
26,"26005",2483,1589,1570,13,19,"Cs",98
52,"52001",54293,31015,30776,185,239,"Cs",907
27,"27012",1264,658,650,6,8,"Cs",8
18,"18047",6103,3992,3922,61,70,"Cs",320
50,"50266",120,77,76,3,1,"Cs",2
19,"19325",154,86,86,1,0,"Cs",4
19,"19229",58,53,53,0,0,"Cs",4
47,"47077",234,172,170,1,2,"Cs",7
41,"41100",954,670,635,7,35,"Cs",32
4,"4001",1002,717,710,3,7,"Cs",47
24,"24160",633,404,403,2,1,"Cs",18
28,"28175",940,740,730,2,10,"Cs",67
19,"19065",109,86,85,1,1,"Cs",6
39,"39002",3408,2360,2323,7,37,"Cs",86
2,"2056",1640,1204,1179,11,25,"Cs",46
6,"6034",171,114,114,2,0,"Cs",7
14,"14059",679,527,521,11,6,"Cs",26
19,"19134",23,14,14,0,0,"Cs",2
24,"24052",139,94,93,0,1,"Cs",4
45,"45171",1329,958,940,4,18,"Cs",57
38,"38032",13579,8941,8880,92,61,"Cs",522
22,"22176",171,140,138,2,2,"Cs",6
42,"42073",73,56,55,0,1,"Cs",3
50,"50169",333,231,230,0,1,"Cs",14
40,"40144",16,15,15,0,0,"Cs",1
15,"15042",2928,1879,1853,11,26,"Cs",67
30,"30039",20442,13299,13167,84,132,"Cs",904
18,"18148",787,618,605,5,13,"Cs",25
14,"14060",3715,2714,2641,41,73,"Cs",232
37,"37073",613,448,440,4,8,"Cs",33
26,"26045",11,10,10,1,0,"Cs",0
3,"3003",449,368,367,1,1,"Cs",20
20,"20901",1399,960,957,3,3,"Cs",6
9,"9325",177,103,101,2,2,"Cs",6
26,"26162",108,90,89,1,1,"Cs",12
41,"41102",14773,10377,10028,174,349,"Cs",825
39,"39088",59,40,40,2,0,"Cs",0
36,"36041",13691,9022,8916,85,106,"Cs",508
37,"37174",975,716,705,2,11,"Cs",41
5,"5200",41,26,26,0,0,"Cs",0
32,"32048",846,460,458,1,2,"Cs",4
28,"28009",14593,11026,10913,73,113,"Cs",1065
40,"40079",229,160,159,2,1,"Cs",5
7,"7007",416,277,275,4,2,"Cs",15
4,"4004",405,282,272,2,10,"Cs",41
50,"50219",4283,3034,2990,30,44,"Cs",350
34,"34139",160,117,115,2,2,"Cs",8
44,"44143",388,298,298,2,0,"Cs",6
9,"9056",4833,3191,3156,37,35,"Cs",301
21,"21025",3886,2489,2431,31,58,"Cs",140
45,"45027",315,249,246,2,3,"Cs",5
20,"20903",5033,3355,3341,18,14,"Cs",22
18,"18150",6964,4717,4622,51,95,"Cs",350
22,"22007",751,527,520,1,7,"Cs",43
48,"48035",406,314,314,0,0,"Cs",2
1,"1014",366,271,266,2,5,"Cs",3
19,"19330",69,62,62,0,0,"Cs",2
9,"9434",1279,966,956,11,10,"Cs",129
47,"47020",270,212,207,5,5,"Cs",10
10,"10013",265,184,182,0,2,"Cs",10
16,"16091",63,43,42,1,1,"Cs",1
16,"16209",110,95,94,2,1,"Cs",2
41,"41902",4599,2906,2868,50,38,"Cs",166
12,"12027",17506,11776,11649,84,127,"Cs",735
50,"50043",241,155,154,1,1,"Cs",6
37,"37302",262,161,161,2,0,"Cs",16
15,"15046",6157,3965,3865,23,100,"Cs",117
27,"27048",1992,1317,1285,21,32,"Cs",34
24,"24092",731,506,504,1,2,"Cs",22
26,"26166",144,125,124,0,1,"Cs",11
5,"5002",1905,1361,1329,11,32,"Cs",81
29,"29022",177,137,136,1,1,"Cs",8
9,"9437",266,207,203,4,4,"Cs",11
50,"50069",66,33,33,1,0,"Cs",3
46,"46210",338,256,251,0,5,"Cs",7
22,"22218",39,34,34,0,0,"Cs",4
12,"12108",443,354,352,4,2,"Cs",21
47,"47084",1077,794,784,11,10,"Cs",43
4,"4007",735,514,509,3,5,"Cs",39
5,"5005",165,127,119,0,8,"Cs",13
19,"19039",56,48,48,2,0,"Cs",0
29,"29097",4160,2872,2800,56,72,"Cs",204
7,"7044",8812,5679,5569,67,110,"Cs",280
5,"5109",445,334,329,4,5,"Cs",21
19,"19234",44,30,30,0,0,"Cs",1
5,"5108",39,21,21,0,0,"Cs",1
50,"50122",68,43,42,1,1,"Cs",3
10,"10003",543,350,335,0,15,"Cs",4
4,"4008",466,374,371,3,3,"Cs",20
40,"40182",169,112,112,1,0,"Cs",5
41,"41033",4958,3299,3250,38,49,"Cs",288
10,"10085",310,219,219,1,0,"Cs",12
45,"45105",376,277,268,5,9,"Cs",14
9,"9274",1035,774,762,8,12,"Cs",54
19,"19332",85,59,57,4,2,"Cs",4
45,"45069",1820,1370,1355,1,15,"Cs",65
49,"49122",761,517,505,7,12,"Cs",57
19,"19299",100,72,71,1,1,"Cs",7
38,"38013",3011,1850,1829,14,21,"Cs",56
40,"40084",52,41,41,2,0,"Cs",2
24,"24059",804,466,463,5,3,"Cs",22
12,"12109",646,489,482,4,7,"Cs",34
50,"50199",318,206,201,1,5,"Cs",10
48,"48010",476,343,343,1,0,"Cs",2
37,"37148",399,295,291,0,4,"Cs",31
5,"5110",696,469,464,2,5,"Cs",37
49,"49193",428,261,253,3,8,"Cs",34
13,"13072",727,518,510,3,8,"Cs",20
18,"18027",2598,1730,1706,12,24,"Cs",100
28,"28152",16986,13444,13366,111,78,"Cs",1491
49,"49159",269,182,182,2,0,"Cs",6
44,"44026",100,73,72,0,1,"Cs",3
19,"19208",39,32,32,0,0,"Cs",1
48,"48039",254,221,220,2,1,"Cs",3
42,"42003",65,49,47,0,2,"Cs",3
39,"39010",610,457,453,1,4,"Cs",2
34,"34903",179,129,129,1,0,"Cs",4
16,"16216",272,207,204,0,3,"Cs",6
22,"22012",102,75,75,2,0,"Cs",4
1,"1021",471,321,319,3,2,"Cs",6
15,"15050",1732,931,917,15,14,"Cs",26
23,"23096",2543,2029,1986,16,43,"Cs",109
19,"19146",47,35,35,0,0,"Cs",1
41,"41064",5602,3520,3417,56,103,"Cs",267
34,"34012",342,237,232,3,5,"Cs",12
46,"46145",22215,15688,15538,127,150,"Cs",1164
10,"10007",627,457,447,3,10,"Cs",22
28,"28901",890,624,618,5,6,"Cs",44
19,"19043",99,80,79,0,1,"Cs",5
14,"14067",3842,2863,2800,42,63,"Cs",186
5,"5210",81,56,56,0,0,"Cs",3
14,"14012",6046,4215,4120,56,95,"Cs",209
37,"37016",563,419,411,4,8,"Cs",41
34,"34208",48,40,40,1,0,"Cs",2
46,"46214",16637,12113,12014,84,99,"Cs",1068
22,"22188",75,50,50,1,0,"Cs",2
22,"22150",459,325,321,8,4,"Cs",15
13,"13076",455,359,356,0,3,"Cs",11
49,"49162",170,117,116,1,1,"Cs",0
6,"6050",4031,3005,2934,38,71,"Cs",186
21,"21003",684,476,452,4,24,"Cs",13
24,"24099",153,111,110,1,1,"Cs",0
10,"10212",1658,1113,1068,19,45,"Cs",50
40,"40186",35,29,29,0,0,"Cs",3
16,"16173",175,128,127,0,1,"Cs",3
26,"26134",81,67,67,3,0,"Cs",2
21,"21034",1155,768,748,5,20,"Cs",74
10,"10131",12803,8477,8347,77,130,"Cs",606
36,"36050",7645,5137,5049,48,88,"Cs",190
18,"18062",11226,7969,7777,88,192,"Cs",680
15,"15084",3039,2002,1981,12,21,"Cs",59
50,"50126",2240,1528,1509,24,19,"Cs",112
21,"21004",1586,994,964,23,30,"Cs",26
23,"23062",1410,1094,1076,0,18,"Cs",27
6,"6097",2258,1631,1602,10,29,"Cs",94
37,"37183",377,267,267,5,0,"Cs",15
35,"35002",24229,15311,15133,101,178,"Cs",877
29,"29903",485,326,324,2,2,"Cs",29
13,"13078",8946,6166,6103,49,63,"Cs",258
49,"49128",520,384,378,7,6,"Cs",24
22,"22016",558,384,382,5,2,"Cs",26
29,"29001",4207,3002,2959,40,43,"Cs",127
14,"14070",1280,911,902,4,9,"Cs",55
13,"13079",12233,8274,8138,93,136,"Cs",591
48,"48044",61957,45253,45063,299,190,"Cs",634
36,"36051",14358,9408,9255,86,153,"Cs",463
37,"37279",713,488,480,4,8,"Cs",36
46,"46011",7523,5154,5077,34,77,"Cs",332
11,"11024",6550,4500,4402,67,98,"Cs",389
20,"20002",359,234,231,7,3,"Cs",0
45,"45002",2619,1676,1663,14,13,"Cs",101
2,"2070",373,306,301,6,5,"Cs",13
22,"22227",200,140,140,2,0,"Cs",11
12,"12090",102,79,78,1,1,"Cs",2
6,"6054",5452,3773,3657,34,116,"Cs",250
1,"1030",141,102,102,0,0,"Cs",0
24,"24030",4158,2746,2696,18,50,"Cs",134
36,"36022",9046,5834,5720,37,114,"Cs",213
10,"10216",1518,1082,1056,11,26,"Cs",57
12,"12064",80,71,69,0,2,"Cs",0
10,"10108",203,116,116,1,0,"Cs",5
46,"46012",965,689,675,4,14,"Cs",47
6,"6010",1063,760,732,2,28,"Cs",36
5,"5052",85,70,69,0,1,"Cs",2
9,"9405",122,94,91,0,3,"Cs",2
16,"16063",112,81,81,1,0,"Cs",3
19,"19011",237,165,162,3,3,"Cs",16
3,"3015",12818,9127,9017,46,110,"Cs",651
39,"39015",828,559,556,3,3,"Cs",19
14,"14044",1613,1186,1164,10,22,"Cs",84
5,"5119",24,17,17,1,0,"Cs",2
47,"47220",151,106,105,1,1,"Cs",9
22,"22228",532,371,364,4,7,"Cs",39
38,"38019",13884,7888,7809,49,79,"Cs",319
37,"37375",678,539,523,8,16,"Cs",27
23,"23066",4274,3517,3460,16,57,"Cs",212
9,"9451",237,196,189,1,7,"Cs",8
16,"16103",235,183,181,2,2,"Cs",4
12,"12091",171,110,108,4,2,"Cs",8
32,"32063",1795,1135,1119,16,16,"Cs",29
37,"37188",158,107,105,3,2,"Cs",8
19,"19244",74,55,55,3,0,"Cs",1
47,"47032",147,102,102,0,0,"Cs",4
19,"19118",11,10,9,0,1,"Cs",1
10,"10138",527,386,379,2,7,"Cs",18
6,"6058",1984,1372,1331,13,41,"Cs",168
12,"12116",61,49,49,0,0,"Cs",4
15,"15089",4299,2924,2887,41,37,"Cs",89
45,"45117",718,552,548,0,4,"Cs",34
34,"34113",40,38,38,0,0,"Cs",3
9,"9295",52,36,35,1,1,"Cs",1
32,"32065",633,422,419,8,3,"Cs",15
50,"50157",289,199,196,1,3,"Cs",4
10,"10098",387,272,267,0,5,"Cs",13
44,"44007",149,112,111,1,1,"Cs",5
5,"5217",54,42,41,0,1,"Cs",3
37,"37092",1933,1342,1327,13,15,"Cs",169
19,"19155",64,49,49,0,0,"Cs",4
37,"37377",215,174,173,0,1,"Cs",21
28,"28054",11943,8800,8731,72,69,"Cs",763
16,"16186",403,309,305,3,4,"Cs",3
32,"32066",547,396,396,0,0,"Cs",3
13,"13040",839,639,623,7,16,"Cs",29
40,"40095",453,341,329,2,12,"Cs",21
45,"45118",2124,1403,1380,8,23,"Cs",81
39,"39074",7050,5074,5029,26,45,"Cs",201
32,"32030",945,642,641,8,1,"Cs",15
14,"14075",552,413,391,5,22,"Cs",18
36,"36056",4932,3368,3310,24,58,"Cs",133
36,"36057",238417,165843,164264,1641,1579,"Cs",7772
9,"9458",490,388,385,6,3,"Cs",43
6,"6061",1074,829,819,5,10,"Cs",18
20,"20038",387,294,293,2,1,"Cs",0
10,"10101",178,129,125,0,4,"Cs",14
32,"32068",1401,882,878,4,4,"Cs",18
5,"5056",91,71,70,0,1,"Cs",8
19,"19051",61,52,52,0,0,"Cs",2
46,"46243",124,93,90,1,3,"Cs",2
5,"5023",174,148,145,2,3,"Cs",2
24,"24181",1404,944,925,7,19,"Cs",37
37,"37191",102,57,57,1,0,"Cs",1
50,"50208",1761,1267,1250,16,17,"Cs",90
19,"19089",23,17,17,0,0,"Cs",0
18,"18068",1638,1197,1167,12,30,"Cs",86
36,"36058",4957,3043,2994,55,49,"Cs",123
44,"44101",55,41,40,1,1,"Cs",6
24,"24109",857,534,528,8,6,"Cs",53
29,"29082",34683,24751,24495,263,256,"Cs",2673
45,"45194",64,45,44,1,1,"Cs",2
46,"46130",862,633,625,6,8,"Cs",34
37,"37059",117,95,95,3,0,"Cs",5
10,"10103",422,290,286,1,4,"Cs",9
26,"26067",22,18,18,3,0,"Cs",2
28,"28026",6767,5058,5024,27,34,"Cs",452
2,"2045",3609,2797,2752,38,45,"Cs",164
42,"42019",519,345,341,3,4,"Cs",13
40,"40196",30,24,24,0,0,"Cs",0
46,"46153",443,353,349,2,4,"Cs",17
42,"42153",12,10,10,0,0,"Cs",0
45,"45195",2064,1519,1481,9,38,"Cs",79
41,"41074",2994,2154,2105,19,49,"Cs",77
41,"41091",539590,389351,384943,4676,4408,"Cs",31677
10,"10022",409,301,291,1,10,"Cs",8
37,"37162",212,139,137,3,2,"Cs",8
44,"44169",298,216,216,0,0,"Cs",2
7,"7027",22101,13161,13028,140,133,"Cs",862
47,"47099",154,123,118,0,5,"Cs",8
5,"5025",78,65,65,0,0,"Cs",4
50,"50135",85,59,59,0,0,"Cs",5
28,"28101",226,174,172,1,2,"Cs",14
37,"37099",63,46,46,1,0,"Cs",1
20,"20071",15062,10442,10407,47,35,"Cs",51
9,"9084",165,116,111,1,5,"Cs",3
27,"27066",12588,8116,7954,109,162,"Cs",291
7,"7028",944,635,628,2,7,"Cs",29
24,"24185",447,303,295,1,8,"Cs",27
27,"27004",1143,640,625,2,15,"Cs",15
47,"47195",426,314,310,2,4,"Cs",22
36,"36061",8613,5822,5718,56,104,"Cs",232
24,"24078",324,228,225,0,3,"Cs",15
33,"33069",3379,2249,2231,41,18,"Cs",94
20,"20012",149,104,104,1,0,"Cs",1
40,"40005",25,23,23,1,0,"Cs",1
42,"42156",29,21,21,0,0,"Cs",1
45,"45014",4039,2606,2552,35,54,"Cs",121
32,"32073",1273,863,857,6,6,"Cs",13
10,"10065",199,135,135,0,0,"Cs",7
19,"19191",13,12,12,0,0,"Cs",0
7,"7029",4393,2888,2855,37,33,"Cs",214
48,"48081",1903,1455,1447,7,8,"Cs",7
22,"22236",232,190,188,2,2,"Cs",12
27,"27006",2441,1479,1460,11,19,"Cs",35
9,"9140",117,78,77,1,1,"Cs",4
49,"49141",290,191,191,1,0,"Cs",10
41,"41077",8631,5788,5598,51,190,"Cs",352
41,"41021",21410,14369,14139,195,230,"Cs",987
18,"18173",8999,5958,5871,50,87,"Cs",416
48,"48913",1236,899,890,8,9,"Cs",5
6,"6161",289,199,197,1,2,"Cs",11
23,"23076",774,606,595,6,11,"Cs",13
10,"10162",519,401,394,4,7,"Cs",8
32,"32086",2531,1348,1332,11,16,"Cs",21
7,"7064",5566,3232,3204,18,28,"Cs",224
19,"19057",69,51,51,0,0,"Cs",3
46,"46156",2017,1538,1524,9,14,"Cs",73
38,"38002",971,577,570,8,7,"Cs",10
5,"5128",339,258,253,5,5,"Cs",9
18,"18174",435,324,320,3,4,"Cs",10
50,"50213",92,70,70,2,0,"Cs",2
27,"27007",2723,1822,1776,23,46,"Cs",40
1,"1046",639,433,432,2,1,"Cs",6
28,"28106",78872,54111,53443,412,668,"Cs",4264
9,"9476",60,46,46,0,0,"Cs",4
16,"16003",134,108,105,0,3,"Cs",6
22,"22242",60,41,40,0,1,"Cs",0
19,"19254",43,34,34,0,0,"Cs",1
2,"2084",298,197,191,2,6,"Cs",15
40,"40202",56,33,33,0,0,"Cs",3
16,"16154",4739,3416,3379,33,37,"Cs",147
9,"9311",59,45,45,0,0,"Cs",4
3,"3081",1492,1070,1044,12,26,"Cs",54
16,"16246",451,327,322,1,5,"Cs",5
11,"11006",24558,15334,15113,231,221,"Cs",1420
26,"26074",107,87,86,2,1,"Cs",4
40,"40106",179,140,139,2,1,"Cs",11
29,"29014",218,122,121,3,1,"Cs",10
5,"5033",169,135,134,0,1,"Cs",5
2,"2018",789,611,606,3,5,"Cs",33
21,"21049",3262,2028,1977,15,51,"Cs",82
47,"47232",96,67,65,0,2,"Cs",8
32,"32040",1400,1001,990,10,11,"Cs",24
10,"10030",455,311,305,2,6,"Cs",13
1,"1049",130,94,94,1,0,"Cs",1
50,"50062",1885,1332,1308,15,24,"Cs",126
33,"33073",8096,4377,4320,59,57,"Cs",193
18,"18077",471,350,343,1,7,"Cs",9
6,"6075",470,363,360,7,3,"Cs",12
46,"46158",1047,771,763,7,8,"Cs",24
26,"26076",115,83,83,0,0,"Cs",9
48,"48001",5899,4094,4074,19,20,"Cs",58
19,"19195",36,26,25,2,1,"Cs",0
13,"13903",498,395,394,0,1,"Cs",7
29,"29015",32093,22044,21716,253,328,"Cs",1736
1,"1052",272,189,186,2,3,"Cs",0
44,"44109",99,64,64,0,0,"Cs",3
16,"16248",862,710,700,6,10,"Cs",28
12,"12048",243,159,155,4,4,"Cs",4
16,"16157",183,150,148,0,2,"Cs",3
6,"6076",825,573,562,1,11,"Cs",33
18,"18177",375,235,231,5,4,"Cs",7
28,"28034",368,258,255,0,3,"Cs",10
18,"18111",2863,2038,2001,29,37,"Cs",146
46,"46159",23038,16719,16596,127,123,"Cs",1258
33,"33074",3366,2042,2011,35,31,"Cs",62
27,"27011",2341,1387,1362,7,25,"Cs",39
46,"46023",322,254,252,1,2,"Cs",10
50,"50216",236,169,167,0,2,"Cs",11
12,"12126",24374,17741,17553,111,188,"Cs",1122
7,"7036",28132,18650,18510,222,140,"Cs",1822
46,"46160",1922,1395,1381,4,14,"Cs",60
19,"19258",84,63,62,0,1,"Cs",5
50,"50168",29,20,20,0,0,"Cs",1
49,"49148",259,119,115,1,4,"Cs",2
22,"22035",225,153,152,1,1,"Cs",6
46,"46091",110,100,100,0,0,"Cs",6
32,"32019",11469,7336,7225,98,111,"Cs",294
5,"5036",118,91,90,0,1,"Cs",7
22,"22246",63,43,43,0,0,"Cs",4
3,"3085",271,229,227,5,2,"Cs",14
9,"9318",56,33,33,0,0,"Cs",0
18,"18914",1660,1255,1227,11,28,"Cs",75
37,"37235",214,163,159,2,4,"Cs",20
22,"22135",173,123,121,0,2,"Cs",11
9,"9377",626,468,460,6,8,"Cs",53
12,"12050",1226,904,891,3,13,"Cs",28
49,"49114",40,31,27,0,4,"Cs",0
9,"9001",32,25,25,0,0,"Cs",1
29,"29018",2009,1421,1362,17,59,"Cs",104
3,"3002",3649,2568,2542,11,26,"Cs",217
50,"50142",23,16,16,1,0,"Cs",0
4,"4036",239,178,176,0,2,"Cs",15
50,"50065",56,37,37,0,0,"Cs",2
34,"34089",141,102,101,4,1,"Cs",2
16,"16086",872,699,690,7,9,"Cs",25
27,"27023",2453,1674,1644,25,30,"Cs",30
46,"46256",7280,4996,4940,32,56,"Cs",394
34,"34046",43,29,29,0,0,"Cs",0
46,"46207",6761,4966,4909,46,57,"Cs",330
50,"50025",4541,3110,3083,39,27,"Cs",281
50,"50292",130,108,107,0,1,"Cs",11
9,"9904",464,344,339,3,5,"Cs",26
6,"6081",1036,760,745,2,15,"Cs",44
10,"10118",278,232,231,1,1,"Cs",5
37,"37299",230,148,147,0,1,"Cs",6
45,"45099",3700,2524,2501,9,23,"Cs",149
18,"18180",636,410,401,2,9,"Cs",39
48,"48005",116,80,79,0,1,"Cs",1
24,"24089",101036,71905,71305,744,600,"Cs",5010
22,"22248",103,73,73,0,0,"Cs",9
12,"12129",1783,1207,1184,16,23,"Cs",77
3,"3004",603,425,423,2,2,"Cs",30
29,"29020",3278,2329,2260,22,69,"Cs",144
26,"26082",101,79,79,0,0,"Cs",5
5,"5170",47,34,34,1,0,"Cs",2
44,"44228",96,75,74,0,1,"Cs",0
37,"37112",158,110,109,2,1,"Cs",4
47,"47019",92,68,68,1,0,"Cs",6
46,"46026",1220,974,965,7,9,"Cs",52
45,"45064",3987,2918,2880,33,38,"Cs",193
10,"10039",400,256,217,0,39,"Cs",10
7,"7040",289448,169300,167908,1594,1392,"Cs",13728
5,"5138",283,218,217,1,1,"Cs",11
28,"28147",991,702,698,4,4,"Cs",42
34,"34190",50,33,33,1,0,"Cs",2
14,"14005",6298,3905,3828,71,77,"Cs",236
19,"19070",65,45,45,0,0,"Cs",1
3,"3090",18095,12539,12412,75,127,"Cs",1136
42,"42035",730,464,460,3,4,"Cs",27
26,"26084",7264,5130,5059,61,71,"Cs",450
50,"50220",45,38,38,0,0,"Cs",0
44,"44023",18,15,14,0,1,"Cs",1
16,"16177",83,65,65,1,0,"Cs",1
39,"39071",410,251,250,1,1,"Cs",5
19,"19263",21,15,15,0,0,"Cs",0
42,"42172",28,26,26,0,0,"Cs",1
12,"12131",97,87,87,0,0,"Cs",0
50,"50147",744,508,506,5,2,"Cs",32
46,"46050",185,141,141,1,0,"Cs",8
26,"26012",37,28,28,1,0,"Cs",4
44,"44262",141,104,103,0,1,"Cs",4
9,"9010",33,25,25,2,0,"Cs",2
18,"18002",529,387,384,1,3,"Cs",12
10,"10163",348,239,238,2,1,"Cs",15
45,"45029",186,154,154,2,0,"Cs",5
3,"3034",1404,1028,1010,5,18,"Cs",71
40,"40017",83,71,68,2,3,"Cs",5
30,"30018",8399,6226,6148,28,78,"Cs",335
46,"46233",3766,2688,2650,14,38,"Cs",154
10,"10123",575,450,438,1,12,"Cs",16
16,"16129",88,72,72,0,0,"Cs",3
21,"21028",370,265,259,2,6,"Cs",42
46,"46165",7349,5460,5412,39,48,"Cs",409
47,"47211",48,37,37,1,0,"Cs",2
37,"37012",144,111,111,0,0,"Cs",9
47,"47148",419,332,324,3,8,"Cs",27
9,"9387",107,89,88,0,1,"Cs",12
37,"37303",179,118,117,1,1,"Cs",17
50,"50094",1500,1041,1022,12,19,"Cs",78
5,"5043",73,58,58,0,0,"Cs",2
40,"40052",72,55,55,0,0,"Cs",5
34,"34053",194,156,154,3,2,"Cs",8
21,"21029",1514,1036,1003,14,33,"Cs",76
29,"29098",1228,902,876,11,26,"Cs",57
3,"3093",19702,13903,13728,113,175,"Cs",1091
44,"44204",27,18,18,0,0,"Cs",1
46,"46029",20448,14673,14556,99,117,"Cs",1034
34,"34147",164,120,120,1,0,"Cs",7
44,"44205",619,420,415,5,5,"Cs",24
2,"2063",1358,987,973,3,14,"Cs",65
44,"44232",364,255,255,3,0,"Cs",7
36,"36046",4073,2887,2818,31,69,"Cs",158
12,"12084",17785,12557,12422,108,135,"Cs",885
22,"22143",190,118,115,1,3,"Cs",8
50,"50071",126,84,84,0,0,"Cs",6
16,"16264",385,311,305,1,6,"Cs",4
45,"45031",2861,1894,1858,13,36,"Cs",112
6,"6045",467,347,346,6,1,"Cs",14
22,"22043",93,53,53,0,0,"Cs",1
36,"36016",1069,639,633,5,6,"Cs",11
14,"14047",1644,1198,1183,14,15,"Cs",108
10,"10127",4691,3044,2974,34,70,"Cs",237
23,"23021",512,406,399,2,7,"Cs",15
13,"13071",37945,24340,24091,227,249,"Cs",1924
10,"10045",971,686,682,4,4,"Cs",27
13,"13027",3185,2112,2055,12,57,"Cs",118
16,"16265",22,18,18,0,0,"Cs",1
6,"6137",934,696,693,3,3,"Cs",24
5,"5176",221,163,159,0,4,"Cs",12
22,"22075",116,71,69,1,2,"Cs",2
42,"42042",53,42,41,1,1,"Cs",4
28,"28121",209,156,152,1,4,"Cs",11
47,"47119",89,59,58,2,1,"Cs",5
37,"37015",198,127,125,2,2,"Cs",2
44,"44089",49,41,41,0,0,"Cs",2
26,"26131",34,33,33,0,0,"Cs",0
29,"29100",2379,1582,1551,22,31,"Cs",90
27,"27032",3197,1979,1956,30,23,"Cs",67
49,"49125",1392,883,871,11,12,"Cs",70
33,"33001",1475,758,753,15,5,"Cs",19
24,"24171",337,136,134,4,2,"Cs",0
19,"19239",93,70,70,1,0,"Cs",3
29,"29026",1021,703,698,15,5,"Cs",25
4,"4049",5711,3766,3732,25,34,"Cs",243
15,"15020",3568,2226,2217,19,9,"Cs",70
46,"46263",235,182,180,2,2,"Cs",4
4,"4012",184,151,150,3,1,"Cs",11
22,"22014",227,164,162,5,2,"Cs",6
47,"47122",2007,1520,1492,8,28,"Cs",113
37,"37182",75,47,47,1,0,"Cs",3
18,"18124",355,232,231,1,1,"Cs",5
21,"21033",569,410,405,3,5,"Cs",20
19,"19210",18,16,16,0,0,"Cs",0
36,"36049",6990,4877,4787,40,90,"Cs",227
6,"6096",206,158,153,0,5,"Cs",6
44,"44002",47,41,41,0,0,"Cs",1
6,"6126",2121,1443,1429,14,14,"Cs",75
49,"49053",919,676,661,8,15,"Cs",29
49,"49126",260,153,150,1,3,"Cs",6
10,"10008",1274,921,908,1,13,"Cs",48
5,"5059",92,49,48,0,1,"Cs",2
6,"6142",257,203,194,1,9,"Cs",15
50,"50152",1351,942,932,14,10,"Cs",40
13,"13031",2475,1855,1834,9,21,"Cs",108
40,"40024",823,582,575,8,7,"Cs",53
14,"14013",16619,11968,11719,153,249,"Cs",757
34,"34017",889,676,665,7,11,"Cs",37
47,"47028",30,17,17,0,0,"Cs",1
41,"41038",102752,71545,70538,980,1007,"Cs",6253
44,"44209",799,584,573,2,11,"Cs",15
3,"3098",523,382,378,1,4,"Cs",26
13,"13032",1076,772,765,0,7,"Cs",26
49,"49201",283,232,228,3,4,"Cs",17
16,"16060",715,519,513,3,6,"Cs",22
46,"46033",196,155,153,0,2,"Cs",6
19,"19271",41,22,21,1,1,"Cs",1
42,"42048",60,52,52,0,0,"Cs",4
48,"48071",6013,4240,4205,23,35,"Cs",22
5,"5051",157,117,115,1,2,"Cs",4
16,"16139",317,226,222,1,4,"Cs",9
44,"44032",17,13,13,0,0,"Cs",2
46,"46102",19696,14700,14579,125,121,"Cs",1013
24,"24141",96,74,74,0,0,"Cs",0
32,"32024",4817,3064,3014,34,50,"Cs",116
50,"50076",70,56,56,0,0,"Cs",2
2,"2004",597,459,455,3,4,"Cs",23
50,"50002",125,91,86,0,5,"Cs",4
16,"16225",55,30,30,0,0,"Cs",1
26,"26023",433,316,314,3,2,"Cs",19
47,"47125",49,42,42,0,0,"Cs",2
42,"42141",101,59,59,0,0,"Cs",5
18,"18161",245,199,196,0,3,"Cs",15
34,"34214",176,121,120,1,1,"Cs",8
26,"26035",16,12,11,0,1,"Cs",0
39,"39005",1419,1039,1030,9,9,"Cs",64
9,"9024",150,100,99,1,1,"Cs",3
49,"49166",1193,835,821,7,14,"Cs",56
26,"26024",204,157,156,1,1,"Cs",2
18,"18162",919,664,652,3,12,"Cs",29
44,"44033",243,165,165,3,0,"Cs",2
24,"24215",149,116,115,0,1,"Cs",7
14,"14016",1273,936,922,5,14,"Cs",40
37,"37313",535,395,394,1,1,"Cs",26
10,"10027",77,62,62,0,0,"Cs",3
49,"49058",301,222,221,1,1,"Cs",12
35,"35004",41975,20773,20602,156,171,"Cs",906
7,"7054",23257,12613,12464,111,149,"Cs",851
46,"46058",1734,1245,1230,8,15,"Cs",61
6,"6148",957,682,665,1,17,"Cs",25
21,"21068",973,562,556,11,6,"Cs",26
15,"15025",986,529,517,6,12,"Cs",9
46,"46195",2000,1540,1532,3,8,"Cs",89
9,"9292",72,55,55,3,0,"Cs",3
34,"34216",61,41,41,0,0,"Cs",4
22,"22906",177,123,122,6,1,"Cs",9
6,"6103",4756,3285,3224,38,61,"Cs",262
15,"15057",12077,8109,8018,83,91,"Cs",352
3,"3016",88,66,66,0,0,"Cs",1
50,"50156",212,156,151,2,5,"Cs",5
33,"33007",1382,804,795,4,9,"Cs",30
30,"30002",9701,6794,6717,27,77,"Cs",280
4,"4056",165,120,120,0,0,"Cs",4
2,"2041",316,238,236,0,2,"Cs",2
37,"37158",230,149,149,1,0,"Cs",12
9,"9184",6,6,6,0,0,"Cs",2
30,"30003",25200,16249,16120,159,129,"Cs",1055
18,"18004",669,467,466,6,1,"Cs",16
44,"44213",68,47,47,0,0,"Cs",2
16,"16030",24,18,18,1,0,"Cs",0
16,"16145",413,333,326,6,7,"Cs",10
47,"47064",37,30,29,1,1,"Cs",3
5,"5121",263,194,189,1,5,"Cs",15
3,"3046",1636,1073,1061,7,12,"Cs",75
39,"39101",231,134,132,2,2,"Cs",3
19,"19120",107,86,86,1,0,"Cs",2
6,"6106",407,261,258,4,3,"Cs",22
28,"28024",168,137,136,2,1,"Cs",7
49,"49024",626,432,426,3,6,"Cs",22
46,"46136",2598,1875,1851,14,24,"Cs",115
38,"38045",3542,1825,1801,7,24,"Cs",47
40,"40031",546,410,406,3,4,"Cs",31
50,"50159",640,493,486,3,7,"Cs",29
46,"46174",942,746,736,1,10,"Cs",25
26,"26183",66,48,48,0,0,"Cs",5
40,"40225",1085,822,809,5,13,"Cs",55
29,"29035",1478,1054,1040,3,14,"Cs",26
19,"19218",43,31,31,0,0,"Cs",0
10,"10141",284,207,205,1,2,"Cs",9
47,"47004",1135,878,872,5,6,"Cs",47
11,"11030",22999,14858,14586,207,272,"Cs",1442
47,"47161",3970,3111,3089,24,22,"Cs",288
9,"9033",80,64,63,1,1,"Cs",4
5,"5057",2418,1785,1748,9,37,"Cs",110
9,"9079",47,38,38,0,0,"Cs",0
10,"10142",833,555,539,0,16,"Cs",34
19,"19257",3279,2233,2206,21,27,"Cs",117
3,"3020",94,84,84,1,0,"Cs",6
20,"20069",147446,102068,101696,564,372,"Cs",1469
21,"21073",1902,1073,1043,13,30,"Cs",61
49,"49248",171,128,128,1,0,"Cs",10
5,"5187",1714,1247,1221,9,26,"Cs",77
16,"16108",44,35,34,1,1,"Cs",1
48,"48022",2305,1434,1425,11,9,"Cs",11
48,"48078",37858,25959,25819,157,140,"Cs",256
27,"27033",591,334,328,0,6,"Cs",3
36,"36059",4641,2844,2796,29,48,"Cs",134
42,"42195",86,51,51,2,0,"Cs",0
14,"14021",260521,185270,183300,2192,1970,"Cs",16955
44,"44038",101,85,83,1,2,"Cs",3
30,"30006",833,699,695,1,4,"Cs",60
23,"23072",1879,1389,1363,3,26,"Cs",59
34,"34223",203,147,143,1,4,"Cs",5
46,"46176",2077,1362,1348,14,14,"Cs",97
39,"39030",1874,1199,1187,6,12,"Cs",46
32,"32058",5247,3547,3489,30,58,"Cs",161
38,"38031",29301,20926,20701,157,225,"Cs",966
37,"37351",268,229,226,0,3,"Cs",10
9,"9360",26,19,19,0,0,"Cs",1
12,"12112",102,79,79,1,0,"Cs",6
50,"50235",2421,1721,1702,18,19,"Cs",193
5,"5060",108,79,79,2,0,"Cs",3
22,"22164",42,28,28,0,0,"Cs",0
37,"37193",362,253,252,4,1,"Cs",13
24,"24077",212,166,162,0,4,"Cs",13
10,"10063",159,130,130,0,0,"Cs",5
42,"42155",146,83,80,2,3,"Cs",5
37,"37061",195,136,136,1,0,"Cs",13
34,"34033",18,14,14,0,0,"Cs",1
9,"9361",103,64,64,1,0,"Cs",0
24,"24005",342,218,217,0,1,"Cs",11
7,"7062",7972,3946,3896,42,50,"Cs",265
46,"46041",313,229,228,1,1,"Cs",14
5,"5257",132,98,95,4,3,"Cs",10
14,"14023",1999,1629,1593,11,36,"Cs",73
37,"37226",152,113,113,2,0,"Cs",10
11,"11034",2319,1520,1487,17,33,"Cs",124
47,"47228",432,324,320,2,4,"Cs",28
4,"4063",1058,766,750,6,16,"Cs",30
9,"9417",42,31,31,1,0,"Cs",0
46,"46064",532,395,387,3,8,"Cs",22
29,"29039",2759,1900,1860,23,40,"Cs",98
49,"49219",7196,4613,4528,64,85,"Cs",338
42,"42198",19,9,9,1,0,"Cs",0
49,"49068",422,263,261,4,2,"Cs",11
30,"30008",14560,9974,9840,79,134,"Cs",713
18,"18012",2114,1519,1492,9,27,"Cs",62
36,"36901",4154,3094,3029,21,65,"Cs",114
50,"50060",171,126,125,1,1,"Cs",8
50,"50084",67,47,47,1,0,"Cs",5
37,"37029",186,125,124,1,1,"Cs",9
19,"19223",99,66,65,1,1,"Cs",2
33,"33024",224741,151660,150461,1597,1199,"Cs",11141
2,"2071",1027,800,795,7,5,"Cs",21
18,"18117",497,360,354,1,6,"Cs",12
2,"2027",274,209,203,1,6,"Cs",13
18,"18909",514,403,403,0,0,"Cs",4
28,"28136",693,538,533,2,5,"Cs",31
14,"14025",2834,2352,2299,9,53,"Cs",90
3,"3111",5579,3777,3737,23,40,"Cs",239
9,"9199",91,68,68,0,0,"Cs",6
13,"13006",552,411,406,0,5,"Cs",12
46,"46141",433,340,337,6,3,"Cs",25
16,"16906",70,44,44,1,0,"Cs",0
50,"50085",182,121,121,0,0,"Cs",11
5,"5162",76,47,45,1,2,"Cs",1
19,"19193",22,21,21,1,0,"Cs",3
9,"9200",48,29,29,0,0,"Cs",1
42,"42063",45,31,30,1,1,"Cs",0
50,"50012",94,76,72,0,4,"Cs",6
50,"50061",190,157,155,2,2,"Cs",5
49,"49257",305,186,184,0,2,"Cs",14
37,"37031",329,241,238,3,3,"Cs",16
46,"46180",659,509,500,7,9,"Cs",21
26,"26001",199,145,141,3,4,"Cs",8
37,"37324",333,247,242,3,5,"Cs",18
50,"50086",176,106,102,1,4,"Cs",8
29,"29042",14586,9793,9649,95,144,"Cs",893
46,"46112",533,435,432,7,3,"Cs",14
47,"47074",141,110,109,0,1,"Cs",4
50,"50037",125,85,80,0,5,"Cs",1
10,"10192",777,567,563,3,4,"Cs",20
26,"26002",821,611,597,1,14,"Cs",27
37,"37068",337,240,236,1,4,"Cs",8
7,"7902",1091,663,645,13,18,"Cs",31
42,"42065",23,18,18,1,0,"Cs",0
23,"23008",1422,1042,1020,9,22,"Cs",38
20,"20046",1243,822,816,1,6,"Cs",4
37,"37325",88,63,63,0,0,"Cs",1
6,"6121",3276,2301,2256,30,45,"Cs",189
47,"47140",106,83,83,0,0,"Cs",3
44,"44195",82,58,57,0,1,"Cs",1
14,"14027",7890,5841,5726,78,115,"Cs",447
22,"22029",118,85,83,1,2,"Cs",2
10,"10153",281,183,181,0,2,"Cs",8
27,"27041",2216,1463,1445,19,18,"Cs",47
12,"12076",72,54,54,0,0,"Cs",3
37,"37034",77,63,62,0,1,"Cs",2
24,"24119",695,464,458,7,6,"Cs",26
10,"10181",676,470,462,2,8,"Cs",30
39,"39056",2262,1683,1671,14,12,"Cs",72
46,"46182",1312,908,904,5,4,"Cs",51
20,"20048",183,112,112,0,0,"Cs",0
37,"37358",159,124,124,0,0,"Cs",12
9,"9206",52,43,43,0,0,"Cs",4
5,"5229",75,61,61,1,0,"Cs",2
42,"42206",8,5,5,2,0,"Cs",0
6,"6122",6535,4204,4110,47,94,"Cs",417
49,"49078",138,113,109,4,4,"Cs",3
48,"48002",7791,5510,5471,42,39,"Cs",28
30,"30012",9085,6704,6599,46,105,"Cs",411
15,"15040",2647,1779,1762,15,17,"Cs",52
18,"18112",104,68,66,2,2,"Cs",5
36,"36037",2538,1650,1625,12,25,"Cs",70
18,"18016",297,200,198,3,2,"Cs",7
44,"44018",16,16,16,0,0,"Cs",0
29,"29054",42538,28080,27814,225,266,"Cs",2447
4,"4011",2744,2010,1984,20,26,"Cs",103
24,"24121",599,422,418,3,4,"Cs",14
46,"46183",6036,4276,4213,21,63,"Cs",289
2,"2022",341,243,243,2,0,"Cs",10
33,"33020",12981,8550,8453,120,97,"Cs",470
2,"2055",1055,672,668,2,4,"Cs",21
7,"7004",4069,2652,2624,27,28,"Cs",135
29,"29045",1679,1162,1144,5,18,"Cs",76
12,"12103",87,61,60,0,1,"Cs",3
18,"18114",585,425,424,7,1,"Cs",25
44,"44046",44,33,33,0,0,"Cs",0
18,"18048",2494,1708,1657,18,51,"Cs",143
49,"49080",622,440,437,4,3,"Cs",24
37,"37037",108,72,72,0,0,"Cs",13
45,"45061",2490,1690,1669,9,21,"Cs",79
44,"44141",122,88,85,0,3,"Cs",5
18,"18018",542,384,377,2,7,"Cs",18
28,"28089",3856,2866,2829,21,37,"Cs",250
13,"13015",5220,3665,3629,25,36,"Cs",223
5,"5081",37,21,21,3,0,"Cs",1
37,"37330",314,227,223,2,4,"Cs",9
48,"48070",527,357,355,0,2,"Cs",0
46,"46131",49805,35527,35231,298,296,"Cs",2431
7,"7050",3513,2036,2013,25,23,"Cs",126
10,"10158",344,247,246,7,1,"Cs",8
39,"39087",41241,29341,29084,152,257,"Cs",1136
49,"49081",1321,972,953,6,19,"Cs",65
41,"41101",6025,4299,4213,53,86,"Cs",201
13,"13016",656,463,454,3,9,"Cs",18
50,"50144",31,24,24,0,0,"Cs",1
16,"16204",237,179,177,1,2,"Cs",17
44,"44260",137,93,93,1,0,"Cs",7
50,"50170",357,245,242,6,3,"Cs",14
22,"22067",70,52,52,0,0,"Cs",2
32,"32011",916,512,507,3,5,"Cs",2
5,"5072",92,74,72,1,2,"Cs",5
16,"16162",39,31,31,0,0,"Cs",1
19,"19200",66,53,52,0,1,"Cs",2
42,"42121",54,39,39,0,0,"Cs",2
49,"49041",409,287,282,1,5,"Cs",23
10,"10160",240,179,177,2,2,"Cs",8
20,"20052",1050,746,743,4,3,"Cs",4
45,"45173",9756,6811,6720,49,91,"Cs",485
23,"23052",1094,920,896,6,24,"Cs",34
16,"16088",100,86,86,0,0,"Cs",0
37,"37143",384,273,273,2,0,"Cs",15
48,"48090",6004,4305,4254,28,51,"Cs",35
50,"50245",74,51,51,0,0,"Cs",6
5,"5106",27,14,14,0,0,"Cs",2
9,"9269",29,24,23,0,1,"Cs",1
3,"3119",17253,12346,12258,81,88,"Cs",1177
9,"9384",292,199,193,3,6,"Cs",17
28,"28071",63,46,45,0,1,"Cs",2
45,"45065",264,211,206,1,5,"Cs",7
39,"39014",882,538,536,0,2,"Cs",21
46,"46209",1903,1406,1383,5,23,"Cs",98
32,"32025",1014,731,718,5,13,"Cs",28
45,"45188",2770,1925,1886,12,39,"Cs",135
37,"37240",928,648,637,2,11,"Cs",81
37,"37145",236,173,170,3,3,"Cs",12
16,"16013",26,24,24,0,0,"Cs",0
32,"32050",2254,1630,1612,15,18,"Cs",45
16,"16258",172,124,119,0,5,"Cs",5
10,"10054",523,389,380,1,9,"Cs",12
46,"46149",350,252,249,3,3,"Cs",17
28,"28093",2177,1681,1658,11,23,"Cs",126
19,"19296",29,24,24,0,0,"Cs",0
46,"46164",12145,8373,8248,44,125,"Cs",643
16,"16014",558,419,417,6,2,"Cs",11
3,"3062",228,173,172,3,1,"Cs",34
48,"48008",609,415,407,4,8,"Cs",1
15,"15047",2256,1429,1405,25,24,"Cs",52
34,"34199",1150,767,754,14,13,"Cs",36
46,"46051",8469,6120,6070,40,50,"Cs",392
42,"42081",126,88,88,0,0,"Cs",5
22,"22182",227,132,131,3,1,"Cs",9
10,"10042",85,58,58,0,0,"Cs",1
34,"34098",790,562,558,3,4,"Cs",43
44,"44175",112,76,75,1,1,"Cs",2
34,"34099",53,44,42,0,2,"Cs",5
37,"37366",40,34,33,2,1,"Cs",1
24,"24130",415,291,289,2,2,"Cs",12
10,"10206",196,135,133,0,2,"Cs",6
23,"23056",3052,2279,2207,26,72,"Cs",158
16,"16052",539,422,419,3,3,"Cs",28
26,"26014",443,278,273,3,5,"Cs",11
44,"44264",254,170,170,0,0,"Cs",11
38,"38037",12817,7582,7494,55,88,"Cs",301
9,"9389",63,45,45,0,0,"Cs",1
46,"46120",1179,903,880,5,23,"Cs",52
34,"34055",254,185,184,3,1,"Cs",10
27,"27051",7986,5324,5241,58,83,"Cs",168
46,"46143",4274,3027,2995,19,32,"Cs",148
5,"5008",202,158,155,0,3,"Cs",8
37,"37081",879,680,674,2,6,"Cs",36
47,"47085",16330,11556,11419,121,137,"Cs",935
26,"26129",939,657,644,2,13,"Cs",43
21,"21061",5083,3325,3255,36,70,"Cs",217
30,"30020",6503,4521,4484,35,37,"Cs",183
12,"12003",954,710,702,6,8,"Cs",36
10,"10207",455,298,291,0,7,"Cs",14
36,"36036",2546,1763,1742,14,21,"Cs",49
12,"12039",792,665,659,2,6,"Cs",42
19,"19111",160,128,125,0,3,"Cs",2
34,"34086",102,81,81,2,0,"Cs",7
46,"46053",525,433,428,2,5,"Cs",15
3,"3037",340,261,255,3,6,"Cs",31
1,"1063",1852,1316,1303,6,13,"Cs",13
24,"24132",610,330,329,5,1,"Cs",18
45,"45119",3499,2217,2190,3,27,"Cs",160
9,"9225",80,55,55,0,0,"Cs",7
45,"45181",2330,1693,1661,10,32,"Cs",94
50,"50098",162,119,118,1,1,"Cs",8
40,"40152",732,575,565,10,10,"Cs",42
37,"37339",295,219,219,5,0,"Cs",6
10,"10128",5618,3799,3630,37,169,"Cs",223
46,"46031",10574,7233,7158,58,75,"Cs",508
10,"10183",950,696,684,3,12,"Cs",33
46,"46198",862,670,660,3,10,"Cs",26
14,"14011",580,444,443,3,1,"Cs",27
28,"28016",79,55,55,0,0,"Cs",1
9,"9018",24624,17232,16983,192,249,"Cs",1607
19,"19267",20,15,14,0,1,"Cs",0
1,"1022",755,532,523,4,9,"Cs",12
28,"28154",5570,3999,3961,29,38,"Cs",328
10,"10048",202,141,139,0,2,"Cs",1
46,"46168",2004,1463,1447,12,16,"Cs",72
23,"23097",6346,4243,4194,31,49,"Cs",253
29,"29901",44757,29291,28960,307,331,"Cs",2624
22,"22077",362,280,272,5,8,"Cs",21
28,"28122",578,404,401,1,3,"Cs",24
3,"3011",8014,5278,5212,50,66,"Cs",480
5,"5178",340,261,255,3,6,"Cs",9
6,"6141",1678,1183,1158,15,25,"Cs",70
38,"38015",4055,2635,2601,16,34,"Cs",94
6,"6156",1170,829,814,12,15,"Cs",52
37,"37047",215,89,89,0,0,"Cs",2
5,"5231",150,123,122,2,1,"Cs",5
3,"3040",264,227,221,1,6,"Cs",8
3,"3127",350,260,255,1,5,"Cs",10
13,"13030",115,81,81,0,0,"Cs",11
49,"49214",666,486,477,6,9,"Cs",31
39,"39040",4271,3103,3080,18,23,"Cs",131
29,"29056",1047,708,696,5,12,"Cs",44
19,"19114",30,22,21,1,1,"Cs",0
49,"49093",280,226,223,5,3,"Cs",12
9,"9283",39,25,24,1,1,"Cs",0
19,"19241",35,26,25,2,1,"Cs",0
45,"45074",397,300,293,2,7,"Cs",17
10,"10009",255,165,162,1,3,"Cs",4
28,"28090",9252,7216,7153,58,63,"Cs",713
18,"18192",1462,1125,1103,3,22,"Cs",57
37,"37164",232,176,175,3,1,"Cs",12
13,"13047",5782,4232,4160,27,72,"Cs",251
37,"37163",34,24,24,0,0,"Cs",1
40,"40156",272,194,190,4,4,"Cs",13
5,"5180",76,55,53,0,2,"Cs",1
40,"40057",1397,1081,1067,15,14,"Cs",60
10,"10051",421,316,308,0,8,"Cs",2
48,"48902",18987,12762,12670,88,92,"Cs",133
19,"19115",29,23,23,0,0,"Cs",3
40,"40058",306,244,240,1,4,"Cs",10
19,"19046",22204,16001,15752,156,249,"Cs",1324
16,"16273",300,214,211,3,3,"Cs",4
5,"5084",66,44,44,0,0,"Cs",2
47,"47060",224,171,168,1,3,"Cs",13
39,"39070",126,91,89,0,2,"Cs",2
16,"16062",25,20,20,0,0,"Cs",2
18,"18063",1232,687,678,9,9,"Cs",35
7,"7019",161,104,102,0,2,"Cs",4
42,"42010",21,15,14,0,1,"Cs",1
9,"9232",139,100,97,1,3,"Cs",1
18,"18140",42474,26967,26648,225,319,"Cs",1963
48,"48903",1800,1358,1353,4,5,"Cs",11
23,"23090",1204,953,938,6,15,"Cs",33
49,"49042",229,166,164,2,2,"Cs",6
14,"14043",7406,5323,5211,63,112,"Cs",377
3,"3100",499,384,378,0,6,"Cs",23
16,"16025",24,20,20,0,0,"Cs",0
46,"46194",15852,11124,11009,86,115,"Cs",780
39,"39043",1517,1167,1154,3,13,"Cs",53
18,"18194",2038,1373,1348,12,25,"Cs",108
41,"41095",40187,27090,26680,512,410,"Cs",2581
49,"49108",446,312,309,2,3,"Cs",19
40,"40006",22,19,19,0,0,"Cs",2
12,"12139",299,202,200,3,2,"Cs",4
34,"34110",75,64,64,0,0,"Cs",3
36,"36054",11107,7027,6894,57,133,"Cs",327
28,"28021",571,365,364,1,1,"Cs",34
10,"10218",1074,685,672,0,13,"Cs",46
50,"50104",320,251,251,1,0,"Cs",21
4,"4018",245,202,197,2,5,"Cs",9
16,"16064",651,556,550,4,6,"Cs",25
19,"19215",135,109,109,0,0,"Cs",4
44,"44154",240,164,161,1,3,"Cs",21
45,"45190",462,361,353,3,8,"Cs",16
37,"37187",548,407,399,0,8,"Cs",27
42,"42094",596,448,436,9,12,"Cs",43
40,"40192",134,106,105,1,1,"Cs",10
44,"44006",220,152,151,1,1,"Cs",8
28,"28022",37338,30620,30455,229,165,"Cs",3620
9,"9075",104,82,82,0,0,"Cs",13
26,"26026",1268,986,970,4,16,"Cs",47
4,"4089",687,484,479,2,5,"Cs",16
37,"37126",30,25,25,0,0,"Cs",2
6,"6150",777,592,588,0,4,"Cs",70
45,"45191",524,437,432,2,5,"Cs",16
24,"24033",209,149,149,0,0,"Cs",3
46,"46196",134,111,110,0,1,"Cs",1
9,"9076",24,19,19,1,0,"Cs",0
6,"6014",6503,4235,4181,35,54,"Cs",375
42,"42096",244,132,129,2,3,"Cs",5
36,"36025",2127,1235,1221,5,14,"Cs",78
9,"9297",310,233,233,6,0,"Cs",38
9,"9241",244,171,169,6,2,"Cs",19
9,"9455",45,34,33,0,1,"Cs",1
3,"3133",41333,24527,24340,146,187,"Cs",1684
22,"22230",291,209,207,4,2,"Cs",15
44,"44243",25,19,19,0,0,"Cs",4
10,"10058",979,628,599,6,29,"Cs",27
19,"19265",134,97,97,5,0,"Cs",4
50,"50240",943,693,683,12,10,"Cs",65
30,"30036",15432,10030,9879,64,151,"Cs",669
32,"32006",1418,986,970,14,16,"Cs",23
46,"46151",757,560,552,2,8,"Cs",32
28,"28065",131232,100864,99883,846,981,"Cs",8340
44,"44127",57,43,43,0,0,"Cs",1
22,"22232",88,61,61,2,0,"Cs",4
7,"7002",6678,4149,4108,31,41,"Cs",210
5,"5022",1580,1202,1193,6,9,"Cs",64
4,"4058",342,238,236,3,2,"Cs",13
45,"45156",3334,2561,2502,23,59,"Cs",162
18,"18178",664,474,467,1,7,"Cs",15
44,"44157",61,37,37,0,0,"Cs",0
10,"10060",921,615,596,4,19,"Cs",26
7,"7058",2866,2013,1996,24,17,"Cs",92
28,"28076",432,330,327,4,3,"Cs",30
21,"21032",1827,1337,1314,13,23,"Cs",41
37,"37255",43,33,31,1,2,"Cs",2
22,"22022",542,405,403,2,2,"Cs",39
16,"16238",461,380,378,1,2,"Cs",14
40,"40033",70,55,52,1,3,"Cs",7
16,"16068",125,88,88,3,0,"Cs",2
34,"34121",187,150,150,3,0,"Cs",11
30,"30029",12122,8231,8125,54,106,"Cs",489
49,"49102",182,130,130,2,0,"Cs",6
27,"27064",1505,972,951,9,21,"Cs",39
37,"37349",100,61,58,0,3,"Cs",3
18,"18038",1042,782,760,5,22,"Cs",29
49,"49103",392,319,316,5,3,"Cs",19
28,"28165",1917,1339,1321,2,18,"Cs",74
49,"49065",1048,747,725,6,22,"Cs",40
6,"6110",138,105,102,0,3,"Cs",7
37,"37318",196,132,132,0,0,"Cs",11
48,"48013",79353,53591,53205,331,386,"Cs",702
9,"9903",3112,2087,2058,24,29,"Cs",150
15,"15041",9569,6362,6269,104,93,"Cs",237
15,"15010",1805,1047,1031,19,16,"Cs",22
9,"9020",233,170,166,3,4,"Cs",18
21,"21074",2736,1826,1790,19,36,"Cs",61
45,"45086",483,339,332,0,7,"Cs",21
15,"15064",2103,1458,1447,20,11,"Cs",52
10,"10185",558,376,374,2,2,"Cs",9
3,"3088",5895,4030,3961,29,69,"Cs",357
28,"28079",2384271,1765443,1753633,13854,11810,"Cs",155080
3,"3137",654,449,443,7,6,"Cs",19
42,"42020",4170,2732,2686,35,46,"Cs",143
46,"46200",1840,1475,1455,5,20,"Cs",68
40,"40069",68,59,59,0,0,"Cs",2
4,"4037",1212,890,875,17,15,"Cs",55
28,"28114",141,97,97,0,0,"Cs",8
16,"16087",238,184,184,6,0,"Cs",5
48,"48024",1000,761,752,1,9,"Cs",3
10,"10187",431,288,281,0,7,"Cs",9
24,"24152",433,269,267,4,2,"Cs",15
46,"46132",2176,1725,1708,5,17,"Cs",100
50,"50059",757,556,551,5,5,"Cs",37
49,"49105",135,94,94,2,0,"Cs",7
49,"49252",312,240,236,7,4,"Cs",18
9,"9249",47,35,35,3,0,"Cs",4
19,"19222",95,70,70,2,0,"Cs",3
23,"23004",407,321,315,2,6,"Cs",73
46,"46201",62,40,40,0,0,"Cs",2
37,"37063",58,47,47,0,0,"Cs",4
34,"34227",70,56,52,1,4,"Cs",3
22,"22204",1117,728,723,14,5,"Cs",68
6,"6115",1243,808,798,8,10,"Cs",63
44,"44132",54,49,49,0,0,"Cs",1
1,"1044",232,151,148,2,3,"Cs",1
9,"9472",52,40,38,0,2,"Cs",3
42,"42123",157,103,102,6,1,"Cs",3
9,"9164",147,112,111,0,1,"Cs",16
44,"44238",2278,1630,1620,3,10,"Cs",449
16,"16049",137,98,98,2,0,"Cs",3
5,"5204",578,445,442,3,3,"Cs",43
10,"10067",10210,7090,6946,62,144,"Cs",434
29,"29012",9718,6664,6553,85,111,"Cs",435
42,"42108",10,7,7,0,0,"Cs",0
10,"10189",2499,1747,1700,15,47,"Cs",85
37,"37290",130,106,106,0,0,"Cs",7
13,"13020",4701,3114,3069,42,45,"Cs",240
41,"41068",13963,9596,9407,96,189,"Cs",574
5,"5029",100,73,73,1,0,"Cs",0
19,"19319",4609,3303,3273,22,30,"Cs",299
50,"50188",26,23,23,0,0,"Cs",3
26,"26037",125,98,98,3,0,"Cs",5
49,"49109",561,419,415,6,4,"Cs",15
45,"45091",376,270,269,3,1,"Cs",24
50,"50189",678,494,487,6,7,"Cs",34
45,"45201",3692,2198,2175,15,23,"Cs",166
48,"48065",3285,2341,2326,8,15,"Cs",11
33,"33016",18848,12845,12737,173,108,"Cs",848
24,"24156",220,135,133,0,2,"Cs",3
38,"38052",1283,806,794,3,12,"Cs",35
41,"41023",7999,5500,5435,60,65,"Cs",351
15,"15068",4824,2976,2937,54,39,"Cs",153
12,"12018",279,233,231,3,2,"Cs",14
26,"26154",10,10,9,1,1,"Cs",0
16,"16196",589,490,476,3,14,"Cs",11
3,"3026",1331,987,975,7,12,"Cs",54
32,"32077",1104,703,700,9,3,"Cs",27
9,"9368",29,19,19,1,0,"Cs",3
9,"9093",162,131,131,1,0,"Cs",8
34,"34178",119,94,91,0,3,"Cs",1
13,"13054",4870,3630,3575,26,55,"Cs",228
46,"46253",112,84,84,0,0,"Cs",6
19,"19226",37,22,22,0,0,"Cs",2
5,"5099",451,350,344,3,6,"Cs",21
50,"50264",151,111,110,0,1,"Cs",9
47,"47200",70,60,60,0,0,"Cs",2
37,"37199",128,92,92,2,0,"Cs",15
3,"3027",167,142,138,1,4,"Cs",7
2,"2019",2352,1806,1766,9,40,"Cs",100
40,"40902",113,78,76,1,2,"Cs",1
50,"50191",446,327,326,1,1,"Cs",18
18,"18144",816,592,582,3,10,"Cs",54
45,"45094",365,274,271,3,3,"Cs",6
37,"37169",177,122,122,0,0,"Cs",9
5,"5088",29,22,22,0,0,"Cs",0
12,"12117",3532,2512,2479,12,33,"Cs",161
24,"24145",612,338,337,1,1,"Cs",17
32,"32005",810,576,568,9,8,"Cs",13
41,"41098",5161,3792,3732,33,60,"Cs",203
37,"37294",11750,8395,8280,88,115,"Cs",803
16,"16083",44,24,24,0,0,"Cs",2
32,"32042",1487,1010,1001,12,9,"Cs",26
18,"18145",10909,7925,7780,67,145,"Cs",792
37,"37337",137,104,103,0,1,"Cs",16
15,"15009",10605,7245,7133,101,112,"Cs",325
47,"47076",17787,13484,13306,179,178,"Cs",1258
1,"1006",174,124,122,1,2,"Cs",2
9,"9064",305,225,219,6,6,"Cs",33
16,"16199",27,18,18,0,0,"Cs",0
11,"11009",579,399,390,0,9,"Cs",30
18,"18078",714,546,538,5,8,"Cs",14
34,"34168",45,39,39,1,0,"Cs",2
1,"1901",2473,1633,1612,9,21,"Cs",33
29,"29091",9490,6428,6304,61,124,"Cs",486
37,"37213",83,64,64,0,0,"Cs",2
37,"37359",165,105,103,0,2,"Cs",9
9,"9279",166,116,114,1,2,"Cs",9
40,"40045",119,93,93,1,0,"Cs",10
19,"19104",19,15,14,0,1,"Cs",0
22,"22003",135,107,107,0,0,"Cs",13
5,"5167",223,177,172,0,5,"Cs",4
50,"50193",664,487,475,4,12,"Cs",33
37,"37072",144,121,118,5,3,"Cs",4
4,"4035",8439,5822,5768,45,54,"Cs",326
45,"45097",1037,834,819,7,15,"Cs",48
40,"40176",372,288,287,2,1,"Cs",17
3,"3058",4976,3733,3669,20,64,"Cs",213
22,"22213",2918,2084,2062,20,22,"Cs",180
10,"10171",347,238,219,1,19,"Cs",3
16,"16251",1805,1318,1302,9,16,"Cs",45
29,"29092",576,375,366,7,9,"Cs",45
6,"6095",9506,6616,6425,109,191,"Cs",354
23,"23085",2171,1587,1575,7,12,"Cs",83
50,"50090",134,96,96,0,0,"Cs",11
34,"34237",579,408,400,1,8,"Cs",18
50,"50099",3036,2137,2113,17,24,"Cs",146
36,"36019",1462,916,908,8,8,"Cs",25
22,"22037",112,87,87,2,0,"Cs",14
13,"13061",5616,3679,3634,51,45,"Cs",282
19,"19044",275,186,182,0,4,"Cs",6
26,"26095",93,71,68,0,3,"Cs",0
47,"47017",190,146,146,0,0,"Cs",7
46,"46025",2445,1875,1853,16,22,"Cs",138
49,"49040",109,89,87,2,2,"Cs",2
33,"33078",127,81,81,0,0,"Cs",3
9,"9467",59,46,46,2,0,"Cs",2
15,"15902",4507,2885,2837,34,48,"Cs",119
40,"40004",436,330,319,2,11,"Cs",25
9,"9431",116,85,84,2,1,"Cs",6
22,"22006",268,167,164,4,3,"Cs",11
16,"16254",199,159,159,0,0,"Cs",1
19,"19066",51,42,42,0,0,"Cs",0
18,"18050",1649,1113,1095,5,18,"Cs",69
46,"46003",948,770,757,8,13,"Cs",41
13,"13017",240,178,176,0,2,"Cs",9
35,"35018",13153,7742,7674,80,68,"Cs",417
9,"9007",54,37,35,0,2,"Cs",2
34,"34241",17,17,16,3,1,"Cs",1
26,"26083",337,255,250,3,5,"Cs",9
23,"23063",3784,2699,2664,22,35,"Cs",97
16,"16100",642,518,514,2,4,"Cs",13
2,"2026",834,644,633,4,11,"Cs",33
4,"4074",2910,1813,1789,15,24,"Cs",88
39,"39089",131,82,82,0,0,"Cs",3
2,"2059",320,225,217,0,8,"Cs",5
47,"47176",199,110,110,0,0,"Cs",6
5,"5213",94,72,70,0,2,"Cs",4
49,"49242",439,342,336,2,6,"Cs",12
5,"5041",984,743,732,5,11,"Cs",49
50,"50052",81,61,61,0,0,"Cs",4
46,"46171",16446,11616,11499,94,117,"Cs",936
5,"5107",54,36,35,2,1,"Cs",0
37,"37364",760,502,500,0,2,"Cs",35
19,"19139",26,19,19,2,0,"Cs",0
4,"4076",1209,873,850,7,23,"Cs",39
12,"12081",606,454,446,2,8,"Cs",21
39,"39052",19005,13859,13748,83,111,"Cs",808
37,"37291",269,186,185,1,1,"Cs",16
19,"19082",100,72,71,1,1,"Cs",3
5,"5118",64,41,41,1,0,"Cs",3
34,"34196",87,67,67,3,0,"Cs",7
4,"4055",361,298,290,3,8,"Cs",10
41,"41060",15058,10551,10302,122,249,"Cs",897
46,"46096",263,204,202,0,2,"Cs",13
22,"22141",115,94,93,0,1,"Cs",3
9,"9236",34,25,25,1,0,"Cs",0
16,"16211",335,228,227,1,1,"Cs",6
44,"44263",373,267,267,2,0,"Cs",2
46,"46142",778,536,524,3,12,"Cs",38
24,"24167",703,436,430,3,6,"Cs",31
16,"16166",240,173,171,0,2,"Cs",6
50,"50070",50,30,29,0,1,"Cs",1
37,"37208",71,49,49,0,0,"Cs",2
28,"28012",929,707,698,7,9,"Cs",46
40,"40082",104,84,84,2,0,"Cs",10
10,"10002",360,239,236,1,3,"Cs",6
49,"49086",111,89,89,1,0,"Cs",3
44,"44117",327,258,258,0,0,"Cs",9
26,"26050",125,92,91,1,1,"Cs",2
9,"9221",498,380,377,8,3,"Cs",39
42,"42128",45,40,39,2,1,"Cs",0
50,"50198",47,32,32,0,0,"Cs",2
39,"39092",863,534,533,3,1,"Cs",9
50,"50045",1217,891,878,10,13,"Cs",48
13,"13070",747,575,556,7,19,"Cs",22
5,"5142",88,76,75,0,1,"Cs",3
47,"47118",147,97,97,2,0,"Cs",4
40,"40214",198,160,154,0,6,"Cs",14
45,"45032",445,290,286,2,4,"Cs",20
30,"30901",10556,7862,7775,58,87,"Cs",577
22,"22220",147,106,105,1,1,"Cs",7
19,"19041",163,118,117,1,1,"Cs",8
48,"48038",1151,829,829,1,0,"Cs",3
32,"32078",1099,715,707,4,8,"Cs",15
44,"44223",73,48,48,0,0,"Cs",7
39,"39055",1065,747,736,4,11,"Cs",28
10,"10180",4206,2609,2574,13,35,"Cs",136
16,"16006",113,100,100,1,0,"Cs",46
40,"40141",822,584,568,9,16,"Cs",53
38,"38901",1466,908,894,4,14,"Cs",21
3,"3123",7579,5491,5416,50,75,"Cs",439
5,"5078",95,78,78,2,0,"Cs",9
27,"27031",15107,9759,9593,87,166,"Cs",376
30,"30004",1129,838,833,1,5,"Cs",27
37,"37128",235,169,168,0,1,"Cs",16
46,"46076",610,500,494,1,6,"Cs",15
28,"28025",405,294,291,5,3,"Cs",10
50,"50200",479,389,383,5,6,"Cs",38
12,"12031",3960,2913,2869,13,44,"Cs",176
24,"24133",357,256,256,1,0,"Cs",12
10,"10209",259,151,149,0,2,"Cs",2
46,"46262",206,136,134,1,2,"Cs",16
18,"18101",9449,6688,6568,77,120,"Cs",575
10,"10169",497,370,366,0,4,"Cs",23
15,"15030",199701,137611,136590,1540,1021,"Cs",6882
48,"48040",1303,933,926,7,7,"Cs",3
36,"36027",4401,2940,2781,20,159,"Cs",128
19,"19335",51,39,38,0,1,"Cs",0
49,"49016",230,155,155,0,0,"Cs",10
9,"9120",41,34,33,3,1,"Cs",1
49,"49238",273,205,200,4,5,"Cs",11
12,"12111",327,259,255,8,4,"Cs",5
49,"49200",936,679,670,9,9,"Cs",38
15,"15083",1029,627,614,5,13,"Cs",18
44,"44055",75,52,50,0,2,"Cs",2
47,"47153",101,69,69,1,0,"Cs",0
47,"47121",517,410,398,2,12,"Cs",28
37,"37151",142,109,109,1,0,"Cs",4
35,"35008",6214,4193,4143,33,50,"Cs",239
27,"27054",1135,807,782,5,25,"Cs",16
26,"26019",346,260,251,2,9,"Cs",13
48,"48004",326,245,245,1,0,"Cs",0
37,"37006",116,71,70,3,1,"Cs",1
10,"10035",1798,1201,1171,8,30,"Cs",45
33,"33011",10563,5646,5578,92,68,"Cs",298
46,"46017",33041,23469,23277,173,192,"Cs",1750
18,"18070",287,216,216,3,0,"Cs",21
6,"6005",1694,1167,1139,9,28,"Cs",53
24,"24137",1043,700,691,8,9,"Cs",18
37,"37225",97,78,74,0,4,"Cs",6
6,"6127",2809,2105,2074,9,31,"Cs",104
37,"37310",166,116,115,3,1,"Cs",9
45,"45001",1846,1213,1181,10,32,"Cs",54
5,"5211",425,336,330,2,6,"Cs",14
44,"44029",585,454,451,2,3,"Cs",41
34,"34240",84,67,66,1,1,"Cs",4
4,"4073",327,224,223,0,1,"Cs",9
34,"34186",49,44,44,0,0,"Cs",2
18,"18171",2098,1521,1460,11,61,"Cs",71
10,"10214",216,170,170,2,0,"Cs",7
45,"45112",1844,1121,1086,8,35,"Cs",53
5,"5015",68,45,44,1,1,"Cs",4
49,"49019",232,162,152,2,10,"Cs",15
40,"40189",471,344,329,1,15,"Cs",10
26,"26058",149,114,114,2,0,"Cs",6
7,"7018",389,238,236,1,2,"Cs",10
19,"19045",122,97,96,0,1,"Cs",3
24,"24214",626,438,433,8,5,"Cs",14
3,"3129",1224,934,923,4,11,"Cs",72
20,"20043",1718,1189,1183,2,6,"Cs",3
18,"18011",4403,3002,2947,24,55,"Cs",207
9,"9448",203,159,157,0,2,"Cs",12
50,"50026",418,292,288,4,4,"Cs",19
46,"46057",463,308,304,1,4,"Cs",9
50,"50179",255,197,197,0,0,"Cs",4
36,"36021",12180,8188,8058,115,130,"Cs",367
3,"3005",7937,5907,5869,40,38,"Cs",354
34,"34192",76,59,59,0,0,"Cs",1
37,"37185",539,372,363,2,9,"Cs",39
29,"29049",2890,2069,2034,12,35,"Cs",92
48,"48091",1078,758,757,5,1,"Cs",3
41,"41012",3375,2259,2214,26,45,"Cs",120
10,"10053",279,171,169,1,2,"Cs",2
37,"37052",287,192,191,2,1,"Cs",6
37,"37124",195,137,137,2,0,"Cs",10
15,"15055",4446,2829,2762,50,67,"Cs",101
9,"9166",96,77,77,0,0,"Cs",2
37,"37270",184,139,136,2,3,"Cs",8
37,"37030",82,60,60,0,0,"Cs",3
9,"9310",15,14,11,0,3,"Cs",2
22,"22128",188,145,143,3,2,"Cs",18
37,"37090",68,47,47,0,0,"Cs",1
39,"39025",8637,6256,6179,33,77,"Cs",171
42,"42012",29,22,22,0,0,"Cs",0
48,"48017",13121,8929,8886,45,43,"Cs",18
20,"20004",230,133,133,2,0,"Cs",0
16,"16039",365,241,238,3,3,"Cs",19
16,"16228",173,147,145,2,2,"Cs",19
16,"16181",54,40,40,0,0,"Cs",0
29,"29004",283,222,218,3,4,"Cs",15
44,"44034",124,90,90,0,0,"Cs",4
19,"19306",24,18,18,0,0,"Cs",1
6,"6012",3231,2306,2278,25,28,"Cs",124
45,"45153",1568,1168,1162,8,6,"Cs",62
7,"7055",8062,4546,4492,40,54,"Cs",293
4,"4019",236,174,172,0,2,"Cs",7
5,"5216",209,149,149,0,0,"Cs",12
7,"7022",11659,7045,6965,84,80,"Cs",381
30,"30027",50067,36417,36074,242,343,"Cs",3101
18,"18902",752,589,568,3,21,"Cs",36
49,"49098",200,139,138,3,1,"Cs",5
46,"46173",1309,1029,1010,13,19,"Cs",62
9,"9029",151,111,108,2,3,"Cs",5
46,"46082",4981,3547,3523,29,24,"Cs",358
33,"33064",240,151,151,0,0,"Cs",6
39,"39017",550,378,372,1,6,"Cs",10
50,"50280",290,220,216,1,4,"Cs",33
40,"40129",159,119,117,2,2,"Cs",12
47,"47095",41,29,28,0,1,"Cs",1
46,"46128",1569,1216,1179,7,37,"Cs",75
23,"23033",1325,1008,989,11,19,"Cs",72
5,"5185",96,63,61,1,2,"Cs",0
16,"16066",2280,1765,1734,18,31,"Cs",68
47,"47023",3057,2369,2359,20,10,"Cs",245
32,"32053",1362,1001,989,10,12,"Cs",20
12,"12093",161,111,109,2,2,"Cs",2
49,"49077",157,80,80,0,0,"Cs",4
37,"37170",1361,909,884,9,25,"Cs",70
18,"18912",1352,926,912,7,14,"Cs",68
19,"19196",89,70,67,1,3,"Cs",3
23,"23046",2334,1880,1855,9,25,"Cs",97
47,"47035",901,659,653,4,6,"Cs",24
26,"26077",16,16,16,0,0,"Cs",0
29,"29090",1649,1138,1124,10,14,"Cs",100
22,"22032",102,69,68,1,1,"Cs",6
16,"16107",94,56,56,0,0,"Cs",5
16,"16007",1153,857,847,3,10,"Cs",27
44,"44045",360,271,271,0,0,"Cs",1
42,"42151",38,27,27,0,0,"Cs",4
24,"24073",437,285,282,1,3,"Cs",25
10,"10102",496,378,377,1,1,"Cs",15
50,"50096",34,22,22,0,0,"Cs",4
29,"29081",250,185,182,2,3,"Cs",9
40,"40021",18,15,15,0,0,"Cs",0
40,"40228",493,362,361,3,1,"Cs",22
18,"18079",3466,2391,2333,22,58,"Cs",82
37,"37109",178,127,126,0,1,"Cs",15
38,"38047",1755,1132,1110,9,22,"Cs",39
49,"49210",447,350,348,3,2,"Cs",10
37,"37380",55,41,40,2,1,"Cs",3
14,"14902",1113,877,851,15,26,"Cs",50
4,"4023",118,84,82,2,2,"Cs",7
24,"24183",748,464,460,9,4,"Cs",20
5,"5220",364,277,274,0,3,"Cs",20
6,"6065",293,230,228,2,2,"Cs",2
49,"49249",61,45,45,1,0,"Cs",2
20,"20070",1084,798,795,7,3,"Cs",1
40,"40013",57,47,47,0,0,"Cs",4
28,"28067",4416,3359,3311,18,48,"Cs",242
9,"9213",264,182,182,1,0,"Cs",13
10,"10170",231,164,162,2,2,"Cs",4
24,"24197",717,500,499,2,1,"Cs",23
16,"16160",58,41,41,1,0,"Cs",0
35,"35031",7456,4938,4868,39,70,"Cs",248
39,"39068",642,442,438,1,4,"Cs",33
6,"6157",389,277,271,1,6,"Cs",7
45,"45012",623,482,472,0,10,"Cs",16
33,"33068",1031,518,510,5,8,"Cs",11
44,"44199",39,37,37,2,0,"Cs",0
14,"14041",3113,2234,2160,43,74,"Cs",136
44,"44020",22,21,21,0,0,"Cs",0
29,"29093",2150,1543,1520,8,23,"Cs",58
26,"26033",162,133,132,3,1,"Cs",6
20,"20011",1624,1234,1225,3,9,"Cs",3
39,"39012",6772,4807,4755,31,52,"Cs",269
19,"19221",31,22,22,1,0,"Cs",0
46,"46177",4832,3592,3539,20,53,"Cs",220
42,"42167",235,163,161,4,2,"Cs",16
46,"46223",7776,5848,5798,36,50,"Cs",506
11,"11003",1230,802,787,9,15,"Cs",48
50,"50285",657,448,442,4,6,"Cs",40
16,"16242",300,245,243,2,2,"Cs",17
5,"5160",289,220,213,0,7,"Cs",4
26,"26070",152,125,122,1,3,"Cs",6
50,"50297",503800,365284,362768,3385,2516,"Cs",34949
27,"27005",2560,1691,1662,19,29,"Cs",30
50,"50034",767,516,511,10,5,"Cs",47
40,"40166",251,201,201,0,0,"Cs",14
5,"5267",103,67,67,1,0,"Cs",0
6,"6008",615,522,507,2,15,"Cs",24
5,"5127",600,472,469,7,3,"Cs",40
6,"6069",2985,1921,1874,17,47,"Cs",126
36,"36031",563,426,420,7,6,"Cs",13
37,"37101",138,101,100,1,1,"Cs",5
9,"9471",140,108,107,1,1,"Cs",4
9,"9288",87,64,64,0,0,"Cs",3
49,"49202",173,103,101,0,2,"Cs",4
3,"3033",101,82,78,0,4,"Cs",7
42,"42124",56,27,27,0,0,"Cs",1
13,"13065",2777,1766,1728,10,38,"Cs",54
37,"37301",84,64,64,1,0,"Cs",3
10,"10040",426,301,289,2,12,"Cs",10
9,"9198",100,75,74,2,1,"Cs",9
19,"19252",56,44,44,0,0,"Cs",4
49,"49256",236,183,179,0,4,"Cs",6
33,"33015",1396,849,842,7,7,"Cs",21
9,"9041",25,21,21,2,0,"Cs",1
2,"2082",98,80,80,0,0,"Cs",7
42,"42062",20,10,10,0,0,"Cs",0
40,"40037",30,17,17,0,0,"Cs",2
26,"26073",92,68,66,1,2,"Cs",3
3,"3025",1304,944,934,4,10,"Cs",49
44,"44014",2506,1828,1818,8,10,"Cs",76
5,"5226",63,43,42,0,1,"Cs",0
24,"24189",5872,3915,3873,42,42,"Cs",267
3,"3006",493,365,360,2,5,"Cs",21
19,"19002",55,45,45,0,0,"Cs",0
10,"10110",2226,1431,1400,7,31,"Cs",86
40,"40105",43,35,35,0,0,"Cs",2
16,"16116",76,59,58,1,1,"Cs",3
46,"46089",2182,1590,1576,9,14,"Cs",92
28,"28107",442,316,310,5,6,"Cs",19
37,"37292",91,65,65,0,0,"Cs",12
41,"41051",2317,1715,1688,4,27,"Cs",60
9,"9144",44,31,31,0,0,"Cs",5
3,"3901",1137,783,776,9,7,"Cs",58
34,"34038",259,183,178,0,5,"Cs",7
44,"44016",424,299,297,1,2,"Cs",14
32,"32004",1608,835,824,5,11,"Cs",27
20,"20076",7013,5011,4991,16,20,"Cs",36
24,"24117",410,302,301,1,1,"Cs",17
16,"16909",655,493,488,4,5,"Cs",12
21,"21019",592,397,389,6,8,"Cs",10
18,"18176",242,164,161,2,3,"Cs",4
46,"46181",16967,11951,11835,98,116,"Cs",845
18,"18015",424,331,330,4,1,"Cs",9
9,"9045",269,159,158,0,1,"Cs",6
38,"38004",4536,2914,2887,28,27,"Cs",134
34,"34100",132,96,95,1,1,"Cs",5
45,"45166",1575,1231,1210,5,21,"Cs",76
50,"50013",199,158,158,0,0,"Cs",14
10,"10113",2231,1534,1508,14,26,"Cs",68
2,"2086",2389,1567,1554,10,13,"Cs",62
40,"40193",219,156,155,3,1,"Cs",11
37,"37159",74,59,59,0,0,"Cs",8
37,"37263",339,215,210,0,5,"Cs",11
34,"34009",30,26,26,0,0,"Cs",1
9,"9424",31,24,23,0,1,"Cs",1
16,"16131",123,84,84,0,0,"Cs",3
13,"13056",11706,8399,8288,88,111,"Cs",592
26,"26117",2105,1537,1500,17,37,"Cs",83
37,"37069",981,669,657,3,12,"Cs",62
21,"21041",113074,73295,72313,1063,982,"Cs",6528
48,"48048",527,381,380,3,1,"Cs",1
9,"9354",34,31,31,2,0,"Cs",2
50,"50290",360,260,255,5,5,"Cs",14
44,"44234",71,49,49,0,0,"Cs",0
23,"23024",12215,8702,8447,69,255,"Cs",526
9,"9152",244,161,161,0,0,"Cs",6
10,"10033",397,269,268,0,1,"Cs",14
4,"4103",1432,1003,993,10,10,"Cs",44
45,"45033",297,205,201,1,4,"Cs",2
37,"37161",123,86,86,0,0,"Cs",4
49,"49197",155,109,104,0,5,"Cs",10
37,"37317",287,211,209,1,2,"Cs",14
19,"19076",29,23,23,0,0,"Cs",0
16,"16269",378,287,285,2,2,"Cs",3
16,"16133",4399,3317,3256,34,61,"Cs",134
48,"48031",303,221,221,0,0,"Cs",1
4,"4901",490,343,343,2,0,"Cs",13
12,"12078",334,224,221,2,3,"Cs",8
46,"46206",555,417,408,0,9,"Cs",31
27,"27043",1222,746,737,12,9,"Cs",21
48,"48041",687,548,547,4,1,"Cs",2
9,"9262",160,122,120,2,2,"Cs",5
19,"19169",30,27,27,0,0,"Cs",0
34,"34135",398,267,264,4,3,"Cs",12
44,"44112",400,265,265,2,0,"Cs",13
36,"36018",3033,1951,1926,9,25,"Cs",80
9,"9066",54,37,37,0,0,"Cs",3
9,"9227",112,89,89,1,0,"Cs",5
9,"9052",28,21,20,0,1,"Cs",1
37,"37036",55,36,34,0,2,"Cs",1
5,"5124",87,67,67,2,0,"Cs",4
6,"6131",1057,809,800,6,9,"Cs",28
24,"24087",582,431,427,3,4,"Cs",21
37,"37333",203,125,124,2,1,"Cs",9
34,"34170",50,30,30,1,0,"Cs",2
14,"14050",2350,1774,1720,20,54,"Cs",102
12,"12071",1272,936,925,3,11,"Cs",43
21,"21014",4066,3089,3029,30,60,"Cs",247
38,"38040",5482,3094,3060,14,34,"Cs",144
9,"9446",10,7,7,0,0,"Cs",0
45,"45025",1218,849,844,9,5,"Cs",47
39,"39003",261,189,187,2,2,"Cs",4
50,"50186",37,26,26,1,0,"Cs",0
47,"47018",36,31,31,0,0,"Cs",2
35,"35017",27498,15513,15240,121,273,"Cs",817
50,"50083",81,64,64,2,0,"Cs",1
28,"28039",134,93,93,1,0,"Cs",1
5,"5136",83,55,55,0,0,"Cs",4
9,"9905",373,239,238,2,1,"Cs",17
37,"37342",250,190,189,3,1,"Cs",25
48,"48006",307,242,240,3,2,"Cs",0
49,"49187",1197,839,819,12,20,"Cs",65
3,"3013",1063,809,794,3,15,"Cs",37
10,"10038",83,59,59,0,0,"Cs",1
10,"10134",550,361,354,1,7,"Cs",13
44,"44022",464,330,325,1,5,"Cs",6
6,"6053",592,441,428,7,13,"Cs",21
26,"26034",606,457,440,5,17,"Cs",20
9,"9023",1190,891,879,17,12,"Cs",106
10,"10175",1351,918,901,8,17,"Cs",41
24,"24006",488,356,347,4,9,"Cs",11
28,"28178",1149,869,853,4,16,"Cs",56
42,"42078",1000,653,640,5,13,"Cs",24
42,"42107",70,48,47,1,1,"Cs",3
50,"50051",802,551,550,2,1,"Cs",20
41,"41011",15462,11019,10696,183,323,"Cs",739
16,"16101",137,111,109,1,2,"Cs",4
40,"40059",109,92,91,2,1,"Cs",6
45,"45174",300,218,217,2,1,"Cs",11
41,"41002",1421,938,911,7,27,"Cs",60
30,"30011",4702,3390,3324,8,66,"Cs",174
6,"6040",993,679,668,3,11,"Cs",22
44,"44025",5804,4024,3991,11,33,"Cs",134
48,"48026",1132,834,832,2,2,"Cs",3
32,"32013",1985,1242,1230,16,12,"Cs",40
10,"10109",1714,1030,1006,4,24,"Cs",70
9,"9251",362,258,256,3,2,"Cs",26
49,"49057",107,74,71,0,3,"Cs",1
47,"47102",257,212,210,2,2,"Cs",21
47,"47093",795,585,573,7,12,"Cs",38
1,"1060",204,159,151,0,8,"Cs",5
42,"42036",40,33,32,1,1,"Cs",3
19,"19048",19,14,13,1,1,"Cs",0
50,"50279",74,49,49,0,0,"Cs",0
5,"5236",105,69,69,1,0,"Cs",5
10,"10124",867,622,612,1,10,"Cs",25
49,"49156",218,149,144,0,5,"Cs",4
11,"11016",15079,9353,9192,137,161,"Cs",865
10,"10205",1934,1071,1042,4,29,"Cs",45
26,"26127",182,149,149,1,0,"Cs",3
16,"16092",149,108,108,1,0,"Cs",3
24,"24205",990,678,667,6,11,"Cs",60
47,"47179",368,256,254,2,2,"Cs",25
44,"44174",402,289,288,1,1,"Cs",12
37,"37080",221,164,163,1,1,"Cs",10
23,"23020",1510,1263,1253,16,10,"Cs",74
41,"41089",6621,4650,4549,64,101,"Cs",336
41,"41070",6451,4715,4632,70,83,"Cs",508
38,"38012",2286,1520,1510,8,10,"Cs",36
5,"5238",728,529,525,1,4,"Cs",17
32,"32090",734,448,441,2,7,"Cs",15
1,"1062",318,221,219,2,2,"Cs",8
42,"42039",216,144,141,1,3,"Cs",7
10,"10166",307,197,195,0,2,"Cs",8
49,"49192",123,93,90,2,3,"Cs",5
16,"16065",370,287,287,3,0,"Cs",16
46,"46075",144,125,122,2,3,"Cs",13
50,"50149",34,25,25,0,0,"Cs",1
14,"14009",2653,1658,1631,24,27,"Cs",160
23,"23094",3739,2920,2876,29,44,"Cs",112
1,"1039",188,150,147,2,3,"Cs",2
16,"16042",1091,832,823,4,9,"Cs",34
26,"26139",58,43,43,2,0,"Cs",2
37,"37137",98,60,59,2,1,"Cs",2
46,"46261",1708,1259,1237,12,22,"Cs",49
32,"32054",86117,56997,56376,581,621,"Cs",2534
45,"45167",1370,1078,1065,1,13,"Cs",64
49,"49224",166,102,100,0,2,"Cs",3
34,"34041",82,64,64,3,0,"Cs",3
24,"24901",853,517,513,4,4,"Cs",26
19,"19227",68,42,41,1,1,"Cs",4
10,"10032",1588,1114,1099,6,15,"Cs",68
3,"3075",154,117,115,1,2,"Cs",17
49,"49062",103,58,58,0,0,"Cs",1
22,"22053",783,494,492,6,2,"Cs",18
10,"10006",1224,907,893,7,14,"Cs",23
24,"24209",2597,1651,1636,12,15,"Cs",91
6,"6002",4313,2914,2804,37,110,"Cs",245
2,"2076",313,233,230,2,3,"Cs",9
46,"46190",50042,35290,35066,284,224,"Cs",3385
41,"41017",15907,11486,11302,158,184,"Cs",1125
5,"5240",3346,2259,2232,11,27,"Cs",124
15,"15061",5149,3221,3168,44,53,"Cs",114
6,"6154",2799,1851,1782,20,69,"Cs",114
9,"9173",123,96,93,2,3,"Cs",4
50,"50274",64,46,43,1,3,"Cs",5
9,"9443",151,113,112,0,1,"Cs",8
22,"22013",271,200,197,3,3,"Cs",15
47,"47057",272,200,199,0,1,"Cs",20
45,"45145",2631,1746,1707,12,39,"Cs",128
39,"39048",1772,1311,1295,8,16,"Cs",56
9,"9339",128,106,105,0,1,"Cs",5
46,"46077",7338,5447,5356,44,91,"Cs",265
24,"24098",1149,753,741,8,12,"Cs",44
49,"49092",115,72,72,0,0,"Cs",1
16,"16109",41,30,30,0,0,"Cs",0
24,"24003",603,374,372,0,2,"Cs",15
42,"42119",141,78,78,1,0,"Cs",4
40,"40154",22,18,18,1,0,"Cs",1
19,"19280",3669,2622,2597,24,25,"Cs",240
40,"40221",50,38,35,0,3,"Cs",7
5,"5245",353,262,256,0,6,"Cs",22
22,"22074",303,209,208,5,1,"Cs",12
37,"37040",376,291,288,0,3,"Cs",26
44,"44050",3113,2173,2154,14,19,"Cs",113
19,"19019",14,11,11,1,0,"Cs",1
13,"13092",1703,1327,1307,4,20,"Cs",89
34,"34238",294,238,236,1,2,"Cs",11
37,"37267",177,130,129,0,1,"Cs",9
37,"37173",1412,951,937,15,14,"Cs",85
9,"9343",92,66,65,0,1,"Cs",1
46,"46101",819,670,663,8,7,"Cs",43
19,"19260",38,27,27,1,0,"Cs",0
22,"22024",220,159,158,1,1,"Cs",17
32,"32071",1351,821,814,6,7,"Cs",15
9,"9006",57,30,29,0,1,"Cs",2
48,"48080",9916,6849,6793,44,56,"Cs",63
42,"42197",68,54,53,0,1,"Cs",6
26,"26021",2742,1967,1932,14,35,"Cs",88
49,"49067",329,200,198,4,2,"Cs",25
33,"33004",65304,43473,43153,563,320,"Cs",2945
3,"3099",43101,30222,29885,196,337,"Cs",2628
46,"46109",6248,4516,4440,37,76,"Cs",351
20,"20032",8654,6000,5972,21,28,"Cs",49
50,"50277",45,34,34,0,0,"Cs",1
16,"16061",939,746,727,16,19,"Cs",21
4,"4096",285,222,222,0,0,"Cs",5
46,"46231",2403,1670,1652,11,18,"Cs",60
46,"46250",582242,437146,434438,3315,2708,"Cs",36347
28,"28135",998,712,703,2,9,"Cs",40
12,"12016",1549,1244,1234,9,10,"Cs",48
46,"46125",852,660,650,5,10,"Cs",19
21,"21006",3321,2197,2125,19,72,"Cs",91
41,"41901",2692,2101,2051,47,50,"Cs",81
50,"50187",55,42,42,0,0,"Cs",1
22,"22215",127,81,81,0,0,"Cs",8
15,"15076",2490,1539,1517,25,22,"Cs",46
37,"37239",203,175,174,2,1,"Cs",14
9,"9057",147,110,108,0,2,"Cs",5
50,"50105",277,203,198,4,5,"Cs",6
44,"44147",401,264,256,7,8,"Cs",17
19,"19107",306,245,244,0,1,"Cs",16
24,"24158",296,197,192,0,5,"Cs",9
9,"9334",51,36,34,1,2,"Cs",1
46,"46247",972,649,646,3,3,"Cs",44
50,"50901",133,96,96,0,0,"Cs",7
46,"46202",17801,13010,12906,87,104,"Cs",1204
16,"16153",924,751,741,4,10,"Cs",23
10,"10150",339,279,275,3,4,"Cs",12
44,"44211",33,22,22,0,0,"Cs",1
5,"5018",23,17,17,2,0,"Cs",2
11,"11036",683,401,395,15,6,"Cs",14
30,"30034",1067,818,801,8,17,"Cs",23
37,"37251",108,75,75,0,0,"Cs",10
18,"18163",311,206,204,0,2,"Cs",12
9,"9407",25,19,17,0,2,"Cs",3
50,"50028",78,53,53,0,0,"Cs",1
13,"13037",776,573,563,2,10,"Cs",17
21,"21069",1681,1073,1056,9,17,"Cs",86
12,"12009",17943,12389,12292,102,97,"Cs",937
9,"9201",27,17,17,0,0,"Cs",3
35,"35005",1009,680,668,2,12,"Cs",35
44,"44125",63,41,41,0,0,"Cs",5
22,"22158",11994,8115,8049,79,66,"Cs",705
2,"2007",1017,757,746,5,11,"Cs",18
18,"18066",2095,1401,1378,12,23,"Cs",75
37,"37231",236,185,183,5,2,"Cs",11
19,"19015",82,74,73,1,1,"Cs",5
13,"13039",14195,10104,9933,122,171,"Cs",693
41,"41071",5571,3608,3516,64,92,"Cs",242
22,"22160",207,149,149,1,0,"Cs",5
20,"20036",13208,9102,9056,59,46,"Cs",70
44,"44035",102,82,80,1,2,"Cs",0
49,"49076",330,230,226,9,4,"Cs",22
2,"2008",1103,737,722,8,15,"Cs",31
48,"48047",147,105,105,2,0,"Cs",0
41,"41043",669,447,436,11,11,"Cs",34
28,"28111",629,479,475,2,4,"Cs",34
23,"23017",1498,1153,1129,11,24,"Cs",31
44,"44155",1063,779,778,3,1,"Cs",41
19,"19284",10,10,10,0,0,"Cs",0
20,"20064",12395,7959,7916,42,43,"Cs",76
28,"28148",89174,65500,64784,566,716,"Cs",5854
9,"9014",182,101,101,0,0,"Cs",2
19,"19075",58,38,37,3,1,"Cs",3
46,"46113",2558,1791,1773,7,18,"Cs",146
1,"1004",1357,952,945,5,7,"Cs",8
47,"47171",375,295,290,9,5,"Cs",24
9,"9258",165,128,127,0,1,"Cs",8
12,"12068",41,22,21,0,1,"Cs",1
49,"49170",99,68,68,1,0,"Cs",5
9,"9374",93,75,72,2,3,"Cs",8
50,"50014",119,81,81,0,0,"Cs",9
47,"47015",177,129,129,0,0,"Cs",7
46,"46061",351,276,272,6,4,"Cs",32
19,"19061",56,42,41,0,1,"Cs",1
5,"5230",65,57,56,1,1,"Cs",2
37,"37046",10648,7396,7241,62,155,"Cs",580
32,"32092",491,280,275,0,5,"Cs",5
45,"45047",2694,1733,1706,24,27,"Cs",121
37,"37306",238,140,136,3,4,"Cs",13
22,"22254",1084,744,735,10,9,"Cs",47
9,"9460",162,141,140,0,1,"Cs",9
48,"48087",437,335,332,0,3,"Cs",1
34,"34134",44,25,25,0,0,"Cs",0
26,"26030",18,18,17,1,1,"Cs",1
10,"10061",1591,1010,992,9,18,"Cs",103
5,"5090",73,63,62,0,1,"Cs",5
30,"30013",7421,5171,5094,32,77,"Cs",265
30,"30005",30268,20979,20778,148,201,"Cs",1534
18,"18102",8233,5424,5266,46,158,"Cs",319
16,"16901",624,443,438,5,5,"Cs",24
45,"45158",2545,1805,1786,9,19,"Cs",90
47,"47143",104,67,67,0,0,"Cs",4
37,"37172",846,530,524,6,6,"Cs",35
19,"19007",433,316,310,1,6,"Cs",15
28,"28006",80903,60936,60508,482,428,"Cs",5692
26,"26011",7251,4807,4711,47,96,"Cs",293
13,"13010",872,615,601,3,14,"Cs",30
42,"42079",21,17,17,1,0,"Cs",0
40,"40062",56,43,42,0,1,"Cs",1
33,"33055",1485,992,966,14,26,"Cs",58
19,"19143",1781,1278,1266,18,12,"Cs",78
7,"7045",1317,931,928,8,3,"Cs",45
49,"49047",98,74,72,1,2,"Cs",5
9,"9247",21,18,18,0,0,"Cs",0
47,"47154",146,115,111,6,4,"Cs",5
46,"46192",786,534,519,7,15,"Cs",39
37,"37341",47,29,29,0,0,"Cs",1
24,"24151",433,307,304,1,3,"Cs",12
32,"32059",1686,1099,1082,20,17,"Cs",16
29,"29028",1215,803,779,9,24,"Cs",74
13,"13062",567,450,446,4,4,"Cs",24
38,"38049",2690,1406,1389,27,17,"Cs",67
48,"48089",3540,2561,2555,7,6,"Cs",32
50,"50091",39,32,32,0,0,"Cs",6
44,"44131",26,22,22,0,0,"Cs",2
26,"26057",50,45,45,2,0,"Cs",1
9,"9362",198,156,156,4,0,"Cs",8
13,"13048",495,392,391,4,1,"Cs",20
16,"16224",72,60,58,0,2,"Cs",4
6,"6144",504,391,382,6,9,"Cs",18
45,"45148",263,184,184,0,0,"Cs",8
28,"28167",8640,6564,6504,51,60,"Cs",698
33,"33060",13991,8629,8481,109,148,"Cs",329
9,"9346",90,61,60,1,1,"Cs",7
18,"18193",14934,10301,10127,116,174,"Cs",889
21,"21066",490,394,389,4,5,"Cs",14
46,"46170",3417,2618,2577,11,41,"Cs",183
29,"29011",2893,1763,1736,12,27,"Cs",92
5,"5224",102,85,84,2,1,"Cs",4
50,"50253",379,294,290,1,4,"Cs",28
37,"37353",122,82,80,0,2,"Cs",0
34,"34213",53,46,46,0,0,"Cs",1
12,"12098",529,417,413,3,4,"Cs",15
22,"22249",125,93,92,1,1,"Cs",11
39,"39033",536,375,372,1,3,"Cs",13
15,"15080",1637,1009,992,11,17,"Cs",31
20,"20060",87,75,75,0,0,"Cs",0
45,"45106",7418,5380,5306,34,74,"Cs",267
29,"29058",1542,994,979,5,15,"Cs",96
41,"41031",1204,780,769,5,11,"Cs",44
49,"49083",47,37,37,1,0,"Cs",1
42,"42129",678,485,480,6,5,"Cs",43
39,"39061",3470,2605,2591,14,14,"Cs",162
24,"24095",317,228,228,3,0,"Cs",6
32,"32074",977,642,631,2,11,"Cs",20
28,"28141",6284,4617,4570,42,47,"Cs",440
41,"41078",2445,1722,1689,12,33,"Cs",85
28,"28137",1770,1300,1289,6,11,"Cs",105
32,"32002",2028,1349,1340,4,9,"Cs",42
49,"49044",78,56,53,0,3,"Cs",2
9,"9128",76,56,56,0,0,"Cs",0
39,"39034",255,133,128,2,5,"Cs",0
45,"45067",2267,1722,1675,14,47,"Cs",68
50,"50020",795,548,545,4,3,"Cs",45
6,"6027",645,523,513,0,10,"Cs",25
47,"47073",116,80,79,2,1,"Cs",0
41,"41096",6178,4739,4655,60,84,"Cs",401
32,"32003",863,632,619,3,13,"Cs",10
10,"10001",287,207,203,2,4,"Cs",12
10,"10029",380,284,276,0,8,"Cs",13
12,"12046",188,135,135,4,0,"Cs",6
44,"44074",440,314,308,2,6,"Cs",15
13,"13008",422,280,272,2,8,"Cs",12
49,"49034",408,282,281,2,1,"Cs",7
13,"13068",1023,737,722,2,15,"Cs",41
36,"36002",3049,1994,1968,22,26,"Cs",59
20,"20077",5269,3845,3830,9,15,"Cs",33
9,"9369",419,288,284,3,4,"Cs",23
37,"37033",94,67,67,0,0,"Cs",5
26,"26039",40,31,31,0,0,"Cs",0
19,"19099",286,179,175,1,4,"Cs",6
10,"10070",667,493,489,1,4,"Cs",24
5,"5207",645,485,478,4,7,"Cs",23
34,"34149",23,20,20,0,0,"Cs",2
15,"15017",19866,13497,13344,195,153,"Cs",766
41,"41008",1044,788,766,3,22,"Cs",39
40,"40080",51,31,31,0,0,"Cs",2
18,"18007",730,490,478,3,12,"Cs",34
34,"34039",58,48,47,0,1,"Cs",4
49,"49259",79,59,59,0,0,"Cs",5
26,"26027",139,99,97,0,2,"Cs",3
37,"37144",327,233,233,2,0,"Cs",13
37,"37013",104,72,70,2,2,"Cs",3
4,"4046",849,617,612,6,5,"Cs",40
37,"37209",415,276,275,2,1,"Cs",13
6,"6066",1708,1180,1171,6,9,"Cs",50
15,"15039",1224,802,785,9,17,"Cs",24
51,"51001",59820,33614,33265,323,349,"Cs",1129
9,"9373",399,254,251,5,3,"Cs",19
38,"38029",1475,752,744,10,8,"Cs",32
3,"3019",15501,11261,11106,86,155,"Cs",900
44,"44036",22,20,20,0,0,"Cs",0
2,"2009",19495,13877,13663,134,214,"Cs",997
42,"42029",131,94,94,4,0,"Cs",4
16,"16055",669,429,426,0,3,"Cs",17
48,"48068",1534,1154,1149,1,5,"Cs",2
16,"16121",227,160,152,0,8,"Cs",1
10,"10019",1412,948,934,2,14,"Cs",53
6,"6138",1021,677,658,5,19,"Cs",46
18,"18135",4385,2882,2798,24,84,"Cs",191
4,"4022",356,237,236,5,1,"Cs",8
38,"38014",1342,943,930,6,13,"Cs",27
15,"15082",15446,10821,10687,130,134,"Cs",540
24,"24097",200,138,137,1,1,"Cs",6
42,"42208",20,12,12,1,0,"Cs",0
19,"19228",27,17,17,1,0,"Cs",0
40,"40143",82,68,67,2,1,"Cs",3
6,"6140",612,456,451,1,5,"Cs",22
12,"12059",220,183,183,2,0,"Cs",3
39,"39057",2366,1636,1607,10,29,"Cs",41
30,"30038",15752,10987,10904,39,83,"Cs",836
19,"19133",78,64,64,2,0,"Cs",5
42,"42181",384,281,278,3,3,"Cs",11
42,"42086",33,19,19,1,0,"Cs",1
3,"3048",4993,3549,3502,13,47,"Cs",212
49,"49189",186,104,104,1,0,"Cs",9
20,"20067",30609,20017,19927,111,90,"Cs",242
30,"30041",14040,8999,8876,94,123,"Cs",660
38,"38034",3997,2687,2648,19,39,"Cs",116
47,"47050",3908,2713,2673,39,40,"Cs",250
27,"27058",3283,2275,2241,12,34,"Cs",51
24,"24230",403,268,265,3,3,"Cs",13
40,"40048",35,27,27,0,0,"Cs",0
13,"13019",5101,3502,3468,33,34,"Cs",219
48,"48079",397,289,287,1,2,"Cs",0
9,"9141",617,463,456,5,7,"Cs",37
39,"39031",1237,870,865,1,5,"Cs",45
14,"14004",1963,1465,1437,15,28,"Cs",87
42,"42166",55,38,37,0,1,"Cs",1
50,"50227",107,62,62,1,0,"Cs",8
47,"47184",537,411,402,1,9,"Cs",32
48,"48910",2811,1952,1942,11,10,"Cs",15
40,"40177",139,106,105,0,1,"Cs",3
9,"9416",52,30,30,0,0,"Cs",0
12,"12015",115,94,94,0,0,"Cs",4
41,"41085",4182,3258,3181,43,77,"Cs",210
13,"13093",3901,2617,2569,16,48,"Cs",172
10,"10213",533,397,385,0,12,"Cs",14
50,"50067",13928,9831,9699,92,132,"Cs",820
15,"15033",2421,1673,1655,6,18,"Cs",55
19,"19080",67,47,47,0,0,"Cs",1
38,"38041",7025,4729,4684,42,45,"Cs",210
28,"28157",690,471,467,1,4,"Cs",29
28,"28091",5491,3709,3650,20,59,"Cs",193
47,"47069",115,87,87,0,0,"Cs",6
5,"5094",133,105,105,0,0,"Cs",7
10,"10025",377,308,299,3,9,"Cs",20
41,"41093",19064,14867,14700,151,167,"Cs",1490
47,"47166",251,183,181,2,2,"Cs",14
37,"37322",2462,1580,1537,14,43,"Cs",119
9,"9086",652,479,471,3,8,"Cs",26
13,"13049",742,509,500,4,9,"Cs",16
20,"20042",3180,2056,2053,7,3,"Cs",11
23,"23041",489,378,376,1,2,"Cs",12
47,"47160",395,296,294,3,2,"Cs",14
22,"22247",28,18,18,0,0,"Cs",0
49,"49013",219,160,159,0,1,"Cs",8
29,"29061",1043,803,773,9,30,"Cs",31
45,"45142",7792,5717,5624,62,93,"Cs",299
44,"44265",175,138,136,1,2,"Cs",8
20,"20053",4856,3169,3153,15,16,"Cs",20
44,"44099",644,422,421,2,1,"Cs",22
19,"19266",229,184,182,1,2,"Cs",16
18,"18088",1526,1000,993,10,7,"Cs",38
3,"3017",379,320,314,4,6,"Cs",11
10,"10194",524,408,404,2,4,"Cs",27
40,"40138",2102,1585,1565,13,20,"Cs",92
26,"26061",1542,1104,1079,12,25,"Cs",60
49,"49131",231,149,145,1,4,"Cs",4
19,"19152",540,377,374,2,3,"Cs",17
10,"10068",707,532,521,4,11,"Cs",20
45,"45115",2602,2013,1969,12,44,"Cs",128
22,"22116",1342,915,905,11,10,"Cs",75
14,"14007",15016,10248,10043,99,205,"Cs",874
12,"12082",9602,7323,7248,53,75,"Cs",503
19,"19003",36,30,30,0,0,"Cs",1
40,"40212",26,19,19,1,0,"Cs",2
10,"10083",96,76,74,0,2,"Cs",4
26,"26153",10,10,10,1,0,"Cs",0
28,"28180",5317,4011,3959,35,52,"Cs",338
10,"10084",1266,755,717,7,38,"Cs",48
26,"26062",85,62,62,1,0,"Cs",1
9,"9238",931,473,461,1,12,"Cs",27
30,"30043",25449,18839,18477,180,362,"Cs",1403
22,"22051",90,72,72,2,0,"Cs",3
50,"50131",212,152,147,4,5,"Cs",12
38,"38028",22144,14312,14174,89,138,"Cs",645
37,"37346",251,208,207,1,1,"Cs",13
19,"19004",59,44,44,0,0,"Cs",1
3,"3036",82,73,71,1,2,"Cs",10
32,"32017",1193,735,724,3,11,"Cs",21
50,"50272",13226,9250,9153,97,97,"Cs",914
18,"18136",1778,1320,1284,14,36,"Cs",52
34,"34114",200,134,134,0,0,"Cs",5
19,"19259",28,22,22,0,0,"Cs",0
40,"40146",260,206,204,0,2,"Cs",16
6,"6064",847,616,601,3,15,"Cs",25
22,"22119",1267,880,871,4,9,"Cs",55
9,"9108",433,315,311,3,4,"Cs",23
16,"16163",64,51,51,0,0,"Cs",1
26,"26169",66,51,50,0,1,"Cs",1
4,"4075",5462,3714,3676,19,38,"Cs",252
36,"36042",18125,11975,11775,126,200,"Cs",615
7,"7008",6113,4003,3961,26,42,"Cs",263
20,"20037",101,69,69,0,0,"Cs",0
13,"13005",23256,16610,16367,132,243,"Cs",1282
12,"12088",57,53,53,0,0,"Cs",1
5,"5165",361,266,261,4,5,"Cs",18
45,"45163",8326,5835,5693,48,142,"Cs",416
3,"3140",26036,18637,18267,237,370,"Cs",1466
28,"28035",1404,981,966,4,15,"Cs",51
42,"42163",50,27,27,1,0,"Cs",1
10,"10046",184,144,140,0,4,"Cs",1
15,"15008",5646,3859,3836,52,23,"Cs",210
49,"49183",90,67,65,2,2,"Cs",5
34,"34137",24,19,19,2,0,"Cs",0
28,"28046",4824,3726,3707,33,19,"Cs",277
9,"9078",32,27,27,0,0,"Cs",4
6,"6093",4325,3176,3073,26,103,"Cs",223
46,"46175",429,362,355,3,7,"Cs",8
33,"33038",2218,1501,1477,17,24,"Cs",80
11,"11020",166773,111205,109956,1580,1249,"Cs",10813
3,"3904",1434,1032,1022,8,10,"Cs",89
50,"50124",394,269,266,0,3,"Cs",35
18,"18157",1148,843,827,7,16,"Cs",70
32,"32057",505,334,328,3,6,"Cs",12
37,"37192",361,200,198,3,2,"Cs",24
29,"29064",423,291,285,2,6,"Cs",18
48,"48097",1314,886,882,6,4,"Cs",2
45,"45073",288,214,210,2,4,"Cs",6
44,"44149",99,74,73,4,1,"Cs",5
50,"50256",70,43,43,0,0,"Cs",0
9,"9136",169,129,125,2,4,"Cs",14
16,"16016",217,157,157,1,0,"Cs",6
42,"42082",8,8,8,0,0,"Cs",0
24,"24106",218,139,139,1,0,"Cs",5
26,"26043",346,243,235,2,8,"Cs",16
41,"41062",2151,1619,1589,12,30,"Cs",35
37,"37315",89,65,64,0,1,"Cs",3
44,"44261",713,553,549,3,4,"Cs",9
37,"37189",114,75,74,1,1,"Cs",7
28,"28119",2294,1760,1738,12,22,"Cs",145
5,"5055",532,417,413,3,4,"Cs",13
34,"34025",52,34,34,1,0,"Cs",0
5,"5087",147,108,107,3,1,"Cs",7
50,"50212",32,26,26,0,0,"Cs",0
7,"7017",899,604,596,10,8,"Cs",46
26,"26040",64,47,47,1,0,"Cs",2
16,"16041",334,244,243,2,1,"Cs",9
13,"13082",25917,16834,16670,137,164,"Cs",1170
45,"45013",1679,1266,1248,5,18,"Cs",45
28,"28069",58,44,42,1,2,"Cs",4
46,"46162",1168,839,832,3,7,"Cs",22
49,"49030",79,56,56,0,0,"Cs",4
32,"32027",989,670,660,5,10,"Cs",11
49,"49029",609,435,419,6,16,"Cs",27
50,"50101",833,557,550,5,7,"Cs",37
15,"15093",4012,2413,2386,24,27,"Cs",76
40,"40165",73,53,52,0,1,"Cs",0
5,"5026",183,149,147,1,2,"Cs",9
37,"37123",159,124,123,2,1,"Cs",13
46,"46039",2111,1657,1640,16,17,"Cs",88
28,"28125",3208,2275,2252,5,23,"Cs",180
34,"34063",84,74,74,1,0,"Cs",4
22,"22114",124,75,72,1,3,"Cs",3
6,"6099",1156,683,652,5,31,"Cs",68
18,"18106",413,270,261,3,9,"Cs",8
33,"33070",3267,2211,2185,27,26,"Cs",109
7,"7063",1434,1025,1016,10,9,"Cs",59
49,"49099",96,67,67,0,0,"Cs",1
27,"27008",1326,865,853,5,12,"Cs",13
3,"3008",158,120,118,1,2,"Cs",6
20,"20080",7705,5276,5244,21,32,"Cs",62
50,"50225",1532,983,971,12,12,"Cs",47
19,"19053",1906,1323,1304,12,19,"Cs",58
11,"11017",3198,2054,2004,37,50,"Cs",133
29,"29024",371,216,204,3,12,"Cs",14
19,"19001",43,32,32,0,0,"Cs",0
9,"9114",77,60,59,0,1,"Cs",7
45,"45154",1491,1033,1024,11,9,"Cs",76
13,"13085",2265,1768,1735,5,33,"Cs",92
14,"14046",4442,3283,3190,34,93,"Cs",150
24,"24143",497,344,343,3,1,"Cs",21
18,"18168",783,566,561,11,5,"Cs",167
45,"45176",3859,2694,2662,24,32,"Cs",273
40,"40164",186,131,130,0,1,"Cs",4
24,"24043",116,54,52,0,2,"Cs",1
28,"28063",252,188,187,1,1,"Cs",7
34,"34222",107,71,68,1,3,"Cs",1
49,"49021",14204,9429,9295,87,134,"Cs",675
18,"18141",382,240,237,0,3,"Cs",13
47,"47021",73,57,55,0,2,"Cs",10
37,"37328",159,112,110,1,2,"Cs",4
50,"50121",270,209,208,3,1,"Cs",11
45,"45135",4152,3118,3066,21,52,"Cs",162
48,"48019",3429,2424,2411,14,13,"Cs",30
37,"37320",85,65,64,1,1,"Cs",0
24,"24118",101,72,72,0,0,"Cs",3
44,"44071",585,419,418,6,1,"Cs",19
16,"16276",20,17,17,1,0,"Cs",0
2,"2074",5890,4054,4010,39,44,"Cs",253
42,"42218",68,44,43,0,1,"Cs",2
32,"32028",1537,1012,1004,5,8,"Cs",29
48,"48084",21780,14368,14271,79,97,"Cs",163
28,"28084",16243,11562,11408,90,154,"Cs",1044
40,"40040",2489,1766,1744,26,22,"Cs",149
21,"21079",678,428,417,2,11,"Cs",7
29,"29033",1084,733,722,5,11,"Cs",38
48,"48066",344,246,246,2,0,"Cs",0
19,"19018",142,112,112,1,0,"Cs",10
49,"49260",693,480,473,3,7,"Cs",30
48,"48059",402,299,297,0,2,"Cs",0
23,"23067",2405,1765,1724,14,41,"Cs",79
19,"19326",2463,1671,1650,13,21,"Cs",174
49,"49101",144,88,82,1,6,"Cs",5
5,"5058",71,45,43,0,2,"Cs",6
50,"50251",8209,5732,5658,66,74,"Cs",367
44,"44126",314,222,221,0,1,"Cs",12
46,"46258",2617,1925,1914,5,11,"Cs",117
10,"10901",1161,758,753,1,5,"Cs",25
28,"28085",4194,3126,3091,24,35,"Cs",226
50,"50172",174,125,123,2,2,"Cs",16
50,"50079",226,162,160,1,2,"Cs",13
50,"50163",3846,2863,2840,25,23,"Cs",285
23,"23040",1438,1175,1159,3,16,"Cs",47
16,"16188",74,57,57,1,0,"Cs",1
40,"40054",108,79,78,3,1,"Cs",5
16,"16172",325,233,228,1,5,"Cs",4
29,"29057",330,222,218,2,4,"Cs",4
9,"9338",225,174,172,3,2,"Cs",40
45,"45017",264,199,196,4,3,"Cs",7
42,"42159",39,34,33,0,1,"Cs",4
39,"39078",1410,1004,997,5,7,"Cs",43
45,"45123",3196,2252,2218,11,34,"Cs",216
24,"24051",389,275,269,1,6,"Cs",11
16,"16253",308,230,228,2,2,"Cs",9
37,"37079",77,59,59,1,0,"Cs",4
34,"34236",147,104,104,0,0,"Cs",4
40,"40171",40,32,32,1,0,"Cs",5
39,"39067",753,476,474,1,2,"Cs",14
44,"44191",714,509,500,5,9,"Cs",21
45,"45011",279,235,233,4,2,"Cs",7
21,"21039",303,211,210,6,1,"Cs",10
3,"3029",236,174,172,2,2,"Cs",8
46,"46099",744,539,535,2,4,"Cs",28
48,"48050",188,141,141,0,0,"Cs",0
37,"37071",76,64,62,1,2,"Cs",1
41,"41082",3354,2545,2507,11,38,"Cs",134
32,"32036",1242,856,838,14,18,"Cs",22
37,"37259",39,28,28,1,0,"Cs",0
34,"34174",172,142,136,0,6,"Cs",7
6,"6133",1795,1308,1294,11,14,"Cs",66
50,"50162",135,100,99,3,1,"Cs",9
37,"37367",179,147,143,2,4,"Cs",13
46,"46246",1049,808,793,3,15,"Cs",32
42,"42064",83,65,65,1,0,"Cs",1
19,"19186",76,60,60,0,0,"Cs",2
24,"24034",3466,2382,2359,25,23,"Cs",130
5,"5044",244,170,170,1,0,"Cs",6
41,"41022",4255,2735,2667,32,68,"Cs",135
20,"20035",480,361,361,0,0,"Cs",0
29,"29019",853,604,588,2,16,"Cs",23
40,"40139",255,194,192,2,2,"Cs",13
19,"19024",8561,6015,5942,44,73,"Cs",585
16,"16036",120,94,93,0,1,"Cs",8
37,"37297",394,298,297,0,1,"Cs",12
34,"34082",78,59,58,0,1,"Cs",4
45,"45203",2777,1986,1961,18,25,"Cs",136
20,"20026",207,172,171,4,1,"Cs",0
47,"47127",138,89,88,2,1,"Cs",10
48,"48914",332,276,275,0,1,"Cs",0
50,"50203",1065,817,804,5,13,"Cs",63
44,"44122",1277,939,934,5,5,"Cs",47
29,"29076",2354,1498,1444,21,54,"Cs",138
4,"4071",362,286,281,2,5,"Cs",9
47,"47137",29,25,25,0,0,"Cs",0
37,"37100",74,59,58,1,1,"Cs",19
47,"47199",71,57,57,2,0,"Cs",1
40,"40207",802,593,590,11,3,"Cs",62
7,"7012",1908,1301,1282,12,19,"Cs",60
23,"23019",1466,1117,1090,5,27,"Cs",58
5,"5260",95,73,73,0,0,"Cs",5
15,"15072",9434,6304,6228,48,76,"Cs",229
9,"9022",58,46,46,1,0,"Cs",7
19,"19052",21,16,16,0,0,"Cs",2
10,"10043",746,525,520,4,5,"Cs",26
15,"15027",1563,1159,1140,23,19,"Cs",62
9,"9101",72,52,52,0,0,"Cs",4
10,"10011",518,385,370,2,15,"Cs",24
34,"34231",211,157,153,3,4,"Cs",9
37,"37370",316,238,237,2,1,"Cs",19
24,"24206",1594,1104,1093,11,11,"Cs",49
1,"1017",817,537,532,3,5,"Cs",5
46,"46191",1956,1439,1414,8,25,"Cs",47
16,"16033",1633,1199,1174,8,25,"Cs",69
34,"34221",168,129,127,2,2,"Cs",5
7,"7011",28971,17082,16964,164,118,"Cs",1419
4,"4100",9433,5599,5556,48,43,"Cs",427
32,"32016",714,494,493,12,1,"Cs",10
40,"40160",93,65,62,0,3,"Cs",4
19,"19098",20,17,17,0,0,"Cs",0
42,"42140",15,11,11,1,0,"Cs",0
44,"44267",70,47,46,0,1,"Cs",15
5,"5222",140,118,118,0,0,"Cs",4
19,"19261",33,23,23,0,0,"Cs",3
12,"12119",139,97,94,3,3,"Cs",2
21,"21045",231,177,174,4,3,"Cs",12
47,"47005",506,358,348,3,10,"Cs",16
40,"40077",966,718,704,10,14,"Cs",74
41,"41073",1684,1100,1074,7,26,"Cs",69
42,"42152",67,47,44,1,3,"Cs",5
46,"46234",317,247,245,1,2,"Cs",13
45,"45034",1290,968,948,7,20,"Cs",66
24,"24178",60,54,54,1,0,"Cs",0
50,"50190",669,532,518,10,14,"Cs",36
46,"46013",17761,13652,13548,144,104,"Cs",1306
10,"10089",1334,864,837,8,27,"Cs",61
50,"50029",594,432,431,3,1,"Cs",26
23,"23092",27717,19749,19490,217,259,"Cs",1453
9,"9065",136,112,111,0,1,"Cs",4
16,"16277",105,74,74,0,0,"Cs",8
6,"6108",2238,1524,1478,15,46,"Cs",96
7,"7056",5271,3429,3386,44,43,"Cs",222
47,"47042",51,39,39,0,0,"Cs",3
9,"9017",89,61,60,3,1,"Cs",4
49,"49206",776,515,504,7,11,"Cs",31
50,"50031",134,78,75,0,3,"Cs",6
50,"50054",55,37,37,2,0,"Cs",5
18,"18003",14454,10162,9935,105,227,"Cs",895
40,"40025",129,109,107,1,2,"Cs",8
19,"19219",9,8,7,0,1,"Cs",0
28,"28059",4516,3343,3299,30,44,"Cs",335
44,"44240",151,119,117,0,2,"Cs",11
42,"42014",57,35,35,0,0,"Cs",2
45,"45018",550,385,380,1,5,"Cs",16
19,"19122",81,62,60,2,2,"Cs",1
47,"47169",62,52,52,0,0,"Cs",5
39,"39082",1611,1108,1102,8,6,"Cs",32
34,"34028",132,95,92,2,3,"Cs",6
50,"50184",87,70,70,0,0,"Cs",3
50,"50197",95,69,68,2,1,"Cs",6
15,"15019",25981,15866,15672,207,194,"Cs",779
12,"12063",41,31,31,1,0,"Cs",2
33,"33039",1646,1118,1110,8,8,"Cs",74
49,"49184",172,110,107,2,3,"Cs",9
27,"27060",2434,1458,1434,17,24,"Cs",41
6,"6067",1897,1268,1242,14,26,"Cs",89
32,"32041",752,462,458,4,4,"Cs",9
13,"13022",348,244,239,1,5,"Cs",7
5,"5076",468,376,367,1,9,"Cs",12
13,"13090",1005,754,733,4,21,"Cs",27
10,"10057",126,90,89,1,1,"Cs",3
42,"42025",1125,741,732,12,9,"Cs",35
3,"3113",4339,2978,2935,23,43,"Cs",175
4,"4048",1499,964,957,4,7,"Cs",140
50,"50078",227,168,166,0,2,"Cs",9
7,"7901",598,410,402,6,8,"Cs",15
37,"37204",253,176,173,2,3,"Cs",7
45,"45139",144,111,111,0,0,"Cs",2
39,"39020",23993,15944,15792,89,152,"Cs",695
47,"47227",53,36,35,0,1,"Cs",4
45,"45010",383,258,257,3,1,"Cs",9
21,"21060",12287,7761,7638,134,123,"Cs",705
4,"4044",1542,1092,1080,8,12,"Cs",81
39,"39085",7017,5029,4992,23,37,"Cs",271
4,"4093",1916,1143,1130,5,13,"Cs",74
28,"28170",2495,1714,1695,13,19,"Cs",92
48,"48092",872,614,608,3,6,"Cs",2
37,"37168",397,271,266,3,5,"Cs",14
48,"48021",1325,891,888,3,3,"Cs",3
20,"20079",18151,13106,13054,58,52,"Cs",61
5,"5903",137,84,83,0,1,"Cs",9
33,"33013",430,294,292,1,2,"Cs",15
19,"19281",19,18,18,0,0,"Cs",2
44,"44193",73,60,60,1,0,"Cs",2
49,"49120",54,35,35,0,0,"Cs",0
16,"16097",139,117,116,0,1,"Cs",3
19,"19173",47,40,40,0,0,"Cs",3
39,"39063",936,618,616,4,2,"Cs",8
9,"9244",45,31,31,2,0,"Cs",0
39,"39091",1881,1297,1291,8,6,"Cs",37
26,"26006",1833,1358,1335,7,23,"Cs",60
37,"37160",597,380,370,3,10,"Cs",15
29,"29032",6655,4900,4775,36,125,"Cs",259
49,"49110",344,196,195,2,1,"Cs",7
44,"44159",37,27,27,1,0,"Cs",2
22,"22009",581,387,386,7,1,"Cs",18
45,"45019",7560,5216,5135,50,81,"Cs",425
42,"42106",13,11,11,0,0,"Cs",0
4,"4077",296,270,268,3,2,"Cs",6
45,"45197",1888,1446,1426,5,20,"Cs",62
29,"29066",357,248,246,1,2,"Cs",15
37,"37002",125,64,63,0,1,"Cs",7
13,"13002",1415,966,950,3,16,"Cs",32
49,"49175",204,136,135,3,1,"Cs",5
41,"41080",1231,832,815,14,17,"Cs",58
19,"19160",883,535,530,11,5,"Cs",29
50,"50221",29,18,18,0,0,"Cs",3
46,"46016",1070,827,814,10,13,"Cs",35
49,"49268",364,266,263,3,3,"Cs",8
37,"37345",150,117,113,0,4,"Cs",3
44,"44009",798,593,589,4,4,"Cs",35
19,"19301",37,26,26,0,0,"Cs",1
14,"14030",7761,5711,5588,84,123,"Cs",434
9,"9211",1369,938,921,14,17,"Cs",47
37,"37365",162,125,121,0,4,"Cs",5
19,"19264",33,25,25,0,0,"Cs",3
46,"46230",14116,10038,9946,63,92,"Cs",720
20,"20021",185,104,104,2,0,"Cs",0
49,"49186",230,172,170,0,2,"Cs",8
43,"43055",1970,1548,1535,12,13,"Cs",21
8,"8902",3941,2974,2962,16,12,"Cs",182
8,"8032",2100,1472,1465,12,7,"Cs",66
8,"8062",1009,778,776,9,2,"Cs",33
8,"8208",5793,4267,4244,21,23,"Cs",289
43,"43024",1545,1019,1014,14,5,"Cs",69
17,"17173",181,143,143,1,0,"Cs",1
43,"43075",86,65,63,0,2,"Cs",1
17,"17070",110,87,87,0,0,"Cs",2
43,"43102",458,331,324,2,7,"Cs",2
25,"25218",88,76,75,2,1,"Cs",0
8,"8100",2083,1707,1699,13,8,"Cs",18
17,"17172",452,336,335,5,1,"Cs",5
17,"17171",177,138,137,0,1,"Cs",0
8,"8070",269,215,211,1,4,"Cs",1
17,"17097",200,170,167,2,3,"Cs",0
8,"8239",467,362,361,3,1,"Cs",21
17,"17105",248,187,186,2,1,"Cs",3
17,"17095",20044,12638,12576,88,62,"Cs",1019
25,"25060",71,42,42,0,0,"Cs",1
17,"17134",220,175,174,1,1,"Cs",0
43,"43153",11197,7685,7649,53,36,"Cs",482
17,"17041",217,150,146,1,4,"Cs",2
25,"25092",125,93,92,0,1,"Cs",2
43,"43144",1245,975,966,1,9,"Cs",50
8,"8254",1766,1433,1427,16,6,"Cs",9
25,"25052",1541,1183,1176,7,7,"Cs",18
43,"43042",2215,1723,1710,18,13,"Cs",105
43,"43118",422,338,338,0,0,"Cs",12
8,"8202",12943,9408,9358,58,50,"Cs",352
43,"43107",387,285,285,3,0,"Cs",11
43,"43013",4406,3004,2975,19,29,"Cs",115
17,"17037",112,86,86,1,0,"Cs",3
25,"25226",236,156,155,0,1,"Cs",5
25,"25029",1590,1190,1185,4,5,"Cs",7
8,"8004",208,177,177,1,0,"Cs",0
25,"25141",154,105,104,3,1,"Cs",1
17,"17012",1175,845,842,4,3,"Cs",42
25,"25182",1043,763,760,8,3,"Cs",16
43,"43152",435,348,342,2,6,"Cs",1
43,"43124",468,343,339,3,4,"Cs",11
25,"25205",563,412,407,3,5,"Cs",14
43,"43173",98,70,68,0,2,"Cs",0
25,"25216",244,186,186,0,0,"Cs",4
17,"17200",624,469,467,6,2,"Cs",4
25,"25042",204,149,149,5,0,"Cs",1
8,"8232",1773,1368,1362,9,6,"Cs",24
25,"25165",271,210,208,0,2,"Cs",5
25,"25910",91,63,63,0,0,"Cs",0
43,"43021",349,245,243,2,2,"Cs",9
25,"25102",647,484,482,5,2,"Cs",22
8,"8092",3713,2758,2745,9,13,"Cs",62
8,"8097",1103,845,840,4,5,"Cs",31
17,"17077",565,395,394,2,1,"Cs",15
25,"25061",80,51,51,0,0,"Cs",2
8,"8256",693,542,542,3,0,"Cs",11
17,"17224",299,226,222,2,4,"Cs",3
25,"25024",352,248,247,0,1,"Cs",0
8,"8292",1074,796,790,2,6,"Cs",25
8,"8013",1287,982,972,6,10,"Cs",35
25,"25134",605,457,456,5,1,"Cs",2
25,"25088",96,73,73,0,0,"Cs",2
8,"8221",12793,10123,10079,73,44,"Cs",564
25,"25203",8809,5813,5770,40,43,"Cs",238
43,"43062",269,229,226,5,3,"Cs",7
8,"8222",1821,1439,1424,7,15,"Cs",58
43,"43040",325,268,267,1,1,"Cs",2
25,"25191",321,227,222,2,5,"Cs",3
8,"8164",936,750,747,6,3,"Cs",18
8,"8168",388,280,279,3,1,"Cs",9
8,"8160",317,234,234,0,0,"Cs",2
43,"43063",544,376,374,2,2,"Cs",9
43,"43134",281,217,215,5,2,"Cs",8
17,"17049",3246,2527,2502,12,25,"Cs",51
25,"25192",727,527,524,4,3,"Cs",13
8,"8247",982,799,798,4,1,"Cs",11
17,"17182",269,195,195,0,0,"Cs",10
25,"25901",289,214,211,4,3,"Cs",2
8,"8005",6425,4830,4816,28,14,"Cs",211
8,"8270",19014,13635,13594,74,41,"Cs",928
25,"25180",227,158,155,1,3,"Cs",4
43,"43906",2113,1490,1480,12,10,"Cs",65
43,"43071",896,652,647,3,5,"Cs",20
43,"43015",115,92,91,1,1,"Cs",1
43,"43100",3557,2666,2649,22,17,"Cs",176
17,"17086",1769,1116,1109,6,7,"Cs",93
25,"25039",259,197,196,7,1,"Cs",3
8,"8262",6945,4649,4599,38,50,"Cs",204
8,"8277",168,148,146,1,2,"Cs",1
8,"8011",1739,1360,1353,10,7,"Cs",11
43,"43176",746,564,561,2,3,"Cs",10
17,"17078",335,245,245,0,0,"Cs",4
17,"17210",572,414,411,2,3,"Cs",15
43,"43120",421,256,254,1,2,"Cs",7
25,"25021",2513,1668,1662,17,6,"Cs",34
25,"25058",4345,3058,3045,13,13,"Cs",62
43,"43130",169,131,130,2,1,"Cs",4
25,"25142",359,283,283,2,0,"Cs",12
43,"43093",3863,2728,2716,22,12,"Cs",100
25,"25114",96,83,82,1,1,"Cs",0
17,"17029",207,154,154,1,0,"Cs",4
8,"8132",356,265,265,1,0,"Cs",1
8,"8297",138,99,99,0,0,"Cs",0
43,"43111",2129,1412,1401,8,11,"Cs",113
8,"8191",5302,3872,3860,21,12,"Cs",113
17,"17223",808,566,563,1,3,"Cs",13
17,"17046",709,537,531,2,6,"Cs",4
25,"25239",582,330,330,3,0,"Cs",13
8,"8282",6731,5333,5317,40,16,"Cs",236
17,"17157",122,104,103,0,1,"Cs",2
17,"17009",4068,3061,3050,16,11,"Cs",49
17,"17006",1178,826,818,9,8,"Cs",30
43,"43901",8796,5431,5390,41,41,"Cs",88
25,"25172",1762,1332,1323,8,9,"Cs",21
17,"17142",2713,2166,2159,18,7,"Cs",81
43,"43902",2751,1794,1776,21,18,"Cs",42
43,"43098",362,274,274,1,0,"Cs",9
43,"43010",334,262,262,2,0,"Cs",8
43,"43084",514,388,383,2,5,"Cs",2
43,"43171",14849,10140,10081,76,59,"Cs",1122
25,"25247",142,89,89,2,0,"Cs",9
43,"43053",186,135,134,0,1,"Cs",3
43,"43110",247,178,178,2,0,"Cs",4
43,"43141",109,85,84,0,1,"Cs",3
8,"8030",5208,4045,4033,25,12,"Cs",172
8,"8006",11774,8375,8329,53,46,"Cs",316
25,"25125",383,265,265,3,0,"Cs",1
25,"25153",190,139,136,0,3,"Cs",4
8,"8252",24885,18507,18383,162,124,"Cs",1438
8,"8046",13541,10510,10455,73,55,"Cs",486
8,"8146",1384,1030,1027,8,3,"Cs",71
43,"43154",126,104,104,0,0,"Cs",1
25,"25231",483,387,385,0,2,"Cs",9
8,"8024",357,282,282,2,0,"Cs",5
17,"17151",179,131,130,0,1,"Cs",1
43,"43164",310,235,231,3,4,"Cs",5
17,"17187",625,496,492,3,4,"Cs",9
25,"25069",426,296,294,0,2,"Cs",1
43,"43168",83,55,55,1,0,"Cs",0
17,"17190",834,624,619,1,5,"Cs",2
8,"8035",13006,8957,8918,50,39,"Cs",453
43,"43080",230,192,192,2,0,"Cs",10
8,"8201",455,319,318,12,1,"Cs",3
17,"17128",321,239,238,1,1,"Cs",18
17,"17056",1780,1379,1374,13,5,"Cs",17
25,"25067",702,500,494,8,6,"Cs",23
8,"8114",18838,13519,13442,81,77,"Cs",870
25,"25249",176,129,127,2,2,"Cs",1
17,"17066",27378,16755,16644,122,111,"Cs",964
17,"17099",78,55,55,0,0,"Cs",0
8,"8308",139,109,109,1,0,"Cs",0
8,"8047",3751,2600,2578,26,22,"Cs",87
43,"43037",18216,11749,11672,70,77,"Cs",787
17,"17206",158,111,109,0,2,"Cs",1
25,"25049",156,110,109,1,1,"Cs",5
43,"43092",7308,4703,4679,33,24,"Cs",390
8,"8233",1872,1428,1420,15,8,"Cs",23
25,"25077",435,312,312,1,0,"Cs",6
25,"25903",226,169,169,1,0,"Cs",1
25,"25912",841,620,619,5,1,"Cs",18
8,"8054",9215,6994,6943,38,51,"Cs",466
8,"8033",13262,9887,9833,64,54,"Cs",463
17,"17198",437,307,306,0,1,"Cs",11
8,"8240",9469,7351,7327,39,24,"Cs",190
8,"8069",3323,2555,2540,21,15,"Cs",143
8,"8185",197,162,162,1,0,"Cs",7
43,"43907",4386,3083,3067,24,16,"Cs",247
8,"8124",37157,27139,26994,179,145,"Cs",1854
8,"8034",820,644,640,0,4,"Cs",14
25,"25046",410,331,326,4,5,"Cs",7
25,"25907",500,366,364,5,2,"Cs",10
43,"43004",6288,4314,4262,36,52,"Cs",120
17,"17026",549,421,415,3,6,"Cs",5
17,"17164",3918,2856,2838,17,18,"Cs",58
17,"17092",3462,2414,2389,14,25,"Cs",91
8,"8290",1549,1254,1248,6,6,"Cs",33
17,"17109",704,542,539,2,3,"Cs",3
25,"25238",212,161,160,0,1,"Cs",3
25,"25183",520,372,370,4,2,"Cs",3
8,"8139",172,148,147,2,1,"Cs",0
43,"43133",5627,3794,3773,31,21,"Cs",114
25,"25130",181,130,128,0,2,"Cs",0
25,"25194",410,292,289,3,3,"Cs",3
8,"8183",4573,3406,3398,14,8,"Cs",82
17,"17191",163,140,140,1,0,"Cs",2
8,"8225",94,83,82,1,1,"Cs",0
17,"17137",3486,2812,2808,15,4,"Cs",40
25,"25015",336,234,233,3,1,"Cs",2
8,"8248",5687,4187,4165,21,22,"Cs",236
8,"8241",70,52,52,0,0,"Cs",3
8,"8207",2026,1667,1659,12,8,"Cs",23
25,"25004",582,437,432,3,5,"Cs",12
43,"43076",454,336,335,1,1,"Cs",3
8,"8012",1726,1323,1309,17,14,"Cs",26
17,"17209",615,472,471,5,1,"Cs",26
8,"8108",5181,3880,3861,30,19,"Cs",311
25,"25051",1522,1066,1059,6,7,"Cs",33
8,"8051",18570,14112,14054,86,58,"Cs",745
8,"8140",4816,3541,3520,25,21,"Cs",114
8,"8130",110,81,81,2,0,"Cs",1
8,"8195",75,62,62,0,0,"Cs",0
8,"8096",43926,32120,31960,217,160,"Cs",1998
17,"17016",737,570,563,2,7,"Cs",16
17,"17184",1261,1016,1010,7,6,"Cs",8
8,"8163",19672,13421,13364,70,57,"Cs",790
43,"43121",593,404,403,1,1,"Cs",2
8,"8236",1564,1145,1133,4,12,"Cs",16
43,"43047",4234,2590,2564,19,26,"Cs",175
8,"8050",139,118,115,4,3,"Cs",2
25,"25254",704,511,508,2,3,"Cs",14
17,"17234",181,129,129,1,0,"Cs",8
43,"43158",74,52,50,0,2,"Cs",0
25,"25139",477,348,346,3,2,"Cs",8
8,"8169",48478,35283,35114,278,169,"Cs",2497
8,"8228",292,234,233,0,1,"Cs",9
43,"43009",1384,966,959,5,7,"Cs",37
25,"25063",84,52,51,0,1,"Cs",1
8,"8151",450,351,346,5,5,"Cs",5
8,"8022",12213,8594,8558,42,36,"Cs",196
17,"17220",801,649,647,2,2,"Cs",10
43,"43039",101,77,77,0,0,"Cs",2
43,"43125",884,658,645,12,13,"Cs",15
43,"43074",1818,1341,1336,2,5,"Cs",47
8,"8176",158,119,119,0,0,"Cs",0
8,"8040",11116,7923,7891,49,32,"Cs",308
17,"17061",180,141,139,1,2,"Cs",2
17,"17067",704,551,549,6,2,"Cs",9
17,"17188",171,134,134,1,0,"Cs",1
8,"8098",2438,1781,1778,21,3,"Cs",85
43,"43079",364,290,289,2,1,"Cs",3
43,"43119",849,591,588,8,3,"Cs",36
17,"17204",609,429,428,6,1,"Cs",19
8,"8066",1466,1109,1104,7,5,"Cs",56
17,"17038",377,303,301,0,2,"Cs",7
17,"17065",321,264,263,3,1,"Cs",1
25,"25043",800,584,581,2,3,"Cs",9
8,"8259",6979,5362,5341,27,21,"Cs",172
43,"43126",1230,937,933,3,4,"Cs",28
8,"8307",49499,35471,35312,199,159,"Cs",2021
25,"25115",803,601,593,4,8,"Cs",9
8,"8281",4858,3783,3762,19,21,"Cs",164
43,"43146",40,32,32,0,0,"Cs",0
8,"8106",7500,5442,5410,43,32,"Cs",309
25,"25234",4139,2786,2772,13,14,"Cs",84
8,"8284",12597,8244,8183,60,61,"Cs",471
8,"8213",6600,4925,4906,30,19,"Cs",188
17,"17036",2639,1944,1934,21,10,"Cs",48
8,"8264",4608,3459,3444,30,15,"Cs",206
8,"8175",3369,2388,2372,18,16,"Cs",47
43,"43170",877,664,661,4,3,"Cs",13
17,"17022",7043,4940,4903,34,37,"Cs",97
25,"25113",1114,873,863,3,10,"Cs",18
43,"43056",803,566,558,6,8,"Cs",11
8,"8120",7129,5649,5621,51,28,"Cs",174
25,"25050",3256,2260,2249,20,11,"Cs",41
43,"43064",2027,1456,1445,19,11,"Cs",50
8,"8199",648,509,508,3,1,"Cs",12
17,"17197",128,97,97,0,0,"Cs",3
8,"8102",28940,21108,21014,157,94,"Cs",891
17,"17177",562,426,423,1,3,"Cs",6
17,"17032",1745,1139,1133,6,6,"Cs",30
17,"17227",147,104,104,0,0,"Cs",6
8,"8905",2329,1872,1863,7,9,"Cs",76
43,"43014",14386,9542,9464,74,78,"Cs",284
25,"25223",890,673,666,7,7,"Cs",3
8,"8217",25466,19864,19773,129,91,"Cs",1462
25,"25003",3717,2577,2561,15,16,"Cs",79
8,"8048",580,427,426,1,1,"Cs",15
8,"8115",3826,2777,2770,31,7,"Cs",162
17,"17107",267,207,205,2,2,"Cs",3
25,"25225",531,395,393,0,2,"Cs",5
25,"25047",956,745,736,14,9,"Cs",4
17,"17150",1444,1177,1163,13,14,"Cs",26
8,"8177",36,27,27,1,0,"Cs",0
8,"8157",8574,6514,6472,47,42,"Cs",469
25,"25163",230,162,161,0,1,"Cs",2
25,"25904",160,134,133,2,1,"Cs",3
8,"8026",195,148,146,0,2,"Cs",0
43,"43140",2433,1685,1674,11,11,"Cs",159
25,"25248",870,676,675,5,1,"Cs",4
8,"8127",2254,1548,1544,10,4,"Cs",51
8,"8116",557,449,449,1,0,"Cs",8
25,"25133",671,481,479,1,2,"Cs",8
43,"43044",3962,2751,2719,33,32,"Cs",122
25,"25101",536,412,411,5,1,"Cs",0
25,"25031",57,32,32,0,0,"Cs",6
43,"43068",484,322,317,2,5,"Cs",8
25,"25078",995,746,743,7,3,"Cs",12
17,"17166",547,442,440,0,2,"Cs",0
8,"8279",156327,112605,112030,952,575,"Cs",7212
25,"25242",688,494,488,5,6,"Cs",6
8,"8242",223,159,159,0,0,"Cs",0
8,"8101",175048,121359,120620,830,739,"Cs",8791
25,"25035",364,257,256,0,1,"Cs",12
8,"8179",636,466,465,2,1,"Cs",18
43,"43032",462,354,350,2,4,"Cs",6
43,"43008",305,171,171,7,0,"Cs",1
25,"25149",1377,1034,1028,9,6,"Cs",18
25,"25093",629,455,443,5,12,"Cs",14
17,"17034",7289,4880,4862,23,18,"Cs",168
8,"8273",2390,1871,1855,14,16,"Cs",30
43,"43066",158,108,108,1,0,"Cs",1
25,"25230",1541,1105,1099,9,6,"Cs",34
8,"8063",469,390,390,4,0,"Cs",6
17,"17217",350,287,284,0,3,"Cs",6
25,"25209",1586,1115,1102,6,13,"Cs",30
25,"25001",143,102,102,1,0,"Cs",2
43,"43095",2583,1864,1854,12,10,"Cs",138
17,"17221",4138,2999,2988,23,11,"Cs",173
43,"43123",71435,49166,48873,318,293,"Cs",3223
43,"43104",1767,1285,1271,4,14,"Cs",23
25,"25243",3729,2370,2349,33,21,"Cs",164
43,"43105",155,126,123,4,3,"Cs",1
8,"8158",3094,2261,2251,11,10,"Cs",134
8,"8084",1172,902,894,9,8,"Cs",19
8,"8027",724,584,582,1,2,"Cs",29
43,"43114",370,281,278,1,3,"Cs",1
8,"8135",6770,5187,5158,42,29,"Cs",333
25,"25151",731,555,549,1,6,"Cs",15
17,"17201",137,103,103,0,0,"Cs",1
43,"43108",1787,1293,1282,6,11,"Cs",64
25,"25177",356,252,250,1,2,"Cs",4
43,"43106",784,605,598,3,7,"Cs",15
17,"17003",103,85,85,0,0,"Cs",0
17,"17068",253,191,191,0,0,"Cs",5
43,"43129",4607,3284,3261,21,23,"Cs",119
17,"17147",7916,5672,5641,41,31,"Cs",181
17,"17025",1182,943,938,5,5,"Cs",15
8,"8105",9741,6946,6896,62,50,"Cs",530
43,"43019",1332,911,904,8,7,"Cs",38
17,"17020",3677,2851,2835,14,16,"Cs",55
8,"8143",2727,1989,1977,19,12,"Cs",96
8,"8060",139,110,108,1,2,"Cs",1
25,"25232",1357,1012,1007,6,5,"Cs",18
8,"8267",6789,4975,4935,41,40,"Cs",224
25,"25179",169,132,132,0,0,"Cs",2
17,"17075",340,257,256,2,1,"Cs",5
17,"17214",714,516,511,6,5,"Cs",15
25,"25908",217,136,136,0,0,"Cs",2
8,"8002",217,172,172,2,0,"Cs",2
43,"43046",88,69,68,1,1,"Cs",0
8,"8275",247,218,218,3,0,"Cs",1
17,"17010",332,252,251,2,1,"Cs",1
8,"8090",142,116,116,0,0,"Cs",1
43,"43162",4436,3191,3163,24,28,"Cs",243
43,"43151",107,88,88,0,0,"Cs",2
8,"8187",153822,113081,112470,758,611,"Cs",6749
25,"25210",1073,791,780,3,11,"Cs",13
43,"43145",4209,3193,3170,17,23,"Cs",102
25,"25120",92888,62740,62389,450,351,"Cs",3257
25,"25027",978,695,690,3,5,"Cs",35
25,"25055",163,114,114,0,0,"Cs",0
17,"17103",5057,3196,3174,21,22,"Cs",185
43,"43178",1435,1071,1066,2,5,"Cs",47
43,"43103",908,705,701,9,4,"Cs",57
25,"25110",2745,1943,1927,13,16,"Cs",51
8,"8246",1692,1345,1340,7,5,"Cs",17
43,"43161",17103,11905,11838,82,67,"Cs",548
25,"25023",4560,3350,3334,24,16,"Cs",153
43,"43061",40,27,27,3,0,"Cs",0
17,"17155",14957,9519,9410,71,109,"Cs",411
8,"8094",1588,1258,1252,7,6,"Cs",40
25,"25123",189,135,133,0,2,"Cs",3
8,"8901",240,200,195,2,5,"Cs",2
17,"17228",285,218,217,0,1,"Cs",7
43,"43167",391,307,307,2,0,"Cs",4
17,"17019",1780,1403,1393,5,10,"Cs",22
43,"43045",143,114,113,0,1,"Cs",1
25,"25073",559,377,377,2,0,"Cs",7
43,"43073",80,67,65,0,2,"Cs",3
8,"8269",2729,2114,2105,9,9,"Cs",40
8,"8138",4461,3286,3259,27,27,"Cs",81
17,"17208",978,723,719,6,4,"Cs",11
8,"8194",25680,16465,16376,131,89,"Cs",1306
17,"17106",142,114,114,0,0,"Cs",1
8,"8078",216,154,154,2,0,"Cs",1
8,"8285",10349,7630,7599,48,31,"Cs",216
8,"8123",19570,15378,15316,91,62,"Cs",722
8,"8216",25,17,17,0,0,"Cs",0
8,"8131",745,552,550,3,2,"Cs",9
17,"17116",351,261,261,2,0,"Cs",3
8,"8224",885,653,652,6,1,"Cs",16
8,"8109",207,176,174,0,2,"Cs",1
8,"8071",249,209,208,0,1,"Cs",4
8,"8192",5701,4366,4349,15,17,"Cs",138
8,"8147",17389,12679,12601,102,78,"Cs",823
25,"25044",178,144,142,0,2,"Cs",4
17,"17057",968,770,769,7,1,"Cs",9
43,"43026",756,576,574,1,2,"Cs",15
43,"43017",112,94,94,1,0,"Cs",2
43,"43166",1646,1183,1176,4,7,"Cs",56
8,"8031",2339,1760,1750,15,10,"Cs",36
25,"25045",57,26,26,2,0,"Cs",0
25,"25157",159,127,126,1,1,"Cs",4
25,"25202",108,72,72,2,0,"Cs",0
8,"8299",380,301,300,4,1,"Cs",1
43,"43903",2332,1502,1487,18,15,"Cs",43
8,"8125",25583,18334,18225,122,109,"Cs",1258
25,"25138",558,427,424,2,3,"Cs",4
8,"8184",55053,38519,38323,298,196,"Cs",2714
17,"17121",225,166,163,2,3,"Cs",1
8,"8089",34190,24548,24404,194,144,"Cs",1965
8,"8079",333,260,258,2,2,"Cs",5
8,"8016",1803,1371,1363,11,8,"Cs",47
17,"17062",5982,4025,4001,19,24,"Cs",181
17,"17902",1294,992,990,9,2,"Cs",22
17,"17153",189,150,149,1,1,"Cs",1
17,"17139",1407,1128,1119,8,9,"Cs",19
25,"25121",632,380,374,3,6,"Cs",18
17,"17071",1134,943,940,1,3,"Cs",11
25,"25208",337,242,241,2,1,"Cs",0
25,"25905",366,281,276,4,5,"Cs",7
43,"43112",245,179,179,3,0,"Cs",1
43,"43077",453,306,304,1,2,"Cs",14
17,"17158",565,296,295,2,1,"Cs",11
25,"25062",691,498,491,4,7,"Cs",10
8,"8020",5243,4117,4100,29,17,"Cs",207
8,"8134",848,618,609,4,9,"Cs",15
8,"8303",257,207,205,1,2,"Cs",4
8,"8204",3141,2395,2383,16,12,"Cs",111
25,"25228",3143,2261,2250,18,11,"Cs",92
25,"25252",553,380,379,2,1,"Cs",12
43,"43078",835,610,605,7,5,"Cs",23
17,"17176",128,111,111,0,0,"Cs",3
43,"43163",26162,17276,17128,98,148,"Cs",1192
43,"43034",465,365,365,5,0,"Cs",11
17,"17076",119,95,94,2,1,"Cs",0
17,"17079",65572,47740,47502,279,238,"Cs",1862
43,"43160",1324,967,956,6,11,"Cs",50
8,"8068",6863,5064,5041,40,23,"Cs",308
17,"17136",196,150,150,0,0,"Cs",0
8,"8150",258,207,207,1,0,"Cs",3
17,"17021",119,89,87,0,2,"Cs",0
8,"8258",815,636,632,5,4,"Cs",2
17,"17152",11065,6959,6927,68,32,"Cs",510
25,"25135",997,675,671,3,4,"Cs",6
17,"17222",104,87,87,1,0,"Cs",0
43,"43052",927,680,674,7,6,"Cs",8
8,"8122",1733,1179,1175,4,4,"Cs",37
25,"25197",140,109,109,0,0,"Cs",2
8,"8153",573,457,452,3,5,"Cs",6
43,"43137",1890,1373,1353,8,20,"Cs",90
17,"17027",2857,2236,2229,9,7,"Cs",38
8,"8039",413,322,321,1,1,"Cs",3
17,"17195",338,274,272,1,2,"Cs",1
25,"25118",326,223,218,0,5,"Cs",3
17,"17138",836,591,584,7,7,"Cs",23
8,"8218",8091,5899,5869,50,30,"Cs",300
25,"25240",1366,1030,1021,4,9,"Cs",23
8,"8059",340,255,250,1,5,"Cs",4
8,"8037",1947,1547,1543,11,4,"Cs",29
17,"17169",2511,1901,1890,8,11,"Cs",84
8,"8017",2808,2033,2016,16,17,"Cs",63
8,"8214",7007,5390,5371,25,19,"Cs",217
43,"43036",869,565,557,7,8,"Cs",27
25,"25075",132,101,101,0,0,"Cs",1
17,"17013",2765,1999,1985,15,14,"Cs",95
25,"25212",219,176,176,1,0,"Cs",2
17,"17001",575,428,426,4,2,"Cs",8
43,"43142",1069,783,774,3,9,"Cs",22
17,"17161",1023,844,843,5,1,"Cs",4
43,"43011",1086,862,860,5,2,"Cs",25
25,"25019",4606,2860,2829,19,31,"Cs",109
43,"43116",465,356,352,0,4,"Cs",1
17,"17143",145,104,104,0,0,"Cs",2
8,"8209",6925,4976,4948,39,28,"Cs",324
8,"8235",3875,3004,2996,19,8,"Cs",83
8,"8220",2411,2010,2001,8,9,"Cs",22
17,"17111",984,728,728,7,0,"Cs",22
25,"25190",262,202,202,2,0,"Cs",1
8,"8223",1897,1345,1341,10,4,"Cs",40
25,"25037",361,270,269,4,1,"Cs",1
8,"8018",2540,1862,1855,7,7,"Cs",81
17,"17100",193,147,141,0,6,"Cs",2
25,"25008",1081,803,799,4,4,"Cs",12
25,"25224",122,94,94,0,0,"Cs",0
8,"8091",5428,4048,4024,20,24,"Cs",178
25,"25094",138,96,93,2,3,"Cs",0
17,"17213",5567,3654,3630,19,24,"Cs",136
43,"43094",2143,1558,1541,6,17,"Cs",37
17,"17044",6938,5245,5212,33,33,"Cs",110
8,"8210",4640,3226,3200,24,26,"Cs",94
8,"8278",4925,3820,3804,22,16,"Cs",45
25,"25013",2099,1430,1414,13,16,"Cs",47
43,"43172",334,248,243,4,5,"Cs",9
25,"25064",96,78,78,0,0,"Cs",2
43,"43001",708,510,507,0,3,"Cs",19
25,"25245",427,312,308,4,4,"Cs",8
8,"8904",10516,7068,7025,54,43,"Cs",567
43,"43082",350,276,271,5,5,"Cs",6
43,"43109",2706,1751,1738,17,13,"Cs",158
8,"8077",34690,25896,25767,164,129,"Cs",1986
17,"17087",219,179,177,0,2,"Cs",3
25,"25911",419,298,297,3,1,"Cs",3
25,"25022",105,80,79,0,1,"Cs",0
8,"8280",93,76,75,1,1,"Cs",3
8,"8055",542,426,424,3,2,"Cs",10
8,"8162",2118,1581,1576,13,5,"Cs",66
25,"25902",536,406,403,1,3,"Cs",8
43,"43083",146,110,109,0,1,"Cs",6
8,"8085",986,769,767,6,2,"Cs",14
25,"25032",65,53,52,0,1,"Cs",1
43,"43048",768,564,554,7,10,"Cs",15
17,"17023",27314,18677,18546,117,131,"Cs",1235
25,"25206",247,188,188,2,0,"Cs",1
25,"25906",205,133,131,2,2,"Cs",5
8,"8113",52589,36864,36690,244,174,"Cs",1415
8,"8053",2896,1939,1929,13,10,"Cs",89
43,"43072",90,69,67,1,2,"Cs",2
25,"25221",115,82,81,1,1,"Cs",1
25,"25207",6443,4525,4492,31,33,"Cs",104
8,"8145",2712,2060,2049,8,11,"Cs",86
43,"43069",183,148,147,2,1,"Cs",3
17,"17901",987,733,725,5,8,"Cs",17
25,"25193",768,567,563,4,4,"Cs",4
25,"25185",680,452,451,0,1,"Cs",11
8,"8302",9359,6483,6430,78,53,"Cs",499
17,"17132",1344,1019,1009,12,10,"Cs",25
17,"17058",176,128,128,0,0,"Cs",1
8,"8023",7029,5027,5000,39,27,"Cs",276
17,"17083",2971,2164,2154,13,10,"Cs",79
25,"25103",133,88,87,0,1,"Cs",1
17,"17183",253,197,197,2,0,"Cs",4
17,"17005",457,322,320,3,2,"Cs",10
17,"17014",66,51,49,0,2,"Cs",4
25,"25913",88,72,72,1,0,"Cs",0
25,"25145",75,59,59,0,0,"Cs",1
8,"8044",4156,2991,2976,16,15,"Cs",150
8,"8126",8906,6673,6646,41,27,"Cs",469
43,"43138",2636,1761,1745,11,16,"Cs",58
43,"43059",250,193,192,1,1,"Cs",0
25,"25085",141,109,108,2,1,"Cs",4
8,"8057",61,47,47,1,0,"Cs",1
8,"8219",15755,12235,12206,72,29,"Cs",543
43,"43115",128,106,106,0,0,"Cs",1
43,"43033",766,555,555,4,0,"Cs",14
25,"25105",105,88,87,4,1,"Cs",2
43,"43165",571,469,467,2,2,"Cs",8
8,"8250",7235,4917,4876,41,41,"Cs",381
8,"8249",274,238,237,0,1,"Cs",6
8,"8189",119,96,96,1,0,"Cs",0
25,"25201",110,81,81,0,0,"Cs",2
17,"17232",146,111,111,0,0,"Cs",1
8,"8028",1125,744,743,7,1,"Cs",45
17,"17123",343,286,284,2,2,"Cs",1
43,"43031",1447,1085,1072,13,13,"Cs",33
43,"43136",10489,7029,6996,47,33,"Cs",195
8,"8212",491,393,386,6,7,"Cs",2
8,"8038",1541,1129,1120,6,9,"Cs",39
8,"8112",12926,9268,9230,61,38,"Cs",347
25,"25253",147,118,117,0,1,"Cs",3
17,"17189",1481,1228,1223,5,5,"Cs",12
8,"8074",11190,7698,7651,51,47,"Cs",567
25,"25098",227,160,158,1,2,"Cs",2
17,"17018",494,377,372,4,5,"Cs",11
8,"8165",1680,1177,1171,7,6,"Cs",44
8,"8253",132,103,102,0,1,"Cs",0
43,"43067",526,426,424,3,2,"Cs",6
17,"17162",153,106,105,1,1,"Cs",1
25,"25005",269,193,193,3,0,"Cs",2
25,"25086",525,410,407,3,3,"Cs",6
17,"17089",5749,3973,3949,17,24,"Cs",136
17,"17015",12829,9612,9580,51,32,"Cs",159
25,"25154",117,86,85,0,1,"Cs",0
43,"43058",95,78,78,0,0,"Cs",0
43,"43149",690,512,509,3,3,"Cs",15
8,"8036",163,122,122,0,0,"Cs",2
17,"17192",143,107,104,0,3,"Cs",3
8,"8144",722,551,545,3,6,"Cs",10
25,"25222",69,58,58,0,0,"Cs",0
8,"8045",65,44,43,0,1,"Cs",0
8,"8166",964,700,697,7,3,"Cs",22
8,"8182",2922,2041,2031,10,10,"Cs",138
8,"8251",5130,3719,3698,20,21,"Cs",259
8,"8161",11826,8001,7951,58,50,"Cs",445
43,"43065",379,281,277,4,4,"Cs",0
25,"25173",1646,1180,1169,6,11,"Cs",53
17,"17163",2868,2281,2268,13,13,"Cs",40
8,"8010",4224,3109,3090,22,19,"Cs",127
25,"25057",208,151,149,4,2,"Cs",15
43,"43150",1233,954,941,6,13,"Cs",12
17,"17011",645,518,514,10,4,"Cs",9
25,"25100",184,137,136,1,1,"Cs",2
25,"25150",167,132,130,2,2,"Cs",1
25,"25071",41,31,30,0,1,"Cs",0
8,"8008",175,136,136,2,0,"Cs",0
17,"17008",3605,2595,2577,8,18,"Cs",62
17,"17047",5016,3087,3068,22,19,"Cs",200
8,"8197",7986,5829,5805,37,24,"Cs",315
8,"8238",14946,11911,11873,85,38,"Cs",707
43,"43091",125,90,90,1,0,"Cs",1
8,"8190",255,184,182,1,2,"Cs",4
17,"17225",205,150,150,1,0,"Cs",4
43,"43038",22070,15127,15018,113,109,"Cs",1266
25,"25048",1641,1207,1194,13,13,"Cs",29
25,"25011",5271,3529,3505,21,24,"Cs",106
17,"17088",599,467,465,3,2,"Cs",8
43,"43088",2013,1429,1420,11,9,"Cs",51
17,"17033",5647,3879,3852,25,27,"Cs",145
25,"25129",161,113,112,0,1,"Cs",1
25,"25132",141,106,105,0,1,"Cs",2
8,"8230",7648,5797,5774,40,23,"Cs",390
8,"8041",10698,7324,7258,57,66,"Cs",536
8,"8170",442,322,320,0,2,"Cs",7
43,"43006",676,462,462,3,0,"Cs",11
8,"8056",42897,30873,30757,259,116,"Cs",2509
8,"8263",21208,15014,14890,111,124,"Cs",1156
17,"17146",3150,2243,2224,8,19,"Cs",81
8,"8067",5746,4299,4270,24,29,"Cs",121
8,"8141",4578,3369,3357,28,12,"Cs",95
25,"25175",173,119,119,2,0,"Cs",2
8,"8203",2466,1678,1675,7,3,"Cs",65
17,"17207",2420,1920,1901,9,19,"Cs",22
8,"8093",25,22,22,0,0,"Cs",0
25,"25127",217,145,145,1,0,"Cs",0
8,"8149",980,702,694,6,8,"Cs",13
17,"17052",135,93,92,0,1,"Cs",2
8,"8196",19542,14264,14185,123,79,"Cs",1086
8,"8025",1573,1170,1160,9,10,"Cs",35
17,"17040",551,440,439,5,1,"Cs",7
25,"25109",211,155,154,1,1,"Cs",0
8,"8255",133,100,100,2,0,"Cs",0
17,"17096",159,116,116,3,0,"Cs",2
17,"17031",178,117,117,0,0,"Cs",0
8,"8272",164,128,128,1,0,"Cs",1
43,"43002",1890,1233,1210,12,23,"Cs",103
43,"43028",2770,1784,1770,7,14,"Cs",84
8,"8119",6897,5096,5052,31,44,"Cs",346
43,"43020",2291,1712,1688,19,24,"Cs",130
43,"43096",97,76,76,0,0,"Cs",1
17,"17203",165,126,126,0,0,"Cs",2
17,"17135",393,307,303,0,4,"Cs",20
43,"43035",233,182,182,5,0,"Cs",5
25,"25143",82,63,62,0,1,"Cs",0
43,"43905",15100,9689,9630,43,59,"Cs",938
25,"25227",656,476,476,2,0,"Cs",9
17,"17233",2347,1853,1840,11,13,"Cs",32
17,"17181",3458,2454,2443,18,11,"Cs",135
17,"17124",1593,1163,1160,8,3,"Cs",25
17,"17039",1726,1306,1297,7,9,"Cs",25
25,"25166",170,131,130,2,1,"Cs",1
8,"8155",7056,5050,5011,38,39,"Cs",298
25,"25250",327,269,265,1,4,"Cs",1
17,"17051",202,161,160,0,1,"Cs",4
8,"8301",49348,36261,36045,292,216,"Cs",2988
25,"25174",390,312,312,1,0,"Cs",12
8,"8211",33934,26136,26000,198,136,"Cs",1992
17,"17211",837,677,674,6,3,"Cs",11
8,"8075",4144,2951,2943,20,8,"Cs",159
8,"8001",9097,6860,6818,39,42,"Cs",515
17,"17133",1262,976,964,7,12,"Cs",12
8,"8128",579,428,423,4,5,"Cs",7
43,"43007",631,479,474,1,5,"Cs",18
25,"25200",318,245,245,0,0,"Cs",3
8,"8304",822,655,655,5,0,"Cs",13
25,"25158",1605,1193,1180,8,13,"Cs",28
43,"43022",1436,1028,1024,13,4,"Cs",39
43,"43127",775,607,606,3,1,"Cs",19
25,"25053",1100,819,811,7,8,"Cs",17
8,"8291",4972,3531,3519,23,12,"Cs",215
25,"25020",270,202,201,2,1,"Cs",4
17,"17054",342,250,250,2,0,"Cs",10
8,"8065",1183,920,913,8,7,"Cs",20
8,"8142",136,117,117,3,0,"Cs",4
43,"43054",2807,1972,1957,14,15,"Cs",36
25,"25012",2349,1563,1556,17,7,"Cs",89
43,"43005",3677,2505,2493,17,12,"Cs",86
25,"25038",1478,1057,1048,10,9,"Cs",32
8,"8181",8133,5949,5924,31,25,"Cs",338
8,"8260",18515,13563,13487,84,76,"Cs",1074
25,"25233",289,219,218,6,1,"Cs",5
25,"25169",170,117,117,5,0,"Cs",5
8,"8293",227,177,177,0,0,"Cs",0
17,"17050",664,554,550,10,4,"Cs",8
17,"17216",158,122,121,0,1,"Cs",0
8,"8021",60,44,44,1,0,"Cs",0
8,"8261",2405,1726,1718,11,8,"Cs",159
17,"17098",308,232,230,4,2,"Cs",6
17,"17218",576,456,451,3,5,"Cs",5
25,"25104",120,88,88,0,0,"Cs",2
43,"43029",312,241,240,1,1,"Cs",2
43,"43155",22586,15295,15204,120,91,"Cs",584
25,"25040",10651,7041,6987,57,54,"Cs",222
8,"8295",11290,8091,8054,72,37,"Cs",566
43,"43156",3956,2812,2784,22,28,"Cs",127
43,"43101",146,112,112,2,0,"Cs",2
17,"17199",6984,4919,4894,39,25,"Cs",221
17,"17170",173,140,140,2,0,"Cs",2
43,"43159",76,60,60,0,0,"Cs",1
17,"17102",556,398,396,1,2,"Cs",4
17,"17202",3848,2632,2615,16,17,"Cs",134
8,"8234",3443,2561,2550,15,11,"Cs",115
8,"8052",140,102,102,1,0,"Cs",0
17,"17903",883,681,676,3,5,"Cs",18
8,"8206",744,604,599,5,5,"Cs",14
8,"8288",1696,1103,1096,9,7,"Cs",60
17,"17064",324,249,247,2,2,"Cs",6
8,"8152",117,94,94,0,0,"Cs",0
25,"25148",224,158,158,0,0,"Cs",5
43,"43131",4827,3134,3116,32,18,"Cs",275
43,"43081",629,500,499,2,1,"Cs",5
25,"25111",114,86,86,2,0,"Cs",1
8,"8237",1644,1263,1254,9,9,"Cs",13
8,"8300",5927,4609,4589,41,20,"Cs",308
43,"43157",339,279,279,1,0,"Cs",0
25,"25016",2083,1404,1399,3,5,"Cs",25
17,"17140",635,506,505,2,1,"Cs",19
17,"17215",2286,1855,1844,13,11,"Cs",55
17,"17042",410,299,297,5,2,"Cs",7
17,"17196",252,200,200,1,0,"Cs",14
17,"17154",101,76,76,0,0,"Cs",0
25,"25079",276,202,202,0,0,"Cs",1
8,"8019",1122912,824423,821037,5287,3386,"Cs",46485
25,"25059",800,546,534,5,12,"Cs",24
17,"17125",136,100,100,3,0,"Cs",0
43,"43041",216,156,156,2,0,"Cs",7
17,"17186",3834,2980,2954,17,26,"Cs",164
25,"25068",515,359,358,0,1,"Cs",9
8,"8276",241,179,179,3,0,"Cs",4
17,"17024",281,203,201,4,2,"Cs",0
8,"8049",1309,910,903,3,7,"Cs",13
25,"25097",89,71,71,2,0,"Cs",1
43,"43177",276,229,227,2,2,"Cs",4
25,"25030",117,76,76,0,0,"Cs",1
25,"25219",146,111,111,1,0,"Cs",4
17,"17144",211,162,159,3,3,"Cs",2
8,"8167",6056,4520,4500,38,20,"Cs",363
17,"17069",359,270,267,2,3,"Cs",11
43,"43018",384,297,297,2,0,"Cs",9
8,"8305",27661,20346,20221,118,125,"Cs",798
8,"8266",43422,32827,32696,241,131,"Cs",2298
8,"8274",4640,3385,3363,24,22,"Cs",134
8,"8118",17634,13450,13402,80,48,"Cs",582
43,"43122",112,91,91,1,0,"Cs",5
17,"17165",645,502,502,2,0,"Cs",7
17,"17055",142,124,124,0,0,"Cs",0
8,"8154",697,541,539,3,2,"Cs",15
8,"8015",156540,109145,108440,957,705,"Cs",6914
25,"25070",817,619,617,11,2,"Cs",12
25,"25041",525,375,370,4,5,"Cs",3
25,"25168",496,399,399,6,0,"Cs",9
25,"25217",10891,7651,7610,63,41,"Cs",219
17,"17060",409,300,298,1,2,"Cs",15
43,"43139",2007,1432,1419,9,13,"Cs",30
25,"25161",339,221,221,0,0,"Cs",2
8,"8136",11692,8527,8456,98,71,"Cs",678
25,"25081",281,195,193,3,2,"Cs",0
17,"17160",14756,9892,9852,58,40,"Cs",446
17,"17007",1763,1367,1359,9,8,"Cs",18
17,"17212",145,111,109,0,2,"Cs",0
17,"17043",165,133,133,0,0,"Cs",2
25,"25140",779,540,539,2,1,"Cs",12
43,"43175",534,363,359,5,4,"Cs",9
17,"17230",504,383,382,3,1,"Cs",21
17,"17114",23268,16423,16333,111,90,"Cs",411
8,"8296",1869,1412,1408,10,4,"Cs",65
8,"8137",272,208,207,2,1,"Cs",2
17,"17080",144,113,113,1,0,"Cs",6
43,"43023",211,171,169,2,2,"Cs",4
25,"25087",54,45,45,0,0,"Cs",0
17,"17094",1058,757,747,3,10,"Cs",19
43,"43012",3700,2882,2858,20,24,"Cs",165
17,"17004",529,411,410,3,1,"Cs",14
25,"25128",125,85,85,0,0,"Cs",1
8,"8243",154,125,125,2,0,"Cs",1
17,"17185",2260,1657,1652,8,5,"Cs",28
17,"17035",544,447,447,2,0,"Cs",6
8,"8007",6795,5099,5081,29,18,"Cs",143
8,"8226",929,748,747,10,1,"Cs",14
43,"43027",168,129,129,3,0,"Cs",1
43,"43132",375,295,291,1,4,"Cs",6
17,"17148",1550,1121,1114,15,7,"Cs",62
25,"25167",223,165,164,3,1,"Cs",1
17,"17085",293,239,238,0,1,"Cs",3
8,"8087",144,120,120,0,0,"Cs",2
25,"25119",2258,1701,1686,11,15,"Cs",25
25,"25909",138,99,98,2,1,"Cs",3
8,"8081",349,274,270,0,4,"Cs",4
8,"8188",115,89,89,0,0,"Cs",2
43,"43099",284,214,214,4,0,"Cs",3
8,"8215",2617,1954,1946,22,8,"Cs",51
43,"43147",528,425,420,3,5,"Cs",4
17,"17180",8508,5977,5953,38,24,"Cs",154
25,"25196",108,75,75,1,0,"Cs",0
8,"8099",753,529,529,4,0,"Cs",9
8,"8029",3586,2868,2862,20,6,"Cs",136
8,"8086",14137,9971,9912,77,59,"Cs",688
25,"25186",207,162,161,0,1,"Cs",3
8,"8229",521,418,417,3,1,"Cs",6
17,"17112",198,148,147,3,1,"Cs",5
25,"25072",5881,4059,4031,30,28,"Cs",109
25,"25089",93,70,68,1,2,"Cs",1
25,"25164",353,259,255,0,4,"Cs",5
17,"17093",913,637,634,5,3,"Cs",24
17,"17048",6284,4077,4048,34,29,"Cs",230
17,"17174",164,130,130,4,0,"Cs",2
25,"25131",394,281,279,3,2,"Cs",3
25,"25017",228,175,174,0,1,"Cs",0
25,"25076",131,91,91,0,0,"Cs",0
17,"17141",6019,3855,3833,43,22,"Cs",180
43,"43050",2695,1742,1730,10,12,"Cs",99
25,"25074",179,155,151,2,4,"Cs",2
8,"8287",1067,853,844,4,9,"Cs",23
25,"25124",160,102,101,1,1,"Cs",3
8,"8306",535,368,368,5,0,"Cs",21
43,"43049",727,557,555,3,2,"Cs",5
17,"17205",209,167,166,0,1,"Cs",1
8,"8083",1672,1433,1430,6,3,"Cs",20
25,"25056",209,145,145,0,0,"Cs",0
8,"8058",1808,1280,1262,6,18,"Cs",69
25,"25126",281,211,210,1,1,"Cs",4
17,"17129",143,108,108,2,0,"Cs",5
8,"8227",2420,1775,1769,11,6,"Cs",64
8,"8072",10769,7632,7600,56,32,"Cs",432
25,"25244",374,275,270,1,5,"Cs",5
8,"8180",27198,19822,19704,160,118,"Cs",1510
8,"8121",87515,62961,62574,429,387,"Cs",4110
17,"17226",884,603,600,4,3,"Cs",58
17,"17073",1939,1649,1640,11,9,"Cs",48
17,"17159",622,459,459,1,0,"Cs",8
43,"43003",349,257,255,3,2,"Cs",16
8,"8117",2489,1954,1941,21,13,"Cs",51
43,"43089",279,201,201,1,0,"Cs",5
25,"25033",1120,838,831,5,7,"Cs",16
8,"8268",975,729,723,6,6,"Cs",31
8,"8129",486,399,398,0,1,"Cs",11
17,"17084",228,163,162,1,1,"Cs",1
17,"17082",435,308,307,1,1,"Cs",9
8,"8082",1164,796,780,5,16,"Cs",66
17,"17091",391,296,290,3,6,"Cs",5
8,"8205",61957,49325,49196,441,129,"Cs",2758
43,"43057",38,32,32,1,0,"Cs",0
25,"25152",148,106,106,0,0,"Cs",4
17,"17115",276,208,208,4,0,"Cs",7
17,"17119",71,53,52,3,1,"Cs",0
25,"25122",1929,1408,1398,21,10,"Cs",38
43,"43169",445,388,388,3,0,"Cs",6
17,"17028",297,216,214,2,2,"Cs",3
8,"8289",4473,3379,3371,25,8,"Cs",145
8,"8014",2013,1526,1521,4,5,"Cs",37
17,"17118",12934,8723,8665,38,58,"Cs",455
8,"8073",62934,45699,45407,281,292,"Cs",3381
43,"43025",591,448,443,4,5,"Cs",10
8,"8148",2344,1655,1646,13,9,"Cs",104
17,"17074",536,403,401,1,2,"Cs",19
43,"43143",50,40,39,0,1,"Cs",0
17,"17126",316,269,269,1,0,"Cs",0
43,"43085",237,190,185,1,5,"Cs",3
8,"8061",1628,1154,1151,15,3,"Cs",50
8,"8172",20543,15191,15140,85,51,"Cs",915
25,"25156",765,571,567,3,4,"Cs",9
17,"17178",1065,774,771,9,3,"Cs",23
8,"8283",6165,4546,4524,33,22,"Cs",86
8,"8174",388,322,318,2,4,"Cs",14
25,"25211",680,470,470,3,0,"Cs",8
43,"43060",2672,2032,2015,7,17,"Cs",44
25,"25170",262,210,210,1,0,"Cs",0
8,"8193",988,739,737,10,2,"Cs",19
8,"8095",66,49,49,0,0,"Cs",1
25,"25215",339,249,249,5,0,"Cs",14
43,"43113",387,305,303,1,2,"Cs",13
25,"25009",596,448,442,1,6,"Cs",9
8,"8271",66,48,47,2,1,"Cs",1
25,"25082",292,197,197,2,0,"Cs",3
8,"8064",1956,1439,1423,7,16,"Cs",27
8,"8043",3414,2429,2422,15,7,"Cs",155
25,"25189",2181,1468,1461,11,7,"Cs",57
25,"25251",708,526,524,1,2,"Cs",11
17,"17168",373,309,308,3,1,"Cs",5
25,"25096",885,597,591,2,6,"Cs",10
25,"25181",172,137,137,1,0,"Cs",3
8,"8245",77841,53719,53443,430,276,"Cs",4094
25,"25176",307,241,238,3,3,"Cs",6
17,"17117",14497,9438,9382,66,56,"Cs",428
43,"43117",147,119,119,0,0,"Cs",5
17,"17167",2585,2015,1998,11,17,"Cs",26
8,"8009",9531,7200,7171,47,29,"Cs",381
8,"8244",6099,4733,4706,39,27,"Cs",326
25,"25034",2271,1616,1600,12,16,"Cs",31
25,"25204",1187,858,849,13,9,"Cs",16
17,"17101",566,389,382,1,7,"Cs",11
43,"43904",2864,1881,1851,20,30,"Cs",44
8,"8159",14343,10656,10603,87,53,"Cs",639
25,"25155",616,446,443,2,3,"Cs",3
17,"17193",4351,2945,2927,21,18,"Cs",173
43,"43128",910,665,658,6,7,"Cs",25
8,"8178",444,363,361,2,2,"Cs",14
43,"43030",483,356,351,2,5,"Cs",12
25,"25010",194,138,136,0,2,"Cs",3
8,"8200",62225,45235,44991,306,244,"Cs",3217
25,"25099",1285,908,904,6,4,"Cs",15
8,"8042",2390,1772,1764,12,8,"Cs",115
8,"8080",40,27,27,3,0,"Cs",0
25,"25171",2117,1539,1534,5,5,"Cs",28
8,"8198",4679,3491,3469,12,22,"Cs",144
43,"43097",407,331,328,4,3,"Cs",8
25,"25007",1378,1010,999,12,11,"Cs",41
25,"25146",223,158,155,3,3,"Cs",8
8,"8171",2046,1520,1510,13,10,"Cs",32
25,"25025",1362,909,898,15,11,"Cs",56
17,"17110",1332,990,981,3,9,"Cs",40
8,"8111",216,195,194,2,1,"Cs",2
8,"8257",103,82,82,0,0,"Cs",0
8,"8298",27148,19655,19568,102,87,"Cs",510
17,"17063",179,153,149,0,4,"Cs",3
8,"8076",16526,11988,11893,90,95,"Cs",671
43,"43051",9194,6133,6048,44,85,"Cs",536
43,"43070",243,194,193,0,1,"Cs",0
8,"8231",21269,14655,14573,111,82,"Cs",962
25,"25137",8684,5802,5757,48,45,"Cs",151
17,"17002",578,477,474,2,3,"Cs",16
25,"25036",180,124,124,1,0,"Cs",3
25,"25220",991,768,762,1,6,"Cs",8
17,"17081",252,186,185,2,1,"Cs",2
17,"17030",654,460,459,1,1,"Cs",22
8,"8286",2943,2051,2042,12,9,"Cs",126
43,"43135",339,255,255,0,0,"Cs",5
43,"43148",91182,65076,64756,441,320,"Cs",5113
8,"8294",2093,1546,1534,11,12,"Cs",47
8,"8103",652,476,474,1,2,"Cs",15
25,"25006",319,229,229,2,0,"Cs",4
25,"25112",269,205,200,2,5,"Cs",6
8,"8107",11965,8604,8554,67,50,"Cs",618
17,"17090",539,440,440,2,0,"Cs",9
17,"17149",370,302,300,1,2,"Cs",2
8,"8003",7213,5425,5409,41,16,"Cs",302
8,"8133",123,96,94,5,2,"Cs",2
25,"25014",246,184,178,0,6,"Cs",0
8,"8903",201,181,181,1,0,"Cs",0
43,"43043",3317,2457,2445,12,12,"Cs",163
8,"8110",13671,9362,9311,60,51,"Cs",490
8,"8088",12347,9316,9270,75,46,"Cs",386
43,"43016",3470,2547,2508,15,39,"Cs",164
17,"17120",823,560,558,5,2,"Cs",17
43,"43086",5252,3811,3790,28,21,"Cs",112
25,"25255",390,301,301,0,0,"Cs",14
17,"17175",559,348,343,5,5,"Cs",20
17,"17145",1410,1040,1032,6,8,"Cs",31
8,"8104",657,496,493,4,3,"Cs",5
25,"25002",465,324,323,4,1,"Cs",4
25,"25136",95,74,74,2,0,"Cs",2
43,"43174",144,118,114,0,4,"Cs",3
17,"17130",325,270,270,1,0,"Cs",3
43,"43090",1199,689,686,5,3,"Cs",42
17,"17194",73,56,56,0,0,"Cs",2
8,"8265",1597,1262,1260,4,2,"Cs",13
8,"8156",11254,8440,8411,58,29,"Cs",576
43,"43128",910,665,658,6,7,"CUP-PR",51
25,"25093",629,455,443,5,12,"CUP-PR",17
25,"25249",176,129,127,2,2,"CUP-PR",19
43,"43074",1818,1341,1336,2,5,"CUP-PR",118
8,"8302",9359,6483,6430,78,53,"CUP-PR",206
8,"8136",11692,8527,8456,98,71,"CUP-PR",245
8,"8063",469,390,390,4,0,"CUP-PR",38
8,"8040",11116,7923,7891,49,32,"CUP-PR",619
43,"43119",849,591,588,8,3,"CUP-PR",55
43,"43027",168,129,129,3,0,"CUP-PR",5
43,"43045",143,114,113,0,1,"CUP-PR",9
25,"25180",227,158,155,1,3,"CUP-PR",0
43,"43171",14849,10140,10081,76,59,"CUP-PR",238
43,"43010",334,262,262,2,0,"CUP-PR",18
8,"8113",52589,36864,36690,244,174,"CUP-PR",3300
25,"25039",259,197,196,7,1,"CUP-PR",27
8,"8280",93,76,75,1,1,"CUP-PR",9
25,"25153",190,139,136,0,3,"CUP-PR",7
43,"43176",746,564,561,2,3,"CUP-PR",37
8,"8251",5130,3719,3698,20,21,"CUP-PR",152
25,"25088",96,73,73,0,0,"CUP-PR",0
8,"8231",21269,14655,14573,111,82,"CUP-PR",965
25,"25087",54,45,45,0,0,"CUP-PR",12
8,"8199",648,509,508,3,1,"CUP-PR",58
43,"43013",4406,3004,2975,19,29,"CUP-PR",167
8,"8236",1564,1145,1133,4,12,"CUP-PR",110
43,"43159",76,60,60,0,0,"CUP-PR",3
8,"8159",14343,10656,10603,87,53,"CUP-PR",491
17,"17061",180,141,139,1,2,"CUP-PR",16
25,"25029",1590,1190,1185,4,5,"CUP-PR",99
17,"17038",377,303,301,0,2,"CUP-PR",31
8,"8221",12793,10123,10079,73,44,"CUP-PR",733
17,"17049",3246,2527,2502,12,25,"CUP-PR",536
25,"25238",212,161,160,0,1,"CUP-PR",19
8,"8083",1672,1433,1430,6,3,"CUP-PR",201
43,"43109",2706,1751,1738,17,13,"CUP-PR",51
8,"8257",103,82,82,0,0,"CUP-PR",8
43,"43118",422,338,338,0,0,"CUP-PR",40
25,"25206",247,188,188,2,0,"CUP-PR",11
17,"17164",3918,2856,2838,17,18,"CUP-PR",359
8,"8285",10349,7630,7599,48,31,"CUP-PR",980
17,"17013",2765,1999,1985,15,14,"CUP-PR",108
8,"8002",217,172,172,2,0,"CUP-PR",39
17,"17078",335,245,245,0,0,"CUP-PR",34
17,"17197",128,97,97,0,0,"CUP-PR",5
25,"25164",353,259,255,0,4,"CUP-PR",10
17,"17112",198,148,147,3,1,"CUP-PR",15
43,"43133",5627,3794,3773,31,21,"CUP-PR",236
8,"8298",27148,19655,19568,102,87,"CUP-PR",2268
43,"43177",276,229,227,2,2,"CUP-PR",25
43,"43102",458,331,324,2,7,"CUP-PR",15
25,"25905",366,281,276,4,5,"CUP-PR",21
25,"25076",131,91,91,0,0,"CUP-PR",9
25,"25060",71,42,42,0,0,"CUP-PR",5
8,"8282",6731,5333,5317,40,16,"CUP-PR",437
8,"8216",25,17,17,0,0,"CUP-PR",4
8,"8093",25,22,22,0,0,"CUP-PR",4
25,"25245",427,312,308,4,4,"CUP-PR",21
17,"17005",457,322,320,3,2,"CUP-PR",29
17,"17206",158,111,109,0,2,"CUP-PR",16
8,"8175",3369,2388,2372,18,16,"CUP-PR",269
25,"25209",1586,1115,1102,6,13,"CUP-PR",149
17,"17142",2713,2166,2159,18,7,"CUP-PR",212
8,"8297",138,99,99,0,0,"CUP-PR",6
43,"43163",26162,17276,17128,98,148,"CUP-PR",651
25,"25142",359,283,283,2,0,"CUP-PR",27
8,"8293",227,177,177,0,0,"CUP-PR",20
17,"17106",142,114,114,0,0,"CUP-PR",10
17,"17087",219,179,177,0,2,"CUP-PR",27
17,"17085",293,239,238,0,1,"CUP-PR",50
25,"25212",219,176,176,1,0,"CUP-PR",17
8,"8115",3826,2777,2770,31,7,"CUP-PR",113
17,"17028",297,216,214,2,2,"CUP-PR",21
25,"25101",536,412,411,5,1,"CUP-PR",41
8,"8060",139,110,108,1,2,"CUP-PR",21
8,"8109",207,176,174,0,2,"CUP-PR",58
8,"8225",94,83,82,1,1,"CUP-PR",9
8,"8044",4156,2991,2976,16,15,"CUP-PR",406
43,"43008",305,171,171,7,0,"CUP-PR",10
8,"8010",4224,3109,3090,22,19,"CUP-PR",416
43,"43071",896,652,647,3,5,"CUP-PR",69
25,"25911",419,298,297,3,1,"CUP-PR",35
17,"17025",1182,943,938,5,5,"CUP-PR",170
43,"43144",1245,975,966,1,9,"CUP-PR",108
8,"8178",444,363,361,2,2,"CUP-PR",47
8,"8106",7500,5442,5410,43,32,"CUP-PR",413
43,"43142",1069,783,774,3,9,"CUP-PR",64
25,"25208",337,242,241,2,1,"CUP-PR",61
17,"17213",5567,3654,3630,19,24,"CUP-PR",277
17,"17181",3458,2454,2443,18,11,"CUP-PR",118
17,"17010",332,252,251,2,1,"CUP-PR",50
17,"17169",2511,1901,1890,8,11,"CUP-PR",181
43,"43092",7308,4703,4679,33,24,"CUP-PR",192
8,"8055",542,426,424,3,2,"CUP-PR",57
25,"25217",10891,7651,7610,63,41,"CUP-PR",656
17,"17002",578,477,474,2,3,"CUP-PR",68
17,"17173",181,143,143,1,0,"CUP-PR",34
17,"17153",189,150,149,1,1,"CUP-PR",43
25,"25242",688,494,488,5,6,"CUP-PR",43
8,"8284",12597,8244,8183,60,61,"CUP-PR",426
17,"17114",23268,16423,16333,111,90,"CUP-PR",1582
25,"25004",582,437,432,3,5,"CUP-PR",30
43,"43046",88,69,68,1,1,"CUP-PR",6
8,"8054",9215,6994,6943,38,51,"CUP-PR",450
8,"8183",4573,3406,3398,14,8,"CUP-PR",397
43,"43156",3956,2812,2784,22,28,"CUP-PR",139
17,"17090",539,440,440,2,0,"CUP-PR",35
17,"17022",7043,4940,4903,34,37,"CUP-PR",619
17,"17182",269,195,195,0,0,"CUP-PR",5
43,"43019",1332,911,904,8,7,"CUP-PR",49
8,"8096",43926,32120,31960,217,160,"CUP-PR",1834
17,"17200",624,469,467,6,2,"CUP-PR",79
25,"25012",2349,1563,1556,17,7,"CUP-PR",84
8,"8011",1739,1360,1353,10,7,"CUP-PR",242
17,"17052",135,93,92,0,1,"CUP-PR",6
17,"17147",7916,5672,5641,41,31,"CUP-PR",386
43,"43080",230,192,192,2,0,"CUP-PR",20
8,"8262",6945,4649,4599,38,50,"CUP-PR",267
43,"43098",362,274,274,1,0,"CUP-PR",45
8,"8143",2727,1989,1977,19,12,"CUP-PR",114
25,"25196",108,75,75,1,0,"CUP-PR",6
17,"17016",737,570,563,2,7,"CUP-PR",66
43,"43075",86,65,63,0,2,"CUP-PR",1
43,"43161",17103,11905,11838,82,67,"CUP-PR",1120
25,"25052",1541,1183,1176,7,7,"CUP-PR",81
25,"25211",680,470,470,3,0,"CUP-PR",44
25,"25070",817,619,617,11,2,"CUP-PR",50
43,"43007",631,479,474,1,5,"CUP-PR",57
17,"17034",7289,4880,4862,23,18,"CUP-PR",339
8,"8103",652,476,474,1,2,"CUP-PR",66
17,"17207",2420,1920,1901,9,19,"CUP-PR",249
25,"25200",318,245,245,0,0,"CUP-PR",19
25,"25194",410,292,289,3,3,"CUP-PR",26
25,"25092",125,93,92,0,1,"CUP-PR",14
17,"17123",343,286,284,2,2,"CUP-PR",38
25,"25009",596,448,442,1,6,"CUP-PR",21
17,"17093",913,637,634,5,3,"CUP-PR",54
8,"8287",1067,853,844,4,9,"CUP-PR",94
43,"43044",3962,2751,2719,33,32,"CUP-PR",128
25,"25017",228,175,174,0,1,"CUP-PR",18
17,"17050",664,554,550,10,4,"CUP-PR",94
8,"8264",4608,3459,3444,30,15,"CUP-PR",197
17,"17214",714,516,511,6,5,"CUP-PR",43
25,"25042",204,149,149,5,0,"CUP-PR",8
25,"25223",890,673,666,7,7,"CUP-PR",87
17,"17188",171,134,134,1,0,"CUP-PR",32
8,"8182",2922,2041,2031,10,10,"CUP-PR",87
17,"17193",4351,2945,2927,21,18,"CUP-PR",202
17,"17174",164,130,130,4,0,"CUP-PR",26
8,"8305",27661,20346,20221,118,125,"CUP-PR",1980
43,"43904",2864,1881,1851,20,30,"CUP-PR",71
8,"8206",744,604,599,5,5,"CUP-PR",60
8,"8237",1644,1263,1254,9,9,"CUP-PR",160
43,"43089",279,201,201,1,0,"CUP-PR",17
8,"8201",455,319,318,12,1,"CUP-PR",28
25,"25082",292,197,197,2,0,"CUP-PR",6
8,"8050",139,118,115,4,3,"CUP-PR",12
8,"8101",175048,121359,120620,830,739,"CUP-PR",3580
25,"25902",536,406,403,1,3,"CUP-PR",46
43,"43178",1435,1071,1066,2,5,"CUP-PR",69
17,"17023",27314,18677,18546,117,131,"CUP-PR",693
43,"43093",3863,2728,2716,22,12,"CUP-PR",240
25,"25133",671,481,479,1,2,"CUP-PR",31
8,"8208",5793,4267,4244,21,23,"CUP-PR",239
25,"25172",1762,1332,1323,8,9,"CUP-PR",92
43,"43028",2770,1784,1770,7,14,"CUP-PR",114
8,"8067",5746,4299,4270,24,29,"CUP-PR",466
8,"8250",7235,4917,4876,41,41,"CUP-PR",183
8,"8247",982,799,798,4,1,"CUP-PR",133
25,"25228",3143,2261,2250,18,11,"CUP-PR",98
8,"8014",2013,1526,1521,4,5,"CUP-PR",127
8,"8193",988,739,737,10,2,"CUP-PR",64
43,"43135",339,255,255,0,0,"CUP-PR",35
25,"25059",800,546,534,5,12,"CUP-PR",11
8,"8098",2438,1781,1778,21,3,"CUP-PR",142
8,"8029",3586,2868,2862,20,6,"CUP-PR",220
8,"8169",48478,35283,35114,278,169,"CUP-PR",938
8,"8024",357,282,282,2,0,"CUP-PR",43
8,"8294",2093,1546,1534,11,12,"CUP-PR",171
25,"25111",114,86,86,2,0,"CUP-PR",8
8,"8904",10516,7068,7025,54,43,"CUP-PR",156
8,"8082",1164,796,780,5,16,"CUP-PR",34
8,"8275",247,218,218,3,0,"CUP-PR",42
17,"17128",321,239,238,1,1,"CUP-PR",35
43,"43059",250,193,192,1,1,"CUP-PR",27
17,"17099",78,55,55,0,0,"CUP-PR",8
8,"8019",1122912,824423,821037,5287,3386,"CUP-PR",57082
8,"8234",3443,2561,2550,15,11,"CUP-PR",263
17,"17105",248,187,186,2,1,"CUP-PR",36
8,"8218",8091,5899,5869,50,30,"CUP-PR",384
8,"8075",4144,2951,2943,20,8,"CUP-PR",185
25,"25050",3256,2260,2249,20,11,"CUP-PR",191
25,"25175",173,119,119,2,0,"CUP-PR",11
8,"8008",175,136,136,2,0,"CUP-PR",27
25,"25150",167,132,130,2,2,"CUP-PR",0
8,"8017",2808,2033,2016,16,17,"CUP-PR",198
17,"17066",27378,16755,16644,122,111,"CUP-PR",997
17,"17037",112,86,86,1,0,"CUP-PR",11
8,"8239",467,362,361,3,1,"CUP-PR",36
25,"25141",154,105,104,3,1,"CUP-PR",20
25,"25005",269,193,193,3,0,"CUP-PR",18
8,"8139",172,148,147,2,1,"CUP-PR",28
8,"8227",2420,1775,1769,11,6,"CUP-PR",211
25,"25006",319,229,229,2,0,"CUP-PR",17
8,"8271",66,48,47,2,1,"CUP-PR",16
25,"25032",65,53,52,0,1,"CUP-PR",5
43,"43155",22586,15295,15204,120,91,"CUP-PR",972
43,"43129",4607,3284,3261,21,23,"CUP-PR",257
17,"17224",299,226,222,2,4,"CUP-PR",29
43,"43099",284,214,214,4,0,"CUP-PR",11
17,"17209",615,472,471,5,1,"CUP-PR",37
17,"17205",209,167,166,0,1,"CUP-PR",19
25,"25232",1357,1012,1007,6,5,"CUP-PR",93
43,"43036",869,565,557,7,8,"CUP-PR",42
43,"43152",435,348,342,2,6,"CUP-PR",28
8,"8102",28940,21108,21014,157,94,"CUP-PR",1821
17,"17121",225,166,163,2,3,"CUP-PR",14
25,"25096",885,597,591,2,6,"CUP-PR",39
17,"17223",808,566,563,1,3,"CUP-PR",76
8,"8012",1726,1323,1309,17,14,"CUP-PR",190
25,"25122",1929,1408,1398,21,10,"CUP-PR",84
17,"17012",1175,845,842,4,3,"CUP-PR",41
17,"17095",20044,12638,12576,88,62,"CUP-PR",381
17,"17163",2868,2281,2268,13,13,"CUP-PR",309
25,"25041",525,375,370,4,5,"CUP-PR",32
25,"25173",1646,1180,1169,6,11,"CUP-PR",78
25,"25118",326,223,218,0,5,"CUP-PR",26
25,"25136",95,74,74,2,0,"CUP-PR",10
8,"8214",7007,5390,5371,25,19,"CUP-PR",466
8,"8252",24885,18507,18383,162,124,"CUP-PR",561
17,"17162",153,106,105,1,1,"CUP-PR",10
25,"25015",336,234,233,3,1,"CUP-PR",12
25,"25037",361,270,269,4,1,"CUP-PR",27
17,"17177",562,426,423,1,3,"CUP-PR",34
43,"43136",10489,7029,6996,47,33,"CUP-PR",473
17,"17146",3150,2243,2224,8,19,"CUP-PR",151
17,"17227",147,104,104,0,0,"CUP-PR",15
25,"25057",208,151,149,4,2,"CUP-PR",7
43,"43065",379,281,277,4,4,"CUP-PR",25
17,"17136",196,150,150,0,0,"CUP-PR",20
8,"8085",986,769,767,6,2,"CUP-PR",83
8,"8255",133,100,100,2,0,"CUP-PR",22
8,"8132",356,265,265,1,0,"CUP-PR",28
25,"25222",69,58,58,0,0,"CUP-PR",5
17,"17036",2639,1944,1934,21,10,"CUP-PR",197
8,"8007",6795,5099,5081,29,18,"CUP-PR",556
17,"17073",1939,1649,1640,11,9,"CUP-PR",191
8,"8097",1103,845,840,4,5,"CUP-PR",100
43,"43042",2215,1723,1710,18,13,"CUP-PR",127
17,"17081",252,186,185,2,1,"CUP-PR",24
43,"43147",528,425,420,3,5,"CUP-PR",43
8,"8202",12943,9408,9358,58,50,"CUP-PR",916
25,"25049",156,110,109,1,1,"CUP-PR",12
8,"8279",156327,112605,112030,952,575,"CUP-PR",5639
17,"17019",1780,1403,1393,5,10,"CUP-PR",109
8,"8092",3713,2758,2745,9,13,"CUP-PR",359
43,"43115",128,106,106,0,0,"CUP-PR",15
17,"17030",654,460,459,1,1,"CUP-PR",38
43,"43064",2027,1456,1445,19,11,"CUP-PR",112
25,"25125",383,265,265,3,0,"CUP-PR",16
43,"43122",112,91,91,1,0,"CUP-PR",8
43,"43157",339,279,279,1,0,"CUP-PR",32
43,"43078",835,610,605,7,5,"CUP-PR",27
8,"8195",75,62,62,0,0,"CUP-PR",5
8,"8072",10769,7632,7600,56,32,"CUP-PR",473
25,"25131",394,281,279,3,2,"CUP-PR",17
43,"43170",877,664,661,4,3,"CUP-PR",65
25,"25910",91,63,63,0,0,"CUP-PR",6
8,"8224",885,653,652,6,1,"CUP-PR",69
43,"43015",115,92,91,1,1,"CUP-PR",9
17,"17187",625,496,492,3,4,"CUP-PR",65
8,"8009",9531,7200,7171,47,29,"CUP-PR",709
25,"25219",146,111,111,1,0,"CUP-PR",20
25,"25061",80,51,51,0,0,"CUP-PR",3
25,"25138",558,427,424,2,3,"CUP-PR",18
8,"8244",6099,4733,4706,39,27,"CUP-PR",292
25,"25103",133,88,87,0,1,"CUP-PR",10
25,"25115",803,601,593,4,8,"CUP-PR",41
25,"25225",531,395,393,0,2,"CUP-PR",39
43,"43116",465,356,352,0,4,"CUP-PR",35
17,"17117",14497,9438,9382,66,56,"CUP-PR",546
8,"8270",19014,13635,13594,74,41,"CUP-PR",675
17,"17079",65572,47740,47502,279,238,"CUP-PR",5215
8,"8130",110,81,81,2,0,"CUP-PR",14
8,"8034",820,644,640,0,4,"CUP-PR",116
25,"25047",956,745,736,14,9,"CUP-PR",43
8,"8290",1549,1254,1248,6,6,"CUP-PR",136
8,"8207",2026,1667,1659,12,8,"CUP-PR",279
17,"17011",645,518,514,10,4,"CUP-PR",62
43,"43150",1233,954,941,6,13,"CUP-PR",87
8,"8090",142,116,116,0,0,"CUP-PR",5
8,"8261",2405,1726,1718,11,8,"CUP-PR",107
43,"43004",6288,4314,4262,36,52,"CUP-PR",302
25,"25234",4139,2786,2772,13,14,"CUP-PR",248
8,"8254",1766,1433,1427,16,6,"CUP-PR",238
17,"17024",281,203,201,4,2,"CUP-PR",16
8,"8308",139,109,109,1,0,"CUP-PR",12
8,"8123",19570,15378,15316,91,62,"CUP-PR",1273
8,"8041",10698,7324,7258,57,66,"CUP-PR",186
17,"17055",142,124,124,0,0,"CUP-PR",23
43,"43149",690,512,509,3,3,"CUP-PR",24
8,"8203",2466,1678,1675,7,3,"CUP-PR",137
25,"25100",184,137,136,1,1,"CUP-PR",16
25,"25161",339,221,221,0,0,"CUP-PR",32
43,"43162",4436,3191,3163,24,28,"CUP-PR",158
25,"25251",708,526,524,1,2,"CUP-PR",29
25,"25201",110,81,81,0,0,"CUP-PR",8
43,"43138",2636,1761,1745,11,16,"CUP-PR",70
43,"43016",3470,2547,2508,15,39,"CUP-PR",154
25,"25231",483,387,385,0,2,"CUP-PR",23
17,"17080",144,113,113,1,0,"CUP-PR",21
25,"25003",3717,2577,2561,15,16,"CUP-PR",128
17,"17903",883,681,676,3,5,"CUP-PR",54
25,"25033",1120,838,831,5,7,"CUP-PR",75
43,"43022",1436,1028,1024,13,4,"CUP-PR",43
25,"25135",997,675,671,3,4,"CUP-PR",33
25,"25240",1366,1030,1021,4,9,"CUP-PR",76
43,"43124",468,343,339,3,4,"CUP-PR",17
43,"43131",4827,3134,3116,32,18,"CUP-PR",65
25,"25134",605,457,456,5,1,"CUP-PR",21
25,"25068",515,359,358,0,1,"CUP-PR",24
17,"17094",1058,757,747,3,10,"CUP-PR",73
17,"17185",2260,1657,1652,8,5,"CUP-PR",138
8,"8211",33934,26136,26000,198,136,"CUP-PR",1072
43,"43123",71435,49166,48873,318,293,"CUP-PR",2903
8,"8105",9741,6946,6896,62,50,"CUP-PR",104
43,"43125",884,658,645,12,13,"CUP-PR",48
17,"17183",253,197,197,2,0,"CUP-PR",29
43,"43154",126,104,104,0,0,"CUP-PR",10
8,"8071",249,209,208,0,1,"CUP-PR",34
17,"17148",1550,1121,1114,15,7,"CUP-PR",76
17,"17217",350,287,284,0,3,"CUP-PR",101
17,"17145",1410,1040,1032,6,8,"CUP-PR",146
17,"17004",529,411,410,3,1,"CUP-PR",56
8,"8026",195,148,146,0,2,"CUP-PR",23
43,"43106",784,605,598,3,7,"CUP-PR",43
43,"43143",50,40,39,0,1,"CUP-PR",2
17,"17230",504,383,382,3,1,"CUP-PR",22
25,"25053",1100,819,811,7,8,"CUP-PR",45
17,"17140",635,506,505,2,1,"CUP-PR",46
17,"17063",179,153,149,0,4,"CUP-PR",31
25,"25099",1285,908,904,6,4,"CUP-PR",73
8,"8274",4640,3385,3363,24,22,"CUP-PR",262
43,"43030",483,356,351,2,5,"CUP-PR",17
43,"43173",98,70,68,0,2,"CUP-PR",25
25,"25121",632,380,374,3,6,"CUP-PR",7
25,"25139",477,348,346,3,2,"CUP-PR",37
8,"8045",65,44,43,0,1,"CUP-PR",10
25,"25254",704,511,508,2,3,"CUP-PR",27
25,"25046",410,331,326,4,5,"CUP-PR",56
25,"25056",209,145,145,0,0,"CUP-PR",10
17,"17058",176,128,128,0,0,"CUP-PR",18
43,"43032",462,354,350,2,4,"CUP-PR",20
8,"8256",693,542,542,3,0,"CUP-PR",42
25,"25220",991,768,762,1,6,"CUP-PR",53
43,"43104",1767,1285,1271,4,14,"CUP-PR",124
17,"17062",5982,4025,4001,19,24,"CUP-PR",360
43,"43011",1086,862,860,5,2,"CUP-PR",96
8,"8167",6056,4520,4500,38,20,"CUP-PR",100
17,"17020",3677,2851,2835,14,16,"CUP-PR",347
8,"8086",14137,9971,9912,77,59,"CUP-PR",518
8,"8278",4925,3820,3804,22,16,"CUP-PR",587
8,"8187",153822,113081,112470,758,611,"CUP-PR",7030
8,"8190",255,184,182,1,2,"CUP-PR",35
43,"43110",247,178,178,2,0,"CUP-PR",8
25,"25255",390,301,301,0,0,"CUP-PR",14
8,"8068",6863,5064,5041,40,23,"CUP-PR",284
25,"25098",227,160,158,1,2,"CUP-PR",18
8,"8036",163,122,122,0,0,"CUP-PR",8
17,"17047",5016,3087,3068,22,19,"CUP-PR",242
8,"8138",4461,3286,3259,27,27,"CUP-PR",428
8,"8146",1384,1030,1027,8,3,"CUP-PR",54
8,"8184",55053,38519,38323,298,196,"CUP-PR",1615
25,"25024",352,248,247,0,1,"CUP-PR",39
25,"25110",2745,1943,1927,13,16,"CUP-PR",150
25,"25163",230,162,161,0,1,"CUP-PR",14
8,"8233",1872,1428,1420,15,8,"CUP-PR",166
17,"17152",11065,6959,6927,68,32,"CUP-PR",217
17,"17003",103,85,85,0,0,"CUP-PR",16
25,"25177",356,252,250,1,2,"CUP-PR",17
25,"25130",181,130,128,0,2,"CUP-PR",28
43,"43107",387,285,285,3,0,"CUP-PR",22
17,"17196",252,200,200,1,0,"CUP-PR",29
17,"17160",14756,9892,9852,58,40,"CUP-PR",507
8,"8198",4679,3491,3469,12,22,"CUP-PR",377
25,"25145",75,59,59,0,0,"CUP-PR",6
8,"8125",25583,18334,18225,122,109,"CUP-PR",602
8,"8087",144,120,120,0,0,"CUP-PR",16
43,"43050",2695,1742,1730,10,12,"CUP-PR",49
43,"43101",146,112,112,2,0,"CUP-PR",20
8,"8047",3751,2600,2578,26,22,"CUP-PR",182
25,"25104",120,88,88,0,0,"CUP-PR",6
43,"43901",8796,5431,5390,41,41,"CUP-PR",222
17,"17195",338,274,272,1,2,"CUP-PR",44
43,"43094",2143,1558,1541,6,17,"CUP-PR",87
8,"8161",11826,8001,7951,58,50,"CUP-PR",438
25,"25903",226,169,169,1,0,"CUP-PR",18
25,"25102",647,484,482,5,2,"CUP-PR",23
8,"8005",6425,4830,4816,28,14,"CUP-PR",346
8,"8194",25680,16465,16376,131,89,"CUP-PR",461
8,"8070",269,215,211,1,4,"CUP-PR",35
8,"8230",7648,5797,5774,40,23,"CUP-PR",326
25,"25165",271,210,208,0,2,"CUP-PR",13
8,"8286",2943,2051,2042,12,9,"CUP-PR",123
43,"43121",593,404,403,1,1,"CUP-PR",49
25,"25221",115,82,81,1,1,"CUP-PR",15
8,"8277",168,148,146,1,2,"CUP-PR",23
8,"8300",5927,4609,4589,41,20,"CUP-PR",288
8,"8223",1897,1345,1341,10,4,"CUP-PR",138
8,"8032",2100,1472,1465,12,7,"CUP-PR",109
25,"25113",1114,873,863,3,10,"CUP-PR",66
25,"25114",96,83,82,1,1,"CUP-PR",2
17,"17190",834,624,619,1,5,"CUP-PR",93
25,"25907",500,366,364,5,2,"CUP-PR",43
25,"25002",465,324,323,4,1,"CUP-PR",44
17,"17201",137,103,103,0,0,"CUP-PR",13
17,"17168",373,309,308,3,1,"CUP-PR",52
25,"25913",88,72,72,1,0,"CUP-PR",6
43,"43070",243,194,193,0,1,"CUP-PR",34
8,"8307",49499,35471,35312,199,159,"CUP-PR",2792
8,"8170",442,322,320,0,2,"CUP-PR",40
17,"17044",6938,5245,5212,33,33,"CUP-PR",577
8,"8301",49348,36261,36045,292,216,"CUP-PR",756
25,"25064",96,78,78,0,0,"CUP-PR",16
8,"8179",636,466,465,2,1,"CUP-PR",27
25,"25191",321,227,222,2,5,"CUP-PR",23
43,"43158",74,52,50,0,2,"CUP-PR",3
8,"8151",450,351,346,5,5,"CUP-PR",42
25,"25067",702,500,494,8,6,"CUP-PR",29
43,"43112",245,179,179,3,0,"CUP-PR",39
8,"8027",724,584,582,1,2,"CUP-PR",60
17,"17150",1444,1177,1163,13,14,"CUP-PR",103
8,"8171",2046,1520,1510,13,10,"CUP-PR",174
25,"25127",217,145,145,1,0,"CUP-PR",23
8,"8020",5243,4117,4100,29,17,"CUP-PR",337
43,"43113",387,305,303,1,2,"CUP-PR",31
8,"8088",12347,9316,9270,75,46,"CUP-PR",1046
43,"43086",5252,3811,3790,28,21,"CUP-PR",327
17,"17082",435,308,307,1,1,"CUP-PR",14
8,"8142",136,117,117,3,0,"CUP-PR",20
17,"17170",173,140,140,2,0,"CUP-PR",21
43,"43066",158,108,108,1,0,"CUP-PR",6
17,"17067",704,551,549,6,2,"CUP-PR",64
17,"17120",823,560,558,5,2,"CUP-PR",22
43,"43057",38,32,32,1,0,"CUP-PR",5
43,"43905",15100,9689,9630,43,59,"CUP-PR",226
25,"25182",1043,763,760,8,3,"CUP-PR",59
17,"17216",158,122,121,0,1,"CUP-PR",25
8,"8131",745,552,550,3,2,"CUP-PR",62
8,"8004",208,177,177,1,0,"CUP-PR",44
8,"8269",2729,2114,2105,9,9,"CUP-PR",258
17,"17172",452,336,335,5,1,"CUP-PR",58
25,"25072",5881,4059,4031,30,28,"CUP-PR",310
17,"17077",565,395,394,2,1,"CUP-PR",30
43,"43067",526,426,424,3,2,"CUP-PR",25
17,"17141",6019,3855,3833,43,22,"CUP-PR",232
8,"8238",14946,11911,11873,85,38,"CUP-PR",830
8,"8127",2254,1548,1544,10,4,"CUP-PR",139
25,"25078",995,746,743,7,3,"CUP-PR",51
25,"25051",1522,1066,1059,6,7,"CUP-PR",128
43,"43009",1384,966,959,5,7,"CUP-PR",133
17,"17097",200,170,167,2,3,"CUP-PR",47
17,"17155",14957,9519,9410,71,109,"CUP-PR",771
8,"8048",580,427,426,1,1,"CUP-PR",51
43,"43906",2113,1490,1480,12,10,"CUP-PR",96
8,"8180",27198,19822,19704,160,118,"CUP-PR",697
17,"17109",704,542,539,2,3,"CUP-PR",106
8,"8226",929,748,747,10,1,"CUP-PR",120
43,"43024",1545,1019,1014,14,5,"CUP-PR",42
43,"43001",708,510,507,0,3,"CUP-PR",57
43,"43053",186,135,134,0,1,"CUP-PR",15
17,"17199",6984,4919,4894,39,25,"CUP-PR",521
25,"25124",160,102,101,1,1,"CUP-PR",11
17,"17133",1262,976,964,7,12,"CUP-PR",87
8,"8191",5302,3872,3860,21,12,"CUP-PR",379
25,"25203",8809,5813,5770,40,43,"CUP-PR",432
8,"8229",521,418,417,3,1,"CUP-PR",45
25,"25038",1478,1057,1048,10,9,"CUP-PR",34
17,"17178",1065,774,771,9,3,"CUP-PR",61
8,"8222",1821,1439,1424,7,15,"CUP-PR",143
43,"43031",1447,1085,1072,13,13,"CUP-PR",97
17,"17176",128,111,111,0,0,"CUP-PR",13
25,"25207",6443,4525,4492,31,33,"CUP-PR",459
8,"8124",37157,27139,26994,179,145,"CUP-PR",894
8,"8147",17389,12679,12601,102,78,"CUP-PR",779
8,"8192",5701,4366,4349,15,17,"CUP-PR",471
17,"17008",3605,2595,2577,8,18,"CUP-PR",294
8,"8084",1172,902,894,9,8,"CUP-PR",98
8,"8089",34190,24548,24404,194,144,"CUP-PR",649
8,"8077",34690,25896,25767,164,129,"CUP-PR",817
43,"43082",350,276,271,5,5,"CUP-PR",34
17,"17068",253,191,191,0,0,"CUP-PR",19
25,"25089",93,70,68,1,2,"CUP-PR",24
25,"25904",160,134,133,2,1,"CUP-PR",10
8,"8181",8133,5949,5924,31,25,"CUP-PR",362
17,"17144",211,162,159,3,3,"CUP-PR",16
25,"25014",246,184,178,0,6,"CUP-PR",19
17,"17171",177,138,137,0,1,"CUP-PR",24
25,"25227",656,476,476,2,0,"CUP-PR",56
8,"8059",340,255,250,1,5,"CUP-PR",37
43,"43100",3557,2666,2649,22,17,"CUP-PR",120
17,"17083",2971,2164,2154,13,10,"CUP-PR",169
17,"17232",146,111,111,0,0,"CUP-PR",16
8,"8240",9469,7351,7327,39,24,"CUP-PR",649
43,"43018",384,297,297,2,0,"CUP-PR",16
8,"8296",1869,1412,1408,10,4,"CUP-PR",70
8,"8243",154,125,125,2,0,"CUP-PR",15
8,"8267",6789,4975,4935,41,40,"CUP-PR",352
8,"8289",4473,3379,3371,25,8,"CUP-PR",337
8,"8164",936,750,747,6,3,"CUP-PR",94
8,"8163",19672,13421,13364,70,57,"CUP-PR",583
8,"8148",2344,1655,1646,13,9,"CUP-PR",80
8,"8133",123,96,94,5,2,"CUP-PR",7
8,"8185",197,162,162,1,0,"CUP-PR",22
43,"43153",11197,7685,7649,53,36,"CUP-PR",368
8,"8108",5181,3880,3861,30,19,"CUP-PR",137
17,"17226",884,603,600,4,3,"CUP-PR",13
17,"17116",351,261,261,2,0,"CUP-PR",45
43,"43005",3677,2505,2493,17,12,"CUP-PR",223
8,"8073",62934,45699,45407,281,292,"CUP-PR",1288
25,"25019",4606,2860,2829,19,31,"CUP-PR",125
43,"43083",146,110,109,0,1,"CUP-PR",6
25,"25140",779,540,539,2,1,"CUP-PR",50
8,"8157",8574,6514,6472,47,42,"CUP-PR",269
8,"8162",2118,1581,1576,13,5,"CUP-PR",142
43,"43114",370,281,278,1,3,"CUP-PR",51
43,"43088",2013,1429,1420,11,9,"CUP-PR",119
43,"43072",90,69,67,1,2,"CUP-PR",6
8,"8168",388,280,279,3,1,"CUP-PR",18
8,"8213",6600,4925,4906,30,19,"CUP-PR",358
43,"43039",101,77,77,0,0,"CUP-PR",20
8,"8117",2489,1954,1941,21,13,"CUP-PR",234
25,"25149",1377,1034,1028,9,6,"CUP-PR",56
25,"25040",10651,7041,6987,57,54,"CUP-PR",451
43,"43085",237,190,185,1,5,"CUP-PR",19
43,"43132",375,295,291,1,4,"CUP-PR",19
17,"17220",801,649,647,2,2,"CUP-PR",83
17,"17065",321,264,263,3,1,"CUP-PR",37
17,"17115",276,208,208,4,0,"CUP-PR",28
17,"17014",66,51,49,0,2,"CUP-PR",5
25,"25123",189,135,133,0,2,"CUP-PR",12
25,"25193",768,567,563,4,4,"CUP-PR",85
25,"25023",4560,3350,3334,24,16,"CUP-PR",180
17,"17210",572,414,411,2,3,"CUP-PR",54
8,"8021",60,44,44,1,0,"CUP-PR",2
8,"8249",274,238,237,0,1,"CUP-PR",36
8,"8248",5687,4187,4165,21,22,"CUP-PR",352
17,"17139",1407,1128,1119,8,9,"CUP-PR",120
8,"8259",6979,5362,5341,27,21,"CUP-PR",547
17,"17001",575,428,426,4,2,"CUP-PR",53
25,"25244",374,275,270,1,5,"CUP-PR",26
25,"25179",169,132,132,0,0,"CUP-PR",12
8,"8134",848,618,609,4,9,"CUP-PR",80
17,"17007",1763,1367,1359,9,8,"CUP-PR",128
17,"17221",4138,2999,2988,23,11,"CUP-PR",162
17,"17119",71,53,52,3,1,"CUP-PR",14
25,"25252",553,380,379,2,1,"CUP-PR",26
17,"17149",370,302,300,1,2,"CUP-PR",73
25,"25063",84,52,51,0,1,"CUP-PR",1
17,"17234",181,129,129,1,0,"CUP-PR",10
17,"17137",3486,2812,2808,15,4,"CUP-PR",304
8,"8156",11254,8440,8411,58,29,"CUP-PR",365
17,"17096",159,116,116,3,0,"CUP-PR",17
17,"17151",179,131,130,0,1,"CUP-PR",16
25,"25007",1378,1010,999,12,11,"CUP-PR",73
25,"25036",180,124,124,1,0,"CUP-PR",13
17,"17088",599,467,465,3,2,"CUP-PR",62
25,"25045",57,26,26,2,0,"CUP-PR",2
8,"8197",7986,5829,5805,37,24,"CUP-PR",300
25,"25021",2513,1668,1662,17,6,"CUP-PR",110
17,"17157",122,104,103,0,1,"CUP-PR",16
17,"17009",4068,3061,3050,16,11,"CUP-PR",435
8,"8107",11965,8604,8554,67,50,"CUP-PR",376
43,"43167",391,307,307,2,0,"CUP-PR",31
17,"17159",622,459,459,1,0,"CUP-PR",35
43,"43055",1970,1548,1535,12,13,"CUP-PR",207
25,"25202",108,72,72,2,0,"CUP-PR",9
8,"8100",2083,1707,1699,13,8,"CUP-PR",173
8,"8079",333,260,258,2,2,"CUP-PR",25
8,"8158",3094,2261,2251,11,10,"CUP-PR",172
43,"43041",216,156,156,2,0,"CUP-PR",6
17,"17098",308,232,230,4,2,"CUP-PR",22
25,"25157",159,127,126,1,1,"CUP-PR",5
8,"8217",25466,19864,19773,129,91,"CUP-PR",645
8,"8013",1287,982,972,6,10,"CUP-PR",67
43,"43084",514,388,383,2,5,"CUP-PR",38
17,"17228",285,218,217,0,1,"CUP-PR",19
43,"43145",4209,3193,3170,17,23,"CUP-PR",371
8,"8266",43422,32827,32696,241,131,"CUP-PR",1689
25,"25186",207,162,161,0,1,"CUP-PR",18
17,"17175",559,348,343,5,5,"CUP-PR",26
8,"8062",1009,778,776,9,2,"CUP-PR",60
43,"43048",768,564,554,7,10,"CUP-PR",28
43,"43141",109,85,84,0,1,"CUP-PR",5
17,"17046",709,537,531,2,6,"CUP-PR",51
8,"8120",7129,5649,5621,51,28,"CUP-PR",424
43,"43090",1199,689,686,5,3,"CUP-PR",34
17,"17076",119,95,94,2,1,"CUP-PR",23
43,"43168",83,55,55,1,0,"CUP-PR",6
17,"17040",551,440,439,5,1,"CUP-PR",57
17,"17110",1332,990,981,3,9,"CUP-PR",47
17,"17056",1780,1379,1374,13,5,"CUP-PR",156
25,"25156",765,571,567,3,4,"CUP-PR",36
8,"8232",1773,1368,1362,9,6,"CUP-PR",142
25,"25247",142,89,89,2,0,"CUP-PR",1
17,"17191",163,140,140,1,0,"CUP-PR",24
25,"25027",978,695,690,3,5,"CUP-PR",34
8,"8129",486,399,398,0,1,"CUP-PR",55
8,"8288",1696,1103,1096,9,7,"CUP-PR",63
8,"8165",1680,1177,1171,7,6,"CUP-PR",117
25,"25169",170,117,117,5,0,"CUP-PR",20
8,"8122",1733,1179,1175,4,4,"CUP-PR",135
43,"43047",4234,2590,2564,19,26,"CUP-PR",61
17,"17902",1294,992,990,9,2,"CUP-PR",116
25,"25020",270,202,201,2,1,"CUP-PR",12
17,"17071",1134,943,940,1,3,"CUP-PR",126
43,"43126",1230,937,933,3,4,"CUP-PR",84
25,"25197",140,109,109,0,0,"CUP-PR",23
17,"17233",2347,1853,1840,11,13,"CUP-PR",202
43,"43021",349,245,243,2,2,"CUP-PR",27
8,"8052",140,102,102,1,0,"CUP-PR",13
43,"43148",91182,65076,64756,441,320,"CUP-PR",2949
43,"43134",281,217,215,5,2,"CUP-PR",19
17,"17180",8508,5977,5953,38,24,"CUP-PR",637
25,"25226",236,156,155,0,1,"CUP-PR",14
8,"8263",21208,15014,14890,111,124,"CUP-PR",450
25,"25239",582,330,330,3,0,"CUP-PR",21
43,"43146",40,32,32,0,0,"CUP-PR",5
25,"25158",1605,1193,1180,8,13,"CUP-PR",77
8,"8174",388,322,318,2,4,"CUP-PR",34
8,"8272",164,128,128,1,0,"CUP-PR",25
43,"43033",766,555,555,4,0,"CUP-PR",36
8,"8292",1074,796,790,2,6,"CUP-PR",125
8,"8153",573,457,452,3,5,"CUP-PR",77
8,"8154",697,541,539,3,2,"CUP-PR",46
17,"17154",101,76,76,0,0,"CUP-PR",15
17,"17208",978,723,719,6,4,"CUP-PR",93
8,"8209",6925,4976,4948,39,28,"CUP-PR",233
17,"17043",165,133,133,0,0,"CUP-PR",18
43,"43037",18216,11749,11672,70,77,"CUP-PR",395
17,"17069",359,270,267,2,3,"CUP-PR",23
25,"25044",178,144,142,0,2,"CUP-PR",14
25,"25233",289,219,218,6,1,"CUP-PR",9
25,"25022",105,80,79,0,1,"CUP-PR",4
17,"17100",193,147,141,0,6,"CUP-PR",17
25,"25128",125,85,85,0,0,"CUP-PR",15
8,"8043",3414,2429,2422,15,7,"CUP-PR",106
8,"8061",1628,1154,1151,15,3,"CUP-PR",53
8,"8245",77841,53719,53443,430,276,"CUP-PR",1320
25,"25216",244,186,186,0,0,"CUP-PR",23
17,"17091",391,296,290,3,6,"CUP-PR",27
25,"25069",426,296,294,0,2,"CUP-PR",11
8,"8049",1309,910,903,3,7,"CUP-PR",136
25,"25166",170,131,130,2,1,"CUP-PR",15
8,"8051",18570,14112,14054,86,58,"CUP-PR",929
17,"17129",143,108,108,2,0,"CUP-PR",10
17,"17111",984,728,728,7,0,"CUP-PR",82
8,"8246",1692,1345,1340,7,5,"CUP-PR",175
43,"43164",310,235,231,3,4,"CUP-PR",9
8,"8023",7029,5027,5000,39,27,"CUP-PR",361
25,"25132",141,106,105,0,1,"CUP-PR",3
43,"43058",95,78,78,0,0,"CUP-PR",13
25,"25185",680,452,451,0,1,"CUP-PR",36
25,"25912",841,620,619,5,1,"CUP-PR",26
25,"25174",390,312,312,1,0,"CUP-PR",24
43,"43006",676,462,462,3,0,"CUP-PR",34
17,"17070",110,87,87,0,0,"CUP-PR",8
25,"25143",82,63,62,0,1,"CUP-PR",2
8,"8037",1947,1547,1543,11,4,"CUP-PR",207
8,"8001",9097,6860,6818,39,42,"CUP-PR",215
8,"8095",66,49,49,0,0,"CUP-PR",7
8,"8141",4578,3369,3357,28,12,"CUP-PR",451
25,"25155",616,446,443,2,3,"CUP-PR",20
43,"43025",591,448,443,4,5,"CUP-PR",21
8,"8065",1183,920,913,8,7,"CUP-PR",87
8,"8149",980,702,694,6,8,"CUP-PR",115
17,"17167",2585,2015,1998,11,17,"CUP-PR",196
17,"17054",342,250,250,2,0,"CUP-PR",37
25,"25192",727,527,524,4,3,"CUP-PR",50
43,"43127",775,607,606,3,1,"CUP-PR",69
8,"8189",119,96,96,1,0,"CUP-PR",11
8,"8114",18838,13519,13442,81,77,"CUP-PR",577
8,"8025",1573,1170,1160,9,10,"CUP-PR",122
25,"25079",276,202,202,0,0,"CUP-PR",11
17,"17041",217,150,146,1,4,"CUP-PR",16
25,"25120",92888,62740,62389,450,351,"CUP-PR",3268
8,"8253",132,103,102,0,1,"CUP-PR",14
8,"8172",20543,15191,15140,85,51,"CUP-PR",1069
8,"8119",6897,5096,5052,31,44,"CUP-PR",225
43,"43140",2433,1685,1674,11,11,"CUP-PR",59
17,"17135",393,307,303,0,4,"CUP-PR",28
17,"17064",324,249,247,2,2,"CUP-PR",26
8,"8039",413,322,321,1,1,"CUP-PR",54
8,"8304",822,655,655,5,0,"CUP-PR",59
25,"25224",122,94,94,0,0,"CUP-PR",14
17,"17204",609,429,428,6,1,"CUP-PR",33
25,"25058",4345,3058,3045,13,13,"CUP-PR",256
8,"8210",4640,3226,3200,24,26,"CUP-PR",348
8,"8258",815,636,632,5,4,"CUP-PR",141
43,"43172",334,248,243,4,5,"CUP-PR",19
8,"8033",13262,9887,9833,64,54,"CUP-PR",861
43,"43069",183,148,147,2,1,"CUP-PR",16
17,"17033",5647,3879,3852,25,27,"CUP-PR",323
8,"8056",42897,30873,30757,259,116,"CUP-PR",898
17,"17118",12934,8723,8665,38,58,"CUP-PR",620
25,"25250",327,269,265,1,4,"CUP-PR",20
25,"25013",2099,1430,1414,13,16,"CUP-PR",69
43,"43907",4386,3083,3067,24,16,"CUP-PR",63
25,"25183",520,372,370,4,2,"CUP-PR",46
25,"25189",2181,1468,1461,11,7,"CUP-PR",87
17,"17084",228,163,162,1,1,"CUP-PR",19
8,"8188",115,89,89,0,0,"CUP-PR",19
17,"17042",410,299,297,5,2,"CUP-PR",22
17,"17031",178,117,117,0,0,"CUP-PR",19
17,"17075",340,257,256,2,1,"CUP-PR",42
8,"8295",11290,8091,8054,72,37,"CUP-PR",276
25,"25908",217,136,136,0,0,"CUP-PR",10
43,"43002",1890,1233,1210,12,23,"CUP-PR",48
17,"17060",409,300,298,1,2,"CUP-PR",30
25,"25025",1362,909,898,15,11,"CUP-PR",36
17,"17125",136,100,100,3,0,"CUP-PR",17
17,"17006",1178,826,818,9,8,"CUP-PR",91
25,"25205",563,412,407,3,5,"CUP-PR",24
43,"43077",453,306,304,1,2,"CUP-PR",10
25,"25146",223,158,155,3,3,"CUP-PR",14
8,"8116",557,449,449,1,0,"CUP-PR",42
43,"43052",927,680,674,7,6,"CUP-PR",52
17,"17901",987,733,725,5,8,"CUP-PR",111
8,"8152",117,94,94,0,0,"CUP-PR",15
25,"25210",1073,791,780,3,11,"CUP-PR",26
8,"8135",6770,5187,5158,42,29,"CUP-PR",229
8,"8283",6165,4546,4524,33,22,"CUP-PR",536
8,"8299",380,301,300,4,1,"CUP-PR",52
17,"17161",1023,844,843,5,1,"CUP-PR",117
17,"17126",316,269,269,1,0,"CUP-PR",41
8,"8902",3941,2974,2962,16,12,"CUP-PR",176
43,"43103",908,705,701,9,4,"CUP-PR",26
8,"8228",292,234,233,0,1,"CUP-PR",22
17,"17124",1593,1163,1160,8,3,"CUP-PR",104
43,"43105",155,126,123,4,3,"CUP-PR",23
8,"8016",1803,1371,1363,11,8,"CUP-PR",142
25,"25010",194,138,136,0,2,"CUP-PR",17
25,"25154",117,86,85,0,1,"CUP-PR",6
43,"43111",2129,1412,1401,8,11,"CUP-PR",47
43,"43040",325,268,267,1,1,"CUP-PR",48
8,"8140",4816,3541,3520,25,21,"CUP-PR",237
43,"43029",312,241,240,1,1,"CUP-PR",27
8,"8200",62225,45235,44991,306,244,"CUP-PR",1350
17,"17101",566,389,382,1,7,"CUP-PR",29
8,"8303",257,207,205,1,2,"CUP-PR",40
25,"25167",223,165,164,3,1,"CUP-PR",20
8,"8128",579,428,423,4,5,"CUP-PR",85
25,"25035",364,257,256,0,1,"CUP-PR",16
8,"8111",216,195,194,2,1,"CUP-PR",25
25,"25248",870,676,675,5,1,"CUP-PR",56
17,"17203",165,126,126,0,0,"CUP-PR",22
25,"25152",148,106,106,0,0,"CUP-PR",11
8,"8006",11774,8375,8329,53,46,"CUP-PR",789
43,"43130",169,131,130,2,1,"CUP-PR",17
17,"17218",576,456,451,3,5,"CUP-PR",75
43,"43056",803,566,558,6,8,"CUP-PR",54
8,"8042",2390,1772,1764,12,8,"CUP-PR",99
17,"17015",12829,9612,9580,51,32,"CUP-PR",1064
43,"43097",407,331,328,4,3,"CUP-PR",40
43,"43068",484,322,317,2,5,"CUP-PR",10
25,"25129",161,113,112,0,1,"CUP-PR",15
25,"25151",731,555,549,1,6,"CUP-PR",50
8,"8028",1125,744,743,7,1,"CUP-PR",41
17,"17165",645,502,502,2,0,"CUP-PR",57
25,"25030",117,76,76,0,0,"CUP-PR",9
17,"17198",437,307,306,0,1,"CUP-PR",29
8,"8212",491,393,386,6,7,"CUP-PR",45
8,"8144",722,551,545,3,6,"CUP-PR",92
8,"8015",156540,109145,108440,957,705,"CUP-PR",4433
8,"8074",11190,7698,7651,51,47,"CUP-PR",341
43,"43062",269,229,226,5,3,"CUP-PR",18
43,"43054",2807,1972,1957,14,15,"CUP-PR",204
25,"25901",289,214,211,4,3,"CUP-PR",25
25,"25034",2271,1616,1600,12,16,"CUP-PR",128
43,"43139",2007,1432,1419,9,13,"CUP-PR",176
8,"8137",272,208,207,2,1,"CUP-PR",23
8,"8030",5208,4045,4033,25,12,"CUP-PR",296
43,"43169",445,388,388,3,0,"CUP-PR",66
8,"8110",13671,9362,9311,60,51,"CUP-PR",541
8,"8057",61,47,47,1,0,"CUP-PR",7
17,"17048",6284,4077,4048,34,29,"CUP-PR",136
25,"25109",211,155,154,1,1,"CUP-PR",6
8,"8080",40,27,27,3,0,"CUP-PR",2
8,"8046",13541,10510,10455,73,55,"CUP-PR",1108
43,"43035",233,182,182,5,0,"CUP-PR",16
25,"25176",307,241,238,3,3,"CUP-PR",23
25,"25085",141,109,108,2,1,"CUP-PR",9
8,"8166",964,700,697,7,3,"CUP-PR",66
8,"8273",2390,1871,1855,14,16,"CUP-PR",260
8,"8064",1956,1439,1423,7,16,"CUP-PR",150
25,"25243",3729,2370,2349,33,21,"CUP-PR",61
25,"25074",179,155,151,2,4,"CUP-PR",9
17,"17186",3834,2980,2954,17,26,"CUP-PR",233
17,"17029",207,154,154,1,0,"CUP-PR",25
8,"8094",1588,1258,1252,7,6,"CUP-PR",99
8,"8145",2712,2060,2049,8,11,"CUP-PR",212
8,"8022",12213,8594,8558,42,36,"CUP-PR",1289
8,"8177",36,27,27,1,0,"CUP-PR",6
17,"17086",1769,1116,1109,6,7,"CUP-PR",66
43,"43120",421,256,254,1,2,"CUP-PR",14
8,"8196",19542,14264,14185,123,79,"CUP-PR",305
17,"17192",143,107,104,0,3,"CUP-PR",9
25,"25119",2258,1701,1686,11,15,"CUP-PR",119
8,"8235",3875,3004,2996,19,8,"CUP-PR",348
25,"25168",496,399,399,6,0,"CUP-PR",36
17,"17202",3848,2632,2615,16,17,"CUP-PR",161
17,"17130",325,270,270,1,0,"CUP-PR",48
17,"17143",145,104,104,0,0,"CUP-PR",8
25,"25181",172,137,137,1,0,"CUP-PR",22
43,"43117",147,119,119,0,0,"CUP-PR",7
8,"8276",241,179,179,3,0,"CUP-PR",19
25,"25062",691,498,491,4,7,"CUP-PR",46
8,"8219",15755,12235,12206,72,29,"CUP-PR",1050
8,"8112",12926,9268,9230,61,38,"CUP-PR",896
17,"17211",837,677,674,6,3,"CUP-PR",124
25,"25008",1081,803,799,4,4,"CUP-PR",57
17,"17092",3462,2414,2389,14,25,"CUP-PR",171
25,"25011",5271,3529,3505,21,24,"CUP-PR",246
43,"43063",544,376,374,2,2,"CUP-PR",24
8,"8204",3141,2395,2383,16,12,"CUP-PR",158
8,"8058",1808,1280,1262,6,18,"CUP-PR",75
8,"8265",1597,1262,1260,4,2,"CUP-PR",215
8,"8281",4858,3783,3762,19,21,"CUP-PR",361
8,"8126",8906,6673,6646,41,27,"CUP-PR",393
43,"43108",1787,1293,1282,6,11,"CUP-PR",115
25,"25094",138,96,93,2,3,"CUP-PR",8
43,"43079",364,290,289,2,1,"CUP-PR",22
43,"43073",80,67,65,0,2,"CUP-PR",7
17,"17032",1745,1139,1133,6,6,"CUP-PR",87
43,"43095",2583,1864,1854,12,10,"CUP-PR",98
25,"25230",1541,1105,1099,9,6,"CUP-PR",40
43,"43903",2332,1502,1487,18,15,"CUP-PR",66
8,"8901",240,200,195,2,5,"CUP-PR",16
43,"43174",144,118,114,0,4,"CUP-PR",28
43,"43175",534,363,359,5,4,"CUP-PR",32
43,"43017",112,94,94,1,0,"CUP-PR",12
8,"8035",13006,8957,8918,50,39,"CUP-PR",663
8,"8242",223,159,159,0,0,"CUP-PR",24
25,"25171",2117,1539,1534,5,5,"CUP-PR",141
8,"8241",70,52,52,0,0,"CUP-PR",5
8,"8091",5428,4048,4024,20,24,"CUP-PR",286
8,"8069",3323,2555,2540,21,15,"CUP-PR",182
25,"25081",281,195,193,3,2,"CUP-PR",24
17,"17166",547,442,440,0,2,"CUP-PR",77
8,"8099",753,529,529,4,0,"CUP-PR",87
17,"17051",202,161,160,0,1,"CUP-PR",30
43,"43151",107,88,88,0,0,"CUP-PR",21
8,"8031",2339,1760,1750,15,10,"CUP-PR",145
17,"17222",104,87,87,1,0,"CUP-PR",18
8,"8118",17634,13450,13402,80,48,"CUP-PR",1039
8,"8066",1466,1109,1104,7,5,"CUP-PR",62
8,"8160",317,234,234,0,0,"CUP-PR",36
25,"25043",800,584,581,2,3,"CUP-PR",74
25,"25253",147,118,117,0,1,"CUP-PR",12
17,"17107",267,207,205,2,2,"CUP-PR",26
25,"25105",105,88,87,4,1,"CUP-PR",4
8,"8104",657,496,493,4,3,"CUP-PR",81
25,"25218",88,76,75,2,1,"CUP-PR",8
25,"25190",262,202,202,2,0,"CUP-PR",35
43,"43026",756,576,574,1,2,"CUP-PR",56
43,"43012",3700,2882,2858,20,24,"CUP-PR",181
43,"43038",22070,15127,15018,113,109,"CUP-PR",657
25,"25170",262,210,210,1,0,"CUP-PR",0
25,"25215",339,249,249,5,0,"CUP-PR",27
25,"25016",2083,1404,1399,3,5,"CUP-PR",95
8,"8306",535,368,368,5,0,"CUP-PR",25
43,"43166",1646,1183,1176,4,7,"CUP-PR",74
17,"17039",1726,1306,1297,7,9,"CUP-PR",123
43,"43902",2751,1794,1776,21,18,"CUP-PR",39
17,"17215",2286,1855,1844,13,11,"CUP-PR",144
8,"8076",16526,11988,11893,90,95,"CUP-PR",652
17,"17089",5749,3973,3949,17,24,"CUP-PR",340
25,"25126",281,211,210,1,1,"CUP-PR",36
43,"43096",97,76,76,0,0,"CUP-PR",11
25,"25086",525,410,407,3,3,"CUP-PR",54
25,"25048",1641,1207,1194,13,13,"CUP-PR",64
17,"17158",565,296,295,2,1,"CUP-PR",17
25,"25031",57,32,32,0,0,"CUP-PR",1
8,"8905",2329,1872,1863,7,9,"CUP-PR",154
25,"25075",132,101,101,0,0,"CUP-PR",15
17,"17021",119,89,87,0,2,"CUP-PR",23
8,"8205",61957,49325,49196,441,129,"CUP-PR",3718
17,"17027",2857,2236,2229,9,7,"CUP-PR",269
43,"43091",125,90,90,1,0,"CUP-PR",18
25,"25112",269,205,200,2,5,"CUP-PR",27
43,"43076",454,336,335,1,1,"CUP-PR",61
43,"43034",465,365,365,5,0,"CUP-PR",17
43,"43060",2672,2032,2015,7,17,"CUP-PR",213
25,"25055",163,114,114,0,0,"CUP-PR",15
25,"25906",205,133,131,2,2,"CUP-PR",11
8,"8268",975,729,723,6,6,"CUP-PR",82
8,"8078",216,154,154,2,0,"CUP-PR",21
17,"17132",1344,1019,1009,12,10,"CUP-PR",81
43,"43081",629,500,499,2,1,"CUP-PR",61
43,"43023",211,171,169,2,2,"CUP-PR",20
17,"17035",544,447,447,2,0,"CUP-PR",59
43,"43061",40,27,27,3,0,"CUP-PR",1
17,"17189",1481,1228,1223,5,5,"CUP-PR",147
8,"8018",2540,1862,1855,7,7,"CUP-PR",143
8,"8003",7213,5425,5409,41,16,"CUP-PR",389
25,"25204",1187,858,849,13,9,"CUP-PR",36
17,"17225",205,150,150,1,0,"CUP-PR",13
43,"43165",571,469,467,2,2,"CUP-PR",47
25,"25001",143,102,102,1,0,"CUP-PR",14
43,"43043",3317,2457,2445,12,12,"CUP-PR",174
8,"8155",7056,5050,5011,38,39,"CUP-PR",222
43,"43003",349,257,255,3,2,"CUP-PR",18
17,"17184",1261,1016,1010,7,6,"CUP-PR",117
43,"43160",1324,967,956,6,11,"CUP-PR",81
17,"17057",968,770,769,7,1,"CUP-PR",88
43,"43014",14386,9542,9464,74,78,"CUP-PR",544
8,"8121",87515,62961,62574,429,387,"CUP-PR",3394
17,"17138",836,591,584,7,7,"CUP-PR",26
8,"8053",2896,1939,1929,13,10,"CUP-PR",113
8,"8260",18515,13563,13487,84,76,"CUP-PR",457
17,"17212",145,111,109,0,2,"CUP-PR",28
25,"25097",89,71,71,2,0,"CUP-PR",0
17,"17026",549,421,415,3,6,"CUP-PR",44
43,"43051",9194,6133,6048,44,85,"CUP-PR",136
8,"8150",258,207,207,1,0,"CUP-PR",37
43,"43137",1890,1373,1353,8,20,"CUP-PR",86
8,"8903",201,181,181,1,0,"CUP-PR",32
43,"43020",2291,1712,1688,19,24,"CUP-PR",59
17,"17103",5057,3196,3174,21,22,"CUP-PR",202
43,"43049",727,557,555,3,2,"CUP-PR",86
25,"25071",41,31,30,0,1,"CUP-PR",8
25,"25137",8684,5802,5757,48,45,"CUP-PR",321
25,"25909",138,99,98,2,1,"CUP-PR",11
25,"25148",224,158,158,0,0,"CUP-PR",14
17,"17194",73,56,56,0,0,"CUP-PR",3
8,"8038",1541,1129,1120,6,9,"CUP-PR",131
25,"25077",435,312,312,1,0,"CUP-PR",41
8,"8176",158,119,119,0,0,"CUP-PR",15
8,"8291",4972,3531,3519,23,12,"CUP-PR",234
17,"17074",536,403,401,1,2,"CUP-PR",45
17,"17018",494,377,372,4,5,"CUP-PR",58
8,"8081",349,274,270,0,4,"CUP-PR",43
17,"17134",220,175,174,1,1,"CUP-PR",30
17,"17102",556,398,396,1,2,"CUP-PR",42
8,"8220",2411,2010,2001,8,9,"CUP-PR",262
8,"8215",2617,1954,1946,22,8,"CUP-PR",213
25,"25073",559,377,377,2,0,"CUP-PR",24
30,"30901",10556,7862,7775,58,87,"DPL",3
30,"30022",17108,11041,10851,100,190,"DPL",0
30,"30035",19432,13174,13013,114,161,"DPL",5
30,"30039",20442,13299,13167,84,132,"DPL",2
30,"30033",10377,7330,7215,59,115,"DPL",3
30,"30010",6852,5161,5106,25,55,"DPL",2
30,"30019",25911,17485,17264,157,221,"DPL",2
30,"30013",7421,5171,5094,32,77,"DPL",0
30,"30001",4507,3357,3331,17,26,"DPL",0
30,"30007",6474,4354,4317,26,37,"DPL",1
30,"30025",5016,3663,3623,22,40,"DPL",1
30,"30042",2218,1645,1625,10,20,"DPL",0
30,"30017",11428,8196,8113,44,83,"DPL",1
30,"30020",6503,4521,4484,35,37,"DPL",0
30,"30026",16345,10049,9914,84,135,"DPL",4
30,"30030",321454,235061,233183,1744,1878,"DPL",89
30,"30028",6390,4054,3973,25,81,"DPL",1
30,"30031",497,387,382,1,5,"DPL",0
30,"30005",30268,20979,20778,148,201,"DPL",4
30,"30041",14040,8999,8876,94,123,"DPL",1
30,"30012",9085,6704,6599,46,105,"DPL",0
30,"30016",153034,101232,100202,776,1030,"DPL",44
30,"30014",1587,1150,1134,4,16,"DPL",1
30,"30034",1067,818,801,8,17,"DPL",0
30,"30902",8294,5235,5174,29,61,"DPL",1
30,"30009",12728,9487,9365,46,122,"DPL",1
30,"30036",15432,10030,9879,64,151,"DPL",2
30,"30011",4702,3390,3324,8,66,"DPL",0
30,"30004",1129,838,833,1,5,"DPL",0
30,"30008",14560,9974,9840,79,134,"DPL",0
30,"30029",12122,8231,8125,54,106,"DPL",4
30,"30021",9498,6251,6193,36,58,"DPL",0
30,"30002",9701,6794,6717,27,77,"DPL",4
30,"30006",833,699,695,1,4,"DPL",0
30,"30032",2864,2154,2129,18,25,"DPL",0
30,"30043",25449,18839,18477,180,362,"DPL",0
30,"30027",50067,36417,36074,242,343,"DPL",13
30,"30040",686,564,560,1,4,"DPL",0
30,"30023",3874,2831,2788,18,43,"DPL",1
30,"30003",25200,16249,16120,159,129,"DPL",1
30,"30037",19407,13252,13120,99,132,"DPL",3
30,"30038",15752,10987,10904,39,83,"DPL",3
30,"30015",19344,13502,13347,107,155,"DPL",3
30,"30024",60389,42200,41831,281,369,"DPL",9
30,"30018",8399,6226,6148,28,78,"DPL",1
20,"20034",3200,2193,2180,8,13,"EAJ-PNV",718
20,"20045",47031,30933,30787,172,146,"EAJ-PNV",7659
48,"48907",343,274,273,0,1,"EAJ-PNV",157
1,"1002",8014,5838,5786,24,52,"EAJ-PNV",1994
48,"48089",3540,2561,2555,7,6,"EAJ-PNV",1097
48,"48021",1325,891,888,3,3,"EAJ-PNV",445
20,"20069",147446,102068,101696,564,372,"EAJ-PNV",30828
20,"20017",8462,5944,5917,11,27,"EAJ-PNV",2475
20,"20071",15062,10442,10407,47,35,"EAJ-PNV",3891
20,"20051",6736,4829,4804,22,25,"EAJ-PNV",1506
20,"20038",387,294,293,2,1,"EAJ-PNV",124
1,"1037",589,378,374,1,4,"EAJ-PNV",148
1,"1032",498,363,353,1,10,"EAJ-PNV",118
1,"1006",174,124,122,1,2,"EAJ-PNV",16
48,"48911",381,303,302,1,1,"EAJ-PNV",106
48,"48082",37358,25328,25167,125,161,"EAJ-PNV",7252
1,"1027",444,273,271,0,2,"EAJ-PNV",88
48,"48039",254,221,220,2,1,"EAJ-PNV",111
48,"48040",1303,933,926,7,7,"EAJ-PNV",480
48,"48012",2057,1610,1600,1,10,"EAJ-PNV",769
48,"48088",134,95,95,0,0,"EAJ-PNV",22
48,"48077",3366,2483,2467,9,16,"EAJ-PNV",1182
48,"48902",18987,12762,12670,88,92,"EAJ-PNV",4373
48,"48067",1133,810,805,0,5,"EAJ-PNV",369
1,"1047",982,653,642,6,11,"EAJ-PNV",135
48,"48914",332,276,275,0,1,"EAJ-PNV",151
20,"20009",11369,7402,7355,32,47,"EAJ-PNV",1718
1,"1013",710,469,465,2,4,"EAJ-PNV",131
48,"48005",116,80,79,0,1,"EAJ-PNV",28
20,"20057",198,148,147,1,1,"EAJ-PNV",51
48,"48029",8681,6057,6027,41,30,"EAJ-PNV",1840
20,"20066",437,288,286,1,2,"EAJ-PNV",73
48,"48096",6516,4862,4816,33,46,"EAJ-PNV",2332
20,"20018",11231,7640,7611,33,29,"EAJ-PNV",3228
20,"20041",241,143,142,2,1,"EAJ-PNV",60
20,"20076",7013,5011,4991,16,20,"EAJ-PNV",1572
20,"20078",1143,819,816,1,3,"EAJ-PNV",186
48,"48020",272771,184893,183922,1227,971,"EAJ-PNV",63534
20,"20011",1624,1234,1225,3,9,"EAJ-PNV",367
1,"1901",2473,1633,1612,9,21,"EAJ-PNV",354
48,"48052",1562,1220,1210,5,10,"EAJ-PNV",430
1,"1018",1399,953,947,1,6,"EAJ-PNV",250
48,"48066",344,246,246,2,0,"EAJ-PNV",150
48,"48093",891,669,666,5,3,"EAJ-PNV",270
48,"48019",3429,2424,2411,14,13,"EAJ-PNV",807
48,"48030",591,449,447,2,2,"EAJ-PNV",245
48,"48017",13121,8929,8886,45,43,"EAJ-PNV",4742
48,"48049",543,415,414,1,1,"EAJ-PNV",212
20,"20031",185,113,112,3,1,"EAJ-PNV",43
48,"48908",250,212,210,1,2,"EAJ-PNV",118
48,"48083",6934,4800,4765,21,35,"EAJ-PNV",1373
20,"20058",740,523,522,3,1,"EAJ-PNV",158
20,"20025",1110,791,788,4,3,"EAJ-PNV",341
48,"48912",2321,1684,1670,8,14,"EAJ-PNV",647
1,"1052",272,189,186,2,3,"EAJ-PNV",63
1,"1042",911,680,671,8,9,"EAJ-PNV",288
20,"20068",179,119,119,2,0,"EAJ-PNV",35
48,"48009",774,585,578,0,7,"EAJ-PNV",248
20,"20015",1245,880,876,5,4,"EAJ-PNV",278
20,"20049",4195,2918,2901,12,17,"EAJ-PNV",909
20,"20079",18151,13106,13054,58,52,"EAJ-PNV",5319
48,"48068",1534,1154,1149,1,5,"EAJ-PNV",689
20,"20052",1050,746,743,4,3,"EAJ-PNV",244
48,"48001",5899,4094,4074,19,20,"EAJ-PNV",1145
48,"48061",789,602,601,2,1,"EAJ-PNV",318
48,"48002",7791,5510,5471,42,39,"EAJ-PNV",1806
20,"20061",4427,3073,3053,13,20,"EAJ-PNV",1248
20,"20902",14282,9670,9618,52,52,"EAJ-PNV",1920
48,"48080",9916,6849,6793,44,56,"EAJ-PNV",2082
20,"20036",13208,9102,9056,59,46,"EAJ-PNV",3797
48,"48076",288,211,211,1,0,"EAJ-PNV",128
20,"20067",30609,20017,19927,111,90,"EAJ-PNV",3764
20,"20059",8892,6505,6490,18,15,"EAJ-PNV",2293
48,"48031",303,221,221,0,0,"EAJ-PNV",119
20,"20012",149,104,104,1,0,"EAJ-PNV",45
48,"48043",4591,3337,3325,20,12,"EAJ-PNV",1629
48,"48014",1229,845,843,8,2,"EAJ-PNV",344
48,"48078",37858,25959,25819,157,140,"EAJ-PNV",6959
48,"48033",217,162,162,1,0,"EAJ-PNV",75
48,"48070",527,357,355,0,2,"EAJ-PNV",103
20,"20021",185,104,104,2,0,"EAJ-PNV",47
20,"20072",4762,3175,3153,21,22,"EAJ-PNV",956
48,"48024",1000,761,752,1,9,"EAJ-PNV",370
48,"48075",2066,1524,1508,9,16,"EAJ-PNV",760
48,"48010",476,343,343,1,0,"EAJ-PNV",187
48,"48006",307,242,240,3,2,"EAJ-PNV",80
48,"48064",608,461,461,0,0,"EAJ-PNV",217
1,"1057",235,196,194,0,2,"EAJ-PNV",81
1,"1008",808,546,536,6,10,"EAJ-PNV",172
1,"1063",1852,1316,1303,6,13,"EAJ-PNV",431
20,"20001",253,163,163,1,0,"EAJ-PNV",84
20,"20028",2254,1442,1441,6,1,"EAJ-PNV",381
48,"48095",2324,1568,1555,13,13,"EAJ-PNV",456
48,"48086",2024,1371,1358,5,13,"EAJ-PNV",548
20,"20048",183,112,112,0,0,"EAJ-PNV",30
20,"20901",1399,960,957,3,3,"EAJ-PNV",379
1,"1019",148,112,112,0,0,"EAJ-PNV",71
20,"20037",101,69,69,0,0,"EAJ-PNV",32
48,"48906",736,550,548,2,2,"EAJ-PNV",285
48,"48055",2603,1833,1820,14,13,"EAJ-PNV",744
1,"1061",155,116,116,1,0,"EAJ-PNV",30
48,"48046",12626,9300,9250,31,50,"EAJ-PNV",4330
1,"1011",213,162,160,3,2,"EAJ-PNV",54
1,"1056",202,107,107,0,0,"EAJ-PNV",61
48,"48057",5730,4126,4115,14,11,"EAJ-PNV",1820
20,"20042",3180,2056,2053,7,3,"EAJ-PNV",592
48,"48048",527,381,380,3,1,"EAJ-PNV",187
20,"20026",207,172,171,4,1,"EAJ-PNV",81
48,"48901",5160,3705,3684,16,21,"EAJ-PNV",1371
20,"20906",128,87,87,0,0,"EAJ-PNV",26
48,"48038",1151,829,829,1,0,"EAJ-PNV",441
1,"1051",3569,2259,2244,3,15,"EAJ-PNV",658
48,"48056",980,731,728,3,3,"EAJ-PNV",364
20,"20005",1274,822,822,1,0,"EAJ-PNV",263
1,"1062",318,221,219,2,2,"EAJ-PNV",41
48,"48003",14518,10375,10310,49,65,"EAJ-PNV",4102
1,"1060",204,159,151,0,8,"EAJ-PNV",41
20,"20008",713,424,424,5,0,"EAJ-PNV",133
48,"48903",1800,1358,1353,4,5,"EAJ-PNV",779
20,"20027",2761,1866,1861,10,5,"EAJ-PNV",667
1,"1036",14698,10207,10131,51,76,"EAJ-PNV",3189
20,"20007",337,223,221,2,2,"EAJ-PNV",52
1,"1030",141,102,102,0,0,"EAJ-PNV",33
20,"20907",118,82,82,0,0,"EAJ-PNV",26
1,"1034",152,107,107,1,0,"EAJ-PNV",46
48,"48065",3285,2341,2326,8,15,"EAJ-PNV",932
20,"20029",4264,3116,3104,14,12,"EAJ-PNV",1247
1,"1053",596,364,362,1,2,"EAJ-PNV",124
48,"48015",33077,22441,22295,145,146,"EAJ-PNV",7076
48,"48905",2496,1778,1766,12,12,"EAJ-PNV",818
48,"48913",1236,899,890,8,9,"EAJ-PNV",437
20,"20016",1529,887,883,3,4,"EAJ-PNV",406
48,"48008",609,415,407,4,8,"EAJ-PNV",229
1,"1014",366,271,266,2,5,"EAJ-PNV",93
48,"48063",354,256,252,1,4,"EAJ-PNV",108
20,"20023",441,254,251,1,3,"EAJ-PNV",83
20,"20063",8023,5611,5597,19,14,"EAJ-PNV",1394
20,"20046",1243,822,816,1,6,"EAJ-PNV",268
48,"48094",3121,2201,2188,7,13,"EAJ-PNV",1025
48,"48037",696,497,485,0,12,"EAJ-PNV",246
48,"48035",406,314,314,0,0,"EAJ-PNV",164
48,"48058",947,682,679,2,3,"EAJ-PNV",259
20,"20014",1161,699,693,0,6,"EAJ-PNV",203
20,"20006",261,154,153,1,1,"EAJ-PNV",52
1,"1046",639,433,432,2,1,"EAJ-PNV",140
48,"48073",6827,4614,4591,38,23,"EAJ-PNV",1622
20,"20004",230,133,133,2,0,"EAJ-PNV",61
48,"48062",295,236,236,0,0,"EAJ-PNV",133
1,"1044",232,151,148,2,3,"EAJ-PNV",40
20,"20003",549,360,355,1,5,"EAJ-PNV",103
48,"48085",10716,7707,7679,51,28,"EAJ-PNV",3118
20,"20047",455,314,314,1,0,"EAJ-PNV",81
1,"1033",654,476,476,0,0,"EAJ-PNV",186
1,"1021",471,321,319,3,2,"EAJ-PNV",118
1,"1020",323,228,224,1,4,"EAJ-PNV",83
20,"20013",5433,3906,3893,24,13,"EAJ-PNV",1390
48,"48054",25063,17705,17597,122,108,"EAJ-PNV",6437
48,"48007",389,243,243,0,0,"EAJ-PNV",99
48,"48090",6004,4305,4254,28,51,"EAJ-PNV",1776
1,"1003",1166,843,837,6,6,"EAJ-PNV",256
20,"20077",5269,3845,3830,9,15,"EAJ-PNV",1391
20,"20033",858,644,638,1,6,"EAJ-PNV",225
20,"20050",275,174,174,2,0,"EAJ-PNV",54
48,"48059",402,299,297,0,2,"EAJ-PNV",132
20,"20032",8654,6000,5972,21,28,"EAJ-PNV",2308
20,"20062",941,688,683,1,5,"EAJ-PNV",290
48,"48018",854,563,560,5,3,"EAJ-PNV",252
48,"48074",3275,2308,2295,11,13,"EAJ-PNV",940
20,"20035",480,361,361,0,0,"EAJ-PNV",131
48,"48915",339,245,243,0,2,"EAJ-PNV",102
20,"20054",461,294,294,1,0,"EAJ-PNV",58
48,"48045",5207,3851,3817,9,34,"EAJ-PNV",1664
1,"1031",1136,844,830,1,14,"EAJ-PNV",219
48,"48034",12623,8789,8711,76,78,"EAJ-PNV",1652
1,"1049",130,94,94,1,0,"EAJ-PNV",46
20,"20903",5033,3355,3341,18,14,"EAJ-PNV",989
20,"20044",355,261,261,1,0,"EAJ-PNV",69
48,"48081",1903,1455,1447,7,8,"EAJ-PNV",827
48,"48072",965,730,724,3,6,"EAJ-PNV",268
1,"1043",2340,1487,1468,11,19,"EAJ-PNV",215
48,"48011",9640,6753,6722,41,31,"EAJ-PNV",2255
48,"48091",1078,758,757,5,1,"EAJ-PNV",294
1,"1016",428,194,192,4,2,"EAJ-PNV",72
20,"20053",4856,3169,3153,15,16,"EAJ-PNV",754
48,"48028",682,551,548,3,3,"EAJ-PNV",243
20,"20064",12395,7959,7916,42,43,"EAJ-PNV",1846
48,"48044",61957,45253,45063,299,190,"EAJ-PNV",16879
48,"48025",874,667,662,2,5,"EAJ-PNV",325
1,"1022",755,532,523,4,9,"EAJ-PNV",111
48,"48016",5471,3964,3935,31,29,"EAJ-PNV",1500
20,"20002",359,234,231,7,3,"EAJ-PNV",66
48,"48087",437,335,332,0,3,"EAJ-PNV",186
1,"1004",1357,952,945,5,7,"EAJ-PNV",312
20,"20022",849,574,571,8,3,"EAJ-PNV",213
48,"48047",147,105,105,2,0,"EAJ-PNV",31
20,"20056",4077,2796,2781,12,15,"EAJ-PNV",1093
1,"1017",817,537,532,3,5,"EAJ-PNV",177
48,"48027",22745,16240,16158,74,82,"EAJ-PNV",5838
48,"48026",1132,834,832,2,2,"EAJ-PNV",310
48,"48050",188,141,141,0,0,"EAJ-PNV",52
48,"48904",3547,2563,2541,18,22,"EAJ-PNV",1229
48,"48909",201,158,157,0,1,"EAJ-PNV",58
1,"1902",723,485,478,8,7,"EAJ-PNV",117
20,"20039",2126,1623,1618,9,5,"EAJ-PNV",680
48,"48004",326,245,245,1,0,"EAJ-PNV",118
1,"1039",188,150,147,2,3,"EAJ-PNV",35
48,"48079",397,289,287,1,2,"EAJ-PNV",130
20,"20905",160,123,123,2,0,"EAJ-PNV",33
20,"20055",17300,11784,11725,43,59,"EAJ-PNV",3528
20,"20065",2921,1983,1970,16,13,"EAJ-PNV",555
20,"20075",4312,2848,2845,8,3,"EAJ-PNV",861
1,"1001",2020,1385,1372,5,13,"EAJ-PNV",381
20,"20904",87,56,55,1,1,"EAJ-PNV",11
1,"1010",2315,1705,1688,6,17,"EAJ-PNV",728
1,"1009",1258,839,833,2,6,"EAJ-PNV",238
48,"48041",687,548,547,4,1,"EAJ-PNV",313
20,"20073",4707,3272,3260,14,12,"EAJ-PNV",736
48,"48022",2305,1434,1425,11,9,"EAJ-PNV",753
20,"20024",395,245,245,4,0,"EAJ-PNV",64
20,"20019",9892,6740,6717,40,23,"EAJ-PNV",2635
1,"1059",189597,128849,127910,688,939,"EAJ-PNV",27056
48,"48092",872,614,608,3,6,"EAJ-PNV",319
48,"48032",5762,4287,4262,14,25,"EAJ-PNV",1411
20,"20074",11520,8379,8357,19,22,"EAJ-PNV",2838
48,"48013",79353,53591,53205,331,386,"EAJ-PNV",14031
48,"48036",24015,16501,16425,83,76,"EAJ-PNV",5750
48,"48051",220,151,150,0,1,"EAJ-PNV",68
20,"20010",1524,1057,1053,5,4,"EAJ-PNV",275
20,"20043",1718,1189,1183,2,6,"EAJ-PNV",553
48,"48069",13131,9211,9162,55,49,"EAJ-PNV",4418
1,"1028",1091,735,728,5,7,"EAJ-PNV",159
1,"1058",1414,893,884,1,9,"EAJ-PNV",249
20,"20060",87,75,75,0,0,"EAJ-PNV",2
1,"1055",839,557,552,11,5,"EAJ-PNV",204
20,"20020",114,64,64,0,0,"EAJ-PNV",31
48,"48097",1314,886,882,6,4,"EAJ-PNV",315
48,"48060",3625,2429,2418,12,11,"EAJ-PNV",1167
20,"20040",15771,10549,10481,54,68,"EAJ-PNV",2293
20,"20070",1084,798,795,7,3,"EAJ-PNV",331
1,"1054",998,701,700,4,1,"EAJ-PNV",187
48,"48042",1359,1055,1045,7,10,"EAJ-PNV",560
1,"1023",262,193,190,1,3,"EAJ-PNV",60
20,"20030",21147,14598,14521,92,77,"EAJ-PNV",4180
20,"20081",7690,5382,5363,31,19,"EAJ-PNV",1754
48,"48023",579,451,448,0,3,"EAJ-PNV",218
48,"48053",926,704,702,6,2,"EAJ-PNV",384
1,"1041",150,103,102,1,1,"EAJ-PNV",30
48,"48084",21780,14368,14271,79,97,"EAJ-PNV",3693
20,"20080",7705,5276,5244,21,32,"EAJ-PNV",1391
48,"48910",2811,1952,1942,11,10,"EAJ-PNV",604
48,"48071",6013,4240,4205,23,35,"EAJ-PNV",1552
22,"22067",70,52,52,0,0,"EB",1
50,"50042",19,17,17,1,0,"EB",0
22,"22045",65,52,52,0,0,"EB",0
4,"4081",351,264,263,0,1,"EB",0
4,"4073",327,224,223,0,1,"EB",0
4,"4084",337,238,232,0,6,"EB",0
22,"22157",181,122,121,2,1,"EB",0
39,"39060",6704,4959,4887,23,72,"EB",2
26,"26047",1852,1449,1434,6,15,"EB",2
50,"50066",2903,2095,2078,19,17,"EB",12
14,"14061",687,536,523,1,13,"EB",0
50,"50004",475,360,356,2,4,"EB",0
14,"14014",2496,1962,1907,20,55,"EB",2
50,"50039",462,339,333,1,6,"EB",2
22,"22060",1167,817,808,14,9,"EB",2
50,"50018",883,622,616,5,6,"EB",4
50,"50168",29,20,20,0,0,"EB",0
26,"26123",128,110,110,0,0,"EB",1
4,"4904",1900,1308,1299,4,9,"EB",4
50,"50269",287,172,167,2,5,"EB",0
22,"22117",2384,1606,1596,18,10,"EB",7
14,"14066",5748,4116,4035,59,81,"EB",3
39,"39097",666,342,335,2,7,"EB",0
50,"50012",94,76,72,0,4,"EB",0
26,"26038",76,52,52,0,0,"EB",0
39,"39004",1479,1050,1031,5,19,"EB",1
22,"22012",102,75,75,2,0,"EB",0
39,"39084",868,608,605,3,3,"EB",0
50,"50290",360,260,255,5,5,"EB",0
22,"22015",299,218,215,1,3,"EB",0
50,"50047",38,24,24,0,0,"EB",0
26,"26118",71,54,53,1,1,"EB",0
39,"39013",517,359,356,1,3,"EB",0
22,"22006",268,167,164,4,3,"EB",0
4,"4010",587,421,409,5,12,"EB",0
14,"14013",16619,11968,11719,153,249,"EB",20
26,"26053",191,144,140,2,4,"EB",0
26,"26158",242,184,181,1,3,"EB",0
22,"22903",618,484,482,5,2,"EB",0
39,"39069",1934,1475,1458,2,17,"EB",1
4,"4903",4320,2907,2873,18,34,"EB",1
50,"50228",249,207,207,3,0,"EB",0
39,"39094",840,611,611,2,0,"EB",0
26,"26021",2742,1967,1932,14,35,"EB",5
22,"22035",225,153,152,1,1,"EB",0
4,"4095",687,462,457,4,5,"EB",2
50,"50113",587,471,461,2,10,"EB",0
14,"14057",6157,4773,4707,59,66,"EB",4
39,"39050",260,164,164,1,0,"EB",0
26,"26093",48,34,33,0,1,"EB",0
4,"4047",2224,1649,1627,13,22,"EB",2
22,"22133",108,71,71,3,0,"EB",0
50,"50015",81,57,56,0,1,"EB",0
22,"22024",220,159,158,1,1,"EB",0
26,"26092",104,82,81,3,1,"EB",0
50,"50136",532,366,361,3,5,"EB",0
50,"50224",61,44,44,2,0,"EB",0
39,"39087",41241,29341,29084,152,257,"EB",15
4,"4069",4742,3364,3325,46,39,"EB",6
39,"39038",1512,992,983,5,9,"EB",2
26,"26171",155,109,107,2,2,"EB",0
22,"22014",227,164,162,5,2,"EB",0
22,"22141",115,94,93,0,1,"EB",5
22,"22190",123,77,77,1,0,"EB",0
26,"26135",152,115,114,0,1,"EB",0
22,"22113",478,335,333,6,2,"EB",1
39,"39057",2366,1636,1607,10,29,"EB",1
50,"50216",236,169,167,0,2,"EB",0
26,"26096",257,198,193,2,5,"EB",0
4,"4092",2791,2058,2023,4,35,"EB",5
50,"50056",399,296,296,3,0,"EB",0
26,"26045",11,10,10,1,0,"EB",0
22,"22087",60,46,46,0,0,"EB",0
22,"22908",190,135,134,0,1,"EB",1
26,"26037",125,98,98,3,0,"EB",0
22,"22206",179,138,137,0,1,"EB",0
4,"4085",360,291,289,0,2,"EB",0
22,"22225",2606,1638,1612,20,26,"EB",3
50,"50085",182,121,121,0,0,"EB",1
22,"22248",103,73,73,0,0,"EB",0
50,"50171",99,69,69,2,0,"EB",1
39,"39041",1753,1285,1269,7,16,"EB",0
50,"50175",907,638,632,11,6,"EB",1
50,"50152",1351,942,932,14,10,"EB",1
4,"4088",2444,1587,1574,17,13,"EB",1
26,"26083",337,255,250,3,5,"EB",2
26,"26109",73,68,68,0,0,"EB",0
22,"22079",118,85,84,1,1,"EB",0
26,"26022",177,130,128,0,2,"EB",0
22,"22209",161,121,121,3,0,"EB",0
50,"50064",439,348,346,1,2,"EB",0
4,"4049",5711,3766,3732,25,34,"EB",9
22,"22116",1342,915,905,11,10,"EB",0
50,"50026",418,292,288,4,4,"EB",0
39,"39088",59,40,40,2,0,"EB",0
39,"39032",1420,1032,1027,7,5,"EB",1
14,"14022",3881,2888,2853,15,35,"EB",3
14,"14054",13775,10464,10165,105,299,"EB",11
22,"22214",117,92,89,0,3,"EB",1
50,"50278",175,133,131,2,2,"EB",0
39,"39019",2232,1628,1603,10,25,"EB",0
50,"50192",227,182,181,0,1,"EB",0
14,"14011",580,444,443,3,1,"EB",0
4,"4901",490,343,343,2,0,"EB",1
50,"50281",68,52,50,0,2,"EB",0
14,"14010",3992,2786,2723,14,63,"EB",4
22,"22906",177,123,122,6,1,"EB",0
14,"14026",2000,1294,1253,20,41,"EB",1
26,"26136",90,65,64,2,1,"EB",0
4,"4003",17583,11062,10941,77,121,"EB",16
50,"50116",169,124,123,0,1,"EB",0
39,"39031",1237,870,865,1,5,"EB",2
22,"22039",813,635,634,4,1,"EB",1
38,"38033",3593,2277,2242,15,35,"EB",1
22,"22226",761,537,530,13,7,"EB",0
4,"4058",342,238,236,3,2,"EB",0
38,"38016",1174,595,589,2,6,"EB",0
22,"22007",751,527,520,1,7,"EB",2
26,"26071",8644,5668,5591,53,77,"EB",18
38,"38014",1342,943,930,6,13,"EB",0
4,"4103",1432,1003,993,10,10,"EB",1
26,"26170",423,303,301,2,2,"EB",0
39,"39079",8850,6247,6175,28,72,"EB",2
50,"50072",183,131,129,0,2,"EB",0
22,"22222",516,379,377,6,2,"EB",1
50,"50239",63,46,45,1,1,"EB",0
22,"22103",664,489,489,4,0,"EB",2
26,"26162",108,90,89,1,1,"EB",0
22,"22137",1009,671,665,1,6,"EB",0
50,"50068",1943,1299,1287,10,12,"EB",1
50,"50025",4541,3110,3083,39,27,"EB",4
50,"50251",8209,5732,5658,66,74,"EB",4
50,"50195",53,42,38,0,4,"EB",0
26,"26120",1441,1027,1011,11,16,"EB",0
4,"4014",152,105,103,1,2,"EB",1
4,"4034",169,91,91,1,0,"EB",0
14,"14042",18695,13788,13514,206,274,"EB",33
50,"50065",56,37,37,0,0,"EB",0
4,"4038",3105,2020,1984,17,36,"EB",0
22,"22178",105,89,89,1,0,"EB",0
38,"38017",30964,16228,16102,108,126,"EB",10
50,"50210",37,26,26,0,0,"EB",0
50,"50083",81,64,64,2,0,"EB",0
50,"50293",392,257,255,2,2,"EB",0
50,"50217",426,333,333,1,0,"EB",0
22,"22078",431,285,285,4,0,"EB",0
14,"14004",1963,1465,1437,15,28,"EB",3
50,"50266",120,77,76,3,1,"EB",0
22,"22155",66,52,52,0,0,"EB",0
50,"50110",340,248,238,1,10,"EB",0
50,"50142",23,16,16,1,0,"EB",0
14,"14051",1323,975,951,7,24,"EB",0
22,"22003",135,107,107,0,0,"EB",2
50,"50221",29,18,18,0,0,"EB",0
26,"26046",1552,1056,1027,11,29,"EB",3
22,"22076",285,207,203,4,4,"EB",0
50,"50036",100,76,76,1,0,"EB",0
22,"22027",311,210,209,1,1,"EB",1
22,"22212",69,52,52,1,0,"EB",0
26,"26042",795,578,572,8,6,"EB",1
22,"22018",303,216,215,3,1,"EB",1
26,"26013",330,243,242,2,1,"EB",2
22,"22254",1084,744,735,10,9,"EB",2
38,"38049",2690,1406,1389,27,17,"EB",0
22,"22126",89,64,64,0,0,"EB",0
22,"22048",12635,8889,8807,98,82,"EB",22
50,"50262",1161,849,832,11,17,"EB",1
38,"38035",10518,5870,5819,37,51,"EB",8
4,"4052",12882,8400,8322,93,78,"EB",17
50,"50125",340,230,229,2,1,"EB",0
22,"22242",60,41,40,0,1,"EB",1
26,"26001",199,145,141,3,4,"EB",0
50,"50128",26,23,23,0,0,"EB",0
38,"38042",3778,2410,2386,11,24,"EB",0
22,"22182",227,132,131,3,1,"EB",0
26,"26178",72,56,56,1,0,"EB",0
38,"38023",126137,79423,78706,605,717,"EB",74
50,"50096",34,22,22,0,0,"EB",0
50,"50272",13226,9250,9153,97,97,"EB",30
26,"26079",633,503,499,2,4,"EB",0
50,"50089",8616,6420,6364,50,56,"EB",26
50,"50196",101,73,73,0,0,"EB",0
50,"50141",104,80,78,0,2,"EB",0
50,"50253",379,294,290,1,4,"EB",0
50,"50137",958,740,731,8,9,"EB",0
22,"22245",303,222,213,3,9,"EB",0
50,"50006",913,670,654,13,16,"EB",0
26,"26160",731,539,533,4,6,"EB",0
22,"22143",190,118,115,1,3,"EB",0
50,"50119",876,633,625,11,8,"EB",0
4,"4008",466,374,371,3,3,"EB",2
38,"38003",1517,899,890,5,9,"EB",0
4,"4062",4457,3241,3197,22,44,"EB",3
50,"50091",39,32,32,0,0,"EB",0
26,"26070",152,125,122,1,3,"EB",0
22,"22165",449,305,300,3,5,"EB",2
39,"39037",2033,1431,1420,3,11,"EB",1
22,"22110",700,476,473,3,3,"EB",1
38,"38006",41593,20823,20624,127,199,"EB",17
50,"50225",1532,983,971,12,12,"EB",2
50,"50088",274,195,191,2,4,"EB",0
50,"50150",624,387,384,2,3,"EB",3
22,"22122",69,52,50,2,2,"EB",0
50,"50211",236,174,173,0,1,"EB",0
50,"50144",31,24,24,0,0,"EB",0
14,"14001",3423,2563,2515,11,48,"EB",0
22,"22114",124,75,72,1,3,"EB",0
22,"22066",755,529,520,8,9,"EB",1
50,"50023",199,145,143,2,2,"EB",0
26,"26009",394,282,278,1,4,"EB",0
26,"26172",25,16,15,0,1,"EB",0
26,"26108",309,240,231,2,9,"EB",0
38,"38040",5482,3094,3060,14,34,"EB",2
4,"4048",1499,964,957,4,7,"EB",2
50,"50291",95,76,76,0,0,"EB",0
4,"4001",1002,717,710,3,7,"EB",2
22,"22151",85,60,60,0,0,"EB",0
22,"22150",459,325,321,8,4,"EB",2
4,"4071",362,286,281,2,5,"EB",0
26,"26007",482,360,348,0,12,"EB",0
39,"39051",73,64,64,1,0,"EB",0
38,"38041",7025,4729,4684,42,45,"EB",3
50,"50100",304,215,212,1,3,"EB",0
50,"50009",97,61,61,1,0,"EB",1
50,"50179",255,197,197,0,0,"EB",0
50,"50236",95,77,75,0,2,"EB",0
22,"22090",86,61,61,1,0,"EB",0
4,"4051",404,323,319,2,4,"EB",0
26,"26101",31,18,17,0,1,"EB",0
38,"38012",2286,1520,1510,8,10,"EB",0
50,"50213",92,70,70,2,0,"EB",0
26,"26069",230,166,166,0,0,"EB",0
22,"22050",93,77,77,0,0,"EB",0
50,"50901",133,96,96,0,0,"EB",0
4,"4098",1424,890,885,0,5,"EB",1
39,"39001",2063,1474,1467,5,7,"EB",1
14,"14002",10895,7599,7479,109,120,"EB",18
50,"50200",479,389,383,5,6,"EB",1
14,"14016",1273,936,922,5,14,"EB",1
22,"22016",558,384,382,5,2,"EB",0
50,"50034",767,516,511,10,5,"EB",3
50,"50107",988,758,755,8,3,"EB",4
39,"39044",3921,2805,2783,18,22,"EB",2
39,"39091",1881,1297,1291,8,6,"EB",0
39,"39022",970,673,668,2,5,"EB",0
26,"26180",221,164,162,4,2,"EB",0
4,"4018",245,202,197,2,5,"EB",0
50,"50041",16,10,10,0,0,"EB",0
26,"26036",16989,11463,11260,101,203,"EB",35
26,"26164",50,36,35,0,1,"EB",0
26,"26080",451,347,344,0,3,"EB",0
14,"14035",5774,4076,4017,35,59,"EB",7
26,"26041",109,67,65,0,2,"EB",0
4,"4066",13438,8615,8519,78,96,"EB",8
22,"22204",1117,728,723,14,5,"EB",2
39,"39076",3512,2517,2491,13,26,"EB",3
50,"50206",457,349,345,5,4,"EB",2
22,"22230",291,209,207,4,2,"EB",0
22,"22064",155,100,100,2,0,"EB",0
4,"4083",1727,1265,1250,8,15,"EB",0
38,"38011",21655,13974,13831,106,143,"EB",17
50,"50092",290,218,214,0,4,"EB",2
14,"14032",388,302,293,0,9,"EB",0
22,"22004",123,83,83,0,0,"EB",0
50,"50131",212,152,147,4,5,"EB",0
22,"22019",176,128,126,1,2,"EB",0
22,"22009",581,387,386,7,1,"EB",1
14,"14063",994,731,719,8,12,"EB",0
26,"26126",29,27,27,0,0,"EB",0
4,"4026",57,38,37,0,1,"EB",0
26,"26012",37,28,28,1,0,"EB",0
22,"22057",364,253,248,4,5,"EB",2
50,"50030",197,124,124,1,0,"EB",2
26,"26029",34,26,26,1,0,"EB",1
22,"22239",85,67,65,0,2,"EB",0
22,"22221",92,56,55,0,1,"EB",0
14,"14059",679,527,521,11,6,"EB",0
50,"50265",74,54,54,1,0,"EB",0
14,"14028",302,241,240,3,1,"EB",0
50,"50147",744,508,506,5,2,"EB",6
22,"22001",212,147,146,0,1,"EB",0
26,"26175",47,40,38,1,2,"EB",0
26,"26105",2188,1564,1536,24,28,"EB",7
50,"50241",582,414,406,2,8,"EB",2
50,"50167",208,166,163,1,3,"EB",0
50,"50242",99,74,74,0,0,"EB",0
26,"26005",2483,1589,1570,13,19,"EB",3
39,"39067",753,476,474,1,2,"EB",2
50,"50098",162,119,118,1,1,"EB",0
38,"38025",7065,4657,4590,34,67,"EB",4
39,"39029",629,476,469,1,7,"EB",0
22,"22189",175,142,142,1,0,"EB",0
50,"50073",2122,1559,1540,14,19,"EB",5
22,"22149",301,211,210,1,1,"EB",2
26,"26124",768,603,590,4,13,"EB",0
22,"22201",264,188,186,3,2,"EB",0
50,"50108",50,37,37,0,0,"EB",0
50,"50071",126,84,84,0,0,"EB",0
14,"14030",7761,5711,5588,84,123,"EB",7
50,"50117",123,93,93,4,0,"EB",0
26,"26008",1821,1310,1290,15,20,"EB",2
50,"50032",243,167,164,3,3,"EB",0
39,"39058",806,556,554,2,2,"EB",0
26,"26049",156,120,115,0,5,"EB",0
22,"22111",143,96,95,2,1,"EB",1
22,"22217",370,274,269,4,5,"EB",0
50,"50263",171,110,108,1,2,"EB",1
39,"39071",410,251,250,1,1,"EB",0
4,"4099",4930,3526,3462,22,64,"EB",7
38,"38024",15316,9131,9005,60,126,"EB",1
4,"4029",8830,5546,5482,43,64,"EB",8
22,"22203",77,62,62,2,0,"EB",0
22,"22902",206,147,144,1,3,"EB",1
22,"22102",180,137,136,3,1,"EB",2
50,"50268",41,32,32,1,0,"EB",0
38,"38026",33585,24091,23889,170,202,"EB",19
39,"39096",669,451,450,1,1,"EB",0
50,"50153",914,683,675,9,8,"EB",2
39,"39053",212,133,133,4,0,"EB",0
22,"22129",162,110,110,0,0,"EB",1
50,"50020",795,548,545,4,3,"EB",1
26,"26113",29,28,28,0,0,"EB",0
50,"50044",224,159,159,2,0,"EB",0
26,"26057",50,45,45,2,0,"EB",0
50,"50001",89,68,68,0,0,"EB",0
14,"14023",1999,1629,1593,11,36,"EB",2
50,"50203",1065,817,804,5,13,"EB",26
22,"22167",465,358,356,8,2,"EB",1
50,"50297",503800,365284,362768,3385,2516,"EB",1493
4,"4011",2744,2010,1984,20,26,"EB",0
26,"26163",126,104,104,1,0,"EB",0
14,"14070",1280,911,902,4,9,"EB",0
50,"50244",192,131,130,1,1,"EB",0
4,"4015",113,81,81,0,0,"EB",3
50,"50057",1331,933,922,10,11,"EB",2
39,"39014",882,538,536,0,2,"EB",0
14,"14033",1239,875,856,8,19,"EB",4
22,"22901",714,433,423,6,10,"EB",1
22,"22013",271,200,197,3,3,"EB",0
14,"14037",3161,2233,2158,22,75,"EB",3
26,"26044",51,38,36,0,2,"EB",0
22,"22234",743,498,491,5,7,"EB",0
39,"39003",261,189,187,2,2,"EB",1
50,"50197",95,69,68,2,1,"EB",0
39,"39025",8637,6256,6179,33,77,"EB",3
22,"22128",188,145,143,3,2,"EB",0
39,"39089",131,82,82,0,0,"EB",0
39,"39078",1410,1004,997,5,7,"EB",0
39,"39059",7518,5327,5287,23,40,"EB",6
50,"50121",270,209,208,3,1,"EB",0
26,"26122",115,81,80,4,1,"EB",1
38,"38010",3969,2463,2418,11,45,"EB",0
22,"22205",448,294,292,0,2,"EB",1
22,"22041",145,116,116,2,0,"EB",1
50,"50164",381,245,243,3,2,"EB",3
22,"22032",102,69,68,1,1,"EB",0
26,"26130",205,153,150,1,3,"EB",0
50,"50188",26,23,23,0,0,"EB",0
4,"4080",196,148,147,2,1,"EB",1
22,"22075",116,71,69,1,2,"EB",0
22,"22096",332,248,241,10,7,"EB",0
22,"22144",255,192,190,2,2,"EB",0
38,"38013",3011,1850,1829,14,21,"EB",2
22,"22229",107,70,70,2,0,"EB",0
38,"38027",5581,3577,3533,22,44,"EB",0
26,"26141",98,70,70,0,0,"EB",0
14,"14045",2997,2329,2287,30,42,"EB",8
14,"14073",2768,1934,1880,33,54,"EB",0
22,"22142",94,72,70,0,2,"EB",0
14,"14060",3715,2714,2641,41,73,"EB",0
4,"4019",236,174,172,0,2,"EB",0
50,"50174",80,58,57,0,1,"EB",0
22,"22074",303,209,208,5,1,"EB",2
26,"26062",85,62,62,1,0,"EB",0
26,"26138",4504,2982,2930,32,52,"EB",3
26,"26063",118,88,88,2,0,"EB",0
26,"26051",213,165,165,1,0,"EB",0
50,"50045",1217,891,878,10,13,"EB",0
50,"50256",70,43,43,0,0,"EB",0
22,"22077",362,280,272,5,8,"EB",0
50,"50095",12149,8322,8239,91,83,"EB",19
39,"39068",642,442,438,1,4,"EB",0
38,"38048",3952,2543,2519,22,24,"EB",0
4,"4002",1013,711,699,1,12,"EB",0
4,"4076",1209,873,850,7,23,"EB",3
22,"22156",289,216,213,1,3,"EB",3
22,"22177",96,69,68,0,1,"EB",1
50,"50172",174,125,123,2,2,"EB",2
38,"38051",7328,5017,4969,32,48,"EB",3
50,"50170",357,245,242,6,3,"EB",0
50,"50238",84,65,65,0,0,"EB",0
26,"26144",187,147,143,1,4,"EB",0
38,"38046",9267,6652,6594,55,58,"EB",9
50,"50159",640,493,486,3,7,"EB",0
50,"50133",98,76,76,0,0,"EB",1
14,"14041",3113,2234,2160,43,74,"EB",1
50,"50178",269,165,163,6,2,"EB",0
50,"50249",283,202,200,0,2,"EB",0
50,"50260",35,31,31,0,0,"EB",0
22,"22028",358,237,233,1,4,"EB",0
26,"26179",39,27,27,0,0,"EB",0
50,"50205",72,51,49,0,2,"EB",1
4,"4055",361,298,290,3,8,"EB",0
4,"4077",296,270,268,3,2,"EB",0
26,"26017",364,274,269,2,5,"EB",0
38,"38030",1962,1332,1318,9,14,"EB",0
39,"39028",3892,2905,2878,20,27,"EB",1
26,"26078",86,63,63,0,0,"EB",0
26,"26119",178,132,132,0,0,"EB",2
26,"26006",1833,1358,1335,7,23,"EB",1
39,"39085",7017,5029,4992,23,37,"EB",1
50,"50250",54,44,44,2,0,"EB",0
22,"22233",81,53,53,0,0,"EB",0
22,"22054",1614,1029,1009,19,20,"EB",8
26,"26106",79,67,67,0,0,"EB",0
50,"50258",53,25,25,1,0,"EB",0
39,"39048",1772,1311,1295,8,16,"EB",1
4,"4060",416,286,282,2,4,"EB",0
22,"22043",93,53,53,0,0,"EB",0
14,"14049",16185,11561,11323,145,238,"EB",6
4,"4031",2238,1649,1645,15,4,"EB",1
39,"39077",237,151,148,1,3,"EB",0
50,"50082",82,57,57,0,0,"EB",0
50,"50230",1140,771,767,11,4,"EB",3
50,"50093",87,66,64,1,2,"EB",0
50,"50061",190,157,155,2,2,"EB",0
50,"50017",1773,1283,1265,13,18,"EB",1
50,"50184",87,70,70,0,0,"EB",0
14,"14006",1319,1088,1057,8,31,"EB",0
26,"26183",66,48,48,0,0,"EB",0
14,"14031",556,462,456,5,6,"EB",0
38,"38008",5699,3719,3669,26,50,"EB",2
50,"50218",112,88,88,1,0,"EB",0
22,"22235",88,69,68,1,1,"EB",0
26,"26072",287,239,235,3,4,"EB",0
14,"14053",5918,4054,3968,92,86,"EB",6
22,"22046",713,555,549,9,6,"EB",1
26,"26152",27,20,20,1,0,"EB",0
38,"38901",1466,908,894,4,14,"EB",0
22,"22002",99,81,81,0,0,"EB",0
39,"39056",2262,1683,1671,14,12,"EB",0
4,"4033",121,78,77,3,1,"EB",0
22,"22095",66,52,51,1,1,"EB",0
22,"22168",22,20,19,0,1,"EB",0
39,"39015",828,559,556,3,3,"EB",0
50,"50059",757,556,551,5,5,"EB",0
50,"50252",5019,3486,3456,53,30,"EB",8
26,"26081",15,14,14,1,0,"EB",0
4,"4074",2910,1813,1789,15,24,"EB",3
4,"4037",1212,890,875,17,15,"EB",0
38,"38009",4315,2846,2817,27,29,"EB",0
50,"50219",4283,3034,2990,30,44,"EB",17
14,"14017",10953,7929,7791,84,138,"EB",11
4,"4027",218,130,130,0,0,"EB",1
39,"39023",6563,4788,4753,14,35,"EB",3
4,"4096",285,222,222,0,0,"EB",0
26,"26010",85,66,63,1,3,"EB",0
22,"22139",80,57,57,1,0,"EB",0
26,"26146",84,56,55,0,1,"EB",0
50,"50296",385,240,235,3,5,"EB",2
26,"26043",346,243,235,2,8,"EB",0
26,"26134",81,67,67,3,0,"EB",0
22,"22202",147,128,128,3,0,"EB",1
50,"50259",82,55,55,2,0,"EB",2
50,"50292",130,108,107,0,1,"EB",0
50,"50186",37,26,26,1,0,"EB",0
50,"50111",181,130,130,1,0,"EB",1
38,"38032",13579,8941,8880,92,61,"EB",9
50,"50257",159,128,125,2,3,"EB",0
50,"50058",63,45,43,0,2,"EB",0
22,"22115",348,263,261,3,2,"EB",1
22,"22193",272,199,194,4,5,"EB",0
26,"26177",306,233,229,2,4,"EB",0
4,"4065",365,273,271,1,2,"EB",0
22,"22052",874,660,652,7,8,"EB",2
26,"26077",16,16,16,0,0,"EB",0
50,"50273",33,24,24,1,0,"EB",0
14,"14038",32742,23345,22974,242,371,"EB",30
50,"50074",6156,4100,4022,33,78,"EB",12
50,"50124",394,269,266,0,3,"EB",2
22,"22250",346,241,241,0,0,"EB",2
50,"50086",176,106,102,1,4,"EB",0
22,"22170",672,460,456,5,4,"EB",1
39,"39100",849,567,565,5,2,"EB",0
50,"50279",74,49,49,0,0,"EB",0
50,"50214",18,18,14,1,4,"EB",0
50,"50054",55,37,37,2,0,"EB",0
50,"50094",1500,1041,1022,12,19,"EB",3
22,"22042",116,91,89,1,2,"EB",0
39,"39035",9142,6574,6517,24,57,"EB",5
26,"26142",789,572,564,6,8,"EB",2
4,"4078",1127,725,718,8,7,"EB",0
50,"50160",2140,1421,1394,14,27,"EB",2
22,"22184",167,132,130,4,2,"EB",0
26,"26014",443,278,273,3,5,"EB",0
50,"50198",47,32,32,0,0,"EB",0
50,"50182",3657,2499,2485,23,14,"EB",7
50,"50037",125,85,80,0,5,"EB",0
50,"50222",1574,1024,1008,12,16,"EB",3
26,"26031",95,83,83,0,0,"EB",1
14,"14027",7890,5841,5726,78,115,"EB",8
22,"22246",63,43,43,0,0,"EB",0
26,"26056",404,312,301,2,11,"EB",0
50,"50235",2421,1721,1702,18,19,"EB",4
50,"50194",80,51,51,0,0,"EB",0
22,"22905",287,217,217,1,0,"EB",0
22,"22176",171,140,138,2,2,"EB",0
26,"26165",336,248,242,3,6,"EB",0
50,"50033",61,44,44,1,0,"EB",1
4,"4075",5462,3714,3676,19,38,"EB",2
4,"4091",318,251,250,0,1,"EB",0
4,"4021",179,132,129,2,3,"EB",0
4,"4020",302,207,206,2,1,"EB",0
50,"50050",87,62,62,1,0,"EB",0
26,"26148",154,125,122,3,3,"EB",0
50,"50109",95,65,62,2,3,"EB",0
38,"38029",1475,752,744,10,8,"EB",0
39,"39065",222,166,163,0,3,"EB",0
26,"26004",69,47,46,0,1,"EB",0
26,"26157",283,222,217,0,5,"EB",0
39,"39055",1065,747,736,4,11,"EB",0
50,"50191",446,327,326,1,1,"EB",1
4,"4102",14202,9264,9139,57,125,"EB",12
14,"14072",983,692,680,6,12,"EB",0
26,"26066",263,201,194,5,7,"EB",0
4,"4070",1529,1088,1076,8,12,"EB",0
50,"50014",119,81,81,0,0,"EB",0
22,"22187",288,220,220,2,0,"EB",0
50,"50151",607,450,449,12,1,"EB",2
26,"26018",10443,7664,7538,80,126,"EB",11
22,"22174",462,352,350,0,2,"EB",0
26,"26082",101,79,79,0,0,"EB",0
38,"38022",18630,11420,11284,87,136,"EB",9
14,"14020",336,227,225,0,2,"EB",0
50,"50007",51,34,34,1,0,"EB",0
26,"26145",239,194,187,3,7,"EB",0
14,"14058",7866,5451,5334,69,117,"EB",4
50,"50016",44,31,31,0,0,"EB",0
26,"26039",40,31,31,0,0,"EB",1
39,"39086",358,236,235,2,1,"EB",0
50,"50149",34,25,25,0,0,"EB",1
50,"50202",124,76,74,0,2,"EB",0
22,"22086",194,137,137,1,0,"EB",0
39,"39012",6772,4807,4755,31,52,"EB",3
4,"4061",625,489,479,5,10,"EB",0
50,"50019",63,46,46,0,0,"EB",0
26,"26033",162,133,132,3,1,"EB",2
50,"50138",45,37,37,3,0,"EB",0
50,"50031",134,78,75,0,3,"EB",1
50,"50118",2101,1484,1477,17,7,"EB",4
50,"50275",111,50,50,0,0,"EB",0
50,"50193",664,487,475,4,12,"EB",4
26,"26121",30,19,19,0,0,"EB",0
26,"26048",21,21,21,0,0,"EB",2
39,"39080",3477,2404,2388,4,16,"EB",2
50,"50076",70,56,56,0,0,"EB",0
39,"39040",4271,3103,3080,18,23,"EB",4
26,"26040",64,47,47,1,0,"EB",0
4,"4068",170,129,128,0,1,"EB",1
22,"22173",219,147,141,3,6,"EB",0
50,"50022",504,373,369,12,4,"EB",0
50,"50003",117,89,89,1,0,"EB",0
4,"4079",54675,35691,35365,328,326,"EB",59
26,"26100",54,43,43,0,0,"EB",1
50,"50069",66,33,33,1,0,"EB",0
14,"14069",7340,5100,5000,69,100,"EB",3
50,"50162",135,100,99,3,1,"EB",1
22,"22081",247,173,171,3,2,"EB",1
50,"50067",13928,9831,9699,92,132,"EB",34
39,"39007",386,265,264,0,1,"EB",0
4,"4045",1696,1268,1254,17,14,"EB",0
50,"50248",501,344,328,3,16,"EB",2
39,"39064",1352,1007,990,3,17,"EB",1
50,"50078",227,168,166,0,2,"EB",0
50,"50002",125,91,86,0,5,"EB",0
26,"26098",92,63,63,1,0,"EB",0
50,"50051",802,551,550,2,1,"EB",0
4,"4004",405,282,272,2,10,"EB",0
4,"4035",8439,5822,5768,45,54,"EB",5
22,"22215",127,81,81,0,0,"EB",0
22,"22175",184,129,128,0,1,"EB",0
39,"39002",3408,2360,2323,7,37,"EB",3
14,"14050",2350,1774,1720,20,54,"EB",1
26,"26174",134,100,99,3,1,"EB",0
50,"50126",2240,1528,1509,24,19,"EB",1
26,"26161",8,8,8,0,0,"EB",0
14,"14025",2834,2352,2299,9,53,"EB",1
50,"50106",123,78,78,0,0,"EB",1
22,"22247",28,18,18,0,0,"EB",0
4,"4043",517,398,395,1,3,"EB",1
50,"50129",212,129,127,0,2,"EB",0
26,"26151",412,317,317,4,0,"EB",0
14,"14062",945,700,693,2,7,"EB",0
14,"14047",1644,1198,1183,14,15,"EB",1
39,"39074",7050,5074,5029,26,45,"EB",1
26,"26155",145,120,119,0,1,"EB",0
50,"50115",3279,2170,2131,27,39,"EB",16
50,"50013",199,158,158,0,0,"EB",0
4,"4036",239,178,176,0,2,"EB",0
38,"38038",165135,101564,100807,709,757,"EB",106
39,"39009",3325,2306,2293,7,13,"EB",0
26,"26117",2105,1537,1500,17,37,"EB",5
22,"22044",234,166,164,1,2,"EB",0
4,"4009",140,109,106,2,3,"EB",0
22,"22059",1135,765,752,2,13,"EB",3
50,"50246",37,24,24,0,0,"EB",0
4,"4030",1052,690,678,6,12,"EB",1
50,"50176",220,142,142,3,0,"EB",0
39,"39072",325,184,182,0,2,"EB",0
26,"26131",34,33,33,0,0,"EB",0
39,"39066",866,616,606,6,10,"EB",1
14,"14039",2577,1858,1801,29,57,"EB",3
22,"22909",307,219,217,0,2,"EB",3
50,"50233",96,78,78,0,0,"EB",0
39,"39045",352,238,234,0,4,"EB",0
22,"22158",11994,8115,8049,79,66,"EB",33
22,"22011",98,80,79,0,1,"EB",0
14,"14036",3677,2619,2555,39,64,"EB",1
50,"50114",132,108,108,0,0,"EB",0
39,"39082",1611,1108,1102,8,6,"EB",2
4,"4101",4356,2818,2768,32,50,"EB",1
14,"14068",517,388,378,3,10,"EB",0
22,"22164",42,28,28,0,0,"EB",0
50,"50227",107,62,62,1,0,"EB",1
14,"14021",260521,185270,183300,2192,1970,"EB",441
39,"39081",440,330,327,1,3,"EB",0
26,"26094",67,51,51,0,0,"EB",0
4,"4016",2136,1486,1467,13,19,"EB",2
50,"50207",87,58,58,1,0,"EB",0
39,"39018",4284,3211,3177,22,34,"EB",7
39,"39075",136789,95707,95089,478,618,"EB",83
26,"26169",66,51,50,0,1,"EB",0
22,"22136",749,524,518,5,6,"EB",3
4,"4072",311,212,211,0,1,"EB",0
22,"22047",248,202,201,1,1,"EB",1
50,"50243",307,227,224,2,3,"EB",1
50,"50143",541,373,367,2,6,"EB",1
38,"38005",5646,3302,3283,24,19,"EB",4
50,"50090",134,96,96,0,0,"EB",0
39,"39083",1063,619,611,2,8,"EB",1
22,"22062",154,107,107,1,0,"EB",0
38,"38001",21069,10844,10777,63,67,"EB",14
50,"50046",162,125,125,6,0,"EB",0
50,"50011",117,90,89,3,1,"EB",0
50,"50080",34,27,27,0,0,"EB",0
14,"14901",932,753,750,6,3,"EB",0
50,"50295",48,41,41,0,0,"EB",0
22,"22063",161,128,126,0,2,"EB",0
26,"26074",107,87,86,2,1,"EB",0
50,"50189",678,494,487,6,7,"EB",0
22,"22218",39,34,34,0,0,"EB",0
39,"39073",10260,7537,7482,42,55,"EB",8
50,"50070",50,30,29,0,1,"EB",0
4,"4059",1000,676,666,3,10,"EB",0
22,"22053",783,494,492,6,2,"EB",4
50,"50081",487,355,349,5,6,"EB",2
22,"22124",183,119,119,0,0,"EB",0
22,"22022",542,405,403,2,2,"EB",3
4,"4093",1916,1143,1130,5,13,"EB",4
50,"50024",543,400,397,3,3,"EB",0
14,"14074",2225,1775,1743,17,32,"EB",0
38,"38039",11149,7375,7326,68,49,"EB",3
22,"22188",75,50,50,1,0,"EB",0
26,"26032",43,36,35,0,1,"EB",0
22,"22037",112,87,87,2,0,"EB",0
50,"50270",38,26,25,0,1,"EB",1
26,"26125",2665,1885,1853,21,32,"EB",1
50,"50008",5187,3334,3288,37,46,"EB",10
14,"14012",6046,4215,4120,56,95,"EB",5
4,"4012",184,151,150,3,1,"EB",0
50,"50040",82,66,66,1,0,"EB",0
4,"4050",742,465,464,0,1,"EB",0
26,"26139",58,43,43,2,0,"EB",0
4,"4086",1631,1128,1114,3,14,"EB",0
26,"26023",433,316,314,3,2,"EB",0
50,"50052",81,61,61,0,0,"EB",0
39,"39042",5910,4354,4315,14,39,"EB",3
4,"4032",5716,3727,3696,43,31,"EB",2
26,"26089",111981,80365,79216,893,1149,"EB",270
50,"50240",943,693,683,12,10,"EB",1
22,"22253",56,40,40,1,0,"EB",0
50,"50261",201,154,151,0,3,"EB",0
22,"22088",143,98,97,1,1,"EB",0
26,"26034",606,457,440,5,17,"EB",0
39,"39062",1864,1395,1376,3,19,"EB",0
50,"50155",95,65,65,0,0,"EB",0
22,"22021",1884,1331,1319,26,12,"EB",3
4,"4007",735,514,509,3,5,"EB",1
50,"50208",1761,1267,1250,16,17,"EB",3
50,"50274",64,46,43,1,3,"EB",0
26,"26054",291,225,223,3,2,"EB",1
39,"39010",610,457,453,1,4,"EB",0
14,"14008",2758,1880,1836,21,44,"EB",1
26,"26128",94,71,71,1,0,"EB",0
50,"50021",25,21,21,0,0,"EB",0
26,"26110",149,116,114,0,2,"EB",0
39,"39034",255,133,128,2,5,"EB",0
50,"50101",833,557,550,5,7,"EB",2
50,"50245",74,51,51,0,0,"EB",0
14,"14005",6298,3905,3828,71,77,"EB",6
38,"38047",1755,1132,1110,9,22,"EB",0
50,"50199",318,206,201,1,5,"EB",1
38,"38037",12817,7582,7494,55,88,"EB",3
4,"4902",45571,29423,29169,272,254,"EB",39
4,"4094",215,156,156,0,0,"EB",0
38,"38015",4055,2635,2601,16,34,"EB",1
50,"50169",333,231,230,0,1,"EB",1
50,"50220",45,38,38,0,0,"EB",0
39,"39099",3193,2363,2346,10,17,"EB",1
14,"14064",296,211,208,6,3,"EB",0
39,"39033",536,375,372,1,3,"EB",0
22,"22069",423,296,294,4,2,"EB",0
26,"26076",115,83,83,0,0,"EB",0
22,"22020",115,83,80,3,3,"EB",1
50,"50140",153,96,95,1,1,"EB",0
50,"50038",1404,1024,1007,15,17,"EB",1
14,"14009",2653,1658,1631,24,27,"EB",2
50,"50229",65,46,46,1,0,"EB",0
14,"14056",23477,15826,15470,177,356,"EB",16
22,"22029",118,85,83,1,2,"EB",0
50,"50079",226,162,160,1,2,"EB",0
50,"50181",999,748,732,3,16,"EB",1
50,"50183",316,227,223,1,4,"EB",0
50,"50247",852,600,594,8,6,"EB",2
22,"22195",238,190,186,0,4,"EB",0
38,"38052",1283,806,794,3,12,"EB",0
38,"38019",13884,7888,7809,49,79,"EB",14
22,"22200",239,165,164,2,1,"EB",2
22,"22072",197,127,126,1,1,"EB",0
26,"26088",39,35,34,0,1,"EB",0
26,"26050",125,92,91,1,1,"EB",1
50,"50148",304,213,211,2,2,"EB",1
22,"22084",571,400,391,5,9,"EB",1
26,"26026",1268,986,970,4,16,"EB",0
26,"26173",8,8,8,1,0,"EB",0
22,"22252",118,95,91,1,4,"EB",1
50,"50157",289,199,196,1,3,"EB",0
50,"50063",64,49,49,0,0,"EB",0
26,"26065",63,46,43,0,3,"EB",0
14,"14055",18411,13054,12798,192,256,"EB",23
4,"4067",504,340,330,4,10,"EB",1
14,"14902",1113,877,851,15,26,"EB",1
22,"22135",173,123,121,0,2,"EB",0
26,"26016",28,20,18,0,2,"EB",0
26,"26095",93,71,68,0,3,"EB",0
26,"26060",78,51,50,2,1,"EB",0
22,"22907",1463,1016,1006,21,10,"EB",3
26,"26140",239,180,177,1,3,"EB",0
26,"26127",182,149,149,1,0,"EB",0
22,"22232",88,61,61,2,0,"EB",0
50,"50104",320,251,251,1,0,"EB",0
50,"50154",114,92,92,1,0,"EB",0
22,"22213",2918,2084,2062,20,22,"EB",2
39,"39030",1874,1199,1187,6,12,"EB",1
50,"50267",565,380,375,4,5,"EB",1
22,"22036",84,71,71,1,0,"EB",2
22,"22119",1267,880,871,4,9,"EB",4
14,"14071",874,551,540,5,11,"EB",0
50,"50163",3846,2863,2840,25,23,"EB",8
22,"22197",436,327,325,3,2,"EB",0
50,"50285",657,448,442,4,6,"EB",4
4,"4013",143819,93083,92383,893,700,"EB",204
26,"26058",149,114,114,2,0,"EB",1
39,"39047",1998,1408,1392,8,16,"EB",0
26,"26030",18,18,17,1,1,"EB",0
38,"38034",3997,2687,2648,19,39,"EB",0
22,"22107",102,53,53,0,0,"EB",1
14,"14029",4001,2855,2821,30,34,"EB",2
50,"50173",156,114,114,0,0,"EB",0
4,"4022",356,237,236,5,1,"EB",1
14,"14048",1199,883,866,4,17,"EB",0
26,"26087",180,123,123,3,0,"EB",0
50,"50161",98,75,74,2,1,"EB",0
38,"38036",6857,4170,4090,37,80,"EB",4
22,"22251",327,259,256,0,3,"EB",0
22,"22055",305,242,235,2,7,"EB",0
14,"14003",1245,925,907,5,18,"EB",0
50,"50053",643,476,466,3,10,"EB",0
14,"14075",552,413,391,5,22,"EB",1
22,"22085",94,78,76,0,2,"EB",0
39,"39026",1702,1160,1151,11,9,"EB",0
50,"50029",594,432,431,3,1,"EB",2
14,"14040",3749,2905,2845,53,60,"EB",1
50,"50276",118,91,91,0,0,"EB",0
50,"50234",242,159,154,4,5,"EB",0
50,"50120",55,42,42,1,0,"EB",1
39,"39095",2266,1637,1619,8,18,"EB",0
38,"38021",1609,900,876,2,24,"EB",0
50,"50122",68,43,42,1,1,"EB",0
39,"39016",23850,17235,17106,70,129,"EB",16
50,"50075",70,55,55,1,0,"EB",0
26,"26011",7251,4807,4711,47,96,"EB",8
39,"39070",126,91,89,0,2,"EB",0
22,"22049",73,62,62,0,0,"EB",1
26,"26084",7264,5130,5059,61,71,"EB",11
39,"39061",3470,2605,2591,14,14,"EB",2
14,"14046",4442,3283,3190,34,93,"EB",1
50,"50271",246,179,173,4,6,"EB",1
14,"14015",2045,1465,1418,16,47,"EB",3
50,"50237",100,75,75,2,0,"EB",1
38,"38018",4466,2867,2821,21,46,"EB",2
22,"22106",20,13,13,2,0,"EB",0
50,"50204",2396,1723,1712,17,11,"EB",3
26,"26028",135,111,110,3,1,"EB",0
26,"26154",10,10,9,1,1,"EB",0
50,"50277",45,34,34,0,0,"EB",0
22,"22099",490,349,343,2,6,"EB",0
50,"50282",55,38,38,1,0,"EB",0
38,"38044",2215,1270,1257,5,13,"EB",3
14,"14044",1613,1186,1164,10,22,"EB",3
39,"39021",464,370,364,1,6,"EB",0
50,"50123",430,304,297,3,7,"EB",0
39,"39090",773,557,553,2,4,"EB",0
39,"39049",304,198,195,2,3,"EB",1
4,"4056",165,120,120,0,0,"EB",0
50,"50005",228,185,184,2,1,"EB",1
26,"26168",5584,3757,3696,35,61,"EB",5
50,"50212",32,26,26,0,0,"EB",0
39,"39008",13900,9814,9734,63,80,"EB",10
4,"4046",849,617,612,6,5,"EB",0
38,"38053",3768,2275,2244,16,31,"EB",0
50,"50166",235,186,186,0,0,"EB",1
22,"22112",9525,6317,6245,91,72,"EB",28
22,"22904",751,516,511,3,5,"EB",1
26,"26111",250,191,187,3,4,"EB",0
50,"50135",85,59,59,0,0,"EB",0
50,"50286",75,54,53,0,1,"EB",0
14,"14019",6380,4933,4831,71,102,"EB",14
50,"50105",277,203,198,4,5,"EB",0
39,"39102",2229,1524,1514,10,10,"EB",1
50,"50190",669,532,518,10,14,"EB",2
26,"26149",42,34,34,0,0,"EB",0
26,"26075",315,234,229,1,5,"EB",0
22,"22208",192,150,147,1,3,"EB",0
39,"39092",863,534,533,3,1,"EB",0
22,"22061",6567,4446,4410,48,36,"EB",10
4,"4044",1542,1092,1080,8,12,"EB",2
26,"26147",34,26,25,0,1,"EB",0
14,"14052",9039,5579,5478,79,101,"EB",3
50,"50201",449,345,344,4,1,"EB",2
50,"50132",780,549,538,7,11,"EB",1
14,"14007",15016,10248,10043,99,205,"EB",7
50,"50231",253,199,195,4,4,"EB",2
39,"39020",23993,15944,15792,89,152,"EB",20
39,"39093",297,216,214,1,2,"EB",0
39,"39005",1419,1039,1030,9,9,"EB",2
26,"26153",10,10,10,1,0,"EB",0
22,"22163",426,338,335,0,3,"EB",1
22,"22162",125,94,94,0,0,"EB",0
38,"38004",4536,2914,2887,28,27,"EB",1
50,"50180",107,85,85,1,0,"EB",0
4,"4024",3241,2315,2290,34,25,"EB",4
26,"26129",939,657,644,2,13,"EB",0
50,"50087",28,19,19,0,0,"EB",0
39,"39039",540,355,355,1,0,"EB",0
39,"39101",231,134,132,2,2,"EB",1
39,"39063",936,618,616,4,2,"EB",0
50,"50287",253,189,188,11,1,"EB",0
14,"14043",7406,5323,5211,63,112,"EB",8
22,"22227",200,140,140,2,0,"EB",1
26,"26020",449,319,313,1,6,"EB",0
4,"4053",12545,8864,8744,67,120,"EB",13
26,"26002",821,611,597,1,14,"EB",0
50,"50146",189,149,149,3,0,"EB",0
22,"22127",521,353,352,5,1,"EB",2
22,"22223",77,60,59,2,1,"EB",1
50,"50099",3036,2137,2113,17,24,"EB",2
50,"50232",160,93,92,1,1,"EB",1
26,"26107",86,65,64,1,1,"EB",0
39,"39024",1802,1325,1314,7,11,"EB",2
22,"22068",64,41,41,1,0,"EB",0
26,"26176",56,43,43,0,0,"EB",0
38,"38031",29301,20926,20701,157,225,"EB",33
50,"50043",241,155,154,1,1,"EB",0
50,"50902",77,65,62,0,3,"EB",0
26,"26099",1220,956,931,7,25,"EB",0
26,"26052",146,106,105,0,1,"EB",0
14,"14067",3842,2863,2800,42,63,"EB",5
39,"39054",4541,3271,3252,30,19,"EB",2
26,"26019",346,260,251,2,9,"EB",1
50,"50255",199,152,147,3,5,"EB",0
38,"38020",16057,9921,9809,66,112,"EB",1
26,"26102",6076,4276,4205,52,71,"EB",4
26,"26091",147,115,114,0,1,"EB",0
4,"4057",1261,886,872,6,14,"EB",0
22,"22236",232,190,188,2,2,"EB",0
50,"50223",906,702,693,9,9,"EB",0
50,"50185",140,93,92,1,1,"EB",0
22,"22025",1022,705,694,14,11,"EB",4
22,"22040",149,119,119,3,0,"EB",0
26,"26003",379,311,306,1,5,"EB",0
39,"39027",3045,2231,2199,23,32,"EB",1
50,"50288",3440,2513,2486,26,27,"EB",3
50,"50077",201,140,140,1,0,"EB",0
38,"38045",3542,1825,1801,7,24,"EB",1
50,"50062",1885,1332,1308,15,24,"EB",3
38,"38028",22144,14312,14174,89,138,"EB",14
50,"50215",20,14,14,0,0,"EB",0
26,"26115",23,22,21,3,1,"EB",0
22,"22109",261,184,183,1,1,"EB",0
4,"4100",9433,5599,5556,48,43,"EB",18
4,"4041",344,227,222,4,5,"EB",2
14,"14034",302,222,215,1,7,"EB",0
26,"26114",72,61,61,0,0,"EB",0
22,"22094",102,69,69,3,0,"EB",0
50,"50284",129,98,98,0,0,"EB",1
26,"26167",50,34,33,1,1,"EB",0
39,"39006",1729,1207,1192,1,15,"EB",1
39,"39036",965,707,703,4,4,"EB",0
4,"4005",534,422,419,3,3,"EB",0
50,"50187",55,42,42,0,0,"EB",0
50,"50294",65,45,45,0,0,"EB",1
22,"22228",532,371,364,4,7,"EB",3
22,"22083",447,360,355,6,5,"EB",0
14,"14018",3617,2632,2568,31,64,"EB",2
50,"50289",53,42,42,1,0,"EB",0
22,"22181",86,55,54,2,1,"EB",0
22,"22244",42,33,32,1,1,"EB",0
38,"38007",1619,1053,1043,3,10,"EB",0
22,"22186",189,148,145,3,3,"EB",2
39,"39046",1342,910,902,3,8,"EB",1
50,"50139",318,237,237,1,0,"EB",0
4,"4054",363,279,278,2,1,"EB",0
50,"50254",179,115,113,0,2,"EB",0
50,"50156",212,156,151,2,5,"EB",0
50,"50055",3635,2298,2244,36,54,"EB",16
22,"22105",102,65,65,0,0,"EB",0
22,"22089",274,195,193,2,2,"EB",0
50,"50027",223,166,161,2,5,"EB",1
26,"26181",15,14,14,0,0,"EB",0
26,"26073",92,68,66,1,2,"EB",0
4,"4082",275,185,182,2,3,"EB",0
26,"26025",84,69,65,2,4,"EB",0
22,"22125",39530,27358,27075,344,283,"EB",127
50,"50209",2785,1893,1865,24,28,"EB",3
22,"22130",10146,6505,6436,57,69,"EB",14
22,"22207",121,66,65,0,1,"EB",1
26,"26104",10,9,9,1,0,"EB",0
26,"26064",2335,1617,1584,28,33,"EB",0
50,"50280",290,220,216,1,4,"EB",1
50,"50264",151,111,110,0,1,"EB",0
4,"4063",1058,766,750,6,16,"EB",0
26,"26061",1542,1104,1079,12,25,"EB",1
26,"26027",139,99,97,0,2,"EB",0
26,"26035",16,12,11,0,1,"EB",0
26,"26015",185,140,138,2,2,"EB",0
14,"14065",1820,1374,1352,13,22,"EB",1
50,"50134",120,85,82,4,3,"EB",0
26,"26166",144,125,124,0,1,"EB",0
22,"22160",207,149,149,1,0,"EB",0
22,"22243",43,32,31,0,1,"EB",0
4,"4006",7192,4389,4335,39,54,"EB",2
26,"26086",15,15,15,0,0,"EB",0
38,"38002",971,577,570,8,7,"EB",0
26,"26024",204,157,156,1,1,"EB",1
14,"14024",1849,1417,1391,5,26,"EB",1
26,"26112",218,152,148,1,4,"EB",0
50,"50010",67,52,52,1,0,"EB",0
22,"22082",288,217,214,0,3,"EB",0
4,"4023",118,84,82,2,2,"EB",0
39,"39043",1517,1167,1154,3,13,"EB",0
22,"22017",826,613,608,2,5,"EB",1
22,"22220",147,106,105,1,1,"EB",0
22,"22080",263,188,184,3,4,"EB",2
22,"22008",144,113,112,2,1,"EB",0
4,"4028",207,175,171,1,4,"EB",0
50,"50048",33,25,25,0,0,"EB",0
4,"4087",157,115,113,0,2,"EB",1
4,"4089",687,484,479,2,5,"EB",1
26,"26055",39,30,30,0,0,"EB",0
50,"50084",67,47,47,1,0,"EB",0
50,"50060",171,126,125,1,1,"EB",0
26,"26059",1109,801,791,6,10,"EB",1
39,"39011",1587,1178,1178,6,0,"EB",2
50,"50903",2268,1685,1670,16,15,"EB",4
22,"22131",84,62,58,5,4,"EB",1
50,"50130",354,225,222,1,3,"EB",1
22,"22051",90,72,72,2,0,"EB",0
26,"26103",814,617,603,10,14,"EB",0
50,"50177",288,196,193,0,3,"EB",1
50,"50102",815,594,584,7,10,"EB",1
26,"26150",97,77,77,1,0,"EB",0
39,"39052",19005,13859,13748,83,111,"EB",16
38,"38050",2417,1288,1273,9,15,"EB",3
50,"50035",74,57,57,0,0,"EB",0
39,"39017",550,378,372,1,6,"EB",0
4,"4090",298,229,225,1,4,"EB",0
22,"22199",6884,4438,4384,71,54,"EB",13
26,"26068",78,61,61,0,0,"EB",0
22,"22249",125,93,92,1,1,"EB",0
26,"26143",260,197,192,1,5,"EB",0
38,"38043",19365,12355,12212,126,143,"EB",16
50,"50298",5439,4053,4007,41,46,"EB",9
22,"22058",193,141,141,0,0,"EB",2
50,"50028",78,53,53,0,0,"EB",0
4,"4017",1276,833,818,4,15,"EB",1
22,"22023",385,293,283,2,10,"EB",1
50,"50283",69,46,46,0,0,"EB",0
39,"39098",1381,1088,1080,5,8,"EB",1
50,"50165",1768,1255,1222,20,33,"EB",10
4,"4097",231,173,173,1,0,"EB",0
4,"4064",2878,1937,1924,16,13,"EB",6
26,"26067",22,18,18,3,0,"EB",0
26,"26132",106,73,70,2,3,"EB",0
22,"22172",520,373,369,5,4,"EB",1
20,"20081",7690,5382,5363,31,19,"EB",5
20,"20061",4427,3073,3053,13,20,"EB",4
20,"20051",6736,4829,4804,22,25,"EB",4
20,"20020",114,64,64,0,0,"EB",0
20,"20077",5269,3845,3830,9,15,"EB",1
20,"20006",261,154,153,1,1,"EB",1
20,"20030",21147,14598,14521,92,77,"EB",17
20,"20044",355,261,261,1,0,"EB",1
20,"20036",13208,9102,9056,59,46,"EB",28
20,"20074",11520,8379,8357,19,22,"EB",6
20,"20080",7705,5276,5244,21,32,"EB",5
20,"20046",1243,822,816,1,6,"EB",0
20,"20023",441,254,251,1,3,"EB",0
20,"20037",101,69,69,0,0,"EB",0
20,"20064",12395,7959,7916,42,43,"EB",15
20,"20055",17300,11784,11725,43,59,"EB",9
20,"20041",241,143,142,2,1,"EB",0
20,"20056",4077,2796,2781,12,15,"EB",4
20,"20019",9892,6740,6717,40,23,"EB",4
20,"20029",4264,3116,3104,14,12,"EB",0
20,"20043",1718,1189,1183,2,6,"EB",1
20,"20034",3200,2193,2180,8,13,"EB",4
20,"20073",4707,3272,3260,14,12,"EB",13
20,"20068",179,119,119,2,0,"EB",0
20,"20905",160,123,123,2,0,"EB",0
20,"20003",549,360,355,1,5,"EB",3
20,"20025",1110,791,788,4,3,"EB",1
20,"20076",7013,5011,4991,16,20,"EB",8
20,"20075",4312,2848,2845,8,3,"EB",2
20,"20066",437,288,286,1,2,"EB",0
20,"20016",1529,887,883,3,4,"EB",1
20,"20033",858,644,638,1,6,"EB",1
20,"20013",5433,3906,3893,24,13,"EB",6
20,"20042",3180,2056,2053,7,3,"EB",5
20,"20060",87,75,75,0,0,"EB",0
20,"20002",359,234,231,7,3,"EB",0
20,"20022",849,574,571,8,3,"EB",0
20,"20047",455,314,314,1,0,"EB",0
20,"20027",2761,1866,1861,10,5,"EB",0
20,"20067",30609,20017,19927,111,90,"EB",30
20,"20045",47031,30933,30787,172,146,"EB",50
20,"20070",1084,798,795,7,3,"EB",1
20,"20007",337,223,221,2,2,"EB",0
20,"20024",395,245,245,4,0,"EB",0
20,"20065",2921,1983,1970,16,13,"EB",0
20,"20054",461,294,294,1,0,"EB",0
20,"20008",713,424,424,5,0,"EB",1
20,"20063",8023,5611,5597,19,14,"EB",5
20,"20017",8462,5944,5917,11,27,"EB",3
20,"20904",87,56,55,1,1,"EB",0
20,"20072",4762,3175,3153,21,22,"EB",4
20,"20059",8892,6505,6490,18,15,"EB",3
20,"20021",185,104,104,2,0,"EB",0
20,"20005",1274,822,822,1,0,"EB",0
20,"20902",14282,9670,9618,52,52,"EB",16
20,"20012",149,104,104,1,0,"EB",0
20,"20057",198,148,147,1,1,"EB",2
20,"20010",1524,1057,1053,5,4,"EB",2
20,"20901",1399,960,957,3,3,"EB",0
20,"20069",147446,102068,101696,564,372,"EB",200
20,"20014",1161,699,693,0,6,"EB",0
20,"20028",2254,1442,1441,6,1,"EB",2
20,"20058",740,523,522,3,1,"EB",2
20,"20015",1245,880,876,5,4,"EB",1
20,"20071",15062,10442,10407,47,35,"EB",20
20,"20035",480,361,361,0,0,"EB",0
20,"20078",1143,819,816,1,3,"EB",1
20,"20004",230,133,133,2,0,"EB",0
20,"20048",183,112,112,0,0,"EB",1
20,"20062",941,688,683,1,5,"EB",1
20,"20906",128,87,87,0,0,"EB",0
20,"20009",11369,7402,7355,32,47,"EB",15
20,"20026",207,172,171,4,1,"EB",1
20,"20018",11231,7640,7611,33,29,"EB",4
20,"20079",18151,13106,13054,58,52,"EB",9
20,"20053",4856,3169,3153,15,16,"EB",4
20,"20011",1624,1234,1225,3,9,"EB",2
20,"20039",2126,1623,1618,9,5,"EB",1
20,"20052",1050,746,743,4,3,"EB",0
20,"20050",275,174,174,2,0,"EB",0
20,"20001",253,163,163,1,0,"EB",0
20,"20032",8654,6000,5972,21,28,"EB",10
20,"20040",15771,10549,10481,54,68,"EB",11
20,"20031",185,113,112,3,1,"EB",0
20,"20903",5033,3355,3341,18,14,"EB",4
20,"20907",118,82,82,0,0,"EB",1
20,"20038",387,294,293,2,1,"EB",0
20,"20049",4195,2918,2901,12,17,"EB",3
36,"36053",5783,3955,3899,39,56,"EB",5
36,"36061",8613,5822,5718,56,104,"EB",5
36,"36031",563,426,420,7,6,"EB",2
36,"36059",4641,2844,2796,29,48,"EB",1
36,"36048",5248,3429,3378,25,51,"EB",5
36,"36058",4957,3043,2994,55,49,"EB",4
36,"36006",11502,8057,7927,53,130,"EB",6
36,"36022",9046,5834,5720,37,114,"EB",10
36,"36043",4696,3038,3003,21,35,"EB",1
36,"36033",12305,8759,8597,67,162,"EB",11
36,"36056",4932,3368,3310,24,58,"EB",5
36,"36050",7645,5137,5049,48,88,"EB",7
36,"36029",16126,10936,10771,96,165,"EB",14
36,"36041",13691,9022,8916,85,106,"EB",15
36,"36003",10023,6877,6789,66,88,"EB",8
36,"36014",1867,1265,1243,16,22,"EB",2
36,"36051",14358,9408,9255,86,153,"EB",8
36,"36009",4401,2712,2649,33,63,"EB",2
36,"36042",18125,11975,11775,126,200,"EB",15
36,"36007",1610,1047,1016,5,31,"EB",1
36,"36023",8258,5504,5384,44,120,"EB",5
36,"36057",238417,165843,164264,1641,1579,"EB",231
36,"36020",2172,1435,1418,19,17,"EB",0
36,"36004",10109,6611,6502,79,109,"EB",9
36,"36032",3527,2407,2369,24,38,"EB",7
36,"36034",3299,2155,2132,15,23,"EB",4
36,"36038",66807,46235,45781,493,454,"EB",68
36,"36052",7266,4772,4685,43,87,"EB",6
36,"36002",3049,1994,1968,22,26,"EB",0
36,"36005",8105,5258,5152,54,106,"EB",6
36,"36027",4401,2940,2781,20,159,"EB",4
36,"36060",30431,19909,19673,206,236,"EB",36
36,"36039",15609,10562,10341,102,221,"EB",14
36,"36037",2538,1650,1625,12,25,"EB",1
36,"36010",2825,1983,1947,19,36,"EB",2
36,"36008",21845,14553,14373,138,180,"EB",26
36,"36049",6990,4877,4787,40,90,"EB",9
36,"36018",3033,1951,1926,9,25,"EB",2
36,"36030",3921,2516,2484,31,32,"EB",1
36,"36040",2505,1597,1563,15,34,"EB",6
36,"36001",2397,1674,1651,6,23,"EB",1
36,"36046",4073,2887,2818,31,69,"EB",1
36,"36016",1069,639,633,5,6,"EB",0
36,"36015",4079,2653,2606,29,47,"EB",1
36,"36021",12180,8188,8058,115,130,"EB",9
36,"36047",2248,1379,1363,11,16,"EB",3
36,"36028",4049,2783,2739,22,44,"EB",2
36,"36035",14615,10011,9880,103,131,"EB",10
36,"36054",11107,7027,6894,57,133,"EB",10
36,"36013",2216,1298,1290,18,8,"EB",1
36,"36901",4154,3094,3029,21,65,"EB",1
36,"36026",19890,13041,12891,169,150,"EB",19
36,"36045",24459,16966,16735,124,231,"EB",23
36,"36024",16335,11431,11256,99,175,"EB",9
36,"36017",17364,11771,11598,123,173,"EB",11
36,"36902",5028,3453,3396,19,57,"EB",4
36,"36019",1462,916,908,8,8,"EB",1
36,"36036",2546,1763,1742,14,21,"EB",0
36,"36055",13585,9177,8986,115,191,"EB",8
36,"36044",2527,1535,1499,12,36,"EB",1
36,"36025",2127,1235,1221,5,14,"EB",2
25,"25041",525,375,370,4,5,"ECP-GUANYEM",21
8,"8032",2100,1472,1465,12,7,"ECP-GUANYEM",198
43,"43176",746,564,561,2,3,"ECP-GUANYEM",48
8,"8023",7029,5027,5000,39,27,"ECP-GUANYEM",755
43,"43135",339,255,255,0,0,"ECP-GUANYEM",17
17,"17038",377,303,301,0,2,"ECP-GUANYEM",26
25,"25910",91,63,63,0,0,"ECP-GUANYEM",8
17,"17061",180,141,139,1,2,"ECP-GUANYEM",10
8,"8011",1739,1360,1353,10,7,"ECP-GUANYEM",73
17,"17105",248,187,186,2,1,"ECP-GUANYEM",13
43,"43109",2706,1751,1738,17,13,"ECP-GUANYEM",258
25,"25150",167,132,130,2,2,"ECP-GUANYEM",8
8,"8261",2405,1726,1718,11,8,"ECP-GUANYEM",211
8,"8269",2729,2114,2105,9,9,"ECP-GUANYEM",149
25,"25057",208,151,149,4,2,"ECP-GUANYEM",23
25,"25194",410,292,289,3,3,"ECP-GUANYEM",15
8,"8222",1821,1439,1424,7,15,"ECP-GUANYEM",223
17,"17146",3150,2243,2224,8,19,"ECP-GUANYEM",333
43,"43170",877,664,661,4,3,"ECP-GUANYEM",45
43,"43063",544,376,374,2,2,"ECP-GUANYEM",32
8,"8106",7500,5442,5410,43,32,"ECP-GUANYEM",701
25,"25093",629,455,443,5,12,"ECP-GUANYEM",25
8,"8091",5428,4048,4024,20,24,"ECP-GUANYEM",669
25,"25088",96,73,73,0,0,"ECP-GUANYEM",3
8,"8143",2727,1989,1977,19,12,"ECP-GUANYEM",234
8,"8047",3751,2600,2578,26,22,"ECP-GUANYEM",221
25,"25189",2181,1468,1461,11,7,"ECP-GUANYEM",146
8,"8076",16526,11988,11893,90,95,"ECP-GUANYEM",1916
43,"43058",95,78,78,0,0,"ECP-GUANYEM",8
25,"25255",390,301,301,0,0,"ECP-GUANYEM",19
8,"8238",14946,11911,11873,85,38,"ECP-GUANYEM",1483
17,"17095",20044,12638,12576,88,62,"ECP-GUANYEM",1746
25,"25172",1762,1332,1323,8,9,"ECP-GUANYEM",58
25,"25141",154,105,104,3,1,"ECP-GUANYEM",5
8,"8904",10516,7068,7025,54,43,"ECP-GUANYEM",1545
43,"43178",1435,1071,1066,2,5,"ECP-GUANYEM",114
43,"43147",528,425,420,3,5,"ECP-GUANYEM",16
25,"25164",353,259,255,0,4,"ECP-GUANYEM",8
17,"17902",1294,992,990,9,2,"ECP-GUANYEM",61
25,"25153",190,139,136,0,3,"ECP-GUANYEM",7
43,"43011",1086,862,860,5,2,"ECP-GUANYEM",52
8,"8100",2083,1707,1699,13,8,"ECP-GUANYEM",72
8,"8071",249,209,208,0,1,"ECP-GUANYEM",22
8,"8060",139,110,108,1,2,"ECP-GUANYEM",3
8,"8055",542,426,424,3,2,"ECP-GUANYEM",34
8,"8070",269,215,211,1,4,"ECP-GUANYEM",16
8,"8012",1726,1323,1309,17,14,"ECP-GUANYEM",64
17,"17181",3458,2454,2443,18,11,"ECP-GUANYEM",280
8,"8270",19014,13635,13594,74,41,"ECP-GUANYEM",1609
8,"8075",4144,2951,2943,20,8,"ECP-GUANYEM",405
8,"8029",3586,2868,2862,20,6,"ECP-GUANYEM",294
8,"8019",1122912,824423,821037,5287,3386,"ECP-GUANYEM",128403
43,"43012",3700,2882,2858,20,24,"ECP-GUANYEM",409
8,"8241",70,52,52,0,0,"ECP-GUANYEM",4
43,"43102",458,331,324,2,7,"ECP-GUANYEM",30
8,"8169",48478,35283,35114,278,169,"ECP-GUANYEM",7600
8,"8207",2026,1667,1659,12,8,"ECP-GUANYEM",121
8,"8167",6056,4520,4500,38,20,"ECP-GUANYEM",952
17,"17112",198,148,147,3,1,"ECP-GUANYEM",13
8,"8300",5927,4609,4589,41,20,"ECP-GUANYEM",778
17,"17023",27314,18677,18546,117,131,"ECP-GUANYEM",3121
17,"17139",1407,1128,1119,8,9,"ECP-GUANYEM",54
25,"25145",75,59,59,0,0,"ECP-GUANYEM",2
8,"8162",2118,1581,1576,13,5,"ECP-GUANYEM",228
8,"8184",55053,38519,38323,298,196,"ECP-GUANYEM",7124
8,"8204",3141,2395,2383,16,12,"ECP-GUANYEM",403
8,"8134",848,618,609,4,9,"ECP-GUANYEM",75
8,"8196",19542,14264,14185,123,79,"ECP-GUANYEM",2608
17,"17014",66,51,49,0,2,"ECP-GUANYEM",3
8,"8004",208,177,177,1,0,"ECP-GUANYEM",9
8,"8151",450,351,346,5,5,"ECP-GUANYEM",9
25,"25001",143,102,102,1,0,"ECP-GUANYEM",11
17,"17216",158,122,121,0,1,"ECP-GUANYEM",1
17,"17172",452,336,335,5,1,"ECP-GUANYEM",27
25,"25029",1590,1190,1185,4,5,"ECP-GUANYEM",76
8,"8308",139,109,109,1,0,"ECP-GUANYEM",6
25,"25182",1043,763,760,8,3,"ECP-GUANYEM",65
8,"8144",722,551,545,3,6,"ECP-GUANYEM",34
8,"8249",274,238,237,0,1,"ECP-GUANYEM",17
17,"17062",5982,4025,4001,19,24,"ECP-GUANYEM",381
8,"8178",444,363,361,2,2,"ECP-GUANYEM",38
25,"25040",10651,7041,6987,57,54,"ECP-GUANYEM",536
25,"25180",227,158,155,1,3,"ECP-GUANYEM",13
17,"17106",142,114,114,0,0,"ECP-GUANYEM",11
43,"43013",4406,3004,2975,19,29,"ECP-GUANYEM",322
17,"17005",457,322,320,3,2,"ECP-GUANYEM",19
8,"8282",6731,5333,5317,40,16,"ECP-GUANYEM",692
8,"8223",1897,1345,1341,10,4,"ECP-GUANYEM",134
17,"17178",1065,774,771,9,3,"ECP-GUANYEM",40
17,"17133",1262,976,964,7,12,"ECP-GUANYEM",45
8,"8087",144,120,120,0,0,"ECP-GUANYEM",7
17,"17197",128,97,97,0,0,"ECP-GUANYEM",7
17,"17002",578,477,474,2,3,"ECP-GUANYEM",29
25,"25121",632,380,374,3,6,"ECP-GUANYEM",37
17,"17013",2765,1999,1985,15,14,"ECP-GUANYEM",184
25,"25171",2117,1539,1534,5,5,"ECP-GUANYEM",109
17,"17067",704,551,549,6,2,"ECP-GUANYEM",22
8,"8301",49348,36261,36045,292,216,"ECP-GUANYEM",7016
8,"8113",52589,36864,36690,244,174,"ECP-GUANYEM",3685
8,"8141",4578,3369,3357,28,12,"ECP-GUANYEM",233
17,"17093",913,637,634,5,3,"ECP-GUANYEM",49
17,"17137",3486,2812,2808,15,4,"ECP-GUANYEM",164
43,"43118",422,338,338,0,0,"ECP-GUANYEM",35
25,"25173",1646,1180,1169,6,11,"ECP-GUANYEM",160
25,"25166",170,131,130,2,1,"ECP-GUANYEM",3
43,"43027",168,129,129,3,0,"ECP-GUANYEM",6
17,"17102",556,398,396,1,2,"ECP-GUANYEM",15
8,"8244",6099,4733,4706,39,27,"ECP-GUANYEM",945
8,"8034",820,644,640,0,4,"ECP-GUANYEM",27
17,"17022",7043,4940,4903,34,37,"ECP-GUANYEM",466
8,"8083",1672,1433,1430,6,3,"ECP-GUANYEM",61
8,"8182",2922,2041,2031,10,10,"ECP-GUANYEM",277
25,"25012",2349,1563,1556,17,7,"ECP-GUANYEM",196
8,"8284",12597,8244,8183,60,61,"ECP-GUANYEM",1163
43,"43089",279,201,201,1,0,"ECP-GUANYEM",30
17,"17214",714,516,511,6,5,"ECP-GUANYEM",32
17,"17049",3246,2527,2502,12,25,"ECP-GUANYEM",224
8,"8101",175048,121359,120620,830,739,"ECP-GUANYEM",20724
17,"17173",181,143,143,1,0,"ECP-GUANYEM",9
8,"8158",3094,2261,2251,11,10,"ECP-GUANYEM",338
17,"17188",171,134,134,1,0,"ECP-GUANYEM",15
17,"17170",173,140,140,2,0,"ECP-GUANYEM",4
8,"8109",207,176,174,0,2,"ECP-GUANYEM",9
43,"43049",727,557,555,3,2,"ECP-GUANYEM",32
25,"25200",318,245,245,0,0,"ECP-GUANYEM",8
17,"17050",664,554,550,10,4,"ECP-GUANYEM",33
8,"8305",27661,20346,20221,118,125,"ECP-GUANYEM",2236
25,"25239",582,330,330,3,0,"ECP-GUANYEM",27
43,"43082",350,276,271,5,5,"ECP-GUANYEM",10
25,"25073",559,377,377,2,0,"ECP-GUANYEM",27
8,"8085",986,769,767,6,2,"ECP-GUANYEM",50
17,"17187",625,496,492,3,4,"ECP-GUANYEM",60
17,"17200",624,469,467,6,2,"ECP-GUANYEM",38
17,"17153",189,150,149,1,1,"ECP-GUANYEM",15
8,"8138",4461,3286,3259,27,27,"ECP-GUANYEM",273
43,"43065",379,281,277,4,4,"ECP-GUANYEM",22
43,"43004",6288,4314,4262,36,52,"ECP-GUANYEM",518
8,"8114",18838,13519,13442,81,77,"ECP-GUANYEM",2233
8,"8025",1573,1170,1160,9,10,"ECP-GUANYEM",184
25,"25102",647,484,482,5,2,"ECP-GUANYEM",36
43,"43039",101,77,77,0,0,"ECP-GUANYEM",2
8,"8014",2013,1526,1521,4,5,"ECP-GUANYEM",152
43,"43030",483,356,351,2,5,"ECP-GUANYEM",39
43,"43034",465,365,365,5,0,"ECP-GUANYEM",14
17,"17016",737,570,563,2,7,"ECP-GUANYEM",54
8,"8307",49499,35471,35312,199,159,"ECP-GUANYEM",5358
17,"17208",978,723,719,6,4,"ECP-GUANYEM",50
25,"25911",419,298,297,3,1,"ECP-GUANYEM",16
25,"25079",276,202,202,0,0,"ECP-GUANYEM",8
8,"8230",7648,5797,5774,40,23,"ECP-GUANYEM",670
25,"25133",671,481,479,1,2,"ECP-GUANYEM",23
25,"25099",1285,908,904,6,4,"ECP-GUANYEM",45
17,"17001",575,428,426,4,2,"ECP-GUANYEM",35
25,"25142",359,283,283,2,0,"ECP-GUANYEM",18
8,"8252",24885,18507,18383,162,124,"ECP-GUANYEM",3751
17,"17210",572,414,411,2,3,"ECP-GUANYEM",31
8,"8102",28940,21108,21014,157,94,"ECP-GUANYEM",2035
8,"8280",93,76,75,1,1,"ECP-GUANYEM",7
25,"25049",156,110,109,1,1,"ECP-GUANYEM",2
25,"25024",352,248,247,0,1,"ECP-GUANYEM",6
17,"17089",5749,3973,3949,17,24,"ECP-GUANYEM",370
8,"8148",2344,1655,1646,13,9,"ECP-GUANYEM",267
8,"8038",1541,1129,1120,6,9,"ECP-GUANYEM",97
43,"43111",2129,1412,1401,8,11,"ECP-GUANYEM",234
43,"43154",126,104,104,0,0,"ECP-GUANYEM",9
25,"25216",244,186,186,0,0,"ECP-GUANYEM",4
17,"17171",177,138,137,0,1,"ECP-GUANYEM",10
17,"17209",615,472,471,5,1,"ECP-GUANYEM",33
8,"8251",5130,3719,3698,20,21,"ECP-GUANYEM",491
43,"43019",1332,911,904,8,7,"ECP-GUANYEM",77
25,"25020",270,202,201,2,1,"ECP-GUANYEM",9
17,"17064",324,249,247,2,2,"ECP-GUANYEM",14
25,"25035",364,257,256,0,1,"ECP-GUANYEM",22
8,"8142",136,117,117,3,0,"ECP-GUANYEM",6
8,"8273",2390,1871,1855,14,16,"ECP-GUANYEM",151
25,"25234",4139,2786,2772,13,14,"ECP-GUANYEM",234
25,"25212",219,176,176,1,0,"ECP-GUANYEM",9
8,"8146",1384,1030,1027,8,3,"ECP-GUANYEM",166
8,"8024",357,282,282,2,0,"ECP-GUANYEM",12
8,"8103",652,476,474,1,2,"ECP-GUANYEM",42
43,"43164",310,235,231,3,4,"ECP-GUANYEM",44
17,"17052",135,93,92,0,1,"ECP-GUANYEM",8
25,"25077",435,312,312,1,0,"ECP-GUANYEM",23
43,"43115",128,106,106,0,0,"ECP-GUANYEM",3
25,"25913",88,72,72,1,0,"ECP-GUANYEM",4
17,"17157",122,104,103,0,1,"ECP-GUANYEM",10
17,"17101",566,389,382,1,7,"ECP-GUANYEM",40
43,"43045",143,114,113,0,1,"ECP-GUANYEM",9
25,"25125",383,265,265,3,0,"ECP-GUANYEM",9
17,"17097",200,170,167,2,3,"ECP-GUANYEM",9
25,"25039",259,197,196,7,1,"ECP-GUANYEM",24
8,"8275",247,218,218,3,0,"ECP-GUANYEM",7
43,"43093",3863,2728,2716,22,12,"ECP-GUANYEM",241
8,"8229",521,418,417,3,1,"ECP-GUANYEM",20
17,"17163",2868,2281,2268,13,13,"ECP-GUANYEM",151
17,"17136",196,150,150,0,0,"ECP-GUANYEM",22
25,"25202",108,72,72,2,0,"ECP-GUANYEM",8
8,"8067",5746,4299,4270,24,29,"ECP-GUANYEM",393
25,"25111",114,86,86,2,0,"ECP-GUANYEM",1
43,"43142",1069,783,774,3,9,"ECP-GUANYEM",70
43,"43098",362,274,274,1,0,"ECP-GUANYEM",24
8,"8290",1549,1254,1248,6,6,"ECP-GUANYEM",138
17,"17166",547,442,440,0,2,"ECP-GUANYEM",19
8,"8062",1009,778,776,9,2,"ECP-GUANYEM",75
8,"8077",34690,25896,25767,164,129,"ECP-GUANYEM",4146
17,"17068",253,191,191,0,0,"ECP-GUANYEM",14
17,"17011",645,518,514,10,4,"ECP-GUANYEM",22
17,"17183",253,197,197,2,0,"ECP-GUANYEM",7
17,"17070",110,87,87,0,0,"ECP-GUANYEM",5
43,"43092",7308,4703,4679,33,24,"ECP-GUANYEM",540
43,"43041",216,156,156,2,0,"ECP-GUANYEM",13
25,"25169",170,117,117,5,0,"ECP-GUANYEM",3
43,"43906",2113,1490,1480,12,10,"ECP-GUANYEM",178
8,"8153",573,457,452,3,5,"ECP-GUANYEM",45
8,"8129",486,399,398,0,1,"ECP-GUANYEM",36
8,"8052",140,102,102,1,0,"ECP-GUANYEM",2
17,"17076",119,95,94,2,1,"ECP-GUANYEM",12
17,"17028",297,216,214,2,2,"ECP-GUANYEM",10
43,"43003",349,257,255,3,2,"ECP-GUANYEM",46
43,"43129",4607,3284,3261,21,23,"ECP-GUANYEM",250
43,"43091",125,90,90,1,0,"ECP-GUANYEM",23
25,"25901",289,214,211,4,3,"ECP-GUANYEM",15
8,"8218",8091,5899,5869,50,30,"ECP-GUANYEM",765
8,"8123",19570,15378,15316,91,62,"ECP-GUANYEM",2257
8,"8216",25,17,17,0,0,"ECP-GUANYEM",2
25,"25050",3256,2260,2249,20,11,"ECP-GUANYEM",146
43,"43031",1447,1085,1072,13,13,"ECP-GUANYEM",75
43,"43021",349,245,243,2,2,"ECP-GUANYEM",17
8,"8287",1067,853,844,4,9,"ECP-GUANYEM",84
25,"25082",292,197,197,2,0,"ECP-GUANYEM",8
43,"43163",26162,17276,17128,98,148,"ECP-GUANYEM",2598
8,"8010",4224,3109,3090,22,19,"ECP-GUANYEM",257
43,"43068",484,322,317,2,5,"ECP-GUANYEM",25
8,"8131",745,552,550,3,2,"ECP-GUANYEM",37
8,"8118",17634,13450,13402,80,48,"ECP-GUANYEM",1878
25,"25228",3143,2261,2250,18,11,"ECP-GUANYEM",160
25,"25163",230,162,161,0,1,"ECP-GUANYEM",4
17,"17204",609,429,428,6,1,"ECP-GUANYEM",33
8,"8192",5701,4366,4349,15,17,"ECP-GUANYEM",428
8,"8299",380,301,300,4,1,"ECP-GUANYEM",15
25,"25060",71,42,42,0,0,"ECP-GUANYEM",7
25,"25033",1120,838,831,5,7,"ECP-GUANYEM",65
8,"8063",469,390,390,4,0,"ECP-GUANYEM",31
43,"43121",593,404,403,1,1,"ECP-GUANYEM",28
17,"17004",529,411,410,3,1,"ECP-GUANYEM",40
8,"8285",10349,7630,7599,48,31,"ECP-GUANYEM",613
8,"8201",455,319,318,12,1,"ECP-GUANYEM",19
43,"43028",2770,1784,1770,7,14,"ECP-GUANYEM",289
25,"25903",226,169,169,1,0,"ECP-GUANYEM",8
8,"8095",66,49,49,0,0,"ECP-GUANYEM",2
8,"8211",33934,26136,26000,198,136,"ECP-GUANYEM",4569
17,"17099",78,55,55,0,0,"ECP-GUANYEM",1
17,"17158",565,296,295,2,1,"ECP-GUANYEM",24
25,"25005",269,193,193,3,0,"ECP-GUANYEM",12
8,"8179",636,466,465,2,1,"ECP-GUANYEM",89
8,"8213",6600,4925,4906,30,19,"ECP-GUANYEM",586
25,"25206",247,188,188,2,0,"ECP-GUANYEM",5
25,"25240",1366,1030,1021,4,9,"ECP-GUANYEM",71
25,"25092",125,93,92,0,1,"ECP-GUANYEM",7
17,"17182",269,195,195,0,0,"ECP-GUANYEM",29
8,"8256",693,542,542,3,0,"ECP-GUANYEM",125
17,"17220",801,649,647,2,2,"ECP-GUANYEM",28
8,"8108",5181,3880,3861,30,19,"ECP-GUANYEM",603
25,"25042",204,149,149,5,0,"ECP-GUANYEM",5
8,"8054",9215,6994,6943,38,51,"ECP-GUANYEM",1190
17,"17155",14957,9519,9410,71,109,"ECP-GUANYEM",942
43,"43165",571,469,467,2,2,"ECP-GUANYEM",27
17,"17130",325,270,270,1,0,"ECP-GUANYEM",11
25,"25063",84,52,51,0,1,"ECP-GUANYEM",2
43,"43010",334,262,262,2,0,"ECP-GUANYEM",41
25,"25007",1378,1010,999,12,11,"ECP-GUANYEM",104
17,"17184",1261,1016,1010,7,6,"ECP-GUANYEM",58
8,"8105",9741,6946,6896,62,50,"ECP-GUANYEM",1322
8,"8059",340,255,250,1,5,"ECP-GUANYEM",10
25,"25203",8809,5813,5770,40,43,"ECP-GUANYEM",507
17,"17151",179,131,130,0,1,"ECP-GUANYEM",7
8,"8098",2438,1781,1778,21,3,"ECP-GUANYEM",240
43,"43001",708,510,507,0,3,"ECP-GUANYEM",89
25,"25076",131,91,91,0,0,"ECP-GUANYEM",4
43,"43146",40,32,32,0,0,"ECP-GUANYEM",4
25,"25087",54,45,45,0,0,"ECP-GUANYEM",2
8,"8036",163,122,122,0,0,"ECP-GUANYEM",4
25,"25096",885,597,591,2,6,"ECP-GUANYEM",27
17,"17147",7916,5672,5641,41,31,"ECP-GUANYEM",436
8,"8214",7007,5390,5371,25,19,"ECP-GUANYEM",596
17,"17047",5016,3087,3068,22,19,"ECP-GUANYEM",323
17,"17161",1023,844,843,5,1,"ECP-GUANYEM",61
8,"8202",12943,9408,9358,58,50,"ECP-GUANYEM",1043
25,"25010",194,138,136,0,2,"ECP-GUANYEM",8
8,"8210",4640,3226,3200,24,26,"ECP-GUANYEM",346
25,"25120",92888,62740,62389,450,351,"ECP-GUANYEM",6088
43,"43122",112,91,91,1,0,"ECP-GUANYEM",16
25,"25019",4606,2860,2829,19,31,"ECP-GUANYEM",326
43,"43141",109,85,84,0,1,"ECP-GUANYEM",4
25,"25009",596,448,442,1,6,"ECP-GUANYEM",14
8,"8254",1766,1433,1427,16,6,"ECP-GUANYEM",85
25,"25192",727,527,524,4,3,"ECP-GUANYEM",42
43,"43144",1245,975,966,1,9,"ECP-GUANYEM",103
8,"8092",3713,2758,2745,9,13,"ECP-GUANYEM",196
25,"25904",160,134,133,2,1,"ECP-GUANYEM",7
43,"43055",1970,1548,1535,12,13,"ECP-GUANYEM",84
25,"25078",995,746,743,7,3,"ECP-GUANYEM",37
8,"8901",240,200,195,2,5,"ECP-GUANYEM",12
43,"43009",1384,966,959,5,7,"ECP-GUANYEM",102
43,"43903",2332,1502,1487,18,15,"ECP-GUANYEM",147
8,"8190",255,184,182,1,2,"ECP-GUANYEM",8
43,"43132",375,295,291,1,4,"ECP-GUANYEM",28
17,"17058",176,128,128,0,0,"ECP-GUANYEM",19
17,"17123",343,286,284,2,2,"ECP-GUANYEM",14
8,"8168",388,280,279,3,1,"ECP-GUANYEM",43
25,"25129",161,113,112,0,1,"ECP-GUANYEM",3
17,"17121",225,166,163,2,3,"ECP-GUANYEM",8
8,"8156",11254,8440,8411,58,29,"ECP-GUANYEM",1393
8,"8195",75,62,62,0,0,"ECP-GUANYEM",4
17,"17069",359,270,267,2,3,"ECP-GUANYEM",16
43,"43056",803,566,558,6,8,"ECP-GUANYEM",29
8,"8239",467,362,361,3,1,"ECP-GUANYEM",38
43,"43101",146,112,112,2,0,"ECP-GUANYEM",5
17,"17217",350,287,284,0,3,"ECP-GUANYEM",12
17,"17164",3918,2856,2838,17,18,"ECP-GUANYEM",148
25,"25069",426,296,294,0,2,"ECP-GUANYEM",15
8,"8170",442,322,320,0,2,"ECP-GUANYEM",13
8,"8277",168,148,146,1,2,"ECP-GUANYEM",14
8,"8139",172,148,147,2,1,"ECP-GUANYEM",14
17,"17088",599,467,465,3,2,"ECP-GUANYEM",35
8,"8005",6425,4830,4816,28,14,"ECP-GUANYEM",525
8,"8017",2808,2033,2016,16,17,"ECP-GUANYEM",175
43,"43084",514,388,383,2,5,"ECP-GUANYEM",30
8,"8217",25466,19864,19773,129,91,"ECP-GUANYEM",3605
25,"25022",105,80,79,0,1,"ECP-GUANYEM",3
8,"8094",1588,1258,1252,7,6,"ECP-GUANYEM",128
8,"8225",94,83,82,1,1,"ECP-GUANYEM",3
17,"17079",65572,47740,47502,279,238,"ECP-GUANYEM",4334
43,"43075",86,65,63,0,2,"ECP-GUANYEM",6
43,"43110",247,178,178,2,0,"ECP-GUANYEM",11
8,"8039",413,322,321,1,1,"ECP-GUANYEM",55
25,"25059",800,546,534,5,12,"ECP-GUANYEM",54
25,"25113",1114,873,863,3,10,"ECP-GUANYEM",44
25,"25072",5881,4059,4031,30,28,"ECP-GUANYEM",312
8,"8026",195,148,146,0,2,"ECP-GUANYEM",5
25,"25110",2745,1943,1927,13,16,"ECP-GUANYEM",126
17,"17078",335,245,245,0,0,"ECP-GUANYEM",9
8,"8016",1803,1371,1363,11,8,"ECP-GUANYEM",103
17,"17086",1769,1116,1109,6,7,"ECP-GUANYEM",102
25,"25247",142,89,89,2,0,"ECP-GUANYEM",9
8,"8286",2943,2051,2042,12,9,"ECP-GUANYEM",292
8,"8171",2046,1520,1510,13,10,"ECP-GUANYEM",70
25,"25098",227,160,158,1,2,"ECP-GUANYEM",7
17,"17034",7289,4880,4862,23,18,"ECP-GUANYEM",517
8,"8041",10698,7324,7258,57,66,"ECP-GUANYEM",1151
8,"8267",6789,4975,4935,41,40,"ECP-GUANYEM",850
8,"8174",388,322,318,2,4,"ECP-GUANYEM",14
43,"43173",98,70,68,0,2,"ECP-GUANYEM",1
8,"8057",61,47,47,1,0,"ECP-GUANYEM",5
8,"8302",9359,6483,6430,78,53,"ECP-GUANYEM",1133
17,"17025",1182,943,938,5,5,"ECP-GUANYEM",53
8,"8007",6795,5099,5081,29,18,"ECP-GUANYEM",459
17,"17193",4351,2945,2927,21,18,"ECP-GUANYEM",347
8,"8020",5243,4117,4100,29,17,"ECP-GUANYEM",629
25,"25146",223,158,155,3,3,"ECP-GUANYEM",8
43,"43156",3956,2812,2784,22,28,"ECP-GUANYEM",331
43,"43130",169,131,130,2,1,"ECP-GUANYEM",1
8,"8096",43926,32120,31960,217,160,"ECP-GUANYEM",4229
25,"25201",110,81,81,0,0,"ECP-GUANYEM",6
8,"8042",2390,1772,1764,12,8,"ECP-GUANYEM",271
8,"8278",4925,3820,3804,22,16,"ECP-GUANYEM",211
8,"8121",87515,62961,62574,429,387,"ECP-GUANYEM",8659
17,"17032",1745,1139,1133,6,6,"ECP-GUANYEM",151
25,"25165",271,210,208,0,2,"ECP-GUANYEM",8
8,"8227",2420,1775,1769,11,6,"ECP-GUANYEM",164
43,"43905",15100,9689,9630,43,59,"ECP-GUANYEM",1152
8,"8212",491,393,386,6,7,"ECP-GUANYEM",8
25,"25207",6443,4525,4492,31,33,"ECP-GUANYEM",311
25,"25032",65,53,52,0,1,"ECP-GUANYEM",4
43,"43043",3317,2457,2445,12,12,"ECP-GUANYEM",354
25,"25238",212,161,160,0,1,"ECP-GUANYEM",9
8,"8069",3323,2555,2540,21,15,"ECP-GUANYEM",371
8,"8160",317,234,234,0,0,"ECP-GUANYEM",17
25,"25021",2513,1668,1662,17,6,"ECP-GUANYEM",108
8,"8259",6979,5362,5341,27,21,"ECP-GUANYEM",639
8,"8291",4972,3531,3519,23,12,"ECP-GUANYEM",578
43,"43103",908,705,701,9,4,"ECP-GUANYEM",94
43,"43126",1230,937,933,3,4,"ECP-GUANYEM",115
43,"43006",676,462,462,3,0,"ECP-GUANYEM",48
25,"25013",2099,1430,1414,13,16,"ECP-GUANYEM",105
25,"25253",147,118,117,0,1,"ECP-GUANYEM",8
43,"43079",364,290,289,2,1,"ECP-GUANYEM",38
17,"17189",1481,1228,1223,5,5,"ECP-GUANYEM",52
17,"17195",338,274,272,1,2,"ECP-GUANYEM",18
25,"25907",500,366,364,5,2,"ECP-GUANYEM",25
8,"8248",5687,4187,4165,21,22,"ECP-GUANYEM",614
17,"17175",559,348,343,5,5,"ECP-GUANYEM",29
8,"8221",12793,10123,10079,73,44,"ECP-GUANYEM",1285
17,"17056",1780,1379,1374,13,5,"ECP-GUANYEM",85
25,"25232",1357,1012,1007,6,5,"ECP-GUANYEM",71
8,"8045",65,44,43,0,1,"ECP-GUANYEM",3
8,"8166",964,700,697,7,3,"ECP-GUANYEM",46
17,"17075",340,257,256,2,1,"ECP-GUANYEM",15
43,"43062",269,229,226,5,3,"ECP-GUANYEM",23
43,"43127",775,607,606,3,1,"ECP-GUANYEM",59
8,"8120",7129,5649,5621,51,28,"ECP-GUANYEM",268
43,"43002",1890,1233,1210,12,23,"ECP-GUANYEM",175
43,"43071",896,652,647,3,5,"ECP-GUANYEM",65
43,"43150",1233,954,941,6,13,"ECP-GUANYEM",108
17,"17224",299,226,222,2,4,"ECP-GUANYEM",14
43,"43159",76,60,60,0,0,"ECP-GUANYEM",1
8,"8232",1773,1368,1362,9,6,"ECP-GUANYEM",150
43,"43054",2807,1972,1957,14,15,"ECP-GUANYEM",122
25,"25226",236,156,155,0,1,"ECP-GUANYEM",20
8,"8199",648,509,508,3,1,"ECP-GUANYEM",37
17,"17143",145,104,104,0,0,"ECP-GUANYEM",5
8,"8183",4573,3406,3398,14,8,"ECP-GUANYEM",272
17,"17111",984,728,728,7,0,"ECP-GUANYEM",58
25,"25016",2083,1404,1399,3,5,"ECP-GUANYEM",86
25,"25101",536,412,411,5,1,"ECP-GUANYEM",15
25,"25193",768,567,563,4,4,"ECP-GUANYEM",21
25,"25132",141,106,105,0,1,"ECP-GUANYEM",6
8,"8205",61957,49325,49196,441,129,"ECP-GUANYEM",6025
25,"25138",558,427,424,2,3,"ECP-GUANYEM",18
8,"8046",13541,10510,10455,73,55,"ECP-GUANYEM",1414
17,"17128",321,239,238,1,1,"ECP-GUANYEM",13
25,"25075",132,101,101,0,0,"ECP-GUANYEM",8
25,"25118",326,223,218,0,5,"ECP-GUANYEM",14
25,"25074",179,155,151,2,4,"ECP-GUANYEM",7
43,"43053",186,135,134,0,1,"ECP-GUANYEM",10
43,"43151",107,88,88,0,0,"ECP-GUANYEM",5
17,"17225",205,150,150,1,0,"ECP-GUANYEM",4
17,"17192",143,107,104,0,3,"ECP-GUANYEM",5
8,"8115",3826,2777,2770,31,7,"ECP-GUANYEM",483
25,"25208",337,242,241,2,1,"ECP-GUANYEM",25
25,"25017",228,175,174,0,1,"ECP-GUANYEM",10
8,"8037",1947,1547,1543,11,4,"ECP-GUANYEM",69
25,"25175",173,119,119,2,0,"ECP-GUANYEM",11
43,"43161",17103,11905,11838,82,67,"ECP-GUANYEM",1178
8,"8188",115,89,89,0,0,"ECP-GUANYEM",3
8,"8093",25,22,22,0,0,"ECP-GUANYEM",1
25,"25217",10891,7651,7610,63,41,"ECP-GUANYEM",621
8,"8116",557,449,449,1,0,"ECP-GUANYEM",28
17,"17154",101,76,76,0,0,"ECP-GUANYEM",11
8,"8050",139,118,115,4,3,"ECP-GUANYEM",1
17,"17040",551,440,439,5,1,"ECP-GUANYEM",29
43,"43048",768,564,554,7,10,"ECP-GUANYEM",70
8,"8154",697,541,539,3,2,"ECP-GUANYEM",61
17,"17117",14497,9438,9382,66,56,"ECP-GUANYEM",1026
8,"8086",14137,9971,9912,77,59,"ECP-GUANYEM",1488
25,"25183",520,372,370,4,2,"ECP-GUANYEM",33
8,"8175",3369,2388,2372,18,16,"ECP-GUANYEM",149
43,"43014",14386,9542,9464,74,78,"ECP-GUANYEM",1222
25,"25030",117,76,76,0,0,"ECP-GUANYEM",4
8,"8147",17389,12679,12601,102,78,"ECP-GUANYEM",2053
43,"43086",5252,3811,3790,28,21,"ECP-GUANYEM",344
17,"17176",128,111,111,0,0,"ECP-GUANYEM",11
8,"8220",2411,2010,2001,8,9,"ECP-GUANYEM",71
25,"25115",803,601,593,4,8,"ECP-GUANYEM",29
17,"17036",2639,1944,1934,21,10,"ECP-GUANYEM",186
17,"17009",4068,3061,3050,16,11,"ECP-GUANYEM",217
17,"17074",536,403,401,1,2,"ECP-GUANYEM",24
8,"8276",241,179,179,3,0,"ECP-GUANYEM",25
17,"17190",834,624,619,1,5,"ECP-GUANYEM",50
17,"17098",308,232,230,4,2,"ECP-GUANYEM",23
25,"25008",1081,803,799,4,4,"ECP-GUANYEM",31
8,"8122",1733,1179,1175,4,4,"ECP-GUANYEM",169
17,"17159",622,459,459,1,0,"ECP-GUANYEM",44
17,"17030",654,460,459,1,1,"ECP-GUANYEM",33
43,"43152",435,348,342,2,6,"ECP-GUANYEM",19
8,"8263",21208,15014,14890,111,124,"ECP-GUANYEM",2478
8,"8048",580,427,426,1,1,"ECP-GUANYEM",19
43,"43070",243,194,193,0,1,"ECP-GUANYEM",13
8,"8187",153822,113081,112470,758,611,"ECP-GUANYEM",18053
8,"8021",60,44,44,1,0,"ECP-GUANYEM",3
43,"43015",115,92,91,1,1,"ECP-GUANYEM",17
17,"17222",104,87,87,1,0,"ECP-GUANYEM",4
25,"25244",374,275,270,1,5,"ECP-GUANYEM",17
17,"17081",252,186,185,2,1,"ECP-GUANYEM",11
8,"8236",1564,1145,1133,4,12,"ECP-GUANYEM",107
8,"8125",25583,18334,18225,122,109,"ECP-GUANYEM",3922
43,"43007",631,479,474,1,5,"ECP-GUANYEM",43
17,"17129",143,108,108,2,0,"ECP-GUANYEM",1
8,"8072",10769,7632,7600,56,32,"ECP-GUANYEM",1093
8,"8191",5302,3872,3860,21,12,"ECP-GUANYEM",427
17,"17090",539,440,440,2,0,"ECP-GUANYEM",27
17,"17119",71,53,52,3,1,"ECP-GUANYEM",6
25,"25167",223,165,164,3,1,"ECP-GUANYEM",15
17,"17230",504,383,382,3,1,"ECP-GUANYEM",29
43,"43051",9194,6133,6048,44,85,"ECP-GUANYEM",1093
25,"25044",178,144,142,0,2,"ECP-GUANYEM",12
43,"43171",14849,10140,10081,76,59,"ECP-GUANYEM",1352
43,"43099",284,214,214,4,0,"ECP-GUANYEM",9
25,"25103",133,88,87,0,1,"ECP-GUANYEM",9
8,"8053",2896,1939,1929,13,10,"ECP-GUANYEM",241
17,"17020",3677,2851,2835,14,16,"ECP-GUANYEM",210
43,"43072",90,69,67,1,2,"ECP-GUANYEM",0
8,"8002",217,172,172,2,0,"ECP-GUANYEM",11
17,"17082",435,308,307,1,1,"ECP-GUANYEM",18
17,"17027",2857,2236,2229,9,7,"ECP-GUANYEM",159
43,"43117",147,119,119,0,0,"ECP-GUANYEM",13
17,"17048",6284,4077,4048,34,29,"ECP-GUANYEM",394
17,"17186",3834,2980,2954,17,26,"ECP-GUANYEM",316
25,"25190",262,202,202,2,0,"ECP-GUANYEM",19
17,"17160",14756,9892,9852,58,40,"ECP-GUANYEM",1273
17,"17012",1175,845,842,4,3,"ECP-GUANYEM",94
17,"17003",103,85,85,0,0,"ECP-GUANYEM",9
25,"25034",2271,1616,1600,12,16,"ECP-GUANYEM",64
43,"43119",849,591,588,8,3,"ECP-GUANYEM",71
8,"8243",154,125,125,2,0,"ECP-GUANYEM",2
43,"43097",407,331,328,4,3,"ECP-GUANYEM",37
8,"8176",158,119,119,0,0,"ECP-GUANYEM",1
8,"8008",175,136,136,2,0,"ECP-GUANYEM",8
17,"17168",373,309,308,3,1,"ECP-GUANYEM",19
8,"8289",4473,3379,3371,25,8,"ECP-GUANYEM",496
25,"25179",169,132,132,0,0,"ECP-GUANYEM",4
43,"43033",766,555,555,4,0,"ECP-GUANYEM",60
17,"17196",252,200,200,1,0,"ECP-GUANYEM",18
8,"8080",40,27,27,3,0,"ECP-GUANYEM",0
43,"43036",869,565,557,7,8,"ECP-GUANYEM",80
25,"25170",262,210,210,1,0,"ECP-GUANYEM",8
17,"17150",1444,1177,1163,13,14,"ECP-GUANYEM",66
43,"43106",784,605,598,3,7,"ECP-GUANYEM",87
8,"8292",1074,796,790,2,6,"ECP-GUANYEM",63
25,"25070",817,619,617,11,2,"ECP-GUANYEM",31
8,"8193",988,739,737,10,2,"ECP-GUANYEM",122
17,"17010",332,252,251,2,1,"ECP-GUANYEM",30
8,"8022",12213,8594,8558,42,36,"ECP-GUANYEM",596
8,"8206",744,604,599,5,5,"ECP-GUANYEM",59
43,"43168",83,55,55,1,0,"ECP-GUANYEM",3
17,"17234",181,129,129,1,0,"ECP-GUANYEM",12
43,"43066",158,108,108,1,0,"ECP-GUANYEM",13
17,"17124",1593,1163,1160,8,3,"ECP-GUANYEM",81
8,"8078",216,154,154,2,0,"ECP-GUANYEM",10
25,"25196",108,75,75,1,0,"ECP-GUANYEM",11
25,"25148",224,158,158,0,0,"ECP-GUANYEM",3
8,"8073",62934,45699,45407,281,292,"ECP-GUANYEM",9141
43,"43177",276,229,227,2,2,"ECP-GUANYEM",9
8,"8258",815,636,632,5,4,"ECP-GUANYEM",29
17,"17044",6938,5245,5212,33,33,"ECP-GUANYEM",377
8,"8306",535,368,368,5,0,"ECP-GUANYEM",45
17,"17100",193,147,141,0,6,"ECP-GUANYEM",3
17,"17144",211,162,159,3,3,"ECP-GUANYEM",14
25,"25046",410,331,326,4,5,"ECP-GUANYEM",23
25,"25231",483,387,385,0,2,"ECP-GUANYEM",24
43,"43094",2143,1558,1541,6,17,"ECP-GUANYEM",116
8,"8181",8133,5949,5924,31,25,"ECP-GUANYEM",808
25,"25086",525,410,407,3,3,"ECP-GUANYEM",24
8,"8200",62225,45235,44991,306,244,"ECP-GUANYEM",8967
8,"8003",7213,5425,5409,41,16,"ECP-GUANYEM",511
25,"25177",356,252,250,1,2,"ECP-GUANYEM",14
25,"25174",390,312,312,1,0,"ECP-GUANYEM",14
8,"8013",1287,982,972,6,10,"ECP-GUANYEM",103
25,"25052",1541,1183,1176,7,7,"ECP-GUANYEM",60
8,"8127",2254,1548,1544,10,4,"ECP-GUANYEM",197
8,"8266",43422,32827,32696,241,131,"ECP-GUANYEM",5802
25,"25219",146,111,111,1,0,"ECP-GUANYEM",10
8,"8274",4640,3385,3363,24,22,"ECP-GUANYEM",399
8,"8264",4608,3459,3444,30,15,"ECP-GUANYEM",316
8,"8257",103,82,82,0,0,"ECP-GUANYEM",10
8,"8262",6945,4649,4599,38,50,"ECP-GUANYEM",643
17,"17207",2420,1920,1901,9,19,"ECP-GUANYEM",90
43,"43016",3470,2547,2508,15,39,"ECP-GUANYEM",397
8,"8902",3941,2974,2962,16,12,"ECP-GUANYEM",446
25,"25015",336,234,233,3,1,"ECP-GUANYEM",21
43,"43136",10489,7029,6996,47,33,"ECP-GUANYEM",931
25,"25902",536,406,403,1,3,"ECP-GUANYEM",22
25,"25004",582,437,432,3,5,"ECP-GUANYEM",33
43,"43022",1436,1028,1024,13,4,"ECP-GUANYEM",74
8,"8255",133,100,100,2,0,"ECP-GUANYEM",6
25,"25161",339,221,221,0,0,"ECP-GUANYEM",10
43,"43074",1818,1341,1336,2,5,"ECP-GUANYEM",135
8,"8235",3875,3004,2996,19,8,"ECP-GUANYEM",282
8,"8245",77841,53719,53443,430,276,"ECP-GUANYEM",10284
25,"25038",1478,1057,1048,10,9,"ECP-GUANYEM",63
43,"43113",387,305,303,1,2,"ECP-GUANYEM",35
17,"17232",146,111,111,0,0,"ECP-GUANYEM",14
43,"43131",4827,3134,3116,32,18,"ECP-GUANYEM",454
17,"17008",3605,2595,2577,8,18,"ECP-GUANYEM",189
17,"17162",153,106,105,1,1,"ECP-GUANYEM",16
25,"25210",1073,791,780,3,11,"ECP-GUANYEM",32
43,"43169",445,388,388,3,0,"ECP-GUANYEM",26
43,"43158",74,52,50,0,2,"ECP-GUANYEM",0
8,"8107",11965,8604,8554,67,50,"ECP-GUANYEM",1580
8,"8145",2712,2060,2049,8,11,"ECP-GUANYEM",251
17,"17065",321,264,263,3,1,"ECP-GUANYEM",19
43,"43100",3557,2666,2649,22,17,"ECP-GUANYEM",473
8,"8061",1628,1154,1151,15,3,"ECP-GUANYEM",184
25,"25227",656,476,476,2,0,"ECP-GUANYEM",36
8,"8049",1309,910,903,3,7,"ECP-GUANYEM",49
8,"8140",4816,3541,3520,25,21,"ECP-GUANYEM",422
43,"43155",22586,15295,15204,120,91,"ECP-GUANYEM",1866
17,"17051",202,161,160,0,1,"ECP-GUANYEM",3
8,"8150",258,207,207,1,0,"ECP-GUANYEM",16
25,"25051",1522,1066,1059,6,7,"ECP-GUANYEM",61
17,"17223",808,566,563,1,3,"ECP-GUANYEM",69
25,"25149",1377,1034,1028,9,6,"ECP-GUANYEM",44
25,"25104",120,88,88,0,0,"ECP-GUANYEM",6
17,"17084",228,163,162,1,1,"ECP-GUANYEM",10
25,"25056",209,145,145,0,0,"ECP-GUANYEM",10
43,"43138",2636,1761,1745,11,16,"ECP-GUANYEM",243
8,"8126",8906,6673,6646,41,27,"ECP-GUANYEM",1237
25,"25003",3717,2577,2561,15,16,"ECP-GUANYEM",137
17,"17031",178,117,117,0,0,"ECP-GUANYEM",6
17,"17060",409,300,298,1,2,"ECP-GUANYEM",16
43,"43042",2215,1723,1710,18,13,"ECP-GUANYEM",158
43,"43025",591,448,443,4,5,"ECP-GUANYEM",33
17,"17211",837,677,674,6,3,"ECP-GUANYEM",31
8,"8027",724,584,582,1,2,"ECP-GUANYEM",54
17,"17054",342,250,250,2,0,"ECP-GUANYEM",18
25,"25134",605,457,456,5,1,"ECP-GUANYEM",31
43,"43077",453,306,304,1,2,"ECP-GUANYEM",18
17,"17057",968,770,769,7,1,"ECP-GUANYEM",45
25,"25071",41,31,30,0,1,"ECP-GUANYEM",0
8,"8124",37157,27139,26994,179,145,"ECP-GUANYEM",5173
43,"43057",38,32,32,1,0,"ECP-GUANYEM",5
8,"8237",1644,1263,1254,9,9,"ECP-GUANYEM",52
25,"25122",1929,1408,1398,21,10,"ECP-GUANYEM",74
43,"43114",370,281,278,1,3,"ECP-GUANYEM",36
43,"43140",2433,1685,1674,11,11,"ECP-GUANYEM",236
25,"25058",4345,3058,3045,13,13,"ECP-GUANYEM",159
8,"8903",201,181,181,1,0,"ECP-GUANYEM",6
43,"43123",71435,49166,48873,318,293,"ECP-GUANYEM",5561
8,"8089",34190,24548,24404,194,144,"ECP-GUANYEM",3962
8,"8228",292,234,233,0,1,"ECP-GUANYEM",13
17,"17039",1726,1306,1297,7,9,"ECP-GUANYEM",69
17,"17033",5647,3879,3852,25,27,"ECP-GUANYEM",541
43,"43032",462,354,350,2,4,"ECP-GUANYEM",27
17,"17213",5567,3654,3630,19,24,"ECP-GUANYEM",459
43,"43018",384,297,297,2,0,"ECP-GUANYEM",27
17,"17165",645,502,502,2,0,"ECP-GUANYEM",43
17,"17118",12934,8723,8665,38,58,"ECP-GUANYEM",784
8,"8155",7056,5050,5011,38,39,"ECP-GUANYEM",890
8,"8033",13262,9887,9833,64,54,"ECP-GUANYEM",1239
17,"17218",576,456,451,3,5,"ECP-GUANYEM",37
17,"17092",3462,2414,2389,14,25,"ECP-GUANYEM",241
8,"8030",5208,4045,4033,25,12,"ECP-GUANYEM",379
17,"17046",709,537,531,2,6,"ECP-GUANYEM",38
8,"8117",2489,1954,1941,21,13,"ECP-GUANYEM",130
17,"17015",12829,9612,9580,51,32,"ECP-GUANYEM",742
43,"43107",387,285,285,3,0,"ECP-GUANYEM",36
25,"25139",477,348,346,3,2,"ECP-GUANYEM",16
17,"17042",410,299,297,5,2,"ECP-GUANYEM",21
43,"43104",1767,1285,1271,4,14,"ECP-GUANYEM",118
25,"25006",319,229,229,2,0,"ECP-GUANYEM",13
43,"43901",8796,5431,5390,41,41,"ECP-GUANYEM",608
25,"25248",870,676,675,5,1,"ECP-GUANYEM",23
8,"8090",142,116,116,0,0,"ECP-GUANYEM",9
8,"8009",9531,7200,7171,47,29,"ECP-GUANYEM",839
25,"25048",1641,1207,1194,13,13,"ECP-GUANYEM",87
17,"17066",27378,16755,16644,122,111,"ECP-GUANYEM",1589
8,"8136",11692,8527,8456,98,71,"ECP-GUANYEM",1788
17,"17126",316,269,269,1,0,"ECP-GUANYEM",13
25,"25128",125,85,85,0,0,"ECP-GUANYEM",8
43,"43139",2007,1432,1419,9,13,"ECP-GUANYEM",66
17,"17221",4138,2999,2988,23,11,"ECP-GUANYEM",276
17,"17149",370,302,300,1,2,"ECP-GUANYEM",19
43,"43017",112,94,94,1,0,"ECP-GUANYEM",6
17,"17180",8508,5977,5953,38,24,"ECP-GUANYEM",499
25,"25123",189,135,133,0,2,"ECP-GUANYEM",7
8,"8028",1125,744,743,7,1,"ECP-GUANYEM",147
43,"43020",2291,1712,1688,19,24,"ECP-GUANYEM",258
43,"43120",421,256,254,1,2,"ECP-GUANYEM",33
8,"8208",5793,4267,4244,21,23,"ECP-GUANYEM",644
17,"17094",1058,757,747,3,10,"ECP-GUANYEM",63
25,"25197",140,109,109,0,0,"ECP-GUANYEM",6
43,"43105",155,126,123,4,3,"ECP-GUANYEM",11
43,"43035",233,182,182,5,0,"ECP-GUANYEM",21
43,"43073",80,67,65,0,2,"ECP-GUANYEM",5
8,"8298",27148,19655,19568,102,87,"ECP-GUANYEM",1447
8,"8253",132,103,102,0,1,"ECP-GUANYEM",5
25,"25204",1187,858,849,13,9,"ECP-GUANYEM",39
43,"43040",325,268,267,1,1,"ECP-GUANYEM",22
43,"43023",211,171,169,2,2,"ECP-GUANYEM",10
25,"25143",82,63,62,0,1,"ECP-GUANYEM",3
8,"8161",11826,8001,7951,58,50,"ECP-GUANYEM",1283
8,"8040",11116,7923,7891,49,32,"ECP-GUANYEM",966
17,"17227",147,104,104,0,0,"ECP-GUANYEM",8
43,"43167",391,307,307,2,0,"ECP-GUANYEM",35
8,"8304",822,655,655,5,0,"ECP-GUANYEM",40
25,"25251",708,526,524,1,2,"ECP-GUANYEM",32
25,"25114",96,83,82,1,1,"ECP-GUANYEM",0
25,"25158",1605,1193,1180,8,13,"ECP-GUANYEM",82
43,"43153",11197,7685,7649,53,36,"ECP-GUANYEM",982
43,"43112",245,179,179,3,0,"ECP-GUANYEM",8
43,"43024",1545,1019,1014,14,5,"ECP-GUANYEM",158
17,"17148",1550,1121,1114,15,7,"ECP-GUANYEM",102
8,"8247",982,799,798,4,1,"ECP-GUANYEM",38
17,"17035",544,447,447,2,0,"ECP-GUANYEM",17
8,"8135",6770,5187,5158,42,29,"ECP-GUANYEM",1013
17,"17091",391,296,290,3,6,"ECP-GUANYEM",14
8,"8209",6925,4976,4948,39,28,"ECP-GUANYEM",851
25,"25097",89,71,71,2,0,"ECP-GUANYEM",3
17,"17901",987,733,725,5,8,"ECP-GUANYEM",49
8,"8068",6863,5064,5041,40,23,"ECP-GUANYEM",755
25,"25130",181,130,128,0,2,"ECP-GUANYEM",2
43,"43052",927,680,674,7,6,"ECP-GUANYEM",50
25,"25245",427,312,308,4,4,"ECP-GUANYEM",40
25,"25119",2258,1701,1686,11,15,"ECP-GUANYEM",77
17,"17135",393,307,303,0,4,"ECP-GUANYEM",27
8,"8242",223,159,159,0,0,"ECP-GUANYEM",9
8,"8194",25680,16465,16376,131,89,"ECP-GUANYEM",2927
17,"17167",2585,2015,1998,11,17,"ECP-GUANYEM",127
25,"25157",159,127,126,1,1,"ECP-GUANYEM",10
25,"25064",96,78,78,0,0,"ECP-GUANYEM",2
25,"25089",93,70,68,1,2,"ECP-GUANYEM",7
17,"17152",11065,6959,6927,68,32,"ECP-GUANYEM",645
17,"17024",281,203,201,4,2,"ECP-GUANYEM",12
43,"43067",526,426,424,3,2,"ECP-GUANYEM",31
17,"17107",267,207,205,2,2,"ECP-GUANYEM",12
25,"25081",281,195,193,3,2,"ECP-GUANYEM",15
43,"43137",1890,1373,1353,8,20,"ECP-GUANYEM",141
17,"17041",217,150,146,1,4,"ECP-GUANYEM",6
25,"25027",978,695,690,3,5,"ECP-GUANYEM",33
43,"43904",2864,1881,1851,20,30,"ECP-GUANYEM",196
8,"8031",2339,1760,1750,15,10,"ECP-GUANYEM",166
43,"43095",2583,1864,1854,12,10,"ECP-GUANYEM",215
17,"17228",285,218,217,0,1,"ECP-GUANYEM",16
43,"43133",5627,3794,3773,31,21,"ECP-GUANYEM",505
43,"43050",2695,1742,1730,10,12,"ECP-GUANYEM",265
8,"8231",21269,14655,14573,111,82,"ECP-GUANYEM",2307
8,"8088",12347,9316,9270,75,46,"ECP-GUANYEM",991
17,"17063",179,153,149,0,4,"ECP-GUANYEM",6
17,"17199",6984,4919,4894,39,25,"ECP-GUANYEM",360
17,"17903",883,681,676,3,5,"ECP-GUANYEM",51
8,"8240",9469,7351,7327,39,24,"ECP-GUANYEM",1000
25,"25140",779,540,539,2,1,"ECP-GUANYEM",45
8,"8079",333,260,258,2,2,"ECP-GUANYEM",9
8,"8152",117,94,94,0,0,"ECP-GUANYEM",5
8,"8189",119,96,96,1,0,"ECP-GUANYEM",3
25,"25222",69,58,58,0,0,"ECP-GUANYEM",0
17,"17096",159,116,116,3,0,"ECP-GUANYEM",7
43,"43083",146,110,109,0,1,"ECP-GUANYEM",6
8,"8164",936,750,747,6,3,"ECP-GUANYEM",71
17,"17191",163,140,140,1,0,"ECP-GUANYEM",8
17,"17026",549,421,415,3,6,"ECP-GUANYEM",26
43,"43037",18216,11749,11672,70,77,"ECP-GUANYEM",1842
8,"8288",1696,1103,1096,9,7,"ECP-GUANYEM",133
25,"25136",95,74,74,2,0,"ECP-GUANYEM",3
17,"17226",884,603,600,4,3,"ECP-GUANYEM",55
8,"8185",197,162,162,1,0,"ECP-GUANYEM",23
43,"43080",230,192,192,2,0,"ECP-GUANYEM",17
17,"17125",136,100,100,3,0,"ECP-GUANYEM",4
25,"25205",563,412,407,3,5,"ECP-GUANYEM",36
25,"25135",997,675,671,3,4,"ECP-GUANYEM",31
25,"25043",800,584,581,2,3,"ECP-GUANYEM",65
17,"17019",1780,1403,1393,5,10,"ECP-GUANYEM",88
8,"8074",11190,7698,7651,51,47,"ECP-GUANYEM",1282
25,"25068",515,359,358,0,1,"ECP-GUANYEM",14
25,"25094",138,96,93,2,3,"ECP-GUANYEM",3
8,"8279",156327,112605,112030,952,575,"ECP-GUANYEM",18210
17,"17134",220,175,174,1,1,"ECP-GUANYEM",8
8,"8130",110,81,81,2,0,"ECP-GUANYEM",4
43,"43026",756,576,574,1,2,"ECP-GUANYEM",31
8,"8051",18570,14112,14054,86,58,"ECP-GUANYEM",2161
17,"17205",209,167,166,0,1,"ECP-GUANYEM",10
17,"17169",2511,1901,1890,8,11,"ECP-GUANYEM",178
43,"43175",534,363,359,5,4,"ECP-GUANYEM",17
8,"8226",929,748,747,10,1,"ECP-GUANYEM",25
8,"8097",1103,845,840,4,5,"ECP-GUANYEM",94
43,"43059",250,193,192,1,1,"ECP-GUANYEM",7
25,"25254",704,511,508,2,3,"ECP-GUANYEM",44
25,"25908",217,136,136,0,0,"ECP-GUANYEM",7
8,"8250",7235,4917,4876,41,41,"ECP-GUANYEM",819
8,"8180",27198,19822,19704,160,118,"ECP-GUANYEM",4150
17,"17109",704,542,539,2,3,"ECP-GUANYEM",38
8,"8272",164,128,128,1,0,"ECP-GUANYEM",5
8,"8133",123,96,94,5,2,"ECP-GUANYEM",2
43,"43061",40,27,27,3,0,"ECP-GUANYEM",0
25,"25191",321,227,222,2,5,"ECP-GUANYEM",10
17,"17116",351,261,261,2,0,"ECP-GUANYEM",17
17,"17185",2260,1657,1652,8,5,"ECP-GUANYEM",128
17,"17203",165,126,126,0,0,"ECP-GUANYEM",12
25,"25067",702,500,494,8,6,"ECP-GUANYEM",34
17,"17140",635,506,505,2,1,"ECP-GUANYEM",38
17,"17212",145,111,109,0,2,"ECP-GUANYEM",6
25,"25249",176,129,127,2,2,"ECP-GUANYEM",4
8,"8119",6897,5096,5052,31,44,"ECP-GUANYEM",943
43,"43157",339,279,279,1,0,"ECP-GUANYEM",10
25,"25220",991,768,762,1,6,"ECP-GUANYEM",30
43,"43038",22070,15127,15018,113,109,"ECP-GUANYEM",1842
17,"17145",1410,1040,1032,6,8,"ECP-GUANYEM",61
8,"8281",4858,3783,3762,19,21,"ECP-GUANYEM",409
8,"8233",1872,1428,1420,15,8,"ECP-GUANYEM",62
25,"25037",361,270,269,4,1,"ECP-GUANYEM",10
8,"8112",12926,9268,9230,61,38,"ECP-GUANYEM",760
17,"17115",276,208,208,4,0,"ECP-GUANYEM",11
43,"43160",1324,967,956,6,11,"ECP-GUANYEM",92
17,"17006",1178,826,818,9,8,"ECP-GUANYEM",78
43,"43085",237,190,185,1,5,"ECP-GUANYEM",21
17,"17055",142,124,124,0,0,"ECP-GUANYEM",11
8,"8064",1956,1439,1423,7,16,"ECP-GUANYEM",126
8,"8065",1183,920,913,8,7,"ECP-GUANYEM",80
8,"8224",885,653,652,6,1,"ECP-GUANYEM",80
17,"17029",207,154,154,1,0,"ECP-GUANYEM",8
25,"25225",531,395,393,0,2,"ECP-GUANYEM",19
8,"8293",227,177,177,0,0,"ECP-GUANYEM",7
25,"25053",1100,819,811,7,8,"ECP-GUANYEM",52
17,"17142",2713,2166,2159,18,7,"ECP-GUANYEM",222
25,"25905",366,281,276,4,5,"ECP-GUANYEM",23
8,"8128",579,428,423,4,5,"ECP-GUANYEM",28
17,"17202",3848,2632,2615,16,17,"ECP-GUANYEM",264
43,"43162",4436,3191,3163,24,28,"ECP-GUANYEM",388
8,"8104",657,496,493,4,3,"ECP-GUANYEM",37
17,"17114",23268,16423,16333,111,90,"ECP-GUANYEM",1340
25,"25155",616,446,443,2,3,"ECP-GUANYEM",21
8,"8084",1172,902,894,9,8,"ECP-GUANYEM",90
25,"25233",289,219,218,6,1,"ECP-GUANYEM",25
43,"43166",1646,1183,1176,4,7,"ECP-GUANYEM",128
8,"8297",138,99,99,0,0,"ECP-GUANYEM",11
25,"25223",890,673,666,7,7,"ECP-GUANYEM",35
17,"17080",144,113,113,1,0,"ECP-GUANYEM",1
43,"43907",4386,3083,3067,24,16,"ECP-GUANYEM",480
8,"8260",18515,13563,13487,84,76,"ECP-GUANYEM",2754
43,"43076",454,336,335,1,1,"ECP-GUANYEM",19
25,"25025",1362,909,898,15,11,"ECP-GUANYEM",117
8,"8198",4679,3491,3469,12,22,"ECP-GUANYEM",402
17,"17071",1134,943,940,1,3,"ECP-GUANYEM",44
17,"17120",823,560,558,5,2,"ECP-GUANYEM",35
17,"17007",1763,1367,1359,9,8,"ECP-GUANYEM",60
8,"8177",36,27,27,1,0,"ECP-GUANYEM",1
17,"17037",112,86,86,1,0,"ECP-GUANYEM",4
25,"25224",122,94,94,0,0,"ECP-GUANYEM",5
25,"25131",394,281,279,3,2,"ECP-GUANYEM",21
25,"25211",680,470,470,3,0,"ECP-GUANYEM",21
25,"25061",80,51,51,0,0,"ECP-GUANYEM",2
17,"17177",562,426,423,1,3,"ECP-GUANYEM",31
8,"8234",3443,2561,2550,15,11,"ECP-GUANYEM",386
8,"8132",356,265,265,1,0,"ECP-GUANYEM",16
43,"43108",1787,1293,1282,6,11,"ECP-GUANYEM",96
17,"17043",165,133,133,0,0,"ECP-GUANYEM",5
8,"8110",13671,9362,9311,60,51,"ECP-GUANYEM",1300
25,"25168",496,399,399,6,0,"ECP-GUANYEM",9
25,"25055",163,114,114,0,0,"ECP-GUANYEM",7
8,"8165",1680,1177,1171,7,6,"ECP-GUANYEM",89
8,"8159",14343,10656,10603,87,53,"ECP-GUANYEM",1902
8,"8044",4156,2991,2976,16,15,"ECP-GUANYEM",286
25,"25186",207,162,161,0,1,"ECP-GUANYEM",9
17,"17110",1332,990,981,3,9,"ECP-GUANYEM",98
43,"43134",281,217,215,5,2,"ECP-GUANYEM",26
17,"17083",2971,2164,2154,13,10,"ECP-GUANYEM",346
25,"25218",88,76,75,2,1,"ECP-GUANYEM",3
43,"43149",690,512,509,3,3,"ECP-GUANYEM",22
8,"8058",1808,1280,1262,6,18,"ECP-GUANYEM",181
25,"25124",160,102,101,1,1,"ECP-GUANYEM",7
8,"8246",1692,1345,1340,7,5,"ECP-GUANYEM",78
25,"25176",307,241,238,3,3,"ECP-GUANYEM",14
8,"8283",6165,4546,4524,33,22,"ECP-GUANYEM",337
17,"17087",219,179,177,0,2,"ECP-GUANYEM",13
8,"8163",19672,13421,13364,70,57,"ECP-GUANYEM",1716
8,"8066",1466,1109,1104,7,5,"ECP-GUANYEM",175
17,"17233",2347,1853,1840,11,13,"ECP-GUANYEM",159
17,"17141",6019,3855,3833,43,22,"ECP-GUANYEM",330
25,"25023",4560,3350,3334,24,16,"ECP-GUANYEM",279
17,"17103",5057,3196,3174,21,22,"ECP-GUANYEM",496
8,"8056",42897,30873,30757,259,116,"ECP-GUANYEM",5002
8,"8172",20543,15191,15140,85,51,"ECP-GUANYEM",2363
25,"25215",339,249,249,5,0,"ECP-GUANYEM",21
25,"25181",172,137,137,1,0,"ECP-GUANYEM",7
25,"25909",138,99,98,2,1,"ECP-GUANYEM",10
25,"25152",148,106,106,0,0,"ECP-GUANYEM",4
25,"25014",246,184,178,0,6,"ECP-GUANYEM",7
8,"8035",13006,8957,8918,50,39,"ECP-GUANYEM",1073
25,"25105",105,88,87,4,1,"ECP-GUANYEM",5
8,"8082",1164,796,780,5,16,"ECP-GUANYEM",144
43,"43172",334,248,243,4,5,"ECP-GUANYEM",29
8,"8001",9097,6860,6818,39,42,"ECP-GUANYEM",1318
25,"25906",205,133,131,2,2,"ECP-GUANYEM",4
8,"8296",1869,1412,1408,10,4,"ECP-GUANYEM",161
8,"8018",2540,1862,1855,7,7,"ECP-GUANYEM",195
25,"25062",691,498,491,4,7,"ECP-GUANYEM",43
25,"25127",217,145,145,1,0,"ECP-GUANYEM",8
8,"8294",2093,1546,1534,11,12,"ECP-GUANYEM",206
43,"43064",2027,1456,1445,19,11,"ECP-GUANYEM",111
8,"8197",7986,5829,5805,37,24,"ECP-GUANYEM",597
43,"43078",835,610,605,7,5,"ECP-GUANYEM",42
8,"8149",980,702,694,6,8,"ECP-GUANYEM",26
43,"43029",312,241,240,1,1,"ECP-GUANYEM",19
43,"43124",468,343,339,3,4,"ECP-GUANYEM",27
43,"43081",629,500,499,2,1,"ECP-GUANYEM",45
25,"25100",184,137,136,1,1,"ECP-GUANYEM",8
43,"43088",2013,1429,1420,11,9,"ECP-GUANYEM",144
8,"8215",2617,1954,1946,22,8,"ECP-GUANYEM",127
43,"43116",465,356,352,0,4,"ECP-GUANYEM",24
8,"8043",3414,2429,2422,15,7,"ECP-GUANYEM",411
43,"43005",3677,2505,2493,17,12,"ECP-GUANYEM",301
43,"43047",4234,2590,2564,19,26,"ECP-GUANYEM",282
17,"17174",164,130,130,4,0,"ECP-GUANYEM",5
43,"43143",50,40,39,0,1,"ECP-GUANYEM",2
25,"25036",180,124,124,1,0,"ECP-GUANYEM",6
43,"43044",3962,2751,2719,33,32,"ECP-GUANYEM",329
25,"25185",680,452,451,0,1,"ECP-GUANYEM",41
17,"17018",494,377,372,4,5,"ECP-GUANYEM",30
17,"17073",1939,1649,1640,11,9,"ECP-GUANYEM",92
8,"8137",272,208,207,2,1,"ECP-GUANYEM",15
17,"17198",437,307,306,0,1,"ECP-GUANYEM",33
8,"8015",156540,109145,108440,957,705,"ECP-GUANYEM",19393
8,"8081",349,274,270,0,4,"ECP-GUANYEM",18
8,"8203",2466,1678,1675,7,3,"ECP-GUANYEM",220
25,"25250",327,269,265,1,4,"ECP-GUANYEM",9
8,"8295",11290,8091,8054,72,37,"ECP-GUANYEM",1381
25,"25137",8684,5802,5757,48,45,"ECP-GUANYEM",442
43,"43125",884,658,645,12,13,"ECP-GUANYEM",74
25,"25011",5271,3529,3505,21,24,"ECP-GUANYEM",273
17,"17077",565,395,394,2,1,"ECP-GUANYEM",36
8,"8006",11774,8375,8329,53,46,"ECP-GUANYEM",881
43,"43148",91182,65076,64756,441,320,"ECP-GUANYEM",8461
43,"43174",144,118,114,0,4,"ECP-GUANYEM",8
25,"25045",57,26,26,2,0,"ECP-GUANYEM",3
17,"17138",836,591,584,7,7,"ECP-GUANYEM",57
17,"17132",1344,1019,1009,12,10,"ECP-GUANYEM",79
8,"8099",753,529,529,4,0,"ECP-GUANYEM",37
8,"8271",66,48,47,2,1,"ECP-GUANYEM",0
25,"25252",553,380,379,2,1,"ECP-GUANYEM",18
25,"25031",57,32,32,0,0,"ECP-GUANYEM",1
8,"8265",1597,1262,1260,4,2,"ECP-GUANYEM",59
25,"25221",115,82,81,1,1,"ECP-GUANYEM",3
25,"25126",281,211,210,1,1,"ECP-GUANYEM",15
8,"8157",8574,6514,6472,47,42,"ECP-GUANYEM",1186
25,"25243",3729,2370,2349,33,21,"ECP-GUANYEM",305
43,"43096",97,76,76,0,0,"ECP-GUANYEM",8
25,"25209",1586,1115,1102,6,13,"ECP-GUANYEM",108
17,"17201",137,103,103,0,0,"ECP-GUANYEM",5
17,"17194",73,56,56,0,0,"ECP-GUANYEM",4
8,"8303",257,207,205,1,2,"ECP-GUANYEM",14
25,"25151",731,555,549,1,6,"ECP-GUANYEM",19
17,"17206",158,111,109,0,2,"ECP-GUANYEM",8
43,"43090",1199,689,686,5,3,"ECP-GUANYEM",110
8,"8268",975,729,723,6,6,"ECP-GUANYEM",38
17,"17021",119,89,87,0,2,"ECP-GUANYEM",7
8,"8219",15755,12235,12206,72,29,"ECP-GUANYEM",1532
43,"43128",910,665,658,6,7,"ECP-GUANYEM",81
25,"25109",211,155,154,1,1,"ECP-GUANYEM",6
25,"25912",841,620,619,5,1,"ECP-GUANYEM",49
25,"25156",765,571,567,3,4,"ECP-GUANYEM",39
25,"25230",1541,1105,1099,9,6,"ECP-GUANYEM",44
43,"43145",4209,3193,3170,17,23,"ECP-GUANYEM",276
43,"43046",88,69,68,1,1,"ECP-GUANYEM",3
8,"8905",2329,1872,1863,7,9,"ECP-GUANYEM",271
17,"17215",2286,1855,1844,13,11,"ECP-GUANYEM",150
25,"25085",141,109,108,2,1,"ECP-GUANYEM",2
25,"25154",117,86,85,0,1,"ECP-GUANYEM",4
25,"25242",688,494,488,5,6,"ECP-GUANYEM",29
25,"25002",465,324,323,4,1,"ECP-GUANYEM",13
43,"43060",2672,2032,2015,7,17,"ECP-GUANYEM",123
8,"8111",216,195,194,2,1,"ECP-GUANYEM",8
43,"43008",305,171,171,7,0,"ECP-GUANYEM",9
25,"25047",956,745,736,14,9,"ECP-GUANYEM",24
25,"25112",269,205,200,2,5,"ECP-GUANYEM",6
43,"43902",2751,1794,1776,21,18,"ECP-GUANYEM",252
17,"17085",293,239,238,0,1,"ECP-GUANYEM",20
43,"43069",183,148,147,2,1,"ECP-GUANYEM",16
1,"1028",1091,735,728,5,7,"EH Bildu",103
31,"31040",186,131,129,1,2,"EH Bildu",42
31,"31121",62,42,42,0,0,"EH Bildu",9
31,"31072",5324,3733,3684,33,49,"EH Bildu",59
48,"48073",6827,4614,4591,38,23,"EH Bildu",2119
31,"31043",29,23,23,0,0,"EH Bildu",0
1,"1027",444,273,271,0,2,"EH Bildu",84
48,"48067",1133,810,805,0,5,"EH Bildu",336
48,"48021",1325,891,888,3,3,"EH Bildu",237
31,"31059",182,121,121,1,0,"EH Bildu",44
31,"31145",160,121,120,2,1,"EH Bildu",1
31,"31185",461,291,290,1,1,"EH Bildu",113
48,"48080",9916,6849,6793,44,56,"EH Bildu",860
1,"1020",323,228,224,1,4,"EH Bildu",72
31,"31124",207,134,134,2,0,"EH Bildu",17
20,"20028",2254,1442,1441,6,1,"EH Bildu",569
31,"31132",147,100,100,2,0,"EH Bildu",25
31,"31192",160,125,123,0,2,"EH Bildu",31
31,"31255",103,79,79,0,0,"EH Bildu",5
20,"20011",1624,1234,1225,3,9,"EH Bildu",566
31,"31205",419,290,289,4,1,"EH Bildu",23
31,"31105",1471,1144,1124,10,20,"EH Bildu",24
31,"31214",87,55,54,0,1,"EH Bildu",20
48,"48017",13121,8929,8886,45,43,"EH Bildu",2253
31,"31011",715,483,481,5,2,"EH Bildu",95
31,"31222",57,35,34,3,1,"EH Bildu",12
48,"48039",254,221,220,2,1,"EH Bildu",72
48,"48071",6013,4240,4205,23,35,"EH Bildu",571
31,"31120",376,211,209,7,2,"EH Bildu",64
20,"20071",15062,10442,10407,47,35,"EH Bildu",3415
48,"48036",24015,16501,16425,83,76,"EH Bildu",3072
48,"48907",343,274,273,0,1,"EH Bildu",95
31,"31066",819,577,559,4,18,"EH Bildu",22
1,"1901",2473,1633,1612,9,21,"EH Bildu",200
1,"1016",428,194,192,4,2,"EH Bildu",35
48,"48058",947,682,679,2,3,"EH Bildu",249
31,"31144",760,442,441,4,1,"EH Bildu",248
20,"20001",253,163,163,1,0,"EH Bildu",68
31,"31243",300,216,213,6,3,"EH Bildu",67
31,"31906",2707,1800,1781,22,19,"EH Bildu",285
31,"31181",133,87,84,1,3,"EH Bildu",36
31,"31048",166,121,119,1,2,"EH Bildu",3
31,"31052",101,78,75,0,3,"EH Bildu",5
20,"20055",17300,11784,11725,43,59,"EH Bildu",3504
31,"31259",475,313,311,5,2,"EH Bildu",141
31,"31133",34,27,27,1,0,"EH Bildu",15
31,"31024",100,52,52,0,0,"EH Bildu",33
48,"48092",872,614,608,3,6,"EH Bildu",124
31,"31084",1946,1367,1362,9,5,"EH Bildu",786
31,"31019",1831,1231,1224,17,7,"EH Bildu",465
31,"31177",245,161,159,1,2,"EH Bildu",21
1,"1031",1136,844,830,1,14,"EH Bildu",133
48,"48007",389,243,243,0,0,"EH Bildu",122
31,"31023",7778,5977,5948,106,29,"EH Bildu",590
48,"48030",591,449,447,2,2,"EH Bildu",168
48,"48033",217,162,162,1,0,"EH Bildu",64
20,"20065",2921,1983,1970,16,13,"EH Bildu",626
20,"20068",179,119,119,2,0,"EH Bildu",68
31,"31153",2174,1417,1415,12,2,"EH Bildu",593
20,"20907",118,82,82,0,0,"EH Bildu",37
31,"31061",48,45,45,2,0,"EH Bildu",2
31,"31116",57,27,27,3,0,"EH Bildu",3
31,"31092",683,413,413,6,0,"EH Bildu",148
31,"31108",1819,1348,1325,13,23,"EH Bildu",31
31,"31176",2919,1974,1933,27,41,"EH Bildu",47
1,"1059",189597,128849,127910,688,939,"EH Bildu",17823
31,"31055",267,192,191,0,1,"EH Bildu",80
48,"48005",116,80,79,0,1,"EH Bildu",27
31,"31223",953,667,654,4,13,"EH Bildu",104
48,"48064",608,461,461,0,0,"EH Bildu",184
31,"31056",186,128,124,2,4,"EH Bildu",26
31,"31080",486,362,361,4,1,"EH Bildu",65
1,"1008",808,546,536,6,10,"EH Bildu",116
31,"31067",1887,1265,1249,6,16,"EH Bildu",70
31,"31083",49,39,39,1,0,"EH Bildu",11
1,"1009",1258,839,833,2,6,"EH Bildu",332
31,"31213",99,50,50,0,0,"EH Bildu",24
20,"20018",11231,7640,7611,33,29,"EH Bildu",3140
48,"48054",25063,17705,17597,122,108,"EH Bildu",1862
31,"31010",5719,3799,3770,22,29,"EH Bildu",1225
48,"48026",1132,834,832,2,2,"EH Bildu",419
31,"31152",1255,826,817,8,9,"EH Bildu",54
48,"48077",3366,2483,2467,9,16,"EH Bildu",501
31,"31149",2285,1531,1520,10,11,"EH Bildu",933
31,"31902",4661,3228,3201,39,27,"EH Bildu",537
31,"31035",50,30,29,0,1,"EH Bildu",3
48,"48046",12626,9300,9250,31,50,"EH Bildu",2618
48,"48914",332,276,275,0,1,"EH Bildu",111
31,"31104",1751,1147,1125,8,22,"EH Bildu",76
20,"20067",30609,20017,19927,111,90,"EH Bildu",4698
20,"20044",355,261,261,1,0,"EH Bildu",120
31,"31047",238,163,163,2,0,"EH Bildu",30
31,"31217",327,204,196,1,8,"EH Bildu",31
31,"31107",1671,1204,1182,12,22,"EH Bildu",18
31,"31238",119,96,95,4,1,"EH Bildu",25
20,"20078",1143,819,816,1,3,"EH Bildu",515
20,"20031",185,113,112,3,1,"EH Bildu",55
31,"31165",2772,1946,1930,16,16,"EH Bildu",56
20,"20072",4762,3175,3153,21,22,"EH Bildu",702
31,"31068",2816,2028,1989,20,39,"EH Bildu",59
48,"48050",188,141,141,0,0,"EH Bildu",73
31,"31157",3447,2182,2160,29,22,"EH Bildu",142
1,"1052",272,189,186,2,3,"EH Bildu",49
20,"20004",230,133,133,2,0,"EH Bildu",49
1,"1053",596,364,362,1,2,"EH Bildu",127
31,"31170",44,31,30,2,1,"EH Bildu",7
31,"31212",128,91,91,1,0,"EH Bildu",2
20,"20047",455,314,314,1,0,"EH Bildu",178
20,"20048",183,112,112,0,0,"EH Bildu",60
48,"48014",1229,845,843,8,2,"EH Bildu",183
48,"48002",7791,5510,5471,42,39,"EH Bildu",816
31,"31099",51,38,38,0,0,"EH Bildu",5
48,"48085",10716,7707,7679,51,28,"EH Bildu",1543
31,"31076",2543,1965,1956,19,9,"EH Bildu",197
20,"20904",87,56,55,1,1,"EH Bildu",41
31,"31117",583,373,372,3,1,"EH Bildu",290
31,"31097",10559,6977,6919,71,58,"EH Bildu",1359
48,"48063",354,256,252,1,4,"EH Bildu",107
31,"31091",322,201,201,3,0,"EH Bildu",107
48,"48025",874,667,662,2,5,"EH Bildu",231
48,"48091",1078,758,757,5,1,"EH Bildu",296
48,"48001",5899,4094,4074,19,20,"EH Bildu",1077
31,"31053",509,354,350,4,4,"EH Bildu",56
31,"31128",349,217,215,4,2,"EH Bildu",73
1,"1006",174,124,122,1,2,"EH Bildu",11
31,"31031",212,134,132,2,2,"EH Bildu",73
1,"1010",2315,1705,1688,6,17,"EH Bildu",358
20,"20061",4427,3073,3053,13,20,"EH Bildu",1033
31,"31231",104,65,65,1,0,"EH Bildu",2
31,"31215",4670,3270,3219,33,51,"EH Bildu",55
31,"31254",1916,1336,1322,9,14,"EH Bildu",61
1,"1014",366,271,266,2,5,"EH Bildu",25
31,"31139",152,100,100,1,0,"EH Bildu",15
31,"31063",84,59,59,0,0,"EH Bildu",12
1,"1058",1414,893,884,1,9,"EH Bildu",297
31,"31173",845,642,636,4,6,"EH Bildu",7
20,"20902",14282,9670,9618,52,52,"EH Bildu",1754
1,"1046",639,433,432,2,1,"EH Bildu",72
31,"31210",186,131,130,2,1,"EH Bildu",40
31,"31202",4360,2806,2767,30,39,"EH Bildu",130
31,"31234",146,101,101,0,0,"EH Bildu",8
48,"48023",579,451,448,0,3,"EH Bildu",167
48,"48904",3547,2563,2541,18,22,"EH Bildu",376
1,"1017",817,537,532,3,5,"EH Bildu",153
1,"1032",498,363,353,1,10,"EH Bildu",60
31,"31244",157,69,69,0,0,"EH Bildu",14
31,"31242",258,168,167,2,1,"EH Bildu",37
48,"48057",5730,4126,4115,14,11,"EH Bildu",1785
48,"48004",326,245,245,1,0,"EH Bildu",110
31,"31075",113,69,69,2,0,"EH Bildu",16
31,"31148",92,62,59,2,3,"EH Bildu",2
31,"31140",112,73,73,1,0,"EH Bildu",18
31,"31248",272,142,138,3,4,"EH Bildu",36
48,"48008",609,415,407,4,8,"EH Bildu",72
31,"31219",80,59,58,2,1,"EH Bildu",7
48,"48074",3275,2308,2295,11,13,"EH Bildu",583
31,"31150",200,120,119,1,1,"EH Bildu",49
20,"20023",441,254,251,1,3,"EH Bildu",115
31,"31151",53,37,37,0,0,"EH Bildu",8
31,"31090",139,67,67,0,0,"EH Bildu",19
31,"31005",279,183,183,4,0,"EH Bildu",23
31,"31071",13,11,11,0,0,"EH Bildu",1
1,"1034",152,107,107,1,0,"EH Bildu",18
31,"31232",25687,17548,17304,243,244,"EH Bildu",578
48,"48082",37358,25328,25167,125,161,"EH Bildu",3191
48,"48060",3625,2429,2418,12,11,"EH Bildu",881
20,"20054",461,294,294,1,0,"EH Bildu",212
20,"20035",480,361,361,0,0,"EH Bildu",160
31,"31261",240,161,158,2,3,"EH Bildu",13
20,"20007",337,223,221,2,2,"EH Bildu",135
31,"31079",65,46,46,2,0,"EH Bildu",2
48,"48020",272771,184893,183922,1227,971,"EH Bildu",20104
31,"31193",1440,1062,1055,11,7,"EH Bildu",268
31,"31230",90,66,66,0,0,"EH Bildu",9
48,"48088",134,95,95,0,0,"EH Bildu",59
31,"31211",17,15,14,3,1,"EH Bildu",1
31,"31003",121,71,71,0,0,"EH Bildu",31
48,"48070",527,357,355,0,2,"EH Bildu",221
31,"31088",5656,3929,3893,56,36,"EH Bildu",443
31,"31169",2203,1429,1415,15,14,"EH Bildu",17
31,"31247",141,99,96,1,3,"EH Bildu",45
31,"31251",3144,2197,2164,18,33,"EH Bildu",176
48,"48901",5160,3705,3684,16,21,"EH Bildu",524
48,"48083",6934,4800,4765,21,35,"EH Bildu",540
20,"20901",1399,960,957,3,3,"EH Bildu",218
20,"20008",713,424,424,5,0,"EH Bildu",230
20,"20019",9892,6740,6717,40,23,"EH Bildu",1582
31,"31155",246,165,161,3,4,"EH Bildu",9
20,"20050",275,174,174,2,0,"EH Bildu",98
20,"20906",128,87,87,0,0,"EH Bildu",45
31,"31009",674,455,451,2,4,"EH Bildu",90
31,"31029",913,606,601,14,5,"EH Bildu",64
31,"31077",5416,3840,3794,38,46,"EH Bildu",65
31,"31096",99,79,79,3,0,"EH Bildu",17
31,"31249",1798,1235,1227,13,8,"EH Bildu",12
31,"31220",742,551,539,6,12,"EH Bildu",15
31,"31195",169,108,108,0,0,"EH Bildu",60
20,"20066",437,288,286,1,2,"EH Bildu",203
31,"31253",121,100,100,0,0,"EH Bildu",48
48,"48912",2321,1684,1670,8,14,"EH Bildu",368
48,"48903",1800,1358,1353,4,5,"EH Bildu",155
31,"31156",238,175,174,2,1,"EH Bildu",65
31,"31175",66,46,46,0,0,"EH Bildu",5
48,"48034",12623,8789,8711,76,78,"EH Bildu",937
48,"48042",1359,1055,1045,7,10,"EH Bildu",108
31,"31209",149,111,110,0,1,"EH Bildu",24
31,"31208",2568,1855,1835,24,20,"EH Bildu",28
31,"31183",718,536,534,5,2,"EH Bildu",81
20,"20060",87,75,75,0,0,"EH Bildu",73
31,"31007",122,88,82,1,6,"EH Bildu",12
1,"1036",14698,10207,10131,51,76,"EH Bildu",2033
20,"20064",12395,7959,7916,42,43,"EH Bildu",1963
31,"31164",542,410,408,5,2,"EH Bildu",2
31,"31103",40,28,27,0,1,"EH Bildu",3
1,"1011",213,162,160,3,2,"EH Bildu",3
31,"31112",91,56,56,0,0,"EH Bildu",11
31,"31246",130,89,87,2,2,"EH Bildu",13
20,"20059",8892,6505,6490,18,15,"EH Bildu",2864
48,"48902",18987,12762,12670,88,92,"EH Bildu",1628
31,"31239",282,196,193,6,3,"EH Bildu",51
31,"31018",426,287,283,2,4,"EH Bildu",36
48,"48090",6004,4305,4254,28,51,"EH Bildu",494
48,"48027",22745,16240,16158,74,82,"EH Bildu",3721
31,"31141",106,66,61,1,5,"EH Bildu",3
1,"1002",8014,5838,5786,24,52,"EH Bildu",1400
48,"48059",402,299,297,0,2,"EH Bildu",131
31,"31109",1657,1165,1160,12,5,"EH Bildu",255
31,"31119",35,24,24,1,0,"EH Bildu",5
48,"48906",736,550,548,2,2,"EH Bildu",169
31,"31233",91,62,60,2,2,"EH Bildu",0
31,"31087",179,124,124,3,0,"EH Bildu",60
31,"31172",370,257,250,6,7,"EH Bildu",31
31,"31106",721,547,545,1,2,"EH Bildu",9
1,"1055",839,557,552,11,5,"EH Bildu",101
20,"20003",549,360,355,1,5,"EH Bildu",197
31,"31122",4981,3539,3504,38,35,"EH Bildu",905
31,"31030",135,94,94,0,0,"EH Bildu",27
31,"31089",236,168,167,1,1,"EH Bildu",20
48,"48044",61957,45253,45063,299,190,"EH Bildu",5384
48,"48913",1236,899,890,8,9,"EH Bildu",168
31,"31017",375,250,250,10,0,"EH Bildu",83
1,"1030",141,102,102,0,0,"EH Bildu",12
20,"20051",6736,4829,4804,22,25,"EH Bildu",1425
31,"31237",182,138,135,2,3,"EH Bildu",17
48,"48006",307,242,240,3,2,"EH Bildu",113
48,"48032",5762,4287,4262,14,25,"EH Bildu",1472
20,"20009",11369,7402,7355,32,47,"EH Bildu",1917
20,"20053",4856,3169,3153,15,16,"EH Bildu",1216
48,"48013",79353,53591,53205,331,386,"EH Bildu",4467
20,"20074",11520,8379,8357,19,22,"EH Bildu",3160
48,"48035",406,314,314,0,0,"EH Bildu",94
1,"1062",318,221,219,2,2,"EH Bildu",20
31,"31034",31,24,24,0,0,"EH Bildu",9
48,"48076",288,211,211,1,0,"EH Bildu",47
20,"20903",5033,3355,3341,18,14,"EH Bildu",1051
31,"31229",39,32,32,0,0,"EH Bildu",8
31,"31188",319,197,191,3,6,"EH Bildu",48
31,"31135",111,73,72,3,1,"EH Bildu",0
31,"31904",1559,989,972,11,17,"EH Bildu",303
31,"31027",811,527,521,1,6,"EH Bildu",336
20,"20020",114,64,64,0,0,"EH Bildu",28
31,"31194",328,224,222,3,2,"EH Bildu",83
20,"20075",4312,2848,2845,8,3,"EH Bildu",1087
48,"48047",147,105,105,2,0,"EH Bildu",64
20,"20024",395,245,245,4,0,"EH Bildu",136
20,"20014",1161,699,693,0,6,"EH Bildu",342
20,"20049",4195,2918,2901,12,17,"EH Bildu",1115
31,"31206",2077,1433,1417,15,16,"EH Bildu",313
31,"31262",234,190,188,0,2,"EH Bildu",43
31,"31901",15487,11077,10991,117,86,"EH Bildu",1716
20,"20079",18151,13106,13054,58,52,"EH Bildu",3544
31,"31074",394,293,292,5,1,"EH Bildu",118
48,"48081",1903,1455,1447,7,8,"EH Bildu",295
48,"48911",381,303,302,1,1,"EH Bildu",171
31,"31002",431,294,290,3,4,"EH Bildu",57
1,"1043",2340,1487,1468,11,19,"EH Bildu",178
48,"48909",201,158,157,0,1,"EH Bildu",91
31,"31216",3867,2592,2566,37,26,"EH Bildu",320
31,"31179",486,315,312,3,3,"EH Bildu",10
31,"31187",99,53,52,0,1,"EH Bildu",18
31,"31126",352,223,223,3,0,"EH Bildu",107
20,"20037",101,69,69,0,0,"EH Bildu",32
48,"48012",2057,1610,1600,1,10,"EH Bildu",516
31,"31042",2707,1926,1900,11,26,"EH Bildu",14
31,"31060",14323,9547,9434,79,113,"EH Bildu",1839
20,"20081",7690,5382,5363,31,19,"EH Bildu",1916
1,"1023",262,193,190,1,3,"EH Bildu",27
31,"31224",884,637,630,7,7,"EH Bildu",24
48,"48016",5471,3964,3935,31,29,"EH Bildu",637
20,"20029",4264,3116,3104,14,12,"EH Bildu",1037
31,"31038",1343,975,963,16,12,"EH Bildu",102
31,"31250",2761,1776,1759,13,17,"EH Bildu",659
1,"1019",148,112,112,0,0,"EH Bildu",15
48,"48048",527,381,380,3,1,"EH Bildu",130
48,"48011",9640,6753,6722,41,31,"EH Bildu",1275
31,"31078",2418,1752,1729,16,23,"EH Bildu",56
48,"48094",3121,2201,2188,7,13,"EH Bildu",743
48,"48045",5207,3851,3817,9,34,"EH Bildu",739
20,"20022",849,574,571,8,3,"EH Bildu",276
48,"48049",543,415,414,1,1,"EH Bildu",148
31,"31258",7879,5668,5631,50,37,"EH Bildu",1685
20,"20062",941,688,683,1,5,"EH Bildu",247
31,"31147",110,79,78,1,1,"EH Bildu",13
1,"1054",998,701,700,4,1,"EH Bildu",276
31,"31189",1125,702,698,6,4,"EH Bildu",289
31,"31197",67,51,51,2,0,"EH Bildu",4
31,"31240",514,352,352,3,0,"EH Bildu",201
31,"31115",159,93,93,2,0,"EH Bildu",44
20,"20057",198,148,147,1,1,"EH Bildu",73
1,"1021",471,321,319,3,2,"EH Bildu",48
31,"31138",948,629,627,8,2,"EH Bildu",299
31,"31225",35,29,28,0,1,"EH Bildu",6
20,"20040",15771,10549,10481,54,68,"EH Bildu",4036
31,"31171",670,466,462,1,4,"EH Bildu",32
31,"31013",615,371,365,1,6,"EH Bildu",100
31,"31130",321,203,203,0,0,"EH Bildu",76
31,"31039",92,70,69,1,1,"EH Bildu",22
31,"31110",83,61,61,1,0,"EH Bildu",9
31,"31062",1070,778,770,10,8,"EH Bildu",15
31,"31058",199,134,133,2,1,"EH Bildu",47
20,"20027",2761,1866,1861,10,5,"EH Bildu",859
48,"48040",1303,933,926,7,7,"EH Bildu",235
1,"1044",232,151,148,2,3,"EH Bildu",43
20,"20002",359,234,231,7,3,"EH Bildu",129
48,"48087",437,335,332,0,3,"EH Bildu",35
31,"31191",3024,2156,2133,23,23,"EH Bildu",165
31,"31136",461,294,293,3,1,"EH Bildu",102
1,"1049",130,94,94,1,0,"EH Bildu",24
31,"31168",238,176,174,1,2,"EH Bildu",38
48,"48043",4591,3337,3325,20,12,"EH Bildu",652
31,"31159",1097,813,812,2,1,"EH Bildu",218
1,"1063",1852,1316,1303,6,13,"EH Bildu",346
48,"48095",2324,1568,1555,13,13,"EH Bildu",390
31,"31201",151450,105649,104976,1004,673,"EH Bildu",18179
31,"31057",1741,1237,1219,6,18,"EH Bildu",8
31,"31070",2633,1714,1682,16,32,"EH Bildu",68
48,"48086",2024,1371,1358,5,13,"EH Bildu",262
48,"48053",926,704,702,6,2,"EH Bildu",109
20,"20033",858,644,638,1,6,"EH Bildu",294
48,"48024",1000,761,752,1,9,"EH Bildu",289
48,"48097",1314,886,882,6,4,"EH Bildu",215
48,"48096",6516,4862,4816,33,46,"EH Bildu",593
31,"31184",65,41,40,0,1,"EH Bildu",19
31,"31114",388,272,271,3,1,"EH Bildu",44
31,"31163",2011,1422,1404,6,18,"EH Bildu",33
20,"20045",47031,30933,30787,172,146,"EH Bildu",3261
20,"20063",8023,5611,5597,19,14,"EH Bildu",2927
48,"48084",21780,14368,14271,79,97,"EH Bildu",1458
31,"31227",8118,5691,5636,65,55,"EH Bildu",1251
48,"48015",33077,22441,22295,145,146,"EH Bildu",2304
31,"31101",1428,986,981,6,5,"EH Bildu",267
31,"31102",135,60,60,1,0,"EH Bildu",23
31,"31006",1877,1328,1310,14,18,"EH Bildu",37
1,"1013",710,469,465,2,4,"EH Bildu",182
48,"48079",397,289,287,1,2,"EH Bildu",107
20,"20012",149,104,104,1,0,"EH Bildu",46
31,"31001",79,56,56,0,0,"EH Bildu",14
20,"20017",8462,5944,5917,11,27,"EH Bildu",1866
31,"31004",31,22,22,1,0,"EH Bildu",6
48,"48010",476,343,343,1,0,"EH Bildu",93
31,"31263",231,137,137,1,0,"EH Bildu",95
31,"31026",130,108,107,0,1,"EH Bildu",6
31,"31235",156,112,108,1,4,"EH Bildu",35
31,"31154",217,107,104,0,3,"EH Bildu",33
31,"31127",131,90,86,0,4,"EH Bildu",28
31,"31174",100,55,55,0,0,"EH Bildu",12
31,"31199",138,86,84,0,2,"EH Bildu",30
31,"31198",36,30,30,0,0,"EH Bildu",19
31,"31014",268,168,168,2,0,"EH Bildu",51
48,"48055",2603,1833,1820,14,13,"EH Bildu",552
48,"48066",344,246,246,2,0,"EH Bildu",74
20,"20080",7705,5276,5244,21,32,"EH Bildu",966
31,"31226",572,347,343,4,4,"EH Bildu",158
20,"20006",261,154,153,1,1,"EH Bildu",74
31,"31256",95,55,55,1,0,"EH Bildu",38
31,"31041",1671,1118,1105,15,13,"EH Bildu",169
1,"1001",2020,1385,1372,5,13,"EH Bildu",240
31,"31100",256,166,165,0,1,"EH Bildu",32
31,"31054",453,279,276,2,3,"EH Bildu",125
31,"31137",198,83,83,1,0,"EH Bildu",22
31,"31196",31,23,23,0,0,"EH Bildu",8
31,"31236",1319,815,808,8,7,"EH Bildu",256
31,"31167",833,581,573,2,8,"EH Bildu",107
31,"31204",36,25,25,0,0,"EH Bildu",7
1,"1018",1399,953,947,1,6,"EH Bildu",291
20,"20036",13208,9102,9056,59,46,"EH Bildu",1553
31,"31123",615,350,347,4,3,"EH Bildu",126
48,"48029",8681,6057,6027,41,30,"EH Bildu",457
48,"48072",965,730,724,3,6,"EH Bildu",353
31,"31021",59,42,42,1,0,"EH Bildu",21
31,"31081",338,229,227,1,2,"EH Bildu",104
31,"31044",291,227,227,1,0,"EH Bildu",132
31,"31908",1076,763,762,5,1,"EH Bildu",249
31,"31045",510,347,345,8,2,"EH Bildu",36
48,"48051",220,151,150,0,1,"EH Bildu",21
31,"31178",476,323,320,7,3,"EH Bildu",6
20,"20038",387,294,293,2,1,"EH Bildu",145
31,"31086",13781,10133,10054,114,79,"EH Bildu",1458
31,"31180",202,144,143,1,1,"EH Bildu",18
20,"20034",3200,2193,2180,8,13,"EH Bildu",683
20,"20032",8654,6000,5972,21,28,"EH Bildu",1477
48,"48056",980,731,728,3,3,"EH Bildu",224
31,"31142",1389,909,900,9,9,"EH Bildu",119
31,"31036",879,601,589,5,12,"EH Bildu",98
20,"20046",1243,822,816,1,6,"EH Bildu",311
31,"31166",242,172,172,2,0,"EH Bildu",24
31,"31905",2992,1994,1984,9,10,"EH Bildu",130
48,"48905",2496,1778,1766,12,12,"EH Bildu",401
31,"31022",477,303,301,2,2,"EH Bildu",176
48,"48031",303,221,221,0,0,"EH Bildu",90
31,"31903",6950,4430,4394,39,36,"EH Bildu",999
48,"48068",1534,1154,1149,1,5,"EH Bildu",300
31,"31025",762,497,490,1,7,"EH Bildu",185
31,"31241",126,86,85,2,1,"EH Bildu",11
48,"48075",2066,1524,1508,9,16,"EH Bildu",369
31,"31073",298,207,206,1,1,"EH Bildu",117
31,"31037",91,70,70,0,0,"EH Bildu",44
31,"31085",500,365,362,2,3,"EH Bildu",163
20,"20013",5433,3906,3893,24,13,"EH Bildu",1317
31,"31028",215,121,121,2,0,"EH Bildu",53
20,"20073",4707,3272,3260,14,12,"EH Bildu",1591
20,"20058",740,523,522,3,1,"EH Bildu",131
31,"31012",763,550,542,7,8,"EH Bildu",52
48,"48041",687,548,547,4,1,"EH Bildu",144
31,"31203",30,19,19,2,0,"EH Bildu",0
20,"20030",21147,14598,14521,92,77,"EH Bildu",2790
31,"31093",275,201,198,3,3,"EH Bildu",82
1,"1039",188,150,147,2,3,"EH Bildu",17
31,"31082",627,385,385,5,0,"EH Bildu",166
48,"48915",339,245,243,0,2,"EH Bildu",125
31,"31186",283,183,182,1,1,"EH Bildu",68
48,"48062",295,236,236,0,0,"EH Bildu",82
48,"48038",1151,829,829,1,0,"EH Bildu",222
48,"48089",3540,2561,2555,7,6,"EH Bildu",522
48,"48910",2811,1952,1942,11,10,"EH Bildu",491
1,"1041",150,103,102,1,1,"EH Bildu",7
31,"31125",271,173,171,3,2,"EH Bildu",23
31,"31016",7790,5541,5502,56,39,"EH Bildu",1297
31,"31161",350,261,256,1,5,"EH Bildu",62
1,"1051",3569,2259,2244,3,15,"EH Bildu",742
48,"48078",37858,25959,25819,157,140,"EH Bildu",2447
31,"31162",48,28,27,1,1,"EH Bildu",4
20,"20070",1084,798,795,7,3,"EH Bildu",369
31,"31907",11272,8478,8421,97,57,"EH Bildu",1472
48,"48003",14518,10375,10310,49,65,"EH Bildu",2657
1,"1003",1166,843,837,6,6,"EH Bildu",461
20,"20043",1718,1189,1183,2,6,"EH Bildu",478
20,"20052",1050,746,743,4,3,"EH Bildu",285
48,"48052",1562,1220,1210,5,10,"EH Bildu",596
20,"20077",5269,3845,3830,9,15,"EH Bildu",948
1,"1004",1357,952,945,5,7,"EH Bildu",239
1,"1902",723,485,478,8,7,"EH Bildu",48
1,"1037",589,378,374,1,4,"EH Bildu",101
20,"20039",2126,1623,1618,9,5,"EH Bildu",721
48,"48009",774,585,578,0,7,"EH Bildu",246
48,"48037",696,497,485,0,12,"EH Bildu",116
48,"48908",250,212,210,1,2,"EH Bildu",71
31,"31113",130,77,76,0,1,"EH Bildu",15
20,"20905",160,123,123,2,0,"EH Bildu",80
1,"1042",911,680,671,8,9,"EH Bildu",173
31,"31160",104,83,82,1,1,"EH Bildu",23
31,"31051",241,169,167,3,2,"EH Bildu",16
20,"20026",207,172,171,4,1,"EH Bildu",76
20,"20076",7013,5011,4991,16,20,"EH Bildu",1569
20,"20015",1245,880,876,5,4,"EH Bildu",511
31,"31257",915,654,642,9,12,"EH Bildu",101
31,"31032",1670,1158,1147,18,11,"EH Bildu",24
31,"31064",1398,1035,1031,5,4,"EH Bildu",26
1,"1033",654,476,476,0,0,"EH Bildu",45
48,"48022",2305,1434,1425,11,9,"EH Bildu",193
31,"31118",156,104,104,3,0,"EH Bildu",25
20,"20069",147446,102068,101696,564,372,"EH Bildu",17515
20,"20010",1524,1057,1053,5,4,"EH Bildu",469
20,"20025",1110,791,788,4,3,"EH Bildu",333
31,"31190",44,30,30,1,0,"EH Bildu",6
20,"20016",1529,887,883,3,4,"EH Bildu",316
31,"31049",679,461,453,2,8,"EH Bildu",280
31,"31111",91,52,52,0,0,"EH Bildu",21
31,"31033",45,25,25,2,0,"EH Bildu",10
31,"31015",1989,1399,1386,17,13,"EH Bildu",110
20,"20021",185,104,104,2,0,"EH Bildu",41
31,"31146",30,22,22,1,0,"EH Bildu",3
31,"31069",823,596,595,1,1,"EH Bildu",73
31,"31143",91,44,41,1,3,"EH Bildu",8
48,"48061",789,602,601,2,1,"EH Bildu",136
31,"31182",29,25,25,0,0,"EH Bildu",6
31,"31200",745,489,483,1,6,"EH Bildu",130
48,"48069",13131,9211,9162,55,49,"EH Bildu",1607
1,"1061",155,116,116,1,0,"EH Bildu",61
31,"31207",280,194,191,3,3,"EH Bildu",62
31,"31252",80,52,52,1,0,"EH Bildu",24
1,"1022",755,532,523,4,9,"EH Bildu",38
31,"31065",1843,1311,1300,12,11,"EH Bildu",65
48,"48093",891,669,666,5,3,"EH Bildu",251
31,"31134",172,106,106,1,0,"EH Bildu",38
20,"20005",1274,822,822,1,0,"EH Bildu",376
1,"1056",202,107,107,0,0,"EH Bildu",22
48,"48018",854,563,560,5,3,"EH Bildu",239
31,"31221",1228,823,815,6,8,"EH Bildu",288
31,"31095",71,59,59,0,0,"EH Bildu",27
31,"31046",53,38,38,0,0,"EH Bildu",3
31,"31008",61,42,42,0,0,"EH Bildu",2
20,"20041",241,143,142,2,1,"EH Bildu",58
31,"31131",913,672,664,8,8,"EH Bildu",128
20,"20042",3180,2056,2053,7,3,"EH Bildu",750
20,"20056",4077,2796,2781,12,15,"EH Bildu",1145
31,"31228",496,356,354,1,2,"EH Bildu",37
48,"48065",3285,2341,2326,8,15,"EH Bildu",564
1,"1047",982,653,642,6,11,"EH Bildu",35
31,"31050",6016,3675,3612,41,63,"EH Bildu",1500
1,"1060",204,159,151,0,8,"EH Bildu",14
31,"31265",76,43,40,0,3,"EH Bildu",12
31,"31264",179,91,90,2,1,"EH Bildu",43
31,"31260",1265,817,815,7,2,"EH Bildu",206
1,"1057",235,196,194,0,2,"EH Bildu",59
31,"31158",248,156,151,0,5,"EH Bildu",56
48,"48019",3429,2424,2411,14,13,"EH Bildu",567
31,"31020",435,224,222,1,2,"EH Bildu",147
31,"31098",1984,1443,1428,11,15,"EH Bildu",349
31,"31245",76,51,48,2,3,"EH Bildu",18
31,"31094",105,70,70,1,0,"EH Bildu",9
48,"48028",682,551,548,3,3,"EH Bildu",260
31,"31129",388,239,238,3,1,"EH Bildu",142
20,"20051",6736,4829,4804,22,25,"ELAK/PCTE",3
20,"20027",2761,1866,1861,10,5,"ELAK/PCTE",0
20,"20037",101,69,69,0,0,"ELAK/PCTE",0
20,"20034",3200,2193,2180,8,13,"ELAK/PCTE",2
20,"20055",17300,11784,11725,43,59,"ELAK/PCTE",10
20,"20081",7690,5382,5363,31,19,"ELAK/PCTE",6
20,"20075",4312,2848,2845,8,3,"ELAK/PCTE",2
20,"20077",5269,3845,3830,9,15,"ELAK/PCTE",2
20,"20030",21147,14598,14521,92,77,"ELAK/PCTE",5
20,"20041",241,143,142,2,1,"ELAK/PCTE",0
20,"20020",114,64,64,0,0,"ELAK/PCTE",1
20,"20006",261,154,153,1,1,"ELAK/PCTE",0
20,"20040",15771,10549,10481,54,68,"ELAK/PCTE",9
20,"20066",437,288,286,1,2,"ELAK/PCTE",0
20,"20003",549,360,355,1,5,"ELAK/PCTE",0
20,"20007",337,223,221,2,2,"ELAK/PCTE",0
20,"20056",4077,2796,2781,12,15,"ELAK/PCTE",0
20,"20049",4195,2918,2901,12,17,"ELAK/PCTE",4
20,"20011",1624,1234,1225,3,9,"ELAK/PCTE",1
20,"20043",1718,1189,1183,2,6,"ELAK/PCTE",0
20,"20026",207,172,171,4,1,"ELAK/PCTE",0
20,"20050",275,174,174,2,0,"ELAK/PCTE",0
20,"20036",13208,9102,9056,59,46,"ELAK/PCTE",14
20,"20046",1243,822,816,1,6,"ELAK/PCTE",1
20,"20054",461,294,294,1,0,"ELAK/PCTE",0
20,"20071",15062,10442,10407,47,35,"ELAK/PCTE",3
20,"20013",5433,3906,3893,24,13,"ELAK/PCTE",3
20,"20062",941,688,683,1,5,"ELAK/PCTE",0
20,"20032",8654,6000,5972,21,28,"ELAK/PCTE",2
20,"20058",740,523,522,3,1,"ELAK/PCTE",0
20,"20063",8023,5611,5597,19,14,"ELAK/PCTE",2
20,"20064",12395,7959,7916,42,43,"ELAK/PCTE",10
20,"20072",4762,3175,3153,21,22,"ELAK/PCTE",3
20,"20078",1143,819,816,1,3,"ELAK/PCTE",0
20,"20059",8892,6505,6490,18,15,"ELAK/PCTE",4
20,"20018",11231,7640,7611,33,29,"ELAK/PCTE",2
20,"20074",11520,8379,8357,19,22,"ELAK/PCTE",7
20,"20024",395,245,245,4,0,"ELAK/PCTE",1
20,"20017",8462,5944,5917,11,27,"ELAK/PCTE",1
20,"20044",355,261,261,1,0,"ELAK/PCTE",2
20,"20023",441,254,251,1,3,"ELAK/PCTE",0
20,"20029",4264,3116,3104,14,12,"ELAK/PCTE",0
20,"20048",183,112,112,0,0,"ELAK/PCTE",1
20,"20015",1245,880,876,5,4,"ELAK/PCTE",0
20,"20073",4707,3272,3260,14,12,"ELAK/PCTE",5
20,"20057",198,148,147,1,1,"ELAK/PCTE",0
20,"20906",128,87,87,0,0,"ELAK/PCTE",0
20,"20031",185,113,112,3,1,"ELAK/PCTE",0
20,"20002",359,234,231,7,3,"ELAK/PCTE",0
20,"20042",3180,2056,2053,7,3,"ELAK/PCTE",2
20,"20905",160,123,123,2,0,"ELAK/PCTE",0
20,"20903",5033,3355,3341,18,14,"ELAK/PCTE",1
20,"20022",849,574,571,8,3,"ELAK/PCTE",0
20,"20025",1110,791,788,4,3,"ELAK/PCTE",0
20,"20035",480,361,361,0,0,"ELAK/PCTE",0
20,"20008",713,424,424,5,0,"ELAK/PCTE",0
20,"20076",7013,5011,4991,16,20,"ELAK/PCTE",8
20,"20004",230,133,133,2,0,"ELAK/PCTE",0
20,"20016",1529,887,883,3,4,"ELAK/PCTE",0
20,"20047",455,314,314,1,0,"ELAK/PCTE",0
20,"20902",14282,9670,9618,52,52,"ELAK/PCTE",6
20,"20068",179,119,119,2,0,"ELAK/PCTE",0
20,"20065",2921,1983,1970,16,13,"ELAK/PCTE",1
20,"20009",11369,7402,7355,32,47,"ELAK/PCTE",4
20,"20012",149,104,104,1,0,"ELAK/PCTE",0
20,"20021",185,104,104,2,0,"ELAK/PCTE",0
20,"20039",2126,1623,1618,9,5,"ELAK/PCTE",2
20,"20014",1161,699,693,0,6,"ELAK/PCTE",0
20,"20028",2254,1442,1441,6,1,"ELAK/PCTE",0
20,"20060",87,75,75,0,0,"ELAK/PCTE",0
20,"20052",1050,746,743,4,3,"ELAK/PCTE",0
20,"20901",1399,960,957,3,3,"ELAK/PCTE",1
20,"20019",9892,6740,6717,40,23,"ELAK/PCTE",6
20,"20053",4856,3169,3153,15,16,"ELAK/PCTE",0
20,"20005",1274,822,822,1,0,"ELAK/PCTE",0
20,"20904",87,56,55,1,1,"ELAK/PCTE",0
20,"20045",47031,30933,30787,172,146,"ELAK/PCTE",29
20,"20907",118,82,82,0,0,"ELAK/PCTE",0
20,"20069",147446,102068,101696,564,372,"ELAK/PCTE",76
20,"20079",18151,13106,13054,58,52,"ELAK/PCTE",5
20,"20080",7705,5276,5244,21,32,"ELAK/PCTE",2
20,"20033",858,644,638,1,6,"ELAK/PCTE",0
20,"20010",1524,1057,1053,5,4,"ELAK/PCTE",0
20,"20001",253,163,163,1,0,"ELAK/PCTE",0
20,"20067",30609,20017,19927,111,90,"ELAK/PCTE",20
20,"20038",387,294,293,2,1,"ELAK/PCTE",1
20,"20061",4427,3073,3053,13,20,"ELAK/PCTE",1
20,"20070",1084,798,795,7,3,"ELAK/PCTE",1
43,"43039",101,77,77,0,0,"ERC-SOBIRANISTES",29
25,"25150",167,132,130,2,2,"ERC-SOBIRANISTES",36
17,"17061",180,141,139,1,2,"ERC-SOBIRANISTES",46
43,"43071",896,652,647,3,5,"ERC-SOBIRANISTES",194
43,"43045",143,114,113,0,1,"ERC-SOBIRANISTES",49
8,"8045",65,44,43,0,1,"ERC-SOBIRANISTES",14
17,"17020",3677,2851,2835,14,16,"ERC-SOBIRANISTES",856
17,"17136",196,150,150,0,0,"ERC-SOBIRANISTES",43
8,"8192",5701,4366,4349,15,17,"ERC-SOBIRANISTES",1438
17,"17112",198,148,147,3,1,"ERC-SOBIRANISTES",40
43,"43153",11197,7685,7649,53,36,"ERC-SOBIRANISTES",1983
8,"8023",7029,5027,5000,39,27,"ERC-SOBIRANISTES",1492
17,"17014",66,51,49,0,2,"ERC-SOBIRANISTES",12
8,"8025",1573,1170,1160,9,10,"ERC-SOBIRANISTES",317
25,"25021",2513,1668,1662,17,6,"ERC-SOBIRANISTES",628
25,"25238",212,161,160,0,1,"ERC-SOBIRANISTES",48
17,"17197",128,97,97,0,0,"ERC-SOBIRANISTES",33
8,"8129",486,399,398,0,1,"ERC-SOBIRANISTES",131
17,"17155",14957,9519,9410,71,109,"ERC-SOBIRANISTES",1967
43,"43150",1233,954,941,6,13,"ERC-SOBIRANISTES",370
25,"25192",727,527,524,4,3,"ERC-SOBIRANISTES",167
43,"43142",1069,783,774,3,9,"ERC-SOBIRANISTES",271
8,"8137",272,208,207,2,1,"ERC-SOBIRANISTES",73
8,"8245",77841,53719,53443,430,276,"ERC-SOBIRANISTES",6085
17,"17116",351,261,261,2,0,"ERC-SOBIRANISTES",81
17,"17206",158,111,109,0,2,"ERC-SOBIRANISTES",29
8,"8100",2083,1707,1699,13,8,"ERC-SOBIRANISTES",557
8,"8083",1672,1433,1430,6,3,"ERC-SOBIRANISTES",447
8,"8128",579,428,423,4,5,"ERC-SOBIRANISTES",110
17,"17022",7043,4940,4903,34,37,"ERC-SOBIRANISTES",1500
25,"25012",2349,1563,1556,17,7,"ERC-SOBIRANISTES",469
17,"17146",3150,2243,2224,8,19,"ERC-SOBIRANISTES",629
17,"17224",299,226,222,2,4,"ERC-SOBIRANISTES",54
8,"8146",1384,1030,1027,8,3,"ERC-SOBIRANISTES",261
8,"8086",14137,9971,9912,77,59,"ERC-SOBIRANISTES",2230
8,"8178",444,363,361,2,2,"ERC-SOBIRANISTES",114
25,"25194",410,292,289,3,3,"ERC-SOBIRANISTES",92
8,"8207",2026,1667,1659,12,8,"ERC-SOBIRANISTES",523
25,"25145",75,59,59,0,0,"ERC-SOBIRANISTES",17
17,"17227",147,104,104,0,0,"ERC-SOBIRANISTES",45
25,"25042",204,149,149,5,0,"ERC-SOBIRANISTES",40
25,"25212",219,176,176,1,0,"ERC-SOBIRANISTES",52
25,"25047",956,745,736,14,9,"ERC-SOBIRANISTES",333
25,"25180",227,158,155,1,3,"ERC-SOBIRANISTES",49
8,"8068",6863,5064,5041,40,23,"ERC-SOBIRANISTES",1343
43,"43047",4234,2590,2564,19,26,"ERC-SOBIRANISTES",475
8,"8262",6945,4649,4599,38,50,"ERC-SOBIRANISTES",1293
17,"17078",335,245,245,0,0,"ERC-SOBIRANISTES",81
25,"25207",6443,4525,4492,31,33,"ERC-SOBIRANISTES",1492
25,"25033",1120,838,831,5,7,"ERC-SOBIRANISTES",341
8,"8284",12597,8244,8183,60,61,"ERC-SOBIRANISTES",2055
25,"25004",582,437,432,3,5,"ERC-SOBIRANISTES",158
43,"43013",4406,3004,2975,19,29,"ERC-SOBIRANISTES",1034
8,"8231",21269,14655,14573,111,82,"ERC-SOBIRANISTES",2745
43,"43137",1890,1373,1353,8,20,"ERC-SOBIRANISTES",385
8,"8014",2013,1526,1521,4,5,"ERC-SOBIRANISTES",541
17,"17169",2511,1901,1890,8,11,"ERC-SOBIRANISTES",490
17,"17216",158,122,121,0,1,"ERC-SOBIRANISTES",37
17,"17050",664,554,550,10,4,"ERC-SOBIRANISTES",145
8,"8300",5927,4609,4589,41,20,"ERC-SOBIRANISTES",1109
8,"8214",7007,5390,5371,25,19,"ERC-SOBIRANISTES",1645
8,"8077",34690,25896,25767,164,129,"ERC-SOBIRANISTES",4002
17,"17068",253,191,191,0,0,"ERC-SOBIRANISTES",48
17,"17173",181,143,143,1,0,"ERC-SOBIRANISTES",39
43,"43042",2215,1723,1710,18,13,"ERC-SOBIRANISTES",553
8,"8260",18515,13563,13487,84,76,"ERC-SOBIRANISTES",2391
8,"8060",139,110,108,1,2,"ERC-SOBIRANISTES",21
8,"8032",2100,1472,1465,12,7,"ERC-SOBIRANISTES",434
25,"25114",96,83,82,1,1,"ERC-SOBIRANISTES",23
43,"43034",465,365,365,5,0,"ERC-SOBIRANISTES",143
8,"8151",450,351,346,5,5,"ERC-SOBIRANISTES",115
25,"25003",3717,2577,2561,15,16,"ERC-SOBIRANISTES",928
8,"8308",139,109,109,1,0,"ERC-SOBIRANISTES",18
25,"25141",154,105,104,3,1,"ERC-SOBIRANISTES",25
43,"43010",334,262,262,2,0,"ERC-SOBIRANISTES",73
8,"8063",469,390,390,4,0,"ERC-SOBIRANISTES",153
8,"8070",269,215,211,1,4,"ERC-SOBIRANISTES",73
17,"17143",145,104,104,0,0,"ERC-SOBIRANISTES",44
8,"8290",1549,1254,1248,6,6,"ERC-SOBIRANISTES",416
43,"43147",528,425,420,3,5,"ERC-SOBIRANISTES",170
43,"43160",1324,967,956,6,11,"ERC-SOBIRANISTES",233
25,"25255",390,301,301,0,0,"ERC-SOBIRANISTES",113
25,"25029",1590,1190,1185,4,5,"ERC-SOBIRANISTES",459
17,"17217",350,287,284,0,3,"ERC-SOBIRANISTES",72
8,"8027",724,584,582,1,2,"ERC-SOBIRANISTES",150
17,"17193",4351,2945,2927,21,18,"ERC-SOBIRANISTES",676
43,"43086",5252,3811,3790,28,21,"ERC-SOBIRANISTES",1364
43,"43065",379,281,277,4,4,"ERC-SOBIRANISTES",109
25,"25049",156,110,109,1,1,"ERC-SOBIRANISTES",33
43,"43002",1890,1233,1210,12,23,"ERC-SOBIRANISTES",192
43,"43082",350,276,271,5,5,"ERC-SOBIRANISTES",81
8,"8202",12943,9408,9358,58,50,"ERC-SOBIRANISTES",2448
25,"25079",276,202,202,0,0,"ERC-SOBIRANISTES",70
8,"8069",3323,2555,2540,21,15,"ERC-SOBIRANISTES",810
25,"25041",525,375,370,4,5,"ERC-SOBIRANISTES",149
43,"43057",38,32,32,1,0,"ERC-SOBIRANISTES",5
43,"43115",128,106,106,0,0,"ERC-SOBIRANISTES",34
8,"8078",216,154,154,2,0,"ERC-SOBIRANISTES",62
17,"17130",325,270,270,1,0,"ERC-SOBIRANISTES",77
8,"8253",132,103,102,0,1,"ERC-SOBIRANISTES",40
17,"17023",27314,18677,18546,117,131,"ERC-SOBIRANISTES",3829
25,"25908",217,136,136,0,0,"ERC-SOBIRANISTES",50
43,"43021",349,245,243,2,2,"ERC-SOBIRANISTES",90
8,"8239",467,362,361,3,1,"ERC-SOBIRANISTES",88
43,"43161",17103,11905,11838,82,67,"ERC-SOBIRANISTES",3150
43,"43144",1245,975,966,1,9,"ERC-SOBIRANISTES",287
25,"25911",419,298,297,3,1,"ERC-SOBIRANISTES",97
8,"8285",10349,7630,7599,48,31,"ERC-SOBIRANISTES",2061
17,"17028",297,216,214,2,2,"ERC-SOBIRANISTES",61
8,"8267",6789,4975,4935,41,40,"ERC-SOBIRANISTES",1156
17,"17128",321,239,238,1,1,"ERC-SOBIRANISTES",78
43,"43004",6288,4314,4262,36,52,"ERC-SOBIRANISTES",1664
17,"17205",209,167,166,0,1,"ERC-SOBIRANISTES",57
17,"17171",177,138,137,0,1,"ERC-SOBIRANISTES",40
8,"8269",2729,2114,2105,9,9,"ERC-SOBIRANISTES",764
17,"17056",1780,1379,1374,13,5,"ERC-SOBIRANISTES",351
43,"43100",3557,2666,2649,22,17,"ERC-SOBIRANISTES",599
25,"25057",208,151,149,4,2,"ERC-SOBIRANISTES",28
17,"17114",23268,16423,16333,111,90,"ERC-SOBIRANISTES",4575
17,"17223",808,566,563,1,3,"ERC-SOBIRANISTES",144
17,"17081",252,186,185,2,1,"ERC-SOBIRANISTES",63
25,"25249",176,129,127,2,2,"ERC-SOBIRANISTES",44
17,"17024",281,203,201,4,2,"ERC-SOBIRANISTES",59
8,"8299",380,301,300,4,1,"ERC-SOBIRANISTES",109
8,"8182",2922,2041,2031,10,10,"ERC-SOBIRANISTES",459
8,"8085",986,769,767,6,2,"ERC-SOBIRANISTES",257
8,"8275",247,218,218,3,0,"ERC-SOBIRANISTES",66
43,"43048",768,564,554,7,10,"ERC-SOBIRANISTES",198
25,"25219",146,111,111,1,0,"ERC-SOBIRANISTES",38
25,"25022",105,80,79,0,1,"ERC-SOBIRANISTES",35
25,"25124",160,102,101,1,1,"ERC-SOBIRANISTES",29
25,"25017",228,175,174,0,1,"ERC-SOBIRANISTES",64
25,"25010",194,138,136,0,2,"ERC-SOBIRANISTES",66
43,"43124",468,343,339,3,4,"ERC-SOBIRANISTES",112
8,"8292",1074,796,790,2,6,"ERC-SOBIRANISTES",205
17,"17163",2868,2281,2268,13,13,"ERC-SOBIRANISTES",639
25,"25223",890,673,666,7,7,"ERC-SOBIRANISTES",244
25,"25015",336,234,233,3,1,"ERC-SOBIRANISTES",88
17,"17154",101,76,76,0,0,"ERC-SOBIRANISTES",20
8,"8117",2489,1954,1941,21,13,"ERC-SOBIRANISTES",536
8,"8021",60,44,44,1,0,"ERC-SOBIRANISTES",15
43,"43040",325,268,267,1,1,"ERC-SOBIRANISTES",110
17,"17101",566,389,382,1,7,"ERC-SOBIRANISTES",137
8,"8073",62934,45699,45407,281,292,"ERC-SOBIRANISTES",5876
25,"25142",359,283,283,2,0,"ERC-SOBIRANISTES",96
17,"17052",135,93,92,0,1,"ERC-SOBIRANISTES",34
17,"17181",3458,2454,2443,18,11,"ERC-SOBIRANISTES",664
8,"8136",11692,8527,8456,98,71,"ERC-SOBIRANISTES",1195
17,"17076",119,95,94,2,1,"ERC-SOBIRANISTES",26
17,"17109",704,542,539,2,3,"ERC-SOBIRANISTES",145
25,"25023",4560,3350,3334,24,16,"ERC-SOBIRANISTES",1096
17,"17209",615,472,471,5,1,"ERC-SOBIRANISTES",144
43,"43110",247,178,178,2,0,"ERC-SOBIRANISTES",73
17,"17025",1182,943,938,5,5,"ERC-SOBIRANISTES",237
43,"43120",421,256,254,1,2,"ERC-SOBIRANISTES",62
43,"43077",453,306,304,1,2,"ERC-SOBIRANISTES",80
25,"25011",5271,3529,3505,21,24,"ERC-SOBIRANISTES",1297
8,"8080",40,27,27,3,0,"ERC-SOBIRANISTES",11
8,"8154",697,541,539,3,2,"ERC-SOBIRANISTES",167
43,"43154",126,104,104,0,0,"ERC-SOBIRANISTES",55
17,"17139",1407,1128,1119,8,9,"ERC-SOBIRANISTES",340
8,"8031",2339,1760,1750,15,10,"ERC-SOBIRANISTES",535
8,"8012",1726,1323,1309,17,14,"ERC-SOBIRANISTES",462
17,"17016",737,570,563,2,7,"ERC-SOBIRANISTES",198
17,"17065",321,264,263,3,1,"ERC-SOBIRANISTES",84
8,"8279",156327,112605,112030,952,575,"ERC-SOBIRANISTES",22653
17,"17069",359,270,267,2,3,"ERC-SOBIRANISTES",89
8,"8118",17634,13450,13402,80,48,"ERC-SOBIRANISTES",3785
25,"25247",142,89,89,2,0,"ERC-SOBIRANISTES",12
8,"8237",1644,1263,1254,9,9,"ERC-SOBIRANISTES",409
43,"43027",168,129,129,3,0,"ERC-SOBIRANISTES",42
43,"43030",483,356,351,2,5,"ERC-SOBIRANISTES",112
8,"8097",1103,845,840,4,5,"ERC-SOBIRANISTES",261
17,"17004",529,411,410,3,1,"ERC-SOBIRANISTES",142
25,"25093",629,455,443,5,12,"ERC-SOBIRANISTES",142
17,"17230",504,383,382,3,1,"ERC-SOBIRANISTES",110
17,"17172",452,336,335,5,1,"ERC-SOBIRANISTES",90
8,"8175",3369,2388,2372,18,16,"ERC-SOBIRANISTES",744
43,"43059",250,193,192,1,1,"ERC-SOBIRANISTES",82
25,"25216",244,186,186,0,0,"ERC-SOBIRANISTES",78
25,"25234",4139,2786,2772,13,14,"ERC-SOBIRANISTES",747
25,"25111",114,86,86,2,0,"ERC-SOBIRANISTES",16
25,"25208",337,242,241,2,1,"ERC-SOBIRANISTES",84
17,"17089",5749,3973,3949,17,24,"ERC-SOBIRANISTES",1138
25,"25099",1285,908,904,6,4,"ERC-SOBIRANISTES",324
8,"8091",5428,4048,4024,20,24,"ERC-SOBIRANISTES",1081
43,"43121",593,404,403,1,1,"ERC-SOBIRANISTES",194
43,"43141",109,85,84,0,1,"ERC-SOBIRANISTES",21
17,"17123",343,286,284,2,2,"ERC-SOBIRANISTES",65
8,"8193",988,739,737,10,2,"ERC-SOBIRANISTES",255
17,"17214",714,516,511,6,5,"ERC-SOBIRANISTES",190
17,"17152",11065,6959,6927,68,32,"ERC-SOBIRANISTES",1479
8,"8143",2727,1989,1977,19,12,"ERC-SOBIRANISTES",533
25,"25139",477,348,346,3,2,"ERC-SOBIRANISTES",164
25,"25094",138,96,93,2,3,"ERC-SOBIRANISTES",25
25,"25164",353,259,255,0,4,"ERC-SOBIRANISTES",87
25,"25225",531,395,393,0,2,"ERC-SOBIRANISTES",151
43,"43001",708,510,507,0,3,"ERC-SOBIRANISTES",146
17,"17010",332,252,251,2,1,"ERC-SOBIRANISTES",59
43,"43151",107,88,88,0,0,"ERC-SOBIRANISTES",26
43,"43118",422,338,338,0,0,"ERC-SOBIRANISTES",121
8,"8098",2438,1781,1778,21,3,"ERC-SOBIRANISTES",448
43,"43080",230,192,192,2,0,"ERC-SOBIRANISTES",51
17,"17190",834,624,619,1,5,"ERC-SOBIRANISTES",194
17,"17013",2765,1999,1985,15,14,"ERC-SOBIRANISTES",546
8,"8147",17389,12679,12601,102,78,"ERC-SOBIRANISTES",3053
8,"8264",4608,3459,3444,30,15,"ERC-SOBIRANISTES",865
8,"8005",6425,4830,4816,28,14,"ERC-SOBIRANISTES",1425
8,"8282",6731,5333,5317,40,16,"ERC-SOBIRANISTES",1629
43,"43022",1436,1028,1024,13,4,"ERC-SOBIRANISTES",350
17,"17145",1410,1040,1032,6,8,"ERC-SOBIRANISTES",306
43,"43092",7308,4703,4679,33,24,"ERC-SOBIRANISTES",942
25,"25075",132,101,101,0,0,"ERC-SOBIRANISTES",35
8,"8047",3751,2600,2578,26,22,"ERC-SOBIRANISTES",806
8,"8148",2344,1655,1646,13,9,"ERC-SOBIRANISTES",343
17,"17032",1745,1139,1133,6,6,"ERC-SOBIRANISTES",330
8,"8138",4461,3286,3259,27,27,"ERC-SOBIRANISTES",1143
43,"43007",631,479,474,1,5,"ERC-SOBIRANISTES",163
25,"25050",3256,2260,2249,20,11,"ERC-SOBIRANISTES",915
25,"25110",2745,1943,1927,13,16,"ERC-SOBIRANISTES",630
43,"43085",237,190,185,1,5,"ERC-SOBIRANISTES",66
43,"43167",391,307,307,2,0,"ERC-SOBIRANISTES",107
8,"8046",13541,10510,10455,73,55,"ERC-SOBIRANISTES",2856
8,"8162",2118,1581,1576,13,5,"ERC-SOBIRANISTES",441
8,"8185",197,162,162,1,0,"ERC-SOBIRANISTES",45
17,"17030",654,460,459,1,1,"ERC-SOBIRANISTES",128
43,"43005",3677,2505,2493,17,12,"ERC-SOBIRANISTES",662
17,"17182",269,195,195,0,0,"ERC-SOBIRANISTES",33
8,"8201",455,319,318,12,1,"ERC-SOBIRANISTES",116
43,"43165",571,469,467,2,2,"ERC-SOBIRANISTES",163
8,"8024",357,282,282,2,0,"ERC-SOBIRANISTES",92
8,"8183",4573,3406,3398,14,8,"ERC-SOBIRANISTES",1067
43,"43112",245,179,179,3,0,"ERC-SOBIRANISTES",70
8,"8252",24885,18507,18383,162,124,"ERC-SOBIRANISTES",2932
17,"17210",572,414,411,2,3,"ERC-SOBIRANISTES",121
17,"17099",78,55,55,0,0,"ERC-SOBIRANISTES",10
17,"17204",609,429,428,6,1,"ERC-SOBIRANISTES",109
43,"43106",784,605,598,3,7,"ERC-SOBIRANISTES",221
17,"17185",2260,1657,1652,8,5,"ERC-SOBIRANISTES",523
25,"25062",691,498,491,4,7,"ERC-SOBIRANISTES",198
25,"25105",105,88,87,4,1,"ERC-SOBIRANISTES",35
25,"25206",247,188,188,2,0,"ERC-SOBIRANISTES",82
17,"17038",377,303,301,0,2,"ERC-SOBIRANISTES",95
25,"25068",515,359,358,0,1,"ERC-SOBIRANISTES",117
25,"25138",558,427,424,2,3,"ERC-SOBIRANISTES",181
17,"17106",142,114,114,0,0,"ERC-SOBIRANISTES",44
25,"25910",91,63,63,0,0,"ERC-SOBIRANISTES",21
25,"25167",223,165,164,3,1,"ERC-SOBIRANISTES",39
25,"25200",318,245,245,0,0,"ERC-SOBIRANISTES",117
8,"8042",2390,1772,1764,12,8,"ERC-SOBIRANISTES",467
43,"43104",1767,1285,1271,4,14,"ERC-SOBIRANISTES",551
25,"25220",991,768,762,1,6,"ERC-SOBIRANISTES",238
25,"25244",374,275,270,1,5,"ERC-SOBIRANISTES",89
43,"43068",484,322,317,2,5,"ERC-SOBIRANISTES",93
25,"25113",1114,873,863,3,10,"ERC-SOBIRANISTES",349
43,"43173",98,70,68,0,2,"ERC-SOBIRANISTES",19
17,"17012",1175,845,842,4,3,"ERC-SOBIRANISTES",267
25,"25121",632,380,374,3,6,"ERC-SOBIRANISTES",77
25,"25067",702,500,494,8,6,"ERC-SOBIRANISTES",148
25,"25222",69,58,58,0,0,"ERC-SOBIRANISTES",11
25,"25061",80,51,51,0,0,"ERC-SOBIRANISTES",20
17,"17115",276,208,208,4,0,"ERC-SOBIRANISTES",79
8,"8075",4144,2951,2943,20,8,"ERC-SOBIRANISTES",818
17,"17062",5982,4025,4001,19,24,"ERC-SOBIRANISTES",989
43,"43053",186,135,134,0,1,"ERC-SOBIRANISTES",54
17,"17203",165,126,126,0,0,"ERC-SOBIRANISTES",36
17,"17054",342,250,250,2,0,"ERC-SOBIRANISTES",57
8,"8221",12793,10123,10079,73,44,"ERC-SOBIRANISTES",2339
8,"8255",133,100,100,2,0,"ERC-SOBIRANISTES",22
8,"8090",142,116,116,0,0,"ERC-SOBIRANISTES",39
25,"25233",289,219,218,6,1,"ERC-SOBIRANISTES",76
8,"8232",1773,1368,1362,9,6,"ERC-SOBIRANISTES",466
43,"43032",462,354,350,2,4,"ERC-SOBIRANISTES",119
43,"43089",279,201,201,1,0,"ERC-SOBIRANISTES",50
17,"17075",340,257,256,2,1,"ERC-SOBIRANISTES",100
17,"17120",823,560,558,5,2,"ERC-SOBIRANISTES",193
17,"17188",171,134,134,1,0,"ERC-SOBIRANISTES",35
25,"25076",131,91,91,0,0,"ERC-SOBIRANISTES",37
25,"25098",227,160,158,1,2,"ERC-SOBIRANISTES",56
8,"8218",8091,5899,5869,50,30,"ERC-SOBIRANISTES",1373
8,"8209",6925,4976,4948,39,28,"ERC-SOBIRANISTES",1137
8,"8307",49499,35471,35312,199,159,"ERC-SOBIRANISTES",8217
17,"17161",1023,844,843,5,1,"ERC-SOBIRANISTES",272
8,"8233",1872,1428,1420,15,8,"ERC-SOBIRANISTES",523
43,"43138",2636,1761,1745,11,16,"ERC-SOBIRANISTES",540
8,"8195",75,62,62,0,0,"ERC-SOBIRANISTES",13
43,"43103",908,705,701,9,4,"ERC-SOBIRANISTES",184
43,"43079",364,290,289,2,1,"ERC-SOBIRANISTES",94
43,"43058",95,78,78,0,0,"ERC-SOBIRANISTES",25
17,"17083",2971,2164,2154,13,10,"ERC-SOBIRANISTES",558
17,"17187",625,496,492,3,4,"ERC-SOBIRANISTES",132
43,"43028",2770,1784,1770,7,14,"ERC-SOBIRANISTES",322
8,"8017",2808,2033,2016,16,17,"ERC-SOBIRANISTES",627
17,"17174",164,130,130,4,0,"ERC-SOBIRANISTES",34
17,"17903",883,681,676,3,5,"ERC-SOBIRANISTES",201
8,"8179",636,466,465,2,1,"ERC-SOBIRANISTES",156
17,"17129",143,108,108,2,0,"ERC-SOBIRANISTES",40
8,"8216",25,17,17,0,0,"ERC-SOBIRANISTES",5
17,"17902",1294,992,990,9,2,"ERC-SOBIRANISTES",277
25,"25032",65,53,52,0,1,"ERC-SOBIRANISTES",25
25,"25217",10891,7651,7610,63,41,"ERC-SOBIRANISTES",2476
8,"8254",1766,1433,1427,16,6,"ERC-SOBIRANISTES",513
25,"25133",671,481,479,1,2,"ERC-SOBIRANISTES",160
43,"43031",1447,1085,1072,13,13,"ERC-SOBIRANISTES",364
43,"43135",339,255,255,0,0,"ERC-SOBIRANISTES",84
43,"43073",80,67,65,0,2,"ERC-SOBIRANISTES",21
43,"43019",1332,911,904,8,7,"ERC-SOBIRANISTES",376
8,"8038",1541,1129,1120,6,9,"ERC-SOBIRANISTES",413
25,"25155",616,446,443,2,3,"ERC-SOBIRANISTES",167
17,"17191",163,140,140,1,0,"ERC-SOBIRANISTES",37
8,"8293",227,177,177,0,0,"ERC-SOBIRANISTES",77
17,"17057",968,770,769,7,1,"ERC-SOBIRANISTES",280
25,"25903",226,169,169,1,0,"ERC-SOBIRANISTES",65
43,"43902",2751,1794,1776,21,18,"ERC-SOBIRANISTES",595
43,"43088",2013,1429,1420,11,9,"ERC-SOBIRANISTES",521
25,"25250",327,269,265,1,4,"ERC-SOBIRANISTES",115
43,"43009",1384,966,959,5,7,"ERC-SOBIRANISTES",284
43,"43136",10489,7029,6996,47,33,"ERC-SOBIRANISTES",2649
8,"8224",885,653,652,6,1,"ERC-SOBIRANISTES",193
17,"17121",225,166,163,2,3,"ERC-SOBIRANISTES",55
43,"43083",146,110,109,0,1,"ERC-SOBIRANISTES",21
8,"8108",5181,3880,3861,30,19,"ERC-SOBIRANISTES",894
8,"8130",110,81,81,2,0,"ERC-SOBIRANISTES",28
25,"25069",426,296,294,0,2,"ERC-SOBIRANISTES",146
8,"8304",822,655,655,5,0,"ERC-SOBIRANISTES",273
17,"17046",709,537,531,2,6,"ERC-SOBIRANISTES",200
8,"8051",18570,14112,14054,86,58,"ERC-SOBIRANISTES",3676
8,"8011",1739,1360,1353,10,7,"ERC-SOBIRANISTES",499
25,"25191",321,227,222,2,5,"ERC-SOBIRANISTES",67
43,"43143",50,40,39,0,1,"ERC-SOBIRANISTES",15
8,"8095",66,49,49,0,0,"ERC-SOBIRANISTES",18
8,"8171",2046,1520,1510,13,10,"ERC-SOBIRANISTES",473
43,"43901",8796,5431,5390,41,41,"ERC-SOBIRANISTES",2149
25,"25149",1377,1034,1028,9,6,"ERC-SOBIRANISTES",362
43,"43123",71435,49166,48873,318,293,"ERC-SOBIRANISTES",10844
17,"17084",228,163,162,1,1,"ERC-SOBIRANISTES",58
8,"8072",10769,7632,7600,56,32,"ERC-SOBIRANISTES",2175
25,"25024",352,248,247,0,1,"ERC-SOBIRANISTES",103
17,"17007",1763,1367,1359,9,8,"ERC-SOBIRANISTES",278
8,"8007",6795,5099,5081,29,18,"ERC-SOBIRANISTES",1773
43,"43095",2583,1864,1854,12,10,"ERC-SOBIRANISTES",520
25,"25136",95,74,74,2,0,"ERC-SOBIRANISTES",14
25,"25127",217,145,145,1,0,"ERC-SOBIRANISTES",64
25,"25044",178,144,142,0,2,"ERC-SOBIRANISTES",28
8,"8064",1956,1439,1423,7,16,"ERC-SOBIRANISTES",467
25,"25125",383,265,265,3,0,"ERC-SOBIRANISTES",116
43,"43094",2143,1558,1541,6,17,"ERC-SOBIRANISTES",612
8,"8234",3443,2561,2550,15,11,"ERC-SOBIRANISTES",770
8,"8066",1466,1109,1104,7,5,"ERC-SOBIRANISTES",299
8,"8250",7235,4917,4876,41,41,"ERC-SOBIRANISTES",801
25,"25060",71,42,42,0,0,"ERC-SOBIRANISTES",11
43,"43099",284,214,214,4,0,"ERC-SOBIRANISTES",83
43,"43093",3863,2728,2716,22,12,"ERC-SOBIRANISTES",900
17,"17088",599,467,465,3,2,"ERC-SOBIRANISTES",177
43,"43905",15100,9689,9630,43,59,"ERC-SOBIRANISTES",1551
25,"25031",57,32,32,0,0,"ERC-SOBIRANISTES",5
25,"25129",161,113,112,0,1,"ERC-SOBIRANISTES",40
43,"43130",169,131,130,2,1,"ERC-SOBIRANISTES",53
8,"8184",55053,38519,38323,298,196,"ERC-SOBIRANISTES",6897
25,"25242",688,494,488,5,6,"ERC-SOBIRANISTES",162
8,"8277",168,148,146,1,2,"ERC-SOBIRANISTES",43
8,"8110",13671,9362,9311,60,51,"ERC-SOBIRANISTES",2195
25,"25104",120,88,88,0,0,"ERC-SOBIRANISTES",23
25,"25248",870,676,675,5,1,"ERC-SOBIRANISTES",267
17,"17058",176,128,128,0,0,"ERC-SOBIRANISTES",27
25,"25101",536,412,411,5,1,"ERC-SOBIRANISTES",159
8,"8286",2943,2051,2042,12,9,"ERC-SOBIRANISTES",430
43,"43064",2027,1456,1445,19,11,"ERC-SOBIRANISTES",479
43,"43164",310,235,231,3,4,"ERC-SOBIRANISTES",35
43,"43044",3962,2751,2719,33,32,"ERC-SOBIRANISTES",730
8,"8158",3094,2261,2251,11,10,"ERC-SOBIRANISTES",625
43,"43156",3956,2812,2784,22,28,"ERC-SOBIRANISTES",807
8,"8296",1869,1412,1408,10,4,"ERC-SOBIRANISTES",442
8,"8036",163,122,122,0,0,"ERC-SOBIRANISTES",46
25,"25043",800,584,581,2,3,"ERC-SOBIRANISTES",256
8,"8241",70,52,52,0,0,"ERC-SOBIRANISTES",13
43,"43116",465,356,352,0,4,"ERC-SOBIRANISTES",149
43,"43054",2807,1972,1957,14,15,"ERC-SOBIRANISTES",836
8,"8166",964,700,697,7,3,"ERC-SOBIRANISTES",222
8,"8191",5302,3872,3860,21,12,"ERC-SOBIRANISTES",1024
25,"25907",500,366,364,5,2,"ERC-SOBIRANISTES",150
8,"8121",87515,62961,62574,429,387,"ERC-SOBIRANISTES",12769
43,"43062",269,229,226,5,3,"ERC-SOBIRANISTES",61
25,"25009",596,448,442,1,6,"ERC-SOBIRANISTES",175
17,"17055",142,124,124,0,0,"ERC-SOBIRANISTES",41
17,"17001",575,428,426,4,2,"ERC-SOBIRANISTES",172
8,"8905",2329,1872,1863,7,9,"ERC-SOBIRANISTES",574
8,"8159",14343,10656,10603,87,53,"ERC-SOBIRANISTES",2521
17,"17124",1593,1163,1160,8,3,"ERC-SOBIRANISTES",359
25,"25039",259,197,196,7,1,"ERC-SOBIRANISTES",56
8,"8010",4224,3109,3090,22,19,"ERC-SOBIRANISTES",959
8,"8217",25466,19864,19773,129,91,"ERC-SOBIRANISTES",3359
43,"43171",14849,10140,10081,76,59,"ERC-SOBIRANISTES",1317
8,"8132",356,265,265,1,0,"ERC-SOBIRANISTES",69
43,"43023",211,171,169,2,2,"ERC-SOBIRANISTES",72
8,"8139",172,148,147,2,1,"ERC-SOBIRANISTES",55
25,"25025",1362,909,898,15,11,"ERC-SOBIRANISTES",153
43,"43107",387,285,285,3,0,"ERC-SOBIRANISTES",146
8,"8131",745,552,550,3,2,"ERC-SOBIRANISTES",193
25,"25182",1043,763,760,8,3,"ERC-SOBIRANISTES",233
25,"25040",10651,7041,6987,57,54,"ERC-SOBIRANISTES",2281
17,"17162",153,106,105,1,1,"ERC-SOBIRANISTES",27
17,"17226",884,603,600,4,3,"ERC-SOBIRANISTES",130
25,"25135",997,675,671,3,4,"ERC-SOBIRANISTES",242
8,"8034",820,644,640,0,4,"ERC-SOBIRANISTES",197
8,"8294",2093,1546,1534,11,12,"ERC-SOBIRANISTES",482
25,"25179",169,132,132,0,0,"ERC-SOBIRANISTES",47
43,"43903",2332,1502,1487,18,15,"ERC-SOBIRANISTES",671
8,"8120",7129,5649,5621,51,28,"ERC-SOBIRANISTES",1398
8,"8187",153822,113081,112470,758,611,"ERC-SOBIRANISTES",22211
25,"25071",41,31,30,0,1,"ERC-SOBIRANISTES",14
8,"8049",1309,910,903,3,7,"ERC-SOBIRANISTES",274
17,"17196",252,200,200,1,0,"ERC-SOBIRANISTES",57
17,"17141",6019,3855,3833,43,22,"ERC-SOBIRANISTES",1073
8,"8198",4679,3491,3469,12,22,"ERC-SOBIRANISTES",1083
17,"17142",2713,2166,2159,18,7,"ERC-SOBIRANISTES",595
25,"25175",173,119,119,2,0,"ERC-SOBIRANISTES",41
43,"43178",1435,1071,1066,2,5,"ERC-SOBIRANISTES",316
17,"17105",248,187,186,2,1,"ERC-SOBIRANISTES",60
43,"43033",766,555,555,4,0,"ERC-SOBIRANISTES",226
43,"43056",803,566,558,6,8,"ERC-SOBIRANISTES",267
43,"43074",1818,1341,1336,2,5,"ERC-SOBIRANISTES",439
8,"8004",208,177,177,1,0,"ERC-SOBIRANISTES",45
43,"43170",877,664,661,4,3,"ERC-SOBIRANISTES",242
8,"8040",11116,7923,7891,49,32,"ERC-SOBIRANISTES",2287
17,"17208",978,723,719,6,4,"ERC-SOBIRANISTES",213
43,"43109",2706,1751,1738,17,13,"ERC-SOBIRANISTES",331
25,"25156",765,571,567,3,4,"ERC-SOBIRANISTES",207
8,"8278",4925,3820,3804,22,16,"ERC-SOBIRANISTES",1193
17,"17126",316,269,269,1,0,"ERC-SOBIRANISTES",98
17,"17087",219,179,177,0,2,"ERC-SOBIRANISTES",54
25,"25038",1478,1057,1048,10,9,"ERC-SOBIRANISTES",313
8,"8099",753,529,529,4,0,"ERC-SOBIRANISTES",154
17,"17110",1332,990,981,3,9,"ERC-SOBIRANISTES",223
25,"25210",1073,791,780,3,11,"ERC-SOBIRANISTES",301
8,"8058",1808,1280,1262,6,18,"ERC-SOBIRANISTES",322
8,"8268",975,729,723,6,6,"ERC-SOBIRANISTES",245
8,"8119",6897,5096,5052,31,44,"ERC-SOBIRANISTES",1164
8,"8273",2390,1871,1855,14,16,"ERC-SOBIRANISTES",605
8,"8062",1009,778,776,9,2,"ERC-SOBIRANISTES",258
17,"17100",193,147,141,0,6,"ERC-SOBIRANISTES",45
17,"17015",12829,9612,9580,51,32,"ERC-SOBIRANISTES",2913
8,"8213",6600,4925,4906,30,19,"ERC-SOBIRANISTES",1416
8,"8059",340,255,250,1,5,"ERC-SOBIRANISTES",98
8,"8258",815,636,632,5,4,"ERC-SOBIRANISTES",243
8,"8289",4473,3379,3371,25,8,"ERC-SOBIRANISTES",1125
8,"8168",388,280,279,3,1,"ERC-SOBIRANISTES",55
25,"25008",1081,803,799,4,4,"ERC-SOBIRANISTES",325
25,"25002",465,324,323,4,1,"ERC-SOBIRANISTES",114
43,"43097",407,331,328,4,3,"ERC-SOBIRANISTES",110
8,"8274",4640,3385,3363,24,22,"ERC-SOBIRANISTES",827
8,"8251",5130,3719,3698,20,21,"ERC-SOBIRANISTES",941
8,"8048",580,427,426,1,1,"ERC-SOBIRANISTES",185
43,"43018",384,297,297,2,0,"ERC-SOBIRANISTES",104
8,"8041",10698,7324,7258,57,66,"ERC-SOBIRANISTES",949
25,"25052",1541,1183,1176,7,7,"ERC-SOBIRANISTES",516
17,"17151",179,131,130,0,1,"ERC-SOBIRANISTES",50
17,"17166",547,442,440,0,2,"ERC-SOBIRANISTES",135
17,"17211",837,677,674,6,3,"ERC-SOBIRANISTES",183
17,"17234",181,129,129,1,0,"ERC-SOBIRANISTES",44
8,"8163",19672,13421,13364,70,57,"ERC-SOBIRANISTES",2914
25,"25186",207,162,161,0,1,"ERC-SOBIRANISTES",44
8,"8133",123,96,94,5,2,"ERC-SOBIRANISTES",23
25,"25118",326,223,218,0,5,"ERC-SOBIRANISTES",63
25,"25189",2181,1468,1461,11,7,"ERC-SOBIRANISTES",474
8,"8257",103,82,82,0,0,"ERC-SOBIRANISTES",19
17,"17043",165,133,133,0,0,"ERC-SOBIRANISTES",35
25,"25161",339,221,221,0,0,"ERC-SOBIRANISTES",86
17,"17167",2585,2015,1998,11,17,"ERC-SOBIRANISTES",660
8,"8288",1696,1103,1096,9,7,"ERC-SOBIRANISTES",285
25,"25007",1378,1010,999,12,11,"ERC-SOBIRANISTES",328
17,"17164",3918,2856,2838,17,18,"ERC-SOBIRANISTES",877
25,"25226",236,156,155,0,1,"ERC-SOBIRANISTES",65
17,"17901",987,733,725,5,8,"ERC-SOBIRANISTES",221
25,"25165",271,210,208,0,2,"ERC-SOBIRANISTES",73
25,"25143",82,63,62,0,1,"ERC-SOBIRANISTES",25
8,"8109",207,176,174,0,2,"ERC-SOBIRANISTES",50
25,"25120",92888,62740,62389,450,351,"ERC-SOBIRANISTES",16188
17,"17035",544,447,447,2,0,"ERC-SOBIRANISTES",157
17,"17011",645,518,514,10,4,"ERC-SOBIRANISTES",177
17,"17103",5057,3196,3174,21,22,"ERC-SOBIRANISTES",698
8,"8236",1564,1145,1133,4,12,"ERC-SOBIRANISTES",433
25,"25152",148,106,106,0,0,"ERC-SOBIRANISTES",35
25,"25205",563,412,407,3,5,"ERC-SOBIRANISTES",130
8,"8092",3713,2758,2745,9,13,"ERC-SOBIRANISTES",839
17,"17207",2420,1920,1901,9,19,"ERC-SOBIRANISTES",626
17,"17192",143,107,104,0,3,"ERC-SOBIRANISTES",23
17,"17144",211,162,159,3,3,"ERC-SOBIRANISTES",53
17,"17051",202,161,160,0,1,"ERC-SOBIRANISTES",39
25,"25151",731,555,549,1,6,"ERC-SOBIRANISTES",177
8,"8013",1287,982,972,6,10,"ERC-SOBIRANISTES",275
25,"25013",2099,1430,1414,13,16,"ERC-SOBIRANISTES",421
8,"8197",7986,5829,5805,37,24,"ERC-SOBIRANISTES",1649
43,"43035",233,182,182,5,0,"ERC-SOBIRANISTES",61
25,"25056",209,145,145,0,0,"ERC-SOBIRANISTES",57
17,"17147",7916,5672,5641,41,31,"ERC-SOBIRANISTES",1585
17,"17184",1261,1016,1010,7,6,"ERC-SOBIRANISTES",349
17,"17019",1780,1403,1393,5,10,"ERC-SOBIRANISTES",417
25,"25019",4606,2860,2829,19,31,"ERC-SOBIRANISTES",778
8,"8116",557,449,449,1,0,"ERC-SOBIRANISTES",143
8,"8067",5746,4299,4270,24,29,"ERC-SOBIRANISTES",1338
25,"25254",704,511,508,2,3,"ERC-SOBIRANISTES",181
25,"25158",1605,1193,1180,8,13,"ERC-SOBIRANISTES",450
25,"25902",536,406,403,1,3,"ERC-SOBIRANISTES",138
43,"43168",83,55,55,1,0,"ERC-SOBIRANISTES",25
8,"8161",11826,8001,7951,58,50,"ERC-SOBIRANISTES",1876
8,"8298",27148,19655,19568,102,87,"ERC-SOBIRANISTES",5148
8,"8247",982,799,798,4,1,"ERC-SOBIRANISTES",276
8,"8305",27661,20346,20221,118,125,"ERC-SOBIRANISTES",5364
8,"8053",2896,1939,1929,13,10,"ERC-SOBIRANISTES",541
43,"43159",76,60,60,0,0,"ERC-SOBIRANISTES",17
43,"43133",5627,3794,3773,31,21,"ERC-SOBIRANISTES",1317
8,"8055",542,426,424,3,2,"ERC-SOBIRANISTES",159
17,"17232",146,111,111,0,0,"ERC-SOBIRANISTES",40
17,"17221",4138,2999,2988,23,11,"ERC-SOBIRANISTES",780
25,"25036",180,124,124,1,0,"ERC-SOBIRANISTES",34
43,"43026",756,576,574,1,2,"ERC-SOBIRANISTES",248
43,"43117",147,119,119,0,0,"ERC-SOBIRANISTES",28
43,"43169",445,388,388,3,0,"ERC-SOBIRANISTES",159
8,"8015",156540,109145,108440,957,705,"ERC-SOBIRANISTES",18569
8,"8145",2712,2060,2049,8,11,"ERC-SOBIRANISTES",554
8,"8107",11965,8604,8554,67,50,"ERC-SOBIRANISTES",1842
8,"8190",255,184,182,1,2,"ERC-SOBIRANISTES",67
8,"8026",195,148,146,0,2,"ERC-SOBIRANISTES",39
17,"17098",308,232,230,4,2,"ERC-SOBIRANISTES",70
25,"25169",170,117,117,5,0,"ERC-SOBIRANISTES",35
25,"25197",140,109,109,0,0,"ERC-SOBIRANISTES",42
43,"43061",40,27,27,3,0,"ERC-SOBIRANISTES",8
25,"25014",246,184,178,0,6,"ERC-SOBIRANISTES",82
8,"8266",43422,32827,32696,241,131,"ERC-SOBIRANISTES",6069
8,"8150",258,207,207,1,0,"ERC-SOBIRANISTES",61
43,"43006",676,462,462,3,0,"ERC-SOBIRANISTES",179
43,"43119",849,591,588,8,3,"ERC-SOBIRANISTES",172
8,"8008",175,136,136,2,0,"ERC-SOBIRANISTES",42
43,"43158",74,52,50,0,2,"ERC-SOBIRANISTES",16
8,"8029",3586,2868,2862,20,6,"ERC-SOBIRANISTES",824
25,"25913",88,72,72,1,0,"ERC-SOBIRANISTES",32
43,"43155",22586,15295,15204,120,91,"ERC-SOBIRANISTES",4552
25,"25905",366,281,276,4,5,"ERC-SOBIRANISTES",93
25,"25096",885,597,591,2,6,"ERC-SOBIRANISTES",240
25,"25092",125,93,92,0,1,"ERC-SOBIRANISTES",32
17,"17031",178,117,117,0,0,"ERC-SOBIRANISTES",37
8,"8287",1067,853,844,4,9,"ERC-SOBIRANISTES",307
25,"25070",817,619,617,11,2,"ERC-SOBIRANISTES",233
8,"8126",8906,6673,6646,41,27,"ERC-SOBIRANISTES",1655
43,"43162",4436,3191,3163,24,28,"ERC-SOBIRANISTES",704
17,"17063",179,153,149,0,4,"ERC-SOBIRANISTES",54
8,"8141",4578,3369,3357,28,12,"ERC-SOBIRANISTES",931
25,"25153",190,139,136,0,3,"ERC-SOBIRANISTES",42
8,"8270",19014,13635,13594,74,41,"ERC-SOBIRANISTES",3174
25,"25196",108,75,75,1,0,"ERC-SOBIRANISTES",21
17,"17183",253,197,197,2,0,"ERC-SOBIRANISTES",50
25,"25030",117,76,76,0,0,"ERC-SOBIRANISTES",29
25,"25088",96,73,73,0,0,"ERC-SOBIRANISTES",21
8,"8240",9469,7351,7327,39,24,"ERC-SOBIRANISTES",2165
43,"43145",4209,3193,3170,17,23,"ERC-SOBIRANISTES",879
17,"17180",8508,5977,5953,38,24,"ERC-SOBIRANISTES",1598
17,"17107",267,207,205,2,2,"ERC-SOBIRANISTES",53
17,"17074",536,403,401,1,2,"ERC-SOBIRANISTES",139
43,"43012",3700,2882,2858,20,24,"ERC-SOBIRANISTES",762
17,"17008",3605,2595,2577,8,18,"ERC-SOBIRANISTES",602
17,"17153",189,150,149,1,1,"ERC-SOBIRANISTES",46
43,"43055",1970,1548,1535,12,13,"ERC-SOBIRANISTES",562
43,"43132",375,295,291,1,4,"ERC-SOBIRANISTES",114
8,"8243",154,125,125,2,0,"ERC-SOBIRANISTES",49
25,"25123",189,135,133,0,2,"ERC-SOBIRANISTES",53
25,"25211",680,470,470,3,0,"ERC-SOBIRANISTES",220
43,"43108",1787,1293,1282,6,11,"ERC-SOBIRANISTES",336
25,"25177",356,252,250,1,2,"ERC-SOBIRANISTES",89
8,"8003",7213,5425,5409,41,16,"ERC-SOBIRANISTES",1545
25,"25081",281,195,193,3,2,"ERC-SOBIRANISTES",72
25,"25202",108,72,72,2,0,"ERC-SOBIRANISTES",22
43,"43128",910,665,658,6,7,"ERC-SOBIRANISTES",233
25,"25190",262,202,202,2,0,"ERC-SOBIRANISTES",69
43,"43149",690,512,509,3,3,"ERC-SOBIRANISTES",165
8,"8127",2254,1548,1544,10,4,"ERC-SOBIRANISTES",398
8,"8037",1947,1547,1543,11,4,"ERC-SOBIRANISTES",490
8,"8001",9097,6860,6818,39,42,"ERC-SOBIRANISTES",1111
25,"25130",181,130,128,0,2,"ERC-SOBIRANISTES",40
25,"25203",8809,5813,5770,40,43,"ERC-SOBIRANISTES",1739
17,"17034",7289,4880,4862,23,18,"ERC-SOBIRANISTES",1283
8,"8088",12347,9316,9270,75,46,"ERC-SOBIRANISTES",2701
8,"8019",1122912,824423,821037,5287,3386,"ERC-SOBIRANISTES",172149
25,"25035",364,257,256,0,1,"ERC-SOBIRANISTES",93
43,"43101",146,112,112,2,0,"ERC-SOBIRANISTES",27
17,"17090",539,440,440,2,0,"ERC-SOBIRANISTES",115
17,"17093",913,637,634,5,3,"ERC-SOBIRANISTES",242
17,"17102",556,398,396,1,2,"ERC-SOBIRANISTES",158
8,"8189",119,96,96,1,0,"ERC-SOBIRANISTES",31
25,"25906",205,133,131,2,2,"ERC-SOBIRANISTES",61
8,"8111",216,195,194,2,1,"ERC-SOBIRANISTES",46
8,"8194",25680,16465,16376,131,89,"ERC-SOBIRANISTES",2441
17,"17079",65572,47740,47502,279,238,"ERC-SOBIRANISTES",10130
25,"25045",57,26,26,2,0,"ERC-SOBIRANISTES",6
8,"8227",2420,1775,1769,11,6,"ERC-SOBIRANISTES",563
25,"25115",803,601,593,4,8,"ERC-SOBIRANISTES",197
8,"8028",1125,744,743,7,1,"ERC-SOBIRANISTES",155
25,"25074",179,155,151,2,4,"ERC-SOBIRANISTES",68
8,"8089",34190,24548,24404,194,144,"ERC-SOBIRANISTES",4209
43,"43091",125,90,90,1,0,"ERC-SOBIRANISTES",27
25,"25148",224,158,158,0,0,"ERC-SOBIRANISTES",44
17,"17133",1262,976,964,7,12,"ERC-SOBIRANISTES",223
8,"8084",1172,902,894,9,8,"ERC-SOBIRANISTES",282
17,"17049",3246,2527,2502,12,25,"ERC-SOBIRANISTES",665
43,"43015",115,92,91,1,1,"ERC-SOBIRANISTES",35
17,"17039",1726,1306,1297,7,9,"ERC-SOBIRANISTES",336
8,"8170",442,322,320,0,2,"ERC-SOBIRANISTES",96
8,"8054",9215,6994,6943,38,51,"ERC-SOBIRANISTES",1550
43,"43084",514,388,383,2,5,"ERC-SOBIRANISTES",184
25,"25137",8684,5802,5757,48,45,"ERC-SOBIRANISTES",1721
8,"8230",7648,5797,5774,40,23,"ERC-SOBIRANISTES",1363
25,"25086",525,410,407,3,3,"ERC-SOBIRANISTES",168
25,"25134",605,457,456,5,1,"ERC-SOBIRANISTES",181
43,"43070",243,194,193,0,1,"ERC-SOBIRANISTES",90
25,"25174",390,312,312,1,0,"ERC-SOBIRANISTES",114
8,"8302",9359,6483,6430,78,53,"ERC-SOBIRANISTES",1043
8,"8156",11254,8440,8411,58,29,"ERC-SOBIRANISTES",2138
17,"17042",410,299,297,5,2,"ERC-SOBIRANISTES",87
25,"25059",800,546,534,5,12,"ERC-SOBIRANISTES",80
25,"25170",262,210,210,1,0,"ERC-SOBIRANISTES",81
8,"8044",4156,2991,2976,16,15,"ERC-SOBIRANISTES",774
43,"43050",2695,1742,1730,10,12,"ERC-SOBIRANISTES",351
8,"8153",573,457,452,3,5,"ERC-SOBIRANISTES",153
8,"8295",11290,8091,8054,72,37,"ERC-SOBIRANISTES",1746
25,"25173",1646,1180,1169,6,11,"ERC-SOBIRANISTES",285
43,"43127",775,607,606,3,1,"ERC-SOBIRANISTES",219
17,"17040",551,440,439,5,1,"ERC-SOBIRANISTES",126
8,"8009",9531,7200,7171,47,29,"ERC-SOBIRANISTES",1870
25,"25245",427,312,308,4,4,"ERC-SOBIRANISTES",86
25,"25103",133,88,87,0,1,"ERC-SOBIRANISTES",33
43,"43907",4386,3083,3067,24,16,"ERC-SOBIRANISTES",388
25,"25131",394,281,279,3,2,"ERC-SOBIRANISTES",129
17,"17186",3834,2980,2954,17,26,"ERC-SOBIRANISTES",775
43,"43037",18216,11749,11672,70,77,"ERC-SOBIRANISTES",2426
8,"8106",7500,5442,5410,43,32,"ERC-SOBIRANISTES",1595
8,"8235",3875,3004,2996,19,8,"ERC-SOBIRANISTES",991
17,"17002",578,477,474,2,3,"ERC-SOBIRANISTES",115
8,"8222",1821,1439,1424,7,15,"ERC-SOBIRANISTES",430
43,"43038",22070,15127,15018,113,109,"ERC-SOBIRANISTES",3231
25,"25037",361,270,269,4,1,"ERC-SOBIRANISTES",90
25,"25077",435,312,312,1,0,"ERC-SOBIRANISTES",111
25,"25224",122,94,94,0,0,"ERC-SOBIRANISTES",44
25,"25157",159,127,126,1,1,"ERC-SOBIRANISTES",34
25,"25240",1366,1030,1021,4,9,"ERC-SOBIRANISTES",324
25,"25253",147,118,117,0,1,"ERC-SOBIRANISTES",51
8,"8140",4816,3541,3520,25,21,"ERC-SOBIRANISTES",1033
43,"43114",370,281,278,1,3,"ERC-SOBIRANISTES",112
43,"43172",334,248,243,4,5,"ERC-SOBIRANISTES",91
17,"17160",14756,9892,9852,58,40,"ERC-SOBIRANISTES",2274
17,"17125",136,100,100,3,0,"ERC-SOBIRANISTES",26
17,"17080",144,113,113,1,0,"ERC-SOBIRANISTES",38
8,"8276",241,179,179,3,0,"ERC-SOBIRANISTES",60
43,"43166",1646,1183,1176,4,7,"ERC-SOBIRANISTES",359
8,"8056",42897,30873,30757,259,116,"ERC-SOBIRANISTES",5304
8,"8079",333,260,258,2,2,"ERC-SOBIRANISTES",113
43,"43067",526,426,424,3,2,"ERC-SOBIRANISTES",217
25,"25232",1357,1012,1007,6,5,"ERC-SOBIRANISTES",272
17,"17178",1065,774,771,9,3,"ERC-SOBIRANISTES",269
17,"17148",1550,1121,1114,15,7,"ERC-SOBIRANISTES",241
25,"25228",3143,2261,2250,18,11,"ERC-SOBIRANISTES",775
17,"17071",1134,943,940,1,3,"ERC-SOBIRANISTES",330
43,"43036",869,565,557,7,8,"ERC-SOBIRANISTES",111
17,"17175",559,348,343,5,5,"ERC-SOBIRANISTES",75
8,"8177",36,27,27,1,0,"ERC-SOBIRANISTES",12
8,"8204",3141,2395,2383,16,12,"ERC-SOBIRANISTES",643
25,"25251",708,526,524,1,2,"ERC-SOBIRANISTES",204
43,"43025",591,448,443,4,5,"ERC-SOBIRANISTES",169
43,"43096",97,76,76,0,0,"ERC-SOBIRANISTES",25
25,"25243",3729,2370,2349,33,21,"ERC-SOBIRANISTES",362
8,"8149",980,702,694,6,8,"ERC-SOBIRANISTES",229
8,"8123",19570,15378,15316,91,62,"ERC-SOBIRANISTES",4145
17,"17096",159,116,116,3,0,"ERC-SOBIRANISTES",37
8,"8093",25,22,22,0,0,"ERC-SOBIRANISTES",13
43,"43174",144,118,114,0,4,"ERC-SOBIRANISTES",44
43,"43043",3317,2457,2445,12,12,"ERC-SOBIRANISTES",577
25,"25119",2258,1701,1686,11,15,"ERC-SOBIRANISTES",671
43,"43102",458,331,324,2,7,"ERC-SOBIRANISTES",127
8,"8220",2411,2010,2001,8,9,"ERC-SOBIRANISTES",631
25,"25154",117,86,85,0,1,"ERC-SOBIRANISTES",26
8,"8261",2405,1726,1718,11,8,"ERC-SOBIRANISTES",451
17,"17027",2857,2236,2229,9,7,"ERC-SOBIRANISTES",825
8,"8205",61957,49325,49196,441,129,"ERC-SOBIRANISTES",11480
25,"25193",768,567,563,4,4,"ERC-SOBIRANISTES",163
8,"8259",6979,5362,5341,27,21,"ERC-SOBIRANISTES",1475
43,"43126",1230,937,933,3,4,"ERC-SOBIRANISTES",277
17,"17213",5567,3654,3630,19,24,"ERC-SOBIRANISTES",810
25,"25172",1762,1332,1323,8,9,"ERC-SOBIRANISTES",489
17,"17111",984,728,728,7,0,"ERC-SOBIRANISTES",216
25,"25058",4345,3058,3045,13,13,"ERC-SOBIRANISTES",1079
17,"17041",217,150,146,1,4,"ERC-SOBIRANISTES",70
25,"25231",483,387,385,0,2,"ERC-SOBIRANISTES",177
8,"8301",49348,36261,36045,292,216,"ERC-SOBIRANISTES",4774
25,"25163",230,162,161,0,1,"ERC-SOBIRANISTES",68
43,"43163",26162,17276,17128,98,148,"ERC-SOBIRANISTES",3515
43,"43111",2129,1412,1401,8,11,"ERC-SOBIRANISTES",348
8,"8101",175048,121359,120620,830,739,"ERC-SOBIRANISTES",16656
43,"43066",158,108,108,1,0,"ERC-SOBIRANISTES",37
17,"17157",122,104,103,0,1,"ERC-SOBIRANISTES",20
8,"8052",140,102,102,1,0,"ERC-SOBIRANISTES",23
43,"43906",2113,1490,1480,12,10,"ERC-SOBIRANISTES",401
8,"8229",521,418,417,3,1,"ERC-SOBIRANISTES",142
25,"25073",559,377,377,2,0,"ERC-SOBIRANISTES",176
25,"25006",319,229,229,2,0,"ERC-SOBIRANISTES",76
8,"8226",929,748,747,10,1,"ERC-SOBIRANISTES",284
8,"8115",3826,2777,2770,31,7,"ERC-SOBIRANISTES",658
8,"8039",413,322,321,1,1,"ERC-SOBIRANISTES",93
8,"8246",1692,1345,1340,7,5,"ERC-SOBIRANISTES",460
17,"17037",112,86,86,1,0,"ERC-SOBIRANISTES",21
8,"8206",744,604,599,5,5,"ERC-SOBIRANISTES",223
17,"17066",27378,16755,16644,122,111,"ERC-SOBIRANISTES",3760
8,"8219",15755,12235,12206,72,29,"ERC-SOBIRANISTES",3478
43,"43131",4827,3134,3116,32,18,"ERC-SOBIRANISTES",577
8,"8113",52589,36864,36690,244,174,"ERC-SOBIRANISTES",9964
17,"17176",128,111,111,0,0,"ERC-SOBIRANISTES",26
43,"43098",362,274,274,1,0,"ERC-SOBIRANISTES",66
43,"43176",746,564,561,2,3,"ERC-SOBIRANISTES",236
17,"17194",73,56,56,0,0,"ERC-SOBIRANISTES",22
17,"17067",704,551,549,6,2,"ERC-SOBIRANISTES",171
8,"8135",6770,5187,5158,42,29,"ERC-SOBIRANISTES",821
43,"43020",2291,1712,1688,19,24,"ERC-SOBIRANISTES",343
17,"17135",393,307,303,0,4,"ERC-SOBIRANISTES",97
17,"17233",2347,1853,1840,11,13,"ERC-SOBIRANISTES",473
8,"8238",14946,11911,11873,85,38,"ERC-SOBIRANISTES",3274
25,"25904",160,134,133,2,1,"ERC-SOBIRANISTES",28
8,"8122",1733,1179,1175,4,4,"ERC-SOBIRANISTES",371
43,"43146",40,32,32,0,0,"ERC-SOBIRANISTES",10
8,"8223",1897,1345,1341,10,4,"ERC-SOBIRANISTES",444
8,"8210",4640,3226,3200,24,26,"ERC-SOBIRANISTES",1001
17,"17168",373,309,308,3,1,"ERC-SOBIRANISTES",92
43,"43152",435,348,342,2,6,"ERC-SOBIRANISTES",125
8,"8160",317,234,234,0,0,"ERC-SOBIRANISTES",56
8,"8102",28940,21108,21014,157,94,"ERC-SOBIRANISTES",5767
8,"8071",249,209,208,0,1,"ERC-SOBIRANISTES",78
17,"17138",836,591,584,7,7,"ERC-SOBIRANISTES",156
8,"8272",164,128,128,1,0,"ERC-SOBIRANISTES",44
25,"25132",141,106,105,0,1,"ERC-SOBIRANISTES",39
8,"8105",9741,6946,6896,62,50,"ERC-SOBIRANISTES",795
8,"8249",274,238,237,0,1,"ERC-SOBIRANISTES",77
8,"8256",693,542,542,3,0,"ERC-SOBIRANISTES",157
8,"8180",27198,19822,19704,160,118,"ERC-SOBIRANISTES",2957
17,"17150",1444,1177,1163,13,14,"ERC-SOBIRANISTES",327
25,"25072",5881,4059,4031,30,28,"ERC-SOBIRANISTES",1260
8,"8087",144,120,120,0,0,"ERC-SOBIRANISTES",42
17,"17119",71,53,52,3,1,"ERC-SOBIRANISTES",12
25,"25082",292,197,197,2,0,"ERC-SOBIRANISTES",106
8,"8006",11774,8375,8329,53,46,"ERC-SOBIRANISTES",2343
25,"25085",141,109,108,2,1,"ERC-SOBIRANISTES",28
8,"8157",8574,6514,6472,47,42,"ERC-SOBIRANISTES",1377
8,"8297",138,99,99,0,0,"ERC-SOBIRANISTES",22
25,"25183",520,372,370,4,2,"ERC-SOBIRANISTES",117
25,"25102",647,484,482,5,2,"ERC-SOBIRANISTES",132
8,"8035",13006,8957,8918,50,39,"ERC-SOBIRANISTES",2287
8,"8022",12213,8594,8558,42,36,"ERC-SOBIRANISTES",2478
17,"17132",1344,1019,1009,12,10,"ERC-SOBIRANISTES",310
8,"8050",139,118,115,4,3,"ERC-SOBIRANISTES",36
25,"25181",172,137,137,1,0,"ERC-SOBIRANISTES",35
8,"8169",48478,35283,35114,278,169,"ERC-SOBIRANISTES",5169
43,"43072",90,69,67,1,2,"ERC-SOBIRANISTES",29
8,"8291",4972,3531,3519,23,12,"ERC-SOBIRANISTES",925
43,"43113",387,305,303,1,2,"ERC-SOBIRANISTES",93
8,"8065",1183,920,913,8,7,"ERC-SOBIRANISTES",296
25,"25140",779,540,539,2,1,"ERC-SOBIRANISTES",194
17,"17009",4068,3061,3050,16,11,"ERC-SOBIRANISTES",912
25,"25221",115,82,81,1,1,"ERC-SOBIRANISTES",29
8,"8901",240,200,195,2,5,"ERC-SOBIRANISTES",74
25,"25064",96,78,78,0,0,"ERC-SOBIRANISTES",25
8,"8125",25583,18334,18225,122,109,"ERC-SOBIRANISTES",3411
25,"25046",410,331,326,4,5,"ERC-SOBIRANISTES",117
17,"17225",205,150,150,1,0,"ERC-SOBIRANISTES",70
8,"8155",7056,5050,5011,38,39,"ERC-SOBIRANISTES",1191
17,"17165",645,502,502,2,0,"ERC-SOBIRANISTES",136
43,"43081",629,500,499,2,1,"ERC-SOBIRANISTES",171
17,"17070",110,87,87,0,0,"ERC-SOBIRANISTES",21
43,"43125",884,658,645,12,13,"ERC-SOBIRANISTES",199
17,"17159",622,459,459,1,0,"ERC-SOBIRANISTES",154
8,"8142",136,117,117,3,0,"ERC-SOBIRANISTES",27
8,"8033",13262,9887,9833,64,54,"ERC-SOBIRANISTES",2815
8,"8082",1164,796,780,5,16,"ERC-SOBIRANISTES",130
43,"43175",534,363,359,5,4,"ERC-SOBIRANISTES",116
25,"25087",54,45,45,0,0,"ERC-SOBIRANISTES",10
8,"8904",10516,7068,7025,54,43,"ERC-SOBIRANISTES",613
8,"8174",388,322,318,2,4,"ERC-SOBIRANISTES",106
8,"8181",8133,5949,5924,31,25,"ERC-SOBIRANISTES",1575
8,"8203",2466,1678,1675,7,3,"ERC-SOBIRANISTES",517
17,"17060",409,300,298,1,2,"ERC-SOBIRANISTES",93
43,"43024",1545,1019,1014,14,5,"ERC-SOBIRANISTES",216
25,"25051",1522,1066,1059,6,7,"ERC-SOBIRANISTES",382
43,"43029",312,241,240,1,1,"ERC-SOBIRANISTES",132
17,"17202",3848,2632,2615,16,17,"ERC-SOBIRANISTES",697
8,"8103",652,476,474,1,2,"ERC-SOBIRANISTES",167
8,"8172",20543,15191,15140,85,51,"ERC-SOBIRANISTES",3814
25,"25209",1586,1115,1102,6,13,"ERC-SOBIRANISTES",340
8,"8057",61,47,47,1,0,"ERC-SOBIRANISTES",21
8,"8096",43926,32120,31960,217,160,"ERC-SOBIRANISTES",6990
8,"8043",3414,2429,2422,15,7,"ERC-SOBIRANISTES",475
25,"25239",582,330,330,3,0,"ERC-SOBIRANISTES",109
25,"25063",84,52,51,0,1,"ERC-SOBIRANISTES",11
17,"17091",391,296,290,3,6,"ERC-SOBIRANISTES",93
17,"17137",3486,2812,2808,15,4,"ERC-SOBIRANISTES",1055
17,"17199",6984,4919,4894,39,25,"ERC-SOBIRANISTES",1497
25,"25227",656,476,476,2,0,"ERC-SOBIRANISTES",177
8,"8134",848,618,609,4,9,"ERC-SOBIRANISTES",179
17,"17095",20044,12638,12576,88,62,"ERC-SOBIRANISTES",2288
43,"43003",349,257,255,3,2,"ERC-SOBIRANISTES",63
17,"17036",2639,1944,1934,21,10,"ERC-SOBIRANISTES",575
17,"17198",437,307,306,0,1,"ERC-SOBIRANISTES",89
8,"8074",11190,7698,7651,51,47,"ERC-SOBIRANISTES",1574
8,"8114",18838,13519,13442,81,77,"ERC-SOBIRANISTES",2726
8,"8244",6099,4733,4706,39,27,"ERC-SOBIRANISTES",1213
17,"17195",338,274,272,1,2,"ERC-SOBIRANISTES",79
25,"25218",88,76,75,2,1,"ERC-SOBIRANISTES",33
17,"17228",285,218,217,0,1,"ERC-SOBIRANISTES",75
43,"43016",3470,2547,2508,15,39,"ERC-SOBIRANISTES",459
8,"8306",535,368,368,5,0,"ERC-SOBIRANISTES",140
8,"8152",117,94,94,0,0,"ERC-SOBIRANISTES",36
17,"17086",1769,1116,1109,6,7,"ERC-SOBIRANISTES",267
8,"8903",201,181,181,1,0,"ERC-SOBIRANISTES",61
8,"8016",1803,1371,1363,11,8,"ERC-SOBIRANISTES",448
8,"8208",5793,4267,4244,21,23,"ERC-SOBIRANISTES",1088
17,"17177",562,426,423,1,3,"ERC-SOBIRANISTES",136
25,"25176",307,241,238,3,3,"ERC-SOBIRANISTES",70
17,"17149",370,302,300,1,2,"ERC-SOBIRANISTES",68
17,"17064",324,249,247,2,2,"ERC-SOBIRANISTES",82
25,"25166",170,131,130,2,1,"ERC-SOBIRANISTES",35
8,"8002",217,172,172,2,0,"ERC-SOBIRANISTES",32
17,"17097",200,170,167,2,3,"ERC-SOBIRANISTES",53
8,"8124",37157,27139,26994,179,145,"ERC-SOBIRANISTES",4874
8,"8081",349,274,270,0,4,"ERC-SOBIRANISTES",72
43,"43046",88,69,68,1,1,"ERC-SOBIRANISTES",30
43,"43008",305,171,171,7,0,"ERC-SOBIRANISTES",57
8,"8176",158,119,119,0,0,"ERC-SOBIRANISTES",22
43,"43134",281,217,215,5,2,"ERC-SOBIRANISTES",57
17,"17201",137,103,103,0,0,"ERC-SOBIRANISTES",39
17,"17094",1058,757,747,3,10,"ERC-SOBIRANISTES",255
17,"17218",576,456,451,3,5,"ERC-SOBIRANISTES",118
17,"17222",104,87,87,1,0,"ERC-SOBIRANISTES",27
43,"43177",276,229,227,2,2,"ERC-SOBIRANISTES",91
8,"8225",94,83,82,1,1,"ERC-SOBIRANISTES",23
43,"43148",91182,65076,64756,441,320,"ERC-SOBIRANISTES",12962
25,"25097",89,71,71,2,0,"ERC-SOBIRANISTES",42
17,"17033",5647,3879,3852,25,27,"ERC-SOBIRANISTES",902
25,"25252",553,380,379,2,1,"ERC-SOBIRANISTES",144
17,"17029",207,154,154,1,0,"ERC-SOBIRANISTES",51
43,"43105",155,126,123,4,3,"ERC-SOBIRANISTES",40
8,"8211",33934,26136,26000,198,136,"ERC-SOBIRANISTES",4878
17,"17092",3462,2414,2389,14,25,"ERC-SOBIRANISTES",755
17,"17220",801,649,647,2,2,"ERC-SOBIRANISTES",200
8,"8104",657,496,493,4,3,"ERC-SOBIRANISTES",159
25,"25089",93,70,68,1,2,"ERC-SOBIRANISTES",15
17,"17018",494,377,372,4,5,"ERC-SOBIRANISTES",113
8,"8248",5687,4187,4165,21,22,"ERC-SOBIRANISTES",1175
17,"17006",1178,826,818,9,8,"ERC-SOBIRANISTES",266
8,"8303",257,207,205,1,2,"ERC-SOBIRANISTES",75
25,"25122",1929,1408,1398,21,10,"ERC-SOBIRANISTES",540
8,"8199",648,509,508,3,1,"ERC-SOBIRANISTES",162
17,"17003",103,85,85,0,0,"ERC-SOBIRANISTES",25
43,"43140",2433,1685,1674,11,11,"ERC-SOBIRANISTES",306
43,"43157",339,279,279,1,0,"ERC-SOBIRANISTES",112
8,"8228",292,234,233,0,1,"ERC-SOBIRANISTES",95
8,"8018",2540,1862,1855,7,7,"ERC-SOBIRANISTES",499
8,"8281",4858,3783,3762,19,21,"ERC-SOBIRANISTES",1050
25,"25109",211,155,154,1,1,"ERC-SOBIRANISTES",45
17,"17118",12934,8723,8665,38,58,"ERC-SOBIRANISTES",2346
8,"8165",1680,1177,1171,7,6,"ERC-SOBIRANISTES",312
25,"25034",2271,1616,1600,12,16,"ERC-SOBIRANISTES",642
25,"25185",680,452,451,0,1,"ERC-SOBIRANISTES",170
8,"8212",491,393,386,6,7,"ERC-SOBIRANISTES",126
43,"43051",9194,6133,6048,44,85,"ERC-SOBIRANISTES",950
25,"25230",1541,1105,1099,9,6,"ERC-SOBIRANISTES",450
43,"43017",112,94,94,1,0,"ERC-SOBIRANISTES",38
8,"8283",6165,4546,4524,33,22,"ERC-SOBIRANISTES",1328
17,"17215",2286,1855,1844,13,11,"ERC-SOBIRANISTES",639
25,"25112",269,205,200,2,5,"ERC-SOBIRANISTES",55
8,"8188",115,89,89,0,0,"ERC-SOBIRANISTES",23
25,"25078",995,746,743,7,3,"ERC-SOBIRANISTES",355
25,"25146",223,158,155,3,3,"ERC-SOBIRANISTES",36
8,"8263",21208,15014,14890,111,124,"ERC-SOBIRANISTES",3333
17,"17005",457,322,320,3,2,"ERC-SOBIRANISTES",119
8,"8112",12926,9268,9230,61,38,"ERC-SOBIRANISTES",2413
43,"43049",727,557,555,3,2,"ERC-SOBIRANISTES",234
8,"8164",936,750,747,6,3,"ERC-SOBIRANISTES",259
43,"43069",183,148,147,2,1,"ERC-SOBIRANISTES",48
8,"8030",5208,4045,4033,25,12,"ERC-SOBIRANISTES",1245
25,"25100",184,137,136,1,1,"ERC-SOBIRANISTES",49
17,"17140",635,506,505,2,1,"ERC-SOBIRANISTES",128
8,"8020",5243,4117,4100,29,17,"ERC-SOBIRANISTES",1080
8,"8280",93,76,75,1,1,"ERC-SOBIRANISTES",20
25,"25901",289,214,211,4,3,"ERC-SOBIRANISTES",71
17,"17117",14497,9438,9382,66,56,"ERC-SOBIRANISTES",2379
43,"43052",927,680,674,7,6,"ERC-SOBIRANISTES",282
43,"43129",4607,3284,3261,21,23,"ERC-SOBIRANISTES",942
43,"43090",1199,689,686,5,3,"ERC-SOBIRANISTES",127
25,"25005",269,193,193,3,0,"ERC-SOBIRANISTES",67
17,"17200",624,469,467,6,2,"ERC-SOBIRANISTES",157
43,"43014",14386,9542,9464,74,78,"ERC-SOBIRANISTES",3598
8,"8242",223,159,159,0,0,"ERC-SOBIRANISTES",48
25,"25001",143,102,102,1,0,"ERC-SOBIRANISTES",37
25,"25912",841,620,619,5,1,"ERC-SOBIRANISTES",139
17,"17077",565,395,394,2,1,"ERC-SOBIRANISTES",105
17,"17134",220,175,174,1,1,"ERC-SOBIRANISTES",63
25,"25020",270,202,201,2,1,"ERC-SOBIRANISTES",63
43,"43075",86,65,63,0,2,"ERC-SOBIRANISTES",28
43,"43122",112,91,91,1,0,"ERC-SOBIRANISTES",34
17,"17048",6284,4077,4048,34,29,"ERC-SOBIRANISTES",839
17,"17085",293,239,238,0,1,"ERC-SOBIRANISTES",80
8,"8271",66,48,47,2,1,"ERC-SOBIRANISTES",16
17,"17021",119,89,87,0,2,"ERC-SOBIRANISTES",19
25,"25215",339,249,249,5,0,"ERC-SOBIRANISTES",61
25,"25128",125,85,85,0,0,"ERC-SOBIRANISTES",28
25,"25168",496,399,399,6,0,"ERC-SOBIRANISTES",123
17,"17026",549,421,415,3,6,"ERC-SOBIRANISTES",129
8,"8200",62225,45235,44991,306,244,"ERC-SOBIRANISTES",7208
43,"43076",454,336,335,1,1,"ERC-SOBIRANISTES",129
25,"25201",110,81,81,0,0,"ERC-SOBIRANISTES",26
43,"43041",216,156,156,2,0,"ERC-SOBIRANISTES",58
17,"17189",1481,1228,1223,5,5,"ERC-SOBIRANISTES",301
17,"17047",5016,3087,3068,22,19,"ERC-SOBIRANISTES",710
25,"25909",138,99,98,2,1,"ERC-SOBIRANISTES",33
8,"8094",1588,1258,1252,7,6,"ERC-SOBIRANISTES",446
25,"25204",1187,858,849,13,9,"ERC-SOBIRANISTES",315
25,"25055",163,114,114,0,0,"ERC-SOBIRANISTES",25
43,"43139",2007,1432,1419,9,13,"ERC-SOBIRANISTES",491
25,"25053",1100,819,811,7,8,"ERC-SOBIRANISTES",304
17,"17044",6938,5245,5212,33,33,"ERC-SOBIRANISTES",1508
43,"43904",2864,1881,1851,20,30,"ERC-SOBIRANISTES",635
25,"25016",2083,1404,1399,3,5,"ERC-SOBIRANISTES",533
25,"25048",1641,1207,1194,13,13,"ERC-SOBIRANISTES",436
43,"43063",544,376,374,2,2,"ERC-SOBIRANISTES",109
43,"43060",2672,2032,2015,7,17,"ERC-SOBIRANISTES",950
8,"8902",3941,2974,2962,16,12,"ERC-SOBIRANISTES",727
17,"17212",145,111,109,0,2,"ERC-SOBIRANISTES",33
25,"25126",281,211,210,1,1,"ERC-SOBIRANISTES",74
8,"8215",2617,1954,1946,22,8,"ERC-SOBIRANISTES",579
43,"43011",1086,862,860,5,2,"ERC-SOBIRANISTES",287
25,"25027",978,695,690,3,5,"ERC-SOBIRANISTES",274
43,"43078",835,610,605,7,5,"ERC-SOBIRANISTES",175
8,"8076",16526,11988,11893,90,95,"ERC-SOBIRANISTES",2834
25,"25171",2117,1539,1534,5,5,"ERC-SOBIRANISTES",500
17,"17158",565,296,295,2,1,"ERC-SOBIRANISTES",90
17,"17170",173,140,140,2,0,"ERC-SOBIRANISTES",64
8,"8061",1628,1154,1151,15,3,"ERC-SOBIRANISTES",282
8,"8196",19542,14264,14185,123,79,"ERC-SOBIRANISTES",2119
8,"8167",6056,4520,4500,38,20,"ERC-SOBIRANISTES",790
8,"8144",722,551,545,3,6,"ERC-SOBIRANISTES",193
17,"17082",435,308,307,1,1,"ERC-SOBIRANISTES",108
8,"8265",1597,1262,1260,4,2,"ERC-SOBIRANISTES",418
17,"17073",1939,1649,1640,11,9,"ERC-SOBIRANISTES",419
46,"46086",80,66,65,1,1,"ERPV",0
3,"3104",27072,19732,19477,218,255,"ERPV",25
3,"3005",7937,5907,5869,40,38,"ERPV",6
46,"46094",20805,15353,15211,122,142,"ERPV",30
12,"12068",41,22,21,0,1,"ERPV",0
46,"46058",1734,1245,1230,8,15,"ERPV",10
46,"46258",2617,1925,1914,5,11,"ERPV",1
3,"3041",6132,4204,4167,22,37,"ERPV",28
46,"46193",8959,6880,6824,66,56,"ERPV",9
46,"46235",21229,15171,15011,126,160,"ERPV",106
3,"3084",501,413,413,1,0,"ERPV",1
46,"46091",110,100,100,0,0,"ERPV",0
3,"3025",1304,944,934,4,10,"ERPV",0
46,"46230",14116,10038,9946,63,92,"ERPV",19
46,"46252",125,89,86,1,3,"ERPV",1
12,"12053",2040,1587,1579,8,8,"ERPV",3
46,"46101",819,670,663,8,7,"ERPV",2
46,"46238",13117,9172,9088,50,84,"ERPV",46
3,"3032",97,82,82,0,0,"ERPV",1
12,"12050",1226,904,891,3,13,"ERPV",2
3,"3128",4285,2849,2819,18,30,"ERPV",10
46,"46257",5436,3972,3933,28,39,"ERPV",16
12,"12137",40,28,28,0,0,"ERPV",0
46,"46250",582242,437146,434438,3315,2708,"ERPV",731
46,"46026",1220,974,965,7,9,"ERPV",3
46,"46224",156,125,124,0,1,"ERPV",0
12,"12032",23728,16870,16726,121,144,"ERPV",36
12,"12034",1389,1022,1002,5,20,"ERPV",15
12,"12025",116,82,79,1,3,"ERPV",0
46,"46182",1312,908,904,5,4,"ERPV",6
12,"12111",327,259,255,8,4,"ERPV",1
46,"46203",3546,2717,2689,28,28,"ERPV",11
3,"3114",1593,1158,1142,4,16,"ERPV",3
46,"46075",144,125,122,2,3,"ERPV",2
46,"46048",3504,2609,2576,17,33,"ERPV",9
3,"3107",2785,1766,1746,13,20,"ERPV",3
3,"3044",4608,3437,3391,13,46,"ERPV",0
3,"3131",176,129,126,1,3,"ERPV",0
46,"46033",196,155,153,0,2,"ERPV",1
46,"46025",2445,1875,1853,16,22,"ERPV",1
46,"46124",786,638,625,1,13,"ERPV",1
12,"12105",825,602,598,6,4,"ERPV",0
46,"46007",12333,8890,8803,79,87,"ERPV",18
46,"46139",4520,3486,3457,18,29,"ERPV",8
3,"3096",5786,4355,4281,38,74,"ERPV",7
3,"3070",2115,1399,1376,9,23,"ERPV",0
12,"12135",36287,25912,25655,184,257,"ERPV",74
46,"46069",152,112,111,1,1,"ERPV",0
12,"12013",135,106,106,1,0,"ERPV",2
3,"3088",5895,4030,3961,29,69,"ERPV",5
46,"46248",4868,3434,3374,16,60,"ERPV",9
46,"46231",2403,1670,1652,11,18,"ERPV",9
3,"3069",3329,2102,2077,11,25,"ERPV",2
46,"46098",2405,1778,1751,7,27,"ERPV",1
46,"46170",3417,2618,2577,11,41,"ERPV",3
12,"12109",646,489,482,4,7,"ERPV",0
12,"12127",63,45,44,1,1,"ERPV",2
3,"3111",5579,3777,3737,23,40,"ERPV",2
46,"46121",106,91,90,1,1,"ERPV",0
46,"46078",28484,19694,19520,173,174,"ERPV",38
46,"46020",3757,2834,2783,16,51,"ERPV",4
46,"46134",2419,1697,1678,14,19,"ERPV",6
12,"12059",220,183,183,2,0,"ERPV",1
46,"46107",1857,1421,1402,4,19,"ERPV",2
3,"3138",3190,2244,2207,9,37,"ERPV",8
12,"12080",1883,1472,1438,8,34,"ERPV",14
12,"12126",24374,17741,17553,111,188,"ERPV",35
46,"46263",235,182,180,2,2,"ERPV",0
12,"12114",200,144,140,0,4,"ERPV",1
46,"46200",1840,1475,1455,5,20,"ERPV",1
46,"46145",22215,15688,15538,127,150,"ERPV",85
12,"12129",1783,1207,1184,16,23,"ERPV",3
46,"46074",2687,2033,2020,18,13,"ERPV",2
3,"3001",337,260,258,0,2,"ERPV",0
46,"46079",314,244,240,0,4,"ERPV",0
46,"46164",12145,8373,8248,44,125,"ERPV",12
46,"46225",351,267,262,1,5,"ERPV",3
46,"46172",5488,3724,3674,26,50,"ERPV",12
46,"46228",2426,1819,1802,19,17,"ERPV",5
46,"46190",50042,35290,35066,284,224,"ERPV",31
12,"12106",1151,928,908,9,20,"ERPV",2
3,"3118",2446,1617,1598,8,19,"ERPV",2
3,"3904",1434,1032,1022,8,10,"ERPV",1
3,"3903",2612,1838,1814,7,24,"ERPV",0
12,"12007",724,622,614,2,8,"ERPV",1
3,"3078",468,340,336,0,4,"ERPV",0
12,"12085",5081,3271,3235,17,36,"ERPV",7
46,"46205",14237,10641,10533,77,108,"ERPV",17
3,"3129",1224,934,923,4,11,"ERPV",3
3,"3042",1475,1053,1043,7,10,"ERPV",9
12,"12031",3960,2913,2869,13,44,"ERPV",15
46,"46111",11367,7995,7908,66,87,"ERPV",7
46,"46168",2004,1463,1447,12,16,"ERPV",4
3,"3089",9496,6617,6484,51,133,"ERPV",13
46,"46137",248,201,197,3,4,"ERPV",0
3,"3098",523,382,378,1,4,"ERPV",3
46,"46246",1049,808,793,3,15,"ERPV",2
12,"12022",323,257,254,5,3,"ERPV",0
3,"3039",89,65,65,0,0,"ERPV",3
46,"46071",471,355,349,1,6,"ERPV",1
12,"12005",8049,5643,5552,71,91,"ERPV",18
12,"12004",4149,2945,2910,25,35,"ERPV",7
3,"3094",9795,6528,6481,37,47,"ERPV",5
46,"46186",19689,14688,14576,118,112,"ERPV",11
3,"3105",5510,3879,3792,27,87,"ERPV",2
46,"46140",383,321,321,2,0,"ERPV",0
46,"46056",176,142,142,0,0,"ERPV",0
3,"3060",105,78,77,0,1,"ERPV",1
46,"46018",562,442,436,2,6,"ERPV",0
12,"12052",537,409,398,5,11,"ERPV",2
3,"3009",46125,33613,33319,315,294,"ERPV",129
46,"46045",1245,984,961,3,23,"ERPV",11
46,"46040",993,745,733,3,12,"ERPV",4
3,"3117",377,306,302,2,4,"ERPV",1
12,"12038",157,101,100,3,1,"ERPV",0
46,"46236",929,723,716,2,7,"ERPV",2
12,"12061",374,263,261,4,2,"ERPV",4
12,"12076",72,54,54,0,0,"ERPV",1
46,"46010",943,691,681,7,10,"ERPV",2
46,"46003",948,770,757,8,13,"ERPV",1
46,"46198",862,670,660,3,10,"ERPV",2
46,"46147",17186,11507,11399,72,108,"ERPV",21
46,"46054",11389,8266,8190,54,76,"ERPV",19
12,"12015",115,94,94,0,0,"ERPV",0
46,"46117",493,386,380,2,6,"ERPV",0
12,"12077",4828,3395,3357,28,38,"ERPV",5
3,"3125",332,226,226,2,0,"ERPV",0
12,"12089",4555,3070,3045,22,25,"ERPV",24
12,"12113",90,59,59,1,0,"ERPV",1
12,"12044",442,371,368,1,3,"ERPV",2
46,"46031",10574,7233,7158,58,75,"ERPV",40
46,"46144",628,483,478,4,5,"ERPV",0
3,"3072",352,281,277,3,4,"ERPV",4
12,"12074",756,611,601,3,10,"ERPV",1
3,"3013",1063,809,794,3,15,"ERPV",0
46,"46109",6248,4516,4440,37,76,"ERPV",0
46,"46185",361,301,299,5,2,"ERPV",4
46,"46208",1071,854,845,2,9,"ERPV",8
46,"46030",810,641,625,7,16,"ERPV",0
3,"3091",244,194,193,2,1,"ERPV",0
3,"3067",91,78,78,0,0,"ERPV",0
3,"3028",959,780,767,7,13,"ERPV",2
46,"46035",6828,5155,5089,33,66,"ERPV",24
12,"12901",3339,2583,2561,25,22,"ERPV",4
46,"46221",348,292,290,1,2,"ERPV",0
3,"3099",43101,30222,29885,196,337,"ERPV",16
12,"12009",17943,12389,12292,102,97,"ERPV",24
3,"3079",18422,13560,13378,152,182,"ERPV",27
3,"3045",216,176,172,1,4,"ERPV",0
46,"46041",313,229,228,1,1,"ERPV",0
46,"46218",1043,842,829,6,13,"ERPV",7
46,"46162",1168,839,832,3,7,"ERPV",0
12,"12058",59,47,45,1,2,"ERPV",1
3,"3038",330,260,254,3,6,"ERPV",1
3,"3004",603,425,423,2,2,"ERPV",0
3,"3064",5015,3514,3461,15,53,"ERPV",1
46,"46113",2558,1791,1773,7,18,"ERPV",10
3,"3080",1330,1040,1032,4,8,"ERPV",1
3,"3086",169,140,140,2,0,"ERPV",1
12,"12140",1147,849,841,5,8,"ERPV",1
12,"12065",167,142,141,0,1,"ERPV",0
46,"46177",4832,3592,3539,20,53,"ERPV",14
46,"46076",610,500,494,1,6,"ERPV",0
3,"3137",654,449,443,7,6,"ERPV",5
46,"46903",6306,4762,4743,44,19,"ERPV",12
46,"46122",2726,1957,1934,13,23,"ERPV",23
3,"3037",340,261,255,3,6,"ERPV",0
12,"12088",57,53,53,0,0,"ERPV",0
46,"46211",1862,1395,1381,12,14,"ERPV",12
12,"12122",754,608,600,3,8,"ERPV",1
12,"12028",13004,9801,9732,74,69,"ERPV",21
3,"3113",4339,2978,2935,23,43,"ERPV",0
3,"3119",17253,12346,12258,81,88,"ERPV",23
3,"3029",236,174,172,2,2,"ERPV",1
46,"46223",7776,5848,5798,36,50,"ERPV",6
46,"46127",2748,2035,2009,6,26,"ERPV",20
46,"46183",6036,4276,4213,21,63,"ERPV",9
3,"3018",12433,8582,8502,54,80,"ERPV",28
46,"46108",420,328,324,1,4,"ERPV",0
3,"3124",459,360,358,0,2,"ERPV",2
46,"46136",2598,1875,1851,14,24,"ERPV",3
46,"46004",1932,1530,1512,10,18,"ERPV",4
46,"46242",326,260,257,3,3,"ERPV",0
46,"46143",4274,3027,2995,19,32,"ERPV",6
46,"46173",1309,1029,1010,13,19,"ERPV",0
12,"12072",1083,852,827,10,25,"ERPV",0
46,"46062",4552,3402,3362,27,40,"ERPV",4
3,"3002",3649,2568,2542,11,26,"ERPV",7
12,"12097",62,53,51,0,2,"ERPV",0
46,"46081",9999,7486,7412,47,74,"ERPV",23
12,"12087",26,16,16,0,0,"ERPV",1
46,"46169",32403,23890,23698,222,192,"ERPV",20
12,"12071",1272,936,925,3,11,"ERPV",2
46,"46099",744,539,535,2,4,"ERPV",1
12,"12002",114,96,94,1,2,"ERPV",2
46,"46013",17761,13652,13548,144,104,"ERPV",40
46,"46037",1120,891,879,7,12,"ERPV",0
3,"3048",4993,3549,3502,13,47,"ERPV",9
12,"12095",950,723,712,5,11,"ERPV",1
46,"46005",23129,16610,16437,148,173,"ERPV",23
46,"46053",525,433,428,2,5,"ERPV",2
3,"3057",174,138,136,0,2,"ERPV",1
12,"12134",135,95,95,1,0,"ERPV",0
46,"46215",1407,1088,1068,10,20,"ERPV",18
46,"46023",322,254,252,1,2,"ERPV",1
3,"3132",512,376,373,2,3,"ERPV",1
46,"46210",338,256,251,0,5,"ERPV",0
12,"12107",350,299,295,3,4,"ERPV",0
12,"12069",50,38,38,0,0,"ERPV",0
3,"3139",23126,14650,14522,127,128,"ERPV",37
46,"46019",8932,6721,6647,40,74,"ERPV",14
46,"46201",62,40,40,0,0,"ERPV",0
3,"3135",195,134,131,1,3,"ERPV",0
46,"46092",262,176,174,2,2,"ERPV",0
46,"46043",135,119,118,0,1,"ERPV",0
3,"3022",140,125,121,1,4,"ERPV",0
3,"3075",154,117,115,1,2,"ERPV",1
46,"46174",942,746,736,1,10,"ERPV",3
3,"3085",271,229,227,5,2,"ERPV",1
3,"3123",7579,5491,5416,50,75,"ERPV",5
12,"12006",177,133,133,2,0,"ERPV",0
46,"46110",21364,15132,15019,120,113,"ERPV",14
12,"12108",443,354,352,4,2,"ERPV",2
46,"46132",2176,1725,1708,5,17,"ERPV",4
46,"46087",109,94,94,2,0,"ERPV",0
46,"46073",1066,823,817,11,6,"ERPV",1
46,"46167",342,240,239,0,1,"ERPV",1
46,"46262",206,136,134,1,2,"ERPV",0
12,"12043",570,405,397,1,8,"ERPV",3
46,"46165",7349,5460,5412,39,48,"ERPV",16
12,"12091",171,110,108,4,2,"ERPV",0
46,"46068",345,283,279,2,4,"ERPV",0
12,"12057",572,456,437,1,19,"ERPV",4
46,"46008",2617,1954,1931,17,23,"ERPV",11
46,"46212",1620,1130,1112,12,18,"ERPV",5
3,"3017",379,320,314,4,6,"ERPV",1
12,"12067",514,381,373,3,8,"ERPV",0
46,"46006",4454,3527,3486,27,41,"ERPV",5
46,"46064",532,395,387,3,8,"ERPV",1
46,"46234",317,247,245,1,2,"ERPV",0
3,"3101",4933,3502,3462,16,40,"ERPV",36
46,"46213",15499,10610,10482,173,128,"ERPV",12
12,"12012",2622,2084,2056,12,28,"ERPV",0
3,"3115",255,213,213,3,0,"ERPV",5
46,"46254",944,673,661,6,12,"ERPV",0
46,"46232",853,661,648,7,13,"ERPV",3
12,"12092",123,95,95,0,0,"ERPV",1
12,"12141",92,72,72,0,0,"ERPV",0
46,"46178",5001,3513,3477,26,36,"ERPV",5
46,"46133",462,359,352,1,7,"ERPV",0
12,"12104",6843,5181,5111,32,70,"ERPV",6
12,"12121",1043,878,856,5,22,"ERPV",5
12,"12103",87,61,60,0,1,"ERPV",0
46,"46051",8469,6120,6070,40,50,"ERPV",9
46,"46255",3220,2361,2340,20,21,"ERPV",4
12,"12102",518,424,417,4,7,"ERPV",0
46,"46036",558,339,331,6,8,"ERPV",0
46,"46038",302,221,220,1,1,"ERPV",1
46,"46022",15392,10624,10546,69,78,"ERPV",21
46,"46179",2136,1624,1596,17,28,"ERPV",2
3,"3063",27209,18236,18101,164,135,"ERPV",71
3,"3076",8846,6105,6029,40,76,"ERPV",6
46,"46016",1070,827,814,10,13,"ERPV",1
3,"3051",342,288,286,4,2,"ERPV",1
3,"3050",19420,13210,13116,70,94,"ERPV",27
3,"3010",332,275,268,1,7,"ERPV",4
46,"46055",1298,992,977,9,15,"ERPV",2
46,"46046",901,623,609,2,14,"ERPV",2
12,"12060",434,366,360,1,6,"ERPV",3
3,"3056",8588,6219,6135,29,84,"ERPV",23
3,"3092",6712,4924,4858,35,66,"ERPV",22
12,"12045",333,243,235,2,8,"ERPV",1
3,"3061",1060,793,787,5,6,"ERPV",0
12,"12099",597,444,436,6,8,"ERPV",12
46,"46187",1292,924,920,4,4,"ERPV",4
12,"12016",1549,1244,1234,9,10,"ERPV",1
12,"12081",606,454,446,2,8,"ERPV",1
46,"46152",90,63,63,0,0,"ERPV",0
46,"46115",330,219,213,0,6,"ERPV",0
46,"46114",552,417,412,6,5,"ERPV",1
12,"12020",118,104,103,1,1,"ERPV",0
46,"46195",2000,1540,1532,3,8,"ERPV",0
12,"12041",92,69,69,2,0,"ERPV",1
46,"46057",463,308,304,1,4,"ERPV",3
46,"46175",429,362,355,3,7,"ERPV",5
46,"46243",124,93,90,1,3,"ERPV",0
12,"12125",215,179,179,2,0,"ERPV",1
12,"12098",529,417,413,3,4,"ERPV",0
46,"46150",1794,1276,1272,8,4,"ERPV",1
46,"46216",5277,4146,4111,42,35,"ERPV",3
3,"3006",493,365,360,2,5,"ERPV",2
12,"12131",97,87,87,0,0,"ERPV",0
46,"46229",903,715,708,5,7,"ERPV",2
46,"46233",3766,2688,2650,14,38,"ERPV",5
3,"3014",238937,161861,160809,1308,1052,"ERPV",178
46,"46002",1253,946,940,4,6,"ERPV",5
46,"46096",263,204,202,0,2,"ERPV",1
3,"3040",264,227,221,1,6,"ERPV",2
46,"46902",352,283,283,0,0,"ERPV",0
12,"12082",9602,7323,7248,53,75,"ERPV",19
3,"3019",15501,11261,11106,86,155,"ERPV",15
3,"3062",228,173,172,3,1,"ERPV",0
46,"46116",13606,10262,10200,87,62,"ERPV",13
3,"3016",88,66,66,0,0,"ERPV",0
46,"46014",3156,2324,2294,13,30,"ERPV",7
12,"12033",1953,1391,1368,6,23,"ERPV",2
12,"12021",4398,3314,3277,32,37,"ERPV",3
46,"46118",3649,2730,2701,20,29,"ERPV",0
12,"12093",161,111,109,2,2,"ERPV",4
3,"3034",1404,1028,1010,5,18,"ERPV",0
12,"12049",415,317,305,4,12,"ERPV",1
12,"12138",19207,13018,12891,87,127,"ERPV",196
46,"46192",786,534,519,7,15,"ERPV",2
3,"3097",1014,778,764,5,14,"ERPV",0
46,"46089",2182,1590,1576,9,14,"ERPV",4
46,"46188",693,565,560,2,5,"ERPV",1
46,"46138",361,289,287,1,2,"ERPV",0
12,"12055",103,77,76,2,1,"ERPV",4
12,"12039",792,665,659,2,6,"ERPV",0
12,"12056",257,205,199,1,6,"ERPV",1
46,"46189",469,374,367,2,7,"ERPV",0
3,"3901",1137,783,776,9,7,"ERPV",6
3,"3066",41762,28723,28388,358,335,"ERPV",20
46,"46028",383,305,299,8,6,"ERPV",1
3,"3065",169894,121210,120342,1045,868,"ERPV",287
12,"12008",228,195,194,1,1,"ERPV",0
46,"46237",7172,5199,5146,53,53,"ERPV",6
12,"12136",2603,2151,2119,20,32,"ERPV",5
12,"12116",61,49,49,0,0,"ERPV",0
46,"46241",388,288,283,5,5,"ERPV",1
46,"46245",527,407,404,2,3,"ERPV",1
3,"3020",94,84,84,1,0,"ERPV",0
12,"12026",828,577,566,11,11,"ERPV",4
46,"46090",1631,1360,1339,6,21,"ERPV",4
12,"12128",1365,990,972,16,18,"ERPV",3
3,"3059",20710,14788,14685,89,103,"ERPV",55
46,"46184",26514,19610,19399,180,211,"ERPV",78
46,"46084",1487,1136,1123,4,13,"ERPV",2
12,"12118",78,64,63,0,1,"ERPV",0
3,"3110",312,258,258,0,0,"ERPV",0
46,"46093",2151,1652,1640,10,12,"ERPV",1
46,"46156",2017,1538,1524,9,14,"ERPV",3
3,"3024",3937,2992,2952,19,40,"ERPV",1
3,"3109",3003,2186,2151,14,35,"ERPV",1
12,"12110",222,156,155,3,1,"ERPV",0
46,"46130",862,633,625,6,8,"ERPV",3
46,"46247",972,649,646,3,3,"ERPV",0
46,"46141",433,340,337,6,3,"ERPV",0
12,"12073",133,97,97,0,0,"ERPV",0
3,"3030",559,442,433,2,9,"ERPV",0
12,"12079",414,310,305,2,5,"ERPV",0
3,"3068",41,38,37,0,1,"ERPV",0
46,"46163",1883,1471,1460,8,11,"ERPV",10
12,"12010",232,191,187,3,4,"ERPV",0
46,"46104",1906,1422,1409,5,13,"ERPV",7
46,"46154",795,619,608,5,11,"ERPV",4
46,"46061",351,276,272,6,4,"ERPV",0
12,"12133",59,46,45,0,1,"ERPV",0
46,"46029",20448,14673,14556,99,117,"ERPV",71
12,"12078",334,224,221,2,3,"ERPV",3
46,"46160",1922,1395,1381,4,14,"ERPV",2
46,"46142",778,536,524,3,12,"ERPV",1
12,"12029",670,524,514,5,10,"ERPV",3
46,"46194",15852,11124,11009,86,115,"ERPV",28
3,"3103",238,196,194,2,2,"ERPV",1
46,"46176",2077,1362,1348,14,14,"ERPV",1
3,"3003",449,368,367,1,1,"ERPV",1
12,"12051",437,297,295,3,2,"ERPV",1
3,"3121",21997,14689,14572,103,117,"ERPV",17
3,"3095",4807,3453,3410,31,43,"ERPV",17
3,"3058",4976,3733,3669,20,64,"ERPV",2
46,"46049",268,221,217,2,4,"ERPV",1
46,"46042",3335,2655,2620,12,35,"ERPV",2
3,"3031",42046,25035,24819,168,216,"ERPV",14
12,"12120",149,125,121,3,4,"ERPV",0
12,"12142",142,113,113,0,0,"ERPV",0
46,"46119",761,587,580,6,7,"ERPV",1
12,"12112",102,79,79,1,0,"ERPV",0
3,"3023",1377,1138,1122,9,16,"ERPV",5
46,"46161",1467,1129,1113,5,16,"ERPV",3
12,"12132",477,391,385,3,6,"ERPV",0
46,"46015",7519,5575,5532,34,43,"ERPV",18
3,"3082",12941,8399,8304,51,95,"ERPV",35
3,"3073",222,178,178,0,0,"ERPV",2
46,"46034",1826,1345,1335,3,10,"ERPV",5
12,"12119",139,97,94,3,3,"ERPV",1
3,"3008",158,120,118,1,2,"ERPV",0
12,"12011",4583,3228,3177,24,51,"ERPV",11
46,"46131",49805,35527,35231,298,296,"ERPV",109
46,"46063",1786,1270,1255,8,15,"ERPV",6
46,"46166",8214,6093,6031,38,62,"ERPV",12
46,"46123",1926,1392,1368,11,24,"ERPV",7
12,"12070",505,407,398,2,9,"ERPV",0
46,"46070",17824,12888,12802,106,86,"ERPV",23
3,"3035",627,485,485,2,0,"ERPV",3
3,"3012",1138,863,846,4,17,"ERPV",1
46,"46157",2959,2145,2126,11,19,"ERPV",11
3,"3090",18095,12539,12412,75,127,"ERPV",34
3,"3036",82,73,71,1,2,"ERPV",0
3,"3112",650,503,497,3,6,"ERPV",1
12,"12090",102,79,78,1,1,"ERPV",0
12,"12115",205,161,161,1,0,"ERPV",0
46,"46024",454,343,339,1,4,"ERPV",0
3,"3071",4000,2858,2813,27,45,"ERPV",16
3,"3133",41333,24527,24340,146,187,"ERPV",14
46,"46032",5719,4297,4262,35,35,"ERPV",9
12,"12001",1028,783,768,6,15,"ERPV",2
46,"46180",659,509,500,7,9,"ERPV",1
12,"12124",1842,1343,1328,13,15,"ERPV",2
46,"46219",125,107,104,0,3,"ERPV",0
46,"46204",6625,4946,4882,52,64,"ERPV",14
12,"12123",40,32,32,0,0,"ERPV",0
46,"46001",771,562,560,3,2,"ERPV",1
3,"3052",959,747,735,4,12,"ERPV",0
46,"46052",515,423,419,4,4,"ERPV",0
3,"3027",167,142,138,1,4,"ERPV",0
3,"3021",5573,4423,4343,23,80,"ERPV",16
46,"46256",7280,4996,4940,32,56,"ERPV",5
12,"12017",145,111,110,2,1,"ERPV",0
46,"46083",15372,10939,10815,78,124,"ERPV",47
46,"46220",49112,33766,33424,312,342,"ERPV",78
46,"46125",852,660,650,5,10,"ERPV",1
12,"12040",119116,85613,84993,620,620,"ERPV",216
12,"12101",354,274,270,5,4,"ERPV",3
46,"46244",59910,42120,41826,338,294,"ERPV",48
46,"46128",1569,1216,1179,7,37,"ERPV",3
46,"46105",16126,10958,10847,76,111,"ERPV",24
46,"46012",965,689,675,4,14,"ERPV",0
12,"12042",574,459,446,9,13,"ERPV",1
46,"46260",2685,2072,2053,14,19,"ERPV",9
46,"46050",185,141,141,1,0,"ERPV",0
46,"46129",511,389,379,9,10,"ERPV",0
46,"46106",1471,1033,1028,8,5,"ERPV",2
3,"3093",19702,13903,13728,113,175,"ERPV",31
46,"46202",17801,13010,12906,87,104,"ERPV",37
12,"12083",88,69,67,9,2,"ERPV",0
46,"46227",893,687,675,6,12,"ERPV",3
46,"46159",23038,16719,16596,127,123,"ERPV",15
12,"12036",541,401,395,6,6,"ERPV",4
3,"3116",1155,819,805,5,14,"ERPV",0
46,"46120",1179,903,880,5,23,"ERPV",3
46,"46044",4159,3062,2997,26,65,"ERPV",2
12,"12024",138,107,107,1,0,"ERPV",0
3,"3077",1391,1052,1032,10,20,"ERPV",1
46,"46207",6761,4966,4909,46,57,"ERPV",11
46,"46065",1584,1199,1183,11,16,"ERPV",4
12,"12100",1273,1069,1052,5,17,"ERPV",3
3,"3007",173,141,139,0,2,"ERPV",4
46,"46151",757,560,552,2,8,"ERPV",3
46,"46067",1753,1356,1341,8,15,"ERPV",3
46,"46059",1244,1007,995,5,12,"ERPV",27
46,"46027",924,746,737,2,9,"ERPV",0
46,"46904",812,615,605,2,10,"ERPV",1
3,"3130",28,19,19,0,0,"ERPV",0
3,"3043",2906,2360,2334,27,26,"ERPV",9
3,"3011",8014,5278,5212,50,66,"ERPV",9
46,"46153",443,353,349,2,4,"ERPV",4
12,"12096",732,526,519,4,7,"ERPV",15
3,"3136",399,302,301,3,1,"ERPV",2
12,"12027",17506,11776,11649,84,127,"ERPV",143
3,"3120",2433,1688,1652,13,36,"ERPV",1
46,"46155",972,731,716,3,15,"ERPV",5
46,"46171",16446,11616,11499,94,117,"ERPV",28
12,"12117",3532,2512,2479,12,33,"ERPV",13
12,"12046",188,135,135,4,0,"ERPV",0
46,"46135",9817,7596,7558,58,38,"ERPV",17
46,"46097",948,670,663,1,7,"ERPV",0
46,"46206",555,417,408,0,9,"ERPV",1
12,"12902",2250,1557,1532,16,25,"ERPV",6
12,"12014",164,111,111,0,0,"ERPV",1
46,"46077",7338,5447,5356,44,91,"ERPV",6
46,"46146",1647,1241,1229,12,12,"ERPV",6
3,"3033",101,82,78,0,4,"ERPV",1
46,"46226",29,20,19,0,1,"ERPV",0
46,"46060",9278,6796,6724,49,72,"ERPV",24
12,"12063",41,31,31,1,0,"ERPV",0
3,"3026",1331,987,975,7,12,"ERPV",5
3,"3134",139,107,107,0,0,"ERPV",1
3,"3083",5479,3736,3674,39,62,"ERPV",27
46,"46149",350,252,249,3,3,"ERPV",0
3,"3127",350,260,255,1,5,"ERPV",0
12,"12075",110,85,83,3,2,"ERPV",0
46,"46253",112,84,84,0,0,"ERPV",0
3,"3106",559,469,465,3,4,"ERPV",0
3,"3047",9768,6220,6144,41,76,"ERPV",72
46,"46181",16967,11951,11835,98,116,"ERPV",44
46,"46251",2465,1938,1903,19,35,"ERPV",3
46,"46217",900,672,667,7,5,"ERPV",4
46,"46197",1930,1430,1411,11,19,"ERPV",10
3,"3053",7568,5551,5468,40,83,"ERPV",22
46,"46259",457,374,371,2,3,"ERPV",0
46,"46196",134,111,110,0,1,"ERPV",0
12,"12018",279,233,231,3,2,"ERPV",2
46,"46080",979,720,712,2,8,"ERPV",0
46,"46126",5580,4361,4328,36,33,"ERPV",19
3,"3140",26036,18637,18267,237,370,"ERPV",18
46,"46112",533,435,432,7,3,"ERPV",1
3,"3049",12103,8872,8785,57,87,"ERPV",1
12,"12094",871,671,661,1,10,"ERPV",7
46,"46199",5878,4217,4182,21,35,"ERPV",5
3,"3102",7181,5126,5073,36,53,"ERPV",26
46,"46088",152,114,110,1,4,"ERPV",0
46,"46085",11089,7581,7503,60,78,"ERPV",23
46,"46095",580,445,438,5,7,"ERPV",0
46,"46240",200,167,155,1,12,"ERPV",1
12,"12064",80,71,69,0,2,"ERPV",0
3,"3902",10640,7024,6952,36,72,"ERPV",2
46,"46214",16637,12113,12014,84,99,"ERPV",30
12,"12084",17785,12557,12422,108,135,"ERPV",23
46,"46011",7523,5154,5077,34,77,"ERPV",11
46,"46222",402,329,326,0,3,"ERPV",0
46,"46072",3522,2792,2741,25,51,"ERPV",26
12,"12139",299,202,200,3,2,"ERPV",8
3,"3081",1492,1070,1044,12,26,"ERPV",8
46,"46039",2111,1657,1640,16,17,"ERPV",1
46,"46066",1274,972,970,4,2,"ERPV",3
46,"46017",33041,23469,23277,173,192,"ERPV",56
46,"46082",4981,3547,3523,29,24,"ERPV",14
3,"3054",334,248,245,2,3,"ERPV",0
12,"12003",954,710,702,6,8,"ERPV",5
12,"12037",17,13,13,1,0,"ERPV",0
46,"46261",1708,1259,1237,12,22,"ERPV",1
3,"3074",1766,1347,1336,4,11,"ERPV",0
46,"46021",24053,17331,17194,159,137,"ERPV",14
46,"46100",281,190,187,1,3,"ERPV",1
46,"46047",540,428,420,1,8,"ERPV",0
3,"3100",499,384,378,0,6,"ERPV",3
3,"3015",12818,9127,9017,46,110,"ERPV",10
46,"46209",1903,1406,1383,5,23,"ERPV",2
46,"46103",1354,993,978,8,15,"ERPV",8
46,"46009",3144,2473,2449,22,24,"ERPV",5
3,"3046",1636,1073,1061,7,12,"ERPV",2
3,"3122",43774,30060,29834,230,226,"ERPV",25
46,"46191",1956,1439,1414,8,25,"ERPV",1
12,"12130",414,329,327,0,2,"ERPV",0
46,"46102",19696,14700,14579,125,121,"ERPV",17
46,"46239",446,357,352,1,5,"ERPV",0
3,"3055",5265,3741,3697,16,44,"ERPV",1
12,"12048",243,159,155,4,4,"ERPV",0
46,"46249",9136,6538,6439,73,99,"ERPV",0
46,"46158",1047,771,763,7,8,"ERPV",2
46,"46148",1515,1131,1113,5,18,"ERPV",1
10,"10167",301,198,198,0,0,"EXTREMADURA UNIDA",1
10,"10078",365,271,263,7,8,"EXTREMADURA UNIDA",1
10,"10159",314,207,207,2,0,"EXTREMADURA UNIDA",0
10,"10012",553,427,421,1,6,"EXTREMADURA UNIDA",1
10,"10091",351,275,271,2,4,"EXTREMADURA UNIDA",1
10,"10172",696,447,443,5,4,"EXTREMADURA UNIDA",1
10,"10077",626,444,441,5,3,"EXTREMADURA UNIDA",0
10,"10082",1793,1333,1305,11,28,"EXTREMADURA UNIDA",4
10,"10153",281,183,181,0,2,"EXTREMADURA UNIDA",3
10,"10145",123,90,84,0,6,"EXTREMADURA UNIDA",1
10,"10109",1714,1030,1006,4,24,"EXTREMADURA UNIDA",7
10,"10023",842,597,589,2,8,"EXTREMADURA UNIDA",2
10,"10065",199,135,135,0,0,"EXTREMADURA UNIDA",0
10,"10081",176,121,119,0,2,"EXTREMADURA UNIDA",0
10,"10041",1022,720,706,2,14,"EXTREMADURA UNIDA",7
10,"10213",533,397,385,0,12,"EXTREMADURA UNIDA",2
10,"10105",2442,1541,1515,11,26,"EXTREMADURA UNIDA",6
10,"10147",1277,873,837,6,36,"EXTREMADURA UNIDA",2
10,"10106",126,102,102,0,0,"EXTREMADURA UNIDA",0
10,"10209",259,151,149,0,2,"EXTREMADURA UNIDA",1
10,"10067",10210,7090,6946,62,144,"EXTREMADURA UNIDA",41
10,"10071",126,78,71,0,7,"EXTREMADURA UNIDA",0
10,"10031",162,128,124,0,4,"EXTREMADURA UNIDA",11
10,"10135",1240,834,826,3,8,"EXTREMADURA UNIDA",2
10,"10009",255,165,162,1,3,"EXTREMADURA UNIDA",0
10,"10174",171,112,110,0,2,"EXTREMADURA UNIDA",0
10,"10173",558,389,385,5,4,"EXTREMADURA UNIDA",8
10,"10039",400,256,217,0,39,"EXTREMADURA UNIDA",1
10,"10073",733,513,499,8,14,"EXTREMADURA UNIDA",1
10,"10122",219,159,157,2,2,"EXTREMADURA UNIDA",1
10,"10117",238,133,130,0,3,"EXTREMADURA UNIDA",0
10,"10904",714,487,473,8,14,"EXTREMADURA UNIDA",1
10,"10903",806,555,545,8,10,"EXTREMADURA UNIDA",3
10,"10053",279,171,169,1,2,"EXTREMADURA UNIDA",0
10,"10085",310,219,219,1,0,"EXTREMADURA UNIDA",0
10,"10068",707,532,521,4,11,"EXTREMADURA UNIDA",2
10,"10026",647,464,452,6,12,"EXTREMADURA UNIDA",7
10,"10066",161,121,120,1,1,"EXTREMADURA UNIDA",0
10,"10134",550,361,354,1,7,"EXTREMADURA UNIDA",1
10,"10215",438,266,262,2,4,"EXTREMADURA UNIDA",1
10,"10143",141,109,105,0,4,"EXTREMADURA UNIDA",0
10,"10129",340,234,227,2,7,"EXTREMADURA UNIDA",3
10,"10047",938,710,694,1,16,"EXTREMADURA UNIDA",4
10,"10179",272,209,209,2,0,"EXTREMADURA UNIDA",1
10,"10021",4987,3574,3475,31,99,"EXTREMADURA UNIDA",21
10,"10188",483,354,340,0,14,"EXTREMADURA UNIDA",1
10,"10202",583,457,453,1,4,"EXTREMADURA UNIDA",7
10,"10013",265,184,182,0,2,"EXTREMADURA UNIDA",0
10,"10095",317,245,239,0,6,"EXTREMADURA UNIDA",1
10,"10161",81,50,50,0,0,"EXTREMADURA UNIDA",0
10,"10094",220,167,165,0,2,"EXTREMADURA UNIDA",2
10,"10020",1571,1135,1117,2,18,"EXTREMADURA UNIDA",0
10,"10214",216,170,170,2,0,"EXTREMADURA UNIDA",0
10,"10006",1224,907,893,7,14,"EXTREMADURA UNIDA",1
10,"10050",987,707,704,4,3,"EXTREMADURA UNIDA",1
10,"10158",344,247,246,7,1,"EXTREMADURA UNIDA",0
10,"10163",348,239,238,2,1,"EXTREMADURA UNIDA",3
10,"10203",4421,2810,2764,15,46,"EXTREMADURA UNIDA",27
10,"10186",951,756,735,6,21,"EXTREMADURA UNIDA",0
10,"10007",627,457,447,3,10,"EXTREMADURA UNIDA",0
10,"10054",523,389,380,1,9,"EXTREMADURA UNIDA",1
10,"10140",1109,778,769,7,9,"EXTREMADURA UNIDA",1
10,"10017",775,554,545,1,9,"EXTREMADURA UNIDA",2
10,"10112",1495,1071,1049,7,22,"EXTREMADURA UNIDA",2
10,"10175",1351,918,901,8,17,"EXTREMADURA UNIDA",2
10,"10052",172,114,113,3,1,"EXTREMADURA UNIDA",0
10,"10210",489,314,313,2,1,"EXTREMADURA UNIDA",1
10,"10080",353,243,238,1,5,"EXTREMADURA UNIDA",0
10,"10075",238,150,148,0,2,"EXTREMADURA UNIDA",0
10,"10033",397,269,268,0,1,"EXTREMADURA UNIDA",0
10,"10018",1605,974,948,16,26,"EXTREMADURA UNIDA",9
10,"10141",284,207,205,1,2,"EXTREMADURA UNIDA",2
10,"10162",519,401,394,4,7,"EXTREMADURA UNIDA",1
10,"10133",1159,914,893,4,21,"EXTREMADURA UNIDA",3
10,"10027",77,62,62,0,0,"EXTREMADURA UNIDA",0
10,"10108",203,116,116,1,0,"EXTREMADURA UNIDA",0
10,"10148",33054,21731,21379,231,352,"EXTREMADURA UNIDA",169
10,"10150",339,279,275,3,4,"EXTREMADURA UNIDA",0
10,"10116",3737,2579,2507,34,72,"EXTREMADURA UNIDA",12
10,"10064",1400,998,972,3,26,"EXTREMADURA UNIDA",0
10,"10051",421,316,308,0,8,"EXTREMADURA UNIDA",0
10,"10097",107,84,80,0,4,"EXTREMADURA UNIDA",0
10,"10169",497,370,366,0,4,"EXTREMADURA UNIDA",2
10,"10001",287,207,203,2,4,"EXTREMADURA UNIDA",2
10,"10043",746,525,520,4,5,"EXTREMADURA UNIDA",1
10,"10040",426,301,289,2,12,"EXTREMADURA UNIDA",5
10,"10152",444,312,309,2,3,"EXTREMADURA UNIDA",0
10,"10146",1494,924,903,1,21,"EXTREMADURA UNIDA",1
10,"10102",496,378,377,1,1,"EXTREMADURA UNIDA",0
10,"10011",518,385,370,2,15,"EXTREMADURA UNIDA",1
10,"10166",307,197,195,0,2,"EXTREMADURA UNIDA",0
10,"10199",154,99,99,2,0,"EXTREMADURA UNIDA",2
10,"10160",240,179,177,2,2,"EXTREMADURA UNIDA",0
10,"10048",202,141,139,0,2,"EXTREMADURA UNIDA",0
10,"10196",294,208,206,3,2,"EXTREMADURA UNIDA",0
10,"10136",274,205,202,1,3,"EXTREMADURA UNIDA",1
10,"10123",575,450,438,1,12,"EXTREMADURA UNIDA",0
10,"10049",3752,2949,2864,25,85,"EXTREMADURA UNIDA",18
10,"10060",921,615,596,4,19,"EXTREMADURA UNIDA",1
10,"10107",1019,766,755,12,11,"EXTREMADURA UNIDA",2
10,"10189",2499,1747,1700,15,47,"EXTREMADURA UNIDA",9
10,"10035",1798,1201,1171,8,30,"EXTREMADURA UNIDA",8
10,"10156",97,71,69,0,2,"EXTREMADURA UNIDA",2
10,"10207",455,298,291,0,7,"EXTREMADURA UNIDA",0
10,"10038",83,59,59,0,0,"EXTREMADURA UNIDA",1
10,"10120",153,97,97,0,0,"EXTREMADURA UNIDA",2
10,"10190",513,334,325,10,9,"EXTREMADURA UNIDA",2
10,"10216",1518,1082,1056,11,26,"EXTREMADURA UNIDA",3
10,"10032",1588,1114,1099,6,15,"EXTREMADURA UNIDA",6
10,"10005",527,325,301,1,24,"EXTREMADURA UNIDA",1
10,"10046",184,144,140,0,4,"EXTREMADURA UNIDA",1
10,"10217",506,378,377,3,1,"EXTREMADURA UNIDA",0
10,"10176",344,223,213,2,10,"EXTREMADURA UNIDA",0
10,"10093",387,278,253,4,25,"EXTREMADURA UNIDA",0
10,"10024",672,492,480,6,12,"EXTREMADURA UNIDA",1
10,"10119",574,417,414,2,3,"EXTREMADURA UNIDA",1
10,"10187",431,288,281,0,7,"EXTREMADURA UNIDA",0
10,"10193",1392,1045,1025,6,20,"EXTREMADURA UNIDA",3
10,"10901",1161,758,753,1,5,"EXTREMADURA UNIDA",6
10,"10205",1934,1071,1042,4,29,"EXTREMADURA UNIDA",6
10,"10028",83,62,61,1,1,"EXTREMADURA UNIDA",1
10,"10182",122,81,81,0,0,"EXTREMADURA UNIDA",0
10,"10029",380,284,276,0,8,"EXTREMADURA UNIDA",0
10,"10063",159,130,130,0,0,"EXTREMADURA UNIDA",0
10,"10019",1412,948,934,2,14,"EXTREMADURA UNIDA",6
10,"10010",2206,1308,1281,8,27,"EXTREMADURA UNIDA",3
10,"10114",964,644,637,6,7,"EXTREMADURA UNIDA",2
10,"10127",4691,3044,2974,34,70,"EXTREMADURA UNIDA",13
10,"10905",636,443,433,7,10,"EXTREMADURA UNIDA",2
10,"10057",126,90,89,1,1,"EXTREMADURA UNIDA",0
10,"10201",178,142,141,2,1,"EXTREMADURA UNIDA",1
10,"10110",2226,1431,1400,7,31,"EXTREMADURA UNIDA",9
10,"10004",692,482,473,8,9,"EXTREMADURA UNIDA",1
10,"10089",1334,864,837,8,27,"EXTREMADURA UNIDA",9
10,"10036",304,194,192,4,2,"EXTREMADURA UNIDA",2
10,"10090",489,307,302,1,5,"EXTREMADURA UNIDA",0
10,"10181",676,470,462,2,8,"EXTREMADURA UNIDA",1
10,"10022",409,301,291,1,10,"EXTREMADURA UNIDA",0
10,"10902",744,514,498,4,16,"EXTREMADURA UNIDA",2
10,"10194",524,408,404,2,4,"EXTREMADURA UNIDA",2
10,"10099",563,369,358,3,11,"EXTREMADURA UNIDA",1
10,"10137",394,297,296,3,1,"EXTREMADURA UNIDA",1
10,"10092",260,201,200,1,1,"EXTREMADURA UNIDA",1
10,"10180",4206,2609,2574,13,35,"EXTREMADURA UNIDA",15
10,"10002",360,239,236,1,3,"EXTREMADURA UNIDA",0
10,"10178",724,499,494,3,5,"EXTREMADURA UNIDA",5
10,"10124",867,622,612,1,10,"EXTREMADURA UNIDA",0
10,"10149",432,284,280,2,4,"EXTREMADURA UNIDA",2
10,"10183",950,696,684,3,12,"EXTREMADURA UNIDA",3
10,"10128",5618,3799,3630,37,169,"EXTREMADURA UNIDA",16
10,"10155",1073,735,717,6,18,"EXTREMADURA UNIDA",2
10,"10195",7514,5243,5148,47,95,"EXTREMADURA UNIDA",18
10,"10088",198,112,112,1,0,"EXTREMADURA UNIDA",0
10,"10059",329,202,201,1,1,"EXTREMADURA UNIDA",0
10,"10113",2231,1534,1508,14,26,"EXTREMADURA UNIDA",10
10,"10139",92,66,65,1,1,"EXTREMADURA UNIDA",0
10,"10015",630,429,424,1,5,"EXTREMADURA UNIDA",2
10,"10101",178,129,125,0,4,"EXTREMADURA UNIDA",1
10,"10044",1405,968,955,11,13,"EXTREMADURA UNIDA",4
10,"10062",389,303,299,2,4,"EXTREMADURA UNIDA",4
10,"10191",511,374,365,5,9,"EXTREMADURA UNIDA",1
10,"10100",783,494,447,5,47,"EXTREMADURA UNIDA",0
10,"10058",979,628,599,6,29,"EXTREMADURA UNIDA",8
10,"10164",707,391,382,4,9,"EXTREMADURA UNIDA",4
10,"10131",12803,8477,8347,77,130,"EXTREMADURA UNIDA",64
10,"10198",1053,897,889,4,8,"EXTREMADURA UNIDA",1
10,"10104",5123,3470,3396,21,74,"EXTREMADURA UNIDA",23
10,"10170",231,164,162,2,2,"EXTREMADURA UNIDA",2
10,"10171",347,238,219,1,19,"EXTREMADURA UNIDA",0
10,"10061",1591,1010,992,9,18,"EXTREMADURA UNIDA",6
10,"10206",196,135,133,0,2,"EXTREMADURA UNIDA",1
10,"10083",96,76,74,0,2,"EXTREMADURA UNIDA",1
10,"10200",336,243,242,0,1,"EXTREMADURA UNIDA",0
10,"10185",558,376,374,2,2,"EXTREMADURA UNIDA",1
10,"10087",1588,1105,1093,10,12,"EXTREMADURA UNIDA",4
10,"10056",533,377,371,2,6,"EXTREMADURA UNIDA",0
10,"10118",278,232,231,1,1,"EXTREMADURA UNIDA",0
10,"10086",304,228,225,4,3,"EXTREMADURA UNIDA",2
10,"10072",837,545,539,5,6,"EXTREMADURA UNIDA",1
10,"10168",320,210,206,1,4,"EXTREMADURA UNIDA",2
10,"10154",177,117,116,0,1,"EXTREMADURA UNIDA",3
10,"10045",971,686,682,4,4,"EXTREMADURA UNIDA",1
10,"10079",848,641,632,2,9,"EXTREMADURA UNIDA",12
10,"10037",76966,54717,53914,546,803,"EXTREMADURA UNIDA",433
10,"10070",667,493,489,1,4,"EXTREMADURA UNIDA",1
10,"10121",7882,5294,5183,42,111,"EXTREMADURA UNIDA",19
10,"10115",3460,2584,2503,15,81,"EXTREMADURA UNIDA",21
10,"10151",189,145,142,2,3,"EXTREMADURA UNIDA",0
10,"10212",1658,1113,1068,19,45,"EXTREMADURA UNIDA",9
10,"10055",697,488,473,3,15,"EXTREMADURA UNIDA",2
10,"10142",833,555,539,0,16,"EXTREMADURA UNIDA",3
10,"10211",446,303,300,0,3,"EXTREMADURA UNIDA",1
10,"10025",377,308,299,3,9,"EXTREMADURA UNIDA",4
10,"10208",122,85,83,0,2,"EXTREMADURA UNIDA",0
10,"10177",1702,1241,1186,10,55,"EXTREMADURA UNIDA",10
10,"10042",85,58,58,0,0,"EXTREMADURA UNIDA",0
10,"10030",455,311,305,2,6,"EXTREMADURA UNIDA",4
10,"10132",360,251,243,1,8,"EXTREMADURA UNIDA",0
10,"10103",422,290,286,1,4,"EXTREMADURA UNIDA",2
10,"10184",734,520,511,4,9,"EXTREMADURA UNIDA",1
10,"10126",1455,966,948,9,18,"EXTREMADURA UNIDA",1
10,"10084",1266,755,717,7,38,"EXTREMADURA UNIDA",2
10,"10125",859,561,546,3,15,"EXTREMADURA UNIDA",2
10,"10197",106,74,74,0,0,"EXTREMADURA UNIDA",0
10,"10008",1274,921,908,1,13,"EXTREMADURA UNIDA",4
10,"10165",252,204,201,3,3,"EXTREMADURA UNIDA",1
10,"10144",915,618,614,0,4,"EXTREMADURA UNIDA",2
10,"10204",423,289,287,1,2,"EXTREMADURA UNIDA",2
10,"10003",543,350,335,0,15,"EXTREMADURA UNIDA",2
10,"10219",1184,698,686,9,12,"EXTREMADURA UNIDA",3
10,"10096",3311,2248,2201,15,47,"EXTREMADURA UNIDA",4
10,"10014",1816,1285,1254,13,31,"EXTREMADURA UNIDA",3
10,"10218",1074,685,672,0,13,"EXTREMADURA UNIDA",2
10,"10069",786,566,554,3,12,"EXTREMADURA UNIDA",0
10,"10076",791,537,525,10,12,"EXTREMADURA UNIDA",1
10,"10130",1754,1199,1189,10,10,"EXTREMADURA UNIDA",5
10,"10157",246,163,161,0,2,"EXTREMADURA UNIDA",1
10,"10016",329,242,232,2,10,"EXTREMADURA UNIDA",4
10,"10034",337,244,240,0,4,"EXTREMADURA UNIDA",0
10,"10111",1297,888,872,11,16,"EXTREMADURA UNIDA",5
10,"10192",777,567,563,3,4,"EXTREMADURA UNIDA",0
10,"10138",527,386,379,2,7,"EXTREMADURA UNIDA",2
10,"10098",387,272,267,0,5,"EXTREMADURA UNIDA",0
5,"5046",38,35,35,0,0,"FE de las J",0
47,"47087",362,272,268,1,4,"FE de las J",0
34,"34234",66,48,45,0,3,"FE de las J",0
47,"47203",54,40,40,0,0,"FE de las J",0
5,"5229",75,61,61,1,0,"FE de las J",0
47,"47198",64,43,43,0,0,"FE de las J",0
5,"5066",435,344,341,2,3,"FE de las J",0
47,"47146",275,215,214,1,1,"FE de las J",0
47,"47185",82,62,61,1,1,"FE de las J",0
34,"34133",101,75,73,0,2,"FE de las J",1
19,"19031",8,8,8,0,0,"FE de las J",0
34,"34165",57,45,44,1,1,"FE de las J",0
19,"19132",86,65,63,0,2,"FE de las J",0
19,"19291",1143,803,794,2,9,"FE de las J",0
5,"5113",62,42,42,0,0,"FE de las J",0
12,"12034",1389,1022,1002,5,20,"FE de las J",0
5,"5903",137,84,83,0,1,"FE de las J",0
5,"5014",5263,3699,3648,35,51,"FE de las J",3
12,"12053",2040,1587,1579,8,8,"FE de las J",0
47,"47019",92,68,68,1,0,"FE de las J",0
47,"47172",135,114,113,0,1,"FE de las J",1
5,"5093",362,251,249,0,2,"FE de las J",0
47,"47129",855,660,648,7,12,"FE de las J",0
19,"19167",129,104,103,1,1,"FE de las J",0
19,"19061",56,42,41,0,1,"FE de las J",0
19,"19259",28,22,22,0,0,"FE de las J",0
34,"34167",110,84,83,0,1,"FE de las J",0
19,"19250",16,12,12,0,0,"FE de las J",0
5,"5012",117,88,88,1,0,"FE de las J",0
12,"12025",116,82,79,1,3,"FE de las J",0
47,"47026",50,37,37,1,0,"FE de las J",0
5,"5015",68,45,44,1,1,"FE de las J",1
5,"5072",92,74,72,1,2,"FE de las J",0
34,"34049",329,229,227,1,2,"FE de las J",1
5,"5179",199,176,172,1,4,"FE de las J",0
5,"5101",266,206,205,1,1,"FE de las J",0
5,"5211",425,336,330,2,6,"FE de las J",0
34,"34062",148,94,93,0,1,"FE de las J",1
34,"34220",152,133,132,1,1,"FE de las J",0
5,"5106",27,14,14,0,0,"FE de las J",0
34,"34134",44,25,25,0,0,"FE de las J",0
34,"34057",464,308,302,4,6,"FE de las J",0
47,"47171",375,295,290,9,5,"FE de las J",0
19,"19237",39,34,34,0,0,"FE de las J",0
12,"12051",437,297,295,3,2,"FE de las J",0
34,"34189",53,33,33,0,0,"FE de las J",0
47,"47145",583,430,426,6,4,"FE de las J",0
5,"5069",73,59,59,0,0,"FE de las J",0
5,"5170",47,34,34,1,0,"FE de las J",0
5,"5221",322,231,231,0,0,"FE de las J",0
19,"19020",46,31,31,0,0,"FE de las J",0
19,"19138",215,158,154,4,4,"FE de las J",0
34,"34170",50,30,30,1,0,"FE de las J",0
5,"5096",76,62,62,0,0,"FE de las J",0
5,"5001",182,139,138,1,1,"FE de las J",0
12,"12026",828,577,566,11,11,"FE de las J",0
5,"5037",210,135,135,0,0,"FE de las J",0
19,"19288",21,20,20,2,0,"FE de las J",0
19,"19076",29,23,23,0,0,"FE de las J",0
12,"12072",1083,852,827,10,25,"FE de las J",1
47,"47186",244314,182449,180833,1818,1616,"FE de las J",88
19,"19055",44,32,31,2,1,"FE de las J",0
34,"34087",125,99,99,2,0,"FE de las J",0
12,"12055",103,77,76,2,1,"FE de las J",0
5,"5081",37,21,21,3,0,"FE de las J",0
34,"34174",172,142,136,0,6,"FE de las J",0
47,"47056",81,57,57,0,0,"FE de las J",0
19,"19013",111,89,89,0,0,"FE de las J",0
47,"47058",199,126,125,3,1,"FE de las J",0
34,"34171",928,572,562,2,10,"FE de las J",0
12,"12022",323,257,254,5,3,"FE de las J",0
5,"5010",142,102,100,2,2,"FE de las J",0
19,"19270",14,13,13,0,0,"FE de las J",0
34,"34112",39,31,31,0,0,"FE de las J",0
19,"19334",43,35,35,0,0,"FE de las J",0
5,"5267",103,67,67,1,0,"FE de las J",0
12,"12004",4149,2945,2910,25,35,"FE de las J",1
12,"12050",1226,904,891,3,13,"FE de las J",0
5,"5902",286,214,211,1,3,"FE de las J",0
47,"47161",3970,3111,3089,24,22,"FE de las J",1
19,"19283",29,26,26,0,0,"FE de las J",0
12,"12087",26,16,16,0,0,"FE de las J",0
19,"19324",164,122,120,4,2,"FE de las J",0
12,"12043",570,405,397,1,8,"FE de las J",0
5,"5181",46,34,34,0,0,"FE de las J",0
34,"34242",91,65,62,2,3,"FE de las J",0
34,"34100",132,96,95,1,1,"FE de las J",1
5,"5103",63,44,44,1,0,"FE de las J",0
12,"12077",4828,3395,3357,28,38,"FE de las J",3
12,"12080",1883,1472,1438,8,34,"FE de las J",0
12,"12012",2622,2084,2056,12,28,"FE de las J",4
47,"47113",134,110,110,0,0,"FE de las J",0
34,"34241",17,17,16,3,1,"FE de las J",0
47,"47004",1135,878,872,5,6,"FE de las J",0
5,"5239",215,163,163,3,0,"FE de las J",1
34,"34141",176,149,146,0,3,"FE de las J",2
47,"47176",199,110,110,0,0,"FE de las J",0
34,"34018",199,151,149,4,2,"FE de las J",0
47,"47008",22,13,13,0,0,"FE de las J",0
12,"12058",59,47,45,1,2,"FE de las J",0
19,"19209",40,30,29,0,1,"FE de las J",0
5,"5212",197,117,117,0,0,"FE de las J",0
47,"47144",72,54,53,2,1,"FE de las J",0
5,"5079",66,53,52,0,1,"FE de las J",0
47,"47227",53,36,35,0,1,"FE de las J",0
5,"5204",578,445,442,3,3,"FE de las J",0
47,"47059",94,64,64,0,0,"FE de las J",0
19,"19301",37,26,26,0,0,"FE de las J",0
5,"5234",45,38,38,0,0,"FE de las J",0
34,"34229",58,47,47,1,0,"FE de las J",0
34,"34001",39,27,27,1,0,"FE de las J",0
47,"47183",135,100,100,1,0,"FE de las J",0
19,"19146",47,35,35,0,0,"FE de las J",0
19,"19090",90,69,68,1,1,"FE de las J",0
34,"34003",147,104,103,0,1,"FE de las J",0
5,"5190",53,44,43,0,1,"FE de las J",0
5,"5159",224,133,132,3,1,"FE de las J",0
19,"19181",50,34,34,0,0,"FE de las J",0
19,"19042",22,18,17,0,1,"FE de las J",0
19,"19303",41,32,32,0,0,"FE de las J",0
12,"12120",149,125,121,3,4,"FE de las J",0
47,"47154",146,115,111,6,4,"FE de las J",0
47,"47208",53,35,35,1,0,"FE de las J",0
19,"19319",4609,3303,3273,22,30,"FE de las J",2
34,"34196",87,67,67,3,0,"FE de las J",0
19,"19274",953,693,676,9,17,"FE de las J",1
5,"5048",107,89,88,2,1,"FE de las J",0
5,"5094",133,105,105,0,0,"FE de las J",0
19,"19080",67,47,47,0,0,"FE de las J",0
47,"47001",52,43,42,1,1,"FE de las J",0
5,"5022",1580,1202,1193,6,9,"FE de las J",0
19,"19169",30,27,27,0,0,"FE de las J",0
5,"5200",41,26,26,0,0,"FE de las J",0
5,"5257",132,98,95,4,3,"FE de las J",0
34,"34139",160,117,115,2,2,"FE de las J",0
34,"34071",158,128,128,2,0,"FE de las J",0
19,"19052",21,16,16,0,0,"FE de las J",0
19,"19325",154,86,86,1,0,"FE de las J",0
5,"5084",66,44,44,0,0,"FE de las J",0
12,"12089",4555,3070,3045,22,25,"FE de las J",2
12,"12007",724,622,614,2,8,"FE de las J",0
5,"5183",123,103,100,0,3,"FE de las J",0
19,"19133",78,64,64,2,0,"FE de las J",0
5,"5176",221,163,159,0,4,"FE de las J",0
5,"5038",114,83,82,0,1,"FE de las J",0
34,"34123",1634,1274,1258,4,16,"FE de las J",0
19,"19108",95,78,78,0,0,"FE de las J",0
5,"5029",100,73,73,1,0,"FE de las J",0
5,"5264",54,32,31,4,1,"FE de las J",0
19,"19309",20,15,14,0,1,"FE de las J",0
34,"34010",550,407,399,7,8,"FE de las J",0
47,"47204",235,159,157,3,2,"FE de las J",0
5,"5240",3346,2259,2232,11,27,"FE de las J",2
19,"19102",88,75,73,0,2,"FE de las J",1
34,"34201",171,131,130,1,1,"FE de las J",0
34,"34011",379,290,284,2,6,"FE de las J",0
19,"19290",851,551,550,4,1,"FE de las J",2
19,"19124",378,230,229,2,1,"FE de las J",0
5,"5026",183,149,147,1,2,"FE de las J",1
47,"47109",161,120,120,1,0,"FE de las J",0
34,"34045",72,62,62,0,0,"FE de las J",0
34,"34192",76,59,59,0,0,"FE de las J",0
47,"47205",355,248,244,2,4,"FE de las J",0
47,"47081",39,32,32,0,0,"FE de las J",0
19,"19261",33,23,23,0,0,"FE de las J",0
19,"19335",51,39,38,0,1,"FE de las J",0
12,"12029",670,524,514,5,10,"FE de las J",0
5,"5045",81,58,58,0,0,"FE de las J",0
47,"47077",234,172,170,1,2,"FE de las J",0
5,"5133",61,44,43,0,1,"FE de las J",0
34,"34063",84,74,74,1,0,"FE de las J",0
47,"47047",199,136,135,4,1,"FE de las J",0
19,"19065",109,86,85,1,1,"FE de las J",0
19,"19218",43,31,31,0,0,"FE de las J",0
19,"19113",454,327,322,4,5,"FE de las J",0
19,"19282",138,107,106,0,1,"FE de las J",0
34,"34155",122,95,95,0,0,"FE de las J",0
12,"12006",177,133,133,2,0,"FE de las J",0
5,"5254",184,149,147,1,2,"FE de las J",0
47,"47068",29,21,21,0,0,"FE de las J",0
19,"19265",134,97,97,5,0,"FE de las J",0
5,"5126",60,47,45,0,2,"FE de las J",0
47,"47165",6823,4999,4906,48,93,"FE de las J",2
34,"34076",532,443,438,1,5,"FE de las J",0
19,"19008",36,30,30,0,0,"FE de las J",0
47,"47010",14718,11521,11392,137,129,"FE de las J",3
12,"12137",40,28,28,0,0,"FE de las J",0
5,"5143",59,52,51,1,1,"FE de las J",0
47,"47175",6755,4950,4870,49,80,"FE de las J",1
47,"47112",2561,1960,1933,13,27,"FE de las J",0
5,"5209",74,58,58,1,0,"FE de las J",0
34,"34088",265,195,191,1,4,"FE de las J",0
47,"47060",224,171,168,1,3,"FE de las J",0
19,"19034",25,22,21,0,1,"FE de las J",0
5,"5023",174,148,145,2,3,"FE de las J",0
5,"5016",6355,4677,4584,28,93,"FE de las J",4
47,"47188",98,73,70,0,3,"FE de las J",0
19,"19127",88,60,60,1,0,"FE de las J",0
19,"19153",22,20,20,2,0,"FE de las J",0
5,"5077",154,113,110,0,3,"FE de las J",0
47,"47133",2776,2096,2073,28,23,"FE de las J",4
12,"12094",871,671,661,1,10,"FE de las J",1
19,"19022",592,423,420,6,3,"FE de las J",1
5,"5161",545,395,395,0,0,"FE de las J",1
5,"5196",57,43,43,0,0,"FE de las J",0
34,"34004",5517,3819,3769,36,50,"FE de las J",3
47,"47131",167,122,120,2,2,"FE de las J",0
5,"5125",56,47,46,0,1,"FE de las J",0
5,"5189",397,293,291,3,2,"FE de las J",0
34,"34055",254,185,184,3,1,"FE de las J",0
5,"5120",33,26,26,0,0,"FE de las J",0
47,"47050",3908,2713,2673,39,40,"FE de las J",3
34,"34061",91,70,69,1,1,"FE de las J",0
19,"19249",29,26,26,0,0,"FE de las J",0
19,"19036",242,202,200,1,2,"FE de las J",0
19,"19103",247,205,202,1,3,"FE de las J",0
47,"47088",101,79,79,0,0,"FE de las J",0
19,"19067",68,46,44,0,2,"FE de las J",0
47,"47196",29,21,21,0,0,"FE de las J",0
34,"34082",78,59,58,0,1,"FE de las J",0
47,"47073",116,80,79,2,1,"FE de las J",0
34,"34230",16,11,11,0,0,"FE de las J",0
19,"19114",30,22,21,1,1,"FE de las J",0
47,"47194",295,228,227,1,1,"FE de las J",0
47,"47210",399,278,275,3,3,"FE de las J",0
19,"19051",61,52,52,0,0,"FE de las J",0
34,"34204",50,35,35,0,0,"FE de las J",0
19,"19091",23,17,17,0,0,"FE de las J",0
19,"19079",7,6,6,0,0,"FE de las J",0
19,"19111",160,128,125,0,3,"FE de las J",0
19,"19005",91,63,62,0,1,"FE de las J",0
47,"47135",82,65,65,3,0,"FE de las J",0
34,"34113",40,38,38,0,0,"FE de las J",0
5,"5027",258,209,203,5,6,"FE de las J",0
12,"12015",115,94,94,0,0,"FE de las J",0
12,"12085",5081,3271,3235,17,36,"FE de las J",2
47,"47025",114,85,85,3,0,"FE de las J",0
5,"5132",857,548,539,7,9,"FE de las J",0
5,"5123",106,78,78,0,0,"FE de las J",0
19,"19078",47,37,36,0,1,"FE de las J",0
19,"19257",3279,2233,2206,21,27,"FE de las J",0
47,"47152",67,59,59,0,0,"FE de las J",0
34,"34211",171,154,153,2,1,"FE de las J",0
19,"19212",678,501,491,1,10,"FE de las J",0
47,"47119",89,59,58,2,1,"FE de las J",0
12,"12102",518,424,417,4,7,"FE de las J",0
19,"19323",36,26,26,0,0,"FE de las J",0
34,"34032",38,30,30,0,0,"FE de las J",0
19,"19332",85,59,57,4,2,"FE de las J",0
34,"34103",96,79,76,0,3,"FE de las J",0
12,"12135",36287,25912,25655,184,257,"FE de las J",14
19,"19314",44,33,33,0,0,"FE de las J",0
47,"47168",30,26,26,1,0,"FE de las J",0
5,"5075",96,76,76,0,0,"FE de las J",0
47,"47230",285,209,206,1,3,"FE de las J",0
5,"5041",984,743,732,5,11,"FE de las J",0
12,"12024",138,107,107,1,0,"FE de las J",0
34,"34210",98,82,82,1,0,"FE de las J",0
5,"5197",100,82,79,1,3,"FE de las J",0
12,"12103",87,61,60,0,1,"FE de las J",0
5,"5165",361,266,261,4,5,"FE de las J",0
19,"19139",26,19,19,2,0,"FE de las J",0
5,"5082",491,379,369,2,10,"FE de las J",0
47,"47115",276,212,211,1,1,"FE de las J",0
19,"19241",35,26,25,2,1,"FE de las J",0
47,"47090",2447,1823,1784,15,39,"FE de las J",1
19,"19150",116,89,89,0,0,"FE de las J",0
19,"19222",95,70,70,2,0,"FE de las J",0
5,"5243",80,57,56,1,1,"FE de las J",0
34,"34102",197,158,156,1,2,"FE de las J",0
5,"5177",136,117,116,0,1,"FE de las J",0
12,"12076",72,54,54,0,0,"FE de las J",1
5,"5256",110,88,86,1,2,"FE de las J",1
19,"19032",145,94,93,2,1,"FE de las J",0
34,"34186",49,44,44,0,0,"FE de las J",0
47,"47089",133,111,111,2,0,"FE de las J",0
19,"19044",275,186,182,0,4,"FE de las J",0
5,"5149",101,72,71,2,1,"FE de las J",0
5,"5213",94,72,70,0,2,"FE de las J",0
5,"5073",282,210,207,1,3,"FE de las J",0
47,"47143",104,67,67,0,0,"FE de las J",0
19,"19299",100,72,71,1,1,"FE de las J",1
5,"5905",214,148,142,1,6,"FE de las J",0
47,"47164",349,283,281,1,2,"FE de las J",0
47,"47218",981,728,723,4,5,"FE de las J",0
12,"12130",414,329,327,0,2,"FE de las J",0
47,"47037",161,128,125,1,3,"FE de las J",0
12,"12097",62,53,51,0,2,"FE de las J",0
19,"19228",27,17,17,1,0,"FE de las J",0
19,"19304",224,169,166,3,3,"FE de las J",0
12,"12071",1272,936,925,3,11,"FE de las J",1
19,"19082",100,72,71,1,1,"FE de las J",0
19,"19300",782,591,588,5,3,"FE de las J",1
47,"47065",820,608,602,2,6,"FE de las J",0
34,"34116",54,35,35,0,0,"FE de las J",0
19,"19247",140,103,102,1,1,"FE de las J",0
34,"34176",127,95,90,3,5,"FE de las J",0
19,"19202",16,13,13,1,0,"FE de las J",0
12,"12088",57,53,53,0,0,"FE de las J",0
19,"19045",122,97,96,0,1,"FE de las J",0
47,"47048",175,124,122,0,2,"FE de las J",1
19,"19115",29,23,23,0,0,"FE de las J",0
47,"47167",245,198,198,1,0,"FE de las J",0
34,"34216",61,41,41,0,0,"FE de las J",0
47,"47137",29,25,25,0,0,"FE de las J",0
5,"5018",23,17,17,2,0,"FE de las J",0
12,"12092",123,95,95,0,0,"FE de las J",0
47,"47094",120,100,100,0,0,"FE de las J",0
47,"47002",18,18,18,0,0,"FE de las J",0
47,"47124",383,302,300,3,2,"FE de las J",0
5,"5105",330,247,242,2,5,"FE de las J",0
34,"34182",746,558,553,9,5,"FE de las J",0
34,"34181",422,289,285,0,4,"FE de las J",2
5,"5192",92,75,72,1,3,"FE de las J",0
5,"5097",464,309,305,0,4,"FE de las J",0
19,"19071",8277,5838,5763,53,75,"FE de las J",1
12,"12116",61,49,49,0,0,"FE de las J",0
47,"47085",16330,11556,11419,121,137,"FE de las J",1
19,"19040",53,43,42,1,1,"FE de las J",0
34,"34901",1053,762,759,10,3,"FE de las J",1
34,"34147",164,120,120,1,0,"FE de las J",0
5,"5102",1681,1252,1228,8,24,"FE de las J",1
47,"47110",445,335,327,1,8,"FE de las J",0
34,"34039",58,48,47,0,1,"FE de las J",0
34,"34048",62,51,51,1,0,"FE de las J",0
47,"47212",356,289,287,4,2,"FE de las J",2
19,"19049",8,8,7,0,1,"FE de las J",0
12,"12010",232,191,187,3,4,"FE de las J",0
47,"47069",115,87,87,0,0,"FE de las J",0
47,"47100",118,93,87,2,6,"FE de las J",0
19,"19173",47,40,40,0,0,"FE de las J",0
5,"5186",1564,1140,1125,5,15,"FE de las J",1
5,"5242",679,571,562,9,9,"FE de las J",0
5,"5265",83,59,58,1,1,"FE de las J",0
12,"12070",505,407,398,2,9,"FE de las J",0
5,"5168",3503,2536,2511,29,25,"FE de las J",2
47,"47181",165,136,135,1,1,"FE de las J",0
34,"34151",148,98,96,1,2,"FE de las J",0
34,"34080",5231,3207,3161,35,46,"FE de las J",3
47,"47024",223,170,168,1,2,"FE de las J",0
12,"12112",102,79,79,1,0,"FE de las J",0
12,"12009",17943,12389,12292,102,97,"FE de las J",6
34,"34042",294,224,221,1,3,"FE de las J",2
19,"19227",68,42,41,1,1,"FE de las J",0
5,"5112",95,59,58,0,1,"FE de las J",0
47,"47118",147,97,97,2,0,"FE de las J",0
47,"47192",89,78,76,3,2,"FE de las J",0
19,"19156",917,686,679,2,7,"FE de las J",1
47,"47055",188,147,147,2,0,"FE de las J",0
47,"47141",112,90,89,0,1,"FE de las J",0
34,"34205",55,38,38,0,0,"FE de las J",0
19,"19231",10,6,6,0,0,"FE de las J",0
5,"5080",42,30,30,0,0,"FE de las J",0
5,"5195",199,125,125,1,0,"FE de las J",0
34,"34180",68,54,54,1,0,"FE de las J",5
47,"47015",177,129,129,0,0,"FE de las J",0
19,"19268",50,37,35,0,2,"FE de las J",0
34,"34073",180,123,120,3,3,"FE de las J",0
12,"12069",50,38,38,0,0,"FE de las J",0
34,"34184",49,37,35,0,2,"FE de las J",0
19,"19018",142,112,112,1,0,"FE de las J",0
47,"47150",253,193,187,3,6,"FE de las J",0
5,"5207",645,485,478,4,7,"FE de las J",0
19,"19235",98,77,76,1,1,"FE de las J",0
5,"5174",62,51,51,1,0,"FE de las J",0
12,"12121",1043,878,856,5,22,"FE de las J",1
47,"47215",48,43,43,0,0,"FE de las J",0
12,"12059",220,183,183,2,0,"FE de las J",0
19,"19190",2284,1632,1613,16,19,"FE de las J",1
5,"5128",339,258,253,5,5,"FE de las J",0
5,"5025",78,65,65,0,0,"FE de las J",0
12,"12079",414,310,305,2,5,"FE de las J",0
34,"34127",80,62,62,0,0,"FE de las J",0
47,"47147",103,86,82,0,4,"FE de las J",0
47,"47103",252,195,192,1,3,"FE de las J",0
34,"34052",164,127,125,1,2,"FE de las J",0
34,"34047",1711,1275,1248,18,27,"FE de las J",1
34,"34185",69,36,35,0,1,"FE de las J",0
47,"47044",323,273,270,4,3,"FE de las J",1
12,"12131",97,87,87,0,0,"FE de las J",0
5,"5005",165,127,119,0,8,"FE de las J",0
19,"19179",74,64,64,3,0,"FE de las J",0
12,"12061",374,263,261,4,2,"FE de las J",0
34,"34017",889,676,665,7,11,"FE de las J",2
5,"5169",218,171,171,1,0,"FE de las J",0
5,"5222",140,118,118,0,0,"FE de las J",0
34,"34124",60,45,45,0,0,"FE de las J",0
34,"34225",5016,3708,3650,41,58,"FE de las J",5
5,"5115",509,350,344,0,6,"FE de las J",0
19,"19221",31,22,22,1,0,"FE de las J",0
47,"47228",432,324,320,2,4,"FE de las J",0
19,"19197",28,22,22,1,0,"FE de las J",0
5,"5148",22,19,19,0,0,"FE de las J",0
19,"19302",52,42,42,1,0,"FE de las J",0
19,"19171",5380,3964,3919,22,45,"FE de las J",2
19,"19116",12,10,10,0,0,"FE de las J",0
19,"19213",67,53,52,1,1,"FE de las J",0
34,"34034",112,82,82,1,0,"FE de las J",2
19,"19317",124,83,82,0,1,"FE de las J",0
19,"19242",74,53,53,1,0,"FE de las J",0
19,"19046",22204,16001,15752,156,249,"FE de las J",4
5,"5145",43,28,28,0,0,"FE de las J",0
47,"47016",65,55,55,0,0,"FE de las J",0
12,"12127",63,45,44,1,1,"FE de las J",0
19,"19033",47,38,37,1,1,"FE de las J",0
5,"5059",92,49,48,0,1,"FE de las J",1
34,"34157",2353,1697,1669,18,28,"FE de las J",0
19,"19233",79,65,65,2,0,"FE de las J",0
5,"5002",1905,1361,1329,11,32,"FE de las J",2
5,"5104",33,21,19,0,2,"FE de las J",0
19,"19330",69,62,62,0,0,"FE de las J",0
5,"5017",84,70,67,2,3,"FE de las J",0
12,"12040",119116,85613,84993,620,620,"FE de las J",32
19,"19050",15,13,13,0,0,"FE de las J",0
47,"47014",48,39,39,1,0,"FE de las J",0
5,"5208",39,32,32,0,0,"FE de las J",0
19,"19252",56,44,44,0,0,"FE de las J",0
19,"19263",21,15,15,0,0,"FE de las J",0
5,"5258",107,80,80,1,0,"FE de las J",0
34,"34101",48,36,36,1,0,"FE de las J",0
12,"12031",3960,2913,2869,13,44,"FE de las J",4
12,"12136",2603,2151,2119,20,32,"FE de las J",3
34,"34036",230,159,158,0,1,"FE de las J",1
5,"5063",31,26,26,0,0,"FE de las J",0
19,"19097",14,14,13,0,1,"FE de las J",0
34,"34143",161,115,112,2,3,"FE de las J",0
12,"12056",257,205,199,1,6,"FE de las J",0
5,"5129",111,70,69,0,1,"FE de las J",0
34,"34068",29,25,24,0,1,"FE de las J",0
47,"47158",859,618,608,4,10,"FE de las J",0
34,"34098",790,562,558,3,4,"FE de las J",0
34,"34033",18,14,14,0,0,"FE de las J",0
34,"34146",53,43,43,0,0,"FE de las J",0
19,"19142",263,179,179,1,0,"FE de las J",0
12,"12083",88,69,67,9,2,"FE de las J",0
34,"34006",79,73,69,2,4,"FE de las J",0
19,"19154",58,45,45,0,0,"FE de las J",0
47,"47053",123,101,97,3,4,"FE de las J",0
5,"5216",209,149,149,0,0,"FE de las J",0
19,"19245",1138,798,778,6,20,"FE de las J",0
5,"5142",88,76,75,0,1,"FE de las J",0
19,"19004",59,44,44,0,0,"FE de las J",0
47,"47149",46,33,32,1,1,"FE de las J",0
12,"12020",118,104,103,1,1,"FE de las J",2
5,"5238",728,529,525,1,4,"FE de las J",0
5,"5065",452,339,337,2,2,"FE de las J",1
34,"34224",39,25,25,0,0,"FE de las J",0
19,"19023",119,87,85,0,2,"FE de las J",1
34,"34240",84,67,66,1,1,"FE de las J",0
47,"47062",155,128,128,0,0,"FE de las J",0
47,"47174",271,215,213,4,2,"FE de las J",1
19,"19230",558,409,406,1,3,"FE de las J",0
47,"47195",426,314,310,2,4,"FE de las J",0
19,"19104",19,15,14,0,1,"FE de las J",0
5,"5232",104,86,83,1,3,"FE de las J",0
19,"19198",17,14,14,0,0,"FE de las J",0
19,"19226",37,22,22,0,0,"FE de las J",0
47,"47140",106,83,83,0,0,"FE de las J",0
19,"19041",163,118,117,1,1,"FE de las J",0
12,"12098",529,417,413,3,4,"FE de las J",0
5,"5262",318,238,235,1,3,"FE de las J",0
19,"19208",39,32,32,0,0,"FE de las J",0
5,"5008",202,158,155,0,3,"FE de las J",0
34,"34233",128,104,104,0,0,"FE de las J",1
34,"34132",106,73,72,0,1,"FE de las J",0
47,"47076",17787,13484,13306,179,178,"FE de las J",11
12,"12134",135,95,95,1,0,"FE de las J",0
5,"5144",65,47,46,1,1,"FE de las J",0
5,"5056",91,71,70,0,1,"FE de las J",0
19,"19248",73,54,54,0,0,"FE de las J",0
19,"19112",53,35,34,0,1,"FE de las J",0
47,"47005",506,358,348,3,10,"FE de las J",0
19,"19006",755,506,494,4,12,"FE de las J",0
47,"47046",124,99,99,1,0,"FE de las J",0
19,"19168",265,182,175,4,7,"FE de las J",0
5,"5067",73,56,54,0,2,"FE de las J",0
47,"47097",305,239,237,0,2,"FE de las J",0
5,"5230",65,57,56,1,1,"FE de las J",0
19,"19258",84,63,62,0,1,"FE de las J",0
34,"34152",124,99,94,0,5,"FE de las J",0
47,"47098",567,452,446,4,6,"FE de las J",1
5,"5134",47,40,40,0,0,"FE de las J",0
47,"47078",157,114,107,0,7,"FE de las J",0
5,"5241",3062,2011,1977,21,34,"FE de las J",2
47,"47142",121,85,85,0,0,"FE de las J",0
34,"34084",158,125,125,1,0,"FE de las J",0
34,"34238",294,238,236,1,2,"FE de las J",0
47,"47079",55,44,43,1,1,"FE de las J",0
19,"19011",237,165,162,3,3,"FE de las J",0
47,"47111",1001,738,732,5,6,"FE de las J",0
12,"12017",145,111,110,2,1,"FE de las J",0
12,"12107",350,299,295,3,4,"FE de las J",0
47,"47071",396,321,316,5,5,"FE de las J",0
19,"19058",7458,5705,5663,40,42,"FE de las J",3
47,"47051",324,261,258,6,3,"FE de las J",0
47,"47177",104,78,78,0,0,"FE de las J",0
5,"5158",346,263,261,0,2,"FE de las J",0
5,"5199",37,31,31,0,0,"FE de las J",0
47,"47173",879,627,622,9,5,"FE de las J",0
19,"19195",36,26,25,2,1,"FE de las J",0
34,"34902",123,91,91,0,0,"FE de las J",0
47,"47086",3818,2835,2784,36,51,"FE de las J",2
47,"47013",91,77,77,1,0,"FE de las J",0
47,"47011",554,466,462,7,4,"FE de las J",1
12,"12046",188,135,135,4,0,"FE de las J",0
47,"47123",461,360,358,2,2,"FE de las J",0
19,"19136",11,10,10,0,0,"FE de las J",0
5,"5060",108,79,79,2,0,"FE de las J",0
5,"5039",47,43,43,0,0,"FE de las J",0
19,"19092",395,286,279,2,7,"FE de las J",0
5,"5083",137,92,91,0,1,"FE de las J",0
5,"5180",76,55,53,0,2,"FE de las J",1
19,"19327",385,313,308,2,5,"FE de las J",1
19,"19200",66,53,52,0,1,"FE de las J",0
5,"5233",223,174,173,0,1,"FE de las J",0
47,"47155",3454,2445,2405,26,40,"FE de las J",0
19,"19009",263,186,184,0,2,"FE de las J",1
5,"5160",289,220,213,0,7,"FE de las J",0
47,"47221",97,85,84,1,1,"FE de las J",0
5,"5244",39,29,29,0,0,"FE de las J",0
5,"5224",102,85,84,2,1,"FE de las J",0
47,"47091",76,60,59,2,1,"FE de las J",0
19,"19294",26,18,18,0,0,"FE de las J",0
5,"5901",247,154,152,3,2,"FE de las J",0
47,"47029",50,37,35,1,2,"FE de las J",0
34,"34060",133,109,107,0,2,"FE de las J",0
12,"12003",954,710,702,6,8,"FE de las J",0
19,"19148",42,29,28,1,1,"FE de las J",0
34,"34015",37,24,24,0,0,"FE de las J",0
34,"34136",143,89,89,1,0,"FE de las J",0
34,"34091",118,82,82,1,0,"FE de las J",0
19,"19053",1906,1323,1304,12,19,"FE de las J",3
5,"5135",399,294,292,2,2,"FE de las J",1
12,"12118",78,64,63,0,1,"FE de las J",0
12,"12117",3532,2512,2479,12,33,"FE de las J",2
19,"19143",1781,1278,1266,18,12,"FE de las J",2
19,"19096",105,72,70,0,2,"FE de las J",0
47,"47102",257,212,210,2,2,"FE de las J",1
12,"12064",80,71,69,0,2,"FE de las J",0
34,"34158",283,170,167,0,3,"FE de las J",0
34,"34009",30,26,26,0,0,"FE de las J",0
19,"19175",29,18,17,1,1,"FE de las J",0
34,"34149",23,20,20,0,0,"FE de las J",0
12,"12057",572,456,437,1,19,"FE de las J",0
19,"19099",286,179,175,1,4,"FE de las J",0
47,"47052",6781,5213,5156,50,57,"FE de las J",3
47,"47093",795,585,573,7,12,"FE de las J",0
34,"34160",133,107,106,0,1,"FE de las J",0
19,"19244",74,55,55,3,0,"FE de las J",0
5,"5086",76,58,58,1,0,"FE de las J",0
19,"19118",11,10,9,0,1,"FE de las J",0
12,"12038",157,101,100,3,1,"FE de las J",0
34,"34005",786,601,593,3,8,"FE de las J",1
5,"5076",468,376,367,1,9,"FE de las J",0
34,"34245",307,212,212,0,0,"FE de las J",0
5,"5141",95,79,78,1,1,"FE de las J",0
5,"5153",86,58,56,3,2,"FE de las J",0
34,"34069",2184,1555,1517,17,38,"FE de las J",1
5,"5187",1714,1247,1221,9,26,"FE de las J",0
5,"5904",108,70,69,5,1,"FE de las J",0
34,"34099",53,44,42,0,2,"FE de las J",0
5,"5184",238,163,160,2,3,"FE de las J",0
34,"34232",725,505,492,13,13,"FE de las J",0
47,"47117",287,199,197,6,2,"FE de las J",0
34,"34217",1269,999,983,14,16,"FE de las J",1
34,"34114",200,134,134,0,0,"FE de las J",0
47,"47057",272,200,199,0,1,"FE de las J",0
19,"19054",161,136,135,3,1,"FE de las J",0
12,"12033",1953,1391,1368,6,23,"FE de las J",0
12,"12099",597,444,436,6,8,"FE de las J",1
12,"12001",1028,783,768,6,15,"FE de las J",0
47,"47125",49,42,42,0,0,"FE de las J",0
5,"5030",40,32,32,0,0,"FE de las J",0
47,"47132",39,32,32,1,0,"FE de las J",0
19,"19199",19,15,15,0,0,"FE de las J",0
5,"5147",144,101,99,0,2,"FE de las J",0
5,"5088",29,22,22,0,0,"FE de las J",0
19,"19333",96,68,67,0,1,"FE de las J",0
34,"34027",1049,677,665,15,12,"FE de las J",0
34,"34041",82,64,64,3,0,"FE de las J",0
19,"19117",1632,1187,1167,12,20,"FE de las J",1
19,"19287",134,100,98,2,2,"FE de las J",0
47,"47170",43,36,30,0,6,"FE de las J",0
47,"47160",395,296,294,3,2,"FE de las J",0
47,"47054",599,465,460,1,5,"FE de las J",0
12,"12021",4398,3314,3277,32,37,"FE de las J",1
19,"19196",89,70,67,1,3,"FE de las J",0
47,"47214",1349,1036,1019,5,17,"FE de las J",0
19,"19145",40,32,32,0,0,"FE de las J",0
47,"47213",104,78,78,0,0,"FE de las J",0
12,"12068",41,22,21,0,1,"FE de las J",0
5,"5263",162,117,115,1,2,"FE de las J",1
12,"12041",92,69,69,2,0,"FE de las J",0
19,"19177",60,45,45,0,0,"FE de las J",0
34,"34904",300,188,186,0,2,"FE de las J",0
47,"47182",1328,940,934,8,6,"FE de las J",0
19,"19238",43,30,28,0,2,"FE de las J",0
47,"47066",1482,1096,1086,14,10,"FE de las J",0
47,"47049",91,58,58,0,0,"FE de las J",1
34,"34012",342,237,232,3,5,"FE de las J",0
19,"19188",36,31,31,0,0,"FE de las J",0
34,"34222",107,71,68,1,3,"FE de las J",0
34,"34029",665,524,518,1,6,"FE de las J",0
47,"47121",517,410,398,2,12,"FE de las J",0
5,"5198",70,53,51,0,2,"FE de las J",0
34,"34154",77,48,48,1,0,"FE de las J",0
5,"5121",263,194,189,1,5,"FE de las J",1
5,"5228",168,99,98,0,1,"FE de las J",0
19,"19240",49,36,36,0,0,"FE de las J",0
5,"5092",145,111,107,1,4,"FE de las J",0
19,"19105",2550,1913,1889,10,24,"FE de las J",1
19,"19159",87,73,72,1,1,"FE de las J",0
19,"19217",43,36,36,0,0,"FE de las J",0
19,"19047",55,47,47,1,0,"FE de las J",0
12,"12027",17506,11776,11649,84,127,"FE de las J",3
12,"12037",17,13,13,1,0,"FE de las J",0
47,"47067",153,112,112,3,0,"FE de las J",0
5,"5070",30,29,29,0,0,"FE de las J",0
12,"12128",1365,990,972,16,18,"FE de las J",0
12,"12016",1549,1244,1234,9,10,"FE de las J",0
19,"19176",227,172,172,0,0,"FE de las J",1
5,"5100",260,193,192,3,1,"FE de las J",0
47,"47033",205,151,150,2,1,"FE de las J",0
12,"12101",354,274,270,5,4,"FE de las J",1
12,"12044",442,371,368,1,3,"FE de las J",0
5,"5225",355,276,273,6,3,"FE de las J",0
34,"34177",178,149,149,1,0,"FE de las J",0
34,"34106",110,92,92,3,0,"FE de las J",0
19,"19326",2463,1671,1650,13,21,"FE de las J",0
34,"34107",73,47,46,1,1,"FE de las J",0
5,"5049",403,261,253,1,8,"FE de las J",1
47,"47101",1634,1278,1262,7,16,"FE de las J",0
19,"19160",883,535,530,11,5,"FE de las J",0
47,"47018",36,31,31,0,0,"FE de las J",0
19,"19191",13,12,12,0,0,"FE de las J",0
5,"5136",83,55,55,0,0,"FE de las J",0
19,"19106",77,57,57,0,0,"FE de las J",0
19,"19293",1945,1402,1388,19,14,"FE de las J",0
47,"47022",59,52,48,1,4,"FE de las J",0
5,"5173",60,54,54,0,0,"FE de las J",0
47,"47128",53,45,43,0,2,"FE de las J",0
12,"12063",41,31,31,1,0,"FE de las J",0
5,"5191",121,99,99,0,0,"FE de las J",0
5,"5116",96,68,68,0,0,"FE de las J",0
34,"34108",499,391,384,3,7,"FE de las J",0
19,"19232",56,40,40,0,0,"FE de las J",0
19,"19219",9,8,7,0,1,"FE de las J",0
34,"34223",203,147,143,1,4,"FE de las J",0
5,"5175",144,109,109,0,0,"FE de las J",0
5,"5013",834,658,653,2,5,"FE de las J",0
19,"19183",70,59,58,0,1,"FE de las J",0
47,"47220",151,106,105,1,1,"FE de las J",0
12,"12060",434,366,360,1,6,"FE de las J",0
5,"5218",104,81,79,0,2,"FE de las J",0
19,"19088",91,67,66,0,1,"FE de las J",0
5,"5155",46,33,31,1,2,"FE de las J",0
12,"12123",40,32,32,0,0,"FE de las J",0
5,"5107",54,36,35,2,1,"FE de las J",0
5,"5052",85,70,69,0,1,"FE de las J",0
47,"47003",206,167,166,5,1,"FE de las J",0
47,"47030",935,680,669,5,11,"FE de las J",0
5,"5245",353,262,256,0,6,"FE de las J",2
47,"47114",3900,2549,2514,18,35,"FE de las J",2
12,"12067",514,381,373,3,8,"FE de las J",0
19,"19155",64,49,49,0,0,"FE de las J",0
5,"5217",54,42,41,0,1,"FE de las J",0
19,"19015",82,74,73,1,1,"FE de las J",0
19,"19285",20,16,16,0,0,"FE de las J",0
47,"47041",147,105,103,3,2,"FE de las J",0
19,"19152",540,377,374,2,3,"FE de las J",1
47,"47231",4439,3359,3323,36,36,"FE de las J",2
19,"19224",106,83,83,1,0,"FE de las J",0
19,"19165",45,39,39,0,0,"FE de las J",0
5,"5205",81,59,58,2,1,"FE de las J",0
19,"19234",44,30,30,0,0,"FE de las J",0
47,"47104",2816,2153,2099,20,54,"FE de las J",0
47,"47179",368,256,254,2,2,"FE de las J",0
47,"47116",396,304,302,2,2,"FE de las J",1
34,"34168",45,39,39,1,0,"FE de las J",0
5,"5166",155,108,104,1,4,"FE de las J",0
47,"47045",732,558,549,3,9,"FE de las J",0
34,"34024",25,14,14,0,0,"FE de las J",0
47,"47084",1077,794,784,11,10,"FE de las J",0
19,"19298",53,43,41,0,2,"FE de las J",0
47,"47190",95,75,75,1,0,"FE de las J",0
5,"5194",132,105,104,1,1,"FE de las J",0
5,"5099",451,350,344,3,6,"FE de las J",0
47,"47169",62,52,52,0,0,"FE de las J",0
34,"34135",398,267,264,4,3,"FE de las J",0
47,"47036",204,159,156,1,3,"FE de las J",0
12,"12014",164,111,111,0,0,"FE de las J",0
47,"47184",537,411,402,1,9,"FE de las J",1
34,"34096",48,39,38,0,1,"FE de las J",0
19,"19189",114,87,84,0,3,"FE de las J",0
47,"47216",111,94,91,0,3,"FE de las J",0
47,"47122",2007,1520,1492,8,28,"FE de las J",0
47,"47191",111,81,81,0,0,"FE de las J",0
12,"12125",215,179,179,2,0,"FE de las J",0
12,"12109",646,489,482,4,7,"FE de las J",0
47,"47187",71,49,49,0,0,"FE de las J",0
12,"12126",24374,17741,17553,111,188,"FE de las J",5
34,"34202",28,23,23,2,0,"FE de las J",0
19,"19016",57,40,40,0,0,"FE de las J",0
19,"19130",61556,45926,45388,408,538,"FE de las J",142
5,"5139",71,59,58,1,1,"FE de las J",0
47,"47095",41,29,28,0,1,"FE de las J",1
47,"47039",162,119,117,0,2,"FE de las J",0
5,"5042",141,111,111,0,0,"FE de las J",0
34,"34086",102,81,81,2,0,"FE de las J",0
12,"12140",1147,849,841,5,8,"FE de las J",0
47,"47080",33,25,24,0,1,"FE de las J",0
5,"5122",118,91,89,1,2,"FE de las J",0
19,"19121",265,205,204,0,1,"FE de las J",0
5,"5035",92,68,68,0,0,"FE de las J",0
34,"34120",63790,46117,45597,464,520,"FE de las J",28
19,"19289",23,16,16,0,0,"FE de las J",0
19,"19064",64,56,56,0,0,"FE de las J",0
5,"5156",242,145,145,1,0,"FE de las J",0
34,"34092",257,189,189,1,0,"FE de las J",0
19,"19260",38,27,27,1,0,"FE de las J",0
19,"19184",59,47,47,0,0,"FE de las J",0
19,"19280",3669,2622,2597,24,25,"FE de las J",0
5,"5253",75,54,54,0,0,"FE de las J",0
34,"34236",147,104,104,0,0,"FE de las J",0
47,"47162",70,57,57,2,0,"FE de las J",1
19,"19178",27,17,16,0,1,"FE de las J",0
5,"5188",39,33,33,0,0,"FE de las J",0
5,"5167",223,177,172,0,5,"FE de las J",0
5,"5109",445,334,329,4,5,"FE de las J",0
34,"34074",690,502,490,13,12,"FE de las J",1
19,"19123",37,30,28,0,2,"FE de las J",0
19,"19278",24,20,20,0,0,"FE de las J",0
12,"12096",732,526,519,4,7,"FE de las J",0
5,"5214",28,18,18,0,0,"FE de las J",0
47,"47020",270,212,207,5,5,"FE de las J",0
5,"5151",83,60,60,0,0,"FE de las J",0
19,"19220",2608,1673,1653,10,20,"FE de las J",2
47,"47206",79,66,66,0,0,"FE de las J",0
19,"19019",14,11,11,1,0,"FE de las J",0
5,"5251",56,35,34,0,1,"FE de las J",0
5,"5040",64,47,46,0,1,"FE de las J",0
34,"34214",176,121,120,1,1,"FE de las J",1
19,"19284",10,10,10,0,0,"FE de las J",0
5,"5235",141,97,97,2,0,"FE de las J",0
19,"19251",39,30,30,0,0,"FE de las J",0
19,"19001",43,32,32,0,0,"FE de las J",0
12,"12122",754,608,600,3,8,"FE de las J",0
47,"47009",98,84,84,0,0,"FE de las J",0
12,"12113",90,59,59,1,0,"FE de las J",0
5,"5215",156,120,113,0,7,"FE de las J",0
19,"19002",55,45,45,0,0,"FE de las J",0
34,"34137",24,19,19,2,0,"FE de las J",0
47,"47217",1984,1460,1437,11,23,"FE de las J",1
34,"34156",51,42,42,0,0,"FE de las J",0
5,"5260",95,73,73,0,0,"FE de las J",0
5,"5266",100,79,79,1,0,"FE de las J",0
19,"19170",189,115,115,1,0,"FE de las J",0
12,"12052",537,409,398,5,11,"FE de las J",0
19,"19059",73,47,47,0,0,"FE de las J",1
34,"34023",5103,3585,3543,45,42,"FE de las J",4
5,"5057",2418,1785,1748,9,37,"FE de las J",3
34,"34246",68,52,52,0,0,"FE de las J",0
19,"19003",36,30,30,0,0,"FE de las J",0
34,"34019",111,87,86,1,1,"FE de las J",0
12,"12114",200,144,140,0,4,"FE de las J",0
34,"34190",50,33,33,1,0,"FE de las J",0
12,"12036",541,401,395,6,6,"FE de las J",0
34,"34093",83,61,60,0,1,"FE de las J",0
19,"19310",7,7,7,0,0,"FE de las J",0
47,"47105",169,138,137,2,1,"FE de las J",0
5,"5124",87,67,67,2,0,"FE de las J",0
34,"34046",43,29,29,0,0,"FE de las J",0
47,"47223",148,105,102,4,3,"FE de las J",0
12,"12902",2250,1557,1532,16,25,"FE de las J",2
5,"5249",96,63,63,0,0,"FE de las J",0
5,"5044",244,170,170,1,0,"FE de las J",0
12,"12082",9602,7323,7248,53,75,"FE de las J",4
12,"12081",606,454,446,2,8,"FE de las J",1
12,"12139",299,202,200,3,2,"FE de las J",0
12,"12119",139,97,94,3,3,"FE de las J",1
34,"34070",131,98,96,0,2,"FE de las J",0
34,"34056",1926,1335,1311,10,24,"FE de las J",0
19,"19166",154,110,108,0,2,"FE de las J",0
19,"19074",67,57,57,1,0,"FE de las J",0
34,"34140",93,57,57,1,0,"FE de las J",0
19,"19172",51,38,38,0,0,"FE de las J",0
34,"34126",248,177,176,3,1,"FE de las J",0
19,"19262",125,98,98,0,0,"FE de las J",0
19,"19296",29,24,24,0,0,"FE de las J",0
34,"34221",168,129,127,2,2,"FE de las J",0
5,"5062",163,121,119,3,2,"FE de las J",0
5,"5247",231,132,131,1,1,"FE de las J",0
19,"19086",1371,1003,996,9,7,"FE de las J",0
34,"34215",161,126,125,6,1,"FE de las J",0
47,"47038",100,61,61,0,0,"FE de las J",0
5,"5033",169,135,134,0,1,"FE de las J",1
19,"19331",2677,1892,1841,18,51,"FE de las J",2
34,"34130",195,154,153,5,1,"FE de las J",0
47,"47225",73,61,59,1,2,"FE de las J",0
19,"19089",23,17,17,0,0,"FE de las J",0
19,"19264",33,25,25,0,0,"FE de las J",0
5,"5157",227,146,146,3,0,"FE de las J",0
19,"19281",19,18,18,0,0,"FE de las J",0
5,"5054",1192,871,856,6,15,"FE de las J",0
5,"5087",147,108,107,3,1,"FE de las J",0
19,"19027",129,97,95,1,2,"FE de las J",0
5,"5206",26,17,17,0,0,"FE de las J",0
19,"19322",26,20,19,1,1,"FE de las J",0
34,"34083",1647,1089,1080,2,9,"FE de las J",0
19,"19210",18,16,16,0,0,"FE de las J",0
34,"34104",231,164,162,2,2,"FE de las J",0
19,"19211",350,272,269,0,3,"FE de las J",0
19,"19269",86,61,61,0,0,"FE de las J",0
47,"47096",127,94,93,1,1,"FE de las J",0
47,"47027",2799,2059,2025,12,34,"FE de las J",4
34,"34081",60,45,44,0,1,"FE de las J",0
47,"47034",75,58,58,2,0,"FE de las J",0
47,"47106",44,30,30,0,0,"FE de las J",0
19,"19110",51,39,39,0,0,"FE de las J",0
12,"12090",102,79,78,1,1,"FE de las J",0
5,"5138",283,218,217,1,1,"FE de las J",0
34,"34066",54,47,47,1,0,"FE de las J",0
19,"19095",11,7,6,0,1,"FE de las J",0
5,"5201",497,404,401,0,3,"FE de las J",0
12,"12110",222,156,155,3,1,"FE de las J",0
19,"19161",212,158,157,3,1,"FE de las J",0
47,"47021",73,57,55,0,2,"FE de las J",0
19,"19307",25,23,23,0,0,"FE de las J",0
19,"19225",851,618,611,2,7,"FE de las J",1
47,"47063",86,68,68,0,0,"FE de las J",0
5,"5259",99,80,79,2,1,"FE de las J",1
12,"12105",825,602,598,6,4,"FE de las J",0
19,"19135",90,71,69,1,2,"FE de las J",0
47,"47035",901,659,653,4,6,"FE de las J",0
34,"34178",119,94,91,0,3,"FE de las J",0
12,"12142",142,113,113,0,0,"FE de las J",0
34,"34058",182,152,152,0,0,"FE de las J",0
34,"34131",56,46,46,0,0,"FE de las J",0
12,"12129",1783,1207,1184,16,23,"FE de las J",0
5,"5078",95,78,78,2,0,"FE de las J",0
19,"19901",35,27,27,0,0,"FE de las J",0
19,"19243",34,32,31,1,1,"FE de las J",0
12,"12008",228,195,194,1,1,"FE de las J",0
34,"34028",132,95,92,2,3,"FE de las J",0
12,"12013",135,106,106,1,0,"FE de las J",0
34,"34121",187,150,150,3,0,"FE de las J",0
12,"12078",334,224,221,2,3,"FE de las J",0
34,"34089",141,102,101,4,1,"FE de las J",0
19,"19229",58,53,53,0,0,"FE de las J",0
47,"47043",306,241,240,4,1,"FE de las J",0
47,"47064",37,30,29,1,1,"FE de las J",1
47,"47232",96,67,65,0,2,"FE de las J",0
47,"47211",48,37,37,1,0,"FE de las J",0
47,"47012",100,72,71,0,1,"FE de las J",0
12,"12132",477,391,385,3,6,"FE de las J",1
34,"34175",87,67,66,1,1,"FE de las J",0
47,"47226",148,115,115,1,0,"FE de las J",0
5,"5210",81,56,56,0,0,"FE de las J",0
47,"47017",190,146,146,0,0,"FE de las J",0
5,"5021",1861,1323,1304,22,19,"FE de las J",0
47,"47180",57,41,41,1,0,"FE de las J",0
19,"19119",76,65,65,0,0,"FE de las J",0
5,"5130",94,77,77,1,0,"FE de las J",0
5,"5108",39,21,21,0,0,"FE de las J",0
19,"19193",22,21,21,1,0,"FE de las J",0
34,"34237",579,408,400,1,8,"FE de las J",1
19,"19147",42,32,32,0,0,"FE de las J",0
34,"34159",375,221,214,4,7,"FE de las J",0
5,"5089",455,342,324,0,18,"FE de las J",0
34,"34072",145,125,123,1,2,"FE de las J",0
47,"47189",151,128,122,1,6,"FE de las J",0
19,"19048",19,14,13,1,1,"FE de las J",0
12,"12115",205,161,161,1,0,"FE de las J",1
47,"47028",30,17,17,0,0,"FE de las J",0
5,"5252",56,46,45,0,1,"FE de las J",0
34,"34129",168,118,118,1,0,"FE de las J",0
47,"47200",70,60,60,0,0,"FE de las J",0
19,"19043",99,80,79,0,1,"FE de las J",0
12,"12032",23728,16870,16726,121,144,"FE de las J",5
5,"5036",118,91,90,0,1,"FE de las J",0
34,"34903",179,129,129,1,0,"FE de las J",1
19,"19075",58,38,37,3,1,"FE de las J",0
19,"19246",42,27,27,1,0,"FE de las J",0
34,"34050",187,136,136,1,0,"FE de las J",0
47,"47166",251,183,181,2,2,"FE de las J",0
19,"19125",45,23,23,0,0,"FE de las J",0
19,"19021",978,678,662,3,16,"FE de las J",0
47,"47156",150,117,117,0,0,"FE de las J",0
19,"19201",60,44,44,0,0,"FE de las J",0
19,"19070",65,45,45,0,0,"FE de las J",0
47,"47209",32,23,23,0,0,"FE de las J",1
47,"47159",825,672,661,0,11,"FE de las J",0
12,"12133",59,46,45,0,1,"FE de las J",0
34,"34059",411,304,292,6,12,"FE de las J",1
47,"47151",26,22,22,0,0,"FE de las J",0
34,"34161",22,12,12,0,0,"FE de las J",0
34,"34037",301,206,204,1,2,"FE de las J",0
47,"47157",490,398,397,2,1,"FE de las J",0
19,"19107",306,245,244,0,1,"FE de las J",0
47,"47163",277,208,205,3,3,"FE de las J",1
34,"34035",97,76,75,3,1,"FE de las J",0
47,"47082",805,641,630,3,11,"FE de las J",0
47,"47207",256,198,195,3,3,"FE de las J",0
19,"19215",135,109,109,0,0,"FE de las J",0
19,"19216",127,88,88,0,0,"FE de las J",0
19,"19163",60,49,49,0,0,"FE de las J",0
47,"47148",419,332,324,3,8,"FE de las J",0
5,"5131",96,64,64,1,0,"FE de las J",0
34,"34122",83,56,56,0,0,"FE de las J",0
19,"19134",23,14,14,0,0,"FE de las J",0
19,"19187",42,32,32,0,0,"FE de las J",0
19,"19306",24,18,18,0,0,"FE de las J",0
5,"5182",721,457,436,3,21,"FE de las J",0
5,"5162",76,47,45,1,2,"FE de las J",0
12,"12104",6843,5181,5111,32,70,"FE de las J",3
19,"19297",32,28,28,0,0,"FE de las J",0
19,"19007",433,316,310,1,6,"FE de las J",0
19,"19066",51,42,42,0,0,"FE de las J",0
19,"19081",27,21,21,0,0,"FE de las J",0
19,"19157",53,37,37,0,0,"FE de las J",0
12,"12074",756,611,601,3,10,"FE de las J",0
34,"34053",194,156,154,3,2,"FE de las J",1
5,"5193",179,140,139,2,1,"FE de las J",0
5,"5185",96,63,61,1,2,"FE de las J",0
19,"19073",16,15,15,1,0,"FE de las J",0
12,"12028",13004,9801,9732,74,69,"FE de las J",1
12,"12108",443,354,352,4,2,"FE de las J",1
47,"47075",4772,3557,3512,34,45,"FE de las J",0
34,"34163",46,37,37,0,0,"FE de las J",0
5,"5127",600,472,469,7,3,"FE de las J",1
19,"19010",9,9,9,0,0,"FE de las J",0
47,"47197",875,659,656,9,3,"FE de las J",0
19,"19203",29,25,25,0,0,"FE de las J",0
12,"12075",110,85,83,3,2,"FE de las J",0
47,"47007",4051,2987,2954,27,33,"FE de las J",2
12,"12091",171,110,108,4,2,"FE de las J",0
19,"19279",54,42,42,0,0,"FE de las J",0
19,"19120",107,86,86,1,0,"FE de las J",0
19,"19266",229,184,182,1,2,"FE de las J",0
5,"5171",67,49,47,0,2,"FE de las J",0
5,"5034",15,14,13,0,1,"FE de las J",0
5,"5118",64,41,41,1,0,"FE de las J",0
12,"12065",167,142,141,0,1,"FE de las J",0
34,"34125",105,80,80,2,0,"FE de las J",1
34,"34110",75,64,64,0,0,"FE de las J",0
19,"19321",34,28,28,0,0,"FE de las J",0
19,"19017",56,47,47,0,0,"FE de las J",0
47,"47224",93,75,75,1,0,"FE de las J",0
19,"19204",150,105,104,3,1,"FE de las J",0
47,"47092",101,81,79,0,2,"FE de las J",0
5,"5007",109,73,72,0,1,"FE de las J",1
5,"5226",63,43,42,0,1,"FE de las J",0
34,"34213",53,46,46,0,0,"FE de las J",0
5,"5172",111,83,83,1,0,"FE de las J",0
19,"19267",20,15,14,0,1,"FE de las J",0
5,"5231",150,123,122,2,1,"FE de las J",0
34,"34022",1022,813,798,7,15,"FE de las J",0
34,"34231",211,157,153,3,4,"FE de las J",0
34,"34094",61,45,45,2,0,"FE de las J",0
12,"12106",1151,928,908,9,20,"FE de las J",0
5,"5178",340,261,255,3,6,"FE de las J",0
19,"19038",19,16,15,0,1,"FE de las J",0
5,"5140",99,83,81,0,2,"FE de las J",0
12,"12111",327,259,255,8,4,"FE de las J",0
5,"5237",153,125,123,0,2,"FE de las J",0
5,"5114",1257,989,968,5,21,"FE de las J",0
19,"19277",15,10,10,0,0,"FE de las J",0
47,"47040",56,42,41,0,1,"FE de las J",0
19,"19192",1762,1251,1240,5,11,"FE de las J",1
5,"5095",236,181,177,1,4,"FE de las J",1
34,"34067",129,80,78,1,2,"FE de las J",0
19,"19272",66,55,55,2,0,"FE de las J",0
47,"47031",191,141,140,0,1,"FE de las J",0
5,"5043",73,58,58,0,0,"FE de las J",0
47,"47139",997,728,719,4,9,"FE de las J",0
47,"47023",3057,2369,2359,20,10,"FE de las J",1
47,"47138",224,169,166,0,3,"FE de las J",0
5,"5047",4105,3004,2936,23,68,"FE de las J",3
19,"19098",20,17,17,0,0,"FE de las J",0
12,"12093",161,111,109,2,2,"FE de las J",0
19,"19185",26,15,15,1,0,"FE de las J",0
5,"5053",76,48,48,0,0,"FE de las J",0
34,"34218",437,313,309,3,4,"FE de las J",0
12,"12048",243,159,155,4,4,"FE de las J",0
34,"34227",70,56,52,1,4,"FE de las J",0
47,"47193",1625,1251,1236,10,15,"FE de las J",0
5,"5261",32,25,25,0,0,"FE de las J",0
47,"47126",42,35,35,1,0,"FE de las J",0
5,"5024",193,127,125,2,2,"FE de las J",0
5,"5110",696,469,464,2,5,"FE de las J",0
47,"47130",94,64,63,0,1,"FE de las J",0
34,"34020",49,37,37,1,0,"FE de las J",0
19,"19087",17,16,16,0,0,"FE de las J",0
34,"34051",91,72,70,0,2,"FE de las J",0
5,"5051",157,117,115,1,2,"FE de las J",0
34,"34199",1150,767,754,14,13,"FE de las J",1
19,"19329",58,46,46,0,0,"FE de las J",0
12,"12901",3339,2583,2561,25,22,"FE de las J",2
5,"5119",24,17,17,1,0,"FE de las J",0
5,"5152",644,498,496,3,2,"FE de las J",0
34,"34079",1729,1296,1275,19,21,"FE de las J",1
5,"5090",73,63,62,0,1,"FE de las J",0
19,"19239",93,70,70,1,0,"FE de las J",0
19,"19305",139,104,103,1,1,"FE de las J",0
47,"47127",138,89,88,2,1,"FE de las J",0
34,"34228",77,59,59,1,0,"FE de las J",0
47,"47032",147,102,102,0,0,"FE de las J",0
19,"19308",57,49,49,0,0,"FE de las J",0
19,"19223",99,66,65,1,1,"FE de las J",0
19,"19109",33,26,26,2,0,"FE de las J",0
47,"47219",39,31,28,1,3,"FE de las J",0
19,"19024",8561,6015,5942,44,73,"FE de las J",3
5,"5117",191,155,153,1,2,"FE de las J",0
19,"19129",25,21,21,0,0,"FE de las J",0
5,"5246",48,35,35,0,0,"FE de las J",0
12,"12039",792,665,659,2,6,"FE de las J",0
5,"5236",105,69,69,1,0,"FE de las J",0
34,"34025",52,34,34,1,0,"FE de las J",0
47,"47199",71,57,57,2,0,"FE de las J",0
12,"12049",415,317,305,4,12,"FE de las J",0
12,"12124",1842,1343,1328,13,15,"FE de las J",0
5,"5061",257,193,189,1,4,"FE de las J",1
12,"12045",333,243,235,2,8,"FE de las J",0
19,"19039",56,48,48,2,0,"FE de las J",0
34,"34077",395,282,278,7,4,"FE de las J",0
5,"5064",101,77,77,0,0,"FE de las J",0
12,"12002",114,96,94,1,2,"FE de las J",0
34,"34038",259,183,178,0,5,"FE de las J",0
34,"34109",60,34,34,0,0,"FE de las J",0
34,"34206",810,608,602,5,6,"FE de las J",0
19,"19254",43,34,34,0,0,"FE de las J",0
12,"12084",17785,12557,12422,108,135,"FE de las J",9
47,"47099",154,123,118,0,5,"FE de las J",0
34,"34179",25,18,16,0,2,"FE de las J",0
47,"47229",221,150,149,0,1,"FE de las J",0
19,"19318",26,18,18,0,0,"FE de las J",0
19,"19122",81,62,60,2,2,"FE de las J",0
19,"19174",90,65,64,0,1,"FE de las J",1
5,"5227",341,230,228,1,2,"FE de las J",0
47,"47222",85,70,70,1,0,"FE de las J",0
12,"12018",279,233,231,3,2,"FE de las J",0
47,"47178",170,128,124,2,4,"FE de las J",0
19,"19186",76,60,60,0,0,"FE de las J",0
19,"19214",74,51,51,0,0,"FE de las J",0
47,"47083",81,63,61,0,2,"FE de las J",1
5,"5074",668,540,537,5,3,"FE de las J",1
34,"34031",26,26,26,1,0,"FE de las J",0
19,"19060",157,123,122,0,1,"FE de las J",0
5,"5055",532,417,413,3,4,"FE de las J",0
19,"19255",74,37,37,0,0,"FE de las J",0
47,"47070",29,24,24,0,0,"FE de las J",0
5,"5019",44865,32917,32586,282,331,"FE de las J",12
19,"19126",1701,1223,1207,6,16,"FE de las J",0
47,"47006",182,149,145,1,4,"FE de las J",0
19,"19162",67,41,41,0,0,"FE de las J",0
12,"12005",8049,5643,5552,71,91,"FE de las J",5
34,"34208",48,40,40,1,0,"FE de las J",0
19,"19311",85,60,59,0,1,"FE de las J",0
12,"12095",950,723,712,5,11,"FE de las J",1
34,"34243",323,243,239,1,4,"FE de las J",0
47,"47153",101,69,69,1,0,"FE de las J",0
12,"12073",133,97,97,0,0,"FE de las J",0
12,"12138",19207,13018,12891,87,127,"FE de las J",7
5,"5154",31,23,23,0,0,"FE de las J",0
5,"5219",33,23,23,0,0,"FE de las J",0
12,"12141",92,72,72,0,0,"FE de las J",0
12,"12011",4583,3228,3177,24,51,"FE de las J",0
12,"12042",574,459,446,9,13,"FE de las J",1
5,"5163",1702,1258,1233,5,25,"FE de las J",0
5,"5058",71,45,43,0,2,"FE de las J",0
47,"47061",237,185,184,0,1,"FE de las J",0
19,"19037",131,109,108,0,1,"FE de las J",0
5,"5164",18,12,12,0,0,"FE de las J",0
19,"19271",41,22,21,1,1,"FE de las J",0
47,"47134",150,120,116,2,4,"FE de las J",0
19,"19057",69,51,51,0,0,"FE de las J",0
5,"5085",31,27,27,0,0,"FE de las J",0
19,"19256",46,36,36,0,0,"FE de las J",0
19,"19194",91,69,69,0,0,"FE de las J",0
19,"19286",772,585,575,3,10,"FE de las J",1
34,"34169",371,263,259,5,4,"FE de las J",0
47,"47074",141,110,109,0,1,"FE de las J",0
19,"19151",1077,703,693,8,10,"FE de las J",1
5,"5220",364,277,274,0,3,"FE de las J",0
19,"19182",37,32,32,0,0,"FE de las J",0
12,"12100",1273,1069,1052,5,17,"FE de las J",0
47,"47042",51,39,39,0,0,"FE de las J",0
50,"50041",16,10,10,0,0,"FIA",0
50,"50102",815,594,584,7,10,"FIA",0
22,"22126",89,64,64,0,0,"FIA",0
50,"50146",189,149,149,3,0,"FIA",1
50,"50029",594,432,431,3,1,"FIA",1
22,"22004",123,83,83,0,0,"FIA",0
50,"50256",70,43,43,0,0,"FIA",0
50,"50087",28,19,19,0,0,"FIA",0
50,"50105",277,203,198,4,5,"FIA",0
50,"50077",201,140,140,1,0,"FIA",0
50,"50182",3657,2499,2485,23,14,"FIA",2
22,"22136",749,524,518,5,6,"FIA",0
22,"22217",370,274,269,4,5,"FIA",0
50,"50222",1574,1024,1008,12,16,"FIA",0
50,"50091",39,32,32,0,0,"FIA",0
22,"22018",303,216,215,3,1,"FIA",0
22,"22195",238,190,186,0,4,"FIA",0
50,"50157",289,199,196,1,3,"FIA",0
22,"22242",60,41,40,0,1,"FIA",0
50,"50236",95,77,75,0,2,"FIA",0
50,"50253",379,294,290,1,4,"FIA",0
50,"50143",541,373,367,2,6,"FIA",0
22,"22905",287,217,217,1,0,"FIA",0
50,"50245",74,51,51,0,0,"FIA",0
50,"50002",125,91,86,0,5,"FIA",0
50,"50121",270,209,208,3,1,"FIA",0
50,"50120",55,42,42,1,0,"FIA",0
22,"22176",171,140,138,2,2,"FIA",0
50,"50268",41,32,32,1,0,"FIA",0
50,"50169",333,231,230,0,1,"FIA",1
50,"50279",74,49,49,0,0,"FIA",0
22,"22084",571,400,391,5,9,"FIA",0
50,"50068",1943,1299,1287,10,12,"FIA",0
50,"50167",208,166,163,1,3,"FIA",0
22,"22060",1167,817,808,14,9,"FIA",0
22,"22252",118,95,91,1,4,"FIA",0
22,"22151",85,60,60,0,0,"FIA",0
50,"50026",418,292,288,4,4,"FIA",0
22,"22043",93,53,53,0,0,"FIA",0
50,"50083",81,64,64,2,0,"FIA",0
50,"50069",66,33,33,1,0,"FIA",0
50,"50125",340,230,229,2,1,"FIA",0
22,"22061",6567,4446,4410,48,36,"FIA",5
50,"50021",25,21,21,0,0,"FIA",0
50,"50147",744,508,506,5,2,"FIA",0
22,"22199",6884,4438,4384,71,54,"FIA",3
22,"22116",1342,915,905,11,10,"FIA",0
50,"50115",3279,2170,2131,27,39,"FIA",0
50,"50009",97,61,61,1,0,"FIA",0
50,"50126",2240,1528,1509,24,19,"FIA",0
22,"22023",385,293,283,2,10,"FIA",0
22,"22083",447,360,355,6,5,"FIA",0
22,"22090",86,61,61,1,0,"FIA",0
50,"50036",100,76,76,1,0,"FIA",0
22,"22202",147,128,128,3,0,"FIA",0
50,"50204",2396,1723,1712,17,11,"FIA",0
50,"50249",283,202,200,0,2,"FIA",0
50,"50289",53,42,42,1,0,"FIA",0
22,"22903",618,484,482,5,2,"FIA",1
50,"50089",8616,6420,6364,50,56,"FIA",4
22,"22080",263,188,184,3,4,"FIA",0
50,"50050",87,62,62,1,0,"FIA",0
50,"50262",1161,849,832,11,17,"FIA",1
50,"50194",80,51,51,0,0,"FIA",0
50,"50047",38,24,24,0,0,"FIA",0
50,"50025",4541,3110,3083,39,27,"FIA",0
50,"50052",81,61,61,0,0,"FIA",0
50,"50059",757,556,551,5,5,"FIA",0
50,"50179",255,197,197,0,0,"FIA",0
50,"50190",669,532,518,10,14,"FIA",1
50,"50225",1532,983,971,12,12,"FIA",0
50,"50114",132,108,108,0,0,"FIA",0
22,"22036",84,71,71,1,0,"FIA",0
50,"50221",29,18,18,0,0,"FIA",0
50,"50118",2101,1484,1477,17,7,"FIA",1
50,"50283",69,46,46,0,0,"FIA",0
22,"22125",39530,27358,27075,344,283,"FIA",3
22,"22215",127,81,81,0,0,"FIA",0
50,"50008",5187,3334,3288,37,46,"FIA",2
22,"22249",125,93,92,1,1,"FIA",0
22,"22025",1022,705,694,14,11,"FIA",3
50,"50294",65,45,45,0,0,"FIA",0
22,"22234",743,498,491,5,7,"FIA",2
50,"50066",2903,2095,2078,19,17,"FIA",0
50,"50210",37,26,26,0,0,"FIA",0
50,"50090",134,96,96,0,0,"FIA",0
22,"22907",1463,1016,1006,21,10,"FIA",0
50,"50280",290,220,216,1,4,"FIA",0
50,"50260",35,31,31,0,0,"FIA",0
50,"50093",87,66,64,1,2,"FIA",0
22,"22055",305,242,235,2,7,"FIA",0
50,"50162",135,100,99,3,1,"FIA",0
22,"22014",227,164,162,5,2,"FIA",0
22,"22164",42,28,28,0,0,"FIA",0
50,"50022",504,373,369,12,4,"FIA",1
22,"22248",103,73,73,0,0,"FIA",0
50,"50075",70,55,55,1,0,"FIA",0
50,"50124",394,269,266,0,3,"FIA",0
22,"22102",180,137,136,3,1,"FIA",0
22,"22003",135,107,107,0,0,"FIA",0
22,"22017",826,613,608,2,5,"FIA",0
22,"22188",75,50,50,1,0,"FIA",0
50,"50206",457,349,345,5,4,"FIA",0
50,"50252",5019,3486,3456,53,30,"FIA",3
50,"50277",45,34,34,0,0,"FIA",0
22,"22078",431,285,285,4,0,"FIA",0
22,"22035",225,153,152,1,1,"FIA",0
22,"22111",143,96,95,2,1,"FIA",0
22,"22246",63,43,43,0,0,"FIA",0
22,"22013",271,200,197,3,3,"FIA",0
22,"22072",197,127,126,1,1,"FIA",0
22,"22229",107,70,70,2,0,"FIA",0
50,"50247",852,600,594,8,6,"FIA",0
50,"50293",392,257,255,2,2,"FIA",0
22,"22157",181,122,121,2,1,"FIA",0
22,"22128",188,145,143,3,2,"FIA",0
22,"22223",77,60,59,2,1,"FIA",0
50,"50161",98,75,74,2,1,"FIA",0
22,"22088",143,98,97,1,1,"FIA",0
50,"50163",3846,2863,2840,25,23,"FIA",3
22,"22172",520,373,369,5,4,"FIA",0
50,"50209",2785,1893,1865,24,28,"FIA",1
22,"22115",348,263,261,3,2,"FIA",0
50,"50278",175,133,131,2,2,"FIA",0
22,"22041",145,116,116,2,0,"FIA",0
22,"22156",289,216,213,1,3,"FIA",0
50,"50027",223,166,161,2,5,"FIA",0
22,"22143",190,118,115,1,3,"FIA",0
50,"50193",664,487,475,4,12,"FIA",1
50,"50109",95,65,62,2,3,"FIA",0
22,"22106",20,13,13,2,0,"FIA",0
50,"50201",449,345,344,4,1,"FIA",0
50,"50063",64,49,49,0,0,"FIA",0
50,"50136",532,366,361,3,5,"FIA",0
50,"50001",89,68,68,0,0,"FIA",0
22,"22206",179,138,137,0,1,"FIA",0
50,"50104",320,251,251,1,0,"FIA",0
50,"50263",171,110,108,1,2,"FIA",0
50,"50156",212,156,151,2,5,"FIA",0
22,"22063",161,128,126,0,2,"FIA",0
22,"22015",299,218,215,1,3,"FIA",0
22,"22113",478,335,333,6,2,"FIA",0
22,"22150",459,325,321,8,4,"FIA",0
22,"22046",713,555,549,9,6,"FIA",0
50,"50033",61,44,44,1,0,"FIA",0
50,"50171",99,69,69,2,0,"FIA",0
50,"50110",340,248,238,1,10,"FIA",1
22,"22016",558,384,382,5,2,"FIA",0
22,"22155",66,52,52,0,0,"FIA",0
22,"22076",285,207,203,4,4,"FIA",0
22,"22222",516,379,377,6,2,"FIA",2
22,"22901",714,433,423,6,10,"FIA",0
22,"22009",581,387,386,7,1,"FIA",0
50,"50037",125,85,80,0,5,"FIA",0
50,"50202",124,76,74,0,2,"FIA",0
50,"50286",75,54,53,0,1,"FIA",0
22,"22212",69,52,52,1,0,"FIA",0
50,"50084",67,47,47,1,0,"FIA",0
50,"50134",120,85,82,4,3,"FIA",0
50,"50275",111,50,50,0,0,"FIA",0
50,"50108",50,37,37,0,0,"FIA",0
50,"50264",151,111,110,0,1,"FIA",0
50,"50123",430,304,297,3,7,"FIA",0
50,"50207",87,58,58,1,0,"FIA",0
22,"22230",291,209,207,4,2,"FIA",0
22,"22020",115,83,80,3,3,"FIA",0
22,"22228",532,371,364,4,7,"FIA",1
22,"22094",102,69,69,3,0,"FIA",0
50,"50101",833,557,550,5,7,"FIA",1
50,"50080",34,27,27,0,0,"FIA",0
22,"22135",173,123,121,0,2,"FIA",0
50,"50061",190,157,155,2,2,"FIA",0
22,"22057",364,253,248,4,5,"FIA",0
50,"50096",34,22,22,0,0,"FIA",0
22,"22032",102,69,68,1,1,"FIA",0
22,"22133",108,71,71,3,0,"FIA",0
22,"22044",234,166,164,1,2,"FIA",0
22,"22075",116,71,69,1,2,"FIA",0
50,"50023",199,145,143,2,2,"FIA",0
22,"22110",700,476,473,3,3,"FIA",0
50,"50180",107,85,85,1,0,"FIA",0
50,"50131",212,152,147,4,5,"FIA",0
22,"22178",105,89,89,1,0,"FIA",0
22,"22027",311,210,209,1,1,"FIA",0
50,"50048",33,25,25,0,0,"FIA",0
50,"50219",4283,3034,2990,30,44,"FIA",1
22,"22067",70,52,52,0,0,"FIA",0
50,"50250",54,44,44,2,0,"FIA",0
50,"50217",426,333,333,1,0,"FIA",0
22,"22114",124,75,72,1,3,"FIA",0
50,"50296",385,240,235,3,5,"FIA",0
50,"50214",18,18,14,1,4,"FIA",0
50,"50142",23,16,16,1,0,"FIA",0
50,"50234",242,159,154,4,5,"FIA",0
50,"50188",26,23,23,0,0,"FIA",0
50,"50032",243,167,164,3,3,"FIA",0
50,"50248",501,344,328,3,16,"FIA",0
50,"50137",958,740,731,8,9,"FIA",1
50,"50149",34,25,25,0,0,"FIA",0
22,"22160",207,149,149,1,0,"FIA",0
50,"50267",565,380,375,4,5,"FIA",1
50,"50011",117,90,89,3,1,"FIA",0
22,"22193",272,199,194,4,5,"FIA",0
22,"22902",206,147,144,1,3,"FIA",0
50,"50292",130,108,107,0,1,"FIA",0
50,"50016",44,31,31,0,0,"FIA",0
22,"22064",155,100,100,2,0,"FIA",0
50,"50227",107,62,62,1,0,"FIA",0
22,"22213",2918,2084,2062,20,22,"FIA",0
50,"50017",1773,1283,1265,13,18,"FIA",0
50,"50135",85,59,59,0,0,"FIA",0
50,"50189",678,494,487,6,7,"FIA",0
22,"22247",28,18,18,0,0,"FIA",0
22,"22189",175,142,142,1,0,"FIA",0
50,"50276",118,91,91,0,0,"FIA",0
50,"50153",914,683,675,9,8,"FIA",0
22,"22165",449,305,300,3,5,"FIA",0
50,"50244",192,131,130,1,1,"FIA",0
50,"50117",123,93,93,4,0,"FIA",0
50,"50092",290,218,214,0,4,"FIA",0
50,"50274",64,46,43,1,3,"FIA",0
22,"22007",751,527,520,1,7,"FIA",1
50,"50203",1065,817,804,5,13,"FIA",0
50,"50065",56,37,37,0,0,"FIA",0
50,"50184",87,70,70,0,0,"FIA",0
50,"50051",802,551,550,2,1,"FIA",0
22,"22103",664,489,489,4,0,"FIA",0
50,"50013",199,158,158,0,0,"FIA",0
22,"22045",65,52,52,0,0,"FIA",0
50,"50902",77,65,62,0,3,"FIA",0
50,"50198",47,32,32,0,0,"FIA",0
22,"22130",10146,6505,6436,57,69,"FIA",7
50,"50079",226,162,160,1,2,"FIA",0
50,"50043",241,155,154,1,1,"FIA",0
50,"50185",140,93,92,1,1,"FIA",0
50,"50073",2122,1559,1540,14,19,"FIA",1
50,"50223",906,702,693,9,9,"FIA",0
50,"50242",99,74,74,0,0,"FIA",0
50,"50071",126,84,84,0,0,"FIA",0
50,"50238",84,65,65,0,0,"FIA",0
50,"50140",153,96,95,1,1,"FIA",0
50,"50055",3635,2298,2244,36,54,"FIA",5
22,"22227",200,140,140,2,0,"FIA",0
22,"22008",144,113,112,2,1,"FIA",0
50,"50044",224,159,159,2,0,"FIA",0
50,"50232",160,93,92,1,1,"FIA",0
50,"50132",780,549,538,7,11,"FIA",1
50,"50088",274,195,191,2,4,"FIA",1
50,"50138",45,37,37,3,0,"FIA",0
50,"50212",32,26,26,0,0,"FIA",0
22,"22086",194,137,137,1,0,"FIA",1
50,"50246",37,24,24,0,0,"FIA",0
22,"22129",162,110,110,0,0,"FIA",0
50,"50113",587,471,461,2,10,"FIA",0
50,"50164",381,245,243,3,2,"FIA",0
22,"22168",22,20,19,0,1,"FIA",1
50,"50012",94,76,72,0,4,"FIA",0
50,"50094",1500,1041,1022,12,19,"FIA",0
22,"22226",761,537,530,13,7,"FIA",0
50,"50128",26,23,23,0,0,"FIA",0
22,"22085",94,78,76,0,2,"FIA",0
50,"50269",287,172,167,2,5,"FIA",0
22,"22163",426,338,335,0,3,"FIA",0
50,"50018",883,622,616,5,6,"FIA",0
50,"50100",304,215,212,1,3,"FIA",0
50,"50042",19,17,17,1,0,"FIA",0
50,"50098",162,119,118,1,1,"FIA",0
22,"22158",11994,8115,8049,79,66,"FIA",5
22,"22149",301,211,210,1,1,"FIA",0
50,"50291",95,76,76,0,0,"FIA",0
22,"22175",184,129,128,0,1,"FIA",0
22,"22051",90,72,72,2,0,"FIA",0
50,"50070",50,30,29,0,1,"FIA",0
22,"22220",147,106,105,1,1,"FIA",0
22,"22029",118,85,83,1,2,"FIA",0
50,"50259",82,55,55,2,0,"FIA",0
50,"50155",95,65,65,0,0,"FIA",0
22,"22022",542,405,403,2,2,"FIA",0
50,"50038",1404,1024,1007,15,17,"FIA",0
50,"50099",3036,2137,2113,17,24,"FIA",0
50,"50220",45,38,38,0,0,"FIA",0
22,"22066",755,529,520,8,9,"FIA",0
22,"22119",1267,880,871,4,9,"FIA",1
50,"50218",112,88,88,1,0,"FIA",0
22,"22225",2606,1638,1612,20,26,"FIA",0
22,"22011",98,80,79,0,1,"FIA",0
22,"22062",154,107,107,1,0,"FIA",0
22,"22908",190,135,134,0,1,"FIA",0
50,"50196",101,73,73,0,0,"FIA",0
22,"22254",1084,744,735,10,9,"FIA",0
22,"22096",332,248,241,10,7,"FIA",0
22,"22221",92,56,55,0,1,"FIA",0
22,"22095",66,52,51,1,1,"FIA",0
50,"50039",462,339,333,1,6,"FIA",0
50,"50191",446,327,326,1,1,"FIA",0
22,"22122",69,52,50,2,2,"FIA",0
50,"50056",399,296,296,3,0,"FIA",0
50,"50224",61,44,44,2,0,"FIA",0
50,"50144",31,24,24,0,0,"FIA",0
22,"22201",264,188,186,3,2,"FIA",0
22,"22039",813,635,634,4,1,"FIA",0
50,"50216",236,169,167,0,2,"FIA",0
50,"50086",176,106,102,1,4,"FIA",0
50,"50159",640,493,486,3,7,"FIA",0
22,"22190",123,77,77,1,0,"FIA",0
22,"22117",2384,1606,1596,18,10,"FIA",0
50,"50176",220,142,142,3,0,"FIA",0
50,"50005",228,185,184,2,1,"FIA",0
22,"22142",94,72,70,0,2,"FIA",0
22,"22243",43,32,31,0,1,"FIA",0
50,"50168",29,20,20,0,0,"FIA",0
22,"22112",9525,6317,6245,91,72,"FIA",2
50,"50151",607,450,449,12,1,"FIA",0
22,"22099",490,349,343,2,6,"FIA",0
50,"50095",12149,8322,8239,91,83,"FIA",6
50,"50046",162,125,125,6,0,"FIA",0
50,"50298",5439,4053,4007,41,46,"FIA",3
22,"22068",64,41,41,1,0,"FIA",0
50,"50024",543,400,397,3,3,"FIA",0
22,"22059",1135,765,752,2,13,"FIA",1
50,"50053",643,476,466,3,10,"FIA",0
50,"50040",82,66,66,1,0,"FIA",0
50,"50129",212,129,127,0,2,"FIA",0
22,"22052",874,660,652,7,8,"FIA",0
22,"22037",112,87,87,2,0,"FIA",0
22,"22077",362,280,272,5,8,"FIA",0
50,"50074",6156,4100,4022,33,78,"FIA",2
50,"50251",8209,5732,5658,66,74,"FIA",6
50,"50284",129,98,98,0,0,"FIA",0
50,"50235",2421,1721,1702,18,19,"FIA",0
50,"50178",269,165,163,6,2,"FIA",0
50,"50186",37,26,26,1,0,"FIA",0
50,"50270",38,26,25,0,1,"FIA",0
50,"50295",48,41,41,0,0,"FIA",0
22,"22047",248,202,201,1,1,"FIA",0
50,"50285",657,448,442,4,6,"FIA",0
50,"50150",624,387,384,2,3,"FIA",1
50,"50160",2140,1421,1394,14,27,"FIA",3
22,"22054",1614,1029,1009,19,20,"FIA",1
22,"22006",268,167,164,4,3,"FIA",0
50,"50007",51,34,34,1,0,"FIA",0
22,"22203",77,62,62,2,0,"FIA",0
50,"50139",318,237,237,1,0,"FIA",0
50,"50107",988,758,755,8,3,"FIA",0
22,"22170",672,460,456,5,4,"FIA",0
50,"50255",199,152,147,3,5,"FIA",0
50,"50181",999,748,732,3,16,"FIA",0
22,"22184",167,132,130,4,2,"FIA",0
50,"50173",156,114,114,0,0,"FIA",0
22,"22107",102,53,53,0,0,"FIA",0
22,"22058",193,141,141,0,0,"FIA",0
50,"50237",100,75,75,2,0,"FIA",0
50,"50231",253,199,195,4,4,"FIA",0
50,"50195",53,42,38,0,4,"FIA",0
50,"50174",80,58,57,0,1,"FIA",0
50,"50903",2268,1685,1670,16,15,"FIA",1
50,"50240",943,693,683,12,10,"FIA",0
50,"50035",74,57,57,0,0,"FIA",0
50,"50166",235,186,186,0,0,"FIA",0
22,"22109",261,184,183,1,1,"FIA",0
22,"22040",149,119,119,3,0,"FIA",0
22,"22205",448,294,292,0,2,"FIA",0
50,"50229",65,46,46,1,0,"FIA",0
22,"22181",86,55,54,2,1,"FIA",0
50,"50014",119,81,81,0,0,"FIA",0
50,"50281",68,52,50,0,2,"FIA",0
22,"22141",115,94,93,0,1,"FIA",0
50,"50213",92,70,70,2,0,"FIA",0
50,"50172",174,125,123,2,2,"FIA",0
50,"50230",1140,771,767,11,4,"FIA",0
50,"50116",169,124,123,0,1,"FIA",0
22,"22002",99,81,81,0,0,"FIA",0
50,"50064",439,348,346,1,2,"FIA",0
50,"50205",72,51,49,0,2,"FIA",0
22,"22177",96,69,68,0,1,"FIA",0
50,"50228",249,207,207,3,0,"FIA",0
22,"22024",220,159,158,1,1,"FIA",0
50,"50297",503800,365284,362768,3385,2516,"FIA",270
22,"22174",462,352,350,0,2,"FIA",0
22,"22087",60,46,46,0,0,"FIA",0
22,"22042",116,91,89,1,2,"FIA",0
22,"22162",125,94,94,0,0,"FIA",0
50,"50119",876,633,625,11,8,"FIA",0
50,"50258",53,25,25,1,0,"FIA",0
50,"50003",117,89,89,1,0,"FIA",0
22,"22082",288,217,214,0,3,"FIA",25
22,"22050",93,77,77,0,0,"FIA",0
22,"22250",346,241,241,0,0,"FIA",0
22,"22909",307,219,217,0,2,"FIA",0
50,"50272",13226,9250,9153,97,97,"FIA",31
22,"22124",183,119,119,0,0,"FIA",0
22,"22074",303,209,208,5,1,"FIA",0
50,"50010",67,52,52,1,0,"FIA",0
50,"50152",1351,942,932,14,10,"FIA",1
22,"22049",73,62,62,0,0,"FIA",0
22,"22239",85,67,65,0,2,"FIA",0
50,"50177",288,196,193,0,3,"FIA",0
50,"50154",114,92,92,1,0,"FIA",0
50,"50085",182,121,121,0,0,"FIA",0
50,"50215",20,14,14,0,0,"FIA",0
50,"50133",98,76,76,0,0,"FIA",0
50,"50192",227,182,181,0,1,"FIA",0
50,"50273",33,24,24,1,0,"FIA",0
22,"22131",84,62,58,5,4,"FIA",0
22,"22048",12635,8889,8807,98,82,"FIA",7
50,"50106",123,78,78,0,0,"FIA",0
50,"50233",96,78,78,0,0,"FIA",0
22,"22144",255,192,190,2,2,"FIA",0
50,"50183",316,227,223,1,4,"FIA",0
50,"50170",357,245,242,6,3,"FIA",0
50,"50028",78,53,53,0,0,"FIA",0
22,"22081",247,173,171,3,2,"FIA",0
22,"22906",177,123,122,6,1,"FIA",0
50,"50254",179,115,113,0,2,"FIA",0
22,"22182",227,132,131,3,1,"FIA",0
22,"22137",1009,671,665,1,6,"FIA",0
22,"22236",232,190,188,2,2,"FIA",0
50,"50261",201,154,151,0,3,"FIA",0
50,"50165",1768,1255,1222,20,33,"FIA",1
50,"50266",120,77,76,3,1,"FIA",0
50,"50067",13928,9831,9699,92,132,"FIA",3
22,"22197",436,327,325,3,2,"FIA",0
50,"50111",181,130,130,1,0,"FIA",0
22,"22139",80,57,57,1,0,"FIA",0
22,"22019",176,128,126,1,2,"FIA",0
22,"22105",102,65,65,0,0,"FIA",0
50,"50197",95,69,68,2,1,"FIA",0
22,"22214",117,92,89,0,3,"FIA",0
50,"50082",82,57,57,0,0,"FIA",0
50,"50187",55,42,42,0,0,"FIA",0
50,"50200",479,389,383,5,6,"FIA",0
50,"50239",63,46,45,1,1,"FIA",0
50,"50034",767,516,511,10,5,"FIA",0
50,"50060",171,126,125,1,1,"FIA",0
50,"50058",63,45,43,0,2,"FIA",0
50,"50031",134,78,75,0,3,"FIA",1
50,"50901",133,96,96,0,0,"FIA",0
22,"22904",751,516,511,3,5,"FIA",0
50,"50290",360,260,255,5,5,"FIA",0
22,"22021",1884,1331,1319,26,12,"FIA",2
50,"50130",354,225,222,1,3,"FIA",0
22,"22069",423,296,294,4,2,"FIA",0
50,"50243",307,227,224,2,3,"FIA",0
50,"50062",1885,1332,1308,15,24,"FIA",1
50,"50057",1331,933,922,10,11,"FIA",0
50,"50030",197,124,124,1,0,"FIA",0
22,"22089",274,195,193,2,2,"FIA",0
50,"50019",63,46,46,0,0,"FIA",0
50,"50199",318,206,201,1,5,"FIA",0
22,"22028",358,237,233,1,4,"FIA",0
50,"50072",183,131,129,0,2,"FIA",0
22,"22253",56,40,40,1,0,"FIA",0
22,"22208",192,150,147,1,3,"FIA",0
22,"22001",212,147,146,0,1,"FIA",0
22,"22187",288,220,220,2,0,"FIA",0
50,"50122",68,43,42,1,1,"FIA",0
50,"50054",55,37,37,2,0,"FIA",0
50,"50282",55,38,38,1,0,"FIA",1
22,"22079",118,85,84,1,1,"FIA",0
50,"50288",3440,2513,2486,26,27,"FIA",12
50,"50081",487,355,349,5,6,"FIA",0
22,"22200",239,165,164,2,1,"FIA",0
22,"22127",521,353,352,5,1,"FIA",0
22,"22186",189,148,145,3,3,"FIA",0
50,"50020",795,548,545,4,3,"FIA",1
50,"50006",913,670,654,13,16,"FIA",0
50,"50241",582,414,406,2,8,"FIA",0
22,"22207",121,66,65,0,1,"FIA",0
50,"50265",74,54,54,1,0,"FIA",0
22,"22233",81,53,53,0,0,"FIA",0
50,"50015",81,57,56,0,1,"FIA",0
22,"22167",465,358,356,8,2,"FIA",0
22,"22232",88,61,61,2,0,"FIA",0
50,"50287",253,189,188,11,1,"FIA",0
22,"22251",327,259,256,0,3,"FIA",1
22,"22012",102,75,75,2,0,"FIA",0
50,"50076",70,56,56,0,0,"FIA",0
50,"50004",475,360,356,2,4,"FIA",0
50,"50078",227,168,166,0,2,"FIA",0
50,"50257",159,128,125,2,3,"FIA",0
22,"22209",161,121,121,3,0,"FIA",0
50,"50175",907,638,632,11,6,"FIA",1
50,"50045",1217,891,878,10,13,"FIA",0
22,"22245",303,222,213,3,9,"FIA",0
50,"50271",246,179,173,4,6,"FIA",0
22,"22053",783,494,492,6,2,"FIA",0
22,"22218",39,34,34,0,0,"FIA",0
22,"22244",42,33,32,1,1,"FIA",0
50,"50211",236,174,173,0,1,"FIA",0
22,"22204",1117,728,723,14,5,"FIA",0
22,"22173",219,147,141,3,6,"FIA",0
50,"50141",104,80,78,0,2,"FIA",0
22,"22235",88,69,68,1,1,"FIA",0
50,"50208",1761,1267,1250,16,17,"FIA",0
50,"50148",304,213,211,2,2,"FIA",0
31,"31247",141,99,96,1,3,"GBAI",10
31,"31128",349,217,215,4,2,"GBAI",6
31,"31027",811,527,521,1,6,"GBAI",80
31,"31007",122,88,82,1,6,"GBAI",1
31,"31152",1255,826,817,8,9,"GBAI",24
31,"31074",394,293,292,5,1,"GBAI",8
31,"31104",1751,1147,1125,8,22,"GBAI",20
31,"31251",3144,2197,2164,18,33,"GBAI",77
31,"31062",1070,778,770,10,8,"GBAI",3
31,"31026",130,108,107,0,1,"GBAI",4
31,"31906",2707,1800,1781,22,19,"GBAI",65
31,"31165",2772,1946,1930,16,16,"GBAI",12
31,"31140",112,73,73,1,0,"GBAI",8
31,"31114",388,272,271,3,1,"GBAI",7
31,"31116",57,27,27,3,0,"GBAI",2
31,"31043",29,23,23,0,0,"GBAI",6
31,"31215",4670,3270,3219,33,51,"GBAI",16
31,"31039",92,70,69,1,1,"GBAI",2
31,"31151",53,37,37,0,0,"GBAI",3
31,"31069",823,596,595,1,1,"GBAI",5
31,"31100",256,166,165,0,1,"GBAI",15
31,"31138",948,629,627,8,2,"GBAI",80
31,"31051",241,169,167,3,2,"GBAI",2
31,"31058",199,134,133,2,1,"GBAI",15
31,"31260",1265,817,815,7,2,"GBAI",26
31,"31102",135,60,60,1,0,"GBAI",11
31,"31052",101,78,75,0,3,"GBAI",1
31,"31222",57,35,34,3,1,"GBAI",5
31,"31055",267,192,191,0,1,"GBAI",45
31,"31015",1989,1399,1386,17,13,"GBAI",14
31,"31099",51,38,38,0,0,"GBAI",1
31,"31213",99,50,50,0,0,"GBAI",8
31,"31089",236,168,167,1,1,"GBAI",6
31,"31016",7790,5541,5502,56,39,"GBAI",187
31,"31235",156,112,108,1,4,"GBAI",6
31,"31060",14323,9547,9434,79,113,"GBAI",340
31,"31202",4360,2806,2767,30,39,"GBAI",27
31,"31183",718,536,534,5,2,"GBAI",29
31,"31098",1984,1443,1428,11,15,"GBAI",71
31,"31066",819,577,559,4,18,"GBAI",8
31,"31049",679,461,453,2,8,"GBAI",24
31,"31225",35,29,28,0,1,"GBAI",1
31,"31201",151450,105649,104976,1004,673,"GBAI",4030
31,"31025",762,497,490,1,7,"GBAI",30
31,"31186",283,183,182,1,1,"GBAI",9
31,"31088",5656,3929,3893,56,36,"GBAI",101
31,"31198",36,30,30,0,0,"GBAI",1
31,"31097",10559,6977,6919,71,58,"GBAI",293
31,"31083",49,39,39,1,0,"GBAI",4
31,"31228",496,356,354,1,2,"GBAI",14
31,"31119",35,24,24,1,0,"GBAI",5
31,"31079",65,46,46,2,0,"GBAI",2
31,"31031",212,134,132,2,2,"GBAI",14
31,"31209",149,111,110,0,1,"GBAI",3
31,"31112",91,56,56,0,0,"GBAI",8
31,"31238",119,96,95,4,1,"GBAI",0
31,"31080",486,362,361,4,1,"GBAI",15
31,"31229",39,32,32,0,0,"GBAI",2
31,"31076",2543,1965,1956,19,9,"GBAI",64
31,"31149",2285,1531,1520,10,11,"GBAI",117
31,"31197",67,51,51,2,0,"GBAI",1
31,"31141",106,66,61,1,5,"GBAI",2
31,"31123",615,350,347,4,3,"GBAI",39
31,"31004",31,22,22,1,0,"GBAI",1
31,"31064",1398,1035,1031,5,4,"GBAI",10
31,"31153",2174,1417,1415,12,2,"GBAI",270
31,"31048",166,121,119,1,2,"GBAI",3
31,"31125",271,173,171,3,2,"GBAI",7
31,"31230",90,66,66,0,0,"GBAI",9
31,"31019",1831,1231,1224,17,7,"GBAI",54
31,"31189",1125,702,698,6,4,"GBAI",34
31,"31095",71,59,59,0,0,"GBAI",5
31,"31205",419,290,289,4,1,"GBAI",5
31,"31009",674,455,451,2,4,"GBAI",21
31,"31017",375,250,250,10,0,"GBAI",20
31,"31181",133,87,84,1,3,"GBAI",1
31,"31024",100,52,52,0,0,"GBAI",7
31,"31265",76,43,40,0,3,"GBAI",3
31,"31199",138,86,84,0,2,"GBAI",8
31,"31070",2633,1714,1682,16,32,"GBAI",8
31,"31252",80,52,52,1,0,"GBAI",1
31,"31170",44,31,30,2,1,"GBAI",1
31,"31011",715,483,481,5,2,"GBAI",21
31,"31111",91,52,52,0,0,"GBAI",6
31,"31087",179,124,124,3,0,"GBAI",17
31,"31210",186,131,130,2,1,"GBAI",11
31,"31022",477,303,301,2,2,"GBAI",47
31,"31092",683,413,413,6,0,"GBAI",37
31,"31105",1471,1144,1124,10,20,"GBAI",2
31,"31115",159,93,93,2,0,"GBAI",12
31,"31042",2707,1926,1900,11,26,"GBAI",4
31,"31124",207,134,134,2,0,"GBAI",7
31,"31144",760,442,441,4,1,"GBAI",33
31,"31193",1440,1062,1055,11,7,"GBAI",46
31,"31250",2761,1776,1759,13,17,"GBAI",205
31,"31185",461,291,290,1,1,"GBAI",25
31,"31091",322,201,201,3,0,"GBAI",28
31,"31108",1819,1348,1325,13,23,"GBAI",10
31,"31159",1097,813,812,2,1,"GBAI",48
31,"31263",231,137,137,1,0,"GBAI",12
31,"31086",13781,10133,10054,114,79,"GBAI",395
31,"31241",126,86,85,2,1,"GBAI",5
31,"31063",84,59,59,0,0,"GBAI",4
31,"31145",160,121,120,2,1,"GBAI",2
31,"31239",282,196,193,6,3,"GBAI",33
31,"31177",245,161,159,1,2,"GBAI",4
31,"31231",104,65,65,1,0,"GBAI",2
31,"31036",879,601,589,5,12,"GBAI",19
31,"31040",186,131,129,1,2,"GBAI",3
31,"31157",3447,2182,2160,29,22,"GBAI",30
31,"31901",15487,11077,10991,117,86,"GBAI",364
31,"31068",2816,2028,1989,20,39,"GBAI",11
31,"31220",742,551,539,6,12,"GBAI",8
31,"31167",833,581,573,2,8,"GBAI",17
31,"31169",2203,1429,1415,15,14,"GBAI",7
31,"31256",95,55,55,1,0,"GBAI",6
31,"31032",1670,1158,1147,18,11,"GBAI",6
31,"31008",61,42,42,0,0,"GBAI",0
31,"31179",486,315,312,3,3,"GBAI",3
31,"31142",1389,909,900,9,9,"GBAI",15
31,"31264",179,91,90,2,1,"GBAI",5
31,"31057",1741,1237,1219,6,18,"GBAI",0
31,"31187",99,53,52,0,1,"GBAI",13
31,"31047",238,163,163,2,0,"GBAI",12
31,"31075",113,69,69,2,0,"GBAI",5
31,"31242",258,168,167,2,1,"GBAI",9
31,"31206",2077,1433,1417,15,16,"GBAI",56
31,"31021",59,42,42,1,0,"GBAI",3
31,"31905",2992,1994,1984,9,10,"GBAI",38
31,"31127",131,90,86,0,4,"GBAI",8
31,"31196",31,23,23,0,0,"GBAI",1
31,"31246",130,89,87,2,2,"GBAI",5
31,"31014",268,168,168,2,0,"GBAI",4
31,"31136",461,294,293,3,1,"GBAI",13
31,"31002",431,294,290,3,4,"GBAI",26
31,"31172",370,257,250,6,7,"GBAI",9
31,"31001",79,56,56,0,0,"GBAI",6
31,"31084",1946,1367,1362,9,5,"GBAI",174
31,"31164",542,410,408,5,2,"GBAI",2
31,"31207",280,194,191,3,3,"GBAI",13
31,"31018",426,287,283,2,4,"GBAI",5
31,"31907",11272,8478,8421,97,57,"GBAI",418
31,"31219",80,59,58,2,1,"GBAI",1
31,"31234",146,101,101,0,0,"GBAI",6
31,"31059",182,121,121,1,0,"GBAI",5
31,"31259",475,313,311,5,2,"GBAI",52
31,"31120",376,211,209,7,2,"GBAI",11
31,"31243",300,216,213,6,3,"GBAI",6
31,"31194",328,224,222,3,2,"GBAI",20
31,"31254",1916,1336,1322,9,14,"GBAI",15
31,"31038",1343,975,963,16,12,"GBAI",32
31,"31184",65,41,40,0,1,"GBAI",2
31,"31135",111,73,72,3,1,"GBAI",4
31,"31173",845,642,636,4,6,"GBAI",3
31,"31244",157,69,69,0,0,"GBAI",21
31,"31118",156,104,104,3,0,"GBAI",7
31,"31121",62,42,42,0,0,"GBAI",1
31,"31130",321,203,203,0,0,"GBAI",22
31,"31045",510,347,345,8,2,"GBAI",7
31,"31093",275,201,198,3,3,"GBAI",12
31,"31078",2418,1752,1729,16,23,"GBAI",6
31,"31034",31,24,24,0,0,"GBAI",2
31,"31226",572,347,343,4,4,"GBAI",39
31,"31132",147,100,100,2,0,"GBAI",1
31,"31249",1798,1235,1227,13,8,"GBAI",12
31,"31168",238,176,174,1,2,"GBAI",10
31,"31150",200,120,119,1,1,"GBAI",4
31,"31204",36,25,25,0,0,"GBAI",0
31,"31107",1671,1204,1182,12,22,"GBAI",0
31,"31131",913,672,664,8,8,"GBAI",36
31,"31262",234,190,188,0,2,"GBAI",13
31,"31212",128,91,91,1,0,"GBAI",2
31,"31067",1887,1265,1249,6,16,"GBAI",27
31,"31160",104,83,82,1,1,"GBAI",1
31,"31902",4661,3228,3201,39,27,"GBAI",137
31,"31161",350,261,256,1,5,"GBAI",13
31,"31171",670,466,462,1,4,"GBAI",9
31,"31217",327,204,196,1,8,"GBAI",2
31,"31216",3867,2592,2566,37,26,"GBAI",81
31,"31192",160,125,123,0,2,"GBAI",6
31,"31156",238,175,174,2,1,"GBAI",10
31,"31071",13,11,11,0,0,"GBAI",0
31,"31003",121,71,71,0,0,"GBAI",7
31,"31072",5324,3733,3684,33,49,"GBAI",19
31,"31023",7778,5977,5948,106,29,"GBAI",215
31,"31255",103,79,79,0,0,"GBAI",2
31,"31240",514,352,352,3,0,"GBAI",50
31,"31188",319,197,191,3,6,"GBAI",8
31,"31176",2919,1974,1933,27,41,"GBAI",14
31,"31180",202,144,143,1,1,"GBAI",10
31,"31908",1076,763,762,5,1,"GBAI",113
31,"31030",135,94,94,0,0,"GBAI",6
31,"31096",99,79,79,3,0,"GBAI",2
31,"31061",48,45,45,2,0,"GBAI",0
31,"31101",1428,986,981,6,5,"GBAI",42
31,"31073",298,207,206,1,1,"GBAI",20
31,"31154",217,107,104,0,3,"GBAI",17
31,"31020",435,224,222,1,2,"GBAI",27
31,"31178",476,323,320,7,3,"GBAI",6
31,"31005",279,183,183,4,0,"GBAI",2
31,"31006",1877,1328,1310,14,18,"GBAI",2
31,"31163",2011,1422,1404,6,18,"GBAI",16
31,"31044",291,227,227,1,0,"GBAI",29
31,"31245",76,51,48,2,3,"GBAI",5
31,"31065",1843,1311,1300,12,11,"GBAI",11
31,"31037",91,70,70,0,0,"GBAI",10
31,"31258",7879,5668,5631,50,37,"GBAI",297
31,"31208",2568,1855,1835,24,20,"GBAI",31
31,"31103",40,28,27,0,1,"GBAI",0
31,"31904",1559,989,972,11,17,"GBAI",62
31,"31237",182,138,135,2,3,"GBAI",8
31,"31035",50,30,29,0,1,"GBAI",2
31,"31090",139,67,67,0,0,"GBAI",16
31,"31166",242,172,172,2,0,"GBAI",2
31,"31182",29,25,25,0,0,"GBAI",0
31,"31134",172,106,106,1,0,"GBAI",11
31,"31077",5416,3840,3794,38,46,"GBAI",28
31,"31191",3024,2156,2133,23,23,"GBAI",57
31,"31147",110,79,78,1,1,"GBAI",6
31,"31109",1657,1165,1160,12,5,"GBAI",27
31,"31200",745,489,483,1,6,"GBAI",13
31,"31148",92,62,59,2,3,"GBAI",4
31,"31203",30,19,19,2,0,"GBAI",1
31,"31162",48,28,27,1,1,"GBAI",2
31,"31257",915,654,642,9,12,"GBAI",22
31,"31133",34,27,27,1,0,"GBAI",2
31,"31129",388,239,238,3,1,"GBAI",19
31,"31143",91,44,41,1,3,"GBAI",1
31,"31261",240,161,158,2,3,"GBAI",0
31,"31106",721,547,545,1,2,"GBAI",1
31,"31081",338,229,227,1,2,"GBAI",33
31,"31029",913,606,601,14,5,"GBAI",14
31,"31054",453,279,276,2,3,"GBAI",29
31,"31033",45,25,25,2,0,"GBAI",2
31,"31158",248,156,151,0,5,"GBAI",3
31,"31010",5719,3799,3770,22,29,"GBAI",426
31,"31146",30,22,22,1,0,"GBAI",0
31,"31175",66,46,46,0,0,"GBAI",6
31,"31211",17,15,14,3,1,"GBAI",1
31,"31110",83,61,61,1,0,"GBAI",0
31,"31236",1319,815,808,8,7,"GBAI",61
31,"31085",500,365,362,2,3,"GBAI",25
31,"31122",4981,3539,3504,38,35,"GBAI",173
31,"31126",352,223,223,3,0,"GBAI",21
31,"31248",272,142,138,3,4,"GBAI",13
31,"31214",87,55,54,0,1,"GBAI",8
31,"31174",100,55,55,0,0,"GBAI",3
31,"31137",198,83,83,1,0,"GBAI",16
31,"31232",25687,17548,17304,243,244,"GBAI",141
31,"31013",615,371,365,1,6,"GBAI",17
31,"31221",1228,823,815,6,8,"GBAI",90
31,"31190",44,30,30,1,0,"GBAI",3
31,"31041",1671,1118,1105,15,13,"GBAI",32
31,"31233",91,62,60,2,2,"GBAI",2
31,"31195",169,108,108,0,0,"GBAI",15
31,"31223",953,667,654,4,13,"GBAI",5
31,"31253",121,100,100,0,0,"GBAI",7
31,"31139",152,100,100,1,0,"GBAI",8
31,"31224",884,637,630,7,7,"GBAI",10
31,"31053",509,354,350,4,4,"GBAI",10
31,"31094",105,70,70,1,0,"GBAI",0
31,"31903",6950,4430,4394,39,36,"GBAI",95
31,"31227",8118,5691,5636,65,55,"GBAI",142
31,"31046",53,38,38,0,0,"GBAI",0
31,"31028",215,121,121,2,0,"GBAI",15
31,"31113",130,77,76,0,1,"GBAI",8
31,"31050",6016,3675,3612,41,63,"GBAI",381
31,"31056",186,128,124,2,4,"GBAI",4
31,"31155",246,165,161,3,4,"GBAI",5
31,"31012",763,550,542,7,8,"GBAI",11
31,"31082",627,385,385,5,0,"GBAI",46
31,"31117",583,373,372,3,1,"GBAI",25
8,"8136",11692,8527,8456,98,71,"I.Fem",5
8,"8131",745,552,550,3,2,"I.Fem",0
8,"8239",467,362,361,3,1,"I.Fem",0
8,"8262",6945,4649,4599,38,50,"I.Fem",13
8,"8005",6425,4830,4816,28,14,"I.Fem",1
8,"8045",65,44,43,0,1,"I.Fem",0
8,"8060",139,110,108,1,2,"I.Fem",0
8,"8159",14343,10656,10603,87,53,"I.Fem",15
8,"8234",3443,2561,2550,15,11,"I.Fem",1
8,"8032",2100,1472,1465,12,7,"I.Fem",1
8,"8091",5428,4048,4024,20,24,"I.Fem",2
8,"8270",19014,13635,13594,74,41,"I.Fem",7
8,"8116",557,449,449,1,0,"I.Fem",0
8,"8075",4144,2951,2943,20,8,"I.Fem",2
8,"8257",103,82,82,0,0,"I.Fem",0
8,"8098",2438,1781,1778,21,3,"I.Fem",1
8,"8144",722,551,545,3,6,"I.Fem",2
8,"8180",27198,19822,19704,160,118,"I.Fem",18
8,"8267",6789,4975,4935,41,40,"I.Fem",8
8,"8132",356,265,265,1,0,"I.Fem",0
8,"8213",6600,4925,4906,30,19,"I.Fem",5
8,"8133",123,96,94,5,2,"I.Fem",0
8,"8259",6979,5362,5341,27,21,"I.Fem",4
8,"8022",12213,8594,8558,42,36,"I.Fem",3
8,"8108",5181,3880,3861,30,19,"I.Fem",2
8,"8120",7129,5649,5621,51,28,"I.Fem",2
8,"8290",1549,1254,1248,6,6,"I.Fem",2
8,"8158",3094,2261,2251,11,10,"I.Fem",3
8,"8214",7007,5390,5371,25,19,"I.Fem",4
8,"8113",52589,36864,36690,244,174,"I.Fem",26
8,"8287",1067,853,844,4,9,"I.Fem",0
8,"8077",34690,25896,25767,164,129,"I.Fem",29
8,"8103",652,476,474,1,2,"I.Fem",1
8,"8161",11826,8001,7951,58,50,"I.Fem",4
8,"8275",247,218,218,3,0,"I.Fem",0
8,"8293",227,177,177,0,0,"I.Fem",0
8,"8229",521,418,417,3,1,"I.Fem",0
8,"8251",5130,3719,3698,20,21,"I.Fem",6
8,"8073",62934,45699,45407,281,292,"I.Fem",44
8,"8297",138,99,99,0,0,"I.Fem",0
8,"8148",2344,1655,1646,13,9,"I.Fem",2
8,"8249",274,238,237,0,1,"I.Fem",0
8,"8264",4608,3459,3444,30,15,"I.Fem",2
8,"8082",1164,796,780,5,16,"I.Fem",0
8,"8166",964,700,697,7,3,"I.Fem",0
8,"8059",340,255,250,1,5,"I.Fem",0
8,"8057",61,47,47,1,0,"I.Fem",0
8,"8308",139,109,109,1,0,"I.Fem",0
8,"8055",542,426,424,3,2,"I.Fem",1
8,"8191",5302,3872,3860,21,12,"I.Fem",0
8,"8171",2046,1520,1510,13,10,"I.Fem",0
8,"8150",258,207,207,1,0,"I.Fem",0
8,"8230",7648,5797,5774,40,23,"I.Fem",4
8,"8067",5746,4299,4270,24,29,"I.Fem",3
8,"8156",11254,8440,8411,58,29,"I.Fem",9
8,"8244",6099,4733,4706,39,27,"I.Fem",4
8,"8298",27148,19655,19568,102,87,"I.Fem",18
8,"8044",4156,2991,2976,16,15,"I.Fem",1
8,"8221",12793,10123,10079,73,44,"I.Fem",7
8,"8226",929,748,747,10,1,"I.Fem",0
8,"8182",2922,2041,2031,10,10,"I.Fem",0
8,"8203",2466,1678,1675,7,3,"I.Fem",0
8,"8169",48478,35283,35114,278,169,"I.Fem",44
8,"8209",6925,4976,4948,39,28,"I.Fem",3
8,"8245",77841,53719,53443,430,276,"I.Fem",54
8,"8143",2727,1989,1977,19,12,"I.Fem",1
8,"8232",1773,1368,1362,9,6,"I.Fem",0
8,"8068",6863,5064,5041,40,23,"I.Fem",3
8,"8289",4473,3379,3371,25,8,"I.Fem",4
8,"8274",4640,3385,3363,24,22,"I.Fem",2
8,"8037",1947,1547,1543,11,4,"I.Fem",2
8,"8260",18515,13563,13487,84,76,"I.Fem",13
8,"8266",43422,32827,32696,241,131,"I.Fem",35
8,"8014",2013,1526,1521,4,5,"I.Fem",1
8,"8019",1122912,824423,821037,5287,3386,"I.Fem",806
8,"8185",197,162,162,1,0,"I.Fem",0
8,"8904",10516,7068,7025,54,43,"I.Fem",10
8,"8017",2808,2033,2016,16,17,"I.Fem",3
8,"8248",5687,4187,4165,21,22,"I.Fem",8
8,"8036",163,122,122,0,0,"I.Fem",0
8,"8265",1597,1262,1260,4,2,"I.Fem",1
8,"8167",6056,4520,4500,38,20,"I.Fem",6
8,"8263",21208,15014,14890,111,124,"I.Fem",12
8,"8174",388,322,318,2,4,"I.Fem",0
8,"8102",28940,21108,21014,157,94,"I.Fem",12
8,"8195",75,62,62,0,0,"I.Fem",0
8,"8006",11774,8375,8329,53,46,"I.Fem",6
8,"8272",164,128,128,1,0,"I.Fem",0
8,"8219",15755,12235,12206,72,29,"I.Fem",7
8,"8128",579,428,423,4,5,"I.Fem",0
8,"8196",19542,14264,14185,123,79,"I.Fem",15
8,"8121",87515,62961,62574,429,387,"I.Fem",54
8,"8027",724,584,582,1,2,"I.Fem",1
8,"8210",4640,3226,3200,24,26,"I.Fem",4
8,"8001",9097,6860,6818,39,42,"I.Fem",8
8,"8183",4573,3406,3398,14,8,"I.Fem",2
8,"8151",450,351,346,5,5,"I.Fem",0
8,"8189",119,96,96,1,0,"I.Fem",0
8,"8198",4679,3491,3469,12,22,"I.Fem",1
8,"8038",1541,1129,1120,6,9,"I.Fem",1
8,"8087",144,120,120,0,0,"I.Fem",0
8,"8047",3751,2600,2578,26,22,"I.Fem",8
8,"8902",3941,2974,2962,16,12,"I.Fem",3
8,"8040",11116,7923,7891,49,32,"I.Fem",7
8,"8179",636,466,465,2,1,"I.Fem",0
8,"8064",1956,1439,1423,7,16,"I.Fem",1
8,"8247",982,799,798,4,1,"I.Fem",1
8,"8903",201,181,181,1,0,"I.Fem",0
8,"8228",292,234,233,0,1,"I.Fem",0
8,"8278",4925,3820,3804,22,16,"I.Fem",2
8,"8074",11190,7698,7651,51,47,"I.Fem",12
8,"8252",24885,18507,18383,162,124,"I.Fem",30
8,"8225",94,83,82,1,1,"I.Fem",0
8,"8294",2093,1546,1534,11,12,"I.Fem",2
8,"8080",40,27,27,3,0,"I.Fem",0
8,"8300",5927,4609,4589,41,20,"I.Fem",9
8,"8009",9531,7200,7171,47,29,"I.Fem",5
8,"8206",744,604,599,5,5,"I.Fem",0
8,"8254",1766,1433,1427,16,6,"I.Fem",0
8,"8090",142,116,116,0,0,"I.Fem",0
8,"8105",9741,6946,6896,62,50,"I.Fem",10
8,"8283",6165,4546,4524,33,22,"I.Fem",1
8,"8197",7986,5829,5805,37,24,"I.Fem",9
8,"8056",42897,30873,30757,259,116,"I.Fem",44
8,"8211",33934,26136,26000,198,136,"I.Fem",17
8,"8053",2896,1939,1929,13,10,"I.Fem",3
8,"8139",172,148,147,2,1,"I.Fem",0
8,"8285",10349,7630,7599,48,31,"I.Fem",5
8,"8110",13671,9362,9311,60,51,"I.Fem",3
8,"8276",241,179,179,3,0,"I.Fem",0
8,"8302",9359,6483,6430,78,53,"I.Fem",9
8,"8041",10698,7324,7258,57,66,"I.Fem",8
8,"8204",3141,2395,2383,16,12,"I.Fem",1
8,"8153",573,457,452,3,5,"I.Fem",1
8,"8190",255,184,182,1,2,"I.Fem",0
8,"8069",3323,2555,2540,21,15,"I.Fem",3
8,"8241",70,52,52,0,0,"I.Fem",0
8,"8043",3414,2429,2422,15,7,"I.Fem",0
8,"8901",240,200,195,2,5,"I.Fem",0
8,"8101",175048,121359,120620,830,739,"I.Fem",162
8,"8194",25680,16465,16376,131,89,"I.Fem",16
8,"8007",6795,5099,5081,29,18,"I.Fem",4
8,"8012",1726,1323,1309,17,14,"I.Fem",0
8,"8065",1183,920,913,8,7,"I.Fem",0
8,"8187",153822,113081,112470,758,611,"I.Fem",128
8,"8281",4858,3783,3762,19,21,"I.Fem",1
8,"8124",37157,27139,26994,179,145,"I.Fem",31
8,"8051",18570,14112,14054,86,58,"I.Fem",7
8,"8246",1692,1345,1340,7,5,"I.Fem",1
8,"8112",12926,9268,9230,61,38,"I.Fem",37
8,"8114",18838,13519,13442,81,77,"I.Fem",19
8,"8192",5701,4366,4349,15,17,"I.Fem",4
8,"8134",848,618,609,4,9,"I.Fem",1
8,"8305",27661,20346,20221,118,125,"I.Fem",11
8,"8146",1384,1030,1027,8,3,"I.Fem",0
8,"8042",2390,1772,1764,12,8,"I.Fem",0
8,"8140",4816,3541,3520,25,21,"I.Fem",1
8,"8079",333,260,258,2,2,"I.Fem",0
8,"8127",2254,1548,1544,10,4,"I.Fem",1
8,"8301",49348,36261,36045,292,216,"I.Fem",37
8,"8117",2489,1954,1941,21,13,"I.Fem",4
8,"8223",1897,1345,1341,10,4,"I.Fem",1
8,"8286",2943,2051,2042,12,9,"I.Fem",1
8,"8072",10769,7632,7600,56,32,"I.Fem",3
8,"8170",442,322,320,0,2,"I.Fem",0
8,"8093",25,22,22,0,0,"I.Fem",0
8,"8011",1739,1360,1353,10,7,"I.Fem",0
8,"8279",156327,112605,112030,952,575,"I.Fem",110
8,"8004",208,177,177,1,0,"I.Fem",0
8,"8163",19672,13421,13364,70,57,"I.Fem",37
8,"8243",154,125,125,2,0,"I.Fem",0
8,"8193",988,739,737,10,2,"I.Fem",1
8,"8295",11290,8091,8054,72,37,"I.Fem",7
8,"8034",820,644,640,0,4,"I.Fem",0
8,"8147",17389,12679,12601,102,78,"I.Fem",21
8,"8094",1588,1258,1252,7,6,"I.Fem",2
8,"8049",1309,910,903,3,7,"I.Fem",1
8,"8066",1466,1109,1104,7,5,"I.Fem",3
8,"8125",25583,18334,18225,122,109,"I.Fem",10
8,"8268",975,729,723,6,6,"I.Fem",0
8,"8303",257,207,205,1,2,"I.Fem",0
8,"8123",19570,15378,15316,91,62,"I.Fem",33
8,"8155",7056,5050,5011,38,39,"I.Fem",5
8,"8063",469,390,390,4,0,"I.Fem",1
8,"8175",3369,2388,2372,18,16,"I.Fem",1
8,"8054",9215,6994,6943,38,51,"I.Fem",9
8,"8242",223,159,159,0,0,"I.Fem",0
8,"8099",753,529,529,4,0,"I.Fem",1
8,"8271",66,48,47,2,1,"I.Fem",0
8,"8097",1103,845,840,4,5,"I.Fem",2
8,"8095",66,49,49,0,0,"I.Fem",0
8,"8178",444,363,361,2,2,"I.Fem",0
8,"8021",60,44,44,1,0,"I.Fem",0
8,"8052",140,102,102,1,0,"I.Fem",0
8,"8141",4578,3369,3357,28,12,"I.Fem",2
8,"8118",17634,13450,13402,80,48,"I.Fem",10
8,"8212",491,393,386,6,7,"I.Fem",1
8,"8224",885,653,652,6,1,"I.Fem",0
8,"8299",380,301,300,4,1,"I.Fem",0
8,"8107",11965,8604,8554,67,50,"I.Fem",10
8,"8233",1872,1428,1420,15,8,"I.Fem",0
8,"8083",1672,1433,1430,6,3,"I.Fem",0
8,"8016",1803,1371,1363,11,8,"I.Fem",2
8,"8023",7029,5027,5000,39,27,"I.Fem",3
8,"8258",815,636,632,5,4,"I.Fem",0
8,"8165",1680,1177,1171,7,6,"I.Fem",1
8,"8109",207,176,174,0,2,"I.Fem",0
8,"8162",2118,1581,1576,13,5,"I.Fem",5
8,"8277",168,148,146,1,2,"I.Fem",0
8,"8200",62225,45235,44991,306,244,"I.Fem",53
8,"8218",8091,5899,5869,50,30,"I.Fem",2
8,"8307",49499,35471,35312,199,159,"I.Fem",35
8,"8070",269,215,211,1,4,"I.Fem",0
8,"8048",580,427,426,1,1,"I.Fem",0
8,"8236",1564,1145,1133,4,12,"I.Fem",1
8,"8030",5208,4045,4033,25,12,"I.Fem",5
8,"8013",1287,982,972,6,10,"I.Fem",2
8,"8135",6770,5187,5158,42,29,"I.Fem",9
8,"8025",1573,1170,1160,9,10,"I.Fem",2
8,"8096",43926,32120,31960,217,160,"I.Fem",32
8,"8081",349,274,270,0,4,"I.Fem",0
8,"8284",12597,8244,8183,60,61,"I.Fem",9
8,"8092",3713,2758,2745,9,13,"I.Fem",1
8,"8149",980,702,694,6,8,"I.Fem",1
8,"8231",21269,14655,14573,111,82,"I.Fem",11
8,"8062",1009,778,776,9,2,"I.Fem",0
8,"8217",25466,19864,19773,129,91,"I.Fem",11
8,"8184",55053,38519,38323,298,196,"I.Fem",56
8,"8078",216,154,154,2,0,"I.Fem",0
8,"8172",20543,15191,15140,85,51,"I.Fem",13
8,"8160",317,234,234,0,0,"I.Fem",0
8,"8181",8133,5949,5924,31,25,"I.Fem",3
8,"8002",217,172,172,2,0,"I.Fem",0
8,"8157",8574,6514,6472,47,42,"I.Fem",7
8,"8227",2420,1775,1769,11,6,"I.Fem",3
8,"8152",117,94,94,0,0,"I.Fem",0
8,"8084",1172,902,894,9,8,"I.Fem",0
8,"8138",4461,3286,3259,27,27,"I.Fem",0
8,"8115",3826,2777,2770,31,7,"I.Fem",4
8,"8304",822,655,655,5,0,"I.Fem",0
8,"8039",413,322,321,1,1,"I.Fem",0
8,"8208",5793,4267,4244,21,23,"I.Fem",5
8,"8256",693,542,542,3,0,"I.Fem",1
8,"8207",2026,1667,1659,12,8,"I.Fem",0
8,"8291",4972,3531,3519,23,12,"I.Fem",6
8,"8104",657,496,493,4,3,"I.Fem",0
8,"8089",34190,24548,24404,194,144,"I.Fem",29
8,"8288",1696,1103,1096,9,7,"I.Fem",2
8,"8008",175,136,136,2,0,"I.Fem",0
8,"8273",2390,1871,1855,14,16,"I.Fem",1
8,"8100",2083,1707,1699,13,8,"I.Fem",0
8,"8024",357,282,282,2,0,"I.Fem",0
8,"8188",115,89,89,0,0,"I.Fem",0
8,"8282",6731,5333,5317,40,16,"I.Fem",5
8,"8046",13541,10510,10455,73,55,"I.Fem",8
8,"8137",272,208,207,2,1,"I.Fem",0
8,"8015",156540,109145,108440,957,705,"I.Fem",124
8,"8031",2339,1760,1750,15,10,"I.Fem",0
8,"8168",388,280,279,3,1,"I.Fem",2
8,"8240",9469,7351,7327,39,24,"I.Fem",3
8,"8028",1125,744,743,7,1,"I.Fem",1
8,"8050",139,118,115,4,3,"I.Fem",0
8,"8071",249,209,208,0,1,"I.Fem",0
8,"8003",7213,5425,5409,41,16,"I.Fem",7
8,"8261",2405,1726,1718,11,8,"I.Fem",0
8,"8026",195,148,146,0,2,"I.Fem",0
8,"8177",36,27,27,1,0,"I.Fem",0
8,"8176",158,119,119,0,0,"I.Fem",0
8,"8142",136,117,117,3,0,"I.Fem",0
8,"8010",4224,3109,3090,22,19,"I.Fem",1
8,"8076",16526,11988,11893,90,95,"I.Fem",10
8,"8033",13262,9887,9833,64,54,"I.Fem",13
8,"8216",25,17,17,0,0,"I.Fem",0
8,"8253",132,103,102,0,1,"I.Fem",2
8,"8202",12943,9408,9358,58,50,"I.Fem",3
8,"8061",1628,1154,1151,15,3,"I.Fem",1
8,"8122",1733,1179,1175,4,4,"I.Fem",1
8,"8205",61957,49325,49196,441,129,"I.Fem",49
8,"8130",110,81,81,2,0,"I.Fem",0
8,"8235",3875,3004,2996,19,8,"I.Fem",0
8,"8220",2411,2010,2001,8,9,"I.Fem",2
8,"8085",986,769,767,6,2,"I.Fem",0
8,"8306",535,368,368,5,0,"I.Fem",1
8,"8086",14137,9971,9912,77,59,"I.Fem",15
8,"8111",216,195,194,2,1,"I.Fem",0
8,"8269",2729,2114,2105,9,9,"I.Fem",2
8,"8292",1074,796,790,2,6,"I.Fem",1
8,"8088",12347,9316,9270,75,46,"I.Fem",3
8,"8018",2540,1862,1855,7,7,"I.Fem",2
8,"8296",1869,1412,1408,10,4,"I.Fem",1
8,"8029",3586,2868,2862,20,6,"I.Fem",4
8,"8238",14946,11911,11873,85,38,"I.Fem",12
8,"8201",455,319,318,12,1,"I.Fem",0
8,"8255",133,100,100,2,0,"I.Fem",0
8,"8154",697,541,539,3,2,"I.Fem",0
8,"8215",2617,1954,1946,22,8,"I.Fem",0
8,"8237",1644,1263,1254,9,9,"I.Fem",0
8,"8106",7500,5442,5410,43,32,"I.Fem",7
8,"8058",1808,1280,1262,6,18,"I.Fem",0
8,"8035",13006,8957,8918,50,39,"I.Fem",7
8,"8250",7235,4917,4876,41,41,"I.Fem",5
8,"8126",8906,6673,6646,41,27,"I.Fem",33
8,"8145",2712,2060,2049,8,11,"I.Fem",3
8,"8119",6897,5096,5052,31,44,"I.Fem",7
8,"8199",648,509,508,3,1,"I.Fem",0
8,"8905",2329,1872,1863,7,9,"I.Fem",1
8,"8222",1821,1439,1424,7,15,"I.Fem",0
8,"8164",936,750,747,6,3,"I.Fem",1
8,"8129",486,399,398,0,1,"I.Fem",0
8,"8020",5243,4117,4100,29,17,"I.Fem",4
8,"8280",93,76,75,1,1,"I.Fem",0
18,"18086",338,253,247,1,6,"IZAR",0
18,"18170",317,212,209,0,3,"IZAR",0
18,"18039",3343,2293,2252,22,41,"IZAR",0
18,"18036",3986,2956,2917,22,39,"IZAR",0
18,"18048",2494,1708,1657,18,51,"IZAR",2
18,"18049",588,418,415,4,3,"IZAR",0
18,"18103",714,500,498,3,2,"IZAR",0
18,"18051",1092,735,718,8,17,"IZAR",0
18,"18074",265,205,205,0,0,"IZAR",0
18,"18137",968,733,731,3,2,"IZAR",0
18,"18117",497,360,354,1,6,"IZAR",0
18,"18174",435,324,320,3,4,"IZAR",1
18,"18083",232,181,179,1,2,"IZAR",0
18,"18147",3655,2273,2241,16,32,"IZAR",0
18,"18010",527,398,394,5,4,"IZAR",0
18,"18005",363,232,230,3,2,"IZAR",0
18,"18029",1812,1104,1065,7,39,"IZAR",0
18,"18088",1526,1000,993,10,7,"IZAR",0
18,"18183",623,380,376,0,4,"IZAR",0
18,"18021",17929,12165,11949,139,216,"IZAR",6
18,"18059",4265,2960,2886,23,74,"IZAR",1
18,"18053",1554,1001,985,9,16,"IZAR",0
18,"18151",261,167,166,4,1,"IZAR",0
18,"18150",6964,4717,4622,51,95,"IZAR",2
18,"18033",279,179,174,0,5,"IZAR",0
18,"18094",2299,1712,1652,20,60,"IZAR",0
18,"18179",493,315,309,8,6,"IZAR",0
18,"18001",222,147,146,0,1,"IZAR",0
18,"18134",6104,4049,3972,39,77,"IZAR",1
18,"18022",13875,8948,8764,98,184,"IZAR",2
18,"18082",810,503,500,3,3,"IZAR",0
18,"18914",1660,1255,1227,11,28,"IZAR",0
18,"18028",898,723,718,3,5,"IZAR",0
18,"18056",3382,2397,2350,30,47,"IZAR",1
18,"18002",529,387,384,1,3,"IZAR",0
18,"18909",514,403,403,0,0,"IZAR",0
18,"18025",277,198,197,0,1,"IZAR",0
18,"18161",245,199,196,0,3,"IZAR",0
18,"18188",1646,1224,1202,10,22,"IZAR",0
18,"18063",1232,687,678,9,9,"IZAR",0
18,"18093",2751,1693,1674,18,19,"IZAR",0
18,"18127",17005,11790,11583,150,207,"IZAR",2
18,"18146",930,645,629,10,16,"IZAR",0
18,"18906",903,641,639,2,2,"IZAR",0
18,"18061",999,781,770,5,11,"IZAR",0
18,"18099",1582,1184,1156,13,28,"IZAR",1
18,"18069",484,356,356,5,0,"IZAR",1
18,"18054",820,573,569,2,4,"IZAR",2
18,"18153",8834,6174,6063,54,111,"IZAR",3
18,"18128",332,263,260,1,3,"IZAR",1
18,"18173",8999,5958,5871,50,87,"IZAR",1
18,"18176",242,164,161,2,3,"IZAR",0
18,"18050",1649,1113,1095,5,18,"IZAR",0
18,"18066",2095,1401,1378,12,23,"IZAR",0
18,"18175",11793,8099,7943,62,156,"IZAR",2
18,"18098",5959,3816,3749,33,67,"IZAR",0
18,"18133",2101,1496,1477,6,19,"IZAR",0
18,"18100",7997,5523,5367,66,156,"IZAR",1
18,"18158",7978,4861,4771,43,90,"IZAR",0
18,"18114",585,425,424,7,1,"IZAR",0
18,"18014",6938,4864,4742,64,122,"IZAR",0
18,"18106",413,270,261,3,9,"IZAR",0
18,"18097",947,633,631,0,2,"IZAR",2
18,"18067",682,442,437,2,5,"IZAR",0
18,"18032",247,164,163,1,1,"IZAR",0
18,"18162",919,664,652,3,12,"IZAR",0
18,"18123",284,202,200,5,2,"IZAR",0
18,"18077",471,350,343,1,7,"IZAR",1
18,"18072",655,452,445,4,7,"IZAR",0
18,"18017",18201,11500,11358,94,142,"IZAR",0
18,"18035",1179,882,870,7,12,"IZAR",0
18,"18004",669,467,466,6,1,"IZAR",0
18,"18184",2193,1542,1511,16,31,"IZAR",0
18,"18132",3101,2418,2382,23,36,"IZAR",0
18,"18911",7933,5464,5348,53,116,"IZAR",1
18,"18043",129,74,71,0,3,"IZAR",0
18,"18905",15688,10406,10200,122,206,"IZAR",1
18,"18903",852,544,537,9,7,"IZAR",0
18,"18102",8233,5424,5266,46,158,"IZAR",2
18,"18109",597,430,422,5,8,"IZAR",0
18,"18046",1738,1042,1023,7,19,"IZAR",0
18,"18044",161,91,91,0,0,"IZAR",0
18,"18076",789,534,532,2,2,"IZAR",0
18,"18064",366,289,286,0,3,"IZAR",0
18,"18087",182877,131811,130184,1106,1627,"IZAR",27
18,"18070",287,216,216,3,0,"IZAR",0
18,"18143",945,661,651,2,10,"IZAR",0
18,"18030",566,382,380,2,2,"IZAR",0
18,"18140",42474,26967,26648,225,319,"IZAR",4
18,"18165",4265,2870,2820,22,50,"IZAR",0
18,"18915",726,474,467,4,7,"IZAR",0
18,"18045",1065,720,690,11,30,"IZAR",0
18,"18181",194,134,133,0,1,"IZAR",0
18,"18116",2856,2027,1979,13,48,"IZAR",0
18,"18164",1790,1135,1108,11,27,"IZAR",0
18,"18122",15994,11009,10773,109,236,"IZAR",7
18,"18149",5408,3926,3859,42,67,"IZAR",0
18,"18135",4385,2882,2798,24,84,"IZAR",1
18,"18018",542,384,377,2,7,"IZAR",0
18,"18085",690,440,432,1,8,"IZAR",0
18,"18013",4154,2892,2812,28,80,"IZAR",0
18,"18023",15717,10964,10751,132,213,"IZAR",6
18,"18078",714,546,538,5,8,"IZAR",0
18,"18089",14504,9854,9746,100,108,"IZAR",3
18,"18157",1148,843,827,7,16,"IZAR",0
18,"18189",785,598,592,9,6,"IZAR",1
18,"18182",1926,1222,1204,8,18,"IZAR",0
18,"18187",510,350,350,2,0,"IZAR",0
18,"18908",776,553,528,3,25,"IZAR",0
18,"18003",14454,10162,9935,105,227,"IZAR",3
18,"18057",5584,4042,3958,51,84,"IZAR",1
18,"18913",771,530,514,2,16,"IZAR",0
18,"18020",489,318,310,2,8,"IZAR",0
18,"18910",710,439,434,1,5,"IZAR",0
18,"18107",920,643,626,1,17,"IZAR",0
18,"18144",816,592,582,3,10,"IZAR",0
18,"18042",417,332,330,4,2,"IZAR",0
18,"18015",424,331,330,4,1,"IZAR",0
18,"18916",1815,1093,1086,6,7,"IZAR",0
18,"18040",237,146,145,0,1,"IZAR",0
18,"18068",1638,1197,1167,12,30,"IZAR",0
18,"18124",355,232,231,1,1,"IZAR",0
18,"18016",297,200,198,3,2,"IZAR",0
18,"18126",1436,1024,1002,9,22,"IZAR",0
18,"18111",2863,2038,2001,29,37,"IZAR",1
18,"18163",311,206,204,0,2,"IZAR",0
18,"18177",375,235,231,5,4,"IZAR",0
18,"18154",982,668,668,4,0,"IZAR",0
18,"18902",752,589,568,3,21,"IZAR",0
18,"18071",5636,3909,3807,45,102,"IZAR",2
18,"18912",1352,926,912,7,14,"IZAR",0
18,"18007",730,490,478,3,12,"IZAR",0
18,"18194",2038,1373,1348,12,25,"IZAR",0
18,"18168",783,566,561,11,5,"IZAR",0
18,"18120",266,204,204,4,0,"IZAR",0
18,"18901",489,323,322,5,1,"IZAR",0
18,"18108",822,604,599,2,5,"IZAR",0
18,"18115",2635,1766,1738,13,28,"IZAR",1
18,"18171",2098,1521,1460,11,61,"IZAR",1
18,"18095",2054,1475,1433,14,42,"IZAR",3
18,"18121",119,79,79,1,0,"IZAR",0
18,"18027",2598,1730,1706,12,24,"IZAR",0
18,"18119",1708,1264,1240,7,24,"IZAR",0
18,"18006",4062,2765,2711,25,54,"IZAR",1
18,"18079",3466,2391,2333,22,58,"IZAR",0
18,"18084",4533,3233,3178,35,55,"IZAR",2
18,"18136",1778,1320,1284,14,36,"IZAR",0
18,"18065",588,464,451,2,13,"IZAR",1
18,"18112",104,68,66,2,2,"IZAR",0
18,"18152",928,663,660,3,3,"IZAR",0
18,"18034",484,345,342,3,3,"IZAR",0
18,"18105",3827,2436,2392,22,44,"IZAR",0
18,"18012",2114,1519,1492,9,27,"IZAR",0
18,"18038",1042,782,760,5,22,"IZAR",0
18,"18145",10909,7925,7780,67,145,"IZAR",1
18,"18101",9449,6688,6568,77,120,"IZAR",2
18,"18185",545,434,424,5,10,"IZAR",0
18,"18193",14934,10301,10127,116,174,"IZAR",4
18,"18138",2470,1597,1573,25,24,"IZAR",0
18,"18192",1462,1125,1103,3,22,"IZAR",0
18,"18180",636,410,401,2,9,"IZAR",0
18,"18159",989,765,762,2,3,"IZAR",0
18,"18024",837,651,639,11,12,"IZAR",0
18,"18037",535,417,410,2,7,"IZAR",0
18,"18062",11226,7969,7777,88,192,"IZAR",1
18,"18011",4403,3002,2947,24,55,"IZAR",0
18,"18096",340,227,226,0,1,"IZAR",0
18,"18167",1839,1243,1224,9,19,"IZAR",1
18,"18141",382,240,237,0,3,"IZAR",0
18,"18047",6103,3992,3922,61,70,"IZAR",0
18,"18148",787,618,605,5,13,"IZAR",0
18,"18178",664,474,467,1,7,"IZAR",0
18,"18904",741,500,498,1,2,"IZAR",0
18,"18907",1762,1358,1351,4,7,"IZAR",1
43,"43049",727,557,555,3,2,"IZQP",0
25,"25206",247,188,188,2,0,"IZQP",0
8,"8229",521,418,417,3,1,"IZQP",1
43,"43176",746,564,561,2,3,"IZQP",0
17,"17099",78,55,55,0,0,"IZQP",0
8,"8128",579,428,423,4,5,"IZQP",0
43,"43151",107,88,88,0,0,"IZQP",0
8,"8198",4679,3491,3469,12,22,"IZQP",2
8,"8232",1773,1368,1362,9,6,"IZQP",1
25,"25088",96,73,73,0,0,"IZQP",0
25,"25212",219,176,176,1,0,"IZQP",0
8,"8009",9531,7200,7171,47,29,"IZQP",2
8,"8136",11692,8527,8456,98,71,"IZQP",4
17,"17234",181,129,129,1,0,"IZQP",0
17,"17208",978,723,719,6,4,"IZQP",1
25,"25158",1605,1193,1180,8,13,"IZQP",0
8,"8216",25,17,17,0,0,"IZQP",0
8,"8219",15755,12235,12206,72,29,"IZQP",4
43,"43013",4406,3004,2975,19,29,"IZQP",1
17,"17093",913,637,634,5,3,"IZQP",0
8,"8297",138,99,99,0,0,"IZQP",0
25,"25164",353,259,255,0,4,"IZQP",0
25,"25131",394,281,279,3,2,"IZQP",0
25,"25121",632,380,374,3,6,"IZQP",2
17,"17117",14497,9438,9382,66,56,"IZQP",5
25,"25067",702,500,494,8,6,"IZQP",0
8,"8055",542,426,424,3,2,"IZQP",0
8,"8159",14343,10656,10603,87,53,"IZQP",4
17,"17068",253,191,191,0,0,"IZQP",0
17,"17143",145,104,104,0,0,"IZQP",0
43,"43170",877,664,661,4,3,"IZQP",0
30,"30902",8294,5235,5174,29,61,"IZQP",8
43,"43056",803,566,558,6,8,"IZQP",0
25,"25073",559,377,377,2,0,"IZQP",1
43,"43085",237,190,185,1,5,"IZQP",0
25,"25010",194,138,136,0,2,"IZQP",0
8,"8178",444,363,361,2,2,"IZQP",0
17,"17061",180,141,139,1,2,"IZQP",0
43,"43109",2706,1751,1738,17,13,"IZQP",1
25,"25244",374,275,270,1,5,"IZQP",0
43,"43027",168,129,129,3,0,"IZQP",0
25,"25141",154,105,104,3,1,"IZQP",0
43,"43124",468,343,339,3,4,"IZQP",0
8,"8082",1164,796,780,5,16,"IZQP",0
25,"25019",4606,2860,2829,19,31,"IZQP",3
25,"25176",307,241,238,3,3,"IZQP",0
25,"25111",114,86,86,2,0,"IZQP",0
17,"17016",737,570,563,2,7,"IZQP",0
17,"17001",575,428,426,4,2,"IZQP",0
8,"8267",6789,4975,4935,41,40,"IZQP",1
17,"17057",968,770,769,7,1,"IZQP",0
25,"25183",520,372,370,4,2,"IZQP",0
25,"25191",321,227,222,2,5,"IZQP",1
25,"25102",647,484,482,5,2,"IZQP",0
17,"17158",565,296,295,2,1,"IZQP",0
43,"43153",11197,7685,7649,53,36,"IZQP",6
43,"43089",279,201,201,1,0,"IZQP",0
30,"30023",3874,2831,2788,18,43,"IZQP",1
43,"43028",2770,1784,1770,7,14,"IZQP",0
43,"43018",384,297,297,2,0,"IZQP",0
17,"17185",2260,1657,1652,8,5,"IZQP",0
8,"8206",744,604,599,5,5,"IZQP",0
25,"25180",227,158,155,1,3,"IZQP",0
43,"43092",7308,4703,4679,33,24,"IZQP",0
25,"25130",181,130,128,0,2,"IZQP",0
17,"17085",293,239,238,0,1,"IZQP",2
25,"25060",71,42,42,0,0,"IZQP",0
8,"8289",4473,3379,3371,25,8,"IZQP",0
25,"25245",427,312,308,4,4,"IZQP",0
8,"8138",4461,3286,3259,27,27,"IZQP",1
25,"25001",143,102,102,1,0,"IZQP",0
25,"25029",1590,1190,1185,4,5,"IZQP",0
17,"17078",335,245,245,0,0,"IZQP",0
17,"17066",27378,16755,16644,122,111,"IZQP",23
43,"43098",362,274,274,1,0,"IZQP",0
25,"25099",1285,908,904,6,4,"IZQP",1
17,"17172",452,336,335,5,1,"IZQP",0
25,"25192",727,527,524,4,3,"IZQP",0
43,"43162",4436,3191,3163,24,28,"IZQP",2
43,"43042",2215,1723,1710,18,13,"IZQP",0
25,"25911",419,298,297,3,1,"IZQP",0
25,"25172",1762,1332,1323,8,9,"IZQP",2
8,"8131",745,552,550,3,2,"IZQP",0
43,"43016",3470,2547,2508,15,39,"IZQP",0
43,"43128",910,665,658,6,7,"IZQP",0
8,"8129",486,399,398,0,1,"IZQP",0
43,"43132",375,295,291,1,4,"IZQP",0
17,"17190",834,624,619,1,5,"IZQP",1
8,"8037",1947,1547,1543,11,4,"IZQP",0
17,"17227",147,104,104,0,0,"IZQP",0
8,"8275",247,218,218,3,0,"IZQP",0
8,"8194",25680,16465,16376,131,89,"IZQP",13
43,"43019",1332,911,904,8,7,"IZQP",0
25,"25238",212,161,160,0,1,"IZQP",1
8,"8098",2438,1781,1778,21,3,"IZQP",5
8,"8226",929,748,747,10,1,"IZQP",0
25,"25150",167,132,130,2,2,"IZQP",0
17,"17036",2639,1944,1934,21,10,"IZQP",0
30,"30022",17108,11041,10851,100,190,"IZQP",4
43,"43147",528,425,420,3,5,"IZQP",0
8,"8115",3826,2777,2770,31,7,"IZQP",1
17,"17049",3246,2527,2502,12,25,"IZQP",0
25,"25076",131,91,91,0,0,"IZQP",0
8,"8101",175048,121359,120620,830,739,"IZQP",89
25,"25021",2513,1668,1662,17,6,"IZQP",2
17,"17101",566,389,382,1,7,"IZQP",0
17,"17173",181,143,143,1,0,"IZQP",0
17,"17163",2868,2281,2268,13,13,"IZQP",0
43,"43902",2751,1794,1776,21,18,"IZQP",0
25,"25231",483,387,385,0,2,"IZQP",1
8,"8270",19014,13635,13594,74,41,"IZQP",4
43,"43081",629,500,499,2,1,"IZQP",0
8,"8065",1183,920,913,8,7,"IZQP",1
8,"8244",6099,4733,4706,39,27,"IZQP",2
43,"43165",571,469,467,2,2,"IZQP",0
43,"43065",379,281,277,4,4,"IZQP",0
8,"8211",33934,26136,26000,198,136,"IZQP",10
30,"30040",686,564,560,1,4,"IZQP",0
43,"43107",387,285,285,3,0,"IZQP",0
25,"25225",531,395,393,0,2,"IZQP",0
25,"25200",318,245,245,0,0,"IZQP",0
8,"8163",19672,13421,13364,70,57,"IZQP",6
17,"17123",343,286,284,2,2,"IZQP",0
8,"8277",168,148,146,1,2,"IZQP",0
43,"43135",339,255,255,0,0,"IZQP",0
8,"8108",5181,3880,3861,30,19,"IZQP",0
8,"8175",3369,2388,2372,18,16,"IZQP",1
43,"43007",631,479,474,1,5,"IZQP",0
30,"30026",16345,10049,9914,84,135,"IZQP",11
8,"8214",7007,5390,5371,25,19,"IZQP",0
43,"43116",465,356,352,0,4,"IZQP",0
25,"25024",352,248,247,0,1,"IZQP",0
25,"25211",680,470,470,3,0,"IZQP",0
43,"43130",169,131,130,2,1,"IZQP",0
17,"17020",3677,2851,2835,14,16,"IZQP",0
30,"30028",6390,4054,3973,25,81,"IZQP",0
8,"8239",467,362,361,3,1,"IZQP",0
43,"43045",143,114,113,0,1,"IZQP",0
8,"8042",2390,1772,1764,12,8,"IZQP",0
25,"25138",558,427,424,2,3,"IZQP",0
25,"25161",339,221,221,0,0,"IZQP",0
17,"17152",11065,6959,6927,68,32,"IZQP",8
17,"17094",1058,757,747,3,10,"IZQP",0
17,"17211",837,677,674,6,3,"IZQP",0
8,"8217",25466,19864,19773,129,91,"IZQP",11
25,"25078",995,746,743,7,3,"IZQP",0
25,"25170",262,210,210,1,0,"IZQP",0
17,"17022",7043,4940,4903,34,37,"IZQP",4
8,"8032",2100,1472,1465,12,7,"IZQP",0
8,"8223",1897,1345,1341,10,4,"IZQP",0
43,"43041",216,156,156,2,0,"IZQP",0
25,"25041",525,375,370,4,5,"IZQP",0
17,"17064",324,249,247,2,2,"IZQP",0
43,"43050",2695,1742,1730,10,12,"IZQP",2
25,"25139",477,348,346,3,2,"IZQP",1
25,"25082",292,197,197,2,0,"IZQP",1
17,"17065",321,264,263,3,1,"IZQP",0
17,"17010",332,252,251,2,1,"IZQP",0
17,"17126",316,269,269,1,0,"IZQP",0
17,"17039",1726,1306,1297,7,9,"IZQP",2
17,"17050",664,554,550,10,4,"IZQP",0
43,"43067",526,426,424,3,2,"IZQP",0
8,"8164",936,750,747,6,3,"IZQP",0
25,"25006",319,229,229,2,0,"IZQP",0
17,"17062",5982,4025,4001,19,24,"IZQP",1
43,"43036",869,565,557,7,8,"IZQP",0
8,"8199",648,509,508,3,1,"IZQP",0
30,"30004",1129,838,833,1,5,"IZQP",0
8,"8152",117,94,94,0,0,"IZQP",0
43,"43101",146,112,112,2,0,"IZQP",0
8,"8024",357,282,282,2,0,"IZQP",0
25,"25194",410,292,289,3,3,"IZQP",0
8,"8093",25,22,22,0,0,"IZQP",0
25,"25149",1377,1034,1028,9,6,"IZQP",0
25,"25220",991,768,762,1,6,"IZQP",1
25,"25232",1357,1012,1007,6,5,"IZQP",0
17,"17147",7916,5672,5641,41,31,"IZQP",0
43,"43901",8796,5431,5390,41,41,"IZQP",3
8,"8060",139,110,108,1,2,"IZQP",0
43,"43082",350,276,271,5,5,"IZQP",0
17,"17206",158,111,109,0,2,"IZQP",0
30,"30034",1067,818,801,8,17,"IZQP",0
8,"8154",697,541,539,3,2,"IZQP",0
43,"43022",1436,1028,1024,13,4,"IZQP",0
25,"25119",2258,1701,1686,11,15,"IZQP",0
17,"17151",179,131,130,0,1,"IZQP",0
25,"25189",2181,1468,1461,11,7,"IZQP",0
8,"8209",6925,4976,4948,39,28,"IZQP",3
17,"17133",1262,976,964,7,12,"IZQP",0
43,"43071",896,652,647,3,5,"IZQP",0
43,"43001",708,510,507,0,3,"IZQP",0
43,"43115",128,106,106,0,0,"IZQP",0
43,"43037",18216,11749,11672,70,77,"IZQP",11
17,"17112",198,148,147,3,1,"IZQP",0
17,"17114",23268,16423,16333,111,90,"IZQP",20
30,"30012",9085,6704,6599,46,105,"IZQP",2
8,"8176",158,119,119,0,0,"IZQP",0
17,"17023",27314,18677,18546,117,131,"IZQP",12
8,"8007",6795,5099,5081,29,18,"IZQP",1
8,"8012",1726,1323,1309,17,14,"IZQP",1
8,"8151",450,351,346,5,5,"IZQP",0
8,"8155",7056,5050,5011,38,39,"IZQP",0
25,"25092",125,93,92,0,1,"IZQP",0
8,"8052",140,102,102,1,0,"IZQP",0
25,"25047",956,745,736,14,9,"IZQP",1
25,"25118",326,223,218,0,5,"IZQP",0
43,"43159",76,60,60,0,0,"IZQP",0
43,"43129",4607,3284,3261,21,23,"IZQP",0
25,"25030",117,76,76,0,0,"IZQP",0
8,"8264",4608,3459,3444,30,15,"IZQP",0
17,"17105",248,187,186,2,1,"IZQP",0
25,"25113",1114,873,863,3,10,"IZQP",0
8,"8022",12213,8594,8558,42,36,"IZQP",1
8,"8287",1067,853,844,4,9,"IZQP",0
43,"43903",2332,1502,1487,18,15,"IZQP",1
43,"43040",325,268,267,1,1,"IZQP",0
8,"8143",2727,1989,1977,19,12,"IZQP",0
8,"8208",5793,4267,4244,21,23,"IZQP",0
17,"17004",529,411,410,3,1,"IZQP",0
43,"43121",593,404,403,1,1,"IZQP",0
25,"25079",276,202,202,0,0,"IZQP",0
17,"17019",1780,1403,1393,5,10,"IZQP",1
17,"17149",370,302,300,1,2,"IZQP",0
8,"8150",258,207,207,1,0,"IZQP",0
25,"25222",69,58,58,0,0,"IZQP",0
17,"17067",704,551,549,6,2,"IZQP",0
17,"17210",572,414,411,2,3,"IZQP",0
25,"25216",244,186,186,0,0,"IZQP",1
17,"17014",66,51,49,0,2,"IZQP",0
25,"25142",359,283,283,2,0,"IZQP",0
30,"30032",2864,2154,2129,18,25,"IZQP",0
43,"43012",3700,2882,2858,20,24,"IZQP",1
25,"25125",383,265,265,3,0,"IZQP",0
30,"30020",6503,4521,4484,35,37,"IZQP",0
8,"8109",207,176,174,0,2,"IZQP",0
30,"30042",2218,1645,1625,10,20,"IZQP",2
8,"8230",7648,5797,5774,40,23,"IZQP",2
43,"43063",544,376,374,2,2,"IZQP",0
8,"8123",19570,15378,15316,91,62,"IZQP",11
25,"25068",515,359,358,0,1,"IZQP",0
8,"8139",172,148,147,2,1,"IZQP",0
17,"17181",3458,2454,2443,18,11,"IZQP",1
17,"17220",801,649,647,2,2,"IZQP",0
8,"8184",55053,38519,38323,298,196,"IZQP",17
30,"30016",153034,101232,100202,776,1030,"IZQP",49
17,"17187",625,496,492,3,4,"IZQP",1
17,"17102",556,398,396,1,2,"IZQP",0
8,"8016",1803,1371,1363,11,8,"IZQP",0
8,"8132",356,265,265,1,0,"IZQP",0
25,"25012",2349,1563,1556,17,7,"IZQP",0
17,"17182",269,195,195,0,0,"IZQP",2
25,"25228",3143,2261,2250,18,11,"IZQP",2
8,"8171",2046,1520,1510,13,10,"IZQP",0
43,"43118",422,338,338,0,0,"IZQP",0
8,"8302",9359,6483,6430,78,53,"IZQP",3
17,"17071",1134,943,940,1,3,"IZQP",0
17,"17119",71,53,52,3,1,"IZQP",0
8,"8080",40,27,27,3,0,"IZQP",0
25,"25009",596,448,442,1,6,"IZQP",0
43,"43172",334,248,243,4,5,"IZQP",0
8,"8015",156540,109145,108440,957,705,"IZQP",45
17,"17139",1407,1128,1119,8,9,"IZQP",0
17,"17025",1182,943,938,5,5,"IZQP",0
43,"43093",3863,2728,2716,22,12,"IZQP",2
43,"43054",2807,1972,1957,14,15,"IZQP",1
8,"8120",7129,5649,5621,51,28,"IZQP",1
25,"25223",890,673,666,7,7,"IZQP",0
43,"43075",86,65,63,0,2,"IZQP",0
17,"17209",615,472,471,5,1,"IZQP",0
17,"17034",7289,4880,4862,23,18,"IZQP",5
17,"17006",1178,826,818,9,8,"IZQP",12
30,"30007",6474,4354,4317,26,37,"IZQP",3
25,"25251",708,526,524,1,2,"IZQP",0
43,"43010",334,262,262,2,0,"IZQP",0
8,"8068",6863,5064,5041,40,23,"IZQP",1
43,"43048",768,564,554,7,10,"IZQP",0
43,"43178",1435,1071,1066,2,5,"IZQP",0
25,"25063",84,52,51,0,1,"IZQP",0
43,"43023",211,171,169,2,2,"IZQP",1
8,"8003",7213,5425,5409,41,16,"IZQP",1
17,"17201",137,103,103,0,0,"IZQP",0
43,"43158",74,52,50,0,2,"IZQP",0
25,"25096",885,597,591,2,6,"IZQP",2
8,"8134",848,618,609,4,9,"IZQP",0
8,"8059",340,255,250,1,5,"IZQP",0
8,"8116",557,449,449,1,0,"IZQP",0
8,"8170",442,322,320,0,2,"IZQP",0
25,"25008",1081,803,799,4,4,"IZQP",0
8,"8284",12597,8244,8183,60,61,"IZQP",4
8,"8067",5746,4299,4270,24,29,"IZQP",2
8,"8110",13671,9362,9311,60,51,"IZQP",3
25,"25182",1043,763,760,8,3,"IZQP",0
8,"8111",216,195,194,2,1,"IZQP",0
8,"8166",964,700,697,7,3,"IZQP",0
17,"17205",209,167,166,0,1,"IZQP",0
17,"17037",112,86,86,1,0,"IZQP",0
43,"43906",2113,1490,1480,12,10,"IZQP",1
25,"25070",817,619,617,11,2,"IZQP",0
8,"8001",9097,6860,6818,39,42,"IZQP",2
30,"30013",7421,5171,5094,32,77,"IZQP",5
17,"17096",159,116,116,3,0,"IZQP",0
25,"25075",132,101,101,0,0,"IZQP",0
30,"30019",25911,17485,17264,157,221,"IZQP",10
8,"8902",3941,2974,2962,16,12,"IZQP",1
43,"43095",2583,1864,1854,12,10,"IZQP",0
43,"43002",1890,1233,1210,12,23,"IZQP",2
8,"8091",5428,4048,4024,20,24,"IZQP",2
17,"17035",544,447,447,2,0,"IZQP",0
43,"43154",126,104,104,0,0,"IZQP",0
43,"43141",109,85,84,0,1,"IZQP",0
25,"25103",133,88,87,0,1,"IZQP",0
43,"43907",4386,3083,3067,24,16,"IZQP",0
25,"25254",704,511,508,2,3,"IZQP",0
8,"8158",3094,2261,2251,11,10,"IZQP",0
25,"25033",1120,838,831,5,7,"IZQP",0
17,"17115",276,208,208,4,0,"IZQP",0
8,"8905",2329,1872,1863,7,9,"IZQP",0
17,"17076",119,95,94,2,1,"IZQP",0
17,"17230",504,383,382,3,1,"IZQP",0
43,"43076",454,336,335,1,1,"IZQP",0
8,"8146",1384,1030,1027,8,3,"IZQP",0
43,"43004",6288,4314,4262,36,52,"IZQP",2
8,"8282",6731,5333,5317,40,16,"IZQP",2
17,"17902",1294,992,990,9,2,"IZQP",0
30,"30031",497,387,382,1,5,"IZQP",0
25,"25179",169,132,132,0,0,"IZQP",0
30,"30024",60389,42200,41831,281,369,"IZQP",19
8,"8041",10698,7324,7258,57,66,"IZQP",3
8,"8248",5687,4187,4165,21,22,"IZQP",4
25,"25062",691,498,491,4,7,"IZQP",0
43,"43039",101,77,77,0,0,"IZQP",0
17,"17084",228,163,162,1,1,"IZQP",0
43,"43175",534,363,359,5,4,"IZQP",0
25,"25015",336,234,233,3,1,"IZQP",0
8,"8118",17634,13450,13402,80,48,"IZQP",8
8,"8047",3751,2600,2578,26,22,"IZQP",2
17,"17040",551,440,439,5,1,"IZQP",0
8,"8133",123,96,94,5,2,"IZQP",0
8,"8054",9215,6994,6943,38,51,"IZQP",1
25,"25219",146,111,111,1,0,"IZQP",0
17,"17232",146,111,111,0,0,"IZQP",0
17,"17007",1763,1367,1359,9,8,"IZQP",1
17,"17111",984,728,728,7,0,"IZQP",0
8,"8259",6979,5362,5341,27,21,"IZQP",3
17,"17097",200,170,167,2,3,"IZQP",0
17,"17146",3150,2243,2224,8,19,"IZQP",4
43,"43031",1447,1085,1072,13,13,"IZQP",0
8,"8084",1172,902,894,9,8,"IZQP",0
25,"25239",582,330,330,3,0,"IZQP",0
17,"17192",143,107,104,0,3,"IZQP",0
25,"25058",4345,3058,3045,13,13,"IZQP",1
17,"17217",350,287,284,0,3,"IZQP",0
25,"25153",190,139,136,0,3,"IZQP",0
30,"30009",12728,9487,9365,46,122,"IZQP",8
8,"8251",5130,3719,3698,20,21,"IZQP",2
25,"25908",217,136,136,0,0,"IZQP",0
43,"43110",247,178,178,2,0,"IZQP",0
8,"8148",2344,1655,1646,13,9,"IZQP",1
25,"25011",5271,3529,3505,21,24,"IZQP",3
25,"25902",536,406,403,1,3,"IZQP",0
25,"25186",207,162,161,0,1,"IZQP",0
8,"8057",61,47,47,1,0,"IZQP",0
25,"25049",156,110,109,1,1,"IZQP",0
43,"43015",115,92,91,1,1,"IZQP",0
8,"8156",11254,8440,8411,58,29,"IZQP",2
8,"8195",75,62,62,0,0,"IZQP",0
17,"17169",2511,1901,1890,8,11,"IZQP",1
8,"8305",27661,20346,20221,118,125,"IZQP",4
8,"8092",3713,2758,2745,9,13,"IZQP",1
43,"43073",80,67,65,0,2,"IZQP",0
25,"25098",227,160,158,1,2,"IZQP",0
8,"8103",652,476,474,1,2,"IZQP",0
25,"25127",217,145,145,1,0,"IZQP",0
8,"8113",52589,36864,36690,244,174,"IZQP",9
8,"8044",4156,2991,2976,16,15,"IZQP",2
8,"8204",3141,2395,2383,16,12,"IZQP",1
25,"25905",366,281,276,4,5,"IZQP",0
25,"25133",671,481,479,1,2,"IZQP",0
17,"17175",559,348,343,5,5,"IZQP",1
25,"25037",361,270,269,4,1,"IZQP",0
17,"17027",2857,2236,2229,9,7,"IZQP",1
25,"25154",117,86,85,0,1,"IZQP",0
17,"17186",3834,2980,2954,17,26,"IZQP",1
8,"8280",93,76,75,1,1,"IZQP",0
8,"8020",5243,4117,4100,29,17,"IZQP",2
25,"25230",1541,1105,1099,9,6,"IZQP",0
25,"25023",4560,3350,3334,24,16,"IZQP",3
43,"43105",155,126,123,4,3,"IZQP",0
17,"17128",321,239,238,1,1,"IZQP",0
17,"17200",624,469,467,6,2,"IZQP",0
25,"25004",582,437,432,3,5,"IZQP",0
8,"8234",3443,2561,2550,15,11,"IZQP",0
25,"25249",176,129,127,2,2,"IZQP",0
17,"17005",457,322,320,3,2,"IZQP",0
8,"8224",885,653,652,6,1,"IZQP",0
17,"17052",135,93,92,0,1,"IZQP",0
8,"8292",1074,796,790,2,6,"IZQP",0
25,"25145",75,59,59,0,0,"IZQP",0
8,"8179",636,466,465,2,1,"IZQP",1
43,"43169",445,388,388,3,0,"IZQP",0
8,"8274",4640,3385,3363,24,22,"IZQP",1
25,"25175",173,119,119,2,0,"IZQP",0
17,"17055",142,124,124,0,0,"IZQP",0
43,"43079",364,290,289,2,1,"IZQP",0
25,"25253",147,118,117,0,1,"IZQP",0
43,"43143",50,40,39,0,1,"IZQP",0
25,"25002",465,324,323,4,1,"IZQP",0
17,"17136",196,150,150,0,0,"IZQP",0
43,"43123",71435,49166,48873,318,293,"IZQP",28
17,"17178",1065,774,771,9,3,"IZQP",0
8,"8221",12793,10123,10079,73,44,"IZQP",5
17,"17150",1444,1177,1163,13,14,"IZQP",0
25,"25052",1541,1183,1176,7,7,"IZQP",0
43,"43156",3956,2812,2784,22,28,"IZQP",2
25,"25046",410,331,326,4,5,"IZQP",0
25,"25169",170,117,117,5,0,"IZQP",1
8,"8095",66,49,49,0,0,"IZQP",0
30,"30039",20442,13299,13167,84,132,"IZQP",28
43,"43152",435,348,342,2,6,"IZQP",0
8,"8036",163,122,122,0,0,"IZQP",0
43,"43034",465,365,365,5,0,"IZQP",0
8,"8075",4144,2951,2943,20,8,"IZQP",1
8,"8137",272,208,207,2,1,"IZQP",0
17,"17224",299,226,222,2,4,"IZQP",0
8,"8260",18515,13563,13487,84,76,"IZQP",3
43,"43090",1199,689,686,5,3,"IZQP",2
8,"8192",5701,4366,4349,15,17,"IZQP",3
8,"8183",4573,3406,3398,14,8,"IZQP",2
8,"8291",4972,3531,3519,23,12,"IZQP",2
25,"25089",93,70,68,1,2,"IZQP",0
25,"25181",172,137,137,1,0,"IZQP",0
8,"8298",27148,19655,19568,102,87,"IZQP",6
8,"8201",455,319,318,12,1,"IZQP",0
43,"43144",1245,975,966,1,9,"IZQP",1
43,"43021",349,245,243,2,2,"IZQP",0
25,"25135",997,675,671,3,4,"IZQP",1
8,"8077",34690,25896,25767,164,129,"IZQP",27
43,"43038",22070,15127,15018,113,109,"IZQP",31
8,"8218",8091,5899,5869,50,30,"IZQP",1
43,"43091",125,90,90,1,0,"IZQP",0
8,"8213",6600,4925,4906,30,19,"IZQP",1
8,"8307",49499,35471,35312,199,159,"IZQP",12
8,"8046",13541,10510,10455,73,55,"IZQP",2
8,"8122",1733,1179,1175,4,4,"IZQP",0
25,"25185",680,452,451,0,1,"IZQP",0
17,"17145",1410,1040,1032,6,8,"IZQP",0
8,"8256",693,542,542,3,0,"IZQP",0
8,"8048",580,427,426,1,1,"IZQP",2
25,"25061",80,51,51,0,0,"IZQP",0
8,"8090",142,116,116,0,0,"IZQP",0
8,"8182",2922,2041,2031,10,10,"IZQP",0
17,"17028",297,216,214,2,2,"IZQP",0
25,"25056",209,145,145,0,0,"IZQP",0
30,"30001",4507,3357,3331,17,26,"IZQP",2
8,"8254",1766,1433,1427,16,6,"IZQP",0
17,"17233",2347,1853,1840,11,13,"IZQP",1
43,"43164",310,235,231,3,4,"IZQP",0
43,"43024",1545,1019,1014,14,5,"IZQP",3
25,"25904",160,134,133,2,1,"IZQP",0
17,"17109",704,542,539,2,3,"IZQP",0
8,"8237",1644,1263,1254,9,9,"IZQP",0
43,"43126",1230,937,933,3,4,"IZQP",1
25,"25248",870,676,675,5,1,"IZQP",0
8,"8300",5927,4609,4589,41,20,"IZQP",1
43,"43083",146,110,109,0,1,"IZQP",0
17,"17106",142,114,114,0,0,"IZQP",0
8,"8293",227,177,177,0,0,"IZQP",0
25,"25115",803,601,593,4,8,"IZQP",1
43,"43066",158,108,108,1,0,"IZQP",0
43,"43005",3677,2505,2493,17,12,"IZQP",1
43,"43099",284,214,214,4,0,"IZQP",0
8,"8269",2729,2114,2105,9,9,"IZQP",0
17,"17202",3848,2632,2615,16,17,"IZQP",2
25,"25034",2271,1616,1600,12,16,"IZQP",0
17,"17226",884,603,600,4,3,"IZQP",0
8,"8062",1009,778,776,9,2,"IZQP",0
17,"17015",12829,9612,9580,51,32,"IZQP",2
8,"8026",195,148,146,0,2,"IZQP",0
30,"30015",19344,13502,13347,107,155,"IZQP",19
43,"43103",908,705,701,9,4,"IZQP",0
43,"43100",3557,2666,2649,22,17,"IZQP",2
8,"8294",2093,1546,1534,11,12,"IZQP",1
17,"17024",281,203,201,4,2,"IZQP",0
8,"8187",153822,113081,112470,758,611,"IZQP",37
25,"25055",163,114,114,0,0,"IZQP",0
43,"43078",835,610,605,7,5,"IZQP",1
43,"43131",4827,3134,3116,32,18,"IZQP",2
8,"8243",154,125,125,2,0,"IZQP",0
43,"43070",243,194,193,0,1,"IZQP",0
17,"17083",2971,2164,2154,13,10,"IZQP",0
17,"17204",609,429,428,6,1,"IZQP",1
43,"43120",421,256,254,1,2,"IZQP",0
17,"17118",12934,8723,8665,38,58,"IZQP",21
25,"25087",54,45,45,0,0,"IZQP",0
25,"25044",178,144,142,0,2,"IZQP",1
25,"25217",10891,7651,7610,63,41,"IZQP",3
43,"43074",1818,1341,1336,2,5,"IZQP",3
17,"17087",219,179,177,0,2,"IZQP",1
8,"8295",11290,8091,8054,72,37,"IZQP",3
8,"8191",5302,3872,3860,21,12,"IZQP",2
8,"8040",11116,7923,7891,49,32,"IZQP",4
17,"17221",4138,2999,2988,23,11,"IZQP",3
25,"25036",180,124,124,1,0,"IZQP",0
8,"8172",20543,15191,15140,85,51,"IZQP",5
8,"8050",139,118,115,4,3,"IZQP",0
25,"25097",89,71,71,2,0,"IZQP",0
8,"8089",34190,24548,24404,194,144,"IZQP",7
17,"17130",325,270,270,1,0,"IZQP",0
17,"17008",3605,2595,2577,8,18,"IZQP",0
17,"17091",391,296,290,3,6,"IZQP",0
25,"25013",2099,1430,1414,13,16,"IZQP",0
25,"25190",262,202,202,2,0,"IZQP",0
17,"17216",158,122,121,0,1,"IZQP",0
8,"8031",2339,1760,1750,15,10,"IZQP",0
17,"17135",393,307,303,0,4,"IZQP",1
8,"8064",1956,1439,1423,7,16,"IZQP",1
25,"25003",3717,2577,2561,15,16,"IZQP",0
17,"17199",6984,4919,4894,39,25,"IZQP",1
17,"17051",202,161,160,0,1,"IZQP",0
17,"17030",654,460,459,1,1,"IZQP",1
17,"17157",122,104,103,0,1,"IZQP",0
43,"43088",2013,1429,1420,11,9,"IZQP",1
17,"17141",6019,3855,3833,43,22,"IZQP",4
8,"8904",10516,7068,7025,54,43,"IZQP",5
8,"8245",77841,53719,53443,430,276,"IZQP",26
8,"8261",2405,1726,1718,11,8,"IZQP",2
25,"25039",259,197,196,7,1,"IZQP",0
43,"43163",26162,17276,17128,98,148,"IZQP",31
8,"8071",249,209,208,0,1,"IZQP",0
43,"43905",15100,9689,9630,43,59,"IZQP",3
30,"30011",4702,3390,3324,8,66,"IZQP",4
17,"17196",252,200,200,1,0,"IZQP",0
43,"43150",1233,954,941,6,13,"IZQP",0
8,"8196",19542,14264,14185,123,79,"IZQP",3
43,"43053",186,135,134,0,1,"IZQP",0
8,"8272",164,128,128,1,0,"IZQP",0
17,"17063",179,153,149,0,4,"IZQP",0
43,"43138",2636,1761,1745,11,16,"IZQP",0
8,"8231",21269,14655,14573,111,82,"IZQP",4
25,"25152",148,106,106,0,0,"IZQP",0
43,"43127",775,607,606,3,1,"IZQP",1
8,"8004",208,177,177,1,0,"IZQP",0
17,"17060",409,300,298,1,2,"IZQP",0
17,"17214",714,516,511,6,5,"IZQP",0
43,"43080",230,192,192,2,0,"IZQP",0
8,"8106",7500,5442,5410,43,32,"IZQP",0
30,"30005",30268,20979,20778,148,201,"IZQP",15
25,"25100",184,137,136,1,1,"IZQP",0
8,"8252",24885,18507,18383,162,124,"IZQP",10
30,"30037",19407,13252,13120,99,132,"IZQP",5
17,"17180",8508,5977,5953,38,24,"IZQP",2
30,"30038",15752,10987,10904,39,83,"IZQP",4
8,"8073",62934,45699,45407,281,292,"IZQP",18
30,"30014",1587,1150,1134,4,16,"IZQP",0
8,"8021",60,44,44,1,0,"IZQP",0
25,"25032",65,53,52,0,1,"IZQP",0
8,"8153",573,457,452,3,5,"IZQP",0
25,"25166",170,131,130,2,1,"IZQP",0
8,"8246",1692,1345,1340,7,5,"IZQP",0
8,"8188",115,89,89,0,0,"IZQP",0
8,"8017",2808,2033,2016,16,17,"IZQP",0
17,"17207",2420,1920,1901,9,19,"IZQP",0
8,"8299",380,301,300,4,1,"IZQP",0
8,"8177",36,27,27,1,0,"IZQP",0
43,"43006",676,462,462,3,0,"IZQP",1
25,"25071",41,31,30,0,1,"IZQP",0
25,"25227",656,476,476,2,0,"IZQP",0
8,"8174",388,322,318,2,4,"IZQP",0
8,"8112",12926,9268,9230,61,38,"IZQP",4
17,"17080",144,113,113,1,0,"IZQP",0
17,"17228",285,218,217,0,1,"IZQP",0
25,"25064",96,78,78,0,0,"IZQP",0
25,"25913",88,72,72,1,0,"IZQP",0
17,"17056",1780,1379,1374,13,5,"IZQP",1
25,"25155",616,446,443,2,3,"IZQP",0
43,"43062",269,229,226,5,3,"IZQP",0
25,"25072",5881,4059,4031,30,28,"IZQP",2
17,"17903",883,681,676,3,5,"IZQP",1
8,"8203",2466,1678,1675,7,3,"IZQP",1
17,"17090",539,440,440,2,0,"IZQP",0
43,"43173",98,70,68,0,2,"IZQP",0
25,"25105",105,88,87,4,1,"IZQP",0
43,"43077",453,306,304,1,2,"IZQP",0
17,"17148",1550,1121,1114,15,7,"IZQP",2
17,"17013",2765,1999,1985,15,14,"IZQP",3
17,"17183",253,197,197,2,0,"IZQP",0
8,"8247",982,799,798,4,1,"IZQP",0
17,"17041",217,150,146,1,4,"IZQP",0
17,"17154",101,76,76,0,0,"IZQP",0
8,"8025",1573,1170,1160,9,10,"IZQP",1
25,"25050",3256,2260,2249,20,11,"IZQP",0
17,"17170",173,140,140,2,0,"IZQP",1
17,"17177",562,426,423,1,3,"IZQP",1
8,"8038",1541,1129,1120,6,9,"IZQP",3
8,"8215",2617,1954,1946,22,8,"IZQP",0
8,"8161",11826,8001,7951,58,50,"IZQP",1
17,"17116",351,261,261,2,0,"IZQP",1
43,"43059",250,193,192,1,1,"IZQP",0
8,"8107",11965,8604,8554,67,50,"IZQP",1
43,"43030",483,356,351,2,5,"IZQP",0
8,"8125",25583,18334,18225,122,109,"IZQP",5
30,"30025",5016,3663,3623,22,40,"IZQP",1
17,"17193",4351,2945,2927,21,18,"IZQP",4
25,"25157",159,127,126,1,1,"IZQP",0
17,"17223",808,566,563,1,3,"IZQP",0
25,"25129",161,113,112,0,1,"IZQP",0
25,"25901",289,214,211,4,3,"IZQP",2
8,"8240",9469,7351,7327,39,24,"IZQP",0
43,"43035",233,182,182,5,0,"IZQP",0
43,"43061",40,27,27,3,0,"IZQP",0
17,"17195",338,274,272,1,2,"IZQP",0
17,"17121",225,166,163,2,3,"IZQP",0
25,"25126",281,211,210,1,1,"IZQP",0
30,"30018",8399,6226,6148,28,78,"IZQP",2
43,"43146",40,32,32,0,0,"IZQP",0
25,"25038",1478,1057,1048,10,9,"IZQP",0
8,"8141",4578,3369,3357,28,12,"IZQP",1
8,"8085",986,769,767,6,2,"IZQP",0
8,"8185",197,162,162,1,0,"IZQP",0
43,"43047",4234,2590,2564,19,26,"IZQP",1
8,"8019",1122912,824423,821037,5287,3386,"IZQP",293
25,"25035",364,257,256,0,1,"IZQP",2
25,"25059",800,546,534,5,12,"IZQP",1
25,"25007",1378,1010,999,12,11,"IZQP",0
25,"25146",223,158,155,3,3,"IZQP",0
8,"8126",8906,6673,6646,41,27,"IZQP",3
25,"25045",57,26,26,2,0,"IZQP",0
8,"8181",8133,5949,5924,31,25,"IZQP",1
25,"25156",765,571,567,3,4,"IZQP",0
8,"8273",2390,1871,1855,14,16,"IZQP",1
8,"8285",10349,7630,7599,48,31,"IZQP",3
43,"43058",95,78,78,0,0,"IZQP",0
43,"43174",144,118,114,0,4,"IZQP",0
17,"17120",823,560,558,5,2,"IZQP",0
17,"17029",207,154,154,1,0,"IZQP",0
17,"17021",119,89,87,0,2,"IZQP",0
8,"8130",110,81,81,2,0,"IZQP",0
17,"17058",176,128,128,0,0,"IZQP",0
17,"17125",136,100,100,3,0,"IZQP",0
25,"25240",1366,1030,1021,4,9,"IZQP",0
8,"8096",43926,32120,31960,217,160,"IZQP",12
17,"17142",2713,2166,2159,18,7,"IZQP",1
8,"8029",3586,2868,2862,20,6,"IZQP",1
43,"43064",2027,1456,1445,19,11,"IZQP",2
17,"17003",103,85,85,0,0,"IZQP",0
25,"25123",189,135,133,0,2,"IZQP",1
43,"43032",462,354,350,2,4,"IZQP",0
8,"8097",1103,845,840,4,5,"IZQP",0
25,"25903",226,169,169,1,0,"IZQP",0
43,"43102",458,331,324,2,7,"IZQP",0
43,"43106",784,605,598,3,7,"IZQP",1
8,"8135",6770,5187,5158,42,29,"IZQP",1
25,"25218",88,76,75,2,1,"IZQP",0
25,"25174",390,312,312,1,0,"IZQP",0
43,"43137",1890,1373,1353,8,20,"IZQP",1
8,"8124",37157,27139,26994,179,145,"IZQP",14
8,"8006",11774,8375,8329,53,46,"IZQP",2
25,"25167",223,165,164,3,1,"IZQP",0
43,"43112",245,179,179,3,0,"IZQP",0
25,"25136",95,74,74,2,0,"IZQP",0
17,"17031",178,117,117,0,0,"IZQP",0
25,"25124",160,102,101,1,1,"IZQP",0
25,"25053",1100,819,811,7,8,"IZQP",0
8,"8121",87515,62961,62574,429,387,"IZQP",28
43,"43133",5627,3794,3773,31,21,"IZQP",2
8,"8045",65,44,43,0,1,"IZQP",0
25,"25196",108,75,75,1,0,"IZQP",0
43,"43142",1069,783,774,3,9,"IZQP",0
8,"8290",1549,1254,1248,6,6,"IZQP",2
17,"17901",987,733,725,5,8,"IZQP",1
25,"25122",1929,1408,1398,21,10,"IZQP",2
43,"43177",276,229,227,2,2,"IZQP",0
17,"17002",578,477,474,2,3,"IZQP",0
25,"25215",339,249,249,5,0,"IZQP",0
8,"8197",7986,5829,5805,37,24,"IZQP",3
8,"8306",535,368,368,5,0,"IZQP",0
8,"8193",988,739,737,10,2,"IZQP",0
8,"8039",413,322,321,1,1,"IZQP",0
25,"25104",120,88,88,0,0,"IZQP",0
43,"43055",1970,1548,1535,12,13,"IZQP",1
8,"8253",132,103,102,0,1,"IZQP",0
30,"30006",833,699,695,1,4,"IZQP",0
25,"25014",246,184,178,0,6,"IZQP",0
8,"8225",94,83,82,1,1,"IZQP",0
8,"8086",14137,9971,9912,77,59,"IZQP",3
8,"8043",3414,2429,2422,15,7,"IZQP",1
8,"8160",317,234,234,0,0,"IZQP",0
25,"25907",500,366,364,5,2,"IZQP",0
30,"30033",10377,7330,7215,59,115,"IZQP",8
8,"8255",133,100,100,2,0,"IZQP",0
8,"8281",4858,3783,3762,19,21,"IZQP",0
8,"8278",4925,3820,3804,22,16,"IZQP",3
43,"43084",514,388,383,2,5,"IZQP",0
17,"17107",267,207,205,2,2,"IZQP",0
25,"25173",1646,1180,1169,6,11,"IZQP",1
30,"30036",15432,10030,9879,64,151,"IZQP",4
25,"25042",204,149,149,5,0,"IZQP",1
17,"17088",599,467,465,3,2,"IZQP",0
8,"8063",469,390,390,4,0,"IZQP",0
8,"8301",49348,36261,36045,292,216,"IZQP",18
8,"8276",241,179,179,3,0,"IZQP",0
17,"17081",252,186,185,2,1,"IZQP",0
43,"43096",97,76,76,0,0,"IZQP",0
8,"8189",119,96,96,1,0,"IZQP",0
8,"8070",269,215,211,1,4,"IZQP",0
8,"8288",1696,1103,1096,9,7,"IZQP",0
25,"25207",6443,4525,4492,31,33,"IZQP",2
25,"25208",337,242,241,2,1,"IZQP",0
8,"8078",216,154,154,2,0,"IZQP",0
8,"8236",1564,1145,1133,4,12,"IZQP",0
43,"43026",756,576,574,1,2,"IZQP",0
17,"17213",5567,3654,3630,19,24,"IZQP",4
17,"17198",437,307,306,0,1,"IZQP",0
25,"25197",140,109,109,0,0,"IZQP",0
43,"43003",349,257,255,3,2,"IZQP",1
17,"17012",1175,845,842,4,3,"IZQP",0
25,"25040",10651,7041,6987,57,54,"IZQP",5
25,"25020",270,202,201,2,1,"IZQP",0
8,"8279",156327,112605,112030,952,575,"IZQP",57
8,"8049",1309,910,903,3,7,"IZQP",0
17,"17194",73,56,56,0,0,"IZQP",0
8,"8202",12943,9408,9358,58,50,"IZQP",4
43,"43119",849,591,588,8,3,"IZQP",1
8,"8088",12347,9316,9270,75,46,"IZQP",2
17,"17176",128,111,111,0,0,"IZQP",0
43,"43097",407,331,328,4,3,"IZQP",0
17,"17164",3918,2856,2838,17,18,"IZQP",1
25,"25016",2083,1404,1399,3,5,"IZQP",1
17,"17168",373,309,308,3,1,"IZQP",0
8,"8056",42897,30873,30757,259,116,"IZQP",13
8,"8257",103,82,82,0,0,"IZQP",0
43,"43014",14386,9542,9464,74,78,"IZQP",27
17,"17225",205,150,150,1,0,"IZQP",0
8,"8028",1125,744,743,7,1,"IZQP",0
43,"43052",927,680,674,7,6,"IZQP",0
17,"17144",211,162,159,3,3,"IZQP",0
25,"25077",435,312,312,1,0,"IZQP",1
43,"43125",884,658,645,12,13,"IZQP",0
25,"25005",269,193,193,3,0,"IZQP",0
8,"8058",1808,1280,1262,6,18,"IZQP",0
25,"25137",8684,5802,5757,48,45,"IZQP",6
17,"17166",547,442,440,0,2,"IZQP",0
43,"43025",591,448,443,4,5,"IZQP",0
43,"43167",391,307,307,2,0,"IZQP",1
17,"17047",5016,3087,3068,22,19,"IZQP",2
17,"17054",342,250,250,2,0,"IZQP",0
8,"8018",2540,1862,1855,7,7,"IZQP",0
8,"8190",255,184,182,1,2,"IZQP",0
25,"25909",138,99,98,2,1,"IZQP",0
17,"17134",220,175,174,1,1,"IZQP",0
17,"17077",565,395,394,2,1,"IZQP",0
17,"17162",153,106,105,1,1,"IZQP",0
8,"8266",43422,32827,32696,241,131,"IZQP",11
8,"8205",61957,49325,49196,441,129,"IZQP",11
43,"43117",147,119,119,0,0,"IZQP",0
25,"25205",563,412,407,3,5,"IZQP",0
25,"25143",82,63,62,0,1,"IZQP",0
17,"17153",189,150,149,1,1,"IZQP",0
17,"17129",143,108,108,2,0,"IZQP",0
43,"43068",484,322,317,2,5,"IZQP",1
17,"17110",1332,990,981,3,9,"IZQP",0
25,"25224",122,94,94,0,0,"IZQP",0
25,"25043",800,584,581,2,3,"IZQP",0
8,"8241",70,52,52,0,0,"IZQP",0
8,"8094",1588,1258,1252,7,6,"IZQP",1
8,"8114",18838,13519,13442,81,77,"IZQP",4
25,"25057",208,151,149,4,2,"IZQP",0
8,"8023",7029,5027,5000,39,27,"IZQP",3
25,"25134",605,457,456,5,1,"IZQP",0
25,"25017",228,175,174,0,1,"IZQP",0
25,"25203",8809,5813,5770,40,43,"IZQP",3
43,"43104",1767,1285,1271,4,14,"IZQP",1
8,"8072",10769,7632,7600,56,32,"IZQP",6
43,"43033",766,555,555,4,0,"IZQP",0
43,"43043",3317,2457,2445,12,12,"IZQP",1
43,"43171",14849,10140,10081,76,59,"IZQP",15
25,"25114",96,83,82,1,1,"IZQP",0
17,"17160",14756,9892,9852,58,40,"IZQP",4
25,"25163",230,162,161,0,1,"IZQP",0
8,"8011",1739,1360,1353,10,7,"IZQP",0
8,"8238",14946,11911,11873,85,38,"IZQP",1
25,"25081",281,195,193,3,2,"IZQP",0
25,"25193",768,567,563,4,4,"IZQP",1
17,"17222",104,87,87,1,0,"IZQP",0
43,"43051",9194,6133,6048,44,85,"IZQP",4
8,"8249",274,238,237,0,1,"IZQP",0
8,"8304",822,655,655,5,0,"IZQP",0
8,"8233",1872,1428,1420,15,8,"IZQP",0
17,"17046",709,537,531,2,6,"IZQP",1
8,"8051",18570,14112,14054,86,58,"IZQP",7
17,"17070",110,87,87,0,0,"IZQP",0
17,"17069",359,270,267,2,3,"IZQP",0
8,"8308",139,109,109,1,0,"IZQP",0
25,"25165",271,210,208,0,2,"IZQP",0
17,"17011",645,518,514,10,4,"IZQP",1
17,"17033",5647,3879,3852,25,27,"IZQP",3
17,"17218",576,456,451,3,5,"IZQP",0
25,"25132",141,106,105,0,1,"IZQP",0
25,"25110",2745,1943,1927,13,16,"IZQP",3
25,"25085",141,109,108,2,1,"IZQP",0
25,"25252",553,380,379,2,1,"IZQP",0
17,"17212",145,111,109,0,2,"IZQP",0
43,"43086",5252,3811,3790,28,21,"IZQP",5
25,"25202",108,72,72,2,0,"IZQP",0
17,"17038",377,303,301,0,2,"IZQP",0
25,"25250",327,269,265,1,4,"IZQP",0
30,"30041",14040,8999,8876,94,123,"IZQP",9
25,"25234",4139,2786,2772,13,14,"IZQP",0
43,"43046",88,69,68,1,1,"IZQP",0
8,"8099",753,529,529,4,0,"IZQP",0
43,"43044",3962,2751,2719,33,32,"IZQP",3
25,"25910",91,63,63,0,0,"IZQP",1
43,"43029",312,241,240,1,1,"IZQP",0
43,"43009",1384,966,959,5,7,"IZQP",0
43,"43108",1787,1293,1282,6,11,"IZQP",0
8,"8157",8574,6514,6472,47,42,"IZQP",5
30,"30043",25449,18839,18477,180,362,"IZQP",9
8,"8140",4816,3541,3520,25,21,"IZQP",1
17,"17044",6938,5245,5212,33,33,"IZQP",2
43,"43114",370,281,278,1,3,"IZQP",0
8,"8033",13262,9887,9833,64,54,"IZQP",2
8,"8286",2943,2051,2042,12,9,"IZQP",4
8,"8142",136,117,117,3,0,"IZQP",0
8,"8008",175,136,136,2,0,"IZQP",1
25,"25048",1641,1207,1194,13,13,"IZQP",1
8,"8117",2489,1954,1941,21,13,"IZQP",1
17,"17042",410,299,297,5,2,"IZQP",0
8,"8180",27198,19822,19704,160,118,"IZQP",13
25,"25031",57,32,32,0,0,"IZQP",0
17,"17171",177,138,137,0,1,"IZQP",0
8,"8227",2420,1775,1769,11,6,"IZQP",0
8,"8081",349,274,270,0,4,"IZQP",0
25,"25094",138,96,93,2,3,"IZQP",0
30,"30010",6852,5161,5106,25,55,"IZQP",1
17,"17197",128,97,97,0,0,"IZQP",0
25,"25093",629,455,443,5,12,"IZQP",0
43,"43134",281,217,215,5,2,"IZQP",0
8,"8010",4224,3109,3090,22,19,"IZQP",3
43,"43157",339,279,279,1,0,"IZQP",0
25,"25233",289,219,218,6,1,"IZQP",0
30,"30030",321454,235061,233183,1744,1878,"IZQP",129
8,"8242",223,159,159,0,0,"IZQP",0
43,"43145",4209,3193,3170,17,23,"IZQP",1
43,"43155",22586,15295,15204,120,91,"IZQP",8
43,"43149",690,512,509,3,3,"IZQP",0
17,"17189",1481,1228,1223,5,5,"IZQP",0
8,"8061",1628,1154,1151,15,3,"IZQP",0
43,"43904",2864,1881,1851,20,30,"IZQP",4
17,"17086",1769,1116,1109,6,7,"IZQP",0
25,"25086",525,410,407,3,3,"IZQP",0
8,"8119",6897,5096,5052,31,44,"IZQP",1
17,"17100",193,147,141,0,6,"IZQP",0
25,"25101",536,412,411,5,1,"IZQP",0
17,"17075",340,257,256,2,1,"IZQP",0
8,"8087",144,120,120,0,0,"IZQP",0
8,"8014",2013,1526,1521,4,5,"IZQP",0
25,"25226",236,156,155,0,1,"IZQP",0
43,"43072",90,69,67,1,2,"IZQP",0
30,"30008",14560,9974,9840,79,134,"IZQP",16
8,"8228",292,234,233,0,1,"IZQP",0
17,"17048",6284,4077,4048,34,29,"IZQP",3
17,"17155",14957,9519,9410,71,109,"IZQP",5
43,"43057",38,32,32,1,0,"IZQP",0
17,"17161",1023,844,843,5,1,"IZQP",0
25,"25255",390,301,301,0,0,"IZQP",0
43,"43011",1086,862,860,5,2,"IZQP",0
25,"25221",115,82,81,1,1,"IZQP",0
17,"17174",164,130,130,4,0,"IZQP",0
17,"17159",622,459,459,1,0,"IZQP",1
8,"8005",6425,4830,4816,28,14,"IZQP",0
8,"8127",2254,1548,1544,10,4,"IZQP",0
25,"25912",841,620,619,5,1,"IZQP",1
8,"8169",48478,35283,35114,278,169,"IZQP",18
8,"8035",13006,8957,8918,50,39,"IZQP",4
8,"8167",6056,4520,4500,38,20,"IZQP",2
17,"17165",645,502,502,2,0,"IZQP",0
8,"8296",1869,1412,1408,10,4,"IZQP",0
25,"25168",496,399,399,6,0,"IZQP",0
17,"17137",3486,2812,2808,15,4,"IZQP",2
30,"30003",25200,16249,16120,159,129,"IZQP",7
17,"17095",20044,12638,12576,88,62,"IZQP",12
8,"8074",11190,7698,7651,51,47,"IZQP",1
8,"8235",3875,3004,2996,19,8,"IZQP",0
30,"30027",50067,36417,36074,242,343,"IZQP",15
43,"43161",17103,11905,11838,82,67,"IZQP",7
25,"25120",92888,62740,62389,450,351,"IZQP",39
25,"25140",779,540,539,2,1,"IZQP",1
8,"8263",21208,15014,14890,111,124,"IZQP",11
43,"43136",10489,7029,6996,47,33,"IZQP",2
8,"8250",7235,4917,4876,41,41,"IZQP",2
17,"17191",163,140,140,1,0,"IZQP",0
8,"8283",6165,4546,4524,33,22,"IZQP",2
8,"8102",28940,21108,21014,157,94,"IZQP",6
8,"8200",62225,45235,44991,306,244,"IZQP",18
17,"17184",1261,1016,1010,7,6,"IZQP",0
8,"8105",9741,6946,6896,62,50,"IZQP",1
25,"25148",224,158,158,0,0,"IZQP",0
8,"8212",491,393,386,6,7,"IZQP",0
8,"8220",2411,2010,2001,8,9,"IZQP",1
8,"8262",6945,4649,4599,38,50,"IZQP",4
17,"17203",165,126,126,0,0,"IZQP",0
43,"43166",1646,1183,1176,4,7,"IZQP",1
8,"8210",4640,3226,3200,24,26,"IZQP",0
25,"25022",105,80,79,0,1,"IZQP",0
43,"43008",305,171,171,7,0,"IZQP",0
8,"8149",980,702,694,6,8,"IZQP",0
8,"8100",2083,1707,1699,13,8,"IZQP",0
17,"17092",3462,2414,2389,14,25,"IZQP",1
25,"25069",426,296,294,0,2,"IZQP",0
8,"8265",1597,1262,1260,4,2,"IZQP",0
17,"17124",1593,1163,1160,8,3,"IZQP",1
17,"17032",1745,1139,1133,6,6,"IZQP",0
8,"8104",657,496,493,4,3,"IZQP",0
25,"25247",142,89,89,2,0,"IZQP",0
17,"17138",836,591,584,7,7,"IZQP",0
43,"43140",2433,1685,1674,11,11,"IZQP",0
8,"8013",1287,982,972,6,10,"IZQP",0
8,"8027",724,584,582,1,2,"IZQP",0
30,"30002",9701,6794,6717,27,77,"IZQP",5
25,"25243",3729,2370,2349,33,21,"IZQP",4
17,"17167",2585,2015,1998,11,17,"IZQP",0
25,"25151",731,555,549,1,6,"IZQP",0
8,"8168",388,280,279,3,1,"IZQP",0
8,"8147",17389,12679,12601,102,78,"IZQP",6
25,"25242",688,494,488,5,6,"IZQP",0
17,"17009",4068,3061,3050,16,11,"IZQP",1
43,"43160",1324,967,956,6,11,"IZQP",1
8,"8271",66,48,47,2,1,"IZQP",0
8,"8066",1466,1109,1104,7,5,"IZQP",0
30,"30021",9498,6251,6193,36,58,"IZQP",1
25,"25051",1522,1066,1059,6,7,"IZQP",0
17,"17043",165,133,133,0,0,"IZQP",0
43,"43020",2291,1712,1688,19,24,"IZQP",0
25,"25204",1187,858,849,13,9,"IZQP",0
17,"17074",536,403,401,1,2,"IZQP",1
17,"17089",5749,3973,3949,17,24,"IZQP",1
25,"25177",356,252,250,1,2,"IZQP",1
8,"8079",333,260,258,2,2,"IZQP",0
25,"25171",2117,1539,1534,5,5,"IZQP",2
8,"8034",820,644,640,0,4,"IZQP",0
8,"8303",257,207,205,1,2,"IZQP",0
8,"8030",5208,4045,4033,25,12,"IZQP",1
43,"43111",2129,1412,1401,8,11,"IZQP",0
8,"8901",240,200,195,2,5,"IZQP",0
43,"43069",183,148,147,2,1,"IZQP",0
25,"25128",125,85,85,0,0,"IZQP",0
8,"8903",201,181,181,1,0,"IZQP",0
8,"8145",2712,2060,2049,8,11,"IZQP",0
17,"17098",308,232,230,4,2,"IZQP",2
30,"30901",10556,7862,7775,58,87,"IZQP",3
25,"25906",205,133,131,2,2,"IZQP",0
30,"30017",11428,8196,8113,44,83,"IZQP",0
8,"8165",1680,1177,1171,7,6,"IZQP",1
8,"8069",3323,2555,2540,21,15,"IZQP",1
17,"17132",1344,1019,1009,12,10,"IZQP",0
17,"17082",435,308,307,1,1,"IZQP",0
43,"43168",83,55,55,1,0,"IZQP",0
8,"8053",2896,1939,1929,13,10,"IZQP",2
17,"17079",65572,47740,47502,279,238,"IZQP",25
17,"17215",2286,1855,1844,13,11,"IZQP",1
25,"25074",179,155,151,2,4,"IZQP",0
43,"43060",2672,2032,2015,7,17,"IZQP",0
43,"43122",112,91,91,1,0,"IZQP",0
8,"8002",217,172,172,2,0,"IZQP",0
8,"8083",1672,1433,1430,6,3,"IZQP",0
43,"43148",91182,65076,64756,441,320,"IZQP",91
43,"43094",2143,1558,1541,6,17,"IZQP",0
8,"8207",2026,1667,1659,12,8,"IZQP",0
25,"25112",269,205,200,2,5,"IZQP",0
25,"25201",110,81,81,0,0,"IZQP",0
17,"17018",494,377,372,4,5,"IZQP",0
8,"8162",2118,1581,1576,13,5,"IZQP",0
25,"25210",1073,791,780,3,11,"IZQP",1
17,"17140",635,506,505,2,1,"IZQP",0
8,"8076",16526,11988,11893,90,95,"IZQP",10
8,"8258",815,636,632,5,4,"IZQP",0
8,"8268",975,729,723,6,6,"IZQP",1
8,"8144",722,551,545,3,6,"IZQP",0
17,"17103",5057,3196,3174,21,22,"IZQP",3
25,"25027",978,695,690,3,5,"IZQP",1
30,"30029",12122,8231,8125,54,106,"IZQP",6
17,"17073",1939,1649,1640,11,9,"IZQP",1
8,"8222",1821,1439,1424,7,15,"IZQP",1
43,"43017",112,94,94,1,0,"IZQP",0
17,"17188",171,134,134,1,0,"IZQP",0
30,"30035",19432,13174,13013,114,161,"IZQP",17
25,"25209",1586,1115,1102,6,13,"IZQP",0
17,"17026",549,421,415,3,6,"IZQP",0
25,"25025",1362,909,898,15,11,"IZQP",1
43,"43113",387,305,303,1,2,"IZQP",0
25,"25109",211,155,154,1,1,"IZQP",0
43,"43139",2007,1432,1419,9,13,"IZQP",2
8,"8193",988,739,737,10,2,"JxCAT-JUNTS",118
8,"8203",2466,1678,1675,7,3,"JxCAT-JUNTS",281
8,"8011",1739,1360,1353,10,7,"JxCAT-JUNTS",395
8,"8062",1009,778,776,9,2,"JxCAT-JUNTS",162
25,"25135",997,675,671,3,4,"JxCAT-JUNTS",229
17,"17190",834,624,619,1,5,"JxCAT-JUNTS",204
25,"25040",10651,7041,6987,57,54,"JxCAT-JUNTS",1418
43,"43039",101,77,77,0,0,"JxCAT-JUNTS",18
8,"8168",388,280,279,3,1,"JxCAT-JUNTS",69
8,"8075",4144,2951,2943,20,8,"JxCAT-JUNTS",373
17,"17062",5982,4025,4001,19,24,"JxCAT-JUNTS",996
17,"17095",20044,12638,12576,88,62,"JxCAT-JUNTS",1576
25,"25251",708,526,524,1,2,"JxCAT-JUNTS",129
8,"8269",2729,2114,2105,9,9,"JxCAT-JUNTS",617
25,"25171",2117,1539,1534,5,5,"JxCAT-JUNTS",390
43,"43135",339,255,255,0,0,"JxCAT-JUNTS",77
25,"25105",105,88,87,4,1,"JxCAT-JUNTS",26
25,"25234",4139,2786,2772,13,14,"JxCAT-JUNTS",686
43,"43047",4234,2590,2564,19,26,"JxCAT-JUNTS",212
17,"17216",158,122,121,0,1,"JxCAT-JUNTS",44
25,"25037",361,270,269,4,1,"JxCAT-JUNTS",91
8,"8249",274,238,237,0,1,"JxCAT-JUNTS",70
25,"25011",5271,3529,3505,21,24,"JxCAT-JUNTS",683
25,"25062",691,498,491,4,7,"JxCAT-JUNTS",116
25,"25078",995,746,743,7,3,"JxCAT-JUNTS",177
25,"25124",160,102,101,1,1,"JxCAT-JUNTS",32
8,"8026",195,148,146,0,2,"JxCAT-JUNTS",66
17,"17080",144,113,113,1,0,"JxCAT-JUNTS",24
25,"25075",132,101,101,0,0,"JxCAT-JUNTS",30
8,"8297",138,99,99,0,0,"JxCAT-JUNTS",44
25,"25102",647,484,482,5,2,"JxCAT-JUNTS",140
17,"17181",3458,2454,2443,18,11,"JxCAT-JUNTS",543
8,"8169",48478,35283,35114,278,169,"JxCAT-JUNTS",1527
8,"8070",269,215,211,1,4,"JxCAT-JUNTS",65
17,"17042",410,299,297,5,2,"JxCAT-JUNTS",98
17,"17133",1262,976,964,7,12,"JxCAT-JUNTS",494
8,"8141",4578,3369,3357,28,12,"JxCAT-JUNTS",832
8,"8305",27661,20346,20221,118,125,"JxCAT-JUNTS",3831
8,"8268",975,729,723,6,6,"JxCAT-JUNTS",140
43,"43079",364,290,289,2,1,"JxCAT-JUNTS",72
25,"25196",108,75,75,1,0,"JxCAT-JUNTS",23
8,"8090",142,116,116,0,0,"JxCAT-JUNTS",52
43,"43021",349,245,243,2,2,"JxCAT-JUNTS",47
17,"17172",452,336,335,5,1,"JxCAT-JUNTS",101
43,"43118",422,338,338,0,0,"JxCAT-JUNTS",64
25,"25098",227,160,158,1,2,"JxCAT-JUNTS",52
43,"43070",243,194,193,0,1,"JxCAT-JUNTS",21
43,"43115",128,106,106,0,0,"JxCAT-JUNTS",41
25,"25060",71,42,42,0,0,"JxCAT-JUNTS",14
43,"43064",2027,1456,1445,19,11,"JxCAT-JUNTS",351
17,"17225",205,150,150,1,0,"JxCAT-JUNTS",36
17,"17020",3677,2851,2835,14,16,"JxCAT-JUNTS",956
43,"43158",74,52,50,0,2,"JxCAT-JUNTS",27
8,"8085",986,769,767,6,2,"JxCAT-JUNTS",238
43,"43074",1818,1341,1336,2,5,"JxCAT-JUNTS",286
8,"8307",49499,35471,35312,199,159,"JxCAT-JUNTS",4071
8,"8138",4461,3286,3259,27,27,"JxCAT-JUNTS",687
25,"25175",173,119,119,2,0,"JxCAT-JUNTS",29
43,"43029",312,241,240,1,1,"JxCAT-JUNTS",40
43,"43169",445,388,388,3,0,"JxCAT-JUNTS",85
8,"8116",557,449,449,1,0,"JxCAT-JUNTS",168
17,"17198",437,307,306,0,1,"JxCAT-JUNTS",70
17,"17134",220,175,174,1,1,"JxCAT-JUNTS",52
8,"8121",87515,62961,62574,429,387,"JxCAT-JUNTS",7127
8,"8261",2405,1726,1718,11,8,"JxCAT-JUNTS",222
25,"25014",246,184,178,0,6,"JxCAT-JUNTS",60
17,"17051",202,161,160,0,1,"JxCAT-JUNTS",61
8,"8014",2013,1526,1521,4,5,"JxCAT-JUNTS",352
25,"25032",65,53,52,0,1,"JxCAT-JUNTS",12
17,"17092",3462,2414,2389,14,25,"JxCAT-JUNTS",461
8,"8153",573,457,452,3,5,"JxCAT-JUNTS",116
8,"8013",1287,982,972,6,10,"JxCAT-JUNTS",281
8,"8233",1872,1428,1420,15,8,"JxCAT-JUNTS",458
17,"17058",176,128,128,0,0,"JxCAT-JUNTS",55
8,"8093",25,22,22,0,0,"JxCAT-JUNTS",4
8,"8301",49348,36261,36045,292,216,"JxCAT-JUNTS",1268
8,"8155",7056,5050,5011,38,39,"JxCAT-JUNTS",498
17,"17112",198,148,147,3,1,"JxCAT-JUNTS",47
8,"8175",3369,2388,2372,18,16,"JxCAT-JUNTS",648
25,"25132",141,106,105,0,1,"JxCAT-JUNTS",30
43,"43056",803,566,558,6,8,"JxCAT-JUNTS",100
25,"25193",768,567,563,4,4,"JxCAT-JUNTS",220
25,"25003",3717,2577,2561,15,16,"JxCAT-JUNTS",765
8,"8223",1897,1345,1341,10,4,"JxCAT-JUNTS",288
25,"25012",2349,1563,1556,17,7,"JxCAT-JUNTS",278
43,"43075",86,65,63,0,2,"JxCAT-JUNTS",17
25,"25030",117,76,76,0,0,"JxCAT-JUNTS",27
25,"25074",179,155,151,2,4,"JxCAT-JUNTS",34
17,"17089",5749,3973,3949,17,24,"JxCAT-JUNTS",1054
43,"43137",1890,1373,1353,8,20,"JxCAT-JUNTS",188
17,"17201",137,103,103,0,0,"JxCAT-JUNTS",32
17,"17117",14497,9438,9382,66,56,"JxCAT-JUNTS",1787
43,"43020",2291,1712,1688,19,24,"JxCAT-JUNTS",209
8,"8148",2344,1655,1646,13,9,"JxCAT-JUNTS",143
17,"17115",276,208,208,4,0,"JxCAT-JUNTS",54
8,"8057",61,47,47,1,0,"JxCAT-JUNTS",11
25,"25190",262,202,202,2,0,"JxCAT-JUNTS",32
17,"17022",7043,4940,4903,34,37,"JxCAT-JUNTS",1122
8,"8165",1680,1177,1171,7,6,"JxCAT-JUNTS",234
8,"8270",19014,13635,13594,74,41,"JxCAT-JUNTS",1948
25,"25206",247,188,188,2,0,"JxCAT-JUNTS",76
8,"8030",5208,4045,4033,25,12,"JxCAT-JUNTS",978
25,"25180",227,158,155,1,3,"JxCAT-JUNTS",70
25,"25047",956,745,736,14,9,"JxCAT-JUNTS",193
43,"43036",869,565,557,7,8,"JxCAT-JUNTS",93
43,"43061",40,27,27,3,0,"JxCAT-JUNTS",14
8,"8241",70,52,52,0,0,"JxCAT-JUNTS",20
25,"25208",337,242,241,2,1,"JxCAT-JUNTS",42
43,"43016",3470,2547,2508,15,39,"JxCAT-JUNTS",280
8,"8277",168,148,146,1,2,"JxCAT-JUNTS",47
8,"8123",19570,15378,15316,91,62,"JxCAT-JUNTS",1930
8,"8012",1726,1323,1309,17,14,"JxCAT-JUNTS",379
25,"25002",465,324,323,4,1,"JxCAT-JUNTS",88
17,"17173",181,143,143,1,0,"JxCAT-JUNTS",33
8,"8114",18838,13519,13442,81,77,"JxCAT-JUNTS",1139
8,"8132",356,265,265,1,0,"JxCAT-JUNTS",108
43,"43171",14849,10140,10081,76,59,"JxCAT-JUNTS",657
17,"17146",3150,2243,2224,8,19,"JxCAT-JUNTS",345
8,"8052",140,102,102,1,0,"JxCAT-JUNTS",46
8,"8244",6099,4733,4706,39,27,"JxCAT-JUNTS",371
17,"17195",338,274,272,1,2,"JxCAT-JUNTS",98
25,"25061",80,51,51,0,0,"JxCAT-JUNTS",21
25,"25902",536,406,403,1,3,"JxCAT-JUNTS",113
17,"17144",211,162,159,3,3,"JxCAT-JUNTS",49
8,"8219",15755,12235,12206,72,29,"JxCAT-JUNTS",2278
25,"25058",4345,3058,3045,13,13,"JxCAT-JUNTS",976
43,"43126",1230,937,933,3,4,"JxCAT-JUNTS",176
25,"25016",2083,1404,1399,3,5,"JxCAT-JUNTS",371
8,"8112",12926,9268,9230,61,38,"JxCAT-JUNTS",2354
43,"43001",708,510,507,0,3,"JxCAT-JUNTS",98
43,"43053",186,135,134,0,1,"JxCAT-JUNTS",33
43,"43022",1436,1028,1024,13,4,"JxCAT-JUNTS",147
25,"25211",680,470,470,3,0,"JxCAT-JUNTS",96
8,"8008",175,136,136,2,0,"JxCAT-JUNTS",38
17,"17009",4068,3061,3050,16,11,"JxCAT-JUNTS",1035
8,"8171",2046,1520,1510,13,10,"JxCAT-JUNTS",571
8,"8089",34190,24548,24404,194,144,"JxCAT-JUNTS",1515
17,"17014",66,51,49,0,2,"JxCAT-JUNTS",16
17,"17163",2868,2281,2268,13,13,"JxCAT-JUNTS",843
25,"25043",800,584,581,2,3,"JxCAT-JUNTS",116
17,"17049",3246,2527,2502,12,25,"JxCAT-JUNTS",561
8,"8216",25,17,17,0,0,"JxCAT-JUNTS",2
25,"25130",181,130,128,0,2,"JxCAT-JUNTS",39
25,"25158",1605,1193,1180,8,13,"JxCAT-JUNTS",371
43,"43152",435,348,342,2,6,"JxCAT-JUNTS",93
8,"8167",6056,4520,4500,38,20,"JxCAT-JUNTS",199
8,"8160",317,234,234,0,0,"JxCAT-JUNTS",102
25,"25181",172,137,137,1,0,"JxCAT-JUNTS",44
17,"17902",1294,992,990,9,2,"JxCAT-JUNTS",332
25,"25069",426,296,294,0,2,"JxCAT-JUNTS",91
25,"25216",244,186,186,0,0,"JxCAT-JUNTS",47
8,"8094",1588,1258,1252,7,6,"JxCAT-JUNTS",258
43,"43902",2751,1794,1776,21,18,"JxCAT-JUNTS",175
17,"17041",217,150,146,1,4,"JxCAT-JUNTS",24
43,"43048",768,564,554,7,10,"JxCAT-JUNTS",73
43,"43083",146,110,109,0,1,"JxCAT-JUNTS",28
8,"8048",580,427,426,1,1,"JxCAT-JUNTS",93
17,"17234",181,129,129,1,0,"JxCAT-JUNTS",23
8,"8285",10349,7630,7599,48,31,"JxCAT-JUNTS",2132
25,"25148",224,158,158,0,0,"JxCAT-JUNTS",78
8,"8289",4473,3379,3371,25,8,"JxCAT-JUNTS",432
8,"8174",388,322,318,2,4,"JxCAT-JUNTS",83
43,"43122",112,91,91,1,0,"JxCAT-JUNTS",15
17,"17149",370,302,300,1,2,"JxCAT-JUNTS",119
25,"25172",1762,1332,1323,8,9,"JxCAT-JUNTS",401
43,"43164",310,235,231,3,4,"JxCAT-JUNTS",15
43,"43032",462,354,350,2,4,"JxCAT-JUNTS",89
25,"25224",122,94,94,0,0,"JxCAT-JUNTS",23
8,"8024",357,282,282,2,0,"JxCAT-JUNTS",83
17,"17086",1769,1116,1109,6,7,"JxCAT-JUNTS",126
17,"17012",1175,845,842,4,3,"JxCAT-JUNTS",173
25,"25072",5881,4059,4031,30,28,"JxCAT-JUNTS",934
43,"43055",1970,1548,1535,12,13,"JxCAT-JUNTS",344
17,"17138",836,591,584,7,7,"JxCAT-JUNTS",87
8,"8087",144,120,120,0,0,"JxCAT-JUNTS",34
17,"17147",7916,5672,5641,41,31,"JxCAT-JUNTS",1593
8,"8125",25583,18334,18225,122,109,"JxCAT-JUNTS",970
8,"8042",2390,1772,1764,12,8,"JxCAT-JUNTS",192
8,"8208",5793,4267,4244,21,23,"JxCAT-JUNTS",408
8,"8146",1384,1030,1027,8,3,"JxCAT-JUNTS",81
17,"17151",179,131,130,0,1,"JxCAT-JUNTS",34
25,"25182",1043,763,760,8,3,"JxCAT-JUNTS",144
17,"17191",163,140,140,1,0,"JxCAT-JUNTS",57
43,"43170",877,664,661,4,3,"JxCAT-JUNTS",144
8,"8284",12597,8244,8183,60,61,"JxCAT-JUNTS",1177
8,"8045",65,44,43,0,1,"JxCAT-JUNTS",15
43,"43063",544,376,374,2,2,"JxCAT-JUNTS",75
17,"17102",556,398,396,1,2,"JxCAT-JUNTS",121
8,"8199",648,509,508,3,1,"JxCAT-JUNTS",138
43,"43111",2129,1412,1401,8,11,"JxCAT-JUNTS",118
43,"43023",211,171,169,2,2,"JxCAT-JUNTS",27
43,"43102",458,331,324,2,7,"JxCAT-JUNTS",59
17,"17128",321,239,238,1,1,"JxCAT-JUNTS",57
17,"17011",645,518,514,10,4,"JxCAT-JUNTS",175
8,"8159",14343,10656,10603,87,53,"JxCAT-JUNTS",824
43,"43054",2807,1972,1957,14,15,"JxCAT-JUNTS",421
17,"17200",624,469,467,6,2,"JxCAT-JUNTS",123
8,"8293",227,177,177,0,0,"JxCAT-JUNTS",47
25,"25161",339,221,221,0,0,"JxCAT-JUNTS",63
17,"17106",142,114,114,0,0,"JxCAT-JUNTS",33
25,"25055",163,114,114,0,0,"JxCAT-JUNTS",41
17,"17222",104,87,87,1,0,"JxCAT-JUNTS",32
8,"8104",657,496,493,4,3,"JxCAT-JUNTS",141
8,"8903",201,181,181,1,0,"JxCAT-JUNTS",69
43,"43091",125,90,90,1,0,"JxCAT-JUNTS",10
17,"17036",2639,1944,1934,21,10,"JxCAT-JUNTS",522
25,"25231",483,387,385,0,2,"JxCAT-JUNTS",94
17,"17055",142,124,124,0,0,"JxCAT-JUNTS",35
8,"8049",1309,910,903,3,7,"JxCAT-JUNTS",328
25,"25219",146,111,111,1,0,"JxCAT-JUNTS",25
43,"43103",908,705,701,9,4,"JxCAT-JUNTS",73
43,"43035",233,182,182,5,0,"JxCAT-JUNTS",42
17,"17118",12934,8723,8665,38,58,"JxCAT-JUNTS",1725
43,"43114",370,281,278,1,3,"JxCAT-JUNTS",49
8,"8120",7129,5649,5621,51,28,"JxCAT-JUNTS",2156
17,"17223",808,566,563,1,3,"JxCAT-JUNTS",119
17,"17150",1444,1177,1163,13,14,"JxCAT-JUNTS",440
25,"25110",2745,1943,1927,13,16,"JxCAT-JUNTS",522
43,"43033",766,555,555,4,0,"JxCAT-JUNTS",81
25,"25146",223,158,155,3,3,"JxCAT-JUNTS",65
17,"17081",252,186,185,2,1,"JxCAT-JUNTS",66
17,"17025",1182,943,938,5,5,"JxCAT-JUNTS",319
17,"17136",196,150,150,0,0,"JxCAT-JUNTS",38
25,"25150",167,132,130,2,2,"JxCAT-JUNTS",60
43,"43133",5627,3794,3773,31,21,"JxCAT-JUNTS",474
17,"17019",1780,1403,1393,5,10,"JxCAT-JUNTS",556
25,"25239",582,330,330,3,0,"JxCAT-JUNTS",84
25,"25121",632,380,374,3,6,"JxCAT-JUNTS",31
8,"8259",6979,5362,5341,27,21,"JxCAT-JUNTS",1147
25,"25911",419,298,297,3,1,"JxCAT-JUNTS",101
25,"25134",605,457,456,5,1,"JxCAT-JUNTS",138
8,"8217",25466,19864,19773,129,91,"JxCAT-JUNTS",1340
43,"43154",126,104,104,0,0,"JxCAT-JUNTS",16
17,"17088",599,467,465,3,2,"JxCAT-JUNTS",119
8,"8225",94,83,82,1,1,"JxCAT-JUNTS",42
17,"17155",14957,9519,9410,71,109,"JxCAT-JUNTS",1672
25,"25207",6443,4525,4492,31,33,"JxCAT-JUNTS",1267
25,"25050",3256,2260,2249,20,11,"JxCAT-JUNTS",553
8,"8139",172,148,147,2,1,"JxCAT-JUNTS",33
8,"8210",4640,3226,3200,24,26,"JxCAT-JUNTS",674
25,"25115",803,601,593,4,8,"JxCAT-JUNTS",219
43,"43119",849,591,588,8,3,"JxCAT-JUNTS",96
25,"25168",496,399,399,6,0,"JxCAT-JUNTS",134
17,"17074",536,403,401,1,2,"JxCAT-JUNTS",68
8,"8135",6770,5187,5158,42,29,"JxCAT-JUNTS",310
8,"8107",11965,8604,8554,67,50,"JxCAT-JUNTS",611
43,"43109",2706,1751,1738,17,13,"JxCAT-JUNTS",136
43,"43905",15100,9689,9630,43,59,"JxCAT-JUNTS",780
8,"8304",822,655,655,5,0,"JxCAT-JUNTS",158
8,"8166",964,700,697,7,3,"JxCAT-JUNTS",191
25,"25910",91,63,63,0,0,"JxCAT-JUNTS",20
25,"25149",1377,1034,1028,9,6,"JxCAT-JUNTS",327
43,"43143",50,40,39,0,1,"JxCAT-JUNTS",14
17,"17171",177,138,137,0,1,"JxCAT-JUNTS",41
43,"43178",1435,1071,1066,2,5,"JxCAT-JUNTS",196
43,"43161",17103,11905,11838,82,67,"JxCAT-JUNTS",2465
17,"17068",253,191,191,0,0,"JxCAT-JUNTS",79
43,"43092",7308,4703,4679,33,24,"JxCAT-JUNTS",580
25,"25141",154,105,104,3,1,"JxCAT-JUNTS",42
17,"17196",252,200,200,1,0,"JxCAT-JUNTS",51
17,"17052",135,93,92,0,1,"JxCAT-JUNTS",35
43,"43082",350,276,271,5,5,"JxCAT-JUNTS",92
17,"17153",189,150,149,1,1,"JxCAT-JUNTS",37
43,"43030",483,356,351,2,5,"JxCAT-JUNTS",69
8,"8128",579,428,423,4,5,"JxCAT-JUNTS",124
25,"25238",212,161,160,0,1,"JxCAT-JUNTS",61
8,"8032",2100,1472,1465,12,7,"JxCAT-JUNTS",257
8,"8237",1644,1263,1254,9,9,"JxCAT-JUNTS",408
43,"43128",910,665,658,6,7,"JxCAT-JUNTS",97
8,"8002",217,172,172,2,0,"JxCAT-JUNTS",70
17,"17038",377,303,301,0,2,"JxCAT-JUNTS",106
17,"17180",8508,5977,5953,38,24,"JxCAT-JUNTS",1816
8,"8091",5428,4048,4024,20,24,"JxCAT-JUNTS",519
43,"43107",387,285,285,3,0,"JxCAT-JUNTS",33
17,"17178",1065,774,771,9,3,"JxCAT-JUNTS",230
25,"25903",226,169,169,1,0,"JxCAT-JUNTS",62
25,"25174",390,312,312,1,0,"JxCAT-JUNTS",96
25,"25255",390,301,301,0,0,"JxCAT-JUNTS",86
43,"43093",3863,2728,2716,22,12,"JxCAT-JUNTS",471
8,"8010",4224,3109,3090,22,19,"JxCAT-JUNTS",671
8,"8150",258,207,207,1,0,"JxCAT-JUNTS",65
25,"25027",978,695,690,3,5,"JxCAT-JUNTS",236
25,"25243",3729,2370,2349,33,21,"JxCAT-JUNTS",205
8,"8276",241,179,179,3,0,"JxCAT-JUNTS",41
25,"25202",108,72,72,2,0,"JxCAT-JUNTS",19
8,"8266",43422,32827,32696,241,131,"JxCAT-JUNTS",2644
8,"8130",110,81,81,2,0,"JxCAT-JUNTS",26
43,"43073",80,67,65,0,2,"JxCAT-JUNTS",25
17,"17125",136,100,100,3,0,"JxCAT-JUNTS",46
8,"8064",1956,1439,1423,7,16,"JxCAT-JUNTS",379
8,"8246",1692,1345,1340,7,5,"JxCAT-JUNTS",479
25,"25104",120,88,88,0,0,"JxCAT-JUNTS",33
25,"25126",281,211,210,1,1,"JxCAT-JUNTS",49
8,"8056",42897,30873,30757,259,116,"JxCAT-JUNTS",2134
17,"17210",572,414,411,2,3,"JxCAT-JUNTS",134
8,"8034",820,644,640,0,4,"JxCAT-JUNTS",200
43,"43120",421,256,254,1,2,"JxCAT-JUNTS",33
8,"8080",40,27,27,3,0,"JxCAT-JUNTS",4
8,"8103",652,476,474,1,2,"JxCAT-JUNTS",88
8,"8072",10769,7632,7600,56,32,"JxCAT-JUNTS",921
25,"25070",817,619,617,11,2,"JxCAT-JUNTS",187
17,"17109",704,542,539,2,3,"JxCAT-JUNTS",193
43,"43059",250,193,192,1,1,"JxCAT-JUNTS",55
25,"25024",352,248,247,0,1,"JxCAT-JUNTS",72
8,"8214",7007,5390,5371,25,19,"JxCAT-JUNTS",1117
43,"43132",375,295,291,1,4,"JxCAT-JUNTS",79
25,"25254",704,511,508,2,3,"JxCAT-JUNTS",128
25,"25173",1646,1180,1169,6,11,"JxCAT-JUNTS",136
17,"17050",664,554,550,10,4,"JxCAT-JUNTS",197
17,"17217",350,287,284,0,3,"JxCAT-JUNTS",72
25,"25217",10891,7651,7610,63,41,"JxCAT-JUNTS",1941
43,"43127",775,607,606,3,1,"JxCAT-JUNTS",143
8,"8040",11116,7923,7891,49,32,"JxCAT-JUNTS",1339
43,"43145",4209,3193,3170,17,23,"JxCAT-JUNTS",626
25,"25125",383,265,265,3,0,"JxCAT-JUNTS",83
43,"43002",1890,1233,1210,12,23,"JxCAT-JUNTS",135
8,"8028",1125,744,743,7,1,"JxCAT-JUNTS",49
25,"25114",96,83,82,1,1,"JxCAT-JUNTS",53
25,"25176",307,241,238,3,3,"JxCAT-JUNTS",87
25,"25041",525,375,370,4,5,"JxCAT-JUNTS",91
17,"17208",978,723,719,6,4,"JxCAT-JUNTS",269
17,"17070",110,87,87,0,0,"JxCAT-JUNTS",43
17,"17186",3834,2980,2954,17,26,"JxCAT-JUNTS",576
25,"25177",356,252,250,1,2,"JxCAT-JUNTS",74
43,"43088",2013,1429,1420,11,9,"JxCAT-JUNTS",271
25,"25020",270,202,201,2,1,"JxCAT-JUNTS",77
17,"17018",494,377,372,4,5,"JxCAT-JUNTS",111
25,"25094",138,96,93,2,3,"JxCAT-JUNTS",39
25,"25904",160,134,133,2,1,"JxCAT-JUNTS",58
43,"43026",756,576,574,1,2,"JxCAT-JUNTS",134
8,"8140",4816,3541,3520,25,21,"JxCAT-JUNTS",723
8,"8021",60,44,44,1,0,"JxCAT-JUNTS",13
17,"17141",6019,3855,3833,43,22,"JxCAT-JUNTS",718
17,"17027",2857,2236,2229,9,7,"JxCAT-JUNTS",548
43,"43149",690,512,509,3,3,"JxCAT-JUNTS",76
25,"25086",525,410,407,3,3,"JxCAT-JUNTS",111
8,"8158",3094,2261,2251,11,10,"JxCAT-JUNTS",258
25,"25154",117,86,85,0,1,"JxCAT-JUNTS",42
17,"17228",285,218,217,0,1,"JxCAT-JUNTS",56
17,"17220",801,649,647,2,2,"JxCAT-JUNTS",264
25,"25145",75,59,59,0,0,"JxCAT-JUNTS",29
43,"43027",168,129,129,3,0,"JxCAT-JUNTS",58
17,"17066",27378,16755,16644,122,111,"JxCAT-JUNTS",2934
8,"8017",2808,2033,2016,16,17,"JxCAT-JUNTS",457
25,"25046",410,331,326,4,5,"JxCAT-JUNTS",67
17,"17087",219,179,177,0,2,"JxCAT-JUNTS",57
43,"43065",379,281,277,4,4,"JxCAT-JUNTS",84
8,"8037",1947,1547,1543,11,4,"JxCAT-JUNTS",572
17,"17076",119,95,94,2,1,"JxCAT-JUNTS",20
17,"17224",299,226,222,2,4,"JxCAT-JUNTS",95
8,"8055",542,426,424,3,2,"JxCAT-JUNTS",87
25,"25128",125,85,85,0,0,"JxCAT-JUNTS",16
25,"25139",477,348,346,3,2,"JxCAT-JUNTS",74
17,"17008",3605,2595,2577,8,18,"JxCAT-JUNTS",999
17,"17206",158,111,109,0,2,"JxCAT-JUNTS",35
17,"17004",529,411,410,3,1,"JxCAT-JUNTS",118
8,"8152",117,94,94,0,0,"JxCAT-JUNTS",28
17,"17152",11065,6959,6927,68,32,"JxCAT-JUNTS",1025
17,"17002",578,477,474,2,3,"JxCAT-JUNTS",180
8,"8023",7029,5027,5000,39,27,"JxCAT-JUNTS",619
25,"25230",1541,1105,1099,9,6,"JxCAT-JUNTS",238
43,"43175",534,363,359,5,4,"JxCAT-JUNTS",89
8,"8220",2411,2010,2001,8,9,"JxCAT-JUNTS",865
43,"43148",91182,65076,64756,441,320,"JxCAT-JUNTS",5917
43,"43038",22070,15127,15018,113,109,"JxCAT-JUNTS",1692
43,"43078",835,610,605,7,5,"JxCAT-JUNTS",156
8,"8184",55053,38519,38323,298,196,"JxCAT-JUNTS",2311
8,"8142",136,117,117,3,0,"JxCAT-JUNTS",41
25,"25157",159,127,126,1,1,"JxCAT-JUNTS",46
43,"43012",3700,2882,2858,20,24,"JxCAT-JUNTS",415
25,"25169",170,117,117,5,0,"JxCAT-JUNTS",25
8,"8253",132,103,102,0,1,"JxCAT-JUNTS",38
8,"8061",1628,1154,1151,15,3,"JxCAT-JUNTS",152
43,"43100",3557,2666,2649,22,17,"JxCAT-JUNTS",250
17,"17033",5647,3879,3852,25,27,"JxCAT-JUNTS",881
43,"43041",216,156,156,2,0,"JxCAT-JUNTS",13
8,"8038",1541,1129,1120,6,9,"JxCAT-JUNTS",219
8,"8228",292,234,233,0,1,"JxCAT-JUNTS",56
43,"43906",2113,1490,1480,12,10,"JxCAT-JUNTS",378
8,"8274",4640,3385,3363,24,22,"JxCAT-JUNTS",467
43,"43071",896,652,647,3,5,"JxCAT-JUNTS",131
25,"25227",656,476,476,2,0,"JxCAT-JUNTS",153
25,"25167",223,165,164,3,1,"JxCAT-JUNTS",59
8,"8077",34690,25896,25767,164,129,"JxCAT-JUNTS",1667
25,"25113",1114,873,863,3,10,"JxCAT-JUNTS",225
17,"17233",2347,1853,1840,11,13,"JxCAT-JUNTS",677
8,"8009",9531,7200,7171,47,29,"JxCAT-JUNTS",1292
43,"43040",325,268,267,1,1,"JxCAT-JUNTS",55
8,"8308",139,109,109,1,0,"JxCAT-JUNTS",62
17,"17903",883,681,676,3,5,"JxCAT-JUNTS",222
43,"43045",143,114,113,0,1,"JxCAT-JUNTS",37
25,"25131",394,281,279,3,2,"JxCAT-JUNTS",40
25,"25093",629,455,443,5,12,"JxCAT-JUNTS",149
8,"8191",5302,3872,3860,21,12,"JxCAT-JUNTS",745
25,"25004",582,437,432,3,5,"JxCAT-JUNTS",117
25,"25192",727,527,524,4,3,"JxCAT-JUNTS",135
17,"17023",27314,18677,18546,117,131,"JxCAT-JUNTS",2075
17,"17183",253,197,197,2,0,"JxCAT-JUNTS",79
25,"25042",204,149,149,5,0,"JxCAT-JUNTS",63
43,"43136",10489,7029,6996,47,33,"JxCAT-JUNTS",1033
43,"43160",1324,967,956,6,11,"JxCAT-JUNTS",135
25,"25210",1073,791,780,3,11,"JxCAT-JUNTS",233
43,"43097",407,331,328,4,3,"JxCAT-JUNTS",68
8,"8190",255,184,182,1,2,"JxCAT-JUNTS",39
25,"25221",115,82,81,1,1,"JxCAT-JUNTS",19
8,"8054",9215,6994,6943,38,51,"JxCAT-JUNTS",627
17,"17035",544,447,447,2,0,"JxCAT-JUNTS",162
25,"25225",531,395,393,0,2,"JxCAT-JUNTS",129
25,"25901",289,214,211,4,3,"JxCAT-JUNTS",52
8,"8294",2093,1546,1534,11,12,"JxCAT-JUNTS",308
8,"8177",36,27,27,1,0,"JxCAT-JUNTS",2
25,"25082",292,197,197,2,0,"JxCAT-JUNTS",48
25,"25185",680,452,451,0,1,"JxCAT-JUNTS",122
8,"8163",19672,13421,13364,70,57,"JxCAT-JUNTS",1249
17,"17044",6938,5245,5212,33,33,"JxCAT-JUNTS",1590
17,"17157",122,104,103,0,1,"JxCAT-JUNTS",37
17,"17165",645,502,502,2,0,"JxCAT-JUNTS",181
25,"25103",133,88,87,0,1,"JxCAT-JUNTS",24
8,"8218",8091,5899,5869,50,30,"JxCAT-JUNTS",871
25,"25913",88,72,72,1,0,"JxCAT-JUNTS",23
25,"25052",1541,1183,1176,7,7,"JxCAT-JUNTS",327
8,"8022",12213,8594,8558,42,36,"JxCAT-JUNTS",2346
17,"17142",2713,2166,2159,18,7,"JxCAT-JUNTS",508
8,"8287",1067,853,844,4,9,"JxCAT-JUNTS",233
25,"25905",366,281,276,4,5,"JxCAT-JUNTS",75
17,"17105",248,187,186,2,1,"JxCAT-JUNTS",48
17,"17182",269,195,195,0,0,"JxCAT-JUNTS",16
17,"17001",575,428,426,4,2,"JxCAT-JUNTS",93
43,"43089",279,201,201,1,0,"JxCAT-JUNTS",26
8,"8015",156540,109145,108440,957,705,"JxCAT-JUNTS",7409
25,"25226",236,156,155,0,1,"JxCAT-JUNTS",42
17,"17040",551,440,439,5,1,"JxCAT-JUNTS",173
8,"8065",1183,920,913,8,7,"JxCAT-JUNTS",255
17,"17069",359,270,267,2,3,"JxCAT-JUNTS",78
8,"8234",3443,2561,2550,15,11,"JxCAT-JUNTS",354
43,"43901",8796,5431,5390,41,41,"JxCAT-JUNTS",937
17,"17158",565,296,295,2,1,"JxCAT-JUNTS",52
25,"25906",205,133,131,2,2,"JxCAT-JUNTS",29
17,"17043",165,133,133,0,0,"JxCAT-JUNTS",56
8,"8058",1808,1280,1262,6,18,"JxCAT-JUNTS",152
25,"25068",515,359,358,0,1,"JxCAT-JUNTS",150
25,"25247",142,89,89,2,0,"JxCAT-JUNTS",6
25,"25253",147,118,117,0,1,"JxCAT-JUNTS",30
8,"8178",444,363,361,2,2,"JxCAT-JUNTS",90
43,"43008",305,171,171,7,0,"JxCAT-JUNTS",20
17,"17110",1332,990,981,3,9,"JxCAT-JUNTS",236
17,"17215",2286,1855,1844,13,11,"JxCAT-JUNTS",447
17,"17054",342,250,250,2,0,"JxCAT-JUNTS",61
25,"25166",170,131,130,2,1,"JxCAT-JUNTS",50
8,"8074",11190,7698,7651,51,47,"JxCAT-JUNTS",570
8,"8256",693,542,542,3,0,"JxCAT-JUNTS",81
25,"25244",374,275,270,1,5,"JxCAT-JUNTS",79
8,"8281",4858,3783,3762,19,21,"JxCAT-JUNTS",846
25,"25064",96,78,78,0,0,"JxCAT-JUNTS",25
25,"25034",2271,1616,1600,12,16,"JxCAT-JUNTS",508
8,"8105",9741,6946,6896,62,50,"JxCAT-JUNTS",196
8,"8226",929,748,747,10,1,"JxCAT-JUNTS",197
17,"17061",180,141,139,1,2,"JxCAT-JUNTS",41
8,"8243",154,125,125,2,0,"JxCAT-JUNTS",51
17,"17187",625,496,492,3,4,"JxCAT-JUNTS",142
43,"43050",2695,1742,1730,10,12,"JxCAT-JUNTS",177
8,"8179",636,466,465,2,1,"JxCAT-JUNTS",55
17,"17193",4351,2945,2927,21,18,"JxCAT-JUNTS",628
25,"25212",219,176,176,1,0,"JxCAT-JUNTS",59
8,"8059",340,255,250,1,5,"JxCAT-JUNTS",65
43,"43062",269,229,226,5,3,"JxCAT-JUNTS",47
25,"25076",131,91,91,0,0,"JxCAT-JUNTS",31
17,"17164",3918,2856,2838,17,18,"JxCAT-JUNTS",932
25,"25022",105,80,79,0,1,"JxCAT-JUNTS",29
17,"17169",2511,1901,1890,8,11,"JxCAT-JUNTS",459
43,"43090",1199,689,686,5,3,"JxCAT-JUNTS",38
25,"25035",364,257,256,0,1,"JxCAT-JUNTS",68
17,"17085",293,239,238,0,1,"JxCAT-JUNTS",65
25,"25057",208,151,149,4,2,"JxCAT-JUNTS",16
17,"17057",968,770,769,7,1,"JxCAT-JUNTS",229
43,"43125",884,658,645,12,13,"JxCAT-JUNTS",68
8,"8176",158,119,119,0,0,"JxCAT-JUNTS",55
8,"8298",27148,19655,19568,102,87,"JxCAT-JUNTS",6299
25,"25233",289,219,218,6,1,"JxCAT-JUNTS",45
43,"43072",90,69,67,1,2,"JxCAT-JUNTS",16
8,"8071",249,209,208,0,1,"JxCAT-JUNTS",42
17,"17026",549,421,415,3,6,"JxCAT-JUNTS",152
8,"8250",7235,4917,4876,41,41,"JxCAT-JUNTS",248
43,"43157",339,279,279,1,0,"JxCAT-JUNTS",82
17,"17111",984,728,728,7,0,"JxCAT-JUNTS",235
8,"8100",2083,1707,1699,13,8,"JxCAT-JUNTS",675
8,"8036",163,122,122,0,0,"JxCAT-JUNTS",47
25,"25049",156,110,109,1,1,"JxCAT-JUNTS",34
43,"43166",1646,1183,1176,4,7,"JxCAT-JUNTS",160
17,"17103",5057,3196,3174,21,22,"JxCAT-JUNTS",470
8,"8904",10516,7068,7025,54,43,"JxCAT-JUNTS",102
25,"25039",259,197,196,7,1,"JxCAT-JUNTS",48
17,"17021",119,89,87,0,2,"JxCAT-JUNTS",25
8,"8046",13541,10510,10455,73,55,"JxCAT-JUNTS",1757
17,"17100",193,147,141,0,6,"JxCAT-JUNTS",59
25,"25071",41,31,30,0,1,"JxCAT-JUNTS",7
8,"8117",2489,1954,1941,21,13,"JxCAT-JUNTS",572
8,"8033",13262,9887,9833,64,54,"JxCAT-JUNTS",1456
8,"8278",4925,3820,3804,22,16,"JxCAT-JUNTS",1344
43,"43172",334,248,243,4,5,"JxCAT-JUNTS",47
8,"8282",6731,5333,5317,40,16,"JxCAT-JUNTS",975
17,"17056",1780,1379,1374,13,5,"JxCAT-JUNTS",577
43,"43124",468,343,339,3,4,"JxCAT-JUNTS",87
8,"8102",28940,21108,21014,157,94,"JxCAT-JUNTS",4426
25,"25164",353,259,255,0,4,"JxCAT-JUNTS",111
25,"25092",125,93,92,0,1,"JxCAT-JUNTS",30
8,"8254",1766,1433,1427,16,6,"JxCAT-JUNTS",489
8,"8029",3586,2868,2862,20,6,"JxCAT-JUNTS",669
25,"25067",702,500,494,8,6,"JxCAT-JUNTS",133
43,"43013",4406,3004,2975,19,29,"JxCAT-JUNTS",599
8,"8239",467,362,361,3,1,"JxCAT-JUNTS",93
25,"25170",262,210,210,1,0,"JxCAT-JUNTS",71
17,"17137",3486,2812,2808,15,4,"JxCAT-JUNTS",861
25,"25194",410,292,289,3,3,"JxCAT-JUNTS",105
8,"8063",469,390,390,4,0,"JxCAT-JUNTS",113
8,"8202",12943,9408,9358,58,50,"JxCAT-JUNTS",1917
43,"43031",1447,1085,1072,13,13,"JxCAT-JUNTS",286
8,"8300",5927,4609,4589,41,20,"JxCAT-JUNTS",526
8,"8209",6925,4976,4948,39,28,"JxCAT-JUNTS",506
8,"8232",1773,1368,1362,9,6,"JxCAT-JUNTS",302
43,"43060",2672,2032,2015,7,17,"JxCAT-JUNTS",289
8,"8083",1672,1433,1430,6,3,"JxCAT-JUNTS",584
43,"43037",18216,11749,11672,70,77,"JxCAT-JUNTS",1087
8,"8134",848,618,609,4,9,"JxCAT-JUNTS",118
17,"17097",200,170,167,2,3,"JxCAT-JUNTS",44
8,"8109",207,176,174,0,2,"JxCAT-JUNTS",47
43,"43117",147,119,119,0,0,"JxCAT-JUNTS",37
43,"43105",155,126,123,4,3,"JxCAT-JUNTS",30
8,"8031",2339,1760,1750,15,10,"JxCAT-JUNTS",419
25,"25005",269,193,193,3,0,"JxCAT-JUNTS",59
43,"43134",281,217,215,5,2,"JxCAT-JUNTS",39
8,"8248",5687,4187,4165,21,22,"JxCAT-JUNTS",658
43,"43006",676,462,462,3,0,"JxCAT-JUNTS",65
25,"25215",339,249,249,5,0,"JxCAT-JUNTS",47
8,"8230",7648,5797,5774,40,23,"JxCAT-JUNTS",992
25,"25138",558,427,424,2,3,"JxCAT-JUNTS",116
25,"25204",1187,858,849,13,9,"JxCAT-JUNTS",264
17,"17209",615,472,471,5,1,"JxCAT-JUNTS",115
25,"25165",271,210,208,0,2,"JxCAT-JUNTS",75
8,"8079",333,260,258,2,2,"JxCAT-JUNTS",72
43,"43018",384,297,297,2,0,"JxCAT-JUNTS",105
8,"8279",156327,112605,112030,952,575,"JxCAT-JUNTS",11560
8,"8151",450,351,346,5,5,"JxCAT-JUNTS",133
43,"43146",40,32,32,0,0,"JxCAT-JUNTS",8
25,"25073",559,377,377,2,0,"JxCAT-JUNTS",104
17,"17211",837,677,674,6,3,"JxCAT-JUNTS",250
25,"25021",2513,1668,1662,17,6,"JxCAT-JUNTS",361
8,"8292",1074,796,790,2,6,"JxCAT-JUNTS",128
17,"17194",73,56,56,0,0,"JxCAT-JUNTS",19
43,"43173",98,70,68,0,2,"JxCAT-JUNTS",17
8,"8078",216,154,154,2,0,"JxCAT-JUNTS",50
43,"43086",5252,3811,3790,28,21,"JxCAT-JUNTS",816
25,"25044",178,144,142,0,2,"JxCAT-JUNTS",52
8,"8156",11254,8440,8411,58,29,"JxCAT-JUNTS",996
17,"17148",1550,1121,1114,15,7,"JxCAT-JUNTS",331
43,"43156",3956,2812,2784,22,28,"JxCAT-JUNTS",360
8,"8066",1466,1109,1104,7,5,"JxCAT-JUNTS",127
17,"17091",391,296,290,3,6,"JxCAT-JUNTS",125
25,"25137",8684,5802,5757,48,45,"JxCAT-JUNTS",1506
25,"25245",427,312,308,4,4,"JxCAT-JUNTS",42
17,"17096",159,116,116,3,0,"JxCAT-JUNTS",43
25,"25045",57,26,26,2,0,"JxCAT-JUNTS",1
8,"8290",1549,1254,1248,6,6,"JxCAT-JUNTS",258
8,"8288",1696,1103,1096,9,7,"JxCAT-JUNTS",146
25,"25252",553,380,379,2,1,"JxCAT-JUNTS",116
17,"17176",128,111,111,0,0,"JxCAT-JUNTS",23
43,"43177",276,229,227,2,2,"JxCAT-JUNTS",44
25,"25129",161,113,112,0,1,"JxCAT-JUNTS",44
43,"43131",4827,3134,3116,32,18,"JxCAT-JUNTS",236
43,"43163",26162,17276,17128,98,148,"JxCAT-JUNTS",1687
8,"8236",1564,1145,1133,4,12,"JxCAT-JUNTS",222
8,"8097",1103,845,840,4,5,"JxCAT-JUNTS",203
17,"17121",225,166,163,2,3,"JxCAT-JUNTS",66
25,"25013",2099,1430,1414,13,16,"JxCAT-JUNTS",216
8,"8255",133,100,100,2,0,"JxCAT-JUNTS",45
8,"8187",153822,113081,112470,758,611,"JxCAT-JUNTS",12376
25,"25250",327,269,265,1,4,"JxCAT-JUNTS",75
8,"8041",10698,7324,7258,57,66,"JxCAT-JUNTS",464
8,"8162",2118,1581,1576,13,5,"JxCAT-JUNTS",194
17,"17177",562,426,423,1,3,"JxCAT-JUNTS",154
43,"43015",115,92,91,1,1,"JxCAT-JUNTS",25
8,"8136",11692,8527,8456,98,71,"JxCAT-JUNTS",419
8,"8302",9359,6483,6430,78,53,"JxCAT-JUNTS",313
8,"8113",52589,36864,36690,244,174,"JxCAT-JUNTS",7748
17,"17046",709,537,531,2,6,"JxCAT-JUNTS",161
17,"17028",297,216,214,2,2,"JxCAT-JUNTS",99
43,"43141",109,85,84,0,1,"JxCAT-JUNTS",25
8,"8027",724,584,582,1,2,"JxCAT-JUNTS",140
43,"43167",391,307,307,2,0,"JxCAT-JUNTS",75
43,"43028",2770,1784,1770,7,14,"JxCAT-JUNTS",295
8,"8267",6789,4975,4935,41,40,"JxCAT-JUNTS",575
25,"25153",190,139,136,0,3,"JxCAT-JUNTS",30
17,"17197",128,97,97,0,0,"JxCAT-JUNTS",34
8,"8106",7500,5442,5410,43,32,"JxCAT-JUNTS",680
8,"8192",5701,4366,4349,15,17,"JxCAT-JUNTS",945
8,"8275",247,218,218,3,0,"JxCAT-JUNTS",87
8,"8207",2026,1667,1659,12,8,"JxCAT-JUNTS",540
8,"8283",6165,4546,4524,33,22,"JxCAT-JUNTS",1314
17,"17143",145,104,104,0,0,"JxCAT-JUNTS",34
25,"25007",1378,1010,999,12,11,"JxCAT-JUNTS",197
17,"17232",146,111,111,0,0,"JxCAT-JUNTS",25
43,"43116",465,356,352,0,4,"JxCAT-JUNTS",97
17,"17082",435,308,307,1,1,"JxCAT-JUNTS",92
8,"8238",14946,11911,11873,85,38,"JxCAT-JUNTS",1996
25,"25909",138,99,98,2,1,"JxCAT-JUNTS",31
8,"8076",16526,11988,11893,90,95,"JxCAT-JUNTS",1060
8,"8273",2390,1871,1855,14,16,"JxCAT-JUNTS",505
17,"17135",393,307,303,0,4,"JxCAT-JUNTS",58
17,"17207",2420,1920,1901,9,19,"JxCAT-JUNTS",741
8,"8018",2540,1862,1855,7,7,"JxCAT-JUNTS",381
8,"8099",753,529,529,4,0,"JxCAT-JUNTS",122
25,"25048",1641,1207,1194,13,13,"JxCAT-JUNTS",320
25,"25089",93,70,68,1,2,"JxCAT-JUNTS",14
17,"17212",145,111,109,0,2,"JxCAT-JUNTS",34
25,"25017",228,175,174,0,1,"JxCAT-JUNTS",61
17,"17107",267,207,205,2,2,"JxCAT-JUNTS",89
17,"17192",143,107,104,0,3,"JxCAT-JUNTS",46
8,"8901",240,200,195,2,5,"JxCAT-JUNTS",77
8,"8195",75,62,62,0,0,"JxCAT-JUNTS",34
25,"25912",841,620,619,5,1,"JxCAT-JUNTS",80
8,"8127",2254,1548,1544,10,4,"JxCAT-JUNTS",250
17,"17005",457,322,320,3,2,"JxCAT-JUNTS",70
8,"8251",5130,3719,3698,20,21,"JxCAT-JUNTS",382
17,"17139",1407,1128,1119,8,9,"JxCAT-JUNTS",416
17,"17071",1134,943,940,1,3,"JxCAT-JUNTS",332
8,"8231",21269,14655,14573,111,82,"JxCAT-JUNTS",1424
8,"8272",164,128,128,1,0,"JxCAT-JUNTS",44
25,"25908",217,136,136,0,0,"JxCAT-JUNTS",36
17,"17039",1726,1306,1297,7,9,"JxCAT-JUNTS",485
43,"43004",6288,4314,4262,36,52,"JxCAT-JUNTS",499
8,"8101",175048,121359,120620,830,739,"JxCAT-JUNTS",4841
8,"8257",103,82,82,0,0,"JxCAT-JUNTS",32
8,"8025",1573,1170,1160,9,10,"JxCAT-JUNTS",179
25,"25097",89,71,71,2,0,"JxCAT-JUNTS",12
25,"25183",520,372,370,4,2,"JxCAT-JUNTS",103
8,"8154",697,541,539,3,2,"JxCAT-JUNTS",123
25,"25033",1120,838,831,5,7,"JxCAT-JUNTS",213
8,"8185",197,162,162,1,0,"JxCAT-JUNTS",35
25,"25019",4606,2860,2829,19,31,"JxCAT-JUNTS",549
8,"8905",2329,1872,1863,7,9,"JxCAT-JUNTS",289
17,"17073",1939,1649,1640,11,9,"JxCAT-JUNTS",631
8,"8222",1821,1439,1424,7,15,"JxCAT-JUNTS",241
17,"17159",622,459,459,1,0,"JxCAT-JUNTS",153
17,"17079",65572,47740,47502,279,238,"JxCAT-JUNTS",12241
43,"43049",727,557,555,3,2,"JxCAT-JUNTS",132
25,"25205",563,412,407,3,5,"JxCAT-JUNTS",110
8,"8086",14137,9971,9912,77,59,"JxCAT-JUNTS",1086
8,"8181",8133,5949,5924,31,25,"JxCAT-JUNTS",885
43,"43024",1545,1019,1014,14,5,"JxCAT-JUNTS",97
8,"8286",2943,2051,2042,12,9,"JxCAT-JUNTS",217
8,"8188",115,89,89,0,0,"JxCAT-JUNTS",33
43,"43084",514,388,383,2,5,"JxCAT-JUNTS",65
43,"43108",1787,1293,1282,6,11,"JxCAT-JUNTS",331
17,"17124",1593,1163,1160,8,3,"JxCAT-JUNTS",340
8,"8069",3323,2555,2540,21,15,"JxCAT-JUNTS",361
17,"17007",1763,1367,1359,9,8,"JxCAT-JUNTS",716
17,"17098",308,232,230,4,2,"JxCAT-JUNTS",61
17,"17214",714,516,511,6,5,"JxCAT-JUNTS",139
17,"17218",576,456,451,3,5,"JxCAT-JUNTS",173
8,"8242",223,159,159,0,0,"JxCAT-JUNTS",49
8,"8235",3875,3004,2996,19,8,"JxCAT-JUNTS",810
8,"8902",3941,2974,2962,16,12,"JxCAT-JUNTS",496
25,"25222",69,58,58,0,0,"JxCAT-JUNTS",26
43,"43098",362,274,274,1,0,"JxCAT-JUNTS",83
25,"25006",319,229,229,2,0,"JxCAT-JUNTS",44
43,"43176",746,564,561,2,3,"JxCAT-JUNTS",146
8,"8224",885,653,652,6,1,"JxCAT-JUNTS",148
43,"43095",2583,1864,1854,12,10,"JxCAT-JUNTS",264
43,"43069",183,148,147,2,1,"JxCAT-JUNTS",27
8,"8098",2438,1781,1778,21,3,"JxCAT-JUNTS",323
8,"8227",2420,1775,1769,11,6,"JxCAT-JUNTS",395
43,"43085",237,190,185,1,5,"JxCAT-JUNTS",45
25,"25109",211,155,154,1,1,"JxCAT-JUNTS",74
8,"8291",4972,3531,3519,23,12,"JxCAT-JUNTS",320
8,"8164",936,750,747,6,3,"JxCAT-JUNTS",169
25,"25136",95,74,74,2,0,"JxCAT-JUNTS",33
25,"25201",110,81,81,0,0,"JxCAT-JUNTS",27
17,"17185",2260,1657,1652,8,5,"JxCAT-JUNTS",562
17,"17140",635,506,505,2,1,"JxCAT-JUNTS",179
8,"8280",93,76,75,1,1,"JxCAT-JUNTS",31
17,"17901",987,733,725,5,8,"JxCAT-JUNTS",212
8,"8005",6425,4830,4816,28,14,"JxCAT-JUNTS",1105
17,"17199",6984,4919,4894,39,25,"JxCAT-JUNTS",1164
25,"25087",54,45,45,0,0,"JxCAT-JUNTS",15
8,"8051",18570,14112,14054,86,58,"JxCAT-JUNTS",1901
25,"25142",359,283,283,2,0,"JxCAT-JUNTS",84
8,"8145",2712,2060,2049,8,11,"JxCAT-JUNTS",384
17,"17064",324,249,247,2,2,"JxCAT-JUNTS",66
8,"8053",2896,1939,1929,13,10,"JxCAT-JUNTS",270
25,"25031",57,32,32,0,0,"JxCAT-JUNTS",3
8,"8299",380,301,300,4,1,"JxCAT-JUNTS",80
25,"25023",4560,3350,3334,24,16,"JxCAT-JUNTS",703
43,"43903",2332,1502,1487,18,15,"JxCAT-JUNTS",216
43,"43153",11197,7685,7649,53,36,"JxCAT-JUNTS",860
43,"43907",4386,3083,3067,24,16,"JxCAT-JUNTS",150
25,"25085",141,109,108,2,1,"JxCAT-JUNTS",37
25,"25079",276,202,202,0,0,"JxCAT-JUNTS",90
25,"25112",269,205,200,2,5,"JxCAT-JUNTS",66
43,"43046",88,69,68,1,1,"JxCAT-JUNTS",10
43,"43159",76,60,60,0,0,"JxCAT-JUNTS",30
43,"43009",1384,966,959,5,7,"JxCAT-JUNTS",187
8,"8067",5746,4299,4270,24,29,"JxCAT-JUNTS",1073
43,"43150",1233,954,941,6,13,"JxCAT-JUNTS",210
17,"17084",228,163,162,1,1,"JxCAT-JUNTS",45
25,"25228",3143,2261,2250,18,11,"JxCAT-JUNTS",561
25,"25056",209,145,145,0,0,"JxCAT-JUNTS",52
17,"17090",539,440,440,2,0,"JxCAT-JUNTS",198
43,"43168",83,55,55,1,0,"JxCAT-JUNTS",15
8,"8211",33934,26136,26000,198,136,"JxCAT-JUNTS",1840
17,"17030",654,460,459,1,1,"JxCAT-JUNTS",115
43,"43121",593,404,403,1,1,"JxCAT-JUNTS",85
43,"43068",484,322,317,2,5,"JxCAT-JUNTS",28
43,"43140",2433,1685,1674,11,11,"JxCAT-JUNTS",135
8,"8060",139,110,108,1,2,"JxCAT-JUNTS",41
25,"25203",8809,5813,5770,40,43,"JxCAT-JUNTS",1003
8,"8245",77841,53719,53443,430,276,"JxCAT-JUNTS",1358
43,"43080",230,192,192,2,0,"JxCAT-JUNTS",58
43,"43081",629,500,499,2,1,"JxCAT-JUNTS",113
8,"8137",272,208,207,2,1,"JxCAT-JUNTS",64
25,"25101",536,412,411,5,1,"JxCAT-JUNTS",144
25,"25209",1586,1115,1102,6,13,"JxCAT-JUNTS",282
25,"25156",765,571,567,3,4,"JxCAT-JUNTS",159
17,"17145",1410,1040,1032,6,8,"JxCAT-JUNTS",315
17,"17167",2585,2015,1998,11,17,"JxCAT-JUNTS",652
43,"43017",112,94,94,1,0,"JxCAT-JUNTS",26
25,"25200",318,245,245,0,0,"JxCAT-JUNTS",67
25,"25907",500,366,364,5,2,"JxCAT-JUNTS",89
43,"43151",107,88,88,0,0,"JxCAT-JUNTS",19
25,"25218",88,76,75,2,1,"JxCAT-JUNTS",24
43,"43076",454,336,335,1,1,"JxCAT-JUNTS",71
25,"25081",281,195,193,3,2,"JxCAT-JUNTS",49
8,"8084",1172,902,894,9,8,"JxCAT-JUNTS",213
17,"17015",12829,9612,9580,51,32,"JxCAT-JUNTS",3197
17,"17037",112,86,86,1,0,"JxCAT-JUNTS",40
8,"8170",442,322,320,0,2,"JxCAT-JUNTS",113
43,"43142",1069,783,774,3,9,"JxCAT-JUNTS",210
25,"25015",336,234,233,3,1,"JxCAT-JUNTS",72
25,"25232",1357,1012,1007,6,5,"JxCAT-JUNTS",298
25,"25143",82,63,62,0,1,"JxCAT-JUNTS",17
43,"43110",247,178,178,2,0,"JxCAT-JUNTS",30
8,"8262",6945,4649,4599,38,50,"JxCAT-JUNTS",622
43,"43123",71435,49166,48873,318,293,"JxCAT-JUNTS",6237
17,"17101",566,389,382,1,7,"JxCAT-JUNTS",61
43,"43067",526,426,424,3,2,"JxCAT-JUNTS",85
25,"25008",1081,803,799,4,4,"JxCAT-JUNTS",218
25,"25242",688,494,488,5,6,"JxCAT-JUNTS",149
43,"43094",2143,1558,1541,6,17,"JxCAT-JUNTS",292
25,"25179",169,132,132,0,0,"JxCAT-JUNTS",53
8,"8115",3826,2777,2770,31,7,"JxCAT-JUNTS",295
8,"8295",11290,8091,8054,72,37,"JxCAT-JUNTS",608
17,"17093",913,637,634,5,3,"JxCAT-JUNTS",157
8,"8039",413,322,321,1,1,"JxCAT-JUNTS",71
17,"17029",207,154,154,1,0,"JxCAT-JUNTS",30
8,"8215",2617,1954,1946,22,8,"JxCAT-JUNTS",601
8,"8108",5181,3880,3861,30,19,"JxCAT-JUNTS",424
43,"43162",4436,3191,3163,24,28,"JxCAT-JUNTS",437
43,"43005",3677,2505,2493,17,12,"JxCAT-JUNTS",446
17,"17032",1745,1139,1133,6,6,"JxCAT-JUNTS",302
17,"17174",164,130,130,4,0,"JxCAT-JUNTS",51
25,"25096",885,597,591,2,6,"JxCAT-JUNTS",173
8,"8206",744,604,599,5,5,"JxCAT-JUNTS",141
8,"8068",6863,5064,5041,40,23,"JxCAT-JUNTS",487
17,"17129",143,108,108,2,0,"JxCAT-JUNTS",21
25,"25133",671,481,479,1,2,"JxCAT-JUNTS",174
17,"17114",23268,16423,16333,111,90,"JxCAT-JUNTS",4887
17,"17116",351,261,261,2,0,"JxCAT-JUNTS",90
17,"17099",78,55,55,0,0,"JxCAT-JUNTS",20
17,"17184",1261,1016,1010,7,6,"JxCAT-JUNTS",351
8,"8119",6897,5096,5052,31,44,"JxCAT-JUNTS",407
43,"43099",284,214,214,4,0,"JxCAT-JUNTS",79
8,"8092",3713,2758,2745,9,13,"JxCAT-JUNTS",766
8,"8019",1122912,824423,821037,5287,3386,"JxCAT-JUNTS",101634
25,"25099",1285,908,904,6,4,"JxCAT-JUNTS",313
25,"25100",184,137,136,1,1,"JxCAT-JUNTS",41
43,"43014",14386,9542,9464,74,78,"JxCAT-JUNTS",1138
8,"8189",119,96,96,1,0,"JxCAT-JUNTS",44
25,"25010",194,138,136,0,2,"JxCAT-JUNTS",36
8,"8047",3751,2600,2578,26,22,"JxCAT-JUNTS",430
8,"8081",349,274,270,0,4,"JxCAT-JUNTS",109
25,"25120",92888,62740,62389,450,351,"JxCAT-JUNTS",9605
43,"43025",591,448,443,4,5,"JxCAT-JUNTS",34
8,"8172",20543,15191,15140,85,51,"JxCAT-JUNTS",1870
17,"17083",2971,2164,2154,13,10,"JxCAT-JUNTS",415
25,"25111",114,86,86,2,0,"JxCAT-JUNTS",48
8,"8196",19542,14264,14185,123,79,"JxCAT-JUNTS",499
17,"17067",704,551,549,6,2,"JxCAT-JUNTS",200
17,"17213",5567,3654,3630,19,24,"JxCAT-JUNTS",937
8,"8110",13671,9362,9311,60,51,"JxCAT-JUNTS",1145
8,"8198",4679,3491,3469,12,22,"JxCAT-JUNTS",656
17,"17160",14756,9892,9852,58,40,"JxCAT-JUNTS",1975
25,"25063",84,52,51,0,1,"JxCAT-JUNTS",7
25,"25127",217,145,145,1,0,"JxCAT-JUNTS",41
8,"8007",6795,5099,5081,29,18,"JxCAT-JUNTS",1161
43,"43174",144,118,114,0,4,"JxCAT-JUNTS",23
25,"25119",2258,1701,1686,11,15,"JxCAT-JUNTS",502
17,"17034",7289,4880,4862,23,18,"JxCAT-JUNTS",1097
25,"25220",991,768,762,1,6,"JxCAT-JUNTS",324
8,"8240",9469,7351,7327,39,24,"JxCAT-JUNTS",1275
8,"8001",9097,6860,6818,39,42,"JxCAT-JUNTS",326
8,"8111",216,195,194,2,1,"JxCAT-JUNTS",92
17,"17123",343,286,284,2,2,"JxCAT-JUNTS",136
17,"17162",153,106,105,1,1,"JxCAT-JUNTS",38
8,"8221",12793,10123,10079,73,44,"JxCAT-JUNTS",1665
43,"43112",245,179,179,3,0,"JxCAT-JUNTS",40
8,"8205",61957,49325,49196,441,129,"JxCAT-JUNTS",9585
8,"8200",62225,45235,44991,306,244,"JxCAT-JUNTS",2032
8,"8201",455,319,318,12,1,"JxCAT-JUNTS",98
25,"25191",321,227,222,2,5,"JxCAT-JUNTS",75
17,"17094",1058,757,747,3,10,"JxCAT-JUNTS",191
43,"43138",2636,1761,1745,11,16,"JxCAT-JUNTS",248
8,"8044",4156,2991,2976,16,15,"JxCAT-JUNTS",388
8,"8260",18515,13563,13487,84,76,"JxCAT-JUNTS",829
43,"43155",22586,15295,15204,120,91,"JxCAT-JUNTS",2628
25,"25197",140,109,109,0,0,"JxCAT-JUNTS",28
25,"25038",1478,1057,1048,10,9,"JxCAT-JUNTS",314
8,"8263",21208,15014,14890,111,124,"JxCAT-JUNTS",573
8,"8303",257,207,205,1,2,"JxCAT-JUNTS",51
8,"8126",8906,6673,6646,41,27,"JxCAT-JUNTS",674
43,"43101",146,112,112,2,0,"JxCAT-JUNTS",44
8,"8306",535,368,368,5,0,"JxCAT-JUNTS",40
25,"25088",96,73,73,0,0,"JxCAT-JUNTS",43
25,"25001",143,102,102,1,0,"JxCAT-JUNTS",24
8,"8129",486,399,398,0,1,"JxCAT-JUNTS",123
25,"25223",890,673,666,7,7,"JxCAT-JUNTS",207
25,"25163",230,162,161,0,1,"JxCAT-JUNTS",59
8,"8213",6600,4925,4906,30,19,"JxCAT-JUNTS",1032
25,"25240",1366,1030,1021,4,9,"JxCAT-JUNTS",268
25,"25122",1929,1408,1398,21,10,"JxCAT-JUNTS",396
17,"17065",321,264,263,3,1,"JxCAT-JUNTS",100
8,"8182",2922,2041,2031,10,10,"JxCAT-JUNTS",155
43,"43011",1086,862,860,5,2,"JxCAT-JUNTS",216
17,"17168",373,309,308,3,1,"JxCAT-JUNTS",101
17,"17226",884,603,600,4,3,"JxCAT-JUNTS",76
17,"17221",4138,2999,2988,23,11,"JxCAT-JUNTS",505
17,"17077",565,395,394,2,1,"JxCAT-JUNTS",115
8,"8133",123,96,94,5,2,"JxCAT-JUNTS",39
8,"8122",1733,1179,1175,4,4,"JxCAT-JUNTS",158
17,"17204",609,429,428,6,1,"JxCAT-JUNTS",114
8,"8004",208,177,177,1,0,"JxCAT-JUNTS",72
17,"17006",1178,826,818,9,8,"JxCAT-JUNTS",217
17,"17063",179,153,149,0,4,"JxCAT-JUNTS",48
8,"8143",2727,1989,1977,19,12,"JxCAT-JUNTS",286
17,"17175",559,348,343,5,5,"JxCAT-JUNTS",32
17,"17031",178,117,117,0,0,"JxCAT-JUNTS",30
8,"8020",5243,4117,4100,29,17,"JxCAT-JUNTS",692
25,"25036",180,124,124,1,0,"JxCAT-JUNTS",23
17,"17078",335,245,245,0,0,"JxCAT-JUNTS",94
43,"43165",571,469,467,2,2,"JxCAT-JUNTS",144
25,"25248",870,676,675,5,1,"JxCAT-JUNTS",249
8,"8131",745,552,550,3,2,"JxCAT-JUNTS",169
8,"8271",66,48,47,2,1,"JxCAT-JUNTS",10
17,"17188",171,134,134,1,0,"JxCAT-JUNTS",42
43,"43019",1332,911,904,8,7,"JxCAT-JUNTS",136
17,"17170",173,140,140,2,0,"JxCAT-JUNTS",42
8,"8144",722,551,545,3,6,"JxCAT-JUNTS",132
43,"43042",2215,1723,1710,18,13,"JxCAT-JUNTS",351
8,"8050",139,118,115,4,3,"JxCAT-JUNTS",53
43,"43077",453,306,304,1,2,"JxCAT-JUNTS",16
8,"8095",66,49,49,0,0,"JxCAT-JUNTS",16
17,"17227",147,104,104,0,0,"JxCAT-JUNTS",21
8,"8258",815,636,632,5,4,"JxCAT-JUNTS",170
17,"17130",325,270,270,1,0,"JxCAT-JUNTS",111
8,"8124",37157,27139,26994,179,145,"JxCAT-JUNTS",1742
17,"17119",71,53,52,3,1,"JxCAT-JUNTS",8
43,"43010",334,262,262,2,0,"JxCAT-JUNTS",69
43,"43066",158,108,108,1,0,"JxCAT-JUNTS",22
17,"17016",737,570,563,2,7,"JxCAT-JUNTS",161
8,"8082",1164,796,780,5,16,"JxCAT-JUNTS",99
43,"43044",3962,2751,2719,33,32,"JxCAT-JUNTS",231
25,"25029",1590,1190,1185,4,5,"JxCAT-JUNTS",340
8,"8252",24885,18507,18383,162,124,"JxCAT-JUNTS",614
8,"8183",4573,3406,3398,14,8,"JxCAT-JUNTS",983
17,"17154",101,76,76,0,0,"JxCAT-JUNTS",15
43,"43043",3317,2457,2445,12,12,"JxCAT-JUNTS",290
8,"8247",982,799,798,4,1,"JxCAT-JUNTS",269
25,"25155",616,446,443,2,3,"JxCAT-JUNTS",136
17,"17047",5016,3087,3068,22,19,"JxCAT-JUNTS",544
8,"8180",27198,19822,19704,160,118,"JxCAT-JUNTS",841
8,"8157",8574,6514,6472,47,42,"JxCAT-JUNTS",520
8,"8147",17389,12679,12601,102,78,"JxCAT-JUNTS",1276
8,"8204",3141,2395,2383,16,12,"JxCAT-JUNTS",300
25,"25152",148,106,106,0,0,"JxCAT-JUNTS",36
8,"8118",17634,13450,13402,80,48,"JxCAT-JUNTS",2179
17,"17230",504,383,382,3,1,"JxCAT-JUNTS",89
8,"8161",11826,8001,7951,58,50,"JxCAT-JUNTS",736
17,"17048",6284,4077,4048,34,29,"JxCAT-JUNTS",911
17,"17203",165,126,126,0,0,"JxCAT-JUNTS",42
25,"25077",435,312,312,1,0,"JxCAT-JUNTS",81
17,"17003",103,85,85,0,0,"JxCAT-JUNTS",32
17,"17010",332,252,251,2,1,"JxCAT-JUNTS",98
17,"17189",1481,1228,1223,5,5,"JxCAT-JUNTS",575
43,"43003",349,257,255,3,2,"JxCAT-JUNTS",40
25,"25009",596,448,442,1,6,"JxCAT-JUNTS",117
43,"43147",528,425,420,3,5,"JxCAT-JUNTS",131
8,"8194",25680,16465,16376,131,89,"JxCAT-JUNTS",666
8,"8006",11774,8375,8329,53,46,"JxCAT-JUNTS",1739
25,"25025",1362,909,898,15,11,"JxCAT-JUNTS",91
25,"25189",2181,1468,1461,11,7,"JxCAT-JUNTS",338
17,"17126",316,269,269,1,0,"JxCAT-JUNTS",103
8,"8264",4608,3459,3444,30,15,"JxCAT-JUNTS",795
17,"17013",2765,1999,1985,15,14,"JxCAT-JUNTS",379
43,"43113",387,305,303,1,2,"JxCAT-JUNTS",79
43,"43058",95,78,78,0,0,"JxCAT-JUNTS",18
17,"17161",1023,844,843,5,1,"JxCAT-JUNTS",294
43,"43057",38,32,32,1,0,"JxCAT-JUNTS",13
17,"17166",547,442,440,0,2,"JxCAT-JUNTS",160
25,"25249",176,129,127,2,2,"JxCAT-JUNTS",32
43,"43130",169,131,130,2,1,"JxCAT-JUNTS",34
43,"43096",97,76,76,0,0,"JxCAT-JUNTS",21
8,"8016",1803,1371,1363,11,8,"JxCAT-JUNTS",290
43,"43106",784,605,598,3,7,"JxCAT-JUNTS",101
8,"8265",1597,1262,1260,4,2,"JxCAT-JUNTS",402
25,"25051",1522,1066,1059,6,7,"JxCAT-JUNTS",262
25,"25151",731,555,549,1,6,"JxCAT-JUNTS",202
17,"17024",281,203,201,4,2,"JxCAT-JUNTS",55
43,"43144",1245,975,966,1,9,"JxCAT-JUNTS",156
8,"8197",7986,5829,5805,37,24,"JxCAT-JUNTS",1097
25,"25123",189,135,133,0,2,"JxCAT-JUNTS",38
8,"8296",1869,1412,1408,10,4,"JxCAT-JUNTS",277
8,"8043",3414,2429,2422,15,7,"JxCAT-JUNTS",263
17,"17075",340,257,256,2,1,"JxCAT-JUNTS",58
8,"8229",521,418,417,3,1,"JxCAT-JUNTS",144
43,"43129",4607,3284,3261,21,23,"JxCAT-JUNTS",853
43,"43904",2864,1881,1851,20,30,"JxCAT-JUNTS",269
17,"17132",1344,1019,1009,12,10,"JxCAT-JUNTS",315
8,"8073",62934,45699,45407,281,292,"JxCAT-JUNTS",1473
17,"17060",409,300,298,1,2,"JxCAT-JUNTS",69
43,"43104",1767,1285,1271,4,14,"JxCAT-JUNTS",257
8,"8149",980,702,694,6,8,"JxCAT-JUNTS",233
8,"8212",491,393,386,6,7,"JxCAT-JUNTS",157
43,"43007",631,479,474,1,5,"JxCAT-JUNTS",104
8,"8035",13006,8957,8918,50,39,"JxCAT-JUNTS",1620
8,"8096",43926,32120,31960,217,160,"JxCAT-JUNTS",4320
25,"25059",800,546,534,5,12,"JxCAT-JUNTS",31
8,"8088",12347,9316,9270,75,46,"JxCAT-JUNTS",1894
17,"17120",823,560,558,5,2,"JxCAT-JUNTS",154
17,"17205",209,167,166,0,1,"JxCAT-JUNTS",66
25,"25118",326,223,218,0,5,"JxCAT-JUNTS",71
25,"25140",779,540,539,2,1,"JxCAT-JUNTS",131
25,"25186",207,162,161,0,1,"JxCAT-JUNTS",63
43,"43139",2007,1432,1419,9,13,"JxCAT-JUNTS",424
43,"43051",9194,6133,6048,44,85,"JxCAT-JUNTS",328
43,"43034",465,365,365,5,0,"JxCAT-JUNTS",80
25,"25053",1100,819,811,7,8,"JxCAT-JUNTS",216
17,"17202",3848,2632,2615,16,17,"JxCAT-JUNTS",555
43,"43052",927,680,674,7,6,"JxCAT-JUNTS",115
8,"8003",7213,5425,5409,41,16,"JxCAT-JUNTS",1063
50,"50061",190,157,155,2,2,"MAS",0
50,"50180",107,85,85,1,0,"MAS",0
50,"50044",224,159,159,2,0,"MAS",0
50,"50100",304,215,212,1,3,"MAS",0
50,"50254",179,115,113,0,2,"MAS",0
50,"50268",41,32,32,1,0,"MAS",0
50,"50129",212,129,127,0,2,"MAS",0
50,"50262",1161,849,832,11,17,"MAS",0
50,"50210",37,26,26,0,0,"MAS",0
50,"50177",288,196,193,0,3,"MAS",0
50,"50284",129,98,98,0,0,"MAS",1
50,"50281",68,52,50,0,2,"MAS",0
50,"50290",360,260,255,5,5,"MAS",0
50,"50101",833,557,550,5,7,"MAS",4
50,"50130",354,225,222,1,3,"MAS",0
50,"50017",1773,1283,1265,13,18,"MAS",2
50,"50147",744,508,506,5,2,"MAS",0
50,"50131",212,152,147,4,5,"MAS",0
50,"50093",87,66,64,1,2,"MAS",0
50,"50174",80,58,57,0,1,"MAS",0
50,"50170",357,245,242,6,3,"MAS",0
50,"50172",174,125,123,2,2,"MAS",0
50,"50294",65,45,45,0,0,"MAS",0
50,"50238",84,65,65,0,0,"MAS",0
50,"50253",379,294,290,1,4,"MAS",0
50,"50126",2240,1528,1509,24,19,"MAS",2
50,"50119",876,633,625,11,8,"MAS",0
50,"50076",70,56,56,0,0,"MAS",0
50,"50286",75,54,53,0,1,"MAS",0
50,"50155",95,65,65,0,0,"MAS",0
50,"50033",61,44,44,1,0,"MAS",0
50,"50106",123,78,78,0,0,"MAS",1
50,"50146",189,149,149,3,0,"MAS",0
50,"50111",181,130,130,1,0,"MAS",0
50,"50198",47,32,32,0,0,"MAS",1
50,"50205",72,51,49,0,2,"MAS",0
50,"50099",3036,2137,2113,17,24,"MAS",1
50,"50248",501,344,328,3,16,"MAS",1
50,"50035",74,57,57,0,0,"MAS",0
50,"50196",101,73,73,0,0,"MAS",0
50,"50231",253,199,195,4,4,"MAS",0
50,"50185",140,93,92,1,1,"MAS",0
50,"50258",53,25,25,1,0,"MAS",0
50,"50064",439,348,346,1,2,"MAS",1
50,"50058",63,45,43,0,2,"MAS",0
50,"50243",307,227,224,2,3,"MAS",1
50,"50132",780,549,538,7,11,"MAS",3
50,"50227",107,62,62,1,0,"MAS",0
50,"50125",340,230,229,2,1,"MAS",1
50,"50098",162,119,118,1,1,"MAS",0
50,"50050",87,62,62,1,0,"MAS",0
50,"50228",249,207,207,3,0,"MAS",0
50,"50002",125,91,86,0,5,"MAS",0
50,"50221",29,18,18,0,0,"MAS",0
50,"50043",241,155,154,1,1,"MAS",0
50,"50005",228,185,184,2,1,"MAS",0
50,"50040",82,66,66,1,0,"MAS",0
50,"50135",85,59,59,0,0,"MAS",0
50,"50142",23,16,16,1,0,"MAS",0
50,"50193",664,487,475,4,12,"MAS",1
50,"50116",169,124,123,0,1,"MAS",0
50,"50090",134,96,96,0,0,"MAS",0
50,"50183",316,227,223,1,4,"MAS",0
50,"50023",199,145,143,2,2,"MAS",0
50,"50285",657,448,442,4,6,"MAS",1
50,"50267",565,380,375,4,5,"MAS",0
50,"50190",669,532,518,10,14,"MAS",2
50,"50257",159,128,125,2,3,"MAS",1
50,"50298",5439,4053,4007,41,46,"MAS",3
50,"50195",53,42,38,0,4,"MAS",0
50,"50089",8616,6420,6364,50,56,"MAS",7
50,"50016",44,31,31,0,0,"MAS",0
50,"50018",883,622,616,5,6,"MAS",0
50,"50052",81,61,61,0,0,"MAS",0
50,"50051",802,551,550,2,1,"MAS",0
50,"50019",63,46,46,0,0,"MAS",0
50,"50184",87,70,70,0,0,"MAS",0
50,"50120",55,42,42,1,0,"MAS",1
50,"50260",35,31,31,0,0,"MAS",0
50,"50085",182,121,121,0,0,"MAS",0
50,"50218",112,88,88,1,0,"MAS",0
50,"50041",16,10,10,0,0,"MAS",0
50,"50153",914,683,675,9,8,"MAS",0
50,"50219",4283,3034,2990,30,44,"MAS",8
50,"50297",503800,365284,362768,3385,2516,"MAS",760
50,"50139",318,237,237,1,0,"MAS",0
50,"50086",176,106,102,1,4,"MAS",0
50,"50211",236,174,173,0,1,"MAS",0
50,"50095",12149,8322,8239,91,83,"MAS",9
50,"50288",3440,2513,2486,26,27,"MAS",2
50,"50215",20,14,14,0,0,"MAS",0
50,"50031",134,78,75,0,3,"MAS",0
50,"50028",78,53,53,0,0,"MAS",0
50,"50027",223,166,161,2,5,"MAS",1
50,"50204",2396,1723,1712,17,11,"MAS",1
50,"50171",99,69,69,2,0,"MAS",0
50,"50152",1351,942,932,14,10,"MAS",0
50,"50011",117,90,89,3,1,"MAS",0
50,"50055",3635,2298,2244,36,54,"MAS",3
50,"50006",913,670,654,13,16,"MAS",1
50,"50082",82,57,57,0,0,"MAS",0
50,"50264",151,111,110,0,1,"MAS",1
50,"50094",1500,1041,1022,12,19,"MAS",4
50,"50047",38,24,24,0,0,"MAS",0
50,"50150",624,387,384,2,3,"MAS",0
50,"50289",53,42,42,1,0,"MAS",1
50,"50201",449,345,344,4,1,"MAS",0
50,"50036",100,76,76,1,0,"MAS",0
50,"50162",135,100,99,3,1,"MAS",0
50,"50252",5019,3486,3456,53,30,"MAS",1
50,"50156",212,156,151,2,5,"MAS",0
50,"50216",236,169,167,0,2,"MAS",1
50,"50124",394,269,266,0,3,"MAS",1
50,"50149",34,25,25,0,0,"MAS",0
50,"50109",95,65,62,2,3,"MAS",2
50,"50092",290,218,214,0,4,"MAS",0
50,"50188",26,23,23,0,0,"MAS",0
50,"50128",26,23,23,0,0,"MAS",0
50,"50012",94,76,72,0,4,"MAS",0
50,"50010",67,52,52,1,0,"MAS",0
50,"50065",56,37,37,0,0,"MAS",0
50,"50192",227,182,181,0,1,"MAS",0
50,"50269",287,172,167,2,5,"MAS",0
50,"50084",67,47,47,1,0,"MAS",0
50,"50057",1331,933,922,10,11,"MAS",15
50,"50209",2785,1893,1865,24,28,"MAS",7
50,"50225",1532,983,971,12,12,"MAS",1
50,"50161",98,75,74,2,1,"MAS",0
50,"50046",162,125,125,6,0,"MAS",0
50,"50144",31,24,24,0,0,"MAS",0
50,"50108",50,37,37,0,0,"MAS",0
50,"50021",25,21,21,0,0,"MAS",0
50,"50169",333,231,230,0,1,"MAS",0
50,"50245",74,51,51,0,0,"MAS",0
50,"50102",815,594,584,7,10,"MAS",0
50,"50077",201,140,140,1,0,"MAS",0
50,"50275",111,50,50,0,0,"MAS",0
50,"50030",197,124,124,1,0,"MAS",0
50,"50073",2122,1559,1540,14,19,"MAS",1
50,"50230",1140,771,767,11,4,"MAS",1
50,"50066",2903,2095,2078,19,17,"MAS",1
50,"50138",45,37,37,3,0,"MAS",0
50,"50118",2101,1484,1477,17,7,"MAS",1
50,"50292",130,108,107,0,1,"MAS",0
50,"50020",795,548,545,4,3,"MAS",2
50,"50224",61,44,44,2,0,"MAS",0
50,"50053",643,476,466,3,10,"MAS",0
50,"50197",95,69,68,2,1,"MAS",0
50,"50186",37,26,26,1,0,"MAS",0
50,"50001",89,68,68,0,0,"MAS",0
50,"50042",19,17,17,1,0,"MAS",0
50,"50194",80,51,51,0,0,"MAS",0
50,"50279",74,49,49,0,0,"MAS",0
50,"50902",77,65,62,0,3,"MAS",0
50,"50015",81,57,56,0,1,"MAS",0
50,"50236",95,77,75,0,2,"MAS",0
50,"50081",487,355,349,5,6,"MAS",0
50,"50151",607,450,449,12,1,"MAS",0
50,"50293",392,257,255,2,2,"MAS",0
50,"50110",340,248,238,1,10,"MAS",0
50,"50182",3657,2499,2485,23,14,"MAS",8
50,"50222",1574,1024,1008,12,16,"MAS",2
50,"50261",201,154,151,0,3,"MAS",0
50,"50114",132,108,108,0,0,"MAS",0
50,"50187",55,42,42,0,0,"MAS",0
50,"50203",1065,817,804,5,13,"MAS",2
50,"50214",18,18,14,1,4,"MAS",0
50,"50160",2140,1421,1394,14,27,"MAS",3
50,"50256",70,43,43,0,0,"MAS",0
50,"50143",541,373,367,2,6,"MAS",1
50,"50123",430,304,297,3,7,"MAS",1
50,"50251",8209,5732,5658,66,74,"MAS",27
50,"50283",69,46,46,0,0,"MAS",0
50,"50259",82,55,55,2,0,"MAS",0
50,"50137",958,740,731,8,9,"MAS",3
50,"50223",906,702,693,9,9,"MAS",0
50,"50235",2421,1721,1702,18,19,"MAS",2
50,"50167",208,166,163,1,3,"MAS",0
50,"50200",479,389,383,5,6,"MAS",0
50,"50249",283,202,200,0,2,"MAS",0
50,"50069",66,33,33,1,0,"MAS",0
50,"50270",38,26,25,0,1,"MAS",1
50,"50265",74,54,54,1,0,"MAS",0
50,"50191",446,327,326,1,1,"MAS",0
50,"50022",504,373,369,12,4,"MAS",3
50,"50189",678,494,487,6,7,"MAS",0
50,"50213",92,70,70,2,0,"MAS",1
50,"50113",587,471,461,2,10,"MAS",0
50,"50271",246,179,173,4,6,"MAS",0
50,"50266",120,77,76,3,1,"MAS",0
50,"50168",29,20,20,0,0,"MAS",0
50,"50122",68,43,42,1,1,"MAS",0
50,"50277",45,34,34,0,0,"MAS",0
50,"50263",171,110,108,1,2,"MAS",0
50,"50166",235,186,186,0,0,"MAS",0
50,"50062",1885,1332,1308,15,24,"MAS",1
50,"50173",156,114,114,0,0,"MAS",0
50,"50148",304,213,211,2,2,"MAS",0
50,"50134",120,85,82,4,3,"MAS",0
50,"50070",50,30,29,0,1,"MAS",0
50,"50037",125,85,80,0,5,"MAS",0
50,"50903",2268,1685,1670,16,15,"MAS",7
50,"50105",277,203,198,4,5,"MAS",1
50,"50079",226,162,160,1,2,"MAS",1
50,"50176",220,142,142,3,0,"MAS",1
50,"50157",289,199,196,1,3,"MAS",0
50,"50217",426,333,333,1,0,"MAS",0
50,"50175",907,638,632,11,6,"MAS",4
50,"50074",6156,4100,4022,33,78,"MAS",8
50,"50232",160,93,92,1,1,"MAS",1
50,"50003",117,89,89,1,0,"MAS",0
50,"50220",45,38,38,0,0,"MAS",0
50,"50233",96,78,78,0,0,"MAS",2
50,"50212",32,26,26,0,0,"MAS",0
50,"50107",988,758,755,8,3,"MAS",0
50,"50059",757,556,551,5,5,"MAS",12
50,"50202",124,76,74,0,2,"MAS",0
50,"50048",33,25,25,0,0,"MAS",0
50,"50007",51,34,34,1,0,"MAS",0
50,"50181",999,748,732,3,16,"MAS",1
50,"50096",34,22,22,0,0,"MAS",0
50,"50025",4541,3110,3083,39,27,"MAS",4
50,"50901",133,96,96,0,0,"MAS",1
50,"50295",48,41,41,0,0,"MAS",0
50,"50078",227,168,166,0,2,"MAS",0
50,"50273",33,24,24,1,0,"MAS",0
50,"50280",290,220,216,1,4,"MAS",1
50,"50246",37,24,24,0,0,"MAS",0
50,"50075",70,55,55,1,0,"MAS",0
50,"50038",1404,1024,1007,15,17,"MAS",7
50,"50242",99,74,74,0,0,"MAS",2
50,"50240",943,693,683,12,10,"MAS",2
50,"50063",64,49,49,0,0,"MAS",0
50,"50008",5187,3334,3288,37,46,"MAS",6
50,"50039",462,339,333,1,6,"MAS",2
50,"50136",532,366,361,3,5,"MAS",0
50,"50208",1761,1267,1250,16,17,"MAS",0
50,"50029",594,432,431,3,1,"MAS",1
50,"50239",63,46,45,1,1,"MAS",0
50,"50104",320,251,251,1,0,"MAS",0
50,"50067",13928,9831,9699,92,132,"MAS",12
50,"50274",64,46,43,1,3,"MAS",0
50,"50004",475,360,356,2,4,"MAS",0
50,"50247",852,600,594,8,6,"MAS",1
50,"50179",255,197,197,0,0,"MAS",0
50,"50056",399,296,296,3,0,"MAS",0
50,"50278",175,133,131,2,2,"MAS",0
50,"50071",126,84,84,0,0,"MAS",0
50,"50117",123,93,93,4,0,"MAS",1
50,"50272",13226,9250,9153,97,97,"MAS",31
50,"50159",640,493,486,3,7,"MAS",0
50,"50088",274,195,191,2,4,"MAS",6
50,"50244",192,131,130,1,1,"MAS",0
50,"50087",28,19,19,0,0,"MAS",0
50,"50255",199,152,147,3,5,"MAS",0
50,"50083",81,64,64,2,0,"MAS",0
50,"50234",242,159,154,4,5,"MAS",1
50,"50141",104,80,78,0,2,"MAS",0
50,"50250",54,44,44,2,0,"MAS",0
50,"50054",55,37,37,2,0,"MAS",0
50,"50009",97,61,61,1,0,"MAS",0
50,"50115",3279,2170,2131,27,39,"MAS",4
50,"50241",582,414,406,2,8,"MAS",1
50,"50091",39,32,32,0,0,"MAS",0
50,"50068",1943,1299,1287,10,12,"MAS",1
50,"50276",118,91,91,0,0,"MAS",0
50,"50229",65,46,46,1,0,"MAS",0
50,"50121",270,209,208,3,1,"MAS",1
50,"50032",243,167,164,3,3,"MAS",0
50,"50296",385,240,235,3,5,"MAS",1
50,"50199",318,206,201,1,5,"MAS",4
50,"50133",98,76,76,0,0,"MAS",0
50,"50291",95,76,76,0,0,"MAS",0
50,"50164",381,245,243,3,2,"MAS",1
50,"50140",153,96,95,1,1,"MAS",0
50,"50072",183,131,129,0,2,"MAS",0
50,"50154",114,92,92,1,0,"MAS",0
50,"50178",269,165,163,6,2,"MAS",0
50,"50045",1217,891,878,10,13,"MAS",1
50,"50282",55,38,38,1,0,"MAS",0
50,"50024",543,400,397,3,3,"MAS",0
50,"50080",34,27,27,0,0,"MAS",0
50,"50013",199,158,158,0,0,"MAS",0
50,"50014",119,81,81,0,0,"MAS",0
50,"50026",418,292,288,4,4,"MAS",1
50,"50207",87,58,58,1,0,"MAS",0
50,"50287",253,189,188,11,1,"MAS",0
50,"50206",457,349,345,5,4,"MAS",0
50,"50237",100,75,75,2,0,"MAS",1
50,"50165",1768,1255,1222,20,33,"MAS",3
50,"50060",171,126,125,1,1,"MAS",0
50,"50163",3846,2863,2840,25,23,"MAS",13
50,"50034",767,516,511,10,5,"MAS",0
8,"8290",1549,1254,1248,6,6,"MÁS PAÍS",11
8,"8178",444,363,361,2,2,"MÁS PAÍS",0
8,"8136",11692,8527,8456,98,71,"MÁS PAÍS",154
8,"8308",139,109,109,1,0,"MÁS PAÍS",1
8,"8063",469,390,390,4,0,"MÁS PAÍS",2
8,"8285",10349,7630,7599,48,31,"MÁS PAÍS",40
8,"8017",2808,2033,2016,16,17,"MÁS PAÍS",13
8,"8239",467,362,361,3,1,"MÁS PAÍS",5
8,"8129",486,399,398,0,1,"MÁS PAÍS",1
8,"8022",12213,8594,8558,42,36,"MÁS PAÍS",40
8,"8229",521,418,417,3,1,"MÁS PAÍS",2
8,"8262",6945,4649,4599,38,50,"MÁS PAÍS",43
8,"8185",197,162,162,1,0,"MÁS PAÍS",2
8,"8019",1122912,824423,821037,5287,3386,"MÁS PAÍS",12860
8,"8283",6165,4546,4524,33,22,"MÁS PAÍS",20
8,"8052",140,102,102,1,0,"MÁS PAÍS",0
8,"8259",6979,5362,5341,27,21,"MÁS PAÍS",46
8,"8106",7500,5442,5410,43,32,"MÁS PAÍS",57
8,"8029",3586,2868,2862,20,6,"MÁS PAÍS",29
8,"8194",25680,16465,16376,131,89,"MÁS PAÍS",279
8,"8073",62934,45699,45407,281,292,"MÁS PAÍS",865
8,"8096",43926,32120,31960,217,160,"MÁS PAÍS",421
8,"8014",2013,1526,1521,4,5,"MÁS PAÍS",8
8,"8113",52589,36864,36690,244,174,"MÁS PAÍS",230
8,"8159",14343,10656,10603,87,53,"MÁS PAÍS",151
8,"8009",9531,7200,7171,47,29,"MÁS PAÍS",58
8,"8098",2438,1781,1778,21,3,"MÁS PAÍS",11
8,"8024",357,282,282,2,0,"MÁS PAÍS",0
8,"8044",4156,2991,2976,16,15,"MÁS PAÍS",29
8,"8214",7007,5390,5371,25,19,"MÁS PAÍS",40
8,"8252",24885,18507,18383,162,124,"MÁS PAÍS",389
8,"8143",2727,1989,1977,19,12,"MÁS PAÍS",21
8,"8272",164,128,128,1,0,"MÁS PAÍS",0
8,"8086",14137,9971,9912,77,59,"MÁS PAÍS",134
8,"8057",61,47,47,1,0,"MÁS PAÍS",0
8,"8302",9359,6483,6430,78,53,"MÁS PAÍS",101
8,"8206",744,604,599,5,5,"MÁS PAÍS",2
8,"8090",142,116,116,0,0,"MÁS PAÍS",0
8,"8128",579,428,423,4,5,"MÁS PAÍS",1
8,"8146",1384,1030,1027,8,3,"MÁS PAÍS",15
8,"8305",27661,20346,20221,118,125,"MÁS PAÍS",172
8,"8137",272,208,207,2,1,"MÁS PAÍS",1
8,"8135",6770,5187,5158,42,29,"MÁS PAÍS",77
8,"8156",11254,8440,8411,58,29,"MÁS PAÍS",101
8,"8091",5428,4048,4024,20,24,"MÁS PAÍS",37
8,"8297",138,99,99,0,0,"MÁS PAÍS",0
8,"8085",986,769,767,6,2,"MÁS PAÍS",3
8,"8040",11116,7923,7891,49,32,"MÁS PAÍS",110
8,"8059",340,255,250,1,5,"MÁS PAÍS",1
8,"8905",2329,1872,1863,7,9,"MÁS PAÍS",31
8,"8221",12793,10123,10079,73,44,"MÁS PAÍS",117
8,"8125",25583,18334,18225,122,109,"MÁS PAÍS",297
8,"8196",19542,14264,14185,123,79,"MÁS PAÍS",229
8,"8103",652,476,474,1,2,"MÁS PAÍS",5
8,"8055",542,426,424,3,2,"MÁS PAÍS",4
8,"8175",3369,2388,2372,18,16,"MÁS PAÍS",10
8,"8263",21208,15014,14890,111,124,"MÁS PAÍS",194
8,"8105",9741,6946,6896,62,50,"MÁS PAÍS",125
8,"8095",66,49,49,0,0,"MÁS PAÍS",0
8,"8060",139,110,108,1,2,"MÁS PAÍS",1
8,"8244",6099,4733,4706,39,27,"MÁS PAÍS",92
8,"8183",4573,3406,3398,14,8,"MÁS PAÍS",18
8,"8151",450,351,346,5,5,"MÁS PAÍS",0
8,"8152",117,94,94,0,0,"MÁS PAÍS",0
8,"8166",964,700,697,7,3,"MÁS PAÍS",2
8,"8236",1564,1145,1133,4,12,"MÁS PAÍS",5
8,"8247",982,799,798,4,1,"MÁS PAÍS",3
8,"8067",5746,4299,4270,24,29,"MÁS PAÍS",24
8,"8210",4640,3226,3200,24,26,"MÁS PAÍS",30
8,"8025",1573,1170,1160,9,10,"MÁS PAÍS",16
8,"8101",175048,121359,120620,830,739,"MÁS PAÍS",1955
8,"8182",2922,2041,2031,10,10,"MÁS PAÍS",16
8,"8270",19014,13635,13594,74,41,"MÁS PAÍS",187
8,"8249",274,238,237,0,1,"MÁS PAÍS",1
8,"8237",1644,1263,1254,9,9,"MÁS PAÍS",7
8,"8080",40,27,27,3,0,"MÁS PAÍS",0
8,"8282",6731,5333,5317,40,16,"MÁS PAÍS",54
8,"8037",1947,1547,1543,11,4,"MÁS PAÍS",5
8,"8133",123,96,94,5,2,"MÁS PAÍS",2
8,"8267",6789,4975,4935,41,40,"MÁS PAÍS",61
8,"8275",247,218,218,3,0,"MÁS PAÍS",0
8,"8243",154,125,125,2,0,"MÁS PAÍS",0
8,"8139",172,148,147,2,1,"MÁS PAÍS",2
8,"8047",3751,2600,2578,26,22,"MÁS PAÍS",14
8,"8141",4578,3369,3357,28,12,"MÁS PAÍS",17
8,"8032",2100,1472,1465,12,7,"MÁS PAÍS",17
8,"8131",745,552,550,3,2,"MÁS PAÍS",3
8,"8078",216,154,154,2,0,"MÁS PAÍS",0
8,"8108",5181,3880,3861,30,19,"MÁS PAÍS",47
8,"8016",1803,1371,1363,11,8,"MÁS PAÍS",3
8,"8075",4144,2951,2943,20,8,"MÁS PAÍS",21
8,"8235",3875,3004,2996,19,8,"MÁS PAÍS",25
8,"8228",292,234,233,0,1,"MÁS PAÍS",1
8,"8289",4473,3379,3371,25,8,"MÁS PAÍS",37
8,"8300",5927,4609,4589,41,20,"MÁS PAÍS",59
8,"8248",5687,4187,4165,21,22,"MÁS PAÍS",35
8,"8195",75,62,62,0,0,"MÁS PAÍS",0
8,"8902",3941,2974,2962,16,12,"MÁS PAÍS",43
8,"8093",25,22,22,0,0,"MÁS PAÍS",0
8,"8264",4608,3459,3444,30,15,"MÁS PAÍS",39
8,"8232",1773,1368,1362,9,6,"MÁS PAÍS",5
8,"8042",2390,1772,1764,12,8,"MÁS PAÍS",12
8,"8118",17634,13450,13402,80,48,"MÁS PAÍS",181
8,"8112",12926,9268,9230,61,38,"MÁS PAÍS",55
8,"8224",885,653,652,6,1,"MÁS PAÍS",3
8,"8148",2344,1655,1646,13,9,"MÁS PAÍS",26
8,"8097",1103,845,840,4,5,"MÁS PAÍS",2
8,"8266",43422,32827,32696,241,131,"MÁS PAÍS",589
8,"8088",12347,9316,9270,75,46,"MÁS PAÍS",90
8,"8271",66,48,47,2,1,"MÁS PAÍS",0
8,"8211",33934,26136,26000,198,136,"MÁS PAÍS",436
8,"8164",936,750,747,6,3,"MÁS PAÍS",13
8,"8208",5793,4267,4244,21,23,"MÁS PAÍS",60
8,"8110",13671,9362,9311,60,51,"MÁS PAÍS",82
8,"8212",491,393,386,6,7,"MÁS PAÍS",1
8,"8287",1067,853,844,4,9,"MÁS PAÍS",5
8,"8027",724,584,582,1,2,"MÁS PAÍS",7
8,"8082",1164,796,780,5,16,"MÁS PAÍS",7
8,"8021",60,44,44,1,0,"MÁS PAÍS",1
8,"8304",822,655,655,5,0,"MÁS PAÍS",3
8,"8005",6425,4830,4816,28,14,"MÁS PAÍS",40
8,"8064",1956,1439,1423,7,16,"MÁS PAÍS",17
8,"8007",6795,5099,5081,29,18,"MÁS PAÍS",44
8,"8124",37157,27139,26994,179,145,"MÁS PAÍS",449
8,"8158",3094,2261,2251,11,10,"MÁS PAÍS",21
8,"8219",15755,12235,12206,72,29,"MÁS PAÍS",144
8,"8209",6925,4976,4948,39,28,"MÁS PAÍS",64
8,"8087",144,120,120,0,0,"MÁS PAÍS",1
8,"8153",573,457,452,3,5,"MÁS PAÍS",1
8,"8001",9097,6860,6818,39,42,"MÁS PAÍS",140
8,"8049",1309,910,903,3,7,"MÁS PAÍS",6
8,"8036",163,122,122,0,0,"MÁS PAÍS",1
8,"8109",207,176,174,0,2,"MÁS PAÍS",0
8,"8200",62225,45235,44991,306,244,"MÁS PAÍS",874
8,"8204",3141,2395,2383,16,12,"MÁS PAÍS",23
8,"8048",580,427,426,1,1,"MÁS PAÍS",2
8,"8045",65,44,43,0,1,"MÁS PAÍS",1
8,"8234",3443,2561,2550,15,11,"MÁS PAÍS",24
8,"8071",249,209,208,0,1,"MÁS PAÍS",0
8,"8294",2093,1546,1534,11,12,"MÁS PAÍS",12
8,"8034",820,644,640,0,4,"MÁS PAÍS",2
8,"8198",4679,3491,3469,12,22,"MÁS PAÍS",36
8,"8117",2489,1954,1941,21,13,"MÁS PAÍS",12
8,"8301",49348,36261,36045,292,216,"MÁS PAÍS",697
8,"8150",258,207,207,1,0,"MÁS PAÍS",2
8,"8072",10769,7632,7600,56,32,"MÁS PAÍS",99
8,"8142",136,117,117,3,0,"MÁS PAÍS",0
8,"8197",7986,5829,5805,37,24,"MÁS PAÍS",52
8,"8026",195,148,146,0,2,"MÁS PAÍS",1
8,"8079",333,260,258,2,2,"MÁS PAÍS",4
8,"8033",13262,9887,9833,64,54,"MÁS PAÍS",92
8,"8298",27148,19655,19568,102,87,"MÁS PAÍS",88
8,"8203",2466,1678,1675,7,3,"MÁS PAÍS",23
8,"8240",9469,7351,7327,39,24,"MÁS PAÍS",54
8,"8274",4640,3385,3363,24,22,"MÁS PAÍS",33
8,"8901",240,200,195,2,5,"MÁS PAÍS",0
8,"8006",11774,8375,8329,53,46,"MÁS PAÍS",62
8,"8184",55053,38519,38323,298,196,"MÁS PAÍS",696
8,"8286",2943,2051,2042,12,9,"MÁS PAÍS",16
8,"8120",7129,5649,5621,51,28,"MÁS PAÍS",35
8,"8258",815,636,632,5,4,"MÁS PAÍS",0
8,"8030",5208,4045,4033,25,12,"MÁS PAÍS",36
8,"8280",93,76,75,1,1,"MÁS PAÍS",0
8,"8191",5302,3872,3860,21,12,"MÁS PAÍS",19
8,"8277",168,148,146,1,2,"MÁS PAÍS",2
8,"8012",1726,1323,1309,17,14,"MÁS PAÍS",3
8,"8002",217,172,172,2,0,"MÁS PAÍS",0
8,"8054",9215,6994,6943,38,51,"MÁS PAÍS",102
8,"8193",988,739,737,10,2,"MÁS PAÍS",6
8,"8149",980,702,694,6,8,"MÁS PAÍS",0
8,"8278",4925,3820,3804,22,16,"MÁS PAÍS",17
8,"8154",697,541,539,3,2,"MÁS PAÍS",5
8,"8202",12943,9408,9358,58,50,"MÁS PAÍS",72
8,"8134",848,618,609,4,9,"MÁS PAÍS",4
8,"8043",3414,2429,2422,15,7,"MÁS PAÍS",38
8,"8279",156327,112605,112030,952,575,"MÁS PAÍS",2124
8,"8050",139,118,115,4,3,"MÁS PAÍS",0
8,"8250",7235,4917,4876,41,41,"MÁS PAÍS",49
8,"8180",27198,19822,19704,160,118,"MÁS PAÍS",358
8,"8231",21269,14655,14573,111,82,"MÁS PAÍS",218
8,"8303",257,207,205,1,2,"MÁS PAÍS",0
8,"8177",36,27,27,1,0,"MÁS PAÍS",0
8,"8102",28940,21108,21014,157,94,"MÁS PAÍS",162
8,"8127",2254,1548,1544,10,4,"MÁS PAÍS",8
8,"8038",1541,1129,1120,6,9,"MÁS PAÍS",4
8,"8023",7029,5027,5000,39,27,"MÁS PAÍS",59
8,"8162",2118,1581,1576,13,5,"MÁS PAÍS",26
8,"8041",10698,7324,7258,57,66,"MÁS PAÍS",95
8,"8140",4816,3541,3520,25,21,"MÁS PAÍS",33
8,"8170",442,322,320,0,2,"MÁS PAÍS",1
8,"8157",8574,6514,6472,47,42,"MÁS PAÍS",111
8,"8111",216,195,194,2,1,"MÁS PAÍS",1
8,"8065",1183,920,913,8,7,"MÁS PAÍS",6
8,"8216",25,17,17,0,0,"MÁS PAÍS",0
8,"8169",48478,35283,35114,278,169,"MÁS PAÍS",618
8,"8295",11290,8091,8054,72,37,"MÁS PAÍS",106
8,"8189",119,96,96,1,0,"MÁS PAÍS",0
8,"8192",5701,4366,4349,15,17,"MÁS PAÍS",22
8,"8213",6600,4925,4906,30,19,"MÁS PAÍS",24
8,"8051",18570,14112,14054,86,58,"MÁS PAÍS",147
8,"8190",255,184,182,1,2,"MÁS PAÍS",0
8,"8253",132,103,102,0,1,"MÁS PAÍS",0
8,"8155",7056,5050,5011,38,39,"MÁS PAÍS",78
8,"8035",13006,8957,8918,50,39,"MÁS PAÍS",84
8,"8292",1074,796,790,2,6,"MÁS PAÍS",11
8,"8254",1766,1433,1427,16,6,"MÁS PAÍS",2
8,"8123",19570,15378,15316,91,62,"MÁS PAÍS",161
8,"8218",8091,5899,5869,50,30,"MÁS PAÍS",41
8,"8176",158,119,119,0,0,"MÁS PAÍS",0
8,"8132",356,265,265,1,0,"MÁS PAÍS",0
8,"8255",133,100,100,2,0,"MÁS PAÍS",0
8,"8056",42897,30873,30757,259,116,"MÁS PAÍS",599
8,"8225",94,83,82,1,1,"MÁS PAÍS",1
8,"8233",1872,1428,1420,15,8,"MÁS PAÍS",6
8,"8100",2083,1707,1699,13,8,"MÁS PAÍS",3
8,"8013",1287,982,972,6,10,"MÁS PAÍS",8
8,"8201",455,319,318,12,1,"MÁS PAÍS",1
8,"8116",557,449,449,1,0,"MÁS PAÍS",3
8,"8168",388,280,279,3,1,"MÁS PAÍS",2
8,"8179",636,466,465,2,1,"MÁS PAÍS",5
8,"8242",223,159,159,0,0,"MÁS PAÍS",2
8,"8245",77841,53719,53443,430,276,"MÁS PAÍS",939
8,"8163",19672,13421,13364,70,57,"MÁS PAÍS",127
8,"8160",317,234,234,0,0,"MÁS PAÍS",0
8,"8306",535,368,368,5,0,"MÁS PAÍS",2
8,"8256",693,542,542,3,0,"MÁS PAÍS",7
8,"8230",7648,5797,5774,40,23,"MÁS PAÍS",54
8,"8053",2896,1939,1929,13,10,"MÁS PAÍS",20
8,"8003",7213,5425,5409,41,16,"MÁS PAÍS",61
8,"8031",2339,1760,1750,15,10,"MÁS PAÍS",12
8,"8008",175,136,136,2,0,"MÁS PAÍS",0
8,"8084",1172,902,894,9,8,"MÁS PAÍS",8
8,"8062",1009,778,776,9,2,"MÁS PAÍS",1
8,"8145",2712,2060,2049,8,11,"MÁS PAÍS",25
8,"8241",70,52,52,0,0,"MÁS PAÍS",0
8,"8171",2046,1520,1510,13,10,"MÁS PAÍS",4
8,"8174",388,322,318,2,4,"MÁS PAÍS",0
8,"8187",153822,113081,112470,758,611,"MÁS PAÍS",1561
8,"8246",1692,1345,1340,7,5,"MÁS PAÍS",2
8,"8107",11965,8604,8554,67,50,"MÁS PAÍS",143
8,"8010",4224,3109,3090,22,19,"MÁS PAÍS",14
8,"8104",657,496,493,4,3,"MÁS PAÍS",1
8,"8260",18515,13563,13487,84,76,"MÁS PAÍS",226
8,"8147",17389,12679,12601,102,78,"MÁS PAÍS",180
8,"8066",1466,1109,1104,7,5,"MÁS PAÍS",21
8,"8077",34690,25896,25767,164,129,"MÁS PAÍS",421
8,"8223",1897,1345,1341,10,4,"MÁS PAÍS",3
8,"8904",10516,7068,7025,54,43,"MÁS PAÍS",113
8,"8188",115,89,89,0,0,"MÁS PAÍS",0
8,"8165",1680,1177,1171,7,6,"MÁS PAÍS",11
8,"8039",413,322,321,1,1,"MÁS PAÍS",3
8,"8299",380,301,300,4,1,"MÁS PAÍS",2
8,"8069",3323,2555,2540,21,15,"MÁS PAÍS",19
8,"8011",1739,1360,1353,10,7,"MÁS PAÍS",8
8,"8181",8133,5949,5924,31,25,"MÁS PAÍS",79
8,"8307",49499,35471,35312,199,159,"MÁS PAÍS",462
8,"8217",25466,19864,19773,129,91,"MÁS PAÍS",339
8,"8089",34190,24548,24404,194,144,"MÁS PAÍS",429
8,"8288",1696,1103,1096,9,7,"MÁS PAÍS",8
8,"8138",4461,3286,3259,27,27,"MÁS PAÍS",30
8,"8215",2617,1954,1946,22,8,"MÁS PAÍS",1
8,"8251",5130,3719,3698,20,21,"MÁS PAÍS",44
8,"8074",11190,7698,7651,51,47,"MÁS PAÍS",127
8,"8161",11826,8001,7951,58,50,"MÁS PAÍS",127
8,"8903",201,181,181,1,0,"MÁS PAÍS",1
8,"8121",87515,62961,62574,429,387,"MÁS PAÍS",692
8,"8092",3713,2758,2745,9,13,"MÁS PAÍS",8
8,"8281",4858,3783,3762,19,21,"MÁS PAÍS",50
8,"8020",5243,4117,4100,29,17,"MÁS PAÍS",53
8,"8119",6897,5096,5052,31,44,"MÁS PAÍS",79
8,"8207",2026,1667,1659,12,8,"MÁS PAÍS",4
8,"8227",2420,1775,1769,11,6,"MÁS PAÍS",15
8,"8130",110,81,81,2,0,"MÁS PAÍS",0
8,"8094",1588,1258,1252,7,6,"MÁS PAÍS",6
8,"8226",929,748,747,10,1,"MÁS PAÍS",3
8,"8115",3826,2777,2770,31,7,"MÁS PAÍS",27
8,"8291",4972,3531,3519,23,12,"MÁS PAÍS",69
8,"8081",349,274,270,0,4,"MÁS PAÍS",0
8,"8268",975,729,723,6,6,"MÁS PAÍS",1
8,"8099",753,529,529,4,0,"MÁS PAÍS",2
8,"8273",2390,1871,1855,14,16,"MÁS PAÍS",5
8,"8018",2540,1862,1855,7,7,"MÁS PAÍS",18
8,"8284",12597,8244,8183,60,61,"MÁS PAÍS",67
8,"8269",2729,2114,2105,9,9,"MÁS PAÍS",4
8,"8046",13541,10510,10455,73,55,"MÁS PAÍS",109
8,"8061",1628,1154,1151,15,3,"MÁS PAÍS",21
8,"8144",722,551,545,3,6,"MÁS PAÍS",3
8,"8076",16526,11988,11893,90,95,"MÁS PAÍS",163
8,"8199",648,509,508,3,1,"MÁS PAÍS",3
8,"8114",18838,13519,13442,81,77,"MÁS PAÍS",177
8,"8070",269,215,211,1,4,"MÁS PAÍS",0
8,"8004",208,177,177,1,0,"MÁS PAÍS",0
8,"8083",1672,1433,1430,6,3,"MÁS PAÍS",2
8,"8126",8906,6673,6646,41,27,"MÁS PAÍS",98
8,"8015",156540,109145,108440,957,705,"MÁS PAÍS",1645
8,"8172",20543,15191,15140,85,51,"MÁS PAÍS",179
8,"8238",14946,11911,11873,85,38,"MÁS PAÍS",126
8,"8068",6863,5064,5041,40,23,"MÁS PAÍS",73
8,"8122",1733,1179,1175,4,4,"MÁS PAÍS",14
8,"8257",103,82,82,0,0,"MÁS PAÍS",0
8,"8261",2405,1726,1718,11,8,"MÁS PAÍS",14
8,"8220",2411,2010,2001,8,9,"MÁS PAÍS",2
8,"8222",1821,1439,1424,7,15,"MÁS PAÍS",12
8,"8293",227,177,177,0,0,"MÁS PAÍS",1
8,"8205",61957,49325,49196,441,129,"MÁS PAÍS",674
8,"8265",1597,1262,1260,4,2,"MÁS PAÍS",8
8,"8296",1869,1412,1408,10,4,"MÁS PAÍS",11
8,"8167",6056,4520,4500,38,20,"MÁS PAÍS",75
8,"8058",1808,1280,1262,6,18,"MÁS PAÍS",19
8,"8276",241,179,179,3,0,"MÁS PAÍS",0
8,"8028",1125,744,743,7,1,"MÁS PAÍS",15
41,"41028",2108,1652,1632,22,20,"MÁS PAÍS-AN",63
41,"41047",10449,7884,7770,119,114,"MÁS PAÍS-AN",189
18,"18147",3655,2273,2241,16,32,"MÁS PAÍS-AN",44
18,"18124",355,232,231,1,1,"MÁS PAÍS-AN",0
29,"29066",357,248,246,1,2,"MÁS PAÍS-AN",4
18,"18915",726,474,467,4,7,"MÁS PAÍS-AN",0
18,"18909",514,403,403,0,0,"MÁS PAÍS-AN",0
18,"18103",714,500,498,3,2,"MÁS PAÍS-AN",1
29,"29096",2757,1847,1790,19,57,"MÁS PAÍS-AN",30
41,"41040",11183,8351,8253,71,98,"MÁS PAÍS-AN",208
41,"41075",10320,7159,6972,88,187,"MÁS PAÍS-AN",74
11,"11028",32829,21934,21654,310,280,"MÁS PAÍS-AN",679
11,"11005",4508,2978,2900,34,78,"MÁS PAÍS-AN",38
29,"29037",215,156,153,1,3,"MÁS PAÍS-AN",1
29,"29059",2662,1950,1895,16,55,"MÁS PAÍS-AN",20
11,"11042",1158,806,793,6,13,"MÁS PAÍS-AN",13
18,"18086",338,253,247,1,6,"MÁS PAÍS-AN",4
29,"29092",576,375,366,7,9,"MÁS PAÍS-AN",3
18,"18138",2470,1597,1573,25,24,"MÁS PAÍS-AN",8
18,"18021",17929,12165,11949,139,216,"MÁS PAÍS-AN",292
29,"29049",2890,2069,2034,12,35,"MÁS PAÍS-AN",25
18,"18117",497,360,354,1,6,"MÁS PAÍS-AN",7
29,"29019",853,604,588,2,16,"MÁS PAÍS-AN",1
29,"29017",6404,4575,4468,48,107,"MÁS PAÍS-AN",58
29,"29040",1933,1260,1235,11,25,"MÁS PAÍS-AN",17
41,"41101",6025,4299,4213,53,86,"MÁS PAÍS-AN",33
41,"41100",954,670,635,7,35,"MÁS PAÍS-AN",7
29,"29043",2463,1508,1460,20,48,"MÁS PAÍS-AN",16
18,"18128",332,263,260,1,3,"MÁS PAÍS-AN",3
29,"29030",770,618,611,4,7,"MÁS PAÍS-AN",9
41,"41003",2373,1747,1708,18,39,"MÁS PAÍS-AN",11
29,"29065",191,145,143,3,2,"MÁS PAÍS-AN",1
11,"11012",97338,67120,66466,861,654,"MÁS PAÍS-AN",1657
18,"18070",287,216,216,3,0,"MÁS PAÍS-AN",6
18,"18914",1660,1255,1227,11,28,"MÁS PAÍS-AN",12
29,"29087",363,249,243,4,6,"MÁS PAÍS-AN",3
18,"18007",730,490,478,3,12,"MÁS PAÍS-AN",5
18,"18001",222,147,146,0,1,"MÁS PAÍS-AN",0
18,"18033",279,179,174,0,5,"MÁS PAÍS-AN",4
18,"18063",1232,687,678,9,9,"MÁS PAÍS-AN",3
18,"18140",42474,26967,26648,225,319,"MÁS PAÍS-AN",333
41,"41044",7753,5636,5547,55,89,"MÁS PAÍS-AN",152
41,"41065",22527,14684,14463,205,221,"MÁS PAÍS-AN",280
18,"18018",542,384,377,2,7,"MÁS PAÍS-AN",5
41,"41902",4599,2906,2868,50,38,"MÁS PAÍS-AN",16
29,"29902",2593,1561,1533,15,28,"MÁS PAÍS-AN",12
41,"41009",1148,750,732,5,18,"MÁS PAÍS-AN",9
18,"18010",527,398,394,5,4,"MÁS PAÍS-AN",3
41,"41037",3201,2306,2260,22,46,"MÁS PAÍS-AN",21
18,"18051",1092,735,718,8,17,"MÁS PAÍS-AN",4
41,"41901",2692,2101,2051,47,50,"MÁS PAÍS-AN",21
29,"29058",1542,994,979,5,15,"MÁS PAÍS-AN",6
29,"29080",6940,4676,4617,36,59,"MÁS PAÍS-AN",51
29,"29047",1082,860,846,0,14,"MÁS PAÍS-AN",14
41,"41058",17956,12890,12553,200,337,"MÁS PAÍS-AN",202
29,"29904",418,328,322,1,6,"MÁS PAÍS-AN",5
11,"11040",396,332,324,3,8,"MÁS PAÍS-AN",7
11,"11004",89919,55211,54544,830,667,"MÁS PAÍS-AN",997
11,"11039",9957,6134,6043,152,91,"MÁS PAÍS-AN",76
41,"41060",15058,10551,10302,122,249,"MÁS PAÍS-AN",126
29,"29048",1364,1053,1039,8,14,"MÁS PAÍS-AN",17
41,"41066",1307,927,898,7,29,"MÁS PAÍS-AN",12
18,"18116",2856,2027,1979,13,48,"MÁS PAÍS-AN",14
41,"41008",1044,788,766,3,22,"MÁS PAÍS-AN",4
11,"11010",6327,3998,3928,112,70,"MÁS PAÍS-AN",36
29,"29075",12886,8292,8191,63,101,"MÁS PAÍS-AN",133
18,"18083",232,181,179,1,2,"MÁS PAÍS-AN",0
18,"18067",682,442,437,2,5,"MÁS PAÍS-AN",0
18,"18114",585,425,424,7,1,"MÁS PAÍS-AN",1
18,"18150",6964,4717,4622,51,95,"MÁS PAÍS-AN",82
18,"18004",669,467,466,6,1,"MÁS PAÍS-AN",0
18,"18183",623,380,376,0,4,"MÁS PAÍS-AN",5
29,"29046",2494,1727,1693,13,34,"MÁS PAÍS-AN",11
29,"29050",392,229,227,3,2,"MÁS PAÍS-AN",3
18,"18161",245,199,196,0,3,"MÁS PAÍS-AN",0
29,"29011",2893,1763,1736,12,27,"MÁS PAÍS-AN",19
18,"18050",1649,1113,1095,5,18,"MÁS PAÍS-AN",28
18,"18151",261,167,166,4,1,"MÁS PAÍS-AN",3
18,"18180",636,410,401,2,9,"MÁS PAÍS-AN",8
18,"18192",1462,1125,1103,3,22,"MÁS PAÍS-AN",4
18,"18162",919,664,652,3,12,"MÁS PAÍS-AN",0
11,"11019",1757,1233,1172,13,61,"MÁS PAÍS-AN",13
41,"41043",669,447,436,11,11,"MÁS PAÍS-AN",2
29,"29025",41540,27170,26897,271,273,"MÁS PAÍS-AN",640
18,"18088",1526,1000,993,10,7,"MÁS PAÍS-AN",4
11,"11014",17203,10923,10805,222,118,"MÁS PAÍS-AN",169
29,"29020",3278,2329,2260,22,69,"MÁS PAÍS-AN",37
29,"29022",177,137,136,1,1,"MÁS PAÍS-AN",2
41,"41010",4586,3218,3157,42,61,"MÁS PAÍS-AN",92
41,"41038",102752,71545,70538,980,1007,"MÁS PAÍS-AN",1823
29,"29072",3291,2360,2307,19,53,"MÁS PAÍS-AN",30
29,"29082",34683,24751,24495,263,256,"MÁS PAÍS-AN",601
29,"29091",9490,6428,6304,61,124,"MÁS PAÍS-AN",82
29,"29100",2379,1582,1551,22,31,"MÁS PAÍS-AN",11
41,"41011",15462,11019,10696,183,323,"MÁS PAÍS-AN",119
11,"11041",9869,6438,6295,100,143,"MÁS PAÍS-AN",58
18,"18153",8834,6174,6063,54,111,"MÁS PAÍS-AN",131
18,"18176",242,164,161,2,3,"MÁS PAÍS-AN",1
29,"29052",213,129,128,0,1,"MÁS PAÍS-AN",1
41,"41086",16199,10227,10105,137,122,"MÁS PAÍS-AN",220
18,"18159",989,765,762,2,3,"MÁS PAÍS-AN",8
41,"41102",14773,10377,10028,174,349,"MÁS PAÍS-AN",139
18,"18903",852,544,537,9,7,"MÁS PAÍS-AN",6
29,"29034",461,333,332,2,1,"MÁS PAÍS-AN",1
11,"11903",1769,1116,1101,22,15,"MÁS PAÍS-AN",5
41,"41074",2994,2154,2105,19,49,"MÁS PAÍS-AN",20
41,"41015",5426,3778,3639,41,139,"MÁS PAÍS-AN",41
18,"18100",7997,5523,5367,66,156,"MÁS PAÍS-AN",57
18,"18109",597,430,422,5,8,"MÁS PAÍS-AN",1
41,"41084",2799,2029,1937,9,92,"MÁS PAÍS-AN",9
18,"18085",690,440,432,1,8,"MÁS PAÍS-AN",1
18,"18121",119,79,79,1,0,"MÁS PAÍS-AN",1
29,"29056",1047,708,696,5,12,"MÁS PAÍS-AN",5
11,"11022",48785,24758,24422,398,336,"MÁS PAÍS-AN",388
11,"11032",54731,31560,31284,492,276,"MÁS PAÍS-AN",453
11,"11009",579,399,390,0,9,"MÁS PAÍS-AN",3
18,"18135",4385,2882,2798,24,84,"MÁS PAÍS-AN",36
29,"29099",969,688,669,11,19,"MÁS PAÍS-AN",1
18,"18167",1839,1243,1224,9,19,"MÁS PAÍS-AN",13
18,"18171",2098,1521,1460,11,61,"MÁS PAÍS-AN",7
29,"29018",2009,1421,1362,17,59,"MÁS PAÍS-AN",14
18,"18071",5636,3909,3807,45,102,"MÁS PAÍS-AN",96
18,"18916",1815,1093,1086,6,7,"MÁS PAÍS-AN",11
18,"18126",1436,1024,1002,9,22,"MÁS PAÍS-AN",11
18,"18011",4403,3002,2947,24,55,"MÁS PAÍS-AN",50
18,"18095",2054,1475,1433,14,42,"MÁS PAÍS-AN",30
29,"29013",1613,1191,1154,9,37,"MÁS PAÍS-AN",19
18,"18152",928,663,660,3,3,"MÁS PAÍS-AN",0
29,"29903",485,326,324,2,2,"MÁS PAÍS-AN",3
18,"18149",5408,3926,3859,42,67,"MÁS PAÍS-AN",59
18,"18181",194,134,133,0,1,"MÁS PAÍS-AN",0
18,"18173",8999,5958,5871,50,87,"MÁS PAÍS-AN",96
11,"11031",76427,49773,49248,654,525,"MÁS PAÍS-AN",950
11,"11007",18032,9872,9745,213,127,"MÁS PAÍS-AN",146
41,"41097",3131,2197,2140,13,57,"MÁS PAÍS-AN",16
18,"18185",545,434,424,5,10,"MÁS PAÍS-AN",4
41,"41071",5571,3608,3516,64,92,"MÁS PAÍS-AN",28
18,"18025",277,198,197,0,1,"MÁS PAÍS-AN",1
41,"41057",258,174,170,3,4,"MÁS PAÍS-AN",1
18,"18066",2095,1401,1378,12,23,"MÁS PAÍS-AN",9
18,"18170",317,212,209,0,3,"MÁS PAÍS-AN",3
18,"18036",3986,2956,2917,22,39,"MÁS PAÍS-AN",78
41,"41024",22819,14767,14455,169,312,"MÁS PAÍS-AN",192
18,"18064",366,289,286,0,3,"MÁS PAÍS-AN",1
18,"18157",1148,843,827,7,16,"MÁS PAÍS-AN",21
29,"29093",2150,1543,1520,8,23,"MÁS PAÍS-AN",7
11,"11025",4374,2808,2759,30,49,"MÁS PAÍS-AN",26
41,"41030",501,376,366,9,10,"MÁS PAÍS-AN",2
29,"29005",4507,3012,2965,29,47,"MÁS PAÍS-AN",37
18,"18048",2494,1708,1657,18,51,"MÁS PAÍS-AN",41
18,"18043",129,74,71,0,3,"MÁS PAÍS-AN",1
18,"18194",2038,1373,1348,12,25,"MÁS PAÍS-AN",8
18,"18094",2299,1712,1652,20,60,"MÁS PAÍS-AN",17
11,"11033",21804,13361,13133,213,228,"MÁS PAÍS-AN",176
41,"41092",7681,5408,5299,79,109,"MÁS PAÍS-AN",61
29,"29010",1637,1263,1187,2,76,"MÁS PAÍS-AN",13
18,"18039",3343,2293,2252,22,41,"MÁS PAÍS-AN",27
18,"18137",968,733,731,3,2,"MÁS PAÍS-AN",0
11,"11901",5739,3759,3686,99,73,"MÁS PAÍS-AN",26
29,"29063",305,244,242,2,2,"MÁS PAÍS-AN",1
29,"29085",138,98,93,1,5,"MÁS PAÍS-AN",0
18,"18040",237,146,145,0,1,"MÁS PAÍS-AN",5
18,"18193",14934,10301,10127,116,174,"MÁS PAÍS-AN",284
18,"18030",566,382,380,2,2,"MÁS PAÍS-AN",5
11,"11013",2352,1564,1522,13,42,"MÁS PAÍS-AN",14
29,"29068",7833,4897,4806,50,91,"MÁS PAÍS-AN",82
18,"18115",2635,1766,1738,13,28,"MÁS PAÍS-AN",23
18,"18902",752,589,568,3,21,"MÁS PAÍS-AN",4
29,"29071",980,580,564,11,16,"MÁS PAÍS-AN",3
18,"18178",664,474,467,1,7,"MÁS PAÍS-AN",4
18,"18188",1646,1224,1202,10,22,"MÁS PAÍS-AN",14
41,"41035",1051,733,722,10,11,"MÁS PAÍS-AN",6
41,"41094",6496,4733,4628,47,105,"MÁS PAÍS-AN",74
18,"18127",17005,11790,11583,150,207,"MÁS PAÍS-AN",217
41,"41027",4007,2628,2546,33,82,"MÁS PAÍS-AN",30
18,"18184",2193,1542,1511,16,31,"MÁS PAÍS-AN",25
18,"18133",2101,1496,1477,6,19,"MÁS PAÍS-AN",14
29,"29061",1043,803,773,9,30,"MÁS PAÍS-AN",12
41,"41005",9285,6637,6497,83,140,"MÁS PAÍS-AN",109
18,"18158",7978,4861,4771,43,90,"MÁS PAÍS-AN",47
29,"29083",2063,1471,1444,14,27,"MÁS PAÍS-AN",6
11,"11018",1434,1001,977,8,24,"MÁS PAÍS-AN",4
41,"41012",3375,2259,2214,26,45,"MÁS PAÍS-AN",35
29,"29002",1143,777,766,6,11,"MÁS PAÍS-AN",6
18,"18082",810,503,500,3,3,"MÁS PAÍS-AN",8
18,"18165",4265,2870,2820,22,50,"MÁS PAÍS-AN",76
41,"41068",13963,9596,9407,96,189,"MÁS PAÍS-AN",126
41,"41002",1421,938,911,7,27,"MÁS PAÍS-AN",4
18,"18179",493,315,309,8,6,"MÁS PAÍS-AN",0
11,"11029",5442,2826,2765,44,61,"MÁS PAÍS-AN",11
41,"41050",5173,3954,3878,36,76,"MÁS PAÍS-AN",59
18,"18111",2863,2038,2001,29,37,"MÁS PAÍS-AN",55
29,"29041",3697,2406,2361,47,45,"MÁS PAÍS-AN",45
41,"41099",3961,2448,2413,14,35,"MÁS PAÍS-AN",26
18,"18016",297,200,198,3,2,"MÁS PAÍS-AN",0
18,"18904",741,500,498,1,2,"MÁS PAÍS-AN",5
18,"18034",484,345,342,3,3,"MÁS PAÍS-AN",2
29,"29044",749,477,473,1,4,"MÁS PAÍS-AN",2
41,"41093",19064,14867,14700,151,167,"MÁS PAÍS-AN",455
29,"29084",27199,18102,17800,268,302,"MÁS PAÍS-AN",295
18,"18084",4533,3233,3178,35,55,"MÁS PAÍS-AN",56
18,"18076",789,534,532,2,2,"MÁS PAÍS-AN",2
29,"29094",59795,39350,38854,454,496,"MÁS PAÍS-AN",615
11,"11902",3664,2123,2094,46,29,"MÁS PAÍS-AN",13
29,"29001",4207,3002,2959,40,43,"MÁS PAÍS-AN",36
41,"41039",31538,22078,21717,278,361,"MÁS PAÍS-AN",288
41,"41001",1558,1129,1104,6,25,"MÁS PAÍS-AN",7
29,"29029",383,256,254,4,2,"MÁS PAÍS-AN",2
41,"41083",1145,821,814,6,7,"MÁS PAÍS-AN",8
29,"29027",2325,1543,1516,13,27,"MÁS PAÍS-AN",7
11,"11021",4914,3187,3069,61,118,"MÁS PAÍS-AN",40
18,"18108",822,604,599,2,5,"MÁS PAÍS-AN",5
18,"18015",424,331,330,4,1,"MÁS PAÍS-AN",0
41,"41091",539590,389351,384943,4676,4408,"MÁS PAÍS-AN",10005
18,"18905",15688,10406,10200,122,206,"MÁS PAÍS-AN",197
41,"41061",2141,1661,1621,7,40,"MÁS PAÍS-AN",19
29,"29024",371,216,204,3,12,"MÁS PAÍS-AN",3
41,"41019",4931,3323,3251,39,72,"MÁS PAÍS-AN",37
18,"18023",15717,10964,10751,132,213,"MÁS PAÍS-AN",167
18,"18005",363,232,230,3,2,"MÁS PAÍS-AN",2
18,"18032",247,164,163,1,1,"MÁS PAÍS-AN",4
41,"41087",10557,7217,7029,67,188,"MÁS PAÍS-AN",169
29,"29021",155,111,109,1,2,"MÁS PAÍS-AN",7
18,"18096",340,227,226,0,1,"MÁS PAÍS-AN",0
41,"41062",2151,1619,1589,12,30,"MÁS PAÍS-AN",20
11,"11024",6550,4500,4402,67,98,"MÁS PAÍS-AN",44
41,"41021",21410,14369,14139,195,230,"MÁS PAÍS-AN",273
18,"18053",1554,1001,985,9,16,"MÁS PAÍS-AN",10
18,"18020",489,318,310,2,8,"MÁS PAÍS-AN",2
41,"41007",12488,7657,7421,126,236,"MÁS PAÍS-AN",106
18,"18148",787,618,605,5,13,"MÁS PAÍS-AN",5
41,"41056",3687,2836,2779,37,57,"MÁS PAÍS-AN",42
11,"11008",17923,11702,11464,192,238,"MÁS PAÍS-AN",216
18,"18187",510,350,350,2,0,"MÁS PAÍS-AN",3
11,"11023",9386,6363,6248,116,115,"MÁS PAÍS-AN",71
41,"41082",3354,2545,2507,11,38,"MÁS PAÍS-AN",21
41,"41020",13012,8148,7999,135,149,"MÁS PAÍS-AN",61
11,"11016",15079,9353,9192,137,161,"MÁS PAÍS-AN",90
18,"18054",820,573,569,2,4,"MÁS PAÍS-AN",8
41,"41045",5873,3901,3802,53,99,"MÁS PAÍS-AN",72
18,"18163",311,206,204,0,2,"MÁS PAÍS-AN",0
29,"29023",2330,1441,1429,11,12,"MÁS PAÍS-AN",29
41,"41055",14791,10197,10000,125,197,"MÁS PAÍS-AN",99
41,"41070",6451,4715,4632,70,83,"MÁS PAÍS-AN",146
41,"41017",15907,11486,11302,158,184,"MÁS PAÍS-AN",319
41,"41067",7273,5114,5036,59,78,"MÁS PAÍS-AN",75
18,"18042",417,332,330,4,2,"MÁS PAÍS-AN",5
18,"18014",6938,4864,4742,64,122,"MÁS PAÍS-AN",104
18,"18146",930,645,629,10,16,"MÁS PAÍS-AN",7
29,"29008",15249,10396,10234,108,162,"MÁS PAÍS-AN",105
29,"29033",1084,733,722,5,11,"MÁS PAÍS-AN",5
29,"29009",1435,971,957,17,14,"MÁS PAÍS-AN",9
41,"41018",9432,6463,6368,86,95,"MÁS PAÍS-AN",61
11,"11001",4360,2810,2744,32,66,"MÁS PAÍS-AN",22
29,"29089",3138,2262,2186,13,76,"MÁS PAÍS-AN",27
18,"18906",903,641,639,2,2,"MÁS PAÍS-AN",5
18,"18097",947,633,631,0,2,"MÁS PAÍS-AN",5
29,"29062",658,557,551,2,6,"MÁS PAÍS-AN",3
29,"29098",1228,902,876,11,26,"MÁS PAÍS-AN",41
29,"29095",3285,2313,2224,39,89,"MÁS PAÍS-AN",29
11,"11011",1726,1124,1084,8,40,"MÁS PAÍS-AN",19
41,"41073",1684,1100,1074,7,26,"MÁS PAÍS-AN",13
29,"29015",32093,22044,21716,253,328,"MÁS PAÍS-AN",274
18,"18029",1812,1104,1065,7,39,"MÁS PAÍS-AN",13
29,"29028",1215,803,779,9,24,"MÁS PAÍS-AN",10
18,"18910",710,439,434,1,5,"MÁS PAÍS-AN",3
18,"18174",435,324,320,3,4,"MÁS PAÍS-AN",0
41,"41098",5161,3792,3732,33,60,"MÁS PAÍS-AN",48
41,"41078",2445,1722,1689,12,33,"MÁS PAÍS-AN",16
41,"41085",4182,3258,3181,43,77,"MÁS PAÍS-AN",72
18,"18049",588,418,415,4,3,"MÁS PAÍS-AN",3
11,"11036",683,401,395,15,6,"MÁS PAÍS-AN",0
29,"29032",6655,4900,4775,36,125,"MÁS PAÍS-AN",47
29,"29090",1649,1138,1124,10,14,"MÁS PAÍS-AN",4
41,"41033",4958,3299,3250,38,49,"MÁS PAÍS-AN",30
41,"41904",1789,1125,1109,31,16,"MÁS PAÍS-AN",3
29,"29060",665,454,450,1,4,"MÁS PAÍS-AN",0
29,"29097",4160,2872,2800,56,72,"MÁS PAÍS-AN",17
41,"41042",5872,4477,4424,42,53,"MÁS PAÍS-AN",62
18,"18059",4265,2960,2886,23,74,"MÁS PAÍS-AN",32
18,"18175",11793,8099,7943,62,156,"MÁS PAÍS-AN",111
41,"41026",4302,3355,3288,26,67,"MÁS PAÍS-AN",21
41,"41036",3903,2708,2645,35,63,"MÁS PAÍS-AN",46
18,"18017",18201,11500,11358,94,142,"MÁS PAÍS-AN",140
41,"41014",2476,1852,1799,10,53,"MÁS PAÍS-AN",19
18,"18006",4062,2765,2711,25,54,"MÁS PAÍS-AN",20
18,"18182",1926,1222,1204,8,18,"MÁS PAÍS-AN",8
11,"11017",3198,2054,2004,37,50,"MÁS PAÍS-AN",8
18,"18913",771,530,514,2,16,"MÁS PAÍS-AN",5
41,"41064",5602,3520,3417,56,103,"MÁS PAÍS-AN",27
18,"18102",8233,5424,5266,46,158,"MÁS PAÍS-AN",52
18,"18038",1042,782,760,5,22,"MÁS PAÍS-AN",6
29,"29073",1657,1082,1069,15,13,"MÁS PAÍS-AN",18
29,"29076",2354,1498,1444,21,54,"MÁS PAÍS-AN",29
18,"18077",471,350,343,1,7,"MÁS PAÍS-AN",2
29,"29031",1555,1015,986,6,29,"MÁS PAÍS-AN",7
11,"11015",64414,39635,39220,776,415,"MÁS PAÍS-AN",759
29,"29081",250,185,182,2,3,"MÁS PAÍS-AN",0
18,"18105",3827,2436,2392,22,44,"MÁS PAÍS-AN",16
41,"41048",2195,1445,1400,13,45,"MÁS PAÍS-AN",18
18,"18062",11226,7969,7777,88,192,"MÁS PAÍS-AN",143
41,"41076",2134,1246,1230,11,16,"MÁS PAÍS-AN",9
11,"11035",13751,8535,8396,125,139,"MÁS PAÍS-AN",160
41,"41022",4255,2735,2667,32,68,"MÁS PAÍS-AN",36
18,"18189",785,598,592,9,6,"MÁS PAÍS-AN",12
41,"41025",2031,1409,1349,11,60,"MÁS PAÍS-AN",16
41,"41059",35358,26408,26052,346,356,"MÁS PAÍS-AN",913
41,"41063",2735,1855,1797,30,58,"MÁS PAÍS-AN",26
18,"18107",920,643,626,1,17,"MÁS PAÍS-AN",3
18,"18901",489,323,322,5,1,"MÁS PAÍS-AN",8
41,"41023",7999,5500,5435,60,65,"MÁS PAÍS-AN",41
18,"18035",1179,882,870,7,12,"MÁS PAÍS-AN",6
18,"18144",816,592,582,3,10,"MÁS PAÍS-AN",16
18,"18099",1582,1184,1156,13,28,"MÁS PAÍS-AN",27
18,"18911",7933,5464,5348,53,116,"MÁS PAÍS-AN",96
18,"18037",535,417,410,2,7,"MÁS PAÍS-AN",3
18,"18112",104,68,66,2,2,"MÁS PAÍS-AN",0
29,"29036",614,393,387,1,6,"MÁS PAÍS-AN",3
18,"18065",588,464,451,2,13,"MÁS PAÍS-AN",9
29,"29064",423,291,285,2,6,"MÁS PAÍS-AN",5
18,"18003",14454,10162,9935,105,227,"MÁS PAÍS-AN",191
18,"18098",5959,3816,3749,33,67,"MÁS PAÍS-AN",42
18,"18907",1762,1358,1351,4,7,"MÁS PAÍS-AN",3
11,"11026",4700,3387,3293,17,94,"MÁS PAÍS-AN",44
41,"41041",9765,7172,6943,63,229,"MÁS PAÍS-AN",93
29,"29079",2326,1609,1582,12,27,"MÁS PAÍS-AN",15
18,"18069",484,356,356,5,0,"MÁS PAÍS-AN",3
18,"18123",284,202,200,5,2,"MÁS PAÍS-AN",3
18,"18168",783,566,561,11,5,"MÁS PAÍS-AN",9
29,"29069",87188,54019,53240,633,779,"MÁS PAÍS-AN",829
18,"18045",1065,720,690,11,30,"MÁS PAÍS-AN",3
18,"18061",999,781,770,5,11,"MÁS PAÍS-AN",8
41,"41046",3005,2241,2198,11,43,"MÁS PAÍS-AN",26
18,"18013",4154,2892,2812,28,80,"MÁS PAÍS-AN",27
29,"29026",1021,703,698,15,5,"MÁS PAÍS-AN",7
11,"11038",13632,10047,9812,99,235,"MÁS PAÍS-AN",102
18,"18164",1790,1135,1108,11,27,"MÁS PAÍS-AN",5
41,"41032",3842,2800,2704,24,96,"MÁS PAÍS-AN",34
18,"18056",3382,2397,2350,30,47,"MÁS PAÍS-AN",22
29,"29012",9718,6664,6553,85,111,"MÁS PAÍS-AN",54
18,"18074",265,205,205,0,0,"MÁS PAÍS-AN",0
41,"41095",40187,27090,26680,512,410,"MÁS PAÍS-AN",477
18,"18154",982,668,668,4,0,"MÁS PAÍS-AN",1
11,"11006",24558,15334,15113,231,221,"MÁS PAÍS-AN",190
41,"41088",515,368,358,2,10,"MÁS PAÍS-AN",7
29,"29007",28907,20371,20129,254,242,"MÁS PAÍS-AN",407
41,"41006",2733,1776,1742,17,34,"MÁS PAÍS-AN",16
41,"41013",4836,3174,3124,41,50,"MÁS PAÍS-AN",15
41,"41016",7820,5523,5407,57,116,"MÁS PAÍS-AN",116
29,"29004",283,222,218,3,4,"MÁS PAÍS-AN",3
11,"11037",5656,4374,4273,24,101,"MÁS PAÍS-AN",52
11,"11002",4218,3176,3149,16,27,"MÁS PAÍS-AN",21
18,"18132",3101,2418,2382,23,36,"MÁS PAÍS-AN",20
18,"18087",182877,131811,130184,1106,1627,"MÁS PAÍS-AN",3180
41,"41079",9285,6591,6446,101,145,"MÁS PAÍS-AN",85
41,"41903",6776,4616,4494,72,122,"MÁS PAÍS-AN",43
29,"29055",1892,1425,1394,3,31,"MÁS PAÍS-AN",27
18,"18028",898,723,718,3,5,"MÁS PAÍS-AN",0
18,"18002",529,387,384,1,3,"MÁS PAÍS-AN",0
11,"11034",2319,1520,1487,17,33,"MÁS PAÍS-AN",4
41,"41072",4031,2969,2933,15,36,"MÁS PAÍS-AN",56
29,"29045",1679,1162,1144,5,18,"MÁS PAÍS-AN",15
41,"41052",3032,2162,2092,6,70,"MÁS PAÍS-AN",9
18,"18047",6103,3992,3922,61,70,"MÁS PAÍS-AN",105
18,"18024",837,651,639,11,12,"MÁS PAÍS-AN",9
18,"18093",2751,1693,1674,18,19,"MÁS PAÍS-AN",12
41,"41077",8631,5788,5598,51,190,"MÁS PAÍS-AN",53
41,"41049",9515,6961,6843,115,118,"MÁS PAÍS-AN",81
18,"18072",655,452,445,4,7,"MÁS PAÍS-AN",1
18,"18136",1778,1320,1284,14,36,"MÁS PAÍS-AN",11
29,"29003",916,677,666,4,11,"MÁS PAÍS-AN",10
41,"41081",30061,21488,21059,331,429,"MÁS PAÍS-AN",471
29,"29086",770,479,476,5,3,"MÁS PAÍS-AN",2
18,"18177",375,235,231,5,4,"MÁS PAÍS-AN",2
18,"18141",382,240,237,0,3,"MÁS PAÍS-AN",0
29,"29006",679,461,452,4,9,"MÁS PAÍS-AN",5
29,"29014",218,122,121,3,1,"MÁS PAÍS-AN",4
18,"18046",1738,1042,1023,7,19,"MÁS PAÍS-AN",8
18,"18027",2598,1730,1706,12,24,"MÁS PAÍS-AN",10
29,"29053",1717,1133,1116,12,17,"MÁS PAÍS-AN",27
29,"29070",43686,27672,27323,290,349,"MÁS PAÍS-AN",602
18,"18078",714,546,538,5,8,"MÁS PAÍS-AN",7
29,"29016",253,196,194,0,2,"MÁS PAÍS-AN",5
18,"18134",6104,4049,3972,39,77,"MÁS PAÍS-AN",84
18,"18012",2114,1519,1492,9,27,"MÁS PAÍS-AN",10
18,"18106",413,270,261,3,9,"MÁS PAÍS-AN",1
11,"11027",68774,45571,45137,567,434,"MÁS PAÍS-AN",949
18,"18145",10909,7925,7780,67,145,"MÁS PAÍS-AN",206
41,"41054",719,562,546,3,16,"MÁS PAÍS-AN",9
41,"41069",29669,20316,19848,381,468,"MÁS PAÍS-AN",313
29,"29054",42538,28080,27814,225,266,"MÁS PAÍS-AN",467
18,"18044",161,91,91,0,0,"MÁS PAÍS-AN",0
11,"11020",166773,111205,109956,1580,1249,"MÁS PAÍS-AN",2181
29,"29035",1478,1054,1040,3,14,"MÁS PAÍS-AN",14
29,"29039",2759,1900,1860,23,40,"MÁS PAÍS-AN",35
18,"18101",9449,6688,6568,77,120,"MÁS PAÍS-AN",155
41,"41053",21693,15843,15379,171,464,"MÁS PAÍS-AN",231
18,"18079",3466,2391,2333,22,58,"MÁS PAÍS-AN",22
29,"29074",771,561,555,1,6,"MÁS PAÍS-AN",5
29,"29057",330,222,218,2,4,"MÁS PAÍS-AN",0
41,"41089",6621,4650,4549,64,101,"MÁS PAÍS-AN",67
29,"29901",44757,29291,28960,307,331,"MÁS PAÍS-AN",634
41,"41090",3489,2560,2467,27,93,"MÁS PAÍS-AN",18
18,"18022",13875,8948,8764,98,184,"MÁS PAÍS-AN",169
41,"41080",1231,832,815,14,17,"MÁS PAÍS-AN",6
18,"18908",776,553,528,3,25,"MÁS PAÍS-AN",3
18,"18122",15994,11009,10773,109,236,"MÁS PAÍS-AN",102
29,"29088",2689,1817,1747,15,70,"MÁS PAÍS-AN",13
29,"29042",14586,9793,9649,95,144,"MÁS PAÍS-AN",165
29,"29038",18908,12122,11931,197,191,"MÁS PAÍS-AN",186
41,"41029",13520,9849,9663,134,186,"MÁS PAÍS-AN",185
18,"18120",266,204,204,4,0,"MÁS PAÍS-AN",3
18,"18057",5584,4042,3958,51,84,"MÁS PAÍS-AN",73
41,"41034",23576,15461,15214,264,247,"MÁS PAÍS-AN",236
18,"18912",1352,926,912,7,14,"MÁS PAÍS-AN",11
29,"29077",207,135,134,1,1,"MÁS PAÍS-AN",2
41,"41096",6178,4739,4655,60,84,"MÁS PAÍS-AN",152
41,"41004",57692,38578,37814,696,764,"MÁS PAÍS-AN",962
18,"18143",945,661,651,2,10,"MÁS PAÍS-AN",12
18,"18068",1638,1197,1167,12,30,"MÁS PAÍS-AN",24
11,"11003",1230,802,787,9,15,"MÁS PAÍS-AN",3
29,"29051",42179,27231,26724,282,507,"MÁS PAÍS-AN",478
29,"29067",431757,290824,287855,3289,2969,"MÁS PAÍS-AN",6223
18,"18089",14504,9854,9746,100,108,"MÁS PAÍS-AN",110
41,"41051",2317,1715,1688,4,27,"MÁS PAÍS-AN",21
41,"41031",1204,780,769,5,11,"MÁS PAÍS-AN",8
11,"11030",22999,14858,14586,207,272,"MÁS PAÍS-AN",280
18,"18119",1708,1264,1240,7,24,"MÁS PAÍS-AN",11
48,"48088",134,95,95,0,0,"MÁS PAÍS-CA",0
48,"48061",789,602,601,2,1,"MÁS PAÍS-CA",8
48,"48005",116,80,79,0,1,"MÁS PAÍS-CA",0
48,"48910",2811,1952,1942,11,10,"MÁS PAÍS-CA",13
48,"48904",3547,2563,2541,18,22,"MÁS PAÍS-CA",32
48,"48057",5730,4126,4115,14,11,"MÁS PAÍS-CA",9
48,"48070",527,357,355,0,2,"MÁS PAÍS-CA",0
48,"48064",608,461,461,0,0,"MÁS PAÍS-CA",4
48,"48019",3429,2424,2411,14,13,"MÁS PAÍS-CA",25
48,"48011",9640,6753,6722,41,31,"MÁS PAÍS-CA",101
48,"48909",201,158,157,0,1,"MÁS PAÍS-CA",0
48,"48032",5762,4287,4262,14,25,"MÁS PAÍS-CA",27
48,"48901",5160,3705,3684,16,21,"MÁS PAÍS-CA",62
48,"48043",4591,3337,3325,20,12,"MÁS PAÍS-CA",40
48,"48010",476,343,343,1,0,"MÁS PAÍS-CA",3
48,"48086",2024,1371,1358,5,13,"MÁS PAÍS-CA",10
48,"48076",288,211,211,1,0,"MÁS PAÍS-CA",1
48,"48085",10716,7707,7679,51,28,"MÁS PAÍS-CA",138
48,"48001",5899,4094,4074,19,20,"MÁS PAÍS-CA",49
48,"48063",354,256,252,1,4,"MÁS PAÍS-CA",1
48,"48907",343,274,273,0,1,"MÁS PAÍS-CA",1
48,"48056",980,731,728,3,3,"MÁS PAÍS-CA",9
48,"48082",37358,25328,25167,125,161,"MÁS PAÍS-CA",330
48,"48038",1151,829,829,1,0,"MÁS PAÍS-CA",8
48,"48066",344,246,246,2,0,"MÁS PAÍS-CA",1
48,"48072",965,730,724,3,6,"MÁS PAÍS-CA",1
48,"48089",3540,2561,2555,7,6,"MÁS PAÍS-CA",49
48,"48031",303,221,221,0,0,"MÁS PAÍS-CA",0
48,"48025",874,667,662,2,5,"MÁS PAÍS-CA",0
48,"48039",254,221,220,2,1,"MÁS PAÍS-CA",3
48,"48091",1078,758,757,5,1,"MÁS PAÍS-CA",2
48,"48905",2496,1778,1766,12,12,"MÁS PAÍS-CA",20
48,"48009",774,585,578,0,7,"MÁS PAÍS-CA",1
48,"48048",527,381,380,3,1,"MÁS PAÍS-CA",5
48,"48040",1303,933,926,7,7,"MÁS PAÍS-CA",11
48,"48065",3285,2341,2326,8,15,"MÁS PAÍS-CA",18
48,"48074",3275,2308,2295,11,13,"MÁS PAÍS-CA",24
48,"48046",12626,9300,9250,31,50,"MÁS PAÍS-CA",61
48,"48028",682,551,548,3,3,"MÁS PAÍS-CA",2
48,"48045",5207,3851,3817,9,34,"MÁS PAÍS-CA",47
48,"48092",872,614,608,3,6,"MÁS PAÍS-CA",1
48,"48073",6827,4614,4591,38,23,"MÁS PAÍS-CA",12
48,"48051",220,151,150,0,1,"MÁS PAÍS-CA",2
48,"48024",1000,761,752,1,9,"MÁS PAÍS-CA",2
48,"48055",2603,1833,1820,14,13,"MÁS PAÍS-CA",11
48,"48083",6934,4800,4765,21,35,"MÁS PAÍS-CA",48
48,"48016",5471,3964,3935,31,29,"MÁS PAÍS-CA",80
48,"48053",926,704,702,6,2,"MÁS PAÍS-CA",7
48,"48913",1236,899,890,8,9,"MÁS PAÍS-CA",2
48,"48087",437,335,332,0,3,"MÁS PAÍS-CA",0
48,"48902",18987,12762,12670,88,92,"MÁS PAÍS-CA",156
48,"48084",21780,14368,14271,79,97,"MÁS PAÍS-CA",202
48,"48041",687,548,547,4,1,"MÁS PAÍS-CA",6
48,"48007",389,243,243,0,0,"MÁS PAÍS-CA",2
48,"48034",12623,8789,8711,76,78,"MÁS PAÍS-CA",142
48,"48014",1229,845,843,8,2,"MÁS PAÍS-CA",14
48,"48075",2066,1524,1508,9,16,"MÁS PAÍS-CA",12
48,"48002",7791,5510,5471,42,39,"MÁS PAÍS-CA",61
48,"48052",1562,1220,1210,5,10,"MÁS PAÍS-CA",8
48,"48078",37858,25959,25819,157,140,"MÁS PAÍS-CA",356
48,"48026",1132,834,832,2,2,"MÁS PAÍS-CA",10
48,"48097",1314,886,882,6,4,"MÁS PAÍS-CA",12
48,"48036",24015,16501,16425,83,76,"MÁS PAÍS-CA",201
48,"48017",13121,8929,8886,45,43,"MÁS PAÍS-CA",49
48,"48079",397,289,287,1,2,"MÁS PAÍS-CA",3
48,"48044",61957,45253,45063,299,190,"MÁS PAÍS-CA",635
48,"48912",2321,1684,1670,8,14,"MÁS PAÍS-CA",17
48,"48058",947,682,679,2,3,"MÁS PAÍS-CA",4
48,"48914",332,276,275,0,1,"MÁS PAÍS-CA",0
48,"48042",1359,1055,1045,7,10,"MÁS PAÍS-CA",15
48,"48059",402,299,297,0,2,"MÁS PAÍS-CA",3
48,"48067",1133,810,805,0,5,"MÁS PAÍS-CA",4
48,"48095",2324,1568,1555,13,13,"MÁS PAÍS-CA",22
48,"48071",6013,4240,4205,23,35,"MÁS PAÍS-CA",39
48,"48035",406,314,314,0,0,"MÁS PAÍS-CA",2
48,"48081",1903,1455,1447,7,8,"MÁS PAÍS-CA",11
48,"48093",891,669,666,5,3,"MÁS PAÍS-CA",4
48,"48021",1325,891,888,3,3,"MÁS PAÍS-CA",6
48,"48080",9916,6849,6793,44,56,"MÁS PAÍS-CA",89
48,"48090",6004,4305,4254,28,51,"MÁS PAÍS-CA",47
48,"48094",3121,2201,2188,7,13,"MÁS PAÍS-CA",13
48,"48906",736,550,548,2,2,"MÁS PAÍS-CA",0
48,"48903",1800,1358,1353,4,5,"MÁS PAÍS-CA",18
48,"48077",3366,2483,2467,9,16,"MÁS PAÍS-CA",31
48,"48004",326,245,245,1,0,"MÁS PAÍS-CA",0
48,"48023",579,451,448,0,3,"MÁS PAÍS-CA",3
48,"48054",25063,17705,17597,122,108,"MÁS PAÍS-CA",272
48,"48062",295,236,236,0,0,"MÁS PAÍS-CA",1
48,"48030",591,449,447,2,2,"MÁS PAÍS-CA",2
48,"48047",147,105,105,2,0,"MÁS PAÍS-CA",0
48,"48068",1534,1154,1149,1,5,"MÁS PAÍS-CA",5
48,"48018",854,563,560,5,3,"MÁS PAÍS-CA",0
48,"48060",3625,2429,2418,12,11,"MÁS PAÍS-CA",6
48,"48008",609,415,407,4,8,"MÁS PAÍS-CA",2
48,"48020",272771,184893,183922,1227,971,"MÁS PAÍS-CA",3023
48,"48096",6516,4862,4816,33,46,"MÁS PAÍS-CA",27
48,"48069",13131,9211,9162,55,49,"MÁS PAÍS-CA",87
48,"48012",2057,1610,1600,1,10,"MÁS PAÍS-CA",11
48,"48003",14518,10375,10310,49,65,"MÁS PAÍS-CA",107
48,"48013",79353,53591,53205,331,386,"MÁS PAÍS-CA",844
48,"48908",250,212,210,1,2,"MÁS PAÍS-CA",0
48,"48037",696,497,485,0,12,"MÁS PAÍS-CA",3
48,"48006",307,242,240,3,2,"MÁS PAÍS-CA",1
48,"48027",22745,16240,16158,74,82,"MÁS PAÍS-CA",174
48,"48049",543,415,414,1,1,"MÁS PAÍS-CA",0
48,"48029",8681,6057,6027,41,30,"MÁS PAÍS-CA",129
48,"48050",188,141,141,0,0,"MÁS PAÍS-CA",0
48,"48022",2305,1434,1425,11,9,"MÁS PAÍS-CA",3
48,"48033",217,162,162,1,0,"MÁS PAÍS-CA",2
48,"48915",339,245,243,0,2,"MÁS PAÍS-CA",0
48,"48015",33077,22441,22295,145,146,"MÁS PAÍS-CA",278
48,"48911",381,303,302,1,1,"MÁS PAÍS-CA",0
33,"33031",33775,20484,20184,276,300,"MÁS PAÍS-EQ",396
36,"36008",21845,14553,14373,138,180,"MÁS PAÍS-EQ",413
35,"35004",41975,20773,20602,156,171,"MÁS PAÍS-EQ",330
33,"33059",4359,2651,2625,33,26,"MÁS PAÍS-EQ",28
15,"15064",2103,1458,1447,20,11,"MÁS PAÍS-EQ",22
36,"36007",1610,1047,1016,5,31,"MÁS PAÍS-EQ",8
28,"28058",141836,104142,103011,896,1131,"MÁS PAÍS-EQ",5111
33,"33040",4556,2837,2784,58,53,"MÁS PAÍS-EQ",57
36,"36019",1462,916,908,8,8,"MÁS PAÍS-EQ",7
30,"30031",497,387,382,1,5,"MÁS PAÍS-EQ",3
38,"38032",13579,8941,8880,92,61,"MÁS PAÍS-EQ",157
35,"35009",20229,13378,13201,95,177,"MÁS PAÍS-EQ",150
28,"28145",2671,1927,1895,21,32,"MÁS PAÍS-EQ",90
38,"38007",1619,1053,1043,3,10,"MÁS PAÍS-EQ",2
30,"30038",15752,10987,10904,39,83,"MÁS PAÍS-EQ",158
15,"15039",1224,802,785,9,17,"MÁS PAÍS-EQ",7
35,"35016",300581,181532,179831,1458,1701,"MÁS PAÍS-EQ",3456
28,"28064",125,98,95,3,3,"MÁS PAÍS-EQ",0
38,"38040",5482,3094,3060,14,34,"MÁS PAÍS-EQ",30
33,"33012",5085,3158,3142,27,16,"MÁS PAÍS-EQ",50
35,"35032",3331,2293,2252,23,41,"MÁS PAÍS-EQ",45
15,"15024",4314,2859,2790,44,69,"MÁS PAÍS-EQ",20
38,"38048",3952,2543,2519,22,24,"MÁS PAÍS-EQ",26
28,"28008",2008,1333,1323,7,10,"MÁS PAÍS-EQ",38
33,"33021",4304,2643,2610,32,33,"MÁS PAÍS-EQ",45
38,"38024",15316,9131,9005,60,126,"MÁS PAÍS-EQ",81
15,"15045",3610,2057,2044,15,13,"MÁS PAÍS-EQ",15
15,"15091",1097,705,686,17,19,"MÁS PAÍS-EQ",6
28,"28038",5213,3801,3753,24,48,"MÁS PAÍS-EQ",256
33,"33041",7101,4564,4513,58,51,"MÁS PAÍS-EQ",84
15,"15084",3039,2002,1981,12,21,"MÁS PAÍS-EQ",9
28,"28080",49866,39769,39583,346,186,"MÁS PAÍS-EQ",1532
33,"33002",9403,5920,5839,69,81,"MÁS PAÍS-EQ",48
15,"15043",4944,3184,3117,27,67,"MÁS PAÍS-EQ",38
36,"36052",7266,4772,4685,43,87,"MÁS PAÍS-EQ",56
28,"28044",6266,4693,4642,36,51,"MÁS PAÍS-EQ",300
28,"28041",4805,3666,3634,38,32,"MÁS PAÍS-EQ",165
33,"33049",5973,3569,3518,48,51,"MÁS PAÍS-EQ",47
30,"30006",833,699,695,1,4,"MÁS PAÍS-EQ",8
30,"30025",5016,3663,3623,22,40,"MÁS PAÍS-EQ",35
36,"36026",19890,13041,12891,169,150,"MÁS PAÍS-EQ",237
30,"30020",6503,4521,4484,35,37,"MÁS PAÍS-EQ",30
15,"15077",8103,4893,4818,61,75,"MÁS PAÍS-EQ",37
28,"28175",940,740,730,2,10,"MÁS PAÍS-EQ",29
38,"38021",1609,900,876,2,24,"MÁS PAÍS-EQ",8
15,"15901",3334,1948,1928,27,20,"MÁS PAÍS-EQ",17
15,"15014",3836,2191,2158,27,33,"MÁS PAÍS-EQ",16
33,"33027",752,412,405,11,7,"MÁS PAÍS-EQ",4
33,"33071",546,385,383,7,2,"MÁS PAÍS-EQ",3
35,"35029",4415,2498,2472,29,26,"MÁS PAÍS-EQ",35
28,"28159",589,455,447,4,8,"MÁS PAÍS-EQ",8
28,"28144",6525,5032,4987,39,45,"MÁS PAÍS-EQ",303
33,"33019",2844,1702,1680,11,22,"MÁS PAÍS-EQ",21
28,"28183",1162,823,813,9,10,"MÁS PAÍS-EQ",54
15,"15092",6220,3810,3756,30,54,"MÁS PAÍS-EQ",28
35,"35033",6393,4147,4072,38,75,"MÁS PAÍS-EQ",56
28,"28069",58,44,42,1,2,"MÁS PAÍS-EQ",2
35,"35024",14323,8360,8289,81,71,"MÁS PAÍS-EQ",179
28,"28169",1577,1214,1209,7,5,"MÁS PAÍS-EQ",55
33,"33048",132,86,85,1,1,"MÁS PAÍS-EQ",1
15,"15056",5615,3697,3646,31,51,"MÁS PAÍS-EQ",39
28,"28024",168,137,136,2,1,"MÁS PAÍS-EQ",7
33,"33028",1143,519,518,7,1,"MÁS PAÍS-EQ",5
30,"30041",14040,8999,8876,94,123,"MÁS PAÍS-EQ",133
30,"30016",153034,101232,100202,776,1030,"MÁS PAÍS-EQ",2055
33,"33065",1077,670,657,11,13,"MÁS PAÍS-EQ",16
36,"36041",13691,9022,8916,85,106,"MÁS PAÍS-EQ",176
38,"38045",3542,1825,1801,7,24,"MÁS PAÍS-EQ",13
33,"33061",344,174,174,1,0,"MÁS PAÍS-EQ",2
15,"15062",5597,3406,3360,16,46,"MÁS PAÍS-EQ",60
33,"33055",1485,992,966,14,26,"MÁS PAÍS-EQ",20
28,"28165",1917,1339,1321,2,18,"MÁS PAÍS-EQ",23
28,"28065",131232,100864,99883,846,981,"MÁS PAÍS-EQ",5676
15,"15007",3164,2081,2060,24,21,"MÁS PAÍS-EQ",10
30,"30001",4507,3357,3331,17,26,"MÁS PAÍS-EQ",23
33,"33005",1357,832,825,11,7,"MÁS PAÍS-EQ",5
28,"28066",7575,5771,5718,58,53,"MÁS PAÍS-EQ",218
15,"15059",10229,6900,6734,85,166,"MÁS PAÍS-EQ",76
15,"15023",6277,4021,3968,34,53,"MÁS PAÍS-EQ",54
38,"38042",3778,2410,2386,11,24,"MÁS PAÍS-EQ",16
33,"33072",1443,816,814,8,2,"MÁS PAÍS-EQ",8
28,"28022",37338,30620,30455,229,165,"MÁS PAÍS-EQ",1159
15,"15044",1194,806,788,7,18,"MÁS PAÍS-EQ",5
38,"38029",1475,752,744,10,8,"MÁS PAÍS-EQ",5
36,"36039",15609,10562,10341,102,221,"MÁS PAÍS-EQ",212
38,"38001",21069,10844,10777,63,67,"MÁS PAÍS-EQ",171
33,"33052",681,418,416,3,2,"MÁS PAÍS-EQ",1
28,"28087",3301,2539,2519,20,20,"MÁS PAÍS-EQ",120
30,"30004",1129,838,833,1,5,"MÁS PAÍS-EQ",1
28,"28179",1451,1043,1033,6,10,"MÁS PAÍS-EQ",56
28,"28062",306,232,227,0,5,"MÁS PAÍS-EQ",14
28,"28047",42984,30772,30486,270,286,"MÁS PAÍS-EQ",1677
15,"15053",7469,4622,4579,44,43,"MÁS PAÍS-EQ",83
15,"15083",1029,627,614,5,13,"MÁS PAÍS-EQ",4
28,"28168",1347,933,918,6,15,"MÁS PAÍS-EQ",39
15,"15038",2126,1312,1296,12,16,"MÁS PAÍS-EQ",11
33,"33069",3379,2249,2231,41,18,"MÁS PAÍS-EQ",42
15,"15054",31805,19579,19321,335,258,"MÁS PAÍS-EQ",453
36,"36025",2127,1235,1221,5,14,"MÁS PAÍS-EQ",12
28,"28161",52164,38607,38193,306,414,"MÁS PAÍS-EQ",1789
28,"28001",70,48,47,1,1,"MÁS PAÍS-EQ",2
38,"38901",1466,908,894,4,14,"MÁS PAÍS-EQ",7
36,"36050",7645,5137,5049,48,88,"MÁS PAÍS-EQ",93
28,"28082",6110,4622,4581,41,41,"MÁS PAÍS-EQ",358
36,"36057",238417,165843,164264,1641,1579,"MÁS PAÍS-EQ",3796
28,"28174",1858,1284,1273,1,11,"MÁS PAÍS-EQ",32
38,"38005",5646,3302,3283,24,19,"MÁS PAÍS-EQ",34
28,"28027",1215,836,826,8,10,"MÁS PAÍS-EQ",32
33,"33008",1679,1140,1133,10,7,"MÁS PAÍS-EQ",19
28,"28129",8589,6397,6338,46,59,"MÁS PAÍS-EQ",352
33,"33011",10563,5646,5578,92,68,"MÁS PAÍS-EQ",65
28,"28071",63,46,45,0,1,"MÁS PAÍS-EQ",3
28,"28903",35555,28875,28671,341,204,"MÁS PAÍS-EQ",1940
33,"33036",11281,7240,7153,96,87,"MÁS PAÍS-EQ",119
15,"15090",1115,711,701,19,10,"MÁS PAÍS-EQ",3
33,"33009",878,545,542,4,3,"MÁS PAÍS-EQ",12
28,"28011",417,295,292,6,3,"MÁS PAÍS-EQ",12
38,"38009",4315,2846,2817,27,29,"MÁS PAÍS-EQ",39
35,"35019",32830,18390,18243,87,147,"MÁS PAÍS-EQ",270
28,"28137",1770,1300,1289,6,11,"MÁS PAÍS-EQ",34
30,"30036",15432,10030,9879,64,151,"MÁS PAÍS-EQ",135
15,"15002",24040,16302,16117,183,185,"MÁS PAÍS-EQ",457
28,"28127",66793,53258,53009,458,249,"MÁS PAÍS-EQ",2281
28,"28135",998,712,703,2,9,"MÁS PAÍS-EQ",39
28,"28157",690,471,467,1,4,"MÁS PAÍS-EQ",8
35,"35018",13153,7742,7674,80,68,"MÁS PAÍS-EQ",168
33,"33018",2804,1830,1806,30,24,"MÁS PAÍS-EQ",31
38,"38043",19365,12355,12212,126,143,"MÁS PAÍS-EQ",154
28,"28162",2784,2143,2131,20,12,"MÁS PAÍS-EQ",108
36,"36016",1069,639,633,5,6,"MÁS PAÍS-EQ",2
28,"28177",10851,8550,8485,89,65,"MÁS PAÍS-EQ",394
33,"33076",12115,7519,7456,76,63,"MÁS PAÍS-EQ",129
35,"35023",11742,7787,7651,95,136,"MÁS PAÍS-EQ",105
38,"38053",3768,2275,2244,16,31,"MÁS PAÍS-EQ",18
33,"33013",430,294,292,1,2,"MÁS PAÍS-EQ",4
15,"15028",1392,944,936,4,8,"MÁS PAÍS-EQ",20
33,"33039",1646,1118,1110,8,8,"MÁS PAÍS-EQ",20
30,"30003",25200,16249,16120,159,129,"MÁS PAÍS-EQ",208
30,"30023",3874,2831,2788,18,43,"MÁS PAÍS-EQ",53
36,"36056",4932,3368,3310,24,58,"MÁS PAÍS-EQ",43
28,"28146",1806,1232,1218,3,14,"MÁS PAÍS-EQ",20
15,"15072",9434,6304,6228,48,76,"MÁS PAÍS-EQ",73
36,"36003",10023,6877,6789,66,88,"MÁS PAÍS-EQ",126
28,"28101",226,174,172,1,2,"MÁS PAÍS-EQ",12
36,"36053",5783,3955,3899,39,56,"MÁS PAÍS-EQ",57
36,"36060",30431,19909,19673,206,236,"MÁS PAÍS-EQ",408
15,"15021",5254,3473,3422,58,51,"MÁS PAÍS-EQ",62
15,"15017",19866,13497,13344,195,153,"MÁS PAÍS-EQ",363
33,"33077",1097,688,683,4,5,"MÁS PAÍS-EQ",3
15,"15049",1068,752,747,7,5,"MÁS PAÍS-EQ",3
28,"28007",127491,96937,96102,810,835,"MÁS PAÍS-EQ",4762
28,"28034",368,258,255,0,3,"MÁS PAÍS-EQ",6
15,"15068",4824,2976,2937,54,39,"MÁS PAÍS-EQ",23
15,"15070",8778,5802,5656,131,146,"MÁS PAÍS-EQ",141
28,"28100",4482,3146,3113,21,33,"MÁS PAÍS-EQ",153
30,"30012",9085,6704,6599,46,105,"MÁS PAÍS-EQ",83
15,"15029",5354,3082,3050,46,32,"MÁS PAÍS-EQ",27
36,"36040",2505,1597,1563,15,34,"MÁS PAÍS-EQ",17
15,"15005",25347,15441,15211,226,230,"MÁS PAÍS-EQ",406
33,"33075",244,125,122,3,3,"MÁS PAÍS-EQ",2
15,"15040",2647,1779,1762,15,17,"MÁS PAÍS-EQ",20
33,"33050",548,316,314,1,2,"MÁS PAÍS-EQ",6
30,"30040",686,564,560,1,4,"MÁS PAÍS-EQ",4
36,"36009",4401,2712,2649,33,63,"MÁS PAÍS-EQ",31
28,"28120",1220,910,897,5,13,"MÁS PAÍS-EQ",23
28,"28107",442,316,310,5,6,"MÁS PAÍS-EQ",12
28,"28110",2029,1498,1478,9,20,"MÁS PAÍS-EQ",33
36,"36001",2397,1674,1651,6,23,"MÁS PAÍS-EQ",14
36,"36042",18125,11975,11775,126,200,"MÁS PAÍS-EQ",204
38,"38047",1755,1132,1110,9,22,"MÁS PAÍS-EQ",5
36,"36031",563,426,420,7,6,"MÁS PAÍS-EQ",12
28,"28040",16741,10717,10604,79,113,"MÁS PAÍS-EQ",470
15,"15076",2490,1539,1517,25,22,"MÁS PAÍS-EQ",17
33,"33060",13991,8629,8481,109,148,"MÁS PAÍS-EQ",161
28,"28118",61,52,50,0,2,"MÁS PAÍS-EQ",2
30,"30032",2864,2154,2129,18,25,"MÁS PAÍS-EQ",26
38,"38039",11149,7375,7326,68,49,"MÁS PAÍS-EQ",92
38,"38037",12817,7582,7494,55,88,"MÁS PAÍS-EQ",73
28,"28070",105,80,80,3,0,"MÁS PAÍS-EQ",5
28,"28130",28569,22050,21799,187,251,"MÁS PAÍS-EQ",1220
33,"33058",1668,1050,1035,13,15,"MÁS PAÍS-EQ",24
33,"33033",9381,5848,5770,88,78,"MÁS PAÍS-EQ",94
30,"30901",10556,7862,7775,58,87,"MÁS PAÍS-EQ",151
38,"38026",33585,24091,23889,170,202,"MÁS PAÍS-EQ",273
33,"33042",4237,2862,2816,49,46,"MÁS PAÍS-EQ",51
28,"28068",11740,8615,8543,72,72,"MÁS PAÍS-EQ",390
15,"15018",1087,680,670,13,10,"MÁS PAÍS-EQ",4
35,"35031",7456,4938,4868,39,70,"MÁS PAÍS-EQ",83
28,"28152",16986,13444,13366,111,78,"MÁS PAÍS-EQ",674
35,"35022",51765,29309,29034,184,275,"MÁS PAÍS-EQ",460
30,"30042",2218,1645,1625,10,20,"MÁS PAÍS-EQ",20
28,"28122",578,404,401,1,3,"MÁS PAÍS-EQ",15
33,"33056",4850,3068,3044,25,24,"MÁS PAÍS-EQ",38
28,"28166",357,281,276,1,5,"MÁS PAÍS-EQ",9
33,"33022",802,460,452,4,8,"MÁS PAÍS-EQ",13
28,"28021",571,365,364,1,1,"MÁS PAÍS-EQ",20
28,"28055",944,636,627,4,9,"MÁS PAÍS-EQ",10
38,"38027",5581,3577,3533,22,44,"MÁS PAÍS-EQ",32
15,"15088",3396,2047,2022,22,25,"MÁS PAÍS-EQ",13
28,"28039",134,93,93,1,0,"MÁS PAÍS-EQ",6
28,"28167",8640,6564,6504,51,60,"MÁS PAÍS-EQ",357
28,"28019",1272,926,914,6,12,"MÁS PAÍS-EQ",29
15,"15075",12871,8751,8637,129,114,"MÁS PAÍS-EQ",183
36,"36038",66807,46235,45781,493,454,"MÁS PAÍS-EQ",993
33,"33015",1396,849,842,7,7,"MÁS PAÍS-EQ",15
33,"33066",42818,27780,27466,425,314,"MÁS PAÍS-EQ",699
28,"28111",629,479,475,2,4,"MÁS PAÍS-EQ",5
38,"38033",3593,2277,2242,15,35,"MÁS PAÍS-EQ",16
38,"38006",41593,20823,20624,127,199,"MÁS PAÍS-EQ",271
15,"15009",10605,7245,7133,101,112,"MÁS PAÍS-EQ",121
15,"15020",3568,2226,2217,19,9,"MÁS PAÍS-EQ",29
15,"15010",1805,1047,1031,19,16,"MÁS PAÍS-EQ",8
28,"28003",167,133,131,4,2,"MÁS PAÍS-EQ",9
28,"28023",5159,4052,4019,27,33,"MÁS PAÍS-EQ",258
28,"28171",4410,2921,2889,8,32,"MÁS PAÍS-EQ",65
15,"15041",9569,6362,6269,104,93,"MÁS PAÍS-EQ",77
28,"28155",487,374,369,0,5,"MÁS PAÍS-EQ",6
38,"38012",2286,1520,1510,8,10,"MÁS PAÍS-EQ",11
28,"28181",20801,16353,16243,97,110,"MÁS PAÍS-EQ",682
28,"28116",748,576,569,2,7,"MÁS PAÍS-EQ",21
38,"38004",4536,2914,2887,28,27,"MÁS PAÍS-EQ",39
28,"28048",514,386,384,4,2,"MÁS PAÍS-EQ",18
30,"30027",50067,36417,36074,242,343,"MÁS PAÍS-EQ",870
28,"28140",3156,2359,2331,16,28,"MÁS PAÍS-EQ",89
33,"33064",240,151,151,0,0,"MÁS PAÍS-EQ",5
28,"28113",36951,27912,27604,241,308,"MÁS PAÍS-EQ",1424
38,"38008",5699,3719,3669,26,50,"MÁS PAÍS-EQ",24
30,"30014",1587,1150,1134,4,16,"MÁS PAÍS-EQ",10
36,"36046",4073,2887,2818,31,69,"MÁS PAÍS-EQ",50
30,"30017",11428,8196,8113,44,83,"MÁS PAÍS-EQ",96
33,"33024",224741,151660,150461,1597,1199,"MÁS PAÍS-EQ",4032
35,"35010",3853,2224,2194,18,30,"MÁS PAÍS-EQ",47
15,"15036",56053,36487,36175,501,312,"MÁS PAÍS-EQ",708
38,"38003",1517,899,890,5,9,"MÁS PAÍS-EQ",8
33,"33046",480,334,329,0,5,"MÁS PAÍS-EQ",3
35,"35002",24229,15311,15133,101,178,"MÁS PAÍS-EQ",307
30,"30015",19344,13502,13347,107,155,"MÁS PAÍS-EQ",155
28,"28025",405,294,291,5,3,"MÁS PAÍS-EQ",5
28,"28102",880,639,621,7,18,"MÁS PAÍS-EQ",16
15,"15085",3176,2073,2047,29,26,"MÁS PAÍS-EQ",25
28,"28059",4516,3343,3299,30,44,"MÁS PAÍS-EQ",140
35,"35003",5644,2987,2943,20,44,"MÁS PAÍS-EQ",42
15,"15013",6324,4132,4083,35,49,"MÁS PAÍS-EQ",92
28,"28147",991,702,698,4,4,"MÁS PAÍS-EQ",27
38,"38034",3997,2687,2648,19,39,"MÁS PAÍS-EQ",21
28,"28092",153631,112460,111341,913,1119,"MÁS PAÍS-EQ",5788
28,"28178",1149,869,853,4,16,"MÁS PAÍS-EQ",33
28,"28125",3208,2275,2252,5,23,"MÁS PAÍS-EQ",98
15,"15034",2712,1605,1585,15,20,"MÁS PAÍS-EQ",15
33,"33070",3267,2211,2185,27,26,"MÁS PAÍS-EQ",46
28,"28016",79,55,55,0,0,"MÁS PAÍS-EQ",1
28,"28006",80903,60936,60508,482,428,"MÁS PAÍS-EQ",2596
35,"35001",4566,3148,3105,18,43,"MÁS PAÍS-EQ",38
28,"28119",2294,1760,1738,12,22,"MÁS PAÍS-EQ",89
28,"28043",6190,4031,3969,33,62,"MÁS PAÍS-EQ",100
28,"28017",1280,975,963,10,12,"MÁS PAÍS-EQ",47
15,"15052",4070,2512,2488,18,24,"MÁS PAÍS-EQ",25
28,"28096",20022,14440,14238,115,202,"MÁS PAÍS-EQ",620
38,"38015",4055,2635,2601,16,34,"MÁS PAÍS-EQ",16
15,"15066",3995,2746,2695,29,51,"MÁS PAÍS-EQ",30
36,"36059",4641,2844,2796,29,48,"MÁS PAÍS-EQ",21
15,"15032",3430,2243,2197,12,46,"MÁS PAÍS-EQ",32
38,"38023",126137,79423,78706,605,717,"MÁS PAÍS-EQ",1406
33,"33068",1031,518,510,5,8,"MÁS PAÍS-EQ",6
28,"28037",1570,1135,1123,4,12,"MÁS PAÍS-EQ",15
15,"15902",4507,2885,2837,34,48,"MÁS PAÍS-EQ",31
28,"28109",1651,1131,1116,8,15,"MÁS PAÍS-EQ",30
36,"36033",12305,8759,8597,67,162,"MÁS PAÍS-EQ",176
28,"28141",6284,4617,4570,42,47,"MÁS PAÍS-EQ",239
28,"28075",6020,4521,4469,37,52,"MÁS PAÍS-EQ",243
28,"28156",1082,788,784,3,4,"MÁS PAÍS-EQ",35
28,"28072",6176,4716,4673,44,43,"MÁS PAÍS-EQ",287
36,"36023",8258,5504,5384,44,120,"MÁS PAÍS-EQ",101
33,"33043",656,408,401,2,7,"MÁS PAÍS-EQ",3
30,"30902",8294,5235,5174,29,61,"MÁS PAÍS-EQ",97
35,"35015",10752,5289,5222,39,67,"MÁS PAÍS-EQ",73
33,"33004",65304,43473,43153,563,320,"MÁS PAÍS-EQ",1122
36,"36035",14615,10011,9880,103,131,"MÁS PAÍS-EQ",210
28,"28049",57814,44977,44559,385,418,"MÁS PAÍS-EQ",2551
30,"30037",19407,13252,13120,99,132,"MÁS PAÍS-EQ",149
33,"33029",315,145,142,1,3,"MÁS PAÍS-EQ",1
35,"35025",1752,1113,1095,5,18,"MÁS PAÍS-EQ",12
33,"33032",11056,7052,6905,109,147,"MÁS PAÍS-EQ",134
28,"28076",432,330,327,4,3,"MÁS PAÍS-EQ",19
38,"38014",1342,943,930,6,13,"MÁS PAÍS-EQ",6
33,"33057",1525,1005,988,17,17,"MÁS PAÍS-EQ",10
36,"36055",13585,9177,8986,115,191,"MÁS PAÍS-EQ",171
30,"30019",25911,17485,17264,157,221,"MÁS PAÍS-EQ",230
38,"38020",16057,9921,9809,66,112,"MÁS PAÍS-EQ",138
15,"15069",6604,4587,4520,55,67,"MÁS PAÍS-EQ",91
28,"28104",15528,12342,12234,103,108,"MÁS PAÍS-EQ",645
28,"28151",3274,2344,2310,16,34,"MÁS PAÍS-EQ",102
33,"33073",8096,4377,4320,59,57,"MÁS PAÍS-EQ",45
15,"15048",5087,3426,3383,40,43,"MÁS PAÍS-EQ",69
30,"30022",17108,11041,10851,100,190,"MÁS PAÍS-EQ",138
36,"36902",5028,3453,3396,19,57,"MÁS PAÍS-EQ",36
15,"15001",4697,3069,3022,45,47,"MÁS PAÍS-EQ",50
36,"36022",9046,5834,5720,37,114,"MÁS PAÍS-EQ",111
36,"36010",2825,1983,1947,19,36,"MÁS PAÍS-EQ",43
15,"15011",15501,9988,9846,78,142,"MÁS PAÍS-EQ",184
28,"28133",6146,4245,4180,25,65,"MÁS PAÍS-EQ",155
15,"15065",7134,4869,4785,53,84,"MÁS PAÍS-EQ",72
36,"36061",8613,5822,5718,56,104,"MÁS PAÍS-EQ",63
38,"38013",3011,1850,1829,14,21,"MÁS PAÍS-EQ",18
35,"35012",10862,5617,5568,40,49,"MÁS PAÍS-EQ",59
36,"36037",2538,1650,1625,12,25,"MÁS PAÍS-EQ",37
28,"28093",2177,1681,1658,11,23,"MÁS PAÍS-EQ",61
15,"15022",5580,3508,3472,47,36,"MÁS PAÍS-EQ",42
38,"38051",7328,5017,4969,32,48,"MÁS PAÍS-EQ",42
28,"28045",35523,26213,25966,212,247,"MÁS PAÍS-EQ",1446
28,"28090",9252,7216,7153,58,63,"MÁS PAÍS-EQ",422
15,"15074",3902,2629,2589,23,40,"MÁS PAÍS-EQ",31
28,"28052",3961,2700,2659,14,41,"MÁS PAÍS-EQ",65
30,"30007",6474,4354,4317,26,37,"MÁS PAÍS-EQ",59
28,"28036",2699,1977,1957,20,20,"MÁS PAÍS-EQ",84
36,"36006",11502,8057,7927,53,130,"MÁS PAÍS-EQ",116
28,"28154",5570,3999,3961,29,38,"MÁS PAÍS-EQ",147
30,"30039",20442,13299,13167,84,132,"MÁS PAÍS-EQ",188
28,"28114",141,97,97,0,0,"MÁS PAÍS-EQ",2
28,"28164",3230,2371,2345,28,26,"MÁS PAÍS-EQ",88
30,"30002",9701,6794,6717,27,77,"MÁS PAÍS-EQ",55
36,"36901",4154,3094,3029,21,65,"MÁS PAÍS-EQ",57
33,"33051",6787,4318,4268,48,50,"MÁS PAÍS-EQ",54
28,"28050",4406,3202,3167,29,35,"MÁS PAÍS-EQ",117
15,"15031",23868,16113,15954,207,159,"MÁS PAÍS-EQ",447
36,"36028",4049,2783,2739,22,44,"MÁS PAÍS-EQ",21
33,"33007",1382,804,795,4,9,"MÁS PAÍS-EQ",9
28,"28010",10649,8167,8098,76,69,"MÁS PAÍS-EQ",456
38,"38046",9267,6652,6594,55,58,"MÁS PAÍS-EQ",113
28,"28054",11943,8800,8731,72,69,"MÁS PAÍS-EQ",437
35,"35008",6214,4193,4143,33,50,"MÁS PAÍS-EQ",56
36,"36029",16126,10936,10771,96,165,"MÁS PAÍS-EQ",247
33,"33030",876,632,630,8,2,"MÁS PAÍS-EQ",7
15,"15055",4446,2829,2762,50,67,"MÁS PAÍS-EQ",45
28,"28033",4177,2972,2936,20,36,"MÁS PAÍS-EQ",104
35,"35026",83172,48751,48109,449,642,"MÁS PAÍS-EQ",706
28,"28089",3856,2866,2829,21,37,"MÁS PAÍS-EQ",113
36,"36032",3527,2407,2369,24,38,"MÁS PAÍS-EQ",22
30,"30033",10377,7330,7215,59,115,"MÁS PAÍS-EQ",96
38,"38050",2417,1288,1273,9,15,"MÁS PAÍS-EQ",10
35,"35005",1009,680,668,2,12,"MÁS PAÍS-EQ",9
33,"33045",4359,2819,2787,32,32,"MÁS PAÍS-EQ",56
15,"15050",1732,931,917,15,14,"MÁS PAÍS-EQ",9
15,"15012",3603,2484,2422,20,62,"MÁS PAÍS-EQ",23
28,"28013",41661,29431,29168,241,263,"MÁS PAÍS-EQ",1279
28,"28031",2129,1501,1486,8,15,"MÁS PAÍS-EQ",26
28,"28015",20885,16237,16104,134,133,"MÁS PAÍS-EQ",771
28,"28061",22757,17091,16965,115,126,"MÁS PAÍS-EQ",966
36,"36027",4401,2940,2781,20,159,"MÁS PAÍS-EQ",41
33,"33062",385,194,187,4,7,"MÁS PAÍS-EQ",2
33,"33006",1476,862,857,9,5,"MÁS PAÍS-EQ",10
38,"38019",13884,7888,7809,49,79,"MÁS PAÍS-EQ",59
30,"30018",8399,6226,6148,28,78,"MÁS PAÍS-EQ",71
36,"36021",12180,8188,8058,115,130,"MÁS PAÍS-EQ",156
35,"35034",8392,3946,3908,27,38,"MÁS PAÍS-EQ",92
30,"30043",25449,18839,18477,180,362,"MÁS PAÍS-EQ",317
28,"28112",160,129,129,0,0,"MÁS PAÍS-EQ",1
28,"28009",14593,11026,10913,73,113,"MÁS PAÍS-EQ",495
28,"28094",988,711,707,5,4,"MÁS PAÍS-EQ",46
38,"38011",21655,13974,13831,106,143,"MÁS PAÍS-EQ",220
15,"15082",15446,10821,10687,130,134,"MÁS PAÍS-EQ",229
28,"28901",890,624,618,5,6,"MÁS PAÍS-EQ",39
30,"30013",7421,5171,5094,32,77,"MÁS PAÍS-EQ",51
28,"28121",209,156,152,1,4,"MÁS PAÍS-EQ",5
28,"28029",576,443,443,4,0,"MÁS PAÍS-EQ",24
33,"33023",3249,2127,2097,30,30,"MÁS PAÍS-EQ",33
28,"28148",89174,65500,64784,566,716,"MÁS PAÍS-EQ",3009
28,"28097",126,87,87,2,0,"MÁS PAÍS-EQ",4
28,"28124",73,51,50,0,1,"MÁS PAÍS-EQ",2
38,"38049",2690,1406,1389,27,17,"MÁS PAÍS-EQ",17
15,"15089",4299,2924,2887,41,37,"MÁS PAÍS-EQ",47
28,"28085",4194,3126,3091,24,35,"MÁS PAÍS-EQ",142
28,"28074",141137,106626,105602,885,1024,"MÁS PAÍS-EQ",5798
28,"28088",296,196,191,1,5,"MÁS PAÍS-EQ",9
38,"38018",4466,2867,2821,21,46,"MÁS PAÍS-EQ",23
33,"33014",8735,5744,5689,67,55,"MÁS PAÍS-EQ",133
15,"15051",4545,2978,2945,47,33,"MÁS PAÍS-EQ",71
15,"15067",7933,5329,5282,43,47,"MÁS PAÍS-EQ",95
38,"38016",1174,595,589,2,6,"MÁS PAÍS-EQ",7
28,"28095",1719,1236,1226,5,10,"MÁS PAÍS-EQ",28
28,"28128",453,334,331,1,3,"MÁS PAÍS-EQ",6
33,"33054",1601,1025,1010,17,15,"MÁS PAÍS-EQ",16
38,"38017",30964,16228,16102,108,126,"MÁS PAÍS-EQ",247
30,"30005",30268,20979,20778,148,201,"MÁS PAÍS-EQ",346
28,"28131",13510,9647,9544,89,103,"MÁS PAÍS-EQ",493
28,"28182",203,167,163,1,4,"MÁS PAÍS-EQ",7
36,"36047",2248,1379,1363,11,16,"MÁS PAÍS-EQ",4
28,"28126",50,36,36,0,0,"MÁS PAÍS-EQ",0
30,"30028",6390,4054,3973,25,81,"MÁS PAÍS-EQ",76
15,"15046",6157,3965,3865,23,100,"MÁS PAÍS-EQ",36
28,"28063",252,188,187,1,1,"MÁS PAÍS-EQ",14
28,"28136",693,538,533,2,5,"MÁS PAÍS-EQ",24
38,"38010",3969,2463,2418,11,45,"MÁS PAÍS-EQ",26
36,"36054",11107,7027,6894,57,133,"MÁS PAÍS-EQ",110
36,"36045",24459,16966,16735,124,231,"MÁS PAÍS-EQ",331
36,"36049",6990,4877,4787,40,90,"MÁS PAÍS-EQ",106
28,"28902",521,394,389,3,5,"MÁS PAÍS-EQ",37
38,"38030",1962,1332,1318,9,14,"MÁS PAÍS-EQ",9
33,"33035",11214,7359,7303,102,56,"MÁS PAÍS-EQ",154
15,"15058",28761,20250,20098,261,152,"MÁS PAÍS-EQ",544
30,"30024",60389,42200,41831,281,369,"MÁS PAÍS-EQ",555
28,"28020",193,96,93,0,3,"MÁS PAÍS-EQ",13
28,"28115",62612,50619,50431,399,188,"MÁS PAÍS-EQ",2087
36,"36036",2546,1763,1742,14,21,"MÁS PAÍS-EQ",31
28,"28083",9836,7278,7206,64,72,"MÁS PAÍS-EQ",333
36,"36043",4696,3038,3003,21,35,"MÁS PAÍS-EQ",38
33,"33017",2969,1787,1768,38,19,"MÁS PAÍS-EQ",34
30,"30034",1067,818,801,8,17,"MÁS PAÍS-EQ",7
36,"36051",14358,9408,9255,86,153,"MÁS PAÍS-EQ",144
15,"15033",2421,1673,1655,6,18,"MÁS PAÍS-EQ",18
15,"15073",21725,13008,12820,126,188,"MÁS PAÍS-EQ",259
28,"28078",40,38,38,0,0,"MÁS PAÍS-EQ",2
28,"28106",78872,54111,53443,412,668,"MÁS PAÍS-EQ",2687
36,"36015",4079,2653,2606,29,47,"MÁS PAÍS-EQ",34
15,"15035",11189,7256,7165,104,91,"MÁS PAÍS-EQ",130
28,"28158",694,501,495,2,6,"MÁS PAÍS-EQ",25
28,"28091",5491,3709,3650,20,59,"MÁS PAÍS-EQ",102
15,"15086",2760,1829,1810,26,19,"MÁS PAÍS-EQ",22
36,"36020",2172,1435,1418,19,17,"MÁS PAÍS-EQ",10
28,"28123",62178,49883,49515,397,368,"MÁS PAÍS-EQ",4131
28,"28150",3191,2423,2401,13,22,"MÁS PAÍS-EQ",88
28,"28067",4416,3359,3311,18,48,"MÁS PAÍS-EQ",158
35,"35006",31373,20764,20476,189,288,"MÁS PAÍS-EQ",359
35,"35020",5941,3740,3702,27,38,"MÁS PAÍS-EQ",29
36,"36024",16335,11431,11256,99,175,"MÁS PAÍS-EQ",99
30,"30009",12728,9487,9365,46,122,"MÁS PAÍS-EQ",116
35,"35007",517,347,345,2,2,"MÁS PAÍS-EQ",2
28,"28173",523,384,381,1,3,"MÁS PAÍS-EQ",11
28,"28086",5446,3643,3600,19,43,"MÁS PAÍS-EQ",162
15,"15004",4924,3333,3292,38,41,"MÁS PAÍS-EQ",76
35,"35014",11962,5994,5888,60,106,"MÁS PAÍS-EQ",134
15,"15025",986,529,517,6,12,"MÁS PAÍS-EQ",3
35,"35013",6593,4596,4516,47,80,"MÁS PAÍS-EQ",44
28,"28028",1836,1374,1363,3,11,"MÁS PAÍS-EQ",109
38,"38025",7065,4657,4590,34,67,"MÁS PAÍS-EQ",46
15,"15008",5646,3859,3836,52,23,"MÁS PAÍS-EQ",87
28,"28057",1556,1155,1141,7,14,"MÁS PAÍS-EQ",46
28,"28030",1832,1319,1297,13,22,"MÁS PAÍS-EQ",77
30,"30029",12122,8231,8125,54,106,"MÁS PAÍS-EQ",133
36,"36048",5248,3429,3378,25,51,"MÁS PAÍS-EQ",54
38,"38044",2215,1270,1257,5,13,"MÁS PAÍS-EQ",4
38,"38052",1283,806,794,3,12,"MÁS PAÍS-EQ",5
15,"15081",976,713,695,4,18,"MÁS PAÍS-EQ",8
15,"15006",5159,3008,2960,44,48,"MÁS PAÍS-EQ",45
35,"35028",10156,5483,5425,56,58,"MÁS PAÍS-EQ",98
28,"28172",9915,7715,7652,60,63,"MÁS PAÍS-EQ",344
28,"28108",3736,2681,2652,21,29,"MÁS PAÍS-EQ",162
15,"15057",12077,8109,8018,83,91,"MÁS PAÍS-EQ",131
28,"28053",6956,5475,5414,44,61,"MÁS PAÍS-EQ",277
28,"28018",4121,3174,3151,22,23,"MÁS PAÍS-EQ",162
33,"33078",127,81,81,0,0,"MÁS PAÍS-EQ",0
30,"30035",19432,13174,13013,114,161,"MÁS PAÍS-EQ",236
30,"30011",4702,3390,3324,8,66,"MÁS PAÍS-EQ",33
15,"15093",4012,2413,2386,24,27,"MÁS PAÍS-EQ",20
33,"33026",8201,5014,4974,74,40,"MÁS PAÍS-EQ",71
15,"15019",25981,15866,15672,207,194,"MÁS PAÍS-EQ",211
33,"33074",3366,2042,2011,35,31,"MÁS PAÍS-EQ",33
28,"28035",1404,981,966,4,15,"MÁS PAÍS-EQ",34
28,"28046",4824,3726,3707,33,19,"MÁS PAÍS-EQ",241
35,"35027",10502,6831,6750,67,81,"MÁS PAÍS-EQ",119
33,"33047",1068,771,759,9,12,"MÁS PAÍS-EQ",5
33,"33025",8956,5493,5453,81,40,"MÁS PAÍS-EQ",130
33,"33020",12981,8550,8453,120,97,"MÁS PAÍS-EQ",184
28,"28180",5317,4011,3959,35,52,"MÁS PAÍS-EQ",114
35,"35030",10046,5584,5505,44,79,"MÁS PAÍS-EQ",65
15,"15071",7780,4937,4848,34,89,"MÁS PAÍS-EQ",110
33,"33037",33074,20693,20412,259,281,"MÁS PAÍS-EQ",372
28,"28014",34522,25016,24748,229,268,"MÁS PAÍS-EQ",1051
35,"35011",24859,15025,14833,149,192,"MÁS PAÍS-EQ",246
33,"33063",375,269,267,5,2,"MÁS PAÍS-EQ",3
36,"36005",8105,5258,5152,54,106,"MÁS PAÍS-EQ",77
36,"36004",10109,6611,6502,79,109,"MÁS PAÍS-EQ",145
36,"36034",3299,2155,2132,15,23,"MÁS PAÍS-EQ",16
28,"28056",946,664,660,2,4,"MÁS PAÍS-EQ",52
28,"28051",1644,1231,1220,9,11,"MÁS PAÍS-EQ",57
36,"36030",3921,2516,2484,31,32,"MÁS PAÍS-EQ",16
28,"28073",12707,9198,9080,94,118,"MÁS PAÍS-EQ",358
15,"15061",5149,3221,3168,44,53,"MÁS PAÍS-EQ",39
28,"28042",1261,918,908,9,10,"MÁS PAÍS-EQ",40
28,"28138",60,43,42,0,1,"MÁS PAÍS-EQ",3
28,"28153",816,547,544,3,3,"MÁS PAÍS-EQ",44
33,"33044",177059,121380,120421,1543,959,"MÁS PAÍS-EQ",2895
36,"36018",3033,1951,1926,9,25,"MÁS PAÍS-EQ",11
36,"36058",4957,3043,2994,55,49,"MÁS PAÍS-EQ",49
30,"30010",6852,5161,5106,25,55,"MÁS PAÍS-EQ",45
28,"28005",136518,101397,100485,871,912,"MÁS PAÍS-EQ",4442
36,"36013",2216,1298,1290,18,8,"MÁS PAÍS-EQ",12
38,"38036",6857,4170,4090,37,80,"MÁS PAÍS-EQ",66
28,"28084",16243,11562,11408,90,154,"MÁS PAÍS-EQ",571
15,"15079",1437,887,868,8,19,"MÁS PAÍS-EQ",5
15,"15042",2928,1879,1853,11,26,"MÁS PAÍS-EQ",32
28,"28132",12197,8622,8537,75,85,"MÁS PAÍS-EQ",343
15,"15087",5710,3436,3392,31,44,"MÁS PAÍS-EQ",61
15,"15015",2877,1845,1821,26,24,"MÁS PAÍS-EQ",32
15,"15060",5871,4044,3978,58,66,"MÁS PAÍS-EQ",69
15,"15078",78810,55693,55183,569,510,"MÁS PAÍS-EQ",1375
28,"28026",6767,5058,5024,27,34,"MÁS PAÍS-EQ",240
15,"15027",1563,1159,1140,23,19,"MÁS PAÍS-EQ",8
38,"38038",165135,101564,100807,709,757,"MÁS PAÍS-EQ",1804
33,"33053",1078,602,599,10,3,"MÁS PAÍS-EQ",3
30,"30026",16345,10049,9914,84,135,"MÁS PAÍS-EQ",121
33,"33067",751,543,538,7,5,"MÁS PAÍS-EQ",19
15,"15037",4026,2375,2349,10,26,"MÁS PAÍS-EQ",28
28,"28004",6618,4502,4457,28,45,"MÁS PAÍS-EQ",134
36,"36017",17364,11771,11598,123,173,"MÁS PAÍS-EQ",134
15,"15080",1637,1009,992,11,17,"MÁS PAÍS-EQ",5
28,"28099",1950,1409,1404,16,5,"MÁS PAÍS-EQ",47
28,"28002",3250,2261,2243,14,18,"MÁS PAÍS-EQ",105
33,"33010",1722,1085,1069,15,16,"MÁS PAÍS-EQ",13
33,"33001",1475,758,753,15,5,"MÁS PAÍS-EQ",34
28,"28163",429,332,326,0,6,"MÁS PAÍS-EQ",20
28,"28012",929,707,698,7,9,"MÁS PAÍS-EQ",17
28,"28143",77,58,58,0,0,"MÁS PAÍS-EQ",1
36,"36002",3049,1994,1968,22,26,"MÁS PAÍS-EQ",17
38,"38022",18630,11420,11284,87,136,"MÁS PAÍS-EQ",72
35,"35017",27498,15513,15240,121,273,"MÁS PAÍS-EQ",254
30,"30008",14560,9974,9840,79,134,"MÁS PAÍS-EQ",252
33,"33038",2218,1501,1477,17,24,"MÁS PAÍS-EQ",25
36,"36044",2527,1535,1499,12,36,"MÁS PAÍS-EQ",26
28,"28170",2495,1714,1695,13,19,"MÁS PAÍS-EQ",33
15,"15016",4558,2747,2705,16,42,"MÁS PAÍS-EQ",17
15,"15030",199701,137611,136590,1540,1021,"MÁS PAÍS-EQ",3488
38,"38002",971,577,570,8,7,"MÁS PAÍS-EQ",4
38,"38031",29301,20926,20701,157,225,"MÁS PAÍS-EQ",210
33,"33003",603,322,317,7,5,"MÁS PAÍS-EQ",0
15,"15003",1675,1029,1020,9,9,"MÁS PAÍS-EQ",3
30,"30030",321454,235061,233183,1744,1878,"MÁS PAÍS-EQ",5622
28,"28060",1585,1160,1146,5,14,"MÁS PAÍS-EQ",40
36,"36014",1867,1265,1243,16,22,"MÁS PAÍS-EQ",16
28,"28149",6298,4751,4699,35,52,"MÁS PAÍS-EQ",216
28,"28134",63936,48022,47631,421,391,"MÁS PAÍS-EQ",2334
38,"38035",10518,5870,5819,37,51,"MÁS PAÍS-EQ",78
30,"30021",9498,6251,6193,36,58,"MÁS PAÍS-EQ",59
28,"28079",2384271,1765443,1753633,13854,11810,"MÁS PAÍS-EQ",110841
38,"38028",22144,14312,14174,89,138,"MÁS PAÍS-EQ",189
28,"28160",8709,6507,6460,62,47,"MÁS PAÍS-EQ",302
35,"35021",15072,9791,9696,80,95,"MÁS PAÍS-EQ",213
28,"28032",5090,3716,3675,22,41,"MÁS PAÍS-EQ",154
38,"38041",7025,4729,4684,42,45,"MÁS PAÍS-EQ",82
28,"28117",99,87,86,0,1,"MÁS PAÍS-EQ",1
15,"15047",2256,1429,1405,25,24,"MÁS PAÍS-EQ",13
33,"33016",18848,12845,12737,173,108,"MÁS PAÍS-EQ",330
33,"33034",9979,5937,5873,64,64,"MÁS PAÍS-EQ",97
28,"28176",13980,10765,10701,72,64,"MÁS PAÍS-EQ",413
51,"51001",59820,33614,33265,323,349,"MDyC",819
3,"3032",97,82,82,0,0,"MÉS COMPROM",4
3,"3089",9496,6617,6484,51,133,"MÉS COMPROM",227
3,"3098",523,382,378,1,4,"MÉS COMPROM",28
3,"3111",5579,3777,3737,23,40,"MÉS COMPROM",35
46,"46231",2403,1670,1652,11,18,"MÉS COMPROM",245
12,"12050",1226,904,891,3,13,"MÉS COMPROM",52
3,"3131",176,129,126,1,3,"MÉS COMPROM",11
46,"46015",7519,5575,5532,34,43,"MÉS COMPROM",558
12,"12077",4828,3395,3357,28,38,"MÉS COMPROM",197
46,"46200",1840,1475,1455,5,20,"MÉS COMPROM",166
46,"46018",562,442,436,2,6,"MÉS COMPROM",19
12,"12027",17506,11776,11649,84,127,"MÉS COMPROM",726
46,"46020",3757,2834,2783,16,51,"MÉS COMPROM",272
46,"46114",552,417,412,6,5,"MÉS COMPROM",21
12,"12112",102,79,79,1,0,"MÉS COMPROM",1
12,"12137",40,28,28,0,0,"MÉS COMPROM",5
46,"46010",943,691,681,7,10,"MÉS COMPROM",58
46,"46257",5436,3972,3933,28,39,"MÉS COMPROM",694
12,"12130",414,329,327,0,2,"MÉS COMPROM",7
12,"12080",1883,1472,1438,8,34,"MÉS COMPROM",99
3,"3039",89,65,65,0,0,"MÉS COMPROM",4
46,"46091",110,100,100,0,0,"MÉS COMPROM",7
46,"46078",28484,19694,19520,173,174,"MÉS COMPROM",1296
3,"3903",2612,1838,1814,7,24,"MÉS COMPROM",13
46,"46190",50042,35290,35066,284,224,"MÉS COMPROM",2395
3,"3120",2433,1688,1652,13,36,"MÉS COMPROM",25
46,"46136",2598,1875,1851,14,24,"MÉS COMPROM",94
12,"12068",41,22,21,0,1,"MÉS COMPROM",1
12,"12038",157,101,100,3,1,"MÉS COMPROM",4
46,"46238",13117,9172,9088,50,84,"MÉS COMPROM",1414
3,"3114",1593,1158,1142,4,16,"MÉS COMPROM",33
46,"46170",3417,2618,2577,11,41,"MÉS COMPROM",137
12,"12034",1389,1022,1002,5,20,"MÉS COMPROM",53
46,"46068",345,283,279,2,4,"MÉS COMPROM",28
3,"3029",236,174,172,2,2,"MÉS COMPROM",21
46,"46134",2419,1697,1678,14,19,"MÉS COMPROM",112
46,"46145",22215,15688,15538,127,150,"MÉS COMPROM",1332
3,"3901",1137,783,776,9,7,"MÉS COMPROM",104
46,"46208",1071,854,845,2,9,"MÉS COMPROM",131
12,"12021",4398,3314,3277,32,37,"MÉS COMPROM",332
46,"46252",125,89,86,1,3,"MÉS COMPROM",3
46,"46254",944,673,661,6,12,"MÉS COMPROM",17
3,"3013",1063,809,794,3,15,"MÉS COMPROM",7
46,"46101",819,670,663,8,7,"MÉS COMPROM",78
3,"3009",46125,33613,33319,315,294,"MÉS COMPROM",2277
46,"46139",4520,3486,3457,18,29,"MÉS COMPROM",483
46,"46055",1298,992,977,9,15,"MÉS COMPROM",152
46,"46030",810,641,625,7,16,"MÉS COMPROM",46
12,"12058",59,47,45,1,2,"MÉS COMPROM",0
46,"46225",351,267,262,1,5,"MÉS COMPROM",27
46,"46149",350,252,249,3,3,"MÉS COMPROM",3
46,"46033",196,155,153,0,2,"MÉS COMPROM",24
46,"46079",314,244,240,0,4,"MÉS COMPROM",13
12,"12126",24374,17741,17553,111,188,"MÉS COMPROM",1040
3,"3060",105,78,77,0,1,"MÉS COMPROM",8
3,"3104",27072,19732,19477,218,255,"MÉS COMPROM",611
12,"12031",3960,2913,2869,13,44,"MÉS COMPROM",274
3,"3011",8014,5278,5212,50,66,"MÉS COMPROM",220
3,"3002",3649,2568,2542,11,26,"MÉS COMPROM",117
46,"46026",1220,974,965,7,9,"MÉS COMPROM",145
46,"46160",1922,1395,1381,4,14,"MÉS COMPROM",261
12,"12102",518,424,417,4,7,"MÉS COMPROM",16
3,"3044",4608,3437,3391,13,46,"MÉS COMPROM",40
12,"12026",828,577,566,11,11,"MÉS COMPROM",43
46,"46218",1043,842,829,6,13,"MÉS COMPROM",146
3,"3079",18422,13560,13378,152,182,"MÉS COMPROM",538
46,"46117",493,386,380,2,6,"MÉS COMPROM",24
3,"3028",959,780,767,7,13,"MÉS COMPROM",91
46,"46228",2426,1819,1802,19,17,"MÉS COMPROM",140
46,"46098",2405,1778,1751,7,27,"MÉS COMPROM",372
12,"12105",825,602,598,6,4,"MÉS COMPROM",22
46,"46045",1245,984,961,3,23,"MÉS COMPROM",93
46,"46248",4868,3434,3374,16,60,"MÉS COMPROM",197
3,"3095",4807,3453,3410,31,43,"MÉS COMPROM",407
12,"12007",724,622,614,2,8,"MÉS COMPROM",89
46,"46255",3220,2361,2340,20,21,"MÉS COMPROM",281
12,"12003",954,710,702,6,8,"MÉS COMPROM",27
12,"12113",90,59,59,1,0,"MÉS COMPROM",7
46,"46056",176,142,142,0,0,"MÉS COMPROM",24
46,"46109",6248,4516,4440,37,76,"MÉS COMPROM",261
46,"46215",1407,1088,1068,10,20,"MÉS COMPROM",149
46,"46124",786,638,625,1,13,"MÉS COMPROM",132
3,"3137",654,449,443,7,6,"MÉS COMPROM",61
46,"46168",2004,1463,1447,12,16,"MÉS COMPROM",187
3,"3129",1224,934,923,4,11,"MÉS COMPROM",36
46,"46069",152,112,111,1,1,"MÉS COMPROM",5
46,"46032",5719,4297,4262,35,35,"MÉS COMPROM",395
46,"46108",420,328,324,1,4,"MÉS COMPROM",1
3,"3096",5786,4355,4281,38,74,"MÉS COMPROM",251
12,"12029",670,524,514,5,10,"MÉS COMPROM",33
46,"46172",5488,3724,3674,26,50,"MÉS COMPROM",222
3,"3041",6132,4204,4167,22,37,"MÉS COMPROM",410
46,"46094",20805,15353,15211,122,142,"MÉS COMPROM",1421
46,"46106",1471,1033,1028,8,5,"MÉS COMPROM",29
3,"3107",2785,1766,1746,13,20,"MÉS COMPROM",130
12,"12060",434,366,360,1,6,"MÉS COMPROM",24
46,"46022",15392,10624,10546,69,78,"MÉS COMPROM",601
46,"46048",3504,2609,2576,17,33,"MÉS COMPROM",489
46,"46167",342,240,239,0,1,"MÉS COMPROM",10
3,"3088",5895,4030,3961,29,69,"MÉS COMPROM",82
12,"12078",334,224,221,2,3,"MÉS COMPROM",5
46,"46121",106,91,90,1,1,"MÉS COMPROM",6
46,"46099",744,539,535,2,4,"MÉS COMPROM",19
46,"46104",1906,1422,1409,5,13,"MÉS COMPROM",283
3,"3065",169894,121210,120342,1045,868,"MÉS COMPROM",3779
46,"46127",2748,2035,2009,6,26,"MÉS COMPROM",245
3,"3109",3003,2186,2151,14,35,"MÉS COMPROM",25
3,"3038",330,260,254,3,6,"MÉS COMPROM",13
12,"12134",135,95,95,1,0,"MÉS COMPROM",3
3,"3118",2446,1617,1598,8,19,"MÉS COMPROM",27
3,"3005",7937,5907,5869,40,38,"MÉS COMPROM",85
12,"12053",2040,1587,1579,8,8,"MÉS COMPROM",73
46,"46169",32403,23890,23698,222,192,"MÉS COMPROM",1436
46,"46144",628,483,478,4,5,"MÉS COMPROM",7
46,"46216",5277,4146,4111,42,35,"MÉS COMPROM",313
46,"46179",2136,1624,1596,17,28,"MÉS COMPROM",74
3,"3020",94,84,84,1,0,"MÉS COMPROM",6
46,"46086",80,66,65,1,1,"MÉS COMPROM",13
3,"3069",3329,2102,2077,11,25,"MÉS COMPROM",82
46,"46147",17186,11507,11399,72,108,"MÉS COMPROM",919
46,"46193",8959,6880,6824,66,56,"MÉS COMPROM",648
46,"46192",786,534,519,7,15,"MÉS COMPROM",56
3,"3031",42046,25035,24819,168,216,"MÉS COMPROM",664
46,"46063",1786,1270,1255,8,15,"MÉS COMPROM",100
46,"46071",471,355,349,1,6,"MÉS COMPROM",16
3,"3084",501,413,413,1,0,"MÉS COMPROM",39
46,"46224",156,125,124,0,1,"MÉS COMPROM",17
46,"46140",383,321,321,2,0,"MÉS COMPROM",63
46,"46164",12145,8373,8248,44,125,"MÉS COMPROM",578
46,"46113",2558,1791,1773,7,18,"MÉS COMPROM",227
3,"3101",4933,3502,3462,16,40,"MÉS COMPROM",605
46,"46035",6828,5155,5089,33,66,"MÉS COMPROM",539
46,"46213",15499,10610,10482,173,128,"MÉS COMPROM",324
3,"3022",140,125,121,1,4,"MÉS COMPROM",7
46,"46003",948,770,757,8,13,"MÉS COMPROM",87
46,"46081",9999,7486,7412,47,74,"MÉS COMPROM",752
3,"3078",468,340,336,0,4,"MÉS COMPROM",2
12,"12059",220,183,183,2,0,"MÉS COMPROM",4
3,"3004",603,425,423,2,2,"MÉS COMPROM",21
3,"3012",1138,863,846,4,17,"MÉS COMPROM",13
3,"3056",8588,6219,6135,29,84,"MÉS COMPROM",566
46,"46092",262,176,174,2,2,"MÉS COMPROM",9
46,"46153",443,353,349,2,4,"MÉS COMPROM",57
3,"3080",1330,1040,1032,4,8,"MÉS COMPROM",6
46,"46111",11367,7995,7908,66,87,"MÉS COMPROM",503
46,"46132",2176,1725,1708,5,17,"MÉS COMPROM",179
12,"12121",1043,878,856,5,22,"MÉS COMPROM",19
46,"46103",1354,993,978,8,15,"MÉS COMPROM",132
46,"46115",330,219,213,0,6,"MÉS COMPROM",2
46,"46246",1049,808,793,3,15,"MÉS COMPROM",8
46,"46162",1168,839,832,3,7,"MÉS COMPROM",40
46,"46245",527,407,404,2,3,"MÉS COMPROM",26
12,"12135",36287,25912,25655,184,257,"MÉS COMPROM",1708
46,"46263",235,182,180,2,2,"MÉS COMPROM",6
3,"3094",9795,6528,6481,37,47,"MÉS COMPROM",280
46,"46075",144,125,122,2,3,"MÉS COMPROM",11
12,"12097",62,53,51,0,2,"MÉS COMPROM",0
46,"46221",348,292,290,1,2,"MÉS COMPROM",41
3,"3034",1404,1028,1010,5,18,"MÉS COMPROM",8
46,"46119",761,587,580,6,7,"MÉS COMPROM",89
12,"12072",1083,852,827,10,25,"MÉS COMPROM",47
12,"12043",570,405,397,1,8,"MÉS COMPROM",25
3,"3024",3937,2992,2952,19,40,"MÉS COMPROM",25
12,"12079",414,310,305,2,5,"MÉS COMPROM",12
46,"46177",4832,3592,3539,20,53,"MÉS COMPROM",316
46,"46159",23038,16719,16596,127,123,"MÉS COMPROM",1109
3,"3037",340,261,255,3,6,"MÉS COMPROM",21
46,"46236",929,723,716,2,7,"MÉS COMPROM",75
46,"46155",972,731,716,3,15,"MÉS COMPROM",94
12,"12076",72,54,54,0,0,"MÉS COMPROM",3
12,"12095",950,723,712,5,11,"MÉS COMPROM",29
46,"46239",446,357,352,1,5,"MÉS COMPROM",14
3,"3016",88,66,66,0,0,"MÉS COMPROM",4
46,"46065",1584,1199,1183,11,16,"MÉS COMPROM",156
46,"46180",659,509,500,7,9,"MÉS COMPROM",80
3,"3128",4285,2849,2819,18,30,"MÉS COMPROM",311
12,"12006",177,133,133,2,0,"MÉS COMPROM",4
12,"12087",26,16,16,0,0,"MÉS COMPROM",0
46,"46185",361,301,299,5,2,"MÉS COMPROM",92
3,"3018",12433,8582,8502,54,80,"MÉS COMPROM",815
46,"46007",12333,8890,8803,79,87,"MÉS COMPROM",540
3,"3105",5510,3879,3792,27,87,"MÉS COMPROM",100
46,"46182",1312,908,904,5,4,"MÉS COMPROM",79
46,"46258",2617,1925,1914,5,11,"MÉS COMPROM",72
3,"3135",195,134,131,1,3,"MÉS COMPROM",16
12,"12025",116,82,79,1,3,"MÉS COMPROM",4
3,"3058",4976,3733,3669,20,64,"MÉS COMPROM",41
3,"3036",82,73,71,1,2,"MÉS COMPROM",16
12,"12005",8049,5643,5552,71,91,"MÉS COMPROM",286
46,"46054",11389,8266,8190,54,76,"MÉS COMPROM",597
12,"12071",1272,936,925,3,11,"MÉS COMPROM",21
12,"12075",110,85,83,3,2,"MÉS COMPROM",15
3,"3070",2115,1399,1376,9,23,"MÉS COMPROM",16
12,"12089",4555,3070,3045,22,25,"MÉS COMPROM",244
46,"46205",14237,10641,10533,77,108,"MÉS COMPROM",809
3,"3051",342,288,286,4,2,"MÉS COMPROM",16
46,"46250",582242,437146,434438,3315,2708,"MÉS COMPROM",39056
46,"46088",152,114,110,1,4,"MÉS COMPROM",9
12,"12041",92,69,69,2,0,"MÉS COMPROM",1
46,"46262",206,136,134,1,2,"MÉS COMPROM",3
12,"12073",133,97,97,0,0,"MÉS COMPROM",4
3,"3127",350,260,255,1,5,"MÉS COMPROM",28
3,"3121",21997,14689,14572,103,117,"MÉS COMPROM",450
3,"3132",512,376,373,2,3,"MÉS COMPROM",41
46,"46166",8214,6093,6031,38,62,"MÉS COMPROM",751
3,"3027",167,142,138,1,4,"MÉS COMPROM",6
3,"3001",337,260,258,0,2,"MÉS COMPROM",50
12,"12109",646,489,482,4,7,"MÉS COMPROM",26
46,"46034",1826,1345,1335,3,10,"MÉS COMPROM",223
46,"46006",4454,3527,3486,27,41,"MÉS COMPROM",440
12,"12015",115,94,94,0,0,"MÉS COMPROM",33
46,"46049",268,221,217,2,4,"MÉS COMPROM",12
3,"3072",352,281,277,3,4,"MÉS COMPROM",35
46,"46013",17761,13652,13548,144,104,"MÉS COMPROM",1356
46,"46089",2182,1590,1576,9,14,"MÉS COMPROM",153
12,"12061",374,263,261,4,2,"MÉS COMPROM",29
46,"46174",942,746,736,1,10,"MÉS COMPROM",93
3,"3010",332,275,268,1,7,"MÉS COMPROM",32
12,"12022",323,257,254,5,3,"MÉS COMPROM",11
46,"46227",893,687,675,6,12,"MÉS COMPROM",72
46,"46903",6306,4762,4743,44,19,"MÉS COMPROM",301
3,"3904",1434,1032,1022,8,10,"MÉS COMPROM",12
46,"46102",19696,14700,14579,125,121,"MÉS COMPROM",953
46,"46002",1253,946,940,4,6,"MÉS COMPROM",160
46,"46232",853,661,648,7,13,"MÉS COMPROM",20
12,"12119",139,97,94,3,3,"MÉS COMPROM",1
46,"46206",555,417,408,0,9,"MÉS COMPROM",15
46,"46123",1926,1392,1368,11,24,"MÉS COMPROM",198
12,"12044",442,371,368,1,3,"MÉS COMPROM",10
46,"46137",248,201,197,3,4,"MÉS COMPROM",16
12,"12024",138,107,107,1,0,"MÉS COMPROM",3
3,"3008",158,120,118,1,2,"MÉS COMPROM",2
46,"46188",693,565,560,2,5,"MÉS COMPROM",114
46,"46073",1066,823,817,11,6,"MÉS COMPROM",30
46,"46014",3156,2324,2294,13,30,"MÉS COMPROM",242
3,"3067",91,78,78,0,0,"MÉS COMPROM",7
46,"46031",10574,7233,7158,58,75,"MÉS COMPROM",766
46,"46211",1862,1395,1381,12,14,"MÉS COMPROM",135
46,"46053",525,433,428,2,5,"MÉS COMPROM",55
12,"12051",437,297,295,3,2,"MÉS COMPROM",8
46,"46133",462,359,352,1,7,"MÉS COMPROM",11
3,"3090",18095,12539,12412,75,127,"MÉS COMPROM",506
3,"3116",1155,819,805,5,14,"MÉS COMPROM",53
3,"3124",459,360,358,0,2,"MÉS COMPROM",55
12,"12085",5081,3271,3235,17,36,"MÉS COMPROM",124
12,"12001",1028,783,768,6,15,"MÉS COMPROM",70
3,"3093",19702,13903,13728,113,175,"MÉS COMPROM",485
12,"12032",23728,16870,16726,121,144,"MÉS COMPROM",914
3,"3081",1492,1070,1044,12,26,"MÉS COMPROM",191
46,"46178",5001,3513,3477,26,36,"MÉS COMPROM",245
12,"12045",333,243,235,2,8,"MÉS COMPROM",34
46,"46198",862,670,660,3,10,"MÉS COMPROM",149
3,"3048",4993,3549,3502,13,47,"MÉS COMPROM",300
46,"46107",1857,1421,1402,4,19,"MÉS COMPROM",59
46,"46233",3766,2688,2650,14,38,"MÉS COMPROM",208
46,"46223",7776,5848,5798,36,50,"MÉS COMPROM",390
46,"46029",20448,14673,14556,99,117,"MÉS COMPROM",1643
12,"12020",118,104,103,1,1,"MÉS COMPROM",3
12,"12125",215,179,179,2,0,"MÉS COMPROM",7
3,"3125",332,226,226,2,0,"MÉS COMPROM",30
3,"3140",26036,18637,18267,237,370,"MÉS COMPROM",580
46,"46076",610,500,494,1,6,"MÉS COMPROM",26
12,"12002",114,96,94,1,2,"MÉS COMPROM",20
46,"46025",2445,1875,1853,16,22,"MÉS COMPROM",209
3,"3006",493,365,360,2,5,"MÉS COMPROM",55
46,"46095",580,445,438,5,7,"MÉS COMPROM",4
3,"3045",216,176,172,1,4,"MÉS COMPROM",5
3,"3115",255,213,213,3,0,"MÉS COMPROM",24
46,"46195",2000,1540,1532,3,8,"MÉS COMPROM",167
12,"12046",188,135,135,4,0,"MÉS COMPROM",13
12,"12056",257,205,199,1,6,"MÉS COMPROM",10
3,"3003",449,368,367,1,1,"MÉS COMPROM",44
12,"12064",80,71,69,0,2,"MÉS COMPROM",4
46,"46050",185,141,141,1,0,"MÉS COMPROM",6
46,"46027",924,746,737,2,9,"MÉS COMPROM",57
46,"46244",59910,42120,41826,338,294,"MÉS COMPROM",2273
46,"46143",4274,3027,2995,19,32,"MÉS COMPROM",379
3,"3138",3190,2244,2207,9,37,"MÉS COMPROM",199
46,"46131",49805,35527,35231,298,296,"MÉS COMPROM",3222
46,"46129",511,389,379,9,10,"MÉS COMPROM",6
3,"3046",1636,1073,1061,7,12,"MÉS COMPROM",47
46,"46047",540,428,420,1,8,"MÉS COMPROM",54
12,"12139",299,202,200,3,2,"MÉS COMPROM",36
12,"12106",1151,928,908,9,20,"MÉS COMPROM",32
3,"3066",41762,28723,28388,358,335,"MÉS COMPROM",688
46,"46230",14116,10038,9946,63,92,"MÉS COMPROM",717
12,"12067",514,381,373,3,8,"MÉS COMPROM",18
46,"46165",7349,5460,5412,39,48,"MÉS COMPROM",429
3,"3059",20710,14788,14685,89,103,"MÉS COMPROM",1035
46,"46042",3335,2655,2620,12,35,"MÉS COMPROM",248
46,"46202",17801,13010,12906,87,104,"MÉS COMPROM",1178
46,"46186",19689,14688,14576,118,112,"MÉS COMPROM",1021
46,"46016",1070,827,814,10,13,"MÉS COMPROM",103
3,"3035",627,485,485,2,0,"MÉS COMPROM",37
46,"46046",901,623,609,2,14,"MÉS COMPROM",94
12,"12012",2622,2084,2056,12,28,"MÉS COMPROM",52
12,"12049",415,317,305,4,12,"MÉS COMPROM",29
12,"12004",4149,2945,2910,25,35,"MÉS COMPROM",208
46,"46070",17824,12888,12802,106,86,"MÉS COMPROM",1065
46,"46152",90,63,63,0,0,"MÉS COMPROM",0
12,"12108",443,354,352,4,2,"MÉS COMPROM",33
46,"46051",8469,6120,6070,40,50,"MÉS COMPROM",352
12,"12040",119116,85613,84993,620,620,"MÉS COMPROM",5510
46,"46138",361,289,287,1,2,"MÉS COMPROM",24
46,"46001",771,562,560,3,2,"MÉS COMPROM",17
12,"12052",537,409,398,5,11,"MÉS COMPROM",22
46,"46235",21229,15171,15011,126,160,"MÉS COMPROM",2726
46,"46242",326,260,257,3,3,"MÉS COMPROM",15
46,"46142",778,536,524,3,12,"MÉS COMPROM",16
46,"46196",134,111,110,0,1,"MÉS COMPROM",2
12,"12017",145,111,110,2,1,"MÉS COMPROM",2
12,"12123",40,32,32,0,0,"MÉS COMPROM",4
46,"46093",2151,1652,1640,10,12,"MÉS COMPROM",160
12,"12039",792,665,659,2,6,"MÉS COMPROM",11
46,"46150",1794,1276,1272,8,4,"MÉS COMPROM",86
3,"3097",1014,778,764,5,14,"MÉS COMPROM",160
3,"3030",559,442,433,2,9,"MÉS COMPROM",55
12,"12133",59,46,45,0,1,"MÉS COMPROM",2
46,"46005",23129,16610,16437,148,173,"MÉS COMPROM",1067
12,"12088",57,53,53,0,0,"MÉS COMPROM",1
46,"46019",8932,6721,6647,40,74,"MÉS COMPROM",597
46,"46241",388,288,283,5,5,"MÉS COMPROM",27
46,"46038",302,221,220,1,1,"MÉS COMPROM",8
12,"12083",88,69,67,9,2,"MÉS COMPROM",1
46,"46243",124,93,90,1,3,"MÉS COMPROM",9
46,"46040",993,745,733,3,12,"MÉS COMPROM",73
46,"46184",26514,19610,19399,180,211,"MÉS COMPROM",2611
46,"46105",16126,10958,10847,76,111,"MÉS COMPROM",833
46,"46234",317,247,245,1,2,"MÉS COMPROM",13
12,"12103",87,61,60,0,1,"MÉS COMPROM",2
46,"46100",281,190,187,1,3,"MÉS COMPROM",17
46,"46209",1903,1406,1383,5,23,"MÉS COMPROM",120
46,"46058",1734,1245,1230,8,15,"MÉS COMPROM",121
3,"3077",1391,1052,1032,10,20,"MÉS COMPROM",24
3,"3068",41,38,37,0,1,"MÉS COMPROM",0
46,"46116",13606,10262,10200,87,62,"MÉS COMPROM",842
46,"46161",1467,1129,1113,5,16,"MÉS COMPROM",90
46,"46023",322,254,252,1,2,"MÉS COMPROM",34
3,"3073",222,178,178,0,0,"MÉS COMPROM",6
46,"46220",49112,33766,33424,312,342,"MÉS COMPROM",2456
46,"46163",1883,1471,1460,8,11,"MÉS COMPROM",206
12,"12117",3532,2512,2479,12,33,"MÉS COMPROM",279
46,"46072",3522,2792,2741,25,51,"MÉS COMPROM",419
12,"12090",102,79,78,1,1,"MÉS COMPROM",1
46,"46183",6036,4276,4213,21,63,"MÉS COMPROM",494
12,"12902",2250,1557,1532,16,25,"MÉS COMPROM",100
46,"46219",125,107,104,0,3,"MÉS COMPROM",7
46,"46087",109,94,94,2,0,"MÉS COMPROM",2
12,"12028",13004,9801,9732,74,69,"MÉS COMPROM",616
12,"12069",50,38,38,0,0,"MÉS COMPROM",1
46,"46194",15852,11124,11009,86,115,"MÉS COMPROM",916
46,"46251",2465,1938,1903,19,35,"MÉS COMPROM",206
12,"12018",279,233,231,3,2,"MÉS COMPROM",6
46,"46061",351,276,272,6,4,"MÉS COMPROM",27
46,"46130",862,633,625,6,8,"MÉS COMPROM",102
46,"46097",948,670,663,1,7,"MÉS COMPROM",16
3,"3122",43774,30060,29834,230,226,"MÉS COMPROM",1159
3,"3117",377,306,302,2,4,"MÉS COMPROM",47
3,"3103",238,196,194,2,2,"MÉS COMPROM",13
46,"46120",1179,903,880,5,23,"MÉS COMPROM",69
3,"3019",15501,11261,11106,86,155,"MÉS COMPROM",223
46,"46237",7172,5199,5146,53,53,"MÉS COMPROM",363
46,"46256",7280,4996,4940,32,56,"MÉS COMPROM",339
3,"3063",27209,18236,18101,164,135,"MÉS COMPROM",1372
12,"12116",61,49,49,0,0,"MÉS COMPROM",0
46,"46057",463,308,304,1,4,"MÉS COMPROM",39
3,"3086",169,140,140,2,0,"MÉS COMPROM",13
46,"46037",1120,891,879,7,12,"MÉS COMPROM",125
12,"12104",6843,5181,5111,32,70,"MÉS COMPROM",160
46,"46090",1631,1360,1339,6,21,"MÉS COMPROM",130
46,"46181",16967,11951,11835,98,116,"MÉS COMPROM",1486
46,"46077",7338,5447,5356,44,91,"MÉS COMPROM",259
3,"3110",312,258,258,0,0,"MÉS COMPROM",61
3,"3106",559,469,465,3,4,"MÉS COMPROM",35
46,"46110",21364,15132,15019,120,113,"MÉS COMPROM",874
46,"46008",2617,1954,1931,17,23,"MÉS COMPROM",293
46,"46187",1292,924,920,4,4,"MÉS COMPROM",120
3,"3047",9768,6220,6144,41,76,"MÉS COMPROM",323
12,"12140",1147,849,841,5,8,"MÉS COMPROM",43
46,"46260",2685,2072,2053,14,19,"MÉS COMPROM",207
3,"3119",17253,12346,12258,81,88,"MÉS COMPROM",557
12,"12013",135,106,106,1,0,"MÉS COMPROM",4
46,"46067",1753,1356,1341,8,15,"MÉS COMPROM",81
12,"12008",228,195,194,1,1,"MÉS COMPROM",8
46,"46249",9136,6538,6439,73,99,"MÉS COMPROM",161
46,"46041",313,229,228,1,1,"MÉS COMPROM",18
12,"12132",477,391,385,3,6,"MÉS COMPROM",42
46,"46199",5878,4217,4182,21,35,"MÉS COMPROM",297
12,"12092",123,95,95,0,0,"MÉS COMPROM",2
12,"12110",222,156,155,3,1,"MÉS COMPROM",6
3,"3050",19420,13210,13116,70,94,"MÉS COMPROM",639
12,"12094",871,671,661,1,10,"MÉS COMPROM",62
3,"3043",2906,2360,2334,27,26,"MÉS COMPROM",158
46,"46207",6761,4966,4909,46,57,"MÉS COMPROM",475
3,"3014",238937,161861,160809,1308,1052,"MÉS COMPROM",5514
46,"46247",972,649,646,3,3,"MÉS COMPROM",22
3,"3085",271,229,227,5,2,"MÉS COMPROM",23
46,"46082",4981,3547,3523,29,24,"MÉS COMPROM",251
46,"46191",1956,1439,1414,8,25,"MÉS COMPROM",49
12,"12096",732,526,519,4,7,"MÉS COMPROM",40
3,"3023",1377,1138,1122,9,16,"MÉS COMPROM",74
12,"12111",327,259,255,8,4,"MÉS COMPROM",17
12,"12136",2603,2151,2119,20,32,"MÉS COMPROM",87
12,"12010",232,191,187,3,4,"MÉS COMPROM",6
46,"46175",429,362,355,3,7,"MÉS COMPROM",54
46,"46157",2959,2145,2126,11,19,"MÉS COMPROM",217
3,"3007",173,141,139,0,2,"MÉS COMPROM",27
46,"46074",2687,2033,2020,18,13,"MÉS COMPROM",230
46,"46158",1047,771,763,7,8,"MÉS COMPROM",20
3,"3133",41333,24527,24340,146,187,"MÉS COMPROM",492
12,"12036",541,401,395,6,6,"MÉS COMPROM",15
3,"3017",379,320,314,4,6,"MÉS COMPROM",23
3,"3052",959,747,735,4,12,"MÉS COMPROM",37
46,"46210",338,256,251,0,5,"MÉS COMPROM",35
46,"46096",263,204,202,0,2,"MÉS COMPROM",11
46,"46122",2726,1957,1934,13,23,"MÉS COMPROM",179
12,"12128",1365,990,972,16,18,"MÉS COMPROM",108
3,"3062",228,173,172,3,1,"MÉS COMPROM",8
46,"46214",16637,12113,12014,84,99,"MÉS COMPROM",867
46,"46060",9278,6796,6724,49,72,"MÉS COMPROM",650
3,"3033",101,82,78,0,4,"MÉS COMPROM",7
3,"3076",8846,6105,6029,40,76,"MÉS COMPROM",163
3,"3061",1060,793,787,5,6,"MÉS COMPROM",11
46,"46066",1274,972,970,4,2,"MÉS COMPROM",106
3,"3902",10640,7024,6952,36,72,"MÉS COMPROM",93
3,"3057",174,138,136,0,2,"MÉS COMPROM",16
46,"46146",1647,1241,1229,12,12,"MÉS COMPROM",245
46,"46902",352,283,283,0,0,"MÉS COMPROM",8
46,"46028",383,305,299,8,6,"MÉS COMPROM",25
12,"12142",142,113,113,0,0,"MÉS COMPROM",1
12,"12065",167,142,141,0,1,"MÉS COMPROM",2
12,"12099",597,444,436,6,8,"MÉS COMPROM",25
3,"3025",1304,944,934,4,10,"MÉS COMPROM",6
12,"12901",3339,2583,2561,25,22,"MÉS COMPROM",158
46,"46171",16446,11616,11499,94,117,"MÉS COMPROM",1033
3,"3042",1475,1053,1043,7,10,"MÉS COMPROM",75
3,"3130",28,19,19,0,0,"MÉS COMPROM",2
46,"46217",900,672,667,7,5,"MÉS COMPROM",88
46,"46148",1515,1131,1113,5,18,"MÉS COMPROM",62
46,"46052",515,423,419,4,4,"MÉS COMPROM",26
3,"3021",5573,4423,4343,23,80,"MÉS COMPROM",424
46,"46039",2111,1657,1640,16,17,"MÉS COMPROM",84
3,"3053",7568,5551,5468,40,83,"MÉS COMPROM",383
46,"46197",1930,1430,1411,11,19,"MÉS COMPROM",169
3,"3092",6712,4924,4858,35,66,"MÉS COMPROM",572
12,"12098",529,417,413,3,4,"MÉS COMPROM",22
46,"46083",15372,10939,10815,78,124,"MÉS COMPROM",1096
46,"46203",3546,2717,2689,28,28,"MÉS COMPROM",331
46,"46204",6625,4946,4882,52,64,"MÉS COMPROM",401
46,"46043",135,119,118,0,1,"MÉS COMPROM",8
12,"12122",754,608,600,3,8,"MÉS COMPROM",38
46,"46135",9817,7596,7558,58,38,"MÉS COMPROM",758
46,"46126",5580,4361,4328,36,33,"MÉS COMPROM",528
46,"46021",24053,17331,17194,159,137,"MÉS COMPROM",954
12,"12033",1953,1391,1368,6,23,"MÉS COMPROM",80
46,"46084",1487,1136,1123,4,13,"MÉS COMPROM",117
12,"12074",756,611,601,3,10,"MÉS COMPROM",33
12,"12129",1783,1207,1184,16,23,"MÉS COMPROM",135
46,"46151",757,560,552,2,8,"MÉS COMPROM",46
3,"3082",12941,8399,8304,51,95,"MÉS COMPROM",634
46,"46004",1932,1530,1512,10,18,"MÉS COMPROM",299
46,"46212",1620,1130,1112,12,18,"MÉS COMPROM",131
46,"46128",1569,1216,1179,7,37,"MÉS COMPROM",191
12,"12011",4583,3228,3177,24,51,"MÉS COMPROM",290
3,"3139",23126,14650,14522,127,128,"MÉS COMPROM",755
12,"12114",200,144,140,0,4,"MÉS COMPROM",5
12,"12048",243,159,155,4,4,"MÉS COMPROM",6
3,"3049",12103,8872,8785,57,87,"MÉS COMPROM",93
46,"46024",454,343,339,1,4,"MÉS COMPROM",10
46,"46085",11089,7581,7503,60,78,"MÉS COMPROM",691
3,"3091",244,194,193,2,1,"MÉS COMPROM",9
12,"12118",78,64,63,0,1,"MÉS COMPROM",2
12,"12037",17,13,13,1,0,"MÉS COMPROM",3
3,"3075",154,117,115,1,2,"MÉS COMPROM",7
46,"46036",558,339,331,6,8,"MÉS COMPROM",27
46,"46226",29,20,19,0,1,"MÉS COMPROM",1
12,"12124",1842,1343,1328,13,15,"MÉS COMPROM",58
46,"46141",433,340,337,6,3,"MÉS COMPROM",17
46,"46201",62,40,40,0,0,"MÉS COMPROM",6
12,"12138",19207,13018,12891,87,127,"MÉS COMPROM",739
46,"46062",4552,3402,3362,27,40,"MÉS COMPROM",317
46,"46017",33041,23469,23277,173,192,"MÉS COMPROM",2701
46,"46176",2077,1362,1348,14,14,"MÉS COMPROM",78
12,"12127",63,45,44,1,1,"MÉS COMPROM",2
12,"12081",606,454,446,2,8,"MÉS COMPROM",14
3,"3015",12818,9127,9017,46,110,"MÉS COMPROM",113
3,"3071",4000,2858,2813,27,45,"MÉS COMPROM",471
46,"46012",965,689,675,4,14,"MÉS COMPROM",28
12,"12091",171,110,108,4,2,"MÉS COMPROM",7
12,"12100",1273,1069,1052,5,17,"MÉS COMPROM",48
12,"12115",205,161,161,1,0,"MÉS COMPROM",4
3,"3100",499,384,378,0,6,"MÉS COMPROM",42
3,"3055",5265,3741,3697,16,44,"MÉS COMPROM",55
3,"3136",399,302,301,3,1,"MÉS COMPROM",47
46,"46229",903,715,708,5,7,"MÉS COMPROM",24
12,"12014",164,111,111,0,0,"MÉS COMPROM",8
3,"3134",139,107,107,0,0,"MÉS COMPROM",14
12,"12070",505,407,398,2,9,"MÉS COMPROM",40
12,"12120",149,125,121,3,4,"MÉS COMPROM",6
46,"46156",2017,1538,1524,9,14,"MÉS COMPROM",133
3,"3054",334,248,245,2,3,"MÉS COMPROM",20
12,"12141",92,72,72,0,0,"MÉS COMPROM",5
46,"46173",1309,1029,1010,13,19,"MÉS COMPROM",95
3,"3102",7181,5126,5073,36,53,"MÉS COMPROM",816
46,"46240",200,167,155,1,12,"MÉS COMPROM",14
3,"3099",43101,30222,29885,196,337,"MÉS COMPROM",520
46,"46253",112,84,84,0,0,"MÉS COMPROM",8
46,"46064",532,395,387,3,8,"MÉS COMPROM",39
3,"3113",4339,2978,2935,23,43,"MÉS COMPROM",39
3,"3040",264,227,221,1,6,"MÉS COMPROM",31
46,"46009",3144,2473,2449,22,24,"MÉS COMPROM",308
3,"3083",5479,3736,3674,39,62,"MÉS COMPROM",236
46,"46118",3649,2730,2701,20,29,"MÉS COMPROM",153
3,"3123",7579,5491,5416,50,75,"MÉS COMPROM",97
12,"12131",97,87,87,0,0,"MÉS COMPROM",2
46,"46259",457,374,371,2,3,"MÉS COMPROM",12
46,"46261",1708,1259,1237,12,22,"MÉS COMPROM",64
12,"12107",350,299,295,3,4,"MÉS COMPROM",10
12,"12093",161,111,109,2,2,"MÉS COMPROM",3
12,"12009",17943,12389,12292,102,97,"MÉS COMPROM",670
12,"12063",41,31,31,1,0,"MÉS COMPROM",5
12,"12042",574,459,446,9,13,"MÉS COMPROM",14
46,"46189",469,374,367,2,7,"MÉS COMPROM",75
46,"46044",4159,3062,2997,26,65,"MÉS COMPROM",93
46,"46059",1244,1007,995,5,12,"MÉS COMPROM",190
3,"3064",5015,3514,3461,15,53,"MÉS COMPROM",40
3,"3074",1766,1347,1336,4,11,"MÉS COMPROM",14
46,"46904",812,615,605,2,10,"MÉS COMPROM",58
46,"46080",979,720,712,2,8,"MÉS COMPROM",12
12,"12055",103,77,76,2,1,"MÉS COMPROM",11
46,"46222",402,329,326,0,3,"MÉS COMPROM",46
12,"12101",354,274,270,5,4,"MÉS COMPROM",8
12,"12057",572,456,437,1,19,"MÉS COMPROM",51
46,"46125",852,660,650,5,10,"MÉS COMPROM",73
46,"46112",533,435,432,7,3,"MÉS COMPROM",22
12,"12084",17785,12557,12422,108,135,"MÉS COMPROM",588
46,"46154",795,619,608,5,11,"MÉS COMPROM",50
3,"3026",1331,987,975,7,12,"MÉS COMPROM",102
12,"12082",9602,7323,7248,53,75,"MÉS COMPROM",425
46,"46011",7523,5154,5077,34,77,"MÉS COMPROM",541
3,"3112",650,503,497,3,6,"MÉS COMPROM",30
12,"12016",1549,1244,1234,9,10,"MÉS COMPROM",48
7,"7065",2319,1429,1411,15,18,"MÉS-ESQUERR",142
7,"7063",1434,1025,1016,10,9,"MÉS-ESQUERR",50
7,"7020",3707,2522,2493,40,29,"MÉS-ESQUERR",218
7,"7001",3647,2430,2383,26,47,"MÉS-ESQUERR",126
7,"7047",2399,1504,1477,20,27,"MÉS-ESQUERR",98
7,"7036",28132,18650,18510,222,140,"MÉS-ESQUERR",514
7,"7044",8812,5679,5569,67,110,"MÉS-ESQUERR",417
7,"7011",28971,17082,16964,164,118,"MÉS-ESQUERR",205
7,"7052",4853,2765,2743,33,22,"MÉS-ESQUERR",120
7,"7058",2866,2013,1996,24,17,"MÉS-ESQUERR",141
7,"7061",9451,5735,5666,60,69,"MÉS-ESQUERR",371
7,"7054",23257,12613,12464,111,149,"MÉS-ESQUERR",151
7,"7016",2970,1891,1865,22,26,"MÉS-ESQUERR",87
7,"7009",737,495,488,3,7,"MÉS-ESQUERR",47
7,"7028",944,635,628,2,7,"MÉS-ESQUERR",63
7,"7062",7972,3946,3896,42,50,"MÉS-ESQUERR",99
7,"7040",289448,169300,167908,1594,1392,"MÉS-ESQUERR",4288
7,"7031",24972,14866,14757,127,109,"MÉS-ESQUERR",388
7,"7014",7885,3934,3893,43,41,"MÉS-ESQUERR",209
7,"7038",2046,1416,1406,12,10,"MÉS-ESQUERR",178
7,"7902",1091,663,645,13,18,"MÉS-ESQUERR",39
7,"7021",229,154,150,3,4,"MÉS-ESQUERR",6
7,"7032",21005,12039,11928,114,111,"MÉS-ESQUERR",443
7,"7024",7283,3574,3538,36,36,"MÉS-ESQUERR",191
7,"7027",22101,13161,13028,140,133,"MÉS-ESQUERR",494
7,"7025",443,313,310,5,3,"MÉS-ESQUERR",13
7,"7049",1479,935,918,5,17,"MÉS-ESQUERR",101
7,"7008",6113,4003,3961,26,42,"MÉS-ESQUERR",312
7,"7015",22248,12375,12286,202,89,"MÉS-ESQUERR",829
7,"7007",416,277,275,4,2,"MÉS-ESQUERR",23
7,"7033",28539,15238,15070,187,168,"MÉS-ESQUERR",1372
7,"7023",3776,2425,2386,34,39,"MÉS-ESQUERR",194
7,"7039",5019,3066,3017,23,49,"MÉS-ESQUERR",172
7,"7035",1595,1095,1078,13,17,"MÉS-ESQUERR",115
7,"7048",18455,9929,9858,116,71,"MÉS-ESQUERR",197
7,"7042",10846,6354,6299,77,55,"MÉS-ESQUERR",463
7,"7004",4069,2652,2624,27,28,"MÉS-ESQUERR",212
7,"7055",8062,4546,4492,40,54,"MÉS-ESQUERR",189
7,"7002",6678,4149,4108,31,41,"MÉS-ESQUERR",173
7,"7045",1317,931,928,8,3,"MÉS-ESQUERR",86
7,"7003",12521,6457,6381,60,76,"MÉS-ESQUERR",248
7,"7053",1209,870,864,10,6,"MÉS-ESQUERR",61
7,"7018",389,238,236,1,2,"MÉS-ESQUERR",45
7,"7051",5484,3133,3094,43,39,"MÉS-ESQUERR",208
7,"7059",3074,1973,1948,17,25,"MÉS-ESQUERR",88
7,"7012",1908,1301,1282,12,19,"MÉS-ESQUERR",211
7,"7057",7471,4430,4392,41,38,"MÉS-ESQUERR",199
7,"7034",1074,796,779,9,17,"MÉS-ESQUERR",64
7,"7029",4393,2888,2855,37,33,"MÉS-ESQUERR",172
7,"7017",899,604,596,10,8,"MÉS-ESQUERR",33
7,"7043",3431,2196,2166,21,30,"MÉS-ESQUERR",266
7,"7013",7353,4725,4639,43,86,"MÉS-ESQUERR",227
7,"7030",1598,1127,1098,14,29,"MÉS-ESQUERR",239
7,"7056",5271,3429,3386,44,43,"MÉS-ESQUERR",255
7,"7037",3448,1875,1856,18,19,"MÉS-ESQUERR",136
7,"7041",2090,1454,1434,17,20,"MÉS-ESQUERR",186
7,"7046",16884,9184,9097,97,87,"MÉS-ESQUERR",110
7,"7006",5393,3257,3220,34,37,"MÉS-ESQUERR",428
7,"7060",2713,1796,1772,17,24,"MÉS-ESQUERR",201
7,"7010",5078,3353,3318,30,35,"MÉS-ESQUERR",219
7,"7901",598,410,402,6,8,"MÉS-ESQUERR",21
7,"7005",6956,4042,3996,35,46,"MÉS-ESQUERR",112
7,"7026",31129,17489,17342,178,147,"MÉS-ESQUERR",246
7,"7064",5566,3232,3204,18,28,"MÉS-ESQUERR",126
7,"7019",161,104,102,0,2,"MÉS-ESQUERR",6
7,"7050",3513,2036,2013,25,23,"MÉS-ESQUERR",37
7,"7022",11659,7045,6965,84,80,"MÉS-ESQUERR",529
7,"7019",161,104,102,0,2,"M PAÍS",1
7,"7065",2319,1429,1411,15,18,"M PAÍS",29
7,"7030",1598,1127,1098,14,29,"M PAÍS",9
7,"7056",5271,3429,3386,44,43,"M PAÍS",103
7,"7039",5019,3066,3017,23,49,"M PAÍS",37
7,"7063",1434,1025,1016,10,9,"M PAÍS",33
7,"7020",3707,2522,2493,40,29,"M PAÍS",109
7,"7023",3776,2425,2386,34,39,"M PAÍS",51
7,"7027",22101,13161,13028,140,133,"M PAÍS",233
7,"7032",21005,12039,11928,114,111,"M PAÍS",263
7,"7054",23257,12613,12464,111,149,"M PAÍS",321
7,"7053",1209,870,864,10,6,"M PAÍS",16
7,"7022",11659,7045,6965,84,80,"M PAÍS",100
7,"7046",16884,9184,9097,97,87,"M PAÍS",209
7,"7055",8062,4546,4492,40,54,"M PAÍS",61
7,"7033",28539,15238,15070,187,168,"M PAÍS",297
7,"7009",737,495,488,3,7,"M PAÍS",3
7,"7001",3647,2430,2383,26,47,"M PAÍS",55
7,"7036",28132,18650,18510,222,140,"M PAÍS",459
7,"7021",229,154,150,3,4,"M PAÍS",1
7,"7025",443,313,310,5,3,"M PAÍS",5
7,"7038",2046,1416,1406,12,10,"M PAÍS",30
7,"7043",3431,2196,2166,21,30,"M PAÍS",32
7,"7002",6678,4149,4108,31,41,"M PAÍS",89
7,"7047",2399,1504,1477,20,27,"M PAÍS",35
7,"7018",389,238,236,1,2,"M PAÍS",10
7,"7064",5566,3232,3204,18,28,"M PAÍS",98
7,"7026",31129,17489,17342,178,147,"M PAÍS",429
7,"7034",1074,796,779,9,17,"M PAÍS",9
7,"7057",7471,4430,4392,41,38,"M PAÍS",67
7,"7031",24972,14866,14757,127,109,"M PAÍS",294
7,"7035",1595,1095,1078,13,17,"M PAÍS",11
7,"7045",1317,931,928,8,3,"M PAÍS",51
7,"7058",2866,2013,1996,24,17,"M PAÍS",32
7,"7044",8812,5679,5569,67,110,"M PAÍS",78
7,"7061",9451,5735,5666,60,69,"M PAÍS",121
7,"7003",12521,6457,6381,60,76,"M PAÍS",128
7,"7014",7885,3934,3893,43,41,"M PAÍS",78
7,"7004",4069,2652,2624,27,28,"M PAÍS",56
7,"7010",5078,3353,3318,30,35,"M PAÍS",87
7,"7052",4853,2765,2743,33,22,"M PAÍS",75
7,"7024",7283,3574,3538,36,36,"M PAÍS",98
7,"7040",289448,169300,167908,1594,1392,"M PAÍS",4446
7,"7005",6956,4042,3996,35,46,"M PAÍS",86
7,"7015",22248,12375,12286,202,89,"M PAÍS",287
7,"7060",2713,1796,1772,17,24,"M PAÍS",46
7,"7041",2090,1454,1434,17,20,"M PAÍS",26
7,"7017",899,604,596,10,8,"M PAÍS",15
7,"7012",1908,1301,1282,12,19,"M PAÍS",23
7,"7042",10846,6354,6299,77,55,"M PAÍS",152
7,"7029",4393,2888,2855,37,33,"M PAÍS",64
7,"7008",6113,4003,3961,26,42,"M PAÍS",95
7,"7013",7353,4725,4639,43,86,"M PAÍS",74
7,"7006",5393,3257,3220,34,37,"M PAÍS",68
7,"7028",944,635,628,2,7,"M PAÍS",17
7,"7007",416,277,275,4,2,"M PAÍS",10
7,"7062",7972,3946,3896,42,50,"M PAÍS",57
7,"7048",18455,9929,9858,116,71,"M PAÍS",242
7,"7050",3513,2036,2013,25,23,"M PAÍS",39
7,"7051",5484,3133,3094,43,39,"M PAÍS",69
7,"7011",28971,17082,16964,164,118,"M PAÍS",345
7,"7059",3074,1973,1948,17,25,"M PAÍS",24
7,"7902",1091,663,645,13,18,"M PAÍS",14
7,"7901",598,410,402,6,8,"M PAÍS",4
7,"7016",2970,1891,1865,22,26,"M PAÍS",52
7,"7037",3448,1875,1856,18,19,"M PAÍS",33
7,"7049",1479,935,918,5,17,"M PAÍS",14
50,"50040",82,66,66,1,0,"M PAÍS-CHA-",1
50,"50178",269,165,163,6,2,"M PAÍS-CHA-",5
50,"50126",2240,1528,1509,24,19,"M PAÍS-CHA-",87
50,"50091",39,32,32,0,0,"M PAÍS-CHA-",1
50,"50111",181,130,130,1,0,"M PAÍS-CHA-",5
50,"50026",418,292,288,4,4,"M PAÍS-CHA-",7
50,"50180",107,85,85,1,0,"M PAÍS-CHA-",7
50,"50052",81,61,61,0,0,"M PAÍS-CHA-",0
50,"50293",392,257,255,2,2,"M PAÍS-CHA-",8
50,"50246",37,24,24,0,0,"M PAÍS-CHA-",0
50,"50207",87,58,58,1,0,"M PAÍS-CHA-",2
50,"50023",199,145,143,2,2,"M PAÍS-CHA-",0
50,"50119",876,633,625,11,8,"M PAÍS-CHA-",15
50,"50220",45,38,38,0,0,"M PAÍS-CHA-",3
50,"50196",101,73,73,0,0,"M PAÍS-CHA-",4
50,"50065",56,37,37,0,0,"M PAÍS-CHA-",0
50,"50186",37,26,26,1,0,"M PAÍS-CHA-",3
50,"50104",320,251,251,1,0,"M PAÍS-CHA-",1
50,"50055",3635,2298,2244,36,54,"M PAÍS-CHA-",96
50,"50202",124,76,74,0,2,"M PAÍS-CHA-",1
50,"50238",84,65,65,0,0,"M PAÍS-CHA-",3
50,"50169",333,231,230,0,1,"M PAÍS-CHA-",2
50,"50282",55,38,38,1,0,"M PAÍS-CHA-",1
50,"50274",64,46,43,1,3,"M PAÍS-CHA-",1
50,"50059",757,556,551,5,5,"M PAÍS-CHA-",11
50,"50061",190,157,155,2,2,"M PAÍS-CHA-",1
50,"50035",74,57,57,0,0,"M PAÍS-CHA-",19
50,"50019",63,46,46,0,0,"M PAÍS-CHA-",3
50,"50193",664,487,475,4,12,"M PAÍS-CHA-",23
50,"50192",227,182,181,0,1,"M PAÍS-CHA-",4
50,"50269",287,172,167,2,5,"M PAÍS-CHA-",3
50,"50296",385,240,235,3,5,"M PAÍS-CHA-",8
50,"50174",80,58,57,0,1,"M PAÍS-CHA-",2
50,"50245",74,51,51,0,0,"M PAÍS-CHA-",2
50,"50187",55,42,42,0,0,"M PAÍS-CHA-",3
50,"50016",44,31,31,0,0,"M PAÍS-CHA-",0
50,"50027",223,166,161,2,5,"M PAÍS-CHA-",3
50,"50018",883,622,616,5,6,"M PAÍS-CHA-",7
50,"50172",174,125,123,2,2,"M PAÍS-CHA-",0
50,"50135",85,59,59,0,0,"M PAÍS-CHA-",5
50,"50120",55,42,42,1,0,"M PAÍS-CHA-",0
50,"50183",316,227,223,1,4,"M PAÍS-CHA-",3
50,"50069",66,33,33,1,0,"M PAÍS-CHA-",1
50,"50093",87,66,64,1,2,"M PAÍS-CHA-",0
50,"50167",208,166,163,1,3,"M PAÍS-CHA-",5
50,"50290",360,260,255,5,5,"M PAÍS-CHA-",6
50,"50258",53,25,25,1,0,"M PAÍS-CHA-",0
50,"50037",125,85,80,0,5,"M PAÍS-CHA-",0
50,"50254",179,115,113,0,2,"M PAÍS-CHA-",2
50,"50250",54,44,44,2,0,"M PAÍS-CHA-",0
50,"50102",815,594,584,7,10,"M PAÍS-CHA-",14
50,"50017",1773,1283,1265,13,18,"M PAÍS-CHA-",56
50,"50100",304,215,212,1,3,"M PAÍS-CHA-",3
50,"50260",35,31,31,0,0,"M PAÍS-CHA-",0
50,"50141",104,80,78,0,2,"M PAÍS-CHA-",1
50,"50107",988,758,755,8,3,"M PAÍS-CHA-",27
50,"50039",462,339,333,1,6,"M PAÍS-CHA-",8
50,"50098",162,119,118,1,1,"M PAÍS-CHA-",5
50,"50101",833,557,550,5,7,"M PAÍS-CHA-",25
50,"50028",78,53,53,0,0,"M PAÍS-CHA-",2
50,"50020",795,548,545,4,3,"M PAÍS-CHA-",19
50,"50244",192,131,130,1,1,"M PAÍS-CHA-",2
50,"50224",61,44,44,2,0,"M PAÍS-CHA-",4
50,"50200",479,389,383,5,6,"M PAÍS-CHA-",18
50,"50092",290,218,214,0,4,"M PAÍS-CHA-",0
50,"50048",33,25,25,0,0,"M PAÍS-CHA-",4
50,"50151",607,450,449,12,1,"M PAÍS-CHA-",10
50,"50073",2122,1559,1540,14,19,"M PAÍS-CHA-",51
50,"50045",1217,891,878,10,13,"M PAÍS-CHA-",26
50,"50291",95,76,76,0,0,"M PAÍS-CHA-",6
50,"50182",3657,2499,2485,23,14,"M PAÍS-CHA-",170
50,"50118",2101,1484,1477,17,7,"M PAÍS-CHA-",60
50,"50139",318,237,237,1,0,"M PAÍS-CHA-",6
50,"50067",13928,9831,9699,92,132,"M PAÍS-CHA-",342
50,"50142",23,16,16,1,0,"M PAÍS-CHA-",3
50,"50090",134,96,96,0,0,"M PAÍS-CHA-",0
50,"50185",140,93,92,1,1,"M PAÍS-CHA-",6
50,"50155",95,65,65,0,0,"M PAÍS-CHA-",1
50,"50227",107,62,62,1,0,"M PAÍS-CHA-",1
50,"50218",112,88,88,1,0,"M PAÍS-CHA-",4
50,"50267",565,380,375,4,5,"M PAÍS-CHA-",30
50,"50232",160,93,92,1,1,"M PAÍS-CHA-",3
50,"50210",37,26,26,0,0,"M PAÍS-CHA-",1
50,"50256",70,43,43,0,0,"M PAÍS-CHA-",1
50,"50050",87,62,62,1,0,"M PAÍS-CHA-",1
50,"50074",6156,4100,4022,33,78,"M PAÍS-CHA-",237
50,"50147",744,508,506,5,2,"M PAÍS-CHA-",26
50,"50221",29,18,18,0,0,"M PAÍS-CHA-",2
50,"50025",4541,3110,3083,39,27,"M PAÍS-CHA-",132
50,"50271",246,179,173,4,6,"M PAÍS-CHA-",4
50,"50191",446,327,326,1,1,"M PAÍS-CHA-",15
50,"50150",624,387,384,2,3,"M PAÍS-CHA-",10
50,"50041",16,10,10,0,0,"M PAÍS-CHA-",2
50,"50162",135,100,99,3,1,"M PAÍS-CHA-",4
50,"50252",5019,3486,3456,53,30,"M PAÍS-CHA-",170
50,"50173",156,114,114,0,0,"M PAÍS-CHA-",3
50,"50219",4283,3034,2990,30,44,"M PAÍS-CHA-",146
50,"50176",220,142,142,3,0,"M PAÍS-CHA-",2
50,"50122",68,43,42,1,1,"M PAÍS-CHA-",2
50,"50171",99,69,69,2,0,"M PAÍS-CHA-",2
50,"50002",125,91,86,0,5,"M PAÍS-CHA-",0
50,"50116",169,124,123,0,1,"M PAÍS-CHA-",1
50,"50042",19,17,17,1,0,"M PAÍS-CHA-",0
50,"50253",379,294,290,1,4,"M PAÍS-CHA-",5
50,"50068",1943,1299,1287,10,12,"M PAÍS-CHA-",30
50,"50076",70,56,56,0,0,"M PAÍS-CHA-",1
50,"50203",1065,817,804,5,13,"M PAÍS-CHA-",34
50,"50195",53,42,38,0,4,"M PAÍS-CHA-",1
50,"50024",543,400,397,3,3,"M PAÍS-CHA-",5
50,"50125",340,230,229,2,1,"M PAÍS-CHA-",1
50,"50217",426,333,333,1,0,"M PAÍS-CHA-",2
50,"50275",111,50,50,0,0,"M PAÍS-CHA-",0
50,"50294",65,45,45,0,0,"M PAÍS-CHA-",1
50,"50177",288,196,193,0,3,"M PAÍS-CHA-",3
50,"50146",189,149,149,3,0,"M PAÍS-CHA-",4
50,"50251",8209,5732,5658,66,74,"M PAÍS-CHA-",178
50,"50229",65,46,46,1,0,"M PAÍS-CHA-",1
50,"50077",201,140,140,1,0,"M PAÍS-CHA-",5
50,"50204",2396,1723,1712,17,11,"M PAÍS-CHA-",30
50,"50003",117,89,89,1,0,"M PAÍS-CHA-",2
50,"50270",38,26,25,0,1,"M PAÍS-CHA-",4
50,"50278",175,133,131,2,2,"M PAÍS-CHA-",4
50,"50121",270,209,208,3,1,"M PAÍS-CHA-",7
50,"50033",61,44,44,1,0,"M PAÍS-CHA-",8
50,"50175",907,638,632,11,6,"M PAÍS-CHA-",22
50,"50130",354,225,222,1,3,"M PAÍS-CHA-",6
50,"50295",48,41,41,0,0,"M PAÍS-CHA-",1
50,"50053",643,476,466,3,10,"M PAÍS-CHA-",9
50,"50170",357,245,242,6,3,"M PAÍS-CHA-",5
50,"50255",199,152,147,3,5,"M PAÍS-CHA-",3
50,"50094",1500,1041,1022,12,19,"M PAÍS-CHA-",35
50,"50181",999,748,732,3,16,"M PAÍS-CHA-",19
50,"50078",227,168,166,0,2,"M PAÍS-CHA-",7
50,"50266",120,77,76,3,1,"M PAÍS-CHA-",2
50,"50228",249,207,207,3,0,"M PAÍS-CHA-",3
50,"50148",304,213,211,2,2,"M PAÍS-CHA-",9
50,"50034",767,516,511,10,5,"M PAÍS-CHA-",8
50,"50051",802,551,550,2,1,"M PAÍS-CHA-",7
50,"50004",475,360,356,2,4,"M PAÍS-CHA-",21
50,"50279",74,49,49,0,0,"M PAÍS-CHA-",0
50,"50280",290,220,216,1,4,"M PAÍS-CHA-",14
50,"50105",277,203,198,4,5,"M PAÍS-CHA-",2
50,"50054",55,37,37,2,0,"M PAÍS-CHA-",1
50,"50214",18,18,14,1,4,"M PAÍS-CHA-",1
50,"50131",212,152,147,4,5,"M PAÍS-CHA-",1
50,"50264",151,111,110,0,1,"M PAÍS-CHA-",4
50,"50029",594,432,431,3,1,"M PAÍS-CHA-",5
50,"50071",126,84,84,0,0,"M PAÍS-CHA-",0
50,"50248",501,344,328,3,16,"M PAÍS-CHA-",13
50,"50043",241,155,154,1,1,"M PAÍS-CHA-",3
50,"50190",669,532,518,10,14,"M PAÍS-CHA-",11
50,"50021",25,21,21,0,0,"M PAÍS-CHA-",0
50,"50066",2903,2095,2078,19,17,"M PAÍS-CHA-",93
50,"50154",114,92,92,1,0,"M PAÍS-CHA-",0
50,"50046",162,125,125,6,0,"M PAÍS-CHA-",5
50,"50038",1404,1024,1007,15,17,"M PAÍS-CHA-",40
50,"50132",780,549,538,7,11,"M PAÍS-CHA-",14
50,"50096",34,22,22,0,0,"M PAÍS-CHA-",0
50,"50157",289,199,196,1,3,"M PAÍS-CHA-",2
50,"50106",123,78,78,0,0,"M PAÍS-CHA-",2
50,"50080",34,27,27,0,0,"M PAÍS-CHA-",7
50,"50230",1140,771,767,11,4,"M PAÍS-CHA-",21
50,"50268",41,32,32,1,0,"M PAÍS-CHA-",4
50,"50249",283,202,200,0,2,"M PAÍS-CHA-",6
50,"50199",318,206,201,1,5,"M PAÍS-CHA-",4
50,"50115",3279,2170,2131,27,39,"M PAÍS-CHA-",52
50,"50197",95,69,68,2,1,"M PAÍS-CHA-",2
50,"50056",399,296,296,3,0,"M PAÍS-CHA-",10
50,"50273",33,24,24,1,0,"M PAÍS-CHA-",2
50,"50257",159,128,125,2,3,"M PAÍS-CHA-",12
50,"50006",913,670,654,13,16,"M PAÍS-CHA-",21
50,"50208",1761,1267,1250,16,17,"M PAÍS-CHA-",63
50,"50072",183,131,129,0,2,"M PAÍS-CHA-",4
50,"50184",87,70,70,0,0,"M PAÍS-CHA-",2
50,"50070",50,30,29,0,1,"M PAÍS-CHA-",0
50,"50233",96,78,78,0,0,"M PAÍS-CHA-",0
50,"50031",134,78,75,0,3,"M PAÍS-CHA-",2
50,"50007",51,34,34,1,0,"M PAÍS-CHA-",1
50,"50124",394,269,266,0,3,"M PAÍS-CHA-",3
50,"50160",2140,1421,1394,14,27,"M PAÍS-CHA-",40
50,"50209",2785,1893,1865,24,28,"M PAÍS-CHA-",63
50,"50134",120,85,82,4,3,"M PAÍS-CHA-",1
50,"50117",123,93,93,4,0,"M PAÍS-CHA-",3
50,"50081",487,355,349,5,6,"M PAÍS-CHA-",7
50,"50283",69,46,46,0,0,"M PAÍS-CHA-",0
50,"50108",50,37,37,0,0,"M PAÍS-CHA-",1
50,"50243",307,227,224,2,3,"M PAÍS-CHA-",0
50,"50198",47,32,32,0,0,"M PAÍS-CHA-",2
50,"50057",1331,933,922,10,11,"M PAÍS-CHA-",22
50,"50123",430,304,297,3,7,"M PAÍS-CHA-",4
50,"50149",34,25,25,0,0,"M PAÍS-CHA-",1
50,"50008",5187,3334,3288,37,46,"M PAÍS-CHA-",134
50,"50235",2421,1721,1702,18,19,"M PAÍS-CHA-",51
50,"50292",130,108,107,0,1,"M PAÍS-CHA-",5
50,"50143",541,373,367,2,6,"M PAÍS-CHA-",34
50,"50259",82,55,55,2,0,"M PAÍS-CHA-",0
50,"50082",82,57,57,0,0,"M PAÍS-CHA-",2
50,"50109",95,65,62,2,3,"M PAÍS-CHA-",5
50,"50058",63,45,43,0,2,"M PAÍS-CHA-",1
50,"50161",98,75,74,2,1,"M PAÍS-CHA-",0
50,"50194",80,51,51,0,0,"M PAÍS-CHA-",1
50,"50152",1351,942,932,14,10,"M PAÍS-CHA-",23
50,"50047",38,24,24,0,0,"M PAÍS-CHA-",3
50,"50153",914,683,675,9,8,"M PAÍS-CHA-",18
50,"50075",70,55,55,1,0,"M PAÍS-CHA-",0
50,"50284",129,98,98,0,0,"M PAÍS-CHA-",3
50,"50083",81,64,64,2,0,"M PAÍS-CHA-",2
50,"50136",532,366,361,3,5,"M PAÍS-CHA-",3
50,"50236",95,77,75,0,2,"M PAÍS-CHA-",0
50,"50297",503800,365284,362768,3385,2516,"M PAÍS-CHA-",17718
50,"50277",45,34,34,0,0,"M PAÍS-CHA-",8
50,"50001",89,68,68,0,0,"M PAÍS-CHA-",2
50,"50009",97,61,61,1,0,"M PAÍS-CHA-",3
50,"50179",255,197,197,0,0,"M PAÍS-CHA-",3
50,"50261",201,154,151,0,3,"M PAÍS-CHA-",4
50,"50211",236,174,173,0,1,"M PAÍS-CHA-",1
50,"50084",67,47,47,1,0,"M PAÍS-CHA-",3
50,"50144",31,24,24,0,0,"M PAÍS-CHA-",3
50,"50128",26,23,23,0,0,"M PAÍS-CHA-",1
50,"50163",3846,2863,2840,25,23,"M PAÍS-CHA-",134
50,"50010",67,52,52,1,0,"M PAÍS-CHA-",1
50,"50110",340,248,238,1,10,"M PAÍS-CHA-",1
50,"50285",657,448,442,4,6,"M PAÍS-CHA-",11
50,"50099",3036,2137,2113,17,24,"M PAÍS-CHA-",51
50,"50201",449,345,344,4,1,"M PAÍS-CHA-",13
50,"50129",212,129,127,0,2,"M PAÍS-CHA-",2
50,"50060",171,126,125,1,1,"M PAÍS-CHA-",9
50,"50032",243,167,164,3,3,"M PAÍS-CHA-",9
50,"50225",1532,983,971,12,12,"M PAÍS-CHA-",19
50,"50212",32,26,26,0,0,"M PAÍS-CHA-",0
50,"50286",75,54,53,0,1,"M PAÍS-CHA-",4
50,"50164",381,245,243,3,2,"M PAÍS-CHA-",10
50,"50237",100,75,75,2,0,"M PAÍS-CHA-",4
50,"50298",5439,4053,4007,41,46,"M PAÍS-CHA-",114
50,"50137",958,740,731,8,9,"M PAÍS-CHA-",22
50,"50262",1161,849,832,11,17,"M PAÍS-CHA-",20
50,"50011",117,90,89,3,1,"M PAÍS-CHA-",4
50,"50085",182,121,121,0,0,"M PAÍS-CHA-",1
50,"50276",118,91,91,0,0,"M PAÍS-CHA-",3
50,"50138",45,37,37,3,0,"M PAÍS-CHA-",2
50,"50901",133,96,96,0,0,"M PAÍS-CHA-",7
50,"50205",72,51,49,0,2,"M PAÍS-CHA-",1
50,"50036",100,76,76,1,0,"M PAÍS-CHA-",3
50,"50113",587,471,461,2,10,"M PAÍS-CHA-",18
50,"50213",92,70,70,2,0,"M PAÍS-CHA-",1
50,"50189",678,494,487,6,7,"M PAÍS-CHA-",4
50,"50287",253,189,188,11,1,"M PAÍS-CHA-",3
50,"50263",171,110,108,1,2,"M PAÍS-CHA-",2
50,"50044",224,159,159,2,0,"M PAÍS-CHA-",7
50,"50247",852,600,594,8,6,"M PAÍS-CHA-",19
50,"50165",1768,1255,1222,20,33,"M PAÍS-CHA-",37
50,"50156",212,156,151,2,5,"M PAÍS-CHA-",6
50,"50239",63,46,45,1,1,"M PAÍS-CHA-",2
50,"50902",77,65,62,0,3,"M PAÍS-CHA-",1
50,"50062",1885,1332,1308,15,24,"M PAÍS-CHA-",47
50,"50222",1574,1024,1008,12,16,"M PAÍS-CHA-",30
50,"50086",176,106,102,1,4,"M PAÍS-CHA-",1
50,"50012",94,76,72,0,4,"M PAÍS-CHA-",2
50,"50114",132,108,108,0,0,"M PAÍS-CHA-",0
50,"50231",253,199,195,4,4,"M PAÍS-CHA-",4
50,"50013",199,158,158,0,0,"M PAÍS-CHA-",2
50,"50095",12149,8322,8239,91,83,"M PAÍS-CHA-",258
50,"50166",235,186,186,0,0,"M PAÍS-CHA-",3
50,"50005",228,185,184,2,1,"M PAÍS-CHA-",2
50,"50206",457,349,345,5,4,"M PAÍS-CHA-",18
50,"50272",13226,9250,9153,97,97,"M PAÍS-CHA-",357
50,"50288",3440,2513,2486,26,27,"M PAÍS-CHA-",90
50,"50240",943,693,683,12,10,"M PAÍS-CHA-",25
50,"50063",64,49,49,0,0,"M PAÍS-CHA-",0
50,"50079",226,162,160,1,2,"M PAÍS-CHA-",7
50,"50030",197,124,124,1,0,"M PAÍS-CHA-",4
50,"50087",28,19,19,0,0,"M PAÍS-CHA-",0
50,"50281",68,52,50,0,2,"M PAÍS-CHA-",2
50,"50215",20,14,14,0,0,"M PAÍS-CHA-",0
50,"50088",274,195,191,2,4,"M PAÍS-CHA-",0
50,"50140",153,96,95,1,1,"M PAÍS-CHA-",0
50,"50903",2268,1685,1670,16,15,"M PAÍS-CHA-",138
50,"50188",26,23,23,0,0,"M PAÍS-CHA-",0
50,"50223",906,702,693,9,9,"M PAÍS-CHA-",11
50,"50159",640,493,486,3,7,"M PAÍS-CHA-",6
50,"50168",29,20,20,0,0,"M PAÍS-CHA-",4
50,"50022",504,373,369,12,4,"M PAÍS-CHA-",6
50,"50289",53,42,42,1,0,"M PAÍS-CHA-",8
50,"50014",119,81,81,0,0,"M PAÍS-CHA-",2
50,"50265",74,54,54,1,0,"M PAÍS-CHA-",1
50,"50241",582,414,406,2,8,"M PAÍS-CHA-",13
50,"50015",81,57,56,0,1,"M PAÍS-CHA-",1
50,"50064",439,348,346,1,2,"M PAÍS-CHA-",7
50,"50216",236,169,167,0,2,"M PAÍS-CHA-",3
50,"50089",8616,6420,6364,50,56,"M PAÍS-CHA-",253
50,"50133",98,76,76,0,0,"M PAÍS-CHA-",1
50,"50234",242,159,154,4,5,"M PAÍS-CHA-",7
50,"50242",99,74,74,0,0,"M PAÍS-CHA-",14
31,"31076",2543,1965,1956,19,9,"NA+",956
31,"31104",1751,1147,1125,8,22,"NA+",302
31,"31068",2816,2028,1989,20,39,"NA+",642
31,"31128",349,217,215,4,2,"NA+",49
31,"31251",3144,2197,2164,18,33,"NA+",669
31,"31007",122,88,82,1,6,"NA+",33
31,"31189",1125,702,698,6,4,"NA+",65
31,"31100",256,166,165,0,1,"NA+",64
31,"31257",915,654,642,9,12,"NA+",175
31,"31002",431,294,290,3,4,"NA+",98
31,"31263",231,137,137,1,0,"NA+",6
31,"31261",240,161,158,2,3,"NA+",50
31,"31031",212,134,132,2,2,"NA+",9
31,"31233",91,62,60,2,2,"NA+",25
31,"31907",11272,8478,8421,97,57,"NA+",2315
31,"31148",92,62,59,2,3,"NA+",11
31,"31156",238,175,174,2,1,"NA+",24
31,"31135",111,73,72,3,1,"NA+",34
31,"31139",152,100,100,1,0,"NA+",29
31,"31207",280,194,191,3,3,"NA+",44
31,"31149",2285,1531,1520,10,11,"NA+",124
31,"31164",542,410,408,5,2,"NA+",147
31,"31027",811,527,521,1,6,"NA+",37
31,"31043",29,23,23,0,0,"NA+",11
31,"31092",683,413,413,6,0,"NA+",84
31,"31102",135,60,60,1,0,"NA+",11
31,"31080",486,362,361,4,1,"NA+",93
31,"31143",91,44,41,1,3,"NA+",15
31,"31152",1255,826,817,8,9,"NA+",269
31,"31130",321,203,203,0,0,"NA+",48
31,"31209",149,111,110,0,1,"NA+",22
31,"31016",7790,5541,5502,56,39,"NA+",721
31,"31224",884,637,630,7,7,"NA+",247
31,"31107",1671,1204,1182,12,22,"NA+",631
31,"31171",670,466,462,1,4,"NA+",89
31,"31908",1076,763,762,5,1,"NA+",87
31,"31201",151450,105649,104976,1004,673,"NA+",34638
31,"31040",186,131,129,1,2,"NA+",48
31,"31058",199,134,133,2,1,"NA+",31
31,"31259",475,313,311,5,2,"NA+",25
31,"31110",83,61,61,1,0,"NA+",13
31,"31041",1671,1118,1105,15,13,"NA+",330
31,"31039",92,70,69,1,1,"NA+",15
31,"31094",105,70,70,1,0,"NA+",30
31,"31063",84,59,59,0,0,"NA+",29
31,"31112",91,56,56,0,0,"NA+",11
31,"31062",1070,778,770,10,8,"NA+",279
31,"31902",4661,3228,3201,39,27,"NA+",838
31,"31249",1798,1235,1227,13,8,"NA+",409
31,"31069",823,596,595,1,1,"NA+",215
31,"31081",338,229,227,1,2,"NA+",31
31,"31125",271,173,171,3,2,"NA+",59
31,"31223",953,667,654,4,13,"NA+",188
31,"31247",141,99,96,1,3,"NA+",26
31,"31160",104,83,82,1,1,"NA+",26
31,"31153",2174,1417,1415,12,2,"NA+",115
31,"31236",1319,815,808,8,7,"NA+",216
31,"31120",376,211,209,7,2,"NA+",59
31,"31230",90,66,66,0,0,"NA+",26
31,"31177",245,161,159,1,2,"NA+",43
31,"31010",5719,3799,3770,22,29,"NA+",417
31,"31167",833,581,573,2,8,"NA+",190
31,"31014",268,168,168,2,0,"NA+",60
31,"31146",30,22,22,1,0,"NA+",14
31,"31198",36,30,30,0,0,"NA+",1
31,"31154",217,107,104,0,3,"NA+",22
31,"31220",742,551,539,6,12,"NA+",232
31,"31245",76,51,48,2,3,"NA+",19
31,"31033",45,25,25,2,0,"NA+",6
31,"31025",762,497,490,1,7,"NA+",100
31,"31159",1097,813,812,2,1,"NA+",237
31,"31001",79,56,56,0,0,"NA+",12
31,"31038",1343,975,963,16,12,"NA+",326
31,"31064",1398,1035,1031,5,4,"NA+",380
31,"31196",31,23,23,0,0,"NA+",5
31,"31052",101,78,75,0,3,"NA+",31
31,"31216",3867,2592,2566,37,26,"NA+",756
31,"31051",241,169,167,3,2,"NA+",43
31,"31905",2992,1994,1984,9,10,"NA+",504
31,"31234",146,101,101,0,0,"NA+",39
31,"31124",207,134,134,2,0,"NA+",65
31,"31906",2707,1800,1781,22,19,"NA+",393
31,"31030",135,94,94,0,0,"NA+",15
31,"31246",130,89,87,2,2,"NA+",24
31,"31238",119,96,95,4,1,"NA+",23
31,"31255",103,79,79,0,0,"NA+",35
31,"31208",2568,1855,1835,24,20,"NA+",485
31,"31213",99,50,50,0,0,"NA+",0
31,"31242",258,168,167,2,1,"NA+",59
31,"31243",300,216,213,6,3,"NA+",58
31,"31015",1989,1399,1386,17,13,"NA+",474
31,"31136",461,294,293,3,1,"NA+",49
31,"31019",1831,1231,1224,17,7,"NA+",189
31,"31088",5656,3929,3893,56,36,"NA+",1154
31,"31048",166,121,119,1,2,"NA+",64
31,"31133",34,27,27,1,0,"NA+",2
31,"31231",104,65,65,1,0,"NA+",32
31,"31113",130,77,76,0,1,"NA+",19
31,"31212",128,91,91,1,0,"NA+",47
31,"31185",461,291,290,1,1,"NA+",87
31,"31009",674,455,451,2,4,"NA+",112
31,"31181",133,87,84,1,3,"NA+",25
31,"31221",1228,823,815,6,8,"NA+",156
31,"31126",352,223,223,3,0,"NA+",25
31,"31141",106,66,61,1,5,"NA+",30
31,"31032",1670,1158,1147,18,11,"NA+",383
31,"31017",375,250,250,10,0,"NA+",61
31,"31053",509,354,350,4,4,"NA+",101
31,"31049",679,461,453,2,8,"NA+",58
31,"31106",721,547,545,1,2,"NA+",183
31,"31066",819,577,559,4,18,"NA+",211
31,"31199",138,86,84,0,2,"NA+",21
31,"31184",65,41,40,0,1,"NA+",16
31,"31072",5324,3733,3684,33,49,"NA+",1362
31,"31123",615,350,347,4,3,"NA+",62
31,"31904",1559,989,972,11,17,"NA+",169
31,"31091",322,201,201,3,0,"NA+",18
31,"31131",913,672,664,8,8,"NA+",236
31,"31262",234,190,188,0,2,"NA+",46
31,"31103",40,28,27,0,1,"NA+",19
31,"31067",1887,1265,1249,6,16,"NA+",341
31,"31250",2761,1776,1759,13,17,"NA+",193
31,"31222",57,35,34,3,1,"NA+",1
31,"31226",572,347,343,4,4,"NA+",24
31,"31144",760,442,441,4,1,"NA+",52
31,"31084",1946,1367,1362,9,5,"NA+",121
31,"31192",160,125,123,0,2,"NA+",34
31,"31047",238,163,163,2,0,"NA+",61
31,"31059",182,121,121,1,0,"NA+",24
31,"31075",113,69,69,2,0,"NA+",15
31,"31173",845,642,636,4,6,"NA+",257
31,"31214",87,55,54,0,1,"NA+",8
31,"31227",8118,5691,5636,65,55,"NA+",1192
31,"31129",388,239,238,3,1,"NA+",10
31,"31011",715,483,481,5,2,"NA+",162
31,"31169",2203,1429,1415,15,14,"NA+",465
31,"31023",7778,5977,5948,106,29,"NA+",2129
31,"31162",48,28,27,1,1,"NA+",5
31,"31217",327,204,196,1,8,"NA+",72
31,"31193",1440,1062,1055,11,7,"NA+",270
31,"31021",59,42,42,1,0,"NA+",8
31,"31191",3024,2156,2133,23,23,"NA+",637
31,"31228",496,356,354,1,2,"NA+",100
31,"31105",1471,1144,1124,10,20,"NA+",433
31,"31203",30,19,19,2,0,"NA+",7
31,"31252",80,52,52,1,0,"NA+",10
31,"31044",291,227,227,1,0,"NA+",30
31,"31215",4670,3270,3219,33,51,"NA+",1071
31,"31134",172,106,106,1,0,"NA+",24
31,"31170",44,31,30,2,1,"NA+",5
31,"31071",13,11,11,0,0,"NA+",4
31,"31155",246,165,161,3,4,"NA+",43
31,"31037",91,70,70,0,0,"NA+",3
31,"31111",91,52,52,0,0,"NA+",3
31,"31034",31,24,24,0,0,"NA+",5
31,"31229",39,32,32,0,0,"NA+",11
31,"31253",121,100,100,0,0,"NA+",5
31,"31055",267,192,191,0,1,"NA+",14
31,"31200",745,489,483,1,6,"NA+",89
31,"31026",130,108,107,0,1,"NA+",43
31,"31204",36,25,25,0,0,"NA+",11
31,"31050",6016,3675,3612,41,63,"NA+",631
31,"31258",7879,5668,5631,50,37,"NA+",1063
31,"31116",57,27,27,3,0,"NA+",16
31,"31254",1916,1336,1322,9,14,"NA+",485
31,"31188",319,197,191,3,6,"NA+",47
31,"31065",1843,1311,1300,12,11,"NA+",465
31,"31061",48,45,45,2,0,"NA+",28
31,"31183",718,536,534,5,2,"NA+",173
31,"31132",147,100,100,2,0,"NA+",41
31,"31235",156,112,108,1,4,"NA+",23
31,"31035",50,30,29,0,1,"NA+",8
31,"31205",419,290,289,4,1,"NA+",83
31,"31202",4360,2806,2767,30,39,"NA+",1078
31,"31142",1389,909,900,9,9,"NA+",314
31,"31237",182,138,135,2,3,"NA+",51
31,"31057",1741,1237,1219,6,18,"NA+",466
31,"31121",62,42,42,0,0,"NA+",17
31,"31114",388,272,271,3,1,"NA+",57
31,"31265",76,43,40,0,3,"NA+",9
31,"31225",35,29,28,0,1,"NA+",4
31,"31086",13781,10133,10054,114,79,"NA+",3195
31,"31097",10559,6977,6919,71,58,"NA+",2286
31,"31036",879,601,589,5,12,"NA+",162
31,"31256",95,55,55,1,0,"NA+",4
31,"31182",29,25,25,0,0,"NA+",8
31,"31127",131,90,86,0,4,"NA+",29
31,"31087",179,124,124,3,0,"NA+",13
31,"31042",2707,1926,1900,11,26,"NA+",709
31,"31901",15487,11077,10991,117,86,"NA+",3058
31,"31172",370,257,250,6,7,"NA+",102
31,"31079",65,46,46,2,0,"NA+",14
31,"31089",236,168,167,1,1,"NA+",77
31,"31077",5416,3840,3794,38,46,"NA+",1479
31,"31211",17,15,14,3,1,"NA+",9
31,"31147",110,79,78,1,1,"NA+",33
31,"31098",1984,1443,1428,11,15,"NA+",379
31,"31022",477,303,301,2,2,"NA+",19
31,"31054",453,279,276,2,3,"NA+",37
31,"31161",350,261,256,1,5,"NA+",49
31,"31239",282,196,193,6,3,"NA+",47
31,"31206",2077,1433,1417,15,16,"NA+",392
31,"31179",486,315,312,3,3,"NA+",127
31,"31145",160,121,120,2,1,"NA+",65
31,"31157",3447,2182,2160,29,22,"NA+",690
31,"31060",14323,9547,9434,79,113,"NA+",2130
31,"31137",198,83,83,1,0,"NA+",16
31,"31074",394,293,292,5,1,"NA+",57
31,"31024",100,52,52,0,0,"NA+",2
31,"31118",156,104,104,3,0,"NA+",20
31,"31168",238,176,174,1,2,"NA+",74
31,"31197",67,51,51,2,0,"NA+",4
31,"31117",583,373,372,3,1,"NA+",8
31,"31175",66,46,46,0,0,"NA+",18
31,"31078",2418,1752,1729,16,23,"NA+",564
31,"31176",2919,1974,1933,27,41,"NA+",592
31,"31099",51,38,38,0,0,"NA+",11
31,"31095",71,59,59,0,0,"NA+",8
31,"31140",112,73,73,1,0,"NA+",19
31,"31190",44,30,30,1,0,"NA+",10
31,"31028",215,121,121,2,0,"NA+",19
31,"31090",139,67,67,0,0,"NA+",7
31,"31005",279,183,183,4,0,"NA+",65
31,"31085",500,365,362,2,3,"NA+",25
31,"31178",476,323,320,7,3,"NA+",78
31,"31115",159,93,93,2,0,"NA+",14
31,"31056",186,128,124,2,4,"NA+",36
31,"31174",100,55,55,0,0,"NA+",16
31,"31006",1877,1328,1310,14,18,"NA+",422
31,"31018",426,287,283,2,4,"NA+",70
31,"31096",99,79,79,3,0,"NA+",29
31,"31003",121,71,71,0,0,"NA+",11
31,"31070",2633,1714,1682,16,32,"NA+",475
31,"31219",80,59,58,2,1,"NA+",21
31,"31187",99,53,52,0,1,"NA+",5
31,"31020",435,224,222,1,2,"NA+",11
31,"31151",53,37,37,0,0,"NA+",11
31,"31241",126,86,85,2,1,"NA+",37
31,"31108",1819,1348,1325,13,23,"NA+",537
31,"31163",2011,1422,1404,6,18,"NA+",491
31,"31083",49,39,39,1,0,"NA+",8
31,"31248",272,142,138,3,4,"NA+",37
31,"31166",242,172,172,2,0,"NA+",89
31,"31194",328,224,222,3,2,"NA+",40
31,"31008",61,42,42,0,0,"NA+",20
31,"31109",1657,1165,1160,12,5,"NA+",380
31,"31244",157,69,69,0,0,"NA+",13
31,"31012",763,550,542,7,8,"NA+",138
31,"31073",298,207,206,1,1,"NA+",17
31,"31232",25687,17548,17304,243,244,"NA+",6398
31,"31264",179,91,90,2,1,"NA+",11
31,"31046",53,38,38,0,0,"NA+",23
31,"31186",283,183,182,1,1,"NA+",37
31,"31045",510,347,345,8,2,"NA+",87
31,"31119",35,24,24,1,0,"NA+",4
31,"31158",248,156,151,0,5,"NA+",41
31,"31013",615,371,365,1,6,"NA+",81
31,"31195",169,108,108,0,0,"NA+",12
31,"31903",6950,4430,4394,39,36,"NA+",746
31,"31138",948,629,627,8,2,"NA+",38
31,"31122",4981,3539,3504,38,35,"NA+",804
31,"31210",186,131,130,2,1,"NA+",33
31,"31240",514,352,352,3,0,"NA+",20
31,"31260",1265,817,815,7,2,"NA+",243
31,"31029",913,606,601,14,5,"NA+",229
31,"31180",202,144,143,1,1,"NA+",51
31,"31101",1428,986,981,6,5,"NA+",264
31,"31004",31,22,22,1,0,"NA+",8
31,"31150",200,120,119,1,1,"NA+",19
31,"31093",275,201,198,3,3,"NA+",32
31,"31165",2772,1946,1930,16,16,"NA+",628
31,"31082",627,385,385,5,0,"NA+",54
35,"35023",11742,7787,7651,95,136,"NC-CCa-PNC",1105
35,"35016",300581,181532,179831,1458,1701,"NC-CCa-PNC",11178
35,"35009",20229,13378,13201,95,177,"NC-CCa-PNC",2609
35,"35018",13153,7742,7674,80,68,"NC-CCa-PNC",877
35,"35026",83172,48751,48109,449,642,"NC-CCa-PNC",5371
35,"35019",32830,18390,18243,87,147,"NC-CCa-PNC",1969
35,"35001",4566,3148,3105,18,43,"NC-CCa-PNC",201
35,"35030",10046,5584,5505,44,79,"NC-CCa-PNC",1179
35,"35020",5941,3740,3702,27,38,"NC-CCa-PNC",835
35,"35029",4415,2498,2472,29,26,"NC-CCa-PNC",650
35,"35011",24859,15025,14833,149,192,"NC-CCa-PNC",1551
35,"35025",1752,1113,1095,5,18,"NC-CCa-PNC",101
35,"35006",31373,20764,20476,189,288,"NC-CCa-PNC",1757
35,"35034",8392,3946,3908,27,38,"NC-CCa-PNC",527
35,"35004",41975,20773,20602,156,171,"NC-CCa-PNC",2442
35,"35007",517,347,345,2,2,"NC-CCa-PNC",123
35,"35005",1009,680,668,2,12,"NC-CCa-PNC",82
35,"35008",6214,4193,4143,33,50,"NC-CCa-PNC",354
35,"35031",7456,4938,4868,39,70,"NC-CCa-PNC",510
35,"35028",10156,5483,5425,56,58,"NC-CCa-PNC",495
35,"35015",10752,5289,5222,39,67,"NC-CCa-PNC",958
35,"35002",24229,15311,15133,101,178,"NC-CCa-PNC",1884
35,"35024",14323,8360,8289,81,71,"NC-CCa-PNC",1434
35,"35017",27498,15513,15240,121,273,"NC-CCa-PNC",1753
35,"35032",3331,2293,2252,23,41,"NC-CCa-PNC",173
35,"35027",10502,6831,6750,67,81,"NC-CCa-PNC",681
35,"35012",10862,5617,5568,40,49,"NC-CCa-PNC",1138
35,"35003",5644,2987,2943,20,44,"NC-CCa-PNC",357
35,"35022",51765,29309,29034,184,275,"NC-CCa-PNC",3128
35,"35033",6393,4147,4072,38,75,"NC-CCa-PNC",398
35,"35021",15072,9791,9696,80,95,"NC-CCa-PNC",672
35,"35010",3853,2224,2194,18,30,"NC-CCa-PNC",445
35,"35014",11962,5994,5888,60,106,"NC-CCa-PNC",688
35,"35013",6593,4596,4516,47,80,"NC-CCa-PNC",334
32,"32044",794,547,540,2,7,"PACMA",5
28,"28029",576,443,443,4,0,"PACMA",3
13,"13059",193,150,150,0,0,"PACMA",0
44,"44077",68,52,51,0,1,"PACMA",0
14,"14070",1280,911,902,4,9,"PACMA",1
25,"25030",117,76,76,0,0,"PACMA",1
34,"34130",195,154,153,5,1,"PACMA",0
28,"28005",136518,101397,100485,871,912,"PACMA",1135
5,"5213",94,72,70,0,2,"PACMA",1
2,"2021",1013,806,798,6,8,"PACMA",3
9,"9901",334,228,226,4,2,"PACMA",0
44,"44110",37,30,30,0,0,"PACMA",1
9,"9225",80,55,55,0,0,"PACMA",0
22,"22117",2384,1606,1596,18,10,"PACMA",8
47,"47131",167,122,120,2,2,"PACMA",0
50,"50062",1885,1332,1308,15,24,"PACMA",13
19,"19212",678,501,491,1,10,"PACMA",2
45,"45194",64,45,44,1,1,"PACMA",0
22,"22175",184,129,128,0,1,"PACMA",1
19,"19136",11,10,10,0,0,"PACMA",0
24,"24222",14499,10219,10076,99,143,"PACMA",66
2,"2063",1358,987,973,3,14,"PACMA",7
19,"19261",33,23,23,0,0,"PACMA",0
50,"50051",802,551,550,2,1,"PACMA",1
22,"22035",225,153,152,1,1,"PACMA",1
50,"50242",99,74,74,0,0,"PACMA",1
19,"19245",1138,798,778,6,20,"PACMA",3
42,"42118",21,11,11,0,0,"PACMA",0
49,"49208",352,223,214,1,9,"PACMA",1
19,"19009",263,186,184,0,2,"PACMA",0
28,"28025",405,294,291,5,3,"PACMA",0
22,"22149",301,211,210,1,1,"PACMA",0
2,"2084",298,197,191,2,6,"PACMA",0
9,"9139",98,79,79,2,0,"PACMA",2
22,"22109",261,184,183,1,1,"PACMA",0
9,"9478",45,34,34,1,0,"PACMA",0
28,"28013",41661,29431,29168,241,263,"PACMA",266
37,"37235",214,163,159,2,4,"PACMA",0
33,"33048",132,86,85,1,1,"PACMA",0
32,"32084",878,532,527,8,5,"PACMA",2
40,"40021",18,15,15,0,0,"PACMA",0
12,"12012",2622,2084,2056,12,28,"PACMA",4
49,"49251",159,116,109,2,7,"PACMA",1
3,"3025",1304,944,934,4,10,"PACMA",12
1,"1006",174,124,122,1,2,"PACMA",4
15,"15071",7780,4937,4848,34,89,"PACMA",29
49,"49022",282,230,229,2,1,"PACMA",0
5,"5094",133,105,105,0,0,"PACMA",0
26,"26042",795,578,572,8,6,"PACMA",5
41,"41093",19064,14867,14700,151,167,"PACMA",131
22,"22013",271,200,197,3,3,"PACMA",0
50,"50184",87,70,70,0,0,"PACMA",0
7,"7047",2399,1504,1477,20,27,"PACMA",22
34,"34178",119,94,91,0,3,"PACMA",0
46,"46220",49112,33766,33424,312,342,"PACMA",330
39,"39041",1753,1285,1269,7,16,"PACMA",9
16,"16154",4739,3416,3379,33,37,"PACMA",17
48,"48030",591,449,447,2,2,"PACMA",0
11,"11002",4218,3176,3149,16,27,"PACMA",6
26,"26118",71,54,53,1,1,"PACMA",0
29,"29014",218,122,121,3,1,"PACMA",3
9,"9428",102,73,73,1,0,"PACMA",0
18,"18913",771,530,514,2,16,"PACMA",3
5,"5144",65,47,46,1,1,"PACMA",0
17,"17075",340,257,256,2,1,"PACMA",4
20,"20069",147446,102068,101696,564,372,"PACMA",676
13,"13098",1946,1404,1361,13,43,"PACMA",7
22,"22110",700,476,473,3,3,"PACMA",1
42,"42218",68,44,43,0,1,"PACMA",0
9,"9368",29,19,19,1,0,"PACMA",1
39,"39056",2262,1683,1671,14,12,"PACMA",8
50,"50091",39,32,32,0,0,"PACMA",0
16,"16047",214,154,148,3,6,"PACMA",0
42,"42207",48,42,41,0,1,"PACMA",0
3,"3112",650,503,497,3,6,"PACMA",5
24,"24113",346,240,240,2,0,"PACMA",0
46,"46188",693,565,560,2,5,"PACMA",11
37,"37272",132,97,95,0,2,"PACMA",0
4,"4070",1529,1088,1076,8,12,"PACMA",9
36,"36005",8105,5258,5152,54,106,"PACMA",28
22,"22170",672,460,456,5,4,"PACMA",2
3,"3066",41762,28723,28388,358,335,"PACMA",336
37,"37079",77,59,59,1,0,"PACMA",0
16,"16031",35,26,26,0,0,"PACMA",0
48,"48080",9916,6849,6793,44,56,"PACMA",47
44,"44071",585,419,418,6,1,"PACMA",0
2,"2025",7345,5388,5278,51,110,"PACMA",98
26,"26005",2483,1589,1570,13,19,"PACMA",10
45,"45083",568,433,429,2,4,"PACMA",2
44,"44097",126,76,73,0,3,"PACMA",1
9,"9442",368,265,262,1,3,"PACMA",0
19,"19040",53,43,42,1,1,"PACMA",0
10,"10214",216,170,170,2,0,"PACMA",1
18,"18178",664,474,467,1,7,"PACMA",1
34,"34099",53,44,42,0,2,"PACMA",0
50,"50263",171,110,108,1,2,"PACMA",0
18,"18017",18201,11500,11358,94,142,"PACMA",98
22,"22143",190,118,115,1,3,"PACMA",0
19,"19108",95,78,78,0,0,"PACMA",1
21,"21079",678,428,417,2,11,"PACMA",2
9,"9215",359,217,216,2,1,"PACMA",2
25,"25001",143,102,102,1,0,"PACMA",0
3,"3124",459,360,358,0,2,"PACMA",2
9,"9050",57,38,38,1,0,"PACMA",0
48,"48083",6934,4800,4765,21,35,"PACMA",22
34,"34006",79,73,69,2,4,"PACMA",0
26,"26135",152,115,114,0,1,"PACMA",0
10,"10006",1224,907,893,7,14,"PACMA",0
25,"25079",276,202,202,0,0,"PACMA",0
5,"5005",165,127,119,0,8,"PACMA",1
21,"21058",2567,1806,1766,32,40,"PACMA",10
32,"32092",491,280,275,0,5,"PACMA",1
34,"34230",16,11,11,0,0,"PACMA",0
24,"24124",338,196,195,2,1,"PACMA",0
2,"2022",341,243,243,2,0,"PACMA",1
18,"18068",1638,1197,1167,12,30,"PACMA",12
49,"49038",88,63,58,1,5,"PACMA",1
42,"42029",131,94,94,4,0,"PACMA",0
2,"2073",4825,3433,3394,35,39,"PACMA",18
19,"19018",142,112,112,1,0,"PACMA",0
46,"46137",248,201,197,3,4,"PACMA",2
17,"17208",978,723,719,6,4,"PACMA",4
13,"13079",12233,8274,8138,93,136,"PACMA",48
12,"12108",443,354,352,4,2,"PACMA",0
42,"42004",2290,1595,1565,30,30,"PACMA",4
47,"47024",223,170,168,1,2,"PACMA",0
43,"43113",387,305,303,1,2,"PACMA",3
31,"31243",300,216,213,6,3,"PACMA",0
49,"49229",109,80,77,1,3,"PACMA",2
15,"15030",199701,137611,136590,1540,1021,"PACMA",1088
2,"2059",320,225,217,0,8,"PACMA",0
49,"49036",503,319,316,5,3,"PACMA",0
5,"5243",80,57,56,1,1,"PACMA",1
3,"3128",4285,2849,2819,18,30,"PACMA",28
9,"9181",276,194,191,7,3,"PACMA",0
19,"19121",265,205,204,0,1,"PACMA",0
17,"17025",1182,943,938,5,5,"PACMA",4
46,"46236",929,723,716,2,7,"PACMA",5
49,"49094",210,111,111,0,0,"PACMA",0
6,"6002",4313,2914,2804,37,110,"PACMA",18
43,"43022",1436,1028,1024,13,4,"PACMA",0
22,"22254",1084,744,735,10,9,"PACMA",7
31,"31101",1428,986,981,6,5,"PACMA",18
20,"20062",941,688,683,1,5,"PACMA",5
3,"3076",8846,6105,6029,40,76,"PACMA",42
49,"49055",91,72,72,3,0,"PACMA",0
39,"39013",517,359,356,1,3,"PACMA",0
40,"40094",353,265,263,3,2,"PACMA",3
40,"40060",67,40,40,1,0,"PACMA",0
37,"37082",733,468,456,7,12,"PACMA",0
40,"40057",1397,1081,1067,15,14,"PACMA",6
47,"47058",199,126,125,3,1,"PACMA",0
50,"50012",94,76,72,0,4,"PACMA",0
5,"5153",86,58,56,3,2,"PACMA",0
49,"49201",283,232,228,3,4,"PACMA",1
36,"36024",16335,11431,11256,99,175,"PACMA",39
32,"32043",2497,1607,1582,14,25,"PACMA",6
3,"3041",6132,4204,4167,22,37,"PACMA",30
27,"27018",3211,1830,1800,17,30,"PACMA",3
27,"27021",1632,962,935,23,27,"PACMA",2
37,"37254",174,140,135,0,5,"PACMA",4
18,"18171",2098,1521,1460,11,61,"PACMA",8
23,"23019",1466,1117,1090,5,27,"PACMA",4
16,"16130",533,407,404,0,3,"PACMA",5
50,"50028",78,53,53,0,0,"PACMA",0
24,"24170",1806,1232,1220,9,12,"PACMA",7
16,"16216",272,207,204,0,3,"PACMA",0
19,"19048",19,14,13,1,1,"PACMA",0
2,"2061",605,464,458,3,6,"PACMA",3
31,"31224",884,637,630,7,7,"PACMA",0
44,"44135",99,73,73,1,0,"PACMA",0
37,"37104",24,16,16,0,0,"PACMA",0
30,"30902",8294,5235,5174,29,61,"PACMA",58
25,"25122",1929,1408,1398,21,10,"PACMA",8
1,"1008",808,546,536,6,10,"PACMA",7
46,"46182",1312,908,904,5,4,"PACMA",20
40,"40219",573,382,366,5,16,"PACMA",1
4,"4008",466,374,371,3,3,"PACMA",3
10,"10092",260,201,200,1,1,"PACMA",0
17,"17040",551,440,439,5,1,"PACMA",1
50,"50282",55,38,38,1,0,"PACMA",0
47,"47172",135,114,113,0,1,"PACMA",0
6,"6042",984,644,629,5,15,"PACMA",2
18,"18089",14504,9854,9746,100,108,"PACMA",50
36,"36001",2397,1674,1651,6,23,"PACMA",12
49,"49063",303,228,227,3,1,"PACMA",0
31,"31064",1398,1035,1031,5,4,"PACMA",3
18,"18126",1436,1024,1002,9,22,"PACMA",8
19,"19052",21,16,16,0,0,"PACMA",0
45,"45120",113,86,86,0,0,"PACMA",0
1,"1017",817,537,532,3,5,"PACMA",1
5,"5903",137,84,83,0,1,"PACMA",0
2,"2065",441,368,361,0,7,"PACMA",1
40,"40156",272,194,190,4,4,"PACMA",0
9,"9350",421,316,311,5,5,"PACMA",0
24,"24037",330,189,189,1,0,"PACMA",0
50,"50031",134,78,75,0,3,"PACMA",0
40,"40089",209,155,148,2,7,"PACMA",1
1,"1013",710,469,465,2,4,"PACMA",5
25,"25114",96,83,82,1,1,"PACMA",1
39,"39081",440,330,327,1,3,"PACMA",0
10,"10078",365,271,263,7,8,"PACMA",0
44,"44062",31,20,20,0,0,"PACMA",0
39,"39019",2232,1628,1603,10,25,"PACMA",11
29,"29063",305,244,242,2,2,"PACMA",2
47,"47218",981,728,723,4,5,"PACMA",5
5,"5072",92,74,72,1,2,"PACMA",0
46,"46076",610,500,494,1,6,"PACMA",2
41,"41016",7820,5523,5407,57,116,"PACMA",54
9,"9219",27097,17874,17629,192,245,"PACMA",180
22,"22165",449,305,300,3,5,"PACMA",3
37,"37007",391,289,281,7,8,"PACMA",0
5,"5075",96,76,76,0,0,"PACMA",0
22,"22236",232,190,188,2,2,"PACMA",0
42,"42156",29,21,21,0,0,"PACMA",0
10,"10054",523,389,380,1,9,"PACMA",2
9,"9174",768,536,522,6,14,"PACMA",3
45,"45072",653,469,462,1,7,"PACMA",0
44,"44051",2579,1924,1901,10,23,"PACMA",12
9,"9044",55,46,44,1,2,"PACMA",0
24,"24181",1404,944,925,7,19,"PACMA",2
42,"42197",68,54,53,0,1,"PACMA",0
40,"40230",93,66,64,0,2,"PACMA",0
40,"40202",56,33,33,0,0,"PACMA",0
16,"16116",76,59,58,1,1,"PACMA",0
11,"11026",4700,3387,3293,17,94,"PACMA",19
5,"5192",92,75,72,1,3,"PACMA",1
22,"22002",99,81,81,0,0,"PACMA",0
27,"27005",2560,1691,1662,19,29,"PACMA",17
45,"45082",1145,904,893,7,11,"PACMA",3
4,"4062",4457,3241,3197,22,44,"PACMA",18
37,"37190",189,141,139,1,2,"PACMA",0
16,"16107",94,56,56,0,0,"PACMA",0
43,"43065",379,281,277,4,4,"PACMA",2
45,"45181",2330,1693,1661,10,32,"PACMA",3
41,"41099",3961,2448,2413,14,35,"PACMA",16
19,"19146",47,35,35,0,0,"PACMA",0
29,"29059",2662,1950,1895,16,55,"PACMA",13
6,"6011",24731,16786,16538,167,248,"PACMA",115
33,"33063",375,269,267,5,2,"PACMA",0
31,"31117",583,373,372,3,1,"PACMA",0
43,"43103",908,705,701,9,4,"PACMA",21
6,"6033",1276,986,972,5,14,"PACMA",4
46,"46074",2687,2033,2020,18,13,"PACMA",26
40,"40004",436,330,319,2,11,"PACMA",0
11,"11033",21804,13361,13133,213,228,"PACMA",153
17,"17170",173,140,140,2,0,"PACMA",1
48,"48074",3275,2308,2295,11,13,"PACMA",5
49,"49222",369,250,247,2,3,"PACMA",0
16,"16249",1938,1422,1406,6,16,"PACMA",6
28,"28035",1404,981,966,4,15,"PACMA",8
34,"34133",101,75,73,0,2,"PACMA",1
16,"16199",27,18,18,0,0,"PACMA",0
37,"37015",198,127,125,2,2,"PACMA",0
9,"9312",89,68,68,1,0,"PACMA",0
10,"10903",806,555,545,8,10,"PACMA",4
24,"24005",342,218,217,0,1,"PACMA",0
22,"22072",197,127,126,1,1,"PACMA",2
24,"24043",116,54,52,0,2,"PACMA",0
44,"44250",20,15,15,0,0,"PACMA",0
31,"31219",80,59,58,2,1,"PACMA",0
24,"24209",2597,1651,1636,12,15,"PACMA",12
49,"49113",162,131,131,2,0,"PACMA",0
10,"10196",294,208,206,3,2,"PACMA",1
1,"1027",444,273,271,0,2,"PACMA",4
19,"19289",23,16,16,0,0,"PACMA",0
19,"19258",84,63,62,0,1,"PACMA",1
19,"19326",2463,1671,1650,13,21,"PACMA",16
47,"47159",825,672,661,0,11,"PACMA",0
13,"13084",841,652,644,6,8,"PACMA",0
50,"50213",92,70,70,2,0,"PACMA",0
50,"50216",236,169,167,0,2,"PACMA",0
34,"34092",257,189,189,1,0,"PACMA",2
33,"33022",802,460,452,4,8,"PACMA",5
40,"40046",83,67,67,1,0,"PACMA",0
30,"30015",19344,13502,13347,107,155,"PACMA",61
37,"37163",34,24,24,0,0,"PACMA",0
22,"22245",303,222,213,3,9,"PACMA",0
50,"50273",33,24,24,1,0,"PACMA",0
34,"34123",1634,1274,1258,4,16,"PACMA",1
19,"19113",454,327,322,4,5,"PACMA",1
22,"22209",161,121,121,3,0,"PACMA",0
50,"50176",220,142,142,3,0,"PACMA",3
13,"13027",3185,2112,2055,12,57,"PACMA",19
46,"46255",3220,2361,2340,20,21,"PACMA",30
46,"46145",22215,15688,15538,127,150,"PACMA",232
30,"30009",12728,9487,9365,46,122,"PACMA",69
5,"5169",218,171,171,1,0,"PACMA",0
12,"12025",116,82,79,1,3,"PACMA",0
46,"46207",6761,4966,4909,46,57,"PACMA",56
16,"16032",284,220,220,1,0,"PACMA",0
29,"29091",9490,6428,6304,61,124,"PACMA",59
20,"20014",1161,699,693,0,6,"PACMA",3
18,"18044",161,91,91,0,0,"PACMA",1
17,"17226",884,603,600,4,3,"PACMA",12
31,"31145",160,121,120,2,1,"PACMA",0
9,"9266",97,71,68,1,3,"PACMA",0
1,"1002",8014,5838,5786,24,52,"PACMA",22
43,"43053",186,135,134,0,1,"PACMA",0
4,"4099",4930,3526,3462,22,64,"PACMA",17
50,"50901",133,96,96,0,0,"PACMA",0
13,"13052",6288,4360,4278,36,82,"PACMA",23
22,"22226",761,537,530,13,7,"PACMA",5
18,"18151",261,167,166,4,1,"PACMA",2
40,"40024",823,582,575,8,7,"PACMA",0
27,"27012",1264,658,650,6,8,"PACMA",1
34,"34234",66,48,45,0,3,"PACMA",0
50,"50192",227,182,181,0,1,"PACMA",1
31,"31247",141,99,96,1,3,"PACMA",0
22,"22220",147,106,105,1,1,"PACMA",1
44,"44263",373,267,267,2,0,"PACMA",0
24,"24057",1295,909,891,7,18,"PACMA",4
1,"1062",318,221,219,2,2,"PACMA",2
49,"49233",85,51,51,0,0,"PACMA",0
28,"28084",16243,11562,11408,90,154,"PACMA",149
40,"40015",23,19,19,0,0,"PACMA",0
35,"35018",13153,7742,7674,80,68,"PACMA",107
17,"17139",1407,1128,1119,8,9,"PACMA",7
31,"31248",272,142,138,3,4,"PACMA",0
22,"22247",28,18,18,0,0,"PACMA",0
18,"18038",1042,782,760,5,22,"PACMA",3
24,"24014",7152,4494,4448,47,46,"PACMA",20
37,"37097",42,29,29,0,0,"PACMA",0
10,"10125",859,561,546,3,15,"PACMA",0
40,"40081",117,80,76,1,4,"PACMA",0
50,"50246",37,24,24,0,0,"PACMA",0
6,"6051",1523,1147,1137,5,10,"PACMA",3
36,"36044",2527,1535,1499,12,36,"PACMA",13
44,"44174",402,289,288,1,1,"PACMA",0
25,"25047",956,745,736,14,9,"PACMA",4
2,"2058",300,186,177,1,9,"PACMA",0
40,"40162",380,273,265,1,8,"PACMA",0
47,"47104",2816,2153,2099,20,54,"PACMA",9
24,"24092",731,506,504,1,2,"PACMA",1
45,"45029",186,154,154,2,0,"PACMA",3
9,"9387",107,89,88,0,1,"PACMA",0
46,"46073",1066,823,817,11,6,"PACMA",1
50,"50150",624,387,384,2,3,"PACMA",1
50,"50249",283,202,200,0,2,"PACMA",0
44,"44089",49,41,41,0,0,"PACMA",0
9,"9103",200,168,166,1,2,"PACMA",0
31,"31020",435,224,222,1,2,"PACMA",0
47,"47168",30,26,26,1,0,"PACMA",0
24,"24031",207,160,158,0,2,"PACMA",1
44,"44024",31,26,25,0,1,"PACMA",0
31,"31027",811,527,521,1,6,"PACMA",0
50,"50264",151,111,110,0,1,"PACMA",0
47,"47022",59,52,48,1,4,"PACMA",0
22,"22012",102,75,75,2,0,"PACMA",0
17,"17123",343,286,284,2,2,"PACMA",0
48,"48059",402,299,297,0,2,"PACMA",0
25,"25010",194,138,136,0,2,"PACMA",0
17,"17064",324,249,247,2,2,"PACMA",0
29,"29070",43686,27672,27323,290,349,"PACMA",621
45,"45098",2090,1488,1469,7,19,"PACMA",7
22,"22122",69,52,50,2,2,"PACMA",0
3,"3054",334,248,245,2,3,"PACMA",0
42,"42003",65,49,47,0,2,"PACMA",0
20,"20018",11231,7640,7611,33,29,"PACMA",15
43,"43129",4607,3284,3261,21,23,"PACMA",35
1,"1020",323,228,224,1,4,"PACMA",1
44,"44257",149,92,91,0,1,"PACMA",0
26,"26168",5584,3757,3696,35,61,"PACMA",47
22,"22057",364,253,248,4,5,"PACMA",0
10,"10150",339,279,275,3,4,"PACMA",1
19,"19105",2550,1913,1889,10,24,"PACMA",19
42,"42216",26,20,20,0,0,"PACMA",0
44,"44027",144,113,113,2,0,"PACMA",0
19,"19177",60,45,45,0,0,"PACMA",0
41,"41066",1307,927,898,7,29,"PACMA",5
26,"26092",104,82,81,3,1,"PACMA",0
47,"47038",100,61,61,0,0,"PACMA",0
49,"49015",198,156,155,0,1,"PACMA",0
16,"16171",1728,1334,1313,10,21,"PACMA",10
22,"22222",516,379,377,6,2,"PACMA",4
10,"10109",1714,1030,1006,4,24,"PACMA",2
22,"22078",431,285,285,4,0,"PACMA",1
15,"15085",3176,2073,2047,29,26,"PACMA",10
34,"34107",73,47,46,1,1,"PACMA",0
13,"13077",3383,2050,1997,20,53,"PACMA",8
33,"33052",681,418,416,3,2,"PACMA",1
39,"39090",773,557,553,2,4,"PACMA",1
16,"16018",376,290,290,2,0,"PACMA",1
40,"40059",109,92,91,2,1,"PACMA",0
47,"47185",82,62,61,1,1,"PACMA",1
44,"44115",102,91,91,0,0,"PACMA",0
47,"47073",116,80,79,2,1,"PACMA",0
5,"5014",5263,3699,3648,35,51,"PACMA",30
9,"9021",50,30,30,3,0,"PACMA",1
40,"40174",319,229,227,3,2,"PACMA",0
5,"5201",497,404,401,0,3,"PACMA",1
17,"17117",14497,9438,9382,66,56,"PACMA",102
16,"16269",378,287,285,2,2,"PACMA",0
28,"28049",57814,44977,44559,385,418,"PACMA",468
28,"28124",73,51,50,0,1,"PACMA",0
27,"27024",1447,1048,1032,6,16,"PACMA",1
14,"14060",3715,2714,2641,41,73,"PACMA",18
23,"23054",375,280,272,1,8,"PACMA",0
26,"26058",149,114,114,2,0,"PACMA",0
42,"42117",129,98,95,1,3,"PACMA",0
44,"44180",74,56,56,0,0,"PACMA",0
42,"42009",77,58,58,0,0,"PACMA",0
44,"44239",21,19,19,0,0,"PACMA",0
37,"37135",1146,849,837,5,12,"PACMA",1
24,"24198",541,346,344,6,2,"PACMA",0
25,"25043",800,584,581,2,3,"PACMA",1
26,"26121",30,19,19,0,0,"PACMA",1
27,"27045",926,588,583,6,5,"PACMA",2
13,"13032",1076,772,765,0,7,"PACMA",0
33,"33006",1476,862,857,9,5,"PACMA",6
12,"12102",518,424,417,4,7,"PACMA",7
24,"24189",5872,3915,3873,42,42,"PACMA",36
3,"3098",523,382,378,1,4,"PACMA",8
50,"50212",32,26,26,0,0,"PACMA",0
9,"9059",136870,99937,98641,1416,1296,"PACMA",707
19,"19153",22,20,20,2,0,"PACMA",0
49,"49243",107,74,74,0,0,"PACMA",0
16,"16102",1159,815,767,9,48,"PACMA",0
37,"37218",51,25,23,0,2,"PACMA",0
15,"15015",2877,1845,1821,26,24,"PACMA",18
9,"9074",844,610,609,12,1,"PACMA",6
10,"10218",1074,685,672,0,13,"PACMA",1
25,"25044",178,144,142,0,2,"PACMA",0
37,"37208",71,49,49,0,0,"PACMA",0
13,"13042",880,638,626,2,12,"PACMA",0
47,"47089",133,111,111,2,0,"PACMA",0
44,"44005",48,36,36,0,0,"PACMA",0
4,"4045",1696,1268,1254,17,14,"PACMA",8
14,"14017",10953,7929,7791,84,138,"PACMA",64
19,"19154",58,45,45,0,0,"PACMA",0
2,"2040",548,476,474,1,2,"PACMA",0
17,"17035",544,447,447,2,0,"PACMA",4
20,"20026",207,172,171,4,1,"PACMA",0
35,"35028",10156,5483,5425,56,58,"PACMA",47
3,"3083",5479,3736,3674,39,62,"PACMA",39
15,"15068",4824,2976,2937,54,39,"PACMA",8
36,"36013",2216,1298,1290,18,8,"PACMA",11
28,"28022",37338,30620,30455,229,165,"PACMA",180
16,"16143",15,10,10,1,0,"PACMA",0
34,"34161",22,12,12,0,0,"PACMA",0
19,"19263",21,15,15,0,0,"PACMA",0
3,"3081",1492,1070,1044,12,26,"PACMA",8
34,"34091",118,82,82,1,0,"PACMA",2
28,"28149",6298,4751,4699,35,52,"PACMA",56
48,"48089",3540,2561,2555,7,6,"PACMA",18
47,"47061",237,185,184,0,1,"PACMA",0
50,"50238",84,65,65,0,0,"PACMA",0
40,"40092",105,75,75,2,0,"PACMA",0
25,"25141",154,105,104,3,1,"PACMA",1
24,"24221",738,492,485,9,7,"PACMA",1
49,"49017",247,176,176,1,0,"PACMA",3
50,"50036",100,76,76,1,0,"PACMA",0
34,"34116",54,35,35,0,0,"PACMA",0
27,"27031",15107,9759,9593,87,166,"PACMA",82
37,"37316",711,546,541,7,5,"PACMA",2
4,"4021",179,132,129,2,3,"PACMA",2
50,"50006",913,670,654,13,16,"PACMA",3
5,"5122",118,91,89,1,2,"PACMA",0
2,"2010",1784,1374,1349,12,25,"PACMA",7
31,"31903",6950,4430,4394,39,36,"PACMA",47
46,"46106",1471,1033,1028,8,5,"PACMA",7
3,"3104",27072,19732,19477,218,255,"PACMA",249
42,"42151",38,27,27,0,0,"PACMA",0
5,"5186",1564,1140,1125,5,15,"PACMA",3
19,"19011",237,165,162,3,3,"PACMA",0
25,"25111",114,86,86,2,0,"PACMA",3
40,"40228",493,362,361,3,1,"PACMA",1
45,"45047",2694,1733,1706,24,27,"PACMA",24
5,"5133",61,44,43,0,1,"PACMA",0
39,"39067",753,476,474,1,2,"PACMA",1
37,"37026",180,148,147,5,1,"PACMA",0
5,"5077",154,113,110,0,3,"PACMA",0
17,"17203",165,126,126,0,0,"PACMA",1
5,"5154",31,23,23,0,0,"PACMA",0
5,"5007",109,73,72,0,1,"PACMA",0
47,"47190",95,75,75,1,0,"PACMA",0
3,"3053",7568,5551,5468,40,83,"PACMA",56
24,"24097",200,138,137,1,1,"PACMA",0
47,"47048",175,124,122,0,2,"PACMA",0
49,"49120",54,35,35,0,0,"PACMA",0
41,"41038",102752,71545,70538,980,1007,"PACMA",1039
44,"44230",149,111,110,2,1,"PACMA",1
40,"40111",50,39,39,0,0,"PACMA",0
42,"42158",97,73,73,1,0,"PACMA",0
24,"24016",488,244,243,0,1,"PACMA",1
48,"48042",1359,1055,1045,7,10,"PACMA",7
44,"44002",47,41,41,0,0,"PACMA",0
9,"9195",57,40,40,0,0,"PACMA",1
45,"45090",370,262,261,2,1,"PACMA",0
45,"45135",4152,3118,3066,21,52,"PACMA",8
23,"23902",2219,1813,1770,6,43,"PACMA",8
50,"50257",159,128,125,2,3,"PACMA",0
40,"40035",135,110,110,2,0,"PACMA",0
17,"17216",158,122,121,0,1,"PACMA",0
20,"20041",241,143,142,2,1,"PACMA",0
42,"42058",103,74,72,1,2,"PACMA",0
7,"7061",9451,5735,5666,60,69,"PACMA",60
45,"45160",1097,838,824,4,14,"PACMA",6
3,"3078",468,340,336,0,4,"PACMA",3
22,"22024",220,159,158,1,1,"PACMA",2
48,"48052",1562,1220,1210,5,10,"PACMA",3
28,"28102",880,639,621,7,18,"PACMA",3
48,"48071",6013,4240,4205,23,35,"PACMA",20
47,"47165",6823,4999,4906,48,93,"PACMA",10
47,"47196",29,21,21,0,0,"PACMA",0
42,"42060",28,16,14,0,2,"PACMA",0
5,"5061",257,193,189,1,4,"PACMA",1
9,"9196",133,95,95,2,0,"PACMA",0
23,"23052",1094,920,896,6,24,"PACMA",1
34,"34093",83,61,60,0,1,"PACMA",0
20,"20022",849,574,571,8,3,"PACMA",0
19,"19280",3669,2622,2597,24,25,"PACMA",55
45,"45007",656,502,497,0,5,"PACMA",4
49,"49009",382,251,251,0,0,"PACMA",1
35,"35021",15072,9791,9696,80,95,"PACMA",74
10,"10202",583,457,453,1,4,"PACMA",1
28,"28062",306,232,227,0,5,"PACMA",3
37,"37145",236,173,170,3,3,"PACMA",0
13,"13006",552,411,406,0,5,"PACMA",0
28,"28038",5213,3801,3753,24,48,"PACMA",54
3,"3111",5579,3777,3737,23,40,"PACMA",15
40,"40014",56,39,38,0,1,"PACMA",0
2,"2039",945,745,734,8,11,"PACMA",0
24,"24224",564,381,375,5,6,"PACMA",1
23,"23005",29876,20565,20268,254,297,"PACMA",195
16,"16078",41384,28809,28500,322,309,"PACMA",175
23,"23091",675,516,512,1,4,"PACMA",2
43,"43172",334,248,243,4,5,"PACMA",2
47,"47161",3970,3111,3089,24,22,"PACMA",17
45,"45028",3613,2675,2647,22,28,"PACMA",17
26,"26104",10,9,9,1,0,"PACMA",0
28,"28028",1836,1374,1363,3,11,"PACMA",12
41,"41078",2445,1722,1689,12,33,"PACMA",0
4,"4065",365,273,271,1,2,"PACMA",1
19,"19193",22,21,21,1,0,"PACMA",0
24,"24008",8931,6291,6214,79,77,"PACMA",27
39,"39053",212,133,133,4,0,"PACMA",0
29,"29041",3697,2406,2361,47,45,"PACMA",37
9,"9143",28,17,17,0,0,"PACMA",0
45,"45017",264,199,196,4,3,"PACMA",0
4,"4030",1052,690,678,6,12,"PACMA",6
9,"9091",686,479,467,4,12,"PACMA",1
16,"16040",91,76,76,2,0,"PACMA",0
44,"44125",63,41,41,0,0,"PACMA",0
26,"26074",107,87,86,2,1,"PACMA",0
28,"28107",442,316,310,5,6,"PACMA",1
19,"19194",91,69,69,0,0,"PACMA",1
49,"49244",46,23,23,0,0,"PACMA",0
9,"9201",27,17,17,0,0,"PACMA",0
15,"15037",4026,2375,2349,10,26,"PACMA",9
6,"6902",1651,1198,1174,19,24,"PACMA",2
47,"47211",48,37,37,1,0,"PACMA",0
14,"14008",2758,1880,1836,21,44,"PACMA",5
28,"28181",20801,16353,16243,97,110,"PACMA",151
50,"50296",385,240,235,3,5,"PACMA",2
18,"18066",2095,1401,1378,12,23,"PACMA",6
44,"44133",15,12,12,0,0,"PACMA",0
41,"41032",3842,2800,2704,24,96,"PACMA",13
40,"40078",150,123,123,6,0,"PACMA",1
27,"27017",952,568,562,3,6,"PACMA",1
1,"1023",262,193,190,1,3,"PACMA",1
18,"18085",690,440,432,1,8,"PACMA",0
50,"50074",6156,4100,4022,33,78,"PACMA",21
42,"42125",71,55,55,0,0,"PACMA",0
41,"41091",539590,389351,384943,4676,4408,"PACMA",4830
16,"16218",184,134,133,1,1,"PACMA",0
19,"19053",1906,1323,1304,12,19,"PACMA",5
45,"45123",3196,2252,2218,11,34,"PACMA",32
34,"34238",294,238,236,1,2,"PACMA",2
47,"47086",3818,2835,2784,36,51,"PACMA",9
34,"34171",928,572,562,2,10,"PACMA",2
14,"14025",2834,2352,2299,9,53,"PACMA",8
49,"49236",71,54,54,0,0,"PACMA",0
10,"10073",733,513,499,8,14,"PACMA",3
44,"44018",16,16,16,0,0,"PACMA",0
32,"32006",1418,986,970,14,16,"PACMA",1
4,"4069",4742,3364,3325,46,39,"PACMA",21
19,"19167",129,104,103,1,1,"PACMA",1
24,"24086",258,197,196,1,1,"PACMA",0
23,"23010",14264,9801,9635,120,166,"PACMA",77
11,"11040",396,332,324,3,8,"PACMA",2
29,"29044",749,477,473,1,4,"PACMA",2
22,"22174",462,352,350,0,2,"PACMA",2
18,"18078",714,546,538,5,8,"PACMA",3
5,"5263",162,117,115,1,2,"PACMA",0
40,"40904",344,286,284,8,2,"PACMA",1
5,"5166",155,108,104,1,4,"PACMA",0
47,"47045",732,558,549,3,9,"PACMA",1
40,"40142",52,39,37,0,2,"PACMA",0
18,"18101",9449,6688,6568,77,120,"PACMA",84
26,"26030",18,18,17,1,1,"PACMA",0
20,"20049",4195,2918,2901,12,17,"PACMA",7
49,"49261",1504,1044,1026,7,18,"PACMA",7
47,"47215",48,43,43,0,0,"PACMA",0
31,"31037",91,70,70,0,0,"PACMA",0
32,"32057",505,334,328,3,6,"PACMA",5
46,"46067",1753,1356,1341,8,15,"PACMA",6
5,"5172",111,83,83,1,0,"PACMA",1
45,"45103",363,286,283,0,3,"PACMA",0
47,"47079",55,44,43,1,1,"PACMA",0
19,"19139",26,19,19,2,0,"PACMA",0
40,"40177",139,106,105,0,1,"PACMA",0
49,"49178",748,520,505,7,15,"PACMA",6
46,"46040",993,745,733,3,12,"PACMA",8
46,"46035",6828,5155,5089,33,66,"PACMA",59
31,"31263",231,137,137,1,0,"PACMA",0
14,"14063",994,731,719,8,12,"PACMA",1
28,"28021",571,365,364,1,1,"PACMA",2
46,"46259",457,374,371,2,3,"PACMA",7
41,"41065",22527,14684,14463,205,221,"PACMA",125
5,"5259",99,80,79,2,1,"PACMA",0
23,"23035",1111,877,856,2,21,"PACMA",7
42,"42032",138,96,96,0,0,"PACMA",0
31,"31063",84,59,59,0,0,"PACMA",0
31,"31173",845,642,636,4,6,"PACMA",2
25,"25003",3717,2577,2561,15,16,"PACMA",11
43,"43073",80,67,65,0,2,"PACMA",2
19,"19291",1143,803,794,2,9,"PACMA",6
9,"9380",71,42,41,0,1,"PACMA",0
47,"47112",2561,1960,1933,13,27,"PACMA",6
17,"17172",452,336,335,5,1,"PACMA",8
9,"9160",83,63,63,1,0,"PACMA",0
17,"17060",409,300,298,1,2,"PACMA",0
50,"50219",4283,3034,2990,30,44,"PACMA",40
22,"22177",96,69,68,0,1,"PACMA",1
50,"50170",357,245,242,6,3,"PACMA",0
18,"18916",1815,1093,1086,6,7,"PACMA",9
19,"19067",68,46,44,0,2,"PACMA",0
40,"40178",85,61,60,0,1,"PACMA",0
19,"19327",385,313,308,2,5,"PACMA",0
34,"34139",160,117,115,2,2,"PACMA",1
5,"5106",27,14,14,0,0,"PACMA",1
43,"43902",2751,1794,1776,21,18,"PACMA",2
49,"49118",193,151,151,2,0,"PACMA",1
12,"12044",442,371,368,1,3,"PACMA",0
3,"3129",1224,934,923,4,11,"PACMA",8
7,"7030",1598,1127,1098,14,29,"PACMA",11
18,"18043",129,74,71,0,3,"PACMA",1
40,"40906",2149,1701,1662,18,39,"PACMA",13
47,"47231",4439,3359,3323,36,36,"PACMA",33
47,"47217",1984,1460,1437,11,23,"PACMA",8
29,"29012",9718,6664,6553,85,111,"PACMA",58
19,"19211",350,272,269,0,3,"PACMA",0
24,"24067",602,327,324,6,3,"PACMA",4
6,"6157",389,277,271,1,6,"PACMA",0
39,"39012",6772,4807,4755,31,52,"PACMA",26
16,"16110",90,70,70,1,0,"PACMA",0
18,"18048",2494,1708,1657,18,51,"PACMA",15
37,"37298",170,109,109,0,0,"PACMA",0
46,"46103",1354,993,978,8,15,"PACMA",7
2,"2043",1165,872,858,6,14,"PACMA",0
49,"49228",53,36,36,0,0,"PACMA",0
5,"5107",54,36,35,2,1,"PACMA",0
12,"12001",1028,783,768,6,15,"PACMA",4
17,"17174",164,130,130,4,0,"PACMA",0
43,"43076",454,336,335,1,1,"PACMA",1
39,"39062",1864,1395,1376,3,19,"PACMA",8
24,"24020",436,230,228,0,2,"PACMA",0
42,"42080",153,108,108,1,0,"PACMA",0
40,"40211",66,54,54,1,0,"PACMA",0
25,"25096",885,597,591,2,6,"PACMA",2
50,"50247",852,600,594,8,6,"PACMA",3
27,"27049",1324,847,829,8,18,"PACMA",4
16,"16259",28,22,22,0,0,"PACMA",0
42,"42063",45,31,30,1,1,"PACMA",0
49,"49191",265,192,188,2,4,"PACMA",0
16,"16129",88,72,72,0,0,"PACMA",0
5,"5237",153,125,123,0,2,"PACMA",0
39,"39054",4541,3271,3252,30,19,"PACMA",17
38,"38036",6857,4170,4090,37,80,"PACMA",28
12,"12132",477,391,385,3,6,"PACMA",1
24,"24022",304,198,195,2,3,"PACMA",1
46,"46051",8469,6120,6070,40,50,"PACMA",61
19,"19203",29,25,25,0,0,"PACMA",1
48,"48065",3285,2341,2326,8,15,"PACMA",8
17,"17073",1939,1649,1640,11,9,"PACMA",7
19,"19256",46,36,36,0,0,"PACMA",0
18,"18109",597,430,422,5,8,"PACMA",4
22,"22181",86,55,54,2,1,"PACMA",1
13,"13016",656,463,454,3,9,"PACMA",1
49,"49011",214,147,146,5,1,"PACMA",1
34,"34048",62,51,51,1,0,"PACMA",0
9,"9270",157,112,109,2,3,"PACMA",1
31,"31039",92,70,69,1,1,"PACMA",0
48,"48913",1236,899,890,8,9,"PACMA",3
40,"40006",22,19,19,0,0,"PACMA",0
43,"43146",40,32,32,0,0,"PACMA",0
34,"34110",75,64,64,0,0,"PACMA",0
49,"49256",236,183,179,0,4,"PACMA",0
42,"42017",131,99,96,1,3,"PACMA",0
49,"49065",1048,747,725,6,22,"PACMA",2
10,"10122",219,159,157,2,2,"PACMA",0
3,"3094",9795,6528,6481,37,47,"PACMA",102
32,"32067",1189,696,692,4,4,"PACMA",7
28,"28087",3301,2539,2519,20,20,"PACMA",19
31,"31035",50,30,29,0,1,"PACMA",1
6,"6046",1250,983,959,6,24,"PACMA",1
33,"33028",1143,519,518,7,1,"PACMA",2
28,"28014",34522,25016,24748,229,268,"PACMA",254
28,"28183",1162,823,813,9,10,"PACMA",10
13,"13072",727,518,510,3,8,"PACMA",1
34,"34151",148,98,96,1,2,"PACMA",1
9,"9172",131,88,88,1,0,"PACMA",0
37,"37149",60,50,50,0,0,"PACMA",0
39,"39066",866,616,606,6,10,"PACMA",1
32,"32019",11469,7336,7225,98,111,"PACMA",44
15,"15050",1732,931,917,15,14,"PACMA",2
33,"33057",1525,1005,988,17,17,"PACMA",7
42,"42178",99,71,71,0,0,"PACMA",0
24,"24061",1753,1234,1223,10,11,"PACMA",9
45,"45169",179,114,111,1,3,"PACMA",1
13,"13013",7056,5041,4945,52,96,"PACMA",25
41,"41064",5602,3520,3417,56,103,"PACMA",23
33,"33001",1475,758,753,15,5,"PACMA",1
34,"34206",810,608,602,5,6,"PACMA",1
25,"25100",184,137,136,1,1,"PACMA",0
21,"21032",1827,1337,1314,13,23,"PACMA",4
6,"6134",526,306,301,1,5,"PACMA",2
47,"47212",356,289,287,4,2,"PACMA",1
49,"49232",85,64,64,0,0,"PACMA",0
14,"14069",7340,5100,5000,69,100,"PACMA",12
6,"6026",804,578,562,5,16,"PACMA",1
24,"24063",362,247,245,2,2,"PACMA",0
49,"49032",282,196,196,0,0,"PACMA",0
41,"41074",2994,2154,2105,19,49,"PACMA",10
35,"35002",24229,15311,15133,101,178,"PACMA",179
42,"42019",519,345,341,3,4,"PACMA",1
10,"10199",154,99,99,2,0,"PACMA",2
28,"28123",62178,49883,49515,397,368,"PACMA",487
5,"5048",107,89,88,2,1,"PACMA",0
42,"42050",27,17,17,0,0,"PACMA",0
25,"25231",483,387,385,0,2,"PACMA",4
50,"50251",8209,5732,5658,66,74,"PACMA",34
19,"19302",52,42,42,1,0,"PACMA",0
40,"40218",80,56,55,0,1,"PACMA",0
17,"17153",189,150,149,1,1,"PACMA",0
34,"34156",51,42,42,0,0,"PACMA",0
2,"2035",1946,1494,1473,5,21,"PACMA",12
29,"29902",2593,1561,1533,15,28,"PACMA",16
3,"3012",1138,863,846,4,17,"PACMA",10
20,"20031",185,113,112,3,1,"PACMA",0
6,"6143",3389,2430,2371,24,59,"PACMA",5
27,"27056",1218,787,778,6,9,"PACMA",4
37,"37152",400,268,261,4,7,"PACMA",3
9,"9398",73,52,52,0,0,"PACMA",0
17,"17096",159,116,116,3,0,"PACMA",0
31,"31260",1265,817,815,7,2,"PACMA",2
46,"46033",196,155,153,0,2,"PACMA",4
33,"33032",11056,7052,6905,109,147,"PACMA",25
17,"17069",359,270,267,2,3,"PACMA",1
44,"44151",180,134,134,1,0,"PACMA",3
1,"1028",1091,735,728,5,7,"PACMA",6
16,"16088",100,86,86,0,0,"PACMA",0
34,"34241",17,17,16,3,1,"PACMA",0
9,"9472",52,40,38,0,2,"PACMA",0
37,"37039",279,202,197,2,5,"PACMA",0
24,"24091",575,368,362,5,6,"PACMA",0
42,"42123",157,103,102,6,1,"PACMA",0
49,"49153",150,110,107,2,3,"PACMA",0
15,"15074",3902,2629,2589,23,40,"PACMA",8
10,"10204",423,289,287,1,2,"PACMA",1
5,"5211",425,336,330,2,6,"PACMA",0
45,"45004",546,400,398,2,2,"PACMA",4
6,"6097",2258,1631,1602,10,29,"PACMA",4
17,"17166",547,442,440,0,2,"PACMA",3
28,"28051",1644,1231,1220,9,11,"PACMA",8
22,"22115",348,263,261,3,2,"PACMA",0
25,"25062",691,498,491,4,7,"PACMA",3
15,"15067",7933,5329,5282,43,47,"PACMA",21
26,"26166",144,125,124,0,1,"PACMA",0
50,"50118",2101,1484,1477,17,7,"PACMA",8
26,"26081",15,14,14,1,0,"PACMA",0
9,"9289",1353,873,861,4,12,"PACMA",2
48,"48045",5207,3851,3817,9,34,"PACMA",22
9,"9405",122,94,91,0,3,"PACMA",0
4,"4017",1276,833,818,4,15,"PACMA",7
19,"19183",70,59,58,0,1,"PACMA",1
25,"25104",120,88,88,0,0,"PACMA",0
9,"9235",144,107,105,0,2,"PACMA",1
26,"26140",239,180,177,1,3,"PACMA",1
49,"49097",67,44,44,0,0,"PACMA",0
3,"3131",176,129,126,1,3,"PACMA",0
42,"42094",596,448,436,9,12,"PACMA",2
5,"5247",231,132,131,1,1,"PACMA",0
19,"19274",953,693,676,9,17,"PACMA",5
27,"27059",2035,1356,1322,7,34,"PACMA",5
31,"31044",291,227,227,1,0,"PACMA",0
18,"18065",588,464,451,2,13,"PACMA",3
31,"31228",496,356,354,1,2,"PACMA",3
50,"50231",253,199,195,4,4,"PACMA",3
6,"6149",10177,7582,7455,64,127,"PACMA",43
22,"22197",436,327,325,3,2,"PACMA",0
49,"49098",200,139,138,3,1,"PACMA",0
24,"24144",621,419,412,4,7,"PACMA",2
14,"14036",3677,2619,2555,39,64,"PACMA",23
9,"9202",22,16,16,2,0,"PACMA",0
49,"49086",111,89,89,1,0,"PACMA",0
26,"26102",6076,4276,4205,52,71,"PACMA",26
37,"37177",259,198,197,3,1,"PACMA",0
19,"19199",19,15,15,0,0,"PACMA",0
28,"28011",417,295,292,6,3,"PACMA",1
34,"34170",50,30,30,1,0,"PACMA",0
46,"46217",900,672,667,7,5,"PACMA",8
37,"37027",239,182,179,2,3,"PACMA",1
27,"27034",1010,565,558,3,7,"PACMA",1
28,"28165",1917,1339,1321,2,18,"PACMA",4
49,"49092",115,72,72,0,0,"PACMA",0
21,"21034",1155,768,748,5,20,"PACMA",15
21,"21044",18061,11170,11003,123,167,"PACMA",123
4,"4054",363,279,278,2,1,"PACMA",4
49,"49142",244,163,160,0,3,"PACMA",2
19,"19156",917,686,679,2,7,"PACMA",1
47,"47224",93,75,75,1,0,"PACMA",1
31,"31230",90,66,66,0,0,"PACMA",0
9,"9354",34,31,31,2,0,"PACMA",0
26,"26144",187,147,143,1,4,"PACMA",1
34,"34220",152,133,132,1,1,"PACMA",2
15,"15060",5871,4044,3978,58,66,"PACMA",29
28,"28162",2784,2143,2131,20,12,"PACMA",27
9,"9077",26,21,21,0,0,"PACMA",0
4,"4091",318,251,250,0,1,"PACMA",0
9,"9243",73,50,49,1,1,"PACMA",0
17,"17101",566,389,382,1,7,"PACMA",6
4,"4092",2791,2058,2023,4,35,"PACMA",16
37,"37058",56,38,38,1,0,"PACMA",0
5,"5023",174,148,145,2,3,"PACMA",0
33,"33010",1722,1085,1069,15,16,"PACMA",5
40,"40131",51,45,45,0,0,"PACMA",0
37,"37349",100,61,58,0,3,"PACMA",0
5,"5090",73,63,62,0,1,"PACMA",1
4,"4059",1000,676,666,3,10,"PACMA",6
39,"39048",1772,1311,1295,8,16,"PACMA",8
28,"28163",429,332,326,0,6,"PACMA",5
13,"13043",205,163,162,1,1,"PACMA",2
42,"42194",144,101,100,2,1,"PACMA",0
15,"15051",4545,2978,2945,47,33,"PACMA",16
12,"12135",36287,25912,25655,184,257,"PACMA",243
2,"2074",5890,4054,4010,39,44,"PACMA",37
49,"49157",188,136,133,2,3,"PACMA",0
36,"36019",1462,916,908,8,8,"PACMA",5
50,"50262",1161,849,832,11,17,"PACMA",9
49,"49239",599,393,384,6,9,"PACMA",0
22,"22089",274,195,193,2,2,"PACMA",3
29,"29003",916,677,666,4,11,"PACMA",4
19,"19096",105,72,70,0,2,"PACMA",0
4,"4029",8830,5546,5482,43,64,"PACMA",37
12,"12115",205,161,161,1,0,"PACMA",1
29,"29096",2757,1847,1790,19,57,"PACMA",12
24,"24036",252,146,146,1,0,"PACMA",0
16,"16067",123,91,90,1,1,"PACMA",0
46,"46123",1926,1392,1368,11,24,"PACMA",17
17,"17190",834,624,619,1,5,"PACMA",8
24,"24110",1158,784,773,1,11,"PACMA",2
37,"37131",175,125,125,0,0,"PACMA",0
9,"9466",113,84,83,1,1,"PACMA",0
5,"5159",224,133,132,3,1,"PACMA",0
3,"3137",654,449,443,7,6,"PACMA",5
48,"48910",2811,1952,1942,11,10,"PACMA",6
49,"49214",666,486,477,6,9,"PACMA",1
25,"25078",995,746,743,7,3,"PACMA",4
50,"50009",97,61,61,1,0,"PACMA",0
3,"3022",140,125,121,1,4,"PACMA",0
31,"31161",350,261,256,1,5,"PACMA",3
47,"47133",2776,2096,2073,28,23,"PACMA",22
43,"43013",4406,3004,2975,19,29,"PACMA",29
16,"16072",132,84,84,1,0,"PACMA",0
19,"19222",95,70,70,2,0,"PACMA",0
48,"48911",381,303,302,1,1,"PACMA",0
47,"47069",115,87,87,0,0,"PACMA",0
44,"44160",438,287,285,4,2,"PACMA",0
34,"34227",70,56,52,1,4,"PACMA",0
48,"48025",874,667,662,2,5,"PACMA",3
9,"9105",95,65,64,1,1,"PACMA",0
37,"37205",212,157,155,1,2,"PACMA",1
37,"37088",199,135,133,0,2,"PACMA",0
3,"3023",1377,1138,1122,9,16,"PACMA",7
10,"10093",387,278,253,4,25,"PACMA",1
18,"18042",417,332,330,4,2,"PACMA",1
6,"6130",185,152,149,0,3,"PACMA",0
15,"15046",6157,3965,3865,23,100,"PACMA",13
47,"47194",295,228,227,1,1,"PACMA",0
10,"10217",506,378,377,3,1,"PACMA",2
16,"16190",4930,3747,3688,26,59,"PACMA",8
37,"37193",362,253,252,4,1,"PACMA",1
18,"18170",317,212,209,0,3,"PACMA",1
10,"10131",12803,8477,8347,77,130,"PACMA",53
14,"14902",1113,877,851,15,26,"PACMA",7
49,"49174",127,86,85,1,1,"PACMA",0
44,"44028",171,136,136,0,0,"PACMA",0
28,"28155",487,374,369,0,5,"PACMA",1
32,"32087",1669,1158,1136,14,22,"PACMA",8
25,"25082",292,197,197,2,0,"PACMA",1
10,"10190",513,334,325,10,9,"PACMA",1
50,"50035",74,57,57,0,0,"PACMA",0
26,"26036",16989,11463,11260,101,203,"PACMA",69
22,"22205",448,294,292,0,2,"PACMA",3
23,"23043",517,360,360,1,0,"PACMA",1
26,"26152",27,20,20,1,0,"PACMA",0
12,"12099",597,444,436,6,8,"PACMA",7
5,"5097",464,309,305,0,4,"PACMA",0
14,"14053",5918,4054,3968,92,86,"PACMA",27
37,"37167",174,147,144,2,3,"PACMA",1
5,"5227",341,230,228,1,2,"PACMA",0
42,"42111",274,183,181,0,2,"PACMA",0
31,"31240",514,352,352,3,0,"PACMA",0
5,"5260",95,73,73,0,0,"PACMA",1
33,"33016",18848,12845,12737,173,108,"PACMA",87
36,"36034",3299,2155,2132,15,23,"PACMA",17
46,"46252",125,89,86,1,3,"PACMA",0
12,"12100",1273,1069,1052,5,17,"PACMA",6
49,"49223",701,498,494,7,4,"PACMA",1
13,"13053",14031,9930,9796,97,134,"PACMA",90
25,"25025",1362,909,898,15,11,"PACMA",14
25,"25074",179,155,151,2,4,"PACMA",1
15,"15048",5087,3426,3383,40,43,"PACMA",24
47,"47128",53,45,43,0,2,"PACMA",0
42,"42204",53,37,35,1,2,"PACMA",0
44,"44016",424,299,297,1,2,"PACMA",0
25,"25120",92888,62740,62389,450,351,"PACMA",624
50,"50011",117,90,89,3,1,"PACMA",1
23,"23061",7711,5357,5231,44,126,"PACMA",33
14,"14056",23477,15826,15470,177,356,"PACMA",137
46,"46065",1584,1199,1183,11,16,"PACMA",13
12,"12017",145,111,110,2,1,"PACMA",0
24,"24103",274,134,134,0,0,"PACMA",0
34,"34066",54,47,47,1,0,"PACMA",0
46,"46042",3335,2655,2620,12,35,"PACMA",11
35,"35004",41975,20773,20602,156,171,"PACMA",348
5,"5128",339,258,253,5,5,"PACMA",3
40,"40063",6913,4948,4838,57,110,"PACMA",12
35,"35007",517,347,345,2,2,"PACMA",0
16,"16006",113,100,100,1,0,"PACMA",0
9,"9115",90,65,63,3,2,"PACMA",2
42,"42028",75,57,56,0,1,"PACMA",0
50,"50140",153,96,95,1,1,"PACMA",0
47,"47204",235,159,157,3,2,"PACMA",0
44,"44196",121,88,88,0,0,"PACMA",0
48,"48058",947,682,679,2,3,"PACMA",2
38,"38030",1962,1332,1318,9,14,"PACMA",5
13,"13011",4439,2762,2694,16,68,"PACMA",11
5,"5196",57,43,43,0,0,"PACMA",0
19,"19031",8,8,8,0,0,"PACMA",0
20,"20079",18151,13106,13054,58,52,"PACMA",55
10,"10195",7514,5243,5148,47,95,"PACMA",28
10,"10033",397,269,268,0,1,"PACMA",0
24,"24159",1716,1238,1216,6,22,"PACMA",3
5,"5101",266,206,205,1,1,"PACMA",0
4,"4103",1432,1003,993,10,10,"PACMA",5
18,"18046",1738,1042,1023,7,19,"PACMA",7
44,"44076",2089,1577,1565,8,12,"PACMA",1
23,"23048",817,605,599,4,6,"PACMA",4
45,"45096",987,748,725,9,23,"PACMA",2
14,"14057",6157,4773,4707,59,66,"PACMA",11
15,"15072",9434,6304,6228,48,76,"PACMA",46
41,"41026",4302,3355,3288,26,67,"PACMA",7
3,"3115",255,213,213,3,0,"PACMA",1
6,"6003",768,579,557,4,22,"PACMA",0
5,"5168",3503,2536,2511,29,25,"PACMA",16
22,"22212",69,52,52,1,0,"PACMA",0
24,"24004",495,387,384,10,3,"PACMA",3
50,"50082",82,57,57,0,0,"PACMA",0
19,"19189",114,87,84,0,3,"PACMA",0
4,"4032",5716,3727,3696,43,31,"PACMA",15
9,"9304",198,152,149,1,3,"PACMA",2
12,"12101",354,274,270,5,4,"PACMA",2
39,"39049",304,198,195,2,3,"PACMA",1
9,"9078",32,27,27,0,0,"PACMA",0
34,"34167",110,84,83,0,1,"PACMA",1
43,"43115",128,106,106,0,0,"PACMA",0
45,"45086",483,339,332,0,7,"PACMA",3
33,"33040",4556,2837,2784,58,53,"PACMA",17
11,"11042",1158,806,793,6,13,"PACMA",7
16,"16160",58,41,41,1,0,"PACMA",0
31,"31209",149,111,110,0,1,"PACMA",3
50,"50194",80,51,51,0,0,"PACMA",0
44,"44260",137,93,93,1,0,"PACMA",0
22,"22213",2918,2084,2062,20,22,"PACMA",10
16,"16204",237,179,177,1,2,"PACMA",0
5,"5199",37,31,31,0,0,"PACMA",0
17,"17199",6984,4919,4894,39,25,"PACMA",30
23,"23051",2736,2066,2021,16,45,"PACMA",16
45,"45136",5827,3908,3864,22,44,"PACMA",16
24,"24123",709,461,457,2,4,"PACMA",0
45,"45063",375,268,264,0,4,"PACMA",0
18,"18915",726,474,467,4,7,"PACMA",5
31,"31210",186,131,130,2,1,"PACMA",1
9,"9104",49,35,34,0,1,"PACMA",0
9,"9431",116,85,84,2,1,"PACMA",0
41,"41029",13520,9849,9663,134,186,"PACMA",154
26,"26163",126,104,104,1,0,"PACMA",0
32,"32085",10584,6687,6611,58,76,"PACMA",35
44,"44228",96,75,74,0,1,"PACMA",0
22,"22105",102,65,65,0,0,"PACMA",0
19,"19304",224,169,166,3,3,"PACMA",2
37,"37101",138,101,100,1,1,"PACMA",0
39,"39088",59,40,40,2,0,"PACMA",0
38,"38001",21069,10844,10777,63,67,"PACMA",146
39,"39004",1479,1050,1031,5,19,"PACMA",2
6,"6039",1802,1375,1343,9,32,"PACMA",3
41,"41100",954,670,635,7,35,"PACMA",2
47,"47007",4051,2987,2954,27,33,"PACMA",38
5,"5175",144,109,109,0,0,"PACMA",2
28,"28027",1215,836,826,8,10,"PACMA",2
18,"18194",2038,1373,1348,12,25,"PACMA",8
12,"12042",574,459,446,9,13,"PACMA",1
34,"34127",80,62,62,0,0,"PACMA",0
32,"32021",872,555,550,6,5,"PACMA",7
9,"9083",26,21,21,0,0,"PACMA",0
44,"44217",32,25,25,0,0,"PACMA",0
37,"37217",59,43,43,3,0,"PACMA",0
3,"3071",4000,2858,2813,27,45,"PACMA",21
28,"28148",89174,65500,64784,566,716,"PACMA",776
4,"4043",517,398,395,1,3,"PACMA",1
18,"18086",338,253,247,1,6,"PACMA",0
50,"50043",241,155,154,1,1,"PACMA",1
17,"17033",5647,3879,3852,25,27,"PACMA",65
22,"22106",20,13,13,2,0,"PACMA",1
1,"1016",428,194,192,4,2,"PACMA",1
18,"18053",1554,1001,985,9,16,"PACMA",4
4,"4006",7192,4389,4335,39,54,"PACMA",28
14,"14035",5774,4076,4017,35,59,"PACMA",13
41,"41903",6776,4616,4494,72,122,"PACMA",71
19,"19038",19,16,15,0,1,"PACMA",0
9,"9437",266,207,203,4,4,"PACMA",0
45,"45176",3859,2694,2662,24,32,"PACMA",47
22,"22008",144,113,112,2,1,"PACMA",0
2,"2062",382,261,256,2,5,"PACMA",0
50,"50070",50,30,29,0,1,"PACMA",0
21,"21059",221,169,163,1,6,"PACMA",2
31,"31032",1670,1158,1147,18,11,"PACMA",7
5,"5205",81,59,58,2,1,"PACMA",0
4,"4078",1127,725,718,8,7,"PACMA",7
42,"42038",33,22,22,1,0,"PACMA",0
18,"18152",928,663,660,3,3,"PACMA",0
31,"31106",721,547,545,1,2,"PACMA",6
48,"48037",696,497,485,0,12,"PACMA",3
23,"23008",1422,1042,1020,9,22,"PACMA",7
9,"9274",1035,774,762,8,12,"PACMA",3
40,"40083",73,52,52,1,0,"PACMA",0
19,"19143",1781,1278,1266,18,12,"PACMA",12
50,"50291",95,76,76,0,0,"PACMA",0
13,"13091",537,466,464,3,2,"PACMA",1
47,"47150",253,193,187,3,6,"PACMA",0
40,"40203",987,753,740,13,13,"PACMA",11
28,"28093",2177,1681,1658,11,23,"PACMA",12
26,"26076",115,83,83,0,0,"PACMA",0
41,"41077",8631,5788,5598,51,190,"PACMA",41
25,"25904",160,134,133,2,1,"PACMA",2
44,"44132",54,49,49,0,0,"PACMA",0
16,"16156",84,64,64,0,0,"PACMA",0
25,"25075",132,101,101,0,0,"PACMA",0
22,"22162",125,94,94,0,0,"PACMA",2
17,"17213",5567,3654,3630,19,24,"PACMA",46
28,"28055",944,636,627,4,9,"PACMA",3
21,"21031",1166,773,736,11,37,"PACMA",6
49,"49123",519,384,383,4,1,"PACMA",2
4,"4080",196,148,147,2,1,"PACMA",1
10,"10208",122,85,83,0,2,"PACMA",1
47,"47181",165,136,135,1,1,"PACMA",0
34,"34903",179,129,129,1,0,"PACMA",0
5,"5143",59,52,51,1,1,"PACMA",0
31,"31072",5324,3733,3684,33,49,"PACMA",24
10,"10087",1588,1105,1093,10,12,"PACMA",0
46,"46144",628,483,478,4,5,"PACMA",4
45,"45107",3463,2621,2585,23,36,"PACMA",24
4,"4010",587,421,409,5,12,"PACMA",1
47,"47087",362,272,268,1,4,"PACMA",2
26,"26171",155,109,107,2,2,"PACMA",0
34,"34102",197,158,156,1,2,"PACMA",0
14,"14067",3842,2863,2800,42,63,"PACMA",14
19,"19300",782,591,588,5,3,"PACMA",8
44,"44149",99,74,73,4,1,"PACMA",1
18,"18123",284,202,200,5,2,"PACMA",0
19,"19006",755,506,494,4,12,"PACMA",3
40,"40185",800,560,553,4,7,"PACMA",1
49,"49016",230,155,155,0,0,"PACMA",0
22,"22036",84,71,71,1,0,"PACMA",0
49,"49199",236,159,157,3,2,"PACMA",1
15,"15073",21725,13008,12820,126,188,"PACMA",103
12,"12125",215,179,179,2,0,"PACMA",1
2,"2030",2949,2158,2122,16,36,"PACMA",16
17,"17077",565,395,394,2,1,"PACMA",3
50,"50008",5187,3334,3288,37,46,"PACMA",34
37,"37225",97,78,74,0,4,"PACMA",0
50,"50193",664,487,475,4,12,"PACMA",4
39,"39040",4271,3103,3080,18,23,"PACMA",17
17,"17083",2971,2164,2154,13,10,"PACMA",16
48,"48085",10716,7707,7679,51,28,"PACMA",60
28,"28113",36951,27912,27604,241,308,"PACMA",324
48,"48901",5160,3705,3684,16,21,"PACMA",25
17,"17144",211,162,159,3,3,"PACMA",0
36,"36050",7645,5137,5049,48,88,"PACMA",47
47,"47184",537,411,402,1,9,"PACMA",2
21,"21003",684,476,452,4,24,"PACMA",1
19,"19901",35,27,27,0,0,"PACMA",0
43,"43109",2706,1751,1738,17,13,"PACMA",43
22,"22225",2606,1638,1612,20,26,"PACMA",8
49,"49163",203,139,138,3,1,"PACMA",1
15,"15053",7469,4622,4579,44,43,"PACMA",32
47,"47154",146,115,111,6,4,"PACMA",0
50,"50252",5019,3486,3456,53,30,"PACMA",4
39,"39096",669,451,450,1,1,"PACMA",0
33,"33059",4359,2651,2625,33,26,"PACMA",6
39,"39097",666,342,335,2,7,"PACMA",0
28,"28903",35555,28875,28671,341,204,"PACMA",221
46,"46010",943,691,681,7,10,"PACMA",6
19,"19150",116,89,89,0,0,"PACMA",1
25,"25041",525,375,370,4,5,"PACMA",6
49,"49019",232,162,152,2,10,"PACMA",1
5,"5015",68,45,44,1,1,"PACMA",0
49,"49018",277,197,190,2,7,"PACMA",0
17,"17126",316,269,269,1,0,"PACMA",0
47,"47091",76,60,59,2,1,"PACMA",0
31,"31029",913,606,601,14,5,"PACMA",2
47,"47145",583,430,426,6,4,"PACMA",1
44,"44060",32,25,25,0,0,"PACMA",0
4,"4904",1900,1308,1299,4,9,"PACMA",6
24,"24141",96,74,74,0,0,"PACMA",0
22,"22079",118,85,84,1,1,"PACMA",0
40,"40110",316,237,234,4,3,"PACMA",1
48,"48004",326,245,245,1,0,"PACMA",1
3,"3122",43774,30060,29834,230,226,"PACMA",419
50,"50114",132,108,108,0,0,"PACMA",0
28,"28126",50,36,36,0,0,"PACMA",0
13,"13005",23256,16610,16367,132,243,"PACMA",139
34,"34022",1022,813,798,7,15,"PACMA",1
28,"28133",6146,4245,4180,25,65,"PACMA",38
46,"46138",361,289,287,1,2,"PACMA",0
48,"48073",6827,4614,4591,38,23,"PACMA",14
47,"47010",14718,11521,11392,137,129,"PACMA",108
28,"28136",693,538,533,2,5,"PACMA",4
6,"6101",437,355,346,1,9,"PACMA",0
47,"47126",42,35,35,1,0,"PACMA",0
50,"50003",117,89,89,1,0,"PACMA",0
46,"46012",965,689,675,4,14,"PACMA",13
31,"31262",234,190,188,0,2,"PACMA",1
49,"49204",58,44,43,1,1,"PACMA",0
49,"49021",14204,9429,9295,87,134,"PACMA",46
37,"37186",94,68,68,0,0,"PACMA",0
7,"7020",3707,2522,2493,40,29,"PACMA",27
12,"12037",17,13,13,1,0,"PACMA",0
37,"37157",76,64,63,1,1,"PACMA",0
18,"18098",5959,3816,3749,33,67,"PACMA",9
16,"16027",691,500,495,1,5,"PACMA",2
16,"16064",651,556,550,4,6,"PACMA",5
6,"6012",3231,2306,2278,25,28,"PACMA",13
20,"20004",230,133,133,2,0,"PACMA",0
10,"10097",107,84,80,0,4,"PACMA",0
42,"42189",57,43,43,0,0,"PACMA",0
5,"5054",1192,871,856,6,15,"PACMA",5
27,"27060",2434,1458,1434,17,24,"PACMA",3
42,"42013",34,22,22,2,0,"PACMA",0
20,"20005",1274,822,822,1,0,"PACMA",2
26,"26180",221,164,162,4,2,"PACMA",1
19,"19049",8,8,7,0,1,"PACMA",0
9,"9075",104,82,82,0,0,"PACMA",1
40,"40182",169,112,112,1,0,"PACMA",0
5,"5120",33,26,26,0,0,"PACMA",0
25,"25137",8684,5802,5757,48,45,"PACMA",47
42,"42190",94,61,61,1,0,"PACMA",0
9,"9334",51,36,34,1,2,"PACMA",1
50,"50217",426,333,333,1,0,"PACMA",1
4,"4024",3241,2315,2290,34,25,"PACMA",23
41,"41005",9285,6637,6497,83,140,"PACMA",85
3,"3902",10640,7024,6952,36,72,"PACMA",75
17,"17222",104,87,87,1,0,"PACMA",0
16,"16002",192,160,158,2,2,"PACMA",0
47,"47137",29,25,25,0,0,"PACMA",0
44,"44165",168,125,125,2,0,"PACMA",1
50,"50159",640,493,486,3,7,"PACMA",0
5,"5251",56,35,34,0,1,"PACMA",0
18,"18016",297,200,198,3,2,"PACMA",0
46,"46227",893,687,675,6,12,"PACMA",7
37,"37107",10444,6997,6884,76,113,"PACMA",23
6,"6076",825,573,562,1,11,"PACMA",3
29,"29080",6940,4676,4617,36,59,"PACMA",46
25,"25046",410,331,326,4,5,"PACMA",1
5,"5021",1861,1323,1304,22,19,"PACMA",1
44,"44008",1556,1109,1100,7,9,"PACMA",1
24,"24180",1086,767,759,9,8,"PACMA",3
41,"41044",7753,5636,5547,55,89,"PACMA",55
45,"45009",455,277,274,2,3,"PACMA",0
5,"5218",104,81,79,0,2,"PACMA",0
6,"6062",564,394,391,0,3,"PACMA",0
24,"24071",947,618,611,6,7,"PACMA",7
48,"48049",543,415,414,1,1,"PACMA",3
46,"46015",7519,5575,5532,34,43,"PACMA",51
10,"10060",921,615,596,4,19,"PACMA",2
3,"3048",4993,3549,3502,13,47,"PACMA",23
22,"22201",264,188,186,3,2,"PACMA",2
40,"40002",32,22,21,0,1,"PACMA",0
5,"5219",33,23,23,0,0,"PACMA",0
47,"47192",89,78,76,3,2,"PACMA",0
26,"26145",239,194,187,3,7,"PACMA",0
22,"22124",183,119,119,0,0,"PACMA",0
16,"16108",44,35,34,1,1,"PACMA",0
25,"25233",289,219,218,6,1,"PACMA",0
37,"37181",265,158,158,0,0,"PACMA",0
26,"26172",25,16,15,0,1,"PACMA",0
30,"30021",9498,6251,6193,36,58,"PACMA",29
26,"26080",451,347,344,0,3,"PACMA",0
37,"37092",1933,1342,1327,13,15,"PACMA",8
16,"16213",34,27,26,0,1,"PACMA",0
31,"31014",268,168,168,2,0,"PACMA",1
25,"25049",156,110,109,1,1,"PACMA",0
41,"41046",3005,2241,2198,11,43,"PACMA",21
46,"46052",515,423,419,4,4,"PACMA",0
48,"48057",5730,4126,4115,14,11,"PACMA",6
9,"9067",399,232,230,3,2,"PACMA",0
37,"37085",5060,3732,3689,52,43,"PACMA",27
24,"24076",1283,926,913,10,13,"PACMA",8
45,"45110",1685,1288,1274,5,14,"PACMA",0
17,"17135",393,307,303,0,4,"PACMA",2
15,"15001",4697,3069,3022,45,47,"PACMA",19
5,"5221",322,231,231,0,0,"PACMA",1
49,"49138",205,141,140,2,1,"PACMA",0
2,"2013",125,90,88,0,2,"PACMA",0
27,"27004",1143,640,625,2,15,"PACMA",1
29,"29083",2063,1471,1444,14,27,"PACMA",3
43,"43038",22070,15127,15018,113,109,"PACMA",194
50,"50058",63,45,43,0,2,"PACMA",0
36,"36030",3921,2516,2484,31,32,"PACMA",18
12,"12014",164,111,111,0,0,"PACMA",0
45,"45013",1679,1266,1248,5,18,"PACMA",4
37,"37382",162,127,124,0,3,"PACMA",0
9,"9467",59,46,46,2,0,"PACMA",0
18,"18105",3827,2436,2392,22,44,"PACMA",5
19,"19191",13,12,12,0,0,"PACMA",1
5,"5160",289,220,213,0,7,"PACMA",0
22,"22235",88,69,68,1,1,"PACMA",0
44,"44191",714,509,500,5,9,"PACMA",3
40,"40103",139,113,113,0,0,"PACMA",0
46,"46086",80,66,65,1,1,"PACMA",0
50,"50059",757,556,551,5,5,"PACMA",1
22,"22215",127,81,81,0,0,"PACMA",0
3,"3042",1475,1053,1043,7,10,"PACMA",9
2,"2081",18287,12910,12675,130,235,"PACMA",76
44,"44012",303,215,215,2,0,"PACMA",3
9,"9250",264,195,193,3,2,"PACMA",1
45,"45125",2256,1711,1689,16,22,"PACMA",8
28,"28178",1149,869,853,4,16,"PACMA",8
33,"33002",9403,5920,5839,69,81,"PACMA",27
16,"16159",198,135,135,2,0,"PACMA",0
5,"5905",214,148,142,1,6,"PACMA",0
35,"35034",8392,3946,3908,27,38,"PACMA",64
39,"39099",3193,2363,2346,10,17,"PACMA",17
32,"32046",1089,679,670,4,9,"PACMA",2
50,"50016",44,31,31,0,0,"PACMA",0
22,"22041",145,116,116,2,0,"PACMA",0
32,"32074",977,642,631,2,11,"PACMA",6
26,"26086",15,15,15,0,0,"PACMA",0
6,"6147",329,234,234,1,0,"PACMA",0
38,"38051",7328,5017,4969,32,48,"PACMA",36
46,"46088",152,114,110,1,4,"PACMA",1
5,"5225",355,276,273,6,3,"PACMA",1
46,"46156",2017,1538,1524,9,14,"PACMA",8
25,"25145",75,59,59,0,0,"PACMA",0
22,"22027",311,210,209,1,1,"PACMA",2
23,"23077",604,482,477,2,5,"PACMA",0
5,"5029",100,73,73,1,0,"PACMA",0
9,"9476",60,46,46,0,0,"PACMA",0
6,"6072",2211,1610,1586,11,24,"PACMA",3
40,"40105",43,35,35,0,0,"PACMA",0
50,"50287",253,189,188,11,1,"PACMA",0
12,"12045",333,243,235,2,8,"PACMA",1
2,"2050",85,66,66,1,0,"PACMA",0
23,"23079",3624,2661,2630,19,31,"PACMA",7
26,"26113",29,28,28,0,0,"PACMA",0
23,"23044",4697,3495,3400,31,95,"PACMA",21
16,"16196",589,490,476,3,14,"PACMA",1
37,"37291",269,186,185,1,1,"PACMA",0
47,"47199",71,57,57,2,0,"PACMA",0
31,"31129",388,239,238,3,1,"PACMA",1
37,"37002",125,64,63,0,1,"PACMA",0
48,"48056",980,731,728,3,3,"PACMA",1
34,"34231",211,157,153,3,4,"PACMA",0
9,"9148",77,58,58,3,0,"PACMA",0
37,"37022",242,191,190,0,1,"PACMA",0
35,"35013",6593,4596,4516,47,80,"PACMA",32
45,"45056",2341,1315,1295,11,20,"PACMA",14
46,"46158",1047,771,763,7,8,"PACMA",5
13,"13902",449,329,326,4,3,"PACMA",2
2,"2079",2807,2000,1978,17,22,"PACMA",9
50,"50190",669,532,518,10,14,"PACMA",3
18,"18144",816,592,582,3,10,"PACMA",5
47,"47040",56,42,41,0,1,"PACMA",0
14,"14006",1319,1088,1057,8,31,"PACMA",2
4,"4068",170,129,128,0,1,"PACMA",0
12,"12084",17785,12557,12422,108,135,"PACMA",81
47,"47075",4772,3557,3512,34,45,"PACMA",12
31,"31095",71,59,59,0,0,"PACMA",1
45,"45155",311,240,240,0,0,"PACMA",0
49,"49170",99,68,68,1,0,"PACMA",0
40,"40183",117,105,99,1,6,"PACMA",0
32,"32091",1695,1163,1156,2,7,"PACMA",3
12,"12126",24374,17741,17553,111,188,"PACMA",129
44,"44017",269,217,216,0,1,"PACMA",0
11,"11008",17923,11702,11464,192,238,"PACMA",167
19,"19257",3279,2233,2206,21,27,"PACMA",13
49,"49147",250,164,162,1,2,"PACMA",0
22,"22001",212,147,146,0,1,"PACMA",0
50,"50115",3279,2170,2131,27,39,"PACMA",9
14,"14001",3423,2563,2515,11,48,"PACMA",14
45,"45131",259,219,216,1,3,"PACMA",0
6,"6077",319,234,229,2,5,"PACMA",0
9,"9152",244,161,161,0,0,"PACMA",1
50,"50064",439,348,346,1,2,"PACMA",0
19,"19061",56,42,41,0,1,"PACMA",0
40,"40012",241,160,156,7,4,"PACMA",0
42,"42163",50,27,27,1,0,"PACMA",0
46,"46091",110,100,100,0,0,"PACMA",0
39,"39028",3892,2905,2878,20,27,"PACMA",14
27,"27011",2341,1387,1362,7,25,"PACMA",2
5,"5230",65,57,56,1,1,"PACMA",0
45,"45022",395,292,292,2,0,"PACMA",4
17,"17224",299,226,222,2,4,"PACMA",2
6,"6079",649,451,445,3,6,"PACMA",1
46,"46069",152,112,111,1,1,"PACMA",0
37,"37109",178,127,126,0,1,"PACMA",0
46,"46092",262,176,174,2,2,"PACMA",1
25,"25039",259,197,196,7,1,"PACMA",0
14,"14030",7761,5711,5588,84,123,"PACMA",39
50,"50131",212,152,147,4,5,"PACMA",0
49,"49250",1191,844,824,8,20,"PACMA",1
2,"2078",891,650,642,4,8,"PACMA",9
1,"1051",3569,2259,2244,3,15,"PACMA",9
2,"2045",3609,2797,2752,38,45,"PACMA",20
31,"31234",146,101,101,0,0,"PACMA",0
50,"50209",2785,1893,1865,24,28,"PACMA",23
13,"13060",274,205,202,3,3,"PACMA",1
24,"24183",748,464,460,9,4,"PACMA",0
19,"19135",90,71,69,1,2,"PACMA",0
49,"49006",139,98,95,3,3,"PACMA",1
46,"46070",17824,12888,12802,106,86,"PACMA",169
32,"32083",805,498,494,3,4,"PACMA",3
46,"46161",1467,1129,1113,5,16,"PACMA",7
12,"12128",1365,990,972,16,18,"PACMA",6
47,"47111",1001,738,732,5,6,"PACMA",1
5,"5038",114,83,82,0,1,"PACMA",0
18,"18083",232,181,179,1,2,"PACMA",1
20,"20021",185,104,104,2,0,"PACMA",0
19,"19066",51,42,42,0,0,"PACMA",0
6,"6036",4930,3492,3394,20,98,"PACMA",7
13,"13062",567,450,446,4,4,"PACMA",1
50,"50292",130,108,107,0,1,"PACMA",0
31,"31137",198,83,83,1,0,"PACMA",1
1,"1057",235,196,194,0,2,"PACMA",1
28,"28114",141,97,97,0,0,"PACMA",0
17,"17145",1410,1040,1032,6,8,"PACMA",8
39,"39032",1420,1032,1027,7,5,"PACMA",2
11,"11013",2352,1564,1522,13,42,"PACMA",6
33,"33050",548,316,314,1,2,"PACMA",1
34,"34240",84,67,66,1,1,"PACMA",0
37,"37269",424,280,277,2,3,"PACMA",0
13,"13094",294,216,215,1,1,"PACMA",0
18,"18149",5408,3926,3859,42,67,"PACMA",35
42,"42168",108,73,73,0,0,"PACMA",0
37,"37300",540,355,352,7,3,"PACMA",2
10,"10080",353,243,238,1,5,"PACMA",0
11,"11014",17203,10923,10805,222,118,"PACMA",113
16,"16049",137,98,98,2,0,"PACMA",2
45,"45097",1037,834,819,7,15,"PACMA",1
28,"28074",141137,106626,105602,885,1024,"PACMA",976
17,"17042",410,299,297,5,2,"PACMA",4
4,"4902",45571,29423,29169,272,254,"PACMA",228
50,"50185",140,93,92,1,1,"PACMA",0
18,"18002",529,387,384,1,3,"PACMA",1
22,"22049",73,62,62,0,0,"PACMA",0
9,"9024",150,100,99,1,1,"PACMA",1
3,"3043",2906,2360,2334,27,26,"PACMA",6
31,"31054",453,279,276,2,3,"PACMA",0
9,"9109",1072,575,558,0,17,"PACMA",14
34,"34243",323,243,239,1,4,"PACMA",1
9,"9328",70,37,37,3,0,"PACMA",0
37,"37240",928,648,637,2,11,"PACMA",1
12,"12055",103,77,76,2,1,"PACMA",0
12,"12131",97,87,87,0,0,"PACMA",0
24,"24202",7504,4607,4538,51,69,"PACMA",21
16,"16128",50,38,38,0,0,"PACMA",0
49,"49155",81,60,59,0,1,"PACMA",0
3,"3006",493,365,360,2,5,"PACMA",1
6,"6041",456,329,321,2,8,"PACMA",1
10,"10001",287,207,203,2,4,"PACMA",0
37,"37011",100,78,78,3,0,"PACMA",0
50,"50069",66,33,33,1,0,"PACMA",0
50,"50044",224,159,159,2,0,"PACMA",1
19,"19071",8277,5838,5763,53,75,"PACMA",78
37,"37303",179,118,117,1,1,"PACMA",2
10,"10165",252,204,201,3,3,"PACMA",0
34,"34146",53,43,43,0,0,"PACMA",0
20,"20025",1110,791,788,4,3,"PACMA",5
9,"9012",93,70,68,0,2,"PACMA",1
49,"49268",364,266,263,3,3,"PACMA",2
48,"48009",774,585,578,0,7,"PACMA",2
49,"49269",218,126,124,1,2,"PACMA",0
18,"18087",182877,131811,130184,1106,1627,"PACMA",1152
23,"23093",3119,2264,2216,24,48,"PACMA",15
12,"12056",257,205,199,1,6,"PACMA",0
24,"24094",1320,866,852,11,14,"PACMA",1
26,"26088",39,35,34,0,1,"PACMA",0
47,"47117",287,199,197,6,2,"PACMA",1
50,"50122",68,43,42,1,1,"PACMA",0
37,"37141",149,101,100,0,1,"PACMA",0
1,"1019",148,112,112,0,0,"PACMA",0
9,"9199",91,68,68,0,0,"PACMA",1
5,"5214",28,18,18,0,0,"PACMA",0
12,"12133",59,46,45,0,1,"PACMA",0
44,"44075",321,255,252,1,3,"PACMA",0
2,"2052",466,371,370,6,1,"PACMA",4
42,"42027",72,48,47,1,1,"PACMA",0
47,"47129",855,660,648,7,12,"PACMA",2
1,"1052",272,189,186,2,3,"PACMA",0
47,"47140",106,83,83,0,0,"PACMA",0
46,"46242",326,260,257,3,3,"PACMA",1
7,"7057",7471,4430,4392,41,38,"PACMA",40
48,"48039",254,221,220,2,1,"PACMA",1
5,"5208",39,32,32,0,0,"PACMA",0
35,"35022",51765,29309,29034,184,275,"PACMA",373
19,"19237",39,34,34,0,0,"PACMA",1
17,"17065",321,264,263,3,1,"PACMA",0
47,"47213",104,78,78,0,0,"PACMA",2
16,"16095",82,70,70,1,0,"PACMA",1
36,"36047",2248,1379,1363,11,16,"PACMA",2
31,"31108",1819,1348,1325,13,23,"PACMA",9
6,"6092",558,438,426,2,12,"PACMA",0
49,"49050",498,305,305,2,0,"PACMA",1
10,"10005",527,325,301,1,24,"PACMA",2
11,"11019",1757,1233,1172,13,61,"PACMA",10
50,"50072",183,131,129,0,2,"PACMA",1
9,"9017",89,61,60,3,1,"PACMA",0
1,"1901",2473,1633,1612,9,21,"PACMA",23
9,"9018",24624,17232,16983,192,249,"PACMA",106
16,"16217",91,72,72,0,0,"PACMA",0
23,"23059",5736,4245,4119,51,126,"PACMA",36
32,"32056",1490,1009,1003,10,6,"PACMA",2
47,"47182",1328,940,934,8,6,"PACMA",0
49,"49160",42,27,27,0,0,"PACMA",1
46,"46031",10574,7233,7158,58,75,"PACMA",77
14,"14011",580,444,443,3,1,"PACMA",0
5,"5210",81,56,56,0,0,"PACMA",0
45,"45061",2490,1690,1669,9,21,"PACMA",11
47,"47056",81,57,57,0,0,"PACMA",0
40,"40213",93,78,78,1,0,"PACMA",0
42,"42031",25,17,17,1,0,"PACMA",0
35,"35006",31373,20764,20476,189,288,"PACMA",247
3,"3064",5015,3514,3461,15,53,"PACMA",29
45,"45134",1622,1187,1177,8,10,"PACMA",6
33,"33077",1097,688,683,4,5,"PACMA",2
9,"9265",38,31,31,1,0,"PACMA",0
41,"41056",3687,2836,2779,37,57,"PACMA",22
34,"34015",37,24,24,0,0,"PACMA",0
14,"14068",517,388,378,3,10,"PACMA",4
37,"37017",226,169,168,4,1,"PACMA",2
14,"14012",6046,4215,4120,56,95,"PACMA",22
18,"18094",2299,1712,1652,20,60,"PACMA",11
46,"46237",7172,5199,5146,53,53,"PACMA",62
11,"11022",48785,24758,24422,398,336,"PACMA",514
9,"9020",233,170,166,3,4,"PACMA",0
40,"40123",141,98,94,4,4,"PACMA",0
40,"40186",35,29,29,0,0,"PACMA",0
25,"25133",671,481,479,1,2,"PACMA",3
15,"15022",5580,3508,3472,47,36,"PACMA",20
37,"37183",377,267,267,5,0,"PACMA",0
4,"4051",404,323,319,2,4,"PACMA",2
12,"12061",374,263,261,4,2,"PACMA",1
16,"16137",37,27,25,0,2,"PACMA",0
46,"46101",819,670,663,8,7,"PACMA",2
17,"17154",101,76,76,0,0,"PACMA",2
5,"5049",403,261,253,1,8,"PACMA",1
40,"40124",234,169,164,0,5,"PACMA",2
22,"22048",12635,8889,8807,98,82,"PACMA",66
34,"34018",199,151,149,4,2,"PACMA",1
9,"9022",58,46,46,1,0,"PACMA",1
48,"48043",4591,3337,3325,20,12,"PACMA",20
19,"19116",12,10,10,0,0,"PACMA",0
49,"49265",110,79,78,2,1,"PACMA",0
9,"9287",191,144,143,2,1,"PACMA",0
28,"28019",1272,926,914,6,12,"PACMA",9
12,"12007",724,622,614,2,8,"PACMA",4
15,"15086",2760,1829,1810,26,19,"PACMA",6
37,"37185",539,372,363,2,9,"PACMA",5
45,"45137",1541,1007,998,8,9,"PACMA",8
10,"10211",446,303,300,0,3,"PACMA",1
44,"44204",27,18,18,0,0,"PACMA",0
44,"44010",185,144,143,0,1,"PACMA",0
28,"28100",4482,3146,3113,21,33,"PACMA",56
45,"45016",4486,3288,3251,19,37,"PACMA",34
40,"40233",399,279,273,0,6,"PACMA",0
40,"40200",38,28,28,0,0,"PACMA",0
33,"33015",1396,849,842,7,7,"PACMA",1
24,"24007",735,500,496,8,4,"PACMA",4
15,"15077",8103,4893,4818,61,75,"PACMA",16
29,"29075",12886,8292,8191,63,101,"PACMA",102
44,"44096",155,115,114,1,1,"PACMA",0
36,"36053",5783,3955,3899,39,56,"PACMA",26
2,"2071",1027,800,795,7,5,"PACMA",2
17,"17071",1134,943,940,1,3,"PACMA",3
15,"15056",5615,3697,3646,31,51,"PACMA",15
41,"41041",9765,7172,6943,63,229,"PACMA",58
44,"44033",243,165,165,3,0,"PACMA",0
17,"17157",122,104,103,0,1,"PACMA",1
40,"40028",103,88,87,2,1,"PACMA",0
19,"19082",100,72,71,1,1,"PACMA",0
49,"49058",301,222,221,1,1,"PACMA",0
34,"34216",61,41,41,0,0,"PACMA",1
16,"16181",54,40,40,0,0,"PACMA",0
19,"19086",1371,1003,996,9,7,"PACMA",3
31,"31227",8118,5691,5636,65,55,"PACMA",45
28,"28127",66793,53258,53009,458,249,"PACMA",421
47,"47001",52,43,42,1,1,"PACMA",0
37,"37187",548,407,399,0,8,"PACMA",0
45,"45116",666,492,489,4,3,"PACMA",3
3,"3016",88,66,66,0,0,"PACMA",0
40,"40128",123,88,87,1,1,"PACMA",1
22,"22906",177,123,122,6,1,"PACMA",3
20,"20066",437,288,286,1,2,"PACMA",0
18,"18133",2101,1496,1477,6,19,"PACMA",15
16,"16185",36,31,31,0,0,"PACMA",0
3,"3017",379,320,314,4,6,"PACMA",3
22,"22158",11994,8115,8049,79,66,"PACMA",69
24,"24069",37,26,25,0,1,"PACMA",0
34,"34114",200,134,134,0,0,"PACMA",0
34,"34237",579,408,400,1,8,"PACMA",0
22,"22017",826,613,608,2,5,"PACMA",1
49,"49131",231,149,145,1,4,"PACMA",0
3,"3055",5265,3741,3697,16,44,"PACMA",46
9,"9076",24,19,19,1,0,"PACMA",0
50,"50248",501,344,328,3,16,"PACMA",0
33,"33027",752,412,405,11,7,"PACMA",0
48,"48010",476,343,343,1,0,"PACMA",3
47,"47105",169,138,137,2,1,"PACMA",0
40,"40020",149,112,111,1,1,"PACMA",0
18,"18100",7997,5523,5367,66,156,"PACMA",37
31,"31168",238,176,174,1,2,"PACMA",0
40,"40043",1773,1376,1345,21,31,"PACMA",1
6,"6016",2937,2042,1978,12,64,"PACMA",5
22,"22052",874,660,652,7,8,"PACMA",1
2,"2009",19495,13877,13663,134,214,"PACMA",106
24,"24219",489,334,329,7,5,"PACMA",1
9,"9189",123,83,78,0,5,"PACMA",0
19,"19186",76,60,60,0,0,"PACMA",0
40,"40032",368,247,244,5,3,"PACMA",0
11,"11029",5442,2826,2765,44,61,"PACMA",16
17,"17160",14756,9892,9852,58,40,"PACMA",111
24,"24107",206,147,147,1,0,"PACMA",0
41,"41072",4031,2969,2933,15,36,"PACMA",11
6,"6108",2238,1524,1478,15,46,"PACMA",9
37,"37317",287,211,209,1,2,"PACMA",0
47,"47097",305,239,237,0,2,"PACMA",0
46,"46129",511,389,379,9,10,"PACMA",1
25,"25139",477,348,346,3,2,"PACMA",2
3,"3019",15501,11261,11106,86,155,"PACMA",103
19,"19089",23,17,17,0,0,"PACMA",0
27,"27032",3197,1979,1956,30,23,"PACMA",11
34,"34029",665,524,518,1,6,"PACMA",4
10,"10142",833,555,539,0,16,"PACMA",1
18,"18102",8233,5424,5266,46,158,"PACMA",31
42,"42056",28,25,24,0,1,"PACMA",0
9,"9135",41,28,28,0,0,"PACMA",0
20,"20029",4264,3116,3104,14,12,"PACMA",9
19,"19078",47,37,36,0,1,"PACMA",0
49,"49052",183,120,117,2,3,"PACMA",0
45,"45117",718,552,548,0,4,"PACMA",2
37,"37283",116,83,83,0,0,"PACMA",0
16,"16264",385,311,305,1,6,"PACMA",0
37,"37360",206,135,135,1,0,"PACMA",2
42,"42134",2651,1875,1836,21,39,"PACMA",5
22,"22125",39530,27358,27075,344,283,"PACMA",201
12,"12136",2603,2151,2119,20,32,"PACMA",14
9,"9340",74,49,49,1,0,"PACMA",0
33,"33012",5085,3158,3142,27,16,"PACMA",16
4,"4061",625,489,479,5,10,"PACMA",4
31,"31051",241,169,167,3,2,"PACMA",1
44,"44038",101,85,83,1,2,"PACMA",0
19,"19281",19,18,18,0,0,"PACMA",0
46,"46245",527,407,404,2,3,"PACMA",4
16,"16034",155,116,113,0,3,"PACMA",0
19,"19159",87,73,72,1,1,"PACMA",0
10,"10145",123,90,84,0,6,"PACMA",0
17,"17163",2868,2281,2268,13,13,"PACMA",20
9,"9036",31,24,24,4,0,"PACMA",1
10,"10022",409,301,291,1,10,"PACMA",1
44,"44039",204,144,143,1,1,"PACMA",0
12,"12071",1272,936,925,3,11,"PACMA",9
5,"5060",108,79,79,2,0,"PACMA",0
50,"50236",95,77,75,0,2,"PACMA",0
44,"44218",28,24,24,3,0,"PACMA",0
13,"13093",3901,2617,2569,16,48,"PACMA",16
25,"25172",1762,1332,1323,8,9,"PACMA",8
33,"33041",7101,4564,4513,58,51,"PACMA",25
16,"16035",224,177,174,2,3,"PACMA",0
50,"50162",135,100,99,3,1,"PACMA",0
43,"43144",1245,975,966,1,9,"PACMA",18
34,"34034",112,82,82,1,0,"PACMA",0
24,"24225",979,678,668,5,10,"PACMA",1
49,"49252",312,240,236,7,4,"PACMA",0
9,"9471",140,108,107,1,1,"PACMA",0
18,"18140",42474,26967,26648,225,319,"PACMA",272
33,"33013",430,294,292,1,2,"PACMA",2
45,"45014",4039,2606,2552,35,54,"PACMA",20
9,"9038",109,87,86,1,1,"PACMA",2
18,"18072",655,452,445,4,7,"PACMA",2
35,"35016",300581,181532,179831,1458,1701,"PACMA",2439
19,"19259",28,22,22,0,0,"PACMA",0
7,"7005",6956,4042,3996,35,46,"PACMA",48
45,"45053",7820,5814,5712,56,102,"PACMA",19
22,"22904",751,516,511,3,5,"PACMA",3
18,"18097",947,633,631,0,2,"PACMA",0
32,"32062",784,557,550,1,7,"PACMA",0
9,"9164",147,112,111,0,1,"PACMA",0
28,"28116",748,576,569,2,7,"PACMA",5
44,"44004",379,275,275,2,0,"PACMA",2
17,"17218",576,456,451,3,5,"PACMA",5
42,"42023",57,48,48,0,0,"PACMA",0
45,"45162",630,448,438,1,10,"PACMA",1
24,"24115",53159,35203,34784,410,419,"PACMA",269
9,"9041",25,21,21,2,0,"PACMA",0
15,"15036",56053,36487,36175,501,312,"PACMA",292
26,"26112",218,152,148,1,4,"PACMA",0
6,"6117",1388,982,958,11,24,"PACMA",3
45,"45163",8326,5835,5693,48,142,"PACMA",24
27,"27038",923,624,619,8,5,"PACMA",3
25,"25175",173,119,119,2,0,"PACMA",0
32,"32002",2028,1349,1340,4,9,"PACMA",5
9,"9366",76,55,55,2,0,"PACMA",0
44,"44221",386,307,304,1,3,"PACMA",1
27,"27007",2723,1822,1776,23,46,"PACMA",4
5,"5193",179,140,139,2,1,"PACMA",0
32,"32039",1154,801,790,11,11,"PACMA",5
17,"17140",635,506,505,2,1,"PACMA",3
6,"6073",703,451,441,6,10,"PACMA",2
31,"31166",242,172,172,2,0,"PACMA",0
31,"31056",186,128,124,2,4,"PACMA",5
49,"49075",130,100,97,1,3,"PACMA",0
40,"40901",413,320,315,7,5,"PACMA",2
29,"29042",14586,9793,9649,95,144,"PACMA",80
40,"40040",2489,1766,1744,26,22,"PACMA",4
31,"31093",275,201,198,3,3,"PACMA",0
4,"4067",504,340,330,4,10,"PACMA",2
17,"17167",2585,2015,1998,11,17,"PACMA",10
19,"19287",134,100,98,2,2,"PACMA",0
5,"5194",132,105,104,1,1,"PACMA",0
9,"9045",269,159,158,0,1,"PACMA",1
46,"46112",533,435,432,7,3,"PACMA",3
50,"50188",26,23,23,0,0,"PACMA",0
1,"1034",152,107,107,1,0,"PACMA",1
22,"22074",303,209,208,5,1,"PACMA",3
9,"9257",85,67,67,2,0,"PACMA",0
19,"19130",61556,45926,45388,408,538,"PACMA",313
31,"31022",477,303,301,2,2,"PACMA",0
32,"32078",1099,715,707,4,8,"PACMA",1
23,"23094",3739,2920,2876,29,44,"PACMA",13
12,"12068",41,22,21,0,1,"PACMA",0
9,"9046",23,17,17,0,0,"PACMA",0
16,"16145",413,333,326,6,7,"PACMA",1
12,"12109",646,489,482,4,7,"PACMA",6
31,"31242",258,168,167,2,1,"PACMA",0
32,"32079",1280,880,869,13,11,"PACMA",1
6,"6122",6535,4204,4110,47,94,"PACMA",35
44,"44137",187,139,139,0,0,"PACMA",0
49,"49003",860,534,530,5,4,"PACMA",2
26,"26117",2105,1537,1500,17,37,"PACMA",9
9,"9483",189,156,155,2,1,"PACMA",0
47,"47014",48,39,39,1,0,"PACMA",0
9,"9374",93,75,72,2,3,"PACMA",0
20,"20048",183,112,112,0,0,"PACMA",0
24,"24012",278,182,180,0,2,"PACMA",0
37,"37139",189,150,148,1,2,"PACMA",0
45,"45168",62836,46917,46353,424,564,"PACMA",380
22,"22063",161,128,126,0,2,"PACMA",2
49,"49078",138,113,109,4,4,"PACMA",0
45,"45059",1702,1315,1303,1,12,"PACMA",9
46,"46114",552,417,412,6,5,"PACMA",5
28,"28143",77,58,58,0,0,"PACMA",0
48,"48087",437,335,332,0,3,"PACMA",1
49,"49184",172,110,107,2,3,"PACMA",0
24,"24120",305,182,181,1,1,"PACMA",1
5,"5067",73,56,54,0,2,"PACMA",0
50,"50015",81,57,56,0,1,"PACMA",0
47,"47016",65,55,55,0,0,"PACMA",0
10,"10034",337,244,240,0,4,"PACMA",1
18,"18082",810,503,500,3,3,"PACMA",2
1,"1054",998,701,700,4,1,"PACMA",3
5,"5047",4105,3004,2936,23,68,"PACMA",9
45,"45129",98,77,77,1,0,"PACMA",0
3,"3002",3649,2568,2542,11,26,"PACMA",36
16,"16070",29,27,27,0,0,"PACMA",0
3,"3136",399,302,301,3,1,"PACMA",0
32,"32009",10558,6621,6549,50,72,"PACMA",38
46,"46085",11089,7581,7503,60,78,"PACMA",39
22,"22023",385,293,283,2,10,"PACMA",0
26,"26120",1441,1027,1011,11,16,"PACMA",5
14,"14003",1245,925,907,5,18,"PACMA",8
22,"22037",112,87,87,2,0,"PACMA",0
45,"45024",1034,742,733,1,9,"PACMA",1
49,"49039",324,249,239,3,10,"PACMA",1
23,"23086",11427,7984,7735,81,249,"PACMA",84
15,"15042",2928,1879,1853,11,26,"PACMA",11
2,"2024",3361,2444,2411,24,33,"PACMA",26
36,"36007",1610,1047,1016,5,31,"PACMA",3
47,"47047",199,136,135,4,1,"PACMA",0
39,"39059",7518,5327,5287,23,40,"PACMA",26
23,"23014",2535,1890,1861,28,29,"PACMA",10
44,"44142",29,21,21,0,0,"PACMA",0
29,"29047",1082,860,846,0,14,"PACMA",3
9,"9006",57,30,29,0,1,"PACMA",1
3,"3003",449,368,367,1,1,"PACMA",3
16,"16161",51,44,44,1,0,"PACMA",0
12,"12079",414,310,305,2,5,"PACMA",1
49,"49081",1321,972,953,6,19,"PACMA",3
13,"13017",240,178,176,0,2,"PACMA",0
37,"37237",296,212,204,1,8,"PACMA",1
9,"9055",47,33,32,0,1,"PACMA",0
45,"45172",640,475,462,6,13,"PACMA",1
28,"28146",1806,1232,1218,3,14,"PACMA",0
31,"31138",948,629,627,8,2,"PACMA",2
23,"23088",6017,4529,4427,61,102,"PACMA",24
9,"9382",27,22,22,0,0,"PACMA",0
1,"1058",1414,893,884,1,9,"PACMA",5
37,"37238",105,83,80,0,3,"PACMA",1
9,"9056",4833,3191,3156,37,35,"PACMA",22
5,"5040",64,47,46,0,1,"PACMA",0
18,"18021",17929,12165,11949,139,216,"PACMA",125
10,"10039",400,256,217,0,39,"PACMA",3
44,"44267",70,47,46,0,1,"PACMA",1
37,"37020",431,320,314,3,6,"PACMA",4
37,"37312",244,191,189,1,2,"PACMA",0
13,"13095",66,56,56,3,0,"PACMA",0
19,"19022",592,423,420,6,3,"PACMA",0
26,"26072",287,239,235,3,4,"PACMA",0
23,"23064",1669,1311,1296,9,15,"PACMA",0
4,"4016",2136,1486,1467,13,19,"PACMA",6
9,"9310",15,14,11,0,3,"PACMA",0
49,"49043",256,191,189,1,2,"PACMA",1
23,"23090",1204,953,938,6,15,"PACMA",4
47,"47114",3900,2549,2514,18,35,"PACMA",10
26,"26125",2665,1885,1853,21,32,"PACMA",5
47,"47020",270,212,207,5,5,"PACMA",0
48,"48092",872,614,608,3,6,"PACMA",3
13,"13021",412,325,320,1,5,"PACMA",0
19,"19296",29,24,24,0,0,"PACMA",1
34,"34196",87,67,67,3,0,"PACMA",1
29,"29050",392,229,227,3,2,"PACMA",3
34,"34052",164,127,125,1,2,"PACMA",0
22,"22069",423,296,294,4,2,"PACMA",2
20,"20055",17300,11784,11725,43,59,"PACMA",55
10,"10041",1022,720,706,2,14,"PACMA",1
33,"33025",8956,5493,5453,81,40,"PACMA",26
3,"3034",1404,1028,1010,5,18,"PACMA",8
26,"26126",29,27,27,0,0,"PACMA",2
19,"19109",33,26,26,2,0,"PACMA",0
40,"40212",26,19,19,1,0,"PACMA",1
47,"47148",419,332,324,3,8,"PACMA",1
3,"3121",21997,14689,14572,103,117,"PACMA",204
17,"17090",539,440,440,2,0,"PACMA",0
9,"9060",126,104,104,2,0,"PACMA",0
29,"29097",4160,2872,2800,56,72,"PACMA",26
28,"28150",3191,2423,2401,13,22,"PACMA",23
19,"19298",53,43,41,0,2,"PACMA",0
47,"47053",123,101,97,3,4,"PACMA",0
27,"27050",2821,1980,1954,11,26,"PACMA",6
25,"25007",1378,1010,999,12,11,"PACMA",16
3,"3036",82,73,71,1,2,"PACMA",0
31,"31179",486,315,312,3,3,"PACMA",2
45,"45031",2861,1894,1858,13,36,"PACMA",13
36,"36045",24459,16966,16735,124,231,"PACMA",178
24,"24131",684,416,415,2,1,"PACMA",1
5,"5019",44865,32917,32586,282,331,"PACMA",194
46,"46120",1179,903,880,5,23,"PACMA",11
6,"6135",1101,860,849,2,11,"PACMA",5
37,"37242",82,59,59,1,0,"PACMA",0
40,"40052",72,55,55,0,0,"PACMA",0
17,"17168",373,309,308,3,1,"PACMA",4
5,"5066",435,344,341,2,3,"PACMA",0
9,"9062",40,34,33,0,1,"PACMA",0
20,"20047",455,314,314,1,0,"PACMA",2
31,"31047",238,163,163,2,0,"PACMA",0
30,"30901",10556,7862,7775,58,87,"PACMA",77
42,"42176",27,21,21,0,0,"PACMA",0
28,"28119",2294,1760,1738,12,22,"PACMA",18
25,"25190",262,202,202,2,0,"PACMA",2
20,"20027",2761,1866,1861,10,5,"PACMA",5
14,"14038",32742,23345,22974,242,371,"PACMA",217
47,"47054",599,465,460,1,5,"PACMA",0
47,"47118",147,97,97,2,0,"PACMA",0
4,"4047",2224,1649,1627,13,22,"PACMA",10
39,"39037",2033,1431,1420,3,11,"PACMA",5
25,"25009",596,448,442,1,6,"PACMA",1
6,"6001",664,474,460,3,14,"PACMA",0
18,"18027",2598,1730,1706,12,24,"PACMA",9
24,"24133",357,256,256,1,0,"PACMA",0
50,"50098",162,119,118,1,1,"PACMA",1
23,"23024",12215,8702,8447,69,255,"PACMA",80
46,"46190",50042,35290,35066,284,224,"PACMA",429
47,"47055",188,147,147,2,0,"PACMA",0
15,"15019",25981,15866,15672,207,194,"PACMA",113
10,"10047",938,710,694,1,16,"PACMA",4
9,"9392",49,28,28,0,0,"PACMA",1
18,"18093",2751,1693,1674,18,19,"PACMA",8
33,"33029",315,145,142,1,3,"PACMA",0
9,"9394",668,432,429,6,3,"PACMA",4
37,"37150",34,31,31,0,0,"PACMA",0
28,"28076",432,330,327,4,3,"PACMA",0
31,"31183",718,536,534,5,2,"PACMA",4
22,"22064",155,100,100,2,0,"PACMA",2
34,"34046",43,29,29,0,0,"PACMA",0
4,"4012",184,151,150,3,1,"PACMA",3
19,"19169",30,27,27,0,0,"PACMA",0
34,"34184",49,37,35,0,2,"PACMA",0
42,"42182",49,39,39,1,0,"PACMA",0
44,"44226",123,85,84,0,1,"PACMA",0
20,"20020",114,64,64,0,0,"PACMA",0
16,"16058",94,71,71,1,0,"PACMA",0
44,"44150",28,17,17,0,0,"PACMA",0
11,"11021",4914,3187,3069,61,118,"PACMA",13
29,"29055",1892,1425,1394,3,31,"PACMA",16
20,"20061",4427,3073,3053,13,20,"PACMA",5
19,"19114",30,22,21,1,1,"PACMA",0
18,"18124",355,232,231,1,1,"PACMA",0
49,"49093",280,226,223,5,3,"PACMA",0
24,"24027",1214,841,828,6,13,"PACMA",7
9,"9396",149,121,121,4,0,"PACMA",3
25,"25163",230,162,161,0,1,"PACMA",0
43,"43056",803,566,558,6,8,"PACMA",1
45,"45074",397,300,293,2,7,"PACMA",0
33,"33003",603,322,317,7,5,"PACMA",0
36,"36020",2172,1435,1418,19,17,"PACMA",9
3,"3040",264,227,221,1,6,"PACMA",0
41,"41010",4586,3218,3157,42,61,"PACMA",54
50,"50178",269,165,163,6,2,"PACMA",0
9,"9229",178,127,127,1,0,"PACMA",0
9,"9230",33,26,26,0,0,"PACMA",0
14,"14042",18695,13788,13514,206,274,"PACMA",116
19,"19115",29,23,23,0,0,"PACMA",0
9,"9070",33,28,27,0,1,"PACMA",0
24,"24028",367,275,273,5,2,"PACMA",0
2,"2069",11401,8055,7975,30,80,"PACMA",33
35,"35003",5644,2987,2943,20,44,"PACMA",24
25,"25070",817,619,617,11,2,"PACMA",5
23,"23029",798,595,590,0,5,"PACMA",2
23,"23063",3784,2699,2664,22,35,"PACMA",13
47,"47156",150,117,117,0,0,"PACMA",0
26,"26138",4504,2982,2930,32,52,"PACMA",6
48,"48090",6004,4305,4254,28,51,"PACMA",14
31,"31175",66,46,46,0,0,"PACMA",0
3,"3005",7937,5907,5869,40,38,"PACMA",52
47,"47197",875,659,656,9,3,"PACMA",2
45,"45040",1247,727,715,3,12,"PACMA",2
5,"5151",83,60,60,0,0,"PACMA",1
24,"24102",587,403,399,7,4,"PACMA",0
2,"2016",528,353,352,4,1,"PACMA",2
39,"39052",19005,13859,13748,83,111,"PACMA",94
5,"5204",578,445,442,3,3,"PACMA",0
39,"39043",1517,1167,1154,3,13,"PACMA",4
20,"20034",3200,2193,2180,8,13,"PACMA",11
49,"49057",107,74,71,0,3,"PACMA",0
44,"44211",33,22,22,0,0,"PACMA",0
47,"47219",39,31,28,1,3,"PACMA",0
25,"25227",656,476,476,2,0,"PACMA",1
9,"9450",23,18,18,1,0,"PACMA",0
26,"26100",54,43,43,0,0,"PACMA",0
37,"37250",325,212,211,0,1,"PACMA",0
32,"32026",2655,1762,1731,17,31,"PACMA",9
16,"16063",112,81,81,1,0,"PACMA",0
48,"48904",3547,2563,2541,18,22,"PACMA",17
46,"46126",5580,4361,4328,36,33,"PACMA",36
14,"14016",1273,936,922,5,14,"PACMA",0
9,"9026",377,288,288,1,0,"PACMA",3
9,"9406",239,165,162,2,3,"PACMA",2
47,"47221",97,85,84,1,1,"PACMA",0
17,"17015",12829,9612,9580,51,32,"PACMA",62
3,"3044",4608,3437,3391,13,46,"PACMA",30
45,"45152",545,402,393,1,9,"PACMA",3
34,"34023",5103,3585,3543,45,42,"PACMA",33
47,"47032",147,102,102,0,0,"PACMA",0
37,"37345",150,117,113,0,4,"PACMA",2
19,"19307",25,23,23,0,0,"PACMA",0
38,"38044",2215,1270,1257,5,13,"PACMA",6
19,"19118",11,10,9,0,1,"PACMA",0
39,"39017",550,378,372,1,6,"PACMA",1
47,"47094",120,100,100,0,0,"PACMA",1
49,"49206",776,515,504,7,11,"PACMA",2
50,"50256",70,43,43,0,0,"PACMA",0
46,"46036",558,339,331,6,8,"PACMA",0
31,"31009",674,455,451,2,4,"PACMA",4
19,"19087",17,16,16,0,0,"PACMA",0
10,"10901",1161,758,753,1,5,"PACMA",2
45,"45179",493,362,357,5,5,"PACMA",0
30,"30027",50067,36417,36074,242,343,"PACMA",404
33,"33064",240,151,151,0,0,"PACMA",0
6,"6060",5696,4006,3900,37,106,"PACMA",18
20,"20037",101,69,69,0,0,"PACMA",0
37,"37148",399,295,291,0,4,"PACMA",1
5,"5078",95,78,78,2,0,"PACMA",0
47,"47003",206,167,166,5,1,"PACMA",0
3,"3018",12433,8582,8502,54,80,"PACMA",82
24,"24158",296,197,192,0,5,"PACMA",0
46,"46083",15372,10939,10815,78,124,"PACMA",153
50,"50232",160,93,92,1,1,"PACMA",1
50,"50106",123,78,78,0,0,"PACMA",0
26,"26028",135,111,110,3,1,"PACMA",0
33,"33037",33074,20693,20412,259,281,"PACMA",172
19,"19309",20,15,14,0,1,"PACMA",0
19,"19016",57,40,40,0,0,"PACMA",1
10,"10059",329,202,201,1,1,"PACMA",1
37,"37160",597,380,370,3,10,"PACMA",0
43,"43010",334,262,262,2,0,"PACMA",1
36,"36026",19890,13041,12891,169,150,"PACMA",134
34,"34221",168,129,127,2,2,"PACMA",0
39,"39075",136789,95707,95089,478,618,"PACMA",556
34,"34072",145,125,123,1,2,"PACMA",0
33,"33038",2218,1501,1477,17,24,"PACMA",8
44,"44187",193,147,146,0,1,"PACMA",0
31,"31158",248,156,151,0,5,"PACMA",0
25,"25203",8809,5813,5770,40,43,"PACMA",48
43,"43089",279,201,201,1,0,"PACMA",6
17,"17188",171,134,134,1,0,"PACMA",1
9,"9412",750,484,482,4,2,"PACMA",4
47,"47162",70,57,57,2,0,"PACMA",2
43,"43090",1199,689,686,5,3,"PACMA",9
17,"17020",3677,2851,2835,14,16,"PACMA",18
28,"28131",13510,9647,9544,89,103,"PACMA",90
14,"14021",260521,185270,183300,2192,1970,"PACMA",2163
25,"25077",435,312,312,1,0,"PACMA",1
27,"27054",1135,807,782,5,25,"PACMA",1
2,"2033",1864,1352,1315,12,37,"PACMA",12
12,"12078",334,224,221,2,3,"PACMA",1
45,"45060",152,109,109,1,0,"PACMA",3
19,"19249",29,26,26,0,0,"PACMA",0
40,"40132",45,26,25,0,1,"PACMA",0
44,"44179",324,201,201,2,0,"PACMA",3
6,"6156",1170,829,814,12,15,"PACMA",4
49,"49103",392,319,316,5,3,"PACMA",0
32,"32033",667,439,436,4,3,"PACMA",0
50,"50259",82,55,55,2,0,"PACMA",0
10,"10185",558,376,374,2,2,"PACMA",0
3,"3049",12103,8872,8785,57,87,"PACMA",62
24,"24039",1949,1420,1412,33,8,"PACMA",4
46,"46199",5878,4217,4182,21,35,"PACMA",36
44,"44130",28,23,23,0,0,"PACMA",0
46,"46017",33041,23469,23277,173,192,"PACMA",329
19,"19020",46,31,31,0,0,"PACMA",0
6,"6021",898,628,617,16,11,"PACMA",1
34,"34076",532,443,438,1,5,"PACMA",1
27,"27065",12055,7566,7379,119,187,"PACMA",31
21,"21075",338,243,235,3,8,"PACMA",1
46,"46063",1786,1270,1255,8,15,"PACMA",12
22,"22203",77,62,62,2,0,"PACMA",0
9,"9085",481,349,342,2,7,"PACMA",3
31,"31052",101,78,75,0,3,"PACMA",0
25,"25206",247,188,188,2,0,"PACMA",0
28,"28134",63936,48022,47631,421,391,"PACMA",439
24,"24152",433,269,267,4,2,"PACMA",0
6,"6159",2329,1297,1273,22,24,"PACMA",7
37,"37062",78,59,59,0,0,"PACMA",1
19,"19317",124,83,82,0,1,"PACMA",0
14,"14051",1323,975,951,7,24,"PACMA",1
19,"19125",45,23,23,0,0,"PACMA",0
44,"44068",634,497,493,2,4,"PACMA",1
22,"22127",521,353,352,5,1,"PACMA",2
47,"47070",29,24,24,0,0,"PACMA",0
4,"4063",1058,766,750,6,16,"PACMA",6
50,"50261",201,154,151,0,3,"PACMA",0
30,"30032",2864,2154,2129,18,25,"PACMA",13
5,"5095",236,181,177,1,4,"PACMA",1
5,"5267",103,67,67,1,0,"PACMA",0
11,"11025",4374,2808,2759,30,49,"PACMA",18
47,"47125",49,42,42,0,0,"PACMA",0
48,"48007",389,243,243,0,0,"PACMA",1
9,"9309",293,198,193,5,5,"PACMA",1
9,"9347",140,111,107,1,4,"PACMA",0
10,"10081",176,121,119,0,2,"PACMA",0
22,"22156",289,216,213,1,3,"PACMA",1
34,"34036",230,159,158,0,1,"PACMA",0
12,"12073",133,97,97,0,0,"PACMA",0
49,"49069",337,210,201,0,9,"PACMA",0
36,"36033",12305,8759,8597,67,162,"PACMA",57
47,"47167",245,198,198,1,0,"PACMA",0
27,"27902",7122,4472,4385,43,87,"PACMA",50
17,"17024",281,203,201,4,2,"PACMA",3
46,"46251",2465,1938,1903,19,35,"PACMA",13
31,"31091",322,201,201,3,0,"PACMA",0
17,"17193",4351,2945,2927,21,18,"PACMA",44
34,"34081",60,45,44,0,1,"PACMA",1
22,"22206",179,138,137,0,1,"PACMA",1
26,"26037",125,98,98,3,0,"PACMA",1
19,"19224",106,83,83,1,0,"PACMA",0
40,"40072",224,175,171,1,4,"PACMA",3
46,"46202",17801,13010,12906,87,104,"PACMA",161
16,"16003",134,108,105,0,3,"PACMA",1
17,"17220",801,649,647,2,2,"PACMA",3
37,"37324",333,247,242,3,5,"PACMA",1
5,"5064",101,77,77,0,0,"PACMA",0
19,"19129",25,21,21,0,0,"PACMA",0
46,"46134",2419,1697,1678,14,19,"PACMA",28
44,"44164",19,16,16,1,0,"PACMA",0
38,"38052",1283,806,794,3,12,"PACMA",5
37,"37067",3278,2568,2529,30,39,"PACMA",15
17,"17110",1332,990,981,3,9,"PACMA",3
45,"45092",223,193,190,1,3,"PACMA",0
12,"12124",1842,1343,1328,13,15,"PACMA",3
26,"26075",315,234,229,1,5,"PACMA",0
22,"22094",102,69,69,3,0,"PACMA",0
24,"24082",847,615,608,16,7,"PACMA",3
1,"1003",1166,843,837,6,6,"PACMA",1
23,"23045",2054,1423,1412,10,11,"PACMA",5
49,"49180",135,82,81,5,1,"PACMA",0
17,"17044",6938,5245,5212,33,33,"PACMA",53
40,"40139",255,194,192,2,2,"PACMA",0
46,"46044",4159,3062,2997,26,65,"PACMA",22
13,"13055",616,445,444,3,1,"PACMA",0
15,"15070",8778,5802,5656,131,146,"PACMA",37
47,"47170",43,36,30,0,6,"PACMA",0
43,"43097",407,331,328,4,3,"PACMA",2
6,"6030",168,131,128,1,3,"PACMA",0
26,"26155",145,120,119,0,1,"PACMA",0
49,"49246",214,183,180,3,3,"PACMA",1
40,"40041",966,729,716,8,13,"PACMA",2
6,"6121",3276,2301,2256,30,45,"PACMA",7
43,"43070",243,194,193,0,1,"PACMA",1
25,"25121",632,380,374,3,6,"PACMA",4
34,"34233",128,104,104,0,0,"PACMA",0
28,"28141",6284,4617,4570,42,47,"PACMA",72
32,"32042",1487,1010,1001,12,9,"PACMA",6
50,"50038",1404,1024,1007,15,17,"PACMA",1
3,"3028",959,780,767,7,13,"PACMA",6
26,"26041",109,67,65,0,2,"PACMA",0
50,"50039",462,339,333,1,6,"PACMA",1
3,"3903",2612,1838,1814,7,24,"PACMA",15
9,"9259",230,178,176,2,2,"PACMA",0
40,"40075",152,116,116,0,0,"PACMA",0
46,"46205",14237,10641,10533,77,108,"PACMA",109
45,"45095",663,496,492,2,4,"PACMA",0
36,"36037",2538,1650,1625,12,25,"PACMA",7
18,"18047",6103,3992,3922,61,70,"PACMA",44
37,"37171",396,272,270,2,2,"PACMA",2
26,"26158",242,184,181,1,3,"PACMA",0
49,"49004",110,74,71,3,3,"PACMA",0
7,"7003",12521,6457,6381,60,76,"PACMA",92
40,"40076",6576,4700,4607,32,93,"PACMA",39
9,"9261",446,279,271,2,8,"PACMA",0
19,"19133",78,64,64,2,0,"PACMA",0
17,"17197",128,97,97,0,0,"PACMA",1
37,"37202",1004,773,763,12,10,"PACMA",5
37,"37006",116,71,70,3,1,"PACMA",1
31,"31025",762,497,490,1,7,"PACMA",3
6,"6140",612,456,451,1,5,"PACMA",0
5,"5241",3062,2011,1977,21,34,"PACMA",11
25,"25123",189,135,133,0,2,"PACMA",2
37,"37266",68,44,44,0,0,"PACMA",0
46,"46001",771,562,560,3,2,"PACMA",1
41,"41018",9432,6463,6368,86,95,"PACMA",52
18,"18147",3655,2273,2241,16,32,"PACMA",14
33,"33049",5973,3569,3518,48,51,"PACMA",18
12,"12104",6843,5181,5111,32,70,"PACMA",26
28,"28175",940,740,730,2,10,"PACMA",3
1,"1010",2315,1705,1688,6,17,"PACMA",3
50,"50267",565,380,375,4,5,"PACMA",1
14,"14031",556,462,456,5,6,"PACMA",1
44,"44080",281,202,199,0,3,"PACMA",0
44,"44169",298,216,216,0,0,"PACMA",0
28,"28007",127491,96937,96102,810,835,"PACMA",881
41,"41028",2108,1652,1632,22,20,"PACMA",26
30,"30039",20442,13299,13167,84,132,"PACMA",122
46,"46002",1253,946,940,4,6,"PACMA",11
24,"24162",1753,1259,1245,12,14,"PACMA",6
17,"17030",654,460,459,1,1,"PACMA",8
45,"45099",3700,2524,2501,9,23,"PACMA",23
28,"28008",2008,1333,1323,7,10,"PACMA",21
47,"47175",6755,4950,4870,49,80,"PACMA",38
19,"19231",10,6,6,0,0,"PACMA",0
10,"10200",336,243,242,0,1,"PACMA",0
15,"15075",12871,8751,8637,129,114,"PACMA",66
22,"22103",664,489,489,4,0,"PACMA",3
41,"41102",14773,10377,10028,174,349,"PACMA",93
20,"20901",1399,960,957,3,3,"PACMA",6
12,"12105",825,602,598,6,4,"PACMA",0
37,"37074",136,93,90,1,3,"PACMA",0
44,"44048",52,47,47,0,0,"PACMA",0
6,"6038",785,561,550,5,11,"PACMA",2
50,"50269",287,172,167,2,5,"PACMA",1
45,"45100",178,141,138,0,3,"PACMA",2
47,"47176",199,110,110,0,0,"PACMA",0
28,"28009",14593,11026,10913,73,113,"PACMA",122
5,"5001",182,139,138,1,1,"PACMA",0
25,"25217",10891,7651,7610,63,41,"PACMA",62
37,"37077",251,206,204,1,2,"PACMA",0
25,"25072",5881,4059,4031,30,28,"PACMA",43
22,"22139",80,57,57,1,0,"PACMA",0
10,"10134",550,361,354,1,7,"PACMA",2
10,"10162",519,401,394,4,7,"PACMA",0
37,"37229",138,103,101,0,2,"PACMA",0
35,"35026",83172,48751,48109,449,642,"PACMA",595
6,"6025",5083,3543,3469,28,74,"PACMA",19
11,"11015",64414,39635,39220,776,415,"PACMA",612
4,"4005",534,422,419,3,3,"PACMA",2
23,"23053",9451,6038,5975,60,63,"PACMA",31
50,"50270",38,26,25,0,1,"PACMA",0
16,"16209",110,95,94,2,1,"PACMA",0
45,"45066",7815,5540,5447,25,93,"PACMA",45
18,"18051",1092,735,718,8,17,"PACMA",0
34,"34096",48,39,38,0,1,"PACMA",1
37,"37364",760,502,500,0,2,"PACMA",1
28,"28083",9836,7278,7206,64,72,"PACMA",79
30,"30042",2218,1645,1625,10,20,"PACMA",7
13,"13066",2621,2029,1998,12,31,"PACMA",10
44,"44173",103,81,79,0,2,"PACMA",0
48,"48036",24015,16501,16425,83,76,"PACMA",94
32,"32051",1369,1062,1058,13,4,"PACMA",3
37,"37271",349,262,258,2,4,"PACMA",0
34,"34098",790,562,558,3,4,"PACMA",5
15,"15078",78810,55693,55183,569,510,"PACMA",394
12,"12027",17506,11776,11649,84,127,"PACMA",126
46,"46005",23129,16610,16437,148,173,"PACMA",187
28,"28012",929,707,698,7,9,"PACMA",6
17,"17119",71,53,52,3,1,"PACMA",0
32,"32052",1817,1278,1268,12,10,"PACMA",3
5,"5108",39,21,21,0,0,"PACMA",0
26,"26127",182,149,149,1,0,"PACMA",0
41,"41033",4958,3299,3250,38,49,"PACMA",18
24,"24058",189,115,114,1,1,"PACMA",0
50,"50045",1217,891,878,10,13,"PACMA",0
44,"44087",67,52,50,0,2,"PACMA",0
37,"37080",221,164,163,1,1,"PACMA",0
50,"50272",13226,9250,9153,97,97,"PACMA",75
28,"28085",4194,3126,3091,24,35,"PACMA",18
9,"9439",1061,801,790,2,11,"PACMA",10
50,"50222",1574,1024,1008,12,16,"PACMA",3
17,"17120",823,560,558,5,2,"PACMA",4
37,"37367",179,147,143,2,4,"PACMA",1
39,"39092",863,534,533,3,1,"PACMA",2
5,"5110",696,469,464,2,5,"PACMA",1
13,"13070",747,575,556,7,19,"PACMA",0
10,"10044",1405,968,955,11,13,"PACMA",4
19,"19235",98,77,76,1,1,"PACMA",0
19,"19299",100,72,71,1,1,"PACMA",0
9,"9390",554,455,450,6,5,"PACMA",0
45,"45093",147,115,114,0,1,"PACMA",1
3,"3065",169894,121210,120342,1045,868,"PACMA",1369
50,"50223",906,702,693,9,9,"PACMA",0
19,"19041",163,118,117,1,1,"PACMA",1
37,"37045",27,19,19,0,0,"PACMA",0
25,"25221",115,82,81,1,1,"PACMA",2
32,"32054",86117,56997,56376,581,621,"PACMA",441
9,"9441",94,76,76,0,0,"PACMA",0
12,"12031",3960,2913,2869,13,44,"PACMA",24
18,"18153",8834,6174,6063,54,111,"PACMA",73
12,"12110",222,156,155,3,1,"PACMA",0
25,"25222",69,58,58,0,0,"PACMA",1
18,"18057",5584,4042,3958,51,84,"PACMA",29
41,"41035",1051,733,722,10,11,"PACMA",2
9,"9117",71,58,58,0,0,"PACMA",0
25,"25038",1478,1057,1048,10,9,"PACMA",3
43,"43906",2113,1490,1480,12,10,"PACMA",12
40,"40184",245,196,194,0,2,"PACMA",0
28,"28015",20885,16237,16104,134,133,"PACMA",186
19,"19238",43,30,28,0,2,"PACMA",0
37,"37369",126,83,81,0,2,"PACMA",0
28,"28901",890,624,618,5,6,"PACMA",10
2,"2066",222,165,163,1,2,"PACMA",0
10,"10210",489,314,313,2,1,"PACMA",0
13,"13074",943,759,749,5,10,"PACMA",1
44,"44178",52,34,34,0,0,"PACMA",0
19,"19147",42,32,32,0,0,"PACMA",0
50,"50048",33,25,25,0,0,"PACMA",0
42,"42006",154,105,103,0,2,"PACMA",1
22,"22111",143,96,95,2,1,"PACMA",0
49,"49114",40,31,27,0,4,"PACMA",1
49,"49027",125,82,81,0,1,"PACMA",0
9,"9280",26,18,18,0,0,"PACMA",0
47,"47088",101,79,79,0,0,"PACMA",0
40,"40087",85,70,70,0,0,"PACMA",0
22,"22046",713,555,549,9,6,"PACMA",1
50,"50227",107,62,62,1,0,"PACMA",0
46,"46214",16637,12113,12014,84,99,"PACMA",196
10,"10171",347,238,219,1,19,"PACMA",1
31,"31222",57,35,34,3,1,"PACMA",0
10,"10090",489,307,302,1,5,"PACMA",0
18,"18061",999,781,770,5,11,"PACMA",0
44,"44092",70,53,52,0,1,"PACMA",0
25,"25040",10651,7041,6987,57,54,"PACMA",43
40,"40088",272,192,192,0,0,"PACMA",3
18,"18158",7978,4861,4771,43,90,"PACMA",29
32,"32058",5247,3547,3489,30,58,"PACMA",22
25,"25102",647,484,482,5,2,"PACMA",2
42,"42135",69,40,40,1,0,"PACMA",0
25,"25011",5271,3529,3505,21,24,"PACMA",29
19,"19044",275,186,182,0,4,"PACMA",0
28,"28018",4121,3174,3151,22,23,"PACMA",19
37,"37086",107,86,85,2,1,"PACMA",0
31,"31223",953,667,654,4,13,"PACMA",7
9,"9123",42,36,36,0,0,"PACMA",0
42,"42139",21,16,16,2,0,"PACMA",0
19,"19241",35,26,25,2,1,"PACMA",0
26,"26175",47,40,38,1,2,"PACMA",0
3,"3069",3329,2102,2077,11,25,"PACMA",22
24,"24174",457,294,289,3,5,"PACMA",1
12,"12113",90,59,59,1,0,"PACMA",0
6,"6053",592,441,428,7,13,"PACMA",4
30,"30024",60389,42200,41831,281,369,"PACMA",221
38,"38041",7025,4729,4684,42,45,"PACMA",51
25,"25042",204,149,149,5,0,"PACMA",0
48,"48015",33077,22441,22295,145,146,"PACMA",154
18,"18063",1232,687,678,9,9,"PACMA",0
42,"42010",21,15,14,0,1,"PACMA",0
15,"15054",31805,19579,19321,335,258,"PACMA",187
27,"27057",11047,7078,6941,64,137,"PACMA",33
41,"41086",16199,10227,10105,137,122,"PACMA",169
2,"2005",554,426,419,8,7,"PACMA",0
10,"10161",81,50,50,0,0,"PACMA",0
45,"45077",546,413,409,0,4,"PACMA",5
48,"48072",965,730,724,3,6,"PACMA",3
17,"17192",143,107,104,0,3,"PACMA",2
49,"49042",229,166,164,2,2,"PACMA",1
18,"18162",919,664,652,3,12,"PACMA",3
45,"45003",554,398,393,2,5,"PACMA",1
50,"50102",815,594,584,7,10,"PACMA",2
16,"16062",25,20,20,0,0,"PACMA",0
46,"46194",15852,11124,11009,86,115,"PACMA",107
22,"22227",200,140,140,2,0,"PACMA",0
12,"12064",80,71,69,0,2,"PACMA",0
10,"10013",265,184,182,0,2,"PACMA",1
31,"31079",65,46,46,2,0,"PACMA",0
29,"29076",2354,1498,1444,21,54,"PACMA",20
9,"9128",76,56,56,0,0,"PACMA",3
33,"33062",385,194,187,4,7,"PACMA",0
15,"15087",5710,3436,3392,31,44,"PACMA",19
49,"49130",155,116,112,1,4,"PACMA",1
22,"22195",238,190,186,0,4,"PACMA",2
19,"19013",111,89,89,0,0,"PACMA",0
40,"40029",25,21,19,0,2,"PACMA",0
5,"5086",76,58,58,1,0,"PACMA",0
40,"40191",198,143,138,0,5,"PACMA",1
34,"34112",39,31,31,0,0,"PACMA",0
1,"1032",498,363,353,1,10,"PACMA",1
28,"28094",988,711,707,5,4,"PACMA",16
26,"26141",98,70,70,0,0,"PACMA",0
49,"49132",310,220,215,2,5,"PACMA",0
31,"31008",61,42,42,0,0,"PACMA",0
34,"34113",40,38,38,0,0,"PACMA",0
22,"22229",107,70,70,2,0,"PACMA",0
4,"4089",687,484,479,2,5,"PACMA",2
43,"43008",305,171,171,7,0,"PACMA",1
4,"4019",236,174,172,0,2,"PACMA",0
1,"1033",654,476,476,0,0,"PACMA",1
42,"42014",57,35,35,0,0,"PACMA",0
44,"44126",314,222,221,0,1,"PACMA",0
49,"49133",287,206,203,1,3,"PACMA",1
49,"49245",251,174,171,1,3,"PACMA",0
50,"50005",228,185,184,2,1,"PACMA",0
47,"47095",41,29,28,0,1,"PACMA",0
12,"12117",3532,2512,2479,12,33,"PACMA",23
17,"17100",193,147,141,0,6,"PACMA",0
24,"24034",3466,2382,2359,25,23,"PACMA",26
33,"33009",878,545,542,4,3,"PACMA",3
29,"29034",461,333,332,2,1,"PACMA",2
28,"28129",8589,6397,6338,46,59,"PACMA",62
22,"22020",115,83,80,3,3,"PACMA",1
21,"21040",3193,2219,2123,32,96,"PACMA",21
49,"49062",103,58,58,0,0,"PACMA",0
9,"9030",116,81,81,1,0,"PACMA",0
46,"46174",942,746,736,1,10,"PACMA",9
33,"33065",1077,670,657,11,13,"PACMA",6
50,"50132",780,549,538,7,11,"PACMA",9
39,"39018",4284,3211,3177,22,34,"PACMA",17
46,"46151",757,560,552,2,8,"PACMA",8
28,"28096",20022,14440,14238,115,202,"PACMA",144
48,"48048",527,381,380,3,1,"PACMA",1
50,"50056",399,296,296,3,0,"PACMA",0
16,"16237",98,82,82,1,0,"PACMA",0
47,"47191",111,81,81,0,0,"PACMA",0
9,"9133",38,33,33,0,0,"PACMA",0
49,"49135",576,368,366,3,2,"PACMA",0
47,"47096",127,94,93,1,1,"PACMA",0
22,"22084",571,400,391,5,9,"PACMA",8
22,"22200",239,165,164,2,1,"PACMA",1
29,"29007",28907,20371,20129,254,242,"PACMA",337
33,"33066",42818,27780,27466,425,314,"PACMA",256
14,"14901",932,753,750,6,3,"PACMA",6
41,"41045",5873,3901,3802,53,99,"PACMA",54
2,"2077",52,41,41,0,0,"PACMA",0
12,"12119",139,97,94,3,3,"PACMA",0
34,"34121",187,150,150,3,0,"PACMA",1
15,"15092",6220,3810,3756,30,54,"PACMA",17
24,"24074",97,70,70,1,0,"PACMA",0
17,"17047",5016,3087,3068,22,19,"PACMA",41
26,"26107",86,65,64,1,1,"PACMA",0
45,"45109",2791,2123,2072,20,51,"PACMA",8
26,"26160",731,539,533,4,6,"PACMA",6
21,"21073",1902,1073,1043,13,30,"PACMA",3
19,"19123",37,30,28,0,2,"PACMA",0
15,"15093",4012,2413,2386,24,27,"PACMA",6
9,"9082",36,32,32,0,0,"PACMA",0
12,"12120",149,125,121,3,4,"PACMA",0
26,"26068",78,61,61,0,0,"PACMA",2
37,"37287",297,204,202,2,2,"PACMA",0
47,"47098",567,452,446,4,6,"PACMA",5
22,"22234",743,498,491,5,7,"PACMA",1
20,"20010",1524,1057,1053,5,4,"PACMA",3
21,"21013",10626,6990,6807,99,183,"PACMA",65
3,"3077",1391,1052,1032,10,20,"PACMA",18
9,"9137",187,129,127,0,2,"PACMA",0
45,"45122",5605,4321,4288,33,33,"PACMA",37
3,"3021",5573,4423,4343,23,80,"PACMA",29
37,"37381",138,98,93,0,5,"PACMA",0
39,"39021",464,370,364,1,6,"PACMA",0
44,"44190",63,45,45,0,0,"PACMA",0
31,"31124",207,134,134,2,0,"PACMA",3
33,"33068",1031,518,510,5,8,"PACMA",0
6,"6067",1897,1268,1242,14,26,"PACMA",6
41,"41047",10449,7884,7770,119,114,"PACMA",79
46,"46154",795,619,608,5,11,"PACMA",13
5,"5126",60,47,45,0,2,"PACMA",0
37,"37100",74,59,58,1,1,"PACMA",0
24,"24185",447,303,295,1,8,"PACMA",0
15,"15902",4507,2885,2837,34,48,"PACMA",18
15,"15002",24040,16302,16117,183,185,"PACMA",152
25,"25050",3256,2260,2249,20,11,"PACMA",9
32,"32072",3664,2387,2355,24,32,"PACMA",15
49,"49030",79,56,56,0,0,"PACMA",1
20,"20012",149,104,104,1,0,"PACMA",0
19,"19055",44,32,31,2,1,"PACMA",0
40,"40005",25,23,23,1,0,"PACMA",0
47,"47101",1634,1278,1262,7,16,"PACMA",4
50,"50060",171,126,125,1,1,"PACMA",2
29,"29011",2893,1763,1736,12,27,"PACMA",10
43,"43119",849,591,588,8,3,"PACMA",9
19,"19251",39,30,30,0,0,"PACMA",0
5,"5901",247,154,152,3,2,"PACMA",1
40,"40179",620,500,490,3,10,"PACMA",2
39,"39042",5910,4354,4315,14,39,"PACMA",21
48,"48054",25063,17705,17597,122,108,"PACMA",120
31,"31237",182,138,135,2,3,"PACMA",1
6,"6100",845,626,624,2,2,"PACMA",1
26,"26177",306,233,229,2,4,"PACMA",1
10,"10108",203,116,116,1,0,"PACMA",0
15,"15004",4924,3333,3292,38,41,"PACMA",20
45,"45015",656,449,438,2,11,"PACMA",0
49,"49255",387,304,298,3,6,"PACMA",0
28,"28106",78872,54111,53443,412,668,"PACMA",791
47,"47102",257,212,210,2,2,"PACMA",0
28,"28030",1832,1319,1297,13,22,"PACMA",13
1,"1046",639,433,432,2,1,"PACMA",1
42,"42024",84,64,62,1,2,"PACMA",0
31,"31238",119,96,95,4,1,"PACMA",2
22,"22239",85,67,65,0,2,"PACMA",0
28,"28031",2129,1501,1486,8,15,"PACMA",6
29,"29086",770,479,476,5,3,"PACMA",3
47,"47103",252,195,192,1,3,"PACMA",0
40,"40007",68,55,55,1,0,"PACMA",0
22,"22242",60,41,40,0,1,"PACMA",1
29,"29087",363,249,243,4,6,"PACMA",2
50,"50113",587,471,461,2,10,"PACMA",3
14,"14026",2000,1294,1253,20,41,"PACMA",6
19,"19127",88,60,60,1,0,"PACMA",0
50,"50189",678,494,487,6,7,"PACMA",1
19,"19163",60,49,49,0,0,"PACMA",1
3,"3082",12941,8399,8304,51,95,"PACMA",91
37,"37001",165,120,120,0,0,"PACMA",0
40,"40106",179,140,139,2,1,"PACMA",0
46,"46157",2959,2145,2126,11,19,"PACMA",9
17,"17221",4138,2999,2988,23,11,"PACMA",41
18,"18076",789,534,532,2,2,"PACMA",2
1,"1049",130,94,94,1,0,"PACMA",1
31,"31203",30,19,19,2,0,"PACMA",0
16,"16041",334,244,243,2,1,"PACMA",0
5,"5065",452,339,337,2,2,"PACMA",0
7,"7033",28539,15238,15070,187,168,"PACMA",181
22,"22029",118,85,83,1,2,"PACMA",0
24,"24191",106,70,69,2,1,"PACMA",0
5,"5131",96,64,64,1,0,"PACMA",0
33,"33073",8096,4377,4320,59,57,"PACMA",6
49,"49035",220,180,180,4,0,"PACMA",0
26,"26039",40,31,31,0,0,"PACMA",0
9,"9482",34,22,22,0,0,"PACMA",0
6,"6075",470,363,360,7,3,"PACMA",2
38,"38004",4536,2914,2887,28,27,"PACMA",41
9,"9315",384,245,242,3,3,"PACMA",1
47,"47200",70,60,60,0,0,"PACMA",0
45,"45020",1240,905,900,5,5,"PACMA",1
46,"46090",1631,1360,1339,6,21,"PACMA",12
43,"43018",384,297,297,2,0,"PACMA",1
39,"39027",3045,2231,2199,23,32,"PACMA",5
10,"10113",2231,1534,1508,14,26,"PACMA",9
21,"21020",349,230,228,2,2,"PACMA",1
35,"35014",11962,5994,5888,60,106,"PACMA",74
27,"27010",4378,2719,2670,49,49,"PACMA",13
41,"41053",21693,15843,15379,171,464,"PACMA",116
41,"41025",2031,1409,1349,11,60,"PACMA",11
3,"3084",501,413,413,1,0,"PACMA",0
15,"15008",5646,3859,3836,52,23,"PACMA",30
5,"5132",857,548,539,7,9,"PACMA",1
49,"49148",259,119,115,1,4,"PACMA",1
5,"5229",75,61,61,1,0,"PACMA",1
29,"29090",1649,1138,1124,10,14,"PACMA",4
10,"10114",964,644,637,6,7,"PACMA",2
37,"37108",98,75,75,3,0,"PACMA",0
12,"12050",1226,904,891,3,13,"PACMA",4
37,"37296",297,215,210,0,5,"PACMA",0
25,"25150",167,132,130,2,2,"PACMA",0
18,"18079",3466,2391,2333,22,58,"PACMA",17
15,"15009",10605,7245,7133,101,112,"PACMA",42
47,"47205",355,248,244,2,4,"PACMA",0
44,"44197",51,35,35,1,0,"PACMA",0
4,"4034",169,91,91,1,0,"PACMA",0
5,"5036",118,91,90,0,1,"PACMA",0
49,"49005",125,80,80,1,0,"PACMA",0
19,"19325",154,86,86,1,0,"PACMA",0
44,"44046",44,33,33,0,0,"PACMA",0
31,"31001",79,56,56,0,0,"PACMA",3
12,"12127",63,45,44,1,1,"PACMA",0
28,"28036",2699,1977,1957,20,20,"PACMA",24
4,"4035",8439,5822,5768,45,54,"PACMA",23
5,"5037",210,135,135,0,0,"PACMA",0
14,"14002",10895,7599,7479,109,120,"PACMA",58
24,"24197",717,500,499,2,1,"PACMA",4
46,"46024",454,343,339,1,4,"PACMA",5
44,"44198",182,138,135,0,3,"PACMA",0
4,"4036",239,178,176,0,2,"PACMA",2
25,"25058",4345,3058,3045,13,13,"PACMA",13
49,"49263",44,32,32,1,0,"PACMA",0
36,"36039",15609,10562,10341,102,221,"PACMA",91
9,"9323",57,37,36,0,1,"PACMA",0
9,"9903",3112,2087,2058,24,29,"PACMA",17
10,"10118",278,232,231,1,1,"PACMA",1
31,"31246",130,89,87,2,2,"PACMA",1
37,"37110",104,81,79,1,2,"PACMA",0
29,"29093",2150,1543,1520,8,23,"PACMA",11
49,"49040",109,89,87,2,2,"PACMA",1
17,"17058",176,128,128,0,0,"PACMA",0
22,"22136",749,524,518,5,6,"PACMA",0
12,"12129",1783,1207,1184,16,23,"PACMA",5
3,"3088",5895,4030,3961,29,69,"PACMA",42
49,"49152",474,289,282,2,7,"PACMA",0
19,"19170",189,115,115,1,0,"PACMA",0
5,"5136",83,55,55,0,0,"PACMA",1
48,"48061",789,602,601,2,1,"PACMA",4
37,"37008",4213,3092,3046,21,46,"PACMA",11
41,"41057",258,174,170,3,4,"PACMA",1
40,"40112",2813,2126,2087,26,39,"PACMA",19
24,"24090",323,200,200,2,0,"PACMA",0
28,"28177",10851,8550,8485,89,65,"PACMA",72
19,"19171",5380,3964,3919,22,45,"PACMA",37
48,"48062",295,236,236,0,0,"PACMA",0
44,"44200",39,26,26,0,0,"PACMA",0
17,"17227",147,104,104,0,0,"PACMA",0
50,"50144",31,24,24,0,0,"PACMA",0
22,"22039",813,635,634,4,1,"PACMA",5
43,"43049",727,557,555,3,2,"PACMA",0
18,"18084",4533,3233,3178,35,55,"PACMA",35
50,"50002",125,91,86,0,5,"PACMA",0
9,"9327",26,20,20,0,0,"PACMA",0
44,"44022",464,330,325,1,5,"PACMA",2
10,"10121",7882,5294,5183,42,111,"PACMA",37
28,"28168",1347,933,918,6,15,"PACMA",7
17,"17138",836,591,584,7,7,"PACMA",15
5,"5041",984,743,732,5,11,"PACMA",2
31,"31139",152,100,100,1,0,"PACMA",1
17,"17062",5982,4025,4001,19,24,"PACMA",56
28,"28041",4805,3666,3634,38,32,"PACMA",44
4,"4041",344,227,222,4,5,"PACMA",1
49,"49154",111,63,59,0,4,"PACMA",0
3,"3090",18095,12539,12412,75,127,"PACMA",147
5,"5139",71,59,58,1,1,"PACMA",0
44,"44201",477,399,395,1,4,"PACMA",0
42,"42036",40,33,32,1,1,"PACMA",0
34,"34004",5517,3819,3769,36,50,"PACMA",26
17,"17228",285,218,217,0,1,"PACMA",2
37,"37302",262,161,161,2,0,"PACMA",0
1,"1059",189597,128849,127910,688,939,"PACMA",929
14,"14007",15016,10248,10043,99,205,"PACMA",82
47,"47210",399,278,275,3,3,"PACMA",1
38,"38011",21655,13974,13831,106,143,"PACMA",228
16,"16014",558,419,417,6,2,"PACMA",1
5,"5042",141,111,111,0,0,"PACMA",0
9,"9167",53,36,36,0,0,"PACMA",0
24,"24205",990,678,667,6,11,"PACMA",0
19,"19073",16,15,15,1,0,"PACMA",0
4,"4044",1542,1092,1080,8,12,"PACMA",8
5,"5141",95,79,78,1,1,"PACMA",0
22,"22251",327,259,256,0,3,"PACMA",1
31,"31141",106,66,61,1,5,"PACMA",0
1,"1061",155,116,116,1,0,"PACMA",1
19,"19174",90,65,64,0,1,"PACMA",0
18,"18184",2193,1542,1511,16,31,"PACMA",10
46,"46233",3766,2688,2650,14,38,"PACMA",48
9,"9332",137,93,91,2,2,"PACMA",0
28,"28118",61,52,50,0,2,"PACMA",0
5,"5043",73,58,58,0,0,"PACMA",0
46,"46165",7349,5460,5412,39,48,"PACMA",76
26,"26051",213,165,165,1,0,"PACMA",1
6,"6089",610,470,463,2,7,"PACMA",0
46,"46029",20448,14673,14556,99,117,"PACMA",128
37,"37117",1572,1103,1092,12,11,"PACMA",13
9,"9169",97,72,70,1,2,"PACMA",0
19,"19175",29,18,17,1,1,"PACMA",0
42,"42001",250,172,172,3,0,"PACMA",0
3,"3093",19702,13903,13728,113,175,"PACMA",172
37,"37305",219,177,175,2,2,"PACMA",1
6,"6045",467,347,346,6,1,"PACMA",3
17,"17150",1444,1177,1163,13,14,"PACMA",9
25,"25037",361,270,269,4,1,"PACMA",1
17,"17121",225,166,163,2,3,"PACMA",0
18,"18185",545,434,424,5,10,"PACMA",6
46,"46075",144,125,122,2,3,"PACMA",0
17,"17233",2347,1853,1840,11,13,"PACMA",22
48,"48067",1133,810,805,0,5,"PACMA",1
28,"28045",35523,26213,25966,212,247,"PACMA",244
46,"46030",810,641,625,7,16,"PACMA",2
46,"46098",2405,1778,1751,7,27,"PACMA",17
10,"10127",4691,3044,2974,34,70,"PACMA",21
9,"9016",85,54,54,0,0,"PACMA",3
42,"42042",53,42,41,1,1,"PACMA",1
12,"12134",135,95,95,1,0,"PACMA",0
44,"44206",100,73,73,3,0,"PACMA",0
25,"25067",702,500,494,8,6,"PACMA",3
31,"31256",95,55,55,1,0,"PACMA",0
9,"9173",123,96,93,2,3,"PACMA",0
45,"45144",736,562,557,1,5,"PACMA",0
17,"17066",27378,16755,16644,122,111,"PACMA",214
24,"24210",524,353,353,1,0,"PACMA",0
42,"42043",3816,2602,2540,23,62,"PACMA",20
9,"9338",225,174,172,3,2,"PACMA",2
28,"28121",209,156,152,1,4,"PACMA",0
45,"45145",2631,1746,1707,12,39,"PACMA",14
40,"40216",785,633,621,9,12,"PACMA",1
24,"24098",1149,753,741,8,12,"PACMA",4
10,"10129",340,234,227,2,7,"PACMA",2
48,"48068",1534,1154,1149,1,5,"PACMA",3
9,"9155",25,23,23,0,0,"PACMA",0
5,"5145",43,28,28,0,0,"PACMA",0
34,"34103",96,79,76,0,3,"PACMA",0
19,"19268",50,37,35,0,2,"PACMA",0
35,"35024",14323,8360,8289,81,71,"PACMA",93
28,"28016",79,55,55,0,0,"PACMA",0
1,"1022",755,532,523,4,9,"PACMA",3
12,"12112",102,79,79,1,0,"PACMA",0
31,"31038",1343,975,963,16,12,"PACMA",3
46,"46009",3144,2473,2449,22,24,"PACMA",26
17,"17902",1294,992,990,9,2,"PACMA",11
50,"50152",1351,942,932,14,10,"PACMA",2
24,"24099",153,111,110,1,1,"PACMA",0
49,"49275",51064,34471,34017,475,454,"PACMA",174
44,"44029",585,454,451,2,3,"PACMA",1
34,"34017",889,676,665,7,11,"PACMA",3
19,"19179",74,64,64,3,0,"PACMA",0
37,"37214",120,70,68,2,2,"PACMA",0
50,"50276",118,91,91,0,0,"PACMA",0
42,"42045",273,175,174,4,1,"PACMA",0
12,"12137",40,28,28,0,0,"PACMA",1
29,"29028",1215,803,779,9,24,"PACMA",3
37,"37018",106,75,75,0,0,"PACMA",0
10,"10132",360,251,243,1,8,"PACMA",0
46,"46169",32403,23890,23698,222,192,"PACMA",277
19,"19181",50,34,34,0,0,"PACMA",0
31,"31040",186,131,129,1,2,"PACMA",1
47,"47123",461,360,358,2,2,"PACMA",1
11,"11023",9386,6363,6248,116,115,"PACMA",49
5,"5148",22,19,19,0,0,"PACMA",0
46,"46238",13117,9172,9088,50,84,"PACMA",107
42,"42184",55,36,33,0,3,"PACMA",0
27,"27025",2731,2047,2006,18,41,"PACMA",9
16,"16100",642,518,514,2,4,"PACMA",1
43,"43031",1447,1085,1072,13,13,"PACMA",6
43,"43057",38,32,32,1,0,"PACMA",0
40,"40091",109,87,85,0,2,"PACMA",3
37,"37019",138,111,109,0,2,"PACMA",0
34,"34019",111,87,86,1,1,"PACMA",0
21,"21005",15754,9502,9340,84,162,"PACMA",90
3,"3070",2115,1399,1376,9,23,"PACMA",16
32,"32049",683,375,372,3,3,"PACMA",0
17,"17183",253,197,197,2,0,"PACMA",2
25,"25903",226,169,169,1,0,"PACMA",2
2,"2004",597,459,455,3,4,"PACMA",1
43,"43006",676,462,462,3,0,"PACMA",7
39,"39070",126,91,89,0,2,"PACMA",2
46,"46034",1826,1345,1335,3,10,"PACMA",17
10,"10135",1240,834,826,3,8,"PACMA",2
46,"46904",812,615,605,2,10,"PACMA",12
10,"10216",1518,1082,1056,11,26,"PACMA",3
24,"24176",302,232,226,0,6,"PACMA",1
47,"47030",935,680,669,5,11,"PACMA",3
18,"18064",366,289,286,0,3,"PACMA",0
46,"46080",979,720,712,2,8,"PACMA",0
37,"37089",60,44,43,0,1,"PACMA",1
42,"42187",58,44,39,1,5,"PACMA",0
19,"19272",66,55,55,2,0,"PACMA",0
15,"15025",986,529,517,6,12,"PACMA",2
40,"40126",67,44,42,0,2,"PACMA",0
49,"49167",180,131,131,2,0,"PACMA",1
10,"10137",394,297,296,3,1,"PACMA",0
34,"34160",133,107,106,0,1,"PACMA",2
5,"5085",31,27,27,0,0,"PACMA",1
46,"46013",17761,13652,13548,144,104,"PACMA",127
24,"24104",243,167,166,0,1,"PACMA",2
40,"40222",161,134,131,1,3,"PACMA",0
46,"46104",1906,1422,1409,5,13,"PACMA",5
44,"44212",41,29,29,0,0,"PACMA",0
16,"16231",45,38,38,0,0,"PACMA",0
46,"46172",5488,3724,3674,26,50,"PACMA",69
38,"38019",13884,7888,7809,49,79,"PACMA",59
30,"30002",9701,6794,6717,27,77,"PACMA",45
40,"40223",235,177,174,1,3,"PACMA",4
9,"9454",41,34,33,1,1,"PACMA",1
36,"36055",13585,9177,8986,115,191,"PACMA",63
39,"39045",352,238,234,0,4,"PACMA",0
44,"44213",68,47,47,0,0,"PACMA",0
34,"34163",46,37,37,0,0,"PACMA",0
24,"24178",60,54,54,1,0,"PACMA",0
10,"10138",527,386,379,2,7,"PACMA",2
16,"16029",104,76,74,0,2,"PACMA",0
17,"17132",1344,1019,1009,12,10,"PACMA",6
9,"9183",42,32,32,0,0,"PACMA",0
14,"14018",3617,2632,2568,31,64,"PACMA",22
43,"43114",370,281,278,1,3,"PACMA",1
40,"40095",453,341,329,2,12,"PACMA",0
46,"46037",1120,891,879,7,12,"PACMA",13
27,"27030",3117,1945,1898,19,47,"PACMA",11
13,"13086",158,122,120,0,2,"PACMA",0
47,"47034",75,58,58,2,0,"PACMA",3
2,"2075",1700,1357,1347,6,10,"PACMA",7
16,"16106",2701,2029,2001,6,28,"PACMA",4
50,"50281",68,52,50,0,2,"PACMA",1
15,"15091",1097,705,686,17,19,"PACMA",3
5,"5155",46,33,31,1,2,"PACMA",0
16,"16278",61,45,45,0,0,"PACMA",0
23,"23905",1828,1320,1302,12,18,"PACMA",10
25,"25907",500,366,364,5,2,"PACMA",4
14,"14019",6380,4933,4831,71,102,"PACMA",22
40,"40130",127,95,87,1,8,"PACMA",0
22,"22908",190,135,134,0,1,"PACMA",0
6,"6107",1555,980,969,8,11,"PACMA",5
9,"9190",86,58,54,2,4,"PACMA",0
42,"42055",158,113,113,1,0,"PACMA",0
25,"25908",217,136,136,0,0,"PACMA",1
30,"30004",1129,838,833,1,5,"PACMA",9
37,"37379",169,133,132,0,1,"PACMA",0
31,"31231",104,65,65,1,0,"PACMA",0
16,"16147",54,34,33,0,1,"PACMA",2
31,"31048",166,121,119,1,2,"PACMA",4
19,"19188",36,31,31,0,0,"PACMA",0
28,"28056",946,664,660,2,4,"PACMA",6
7,"7058",2866,2013,1996,24,17,"PACMA",26
5,"5252",56,46,45,0,1,"PACMA",0
43,"43142",1069,783,774,3,9,"PACMA",7
50,"50007",51,34,34,1,0,"PACMA",0
22,"22909",307,219,217,0,2,"PACMA",1
18,"18905",15688,10406,10200,122,206,"PACMA",149
50,"50160",2140,1421,1394,14,27,"PACMA",5
11,"11020",166773,111205,109956,1580,1249,"PACMA",1431
42,"42100",30,24,24,1,0,"PACMA",0
27,"27002",1535,990,968,13,22,"PACMA",7
9,"9136",169,129,125,2,4,"PACMA",1
16,"16033",1633,1199,1174,8,25,"PACMA",13
47,"47036",204,159,156,1,3,"PACMA",1
24,"24003",603,374,372,0,2,"PACMA",1
42,"42195",86,51,51,2,0,"PACMA",0
50,"50235",2421,1721,1702,18,19,"PACMA",14
22,"22055",305,242,235,2,7,"PACMA",1
43,"43064",2027,1456,1445,19,11,"PACMA",9
40,"40229",26,22,22,0,0,"PACMA",0
3,"3106",559,469,465,3,4,"PACMA",4
18,"18010",527,398,394,5,4,"PACMA",0
6,"6111",487,318,314,2,4,"PACMA",0
10,"10144",915,618,614,0,4,"PACMA",1
9,"9464",33,24,24,0,0,"PACMA",1
18,"18103",714,500,498,3,2,"PACMA",0
38,"38024",15316,9131,9005,60,126,"PACMA",102
12,"12902",2250,1557,1532,16,25,"PACMA",15
23,"23002",17427,12837,12542,126,295,"PACMA",104
16,"16150",98,66,66,2,0,"PACMA",0
17,"17078",335,245,245,0,0,"PACMA",0
47,"47227",53,36,35,0,1,"PACMA",0
37,"37028",131,96,93,2,3,"PACMA",0
50,"50083",81,64,64,2,0,"PACMA",0
10,"10146",1494,924,903,1,21,"PACMA",5
27,"27035",183,110,110,3,0,"PACMA",0
13,"13002",1415,966,950,3,16,"PACMA",1
38,"38025",7065,4657,4590,34,67,"PACMA",41
9,"9361",103,64,64,1,0,"PACMA",0
5,"5257",132,98,95,4,3,"PACMA",1
7,"7062",7972,3946,3896,42,50,"PACMA",51
6,"6114",127,105,105,0,0,"PACMA",0
40,"40036",496,395,380,8,15,"PACMA",0
50,"50084",67,47,47,1,0,"PACMA",1
29,"29038",18908,12122,11931,197,191,"PACMA",181
12,"12072",1083,852,827,10,25,"PACMA",6
46,"46041",313,229,228,1,1,"PACMA",1
16,"16904",453,348,345,11,3,"PACMA",6
31,"31236",1319,815,808,8,7,"PACMA",9
42,"42198",19,9,9,1,0,"PACMA",0
13,"13049",742,509,500,4,9,"PACMA",1
19,"19162",67,41,41,0,0,"PACMA",0
21,"21016",985,703,680,5,23,"PACMA",3
5,"5027",258,209,203,5,6,"PACMA",1
50,"50298",5439,4053,4007,41,46,"PACMA",15
5,"5258",107,80,80,1,0,"PACMA",1
2,"2015",1432,1163,1148,8,15,"PACMA",2
33,"33014",8735,5744,5689,67,55,"PACMA",37
44,"44041",60,48,48,0,0,"PACMA",0
19,"19192",1762,1251,1240,5,11,"PACMA",3
49,"49177",255,145,144,1,1,"PACMA",0
3,"3110",312,258,258,0,0,"PACMA",1
47,"47230",285,209,206,1,3,"PACMA",0
38,"38026",33585,24091,23889,170,202,"PACMA",235
24,"24227",1527,1036,1032,13,4,"PACMA",8
40,"40138",2102,1585,1565,13,20,"PACMA",4
18,"18013",4154,2892,2812,28,80,"PACMA",12
7,"7064",5566,3232,3204,18,28,"PACMA",44
34,"34177",178,149,149,1,0,"PACMA",0
45,"45054",3798,2612,2587,10,25,"PACMA",7
20,"20045",47031,30933,30787,172,146,"PACMA",259
19,"19097",14,14,13,0,1,"PACMA",0
2,"2083",209,181,181,0,0,"PACMA",0
14,"14054",13775,10464,10165,105,299,"PACMA",45
7,"7032",21005,12039,11928,114,111,"PACMA",127
33,"33072",1443,816,814,8,2,"PACMA",0
43,"43147",528,425,420,3,5,"PACMA",5
47,"47042",51,39,39,0,0,"PACMA",0
24,"24116",387,227,226,3,1,"PACMA",0
17,"17081",252,186,185,2,1,"PACMA",1
24,"24117",410,302,301,1,1,"PACMA",0
7,"7901",598,410,402,6,8,"PACMA",2
26,"26001",199,145,141,3,4,"PACMA",0
10,"10069",786,566,554,3,12,"PACMA",1
22,"22130",10146,6505,6436,57,69,"PACMA",37
9,"9422",19,13,13,0,0,"PACMA",0
14,"14055",18411,13054,12798,192,256,"PACMA",83
47,"47232",96,67,65,0,2,"PACMA",0
21,"21049",3262,2028,1977,15,51,"PACMA",15
28,"28063",252,188,187,1,1,"PACMA",7
37,"37232",377,303,303,2,0,"PACMA",0
2,"2019",2352,1806,1766,9,40,"PACMA",4
14,"14027",7890,5841,5726,78,115,"PACMA",44
48,"48084",21780,14368,14271,79,97,"PACMA",120
6,"6120",3370,2507,2460,11,47,"PACMA",16
39,"39055",1065,747,736,4,11,"PACMA",1
11,"11038",13632,10047,9812,99,235,"PACMA",96
10,"10031",162,128,124,0,4,"PACMA",1
40,"40902",113,78,76,1,2,"PACMA",0
37,"37137",98,60,59,2,1,"PACMA",0
43,"43149",690,512,509,3,3,"PACMA",1
48,"48001",5899,4094,4074,19,20,"PACMA",26
5,"5165",361,266,261,4,5,"PACMA",0
22,"22062",154,107,107,1,0,"PACMA",2
37,"37034",77,63,62,0,1,"PACMA",0
22,"22173",219,147,141,3,6,"PACMA",0
5,"5262",318,238,235,1,3,"PACMA",0
16,"16157",183,150,148,0,2,"PACMA",0
40,"40108",109,85,85,2,0,"PACMA",0
18,"18111",2863,2038,2001,29,37,"PACMA",17
15,"15040",2647,1779,1762,15,17,"PACMA",6
24,"24902",331,239,239,0,0,"PACMA",1
48,"48086",2024,1371,1358,5,13,"PACMA",10
42,"42206",8,5,5,2,0,"PACMA",0
17,"17084",228,163,162,1,1,"PACMA",1
19,"19102",88,75,73,0,2,"PACMA",1
27,"27042",1639,1120,1107,8,13,"PACMA",3
9,"9048",1373,937,911,10,26,"PACMA",3
18,"18112",104,68,66,2,2,"PACMA",0
33,"33019",2844,1702,1680,11,22,"PACMA",6
19,"19197",28,22,22,1,0,"PACMA",0
16,"16158",513,371,366,5,5,"PACMA",2
46,"46046",901,623,609,2,14,"PACMA",5
10,"10156",97,71,69,0,2,"PACMA",0
12,"12077",4828,3395,3357,28,38,"PACMA",26
5,"5167",223,177,172,0,5,"PACMA",0
30,"30013",7421,5171,5094,32,77,"PACMA",19
3,"3029",236,174,172,2,2,"PACMA",1
9,"9902",439,334,326,10,8,"PACMA",4
40,"40143",82,68,67,2,1,"PACMA",0
37,"37140",630,395,393,0,2,"PACMA",0
42,"42071",159,92,92,2,0,"PACMA",0
41,"41083",1145,821,814,6,7,"PACMA",4
31,"31062",1070,778,770,10,8,"PACMA",3
13,"13014",472,361,352,4,9,"PACMA",0
50,"50243",307,227,224,2,3,"PACMA",0
33,"33021",4304,2643,2610,32,33,"PACMA",8
49,"49080",622,440,437,4,3,"PACMA",2
28,"28145",2671,1927,1895,21,32,"PACMA",17
44,"44047",225,103,103,0,0,"PACMA",1
3,"3030",559,442,433,2,9,"PACMA",3
42,"42166",55,38,37,0,1,"PACMA",0
6,"6126",2121,1443,1429,14,14,"PACMA",2
42,"42073",73,56,55,0,1,"PACMA",0
37,"37236",123,85,82,1,3,"PACMA",0
13,"13015",5220,3665,3629,25,36,"PACMA",6
16,"16046",213,142,142,0,0,"PACMA",0
10,"10036",304,194,192,4,2,"PACMA",1
5,"5070",30,29,29,0,0,"PACMA",0
43,"43152",435,348,342,2,6,"PACMA",0
44,"44227",72,58,58,0,0,"PACMA",0
24,"24017",532,375,374,1,1,"PACMA",0
27,"27046",1444,945,921,7,24,"PACMA",3
6,"6128",4457,2996,2934,28,62,"PACMA",6
46,"46048",3504,2609,2576,17,33,"PACMA",18
28,"28069",58,44,42,1,2,"PACMA",0
19,"19106",77,57,57,0,0,"PACMA",0
26,"26122",115,81,80,4,1,"PACMA",1
19,"19200",66,53,52,0,1,"PACMA",0
37,"37038",756,531,517,4,14,"PACMA",2
47,"47208",53,35,35,1,0,"PACMA",0
34,"34049",329,229,227,1,2,"PACMA",1
13,"13018",774,625,622,0,3,"PACMA",1
24,"24018",172,129,128,0,1,"PACMA",0
49,"49082",341,273,270,12,3,"PACMA",0
39,"39060",6704,4959,4887,23,72,"PACMA",17
3,"3032",97,82,82,0,0,"PACMA",0
24,"24125",416,233,231,3,2,"PACMA",0
20,"20053",4856,3169,3153,15,16,"PACMA",15
27,"27047",1517,955,940,12,15,"PACMA",9
15,"15044",1194,806,788,7,18,"PACMA",1
46,"46049",268,221,217,2,4,"PACMA",1
17,"17088",599,467,465,3,2,"PACMA",3
25,"25185",680,452,451,0,1,"PACMA",2
42,"42035",730,464,460,3,4,"PACMA",2
37,"37144",327,233,233,2,0,"PACMA",1
37,"37175",412,298,293,4,5,"PACMA",1
18,"18150",6964,4717,4622,51,95,"PACMA",39
14,"14062",945,700,693,2,7,"PACMA",1
21,"21057",995,600,590,8,10,"PACMA",2
40,"40148",231,165,163,4,2,"PACMA",0
32,"32013",1985,1242,1230,16,12,"PACMA",6
47,"47051",324,261,258,6,3,"PACMA",5
4,"4076",1209,873,850,7,23,"PACMA",3
9,"9386",55,43,43,0,0,"PACMA",0
12,"12081",606,454,446,2,8,"PACMA",2
31,"31067",1887,1265,1249,6,16,"PACMA",4
19,"19202",16,13,13,1,0,"PACMA",0
28,"28071",63,46,45,0,1,"PACMA",0
49,"49190",50,42,42,3,0,"PACMA",0
28,"28072",6176,4716,4673,44,43,"PACMA",52
23,"23018",2243,1606,1584,17,22,"PACMA",3
46,"46187",1292,924,920,4,4,"PACMA",8
31,"31068",2816,2028,1989,20,39,"PACMA",10
6,"6133",1795,1308,1294,11,14,"PACMA",2
24,"24021",1595,1037,1025,7,12,"PACMA",6
5,"5173",60,54,54,0,0,"PACMA",0
37,"37146",106,82,76,0,6,"PACMA",0
37,"37042",36,27,27,1,0,"PACMA",0
40,"40051",34,25,25,0,0,"PACMA",0
31,"31069",823,596,595,1,1,"PACMA",3
42,"42081",126,88,88,0,0,"PACMA",0
18,"18120",266,204,204,4,0,"PACMA",2
45,"45177",1998,1557,1525,10,32,"PACMA",2
45,"45068",179,129,127,0,2,"PACMA",2
44,"44231",35,30,30,0,0,"PACMA",0
12,"12002",114,96,94,1,2,"PACMA",0
12,"12083",88,69,67,9,2,"PACMA",0
50,"50095",12149,8322,8239,91,83,"PACMA",36
44,"44117",327,258,258,0,0,"PACMA",0
50,"50021",25,21,21,0,0,"PACMA",0
39,"39064",1352,1007,990,3,17,"PACMA",6
10,"10043",746,525,520,4,5,"PACMA",0
13,"13024",875,587,577,7,10,"PACMA",2
5,"5174",62,51,51,1,0,"PACMA",0
30,"30019",25911,17485,17264,157,221,"PACMA",132
16,"16052",539,422,419,3,3,"PACMA",1
42,"42219",40,34,34,1,0,"PACMA",0
42,"42083",26,20,20,0,0,"PACMA",0
37,"37044",431,309,308,3,1,"PACMA",1
49,"49270",139,93,92,0,1,"PACMA",0
11,"11018",1434,1001,977,8,24,"PACMA",7
9,"9224",147,113,112,0,1,"PACMA",0
1,"1063",1852,1316,1303,6,13,"PACMA",8
28,"28075",6020,4521,4469,37,52,"PACMA",60
13,"13026",413,333,331,2,2,"PACMA",0
22,"22075",116,71,69,1,2,"PACMA",1
40,"40053",79,56,56,1,0,"PACMA",1
43,"43001",708,510,507,0,3,"PACMA",2
24,"24024",636,407,403,6,4,"PACMA",1
39,"39065",222,166,163,0,3,"PACMA",0
17,"17178",1065,774,771,9,3,"PACMA",7
28,"28152",16986,13444,13366,111,78,"PACMA",111
19,"19005",91,63,62,0,1,"PACMA",0
37,"37244",129,97,97,1,0,"PACMA",1
43,"43159",76,60,60,0,0,"PACMA",0
17,"17093",913,637,634,5,3,"PACMA",4
44,"44054",95,82,81,0,1,"PACMA",0
40,"40054",108,79,78,3,1,"PACMA",0
12,"12085",5081,3271,3235,17,36,"PACMA",29
36,"36017",17364,11771,11598,123,173,"PACMA",65
48,"48012",2057,1610,1600,1,10,"PACMA",4
9,"9064",305,225,219,6,6,"PACMA",0
5,"5080",42,30,30,0,0,"PACMA",0
47,"47152",67,59,59,0,0,"PACMA",0
19,"19112",53,35,34,0,1,"PACMA",0
14,"14039",2577,1858,1801,29,57,"PACMA",17
24,"24025",283,190,185,3,5,"PACMA",0
46,"46122",2726,1957,1934,13,23,"PACMA",19
28,"28153",816,547,544,3,3,"PACMA",6
49,"49091",246,168,167,1,1,"PACMA",0
50,"50275",111,50,50,0,0,"PACMA",0
48,"48013",79353,53591,53205,331,386,"PACMA",419
28,"28122",578,404,401,1,3,"PACMA",10
48,"48069",13131,9211,9162,55,49,"PACMA",34
27,"27023",2453,1674,1644,25,30,"PACMA",7
37,"37151",142,109,109,1,0,"PACMA",0
47,"47216",111,94,91,0,3,"PACMA",0
47,"47057",272,200,199,0,1,"PACMA",1
9,"9228",155,129,129,0,0,"PACMA",0
38,"38040",5482,3094,3060,14,34,"PACMA",11
42,"42087",51,45,42,1,3,"PACMA",0
44,"44056",446,327,325,1,2,"PACMA",0
5,"5178",340,261,255,3,6,"PACMA",0
6,"6005",1694,1167,1139,9,28,"PACMA",6
3,"3127",350,260,255,1,5,"PACMA",0
37,"37121",536,413,403,4,10,"PACMA",3
4,"4084",337,238,232,0,6,"PACMA",1
24,"24137",1043,700,691,8,9,"PACMA",1
25,"25101",536,412,411,5,1,"PACMA",1
14,"14041",3113,2234,2160,43,74,"PACMA",3
42,"42088",62,45,44,0,1,"PACMA",0
5,"5179",199,176,172,1,4,"PACMA",0
10,"10050",987,707,704,4,3,"PACMA",2
6,"6006",4479,2991,2934,27,57,"PACMA",15
28,"28156",1082,788,784,3,4,"PACMA",10
44,"44237",367,267,262,0,5,"PACMA",1
9,"9068",23,16,16,0,0,"PACMA",1
37,"37051",79,58,58,0,0,"PACMA",1
47,"47155",3454,2445,2405,26,40,"PACMA",29
25,"25194",410,292,289,3,3,"PACMA",0
31,"31186",283,183,182,1,1,"PACMA",2
42,"42089",57,44,43,0,1,"PACMA",0
45,"45075",120,77,74,0,3,"PACMA",0
20,"20063",8023,5611,5597,19,14,"PACMA",14
4,"4085",360,291,289,0,2,"PACMA",1
16,"16061",939,746,727,16,19,"PACMA",5
37,"37343",66,44,43,1,1,"PACMA",1
50,"50179",255,197,197,0,0,"PACMA",0
26,"26099",1220,956,931,7,25,"PACMA",0
16,"16140",18,14,14,1,0,"PACMA",0
28,"28158",694,501,495,2,6,"PACMA",2
5,"5181",46,34,34,0,0,"PACMA",0
44,"44032",17,13,13,0,0,"PACMA",0
31,"31042",2707,1926,1900,11,26,"PACMA",8
17,"17210",572,414,411,2,3,"PACMA",3
25,"25103",133,88,87,0,1,"PACMA",0
19,"19214",74,51,51,0,0,"PACMA",0
3,"3100",499,384,378,0,6,"PACMA",4
37,"37124",195,137,137,2,0,"PACMA",0
12,"12139",299,202,200,3,2,"PACMA",1
44,"44153",1733,1131,1125,0,6,"PACMA",2
27,"27027",1791,1198,1167,17,31,"PACMA",7
47,"47220",151,106,105,1,1,"PACMA",0
10,"10136",274,205,202,1,3,"PACMA",3
9,"9072",331,261,260,4,1,"PACMA",5
4,"4087",157,115,113,0,2,"PACMA",0
39,"39071",410,251,250,1,1,"PACMA",0
33,"33034",9979,5937,5873,64,64,"PACMA",35
43,"43085",237,190,185,1,5,"PACMA",0
26,"26024",204,157,156,1,1,"PACMA",0
42,"42093",36,28,28,1,0,"PACMA",0
47,"47127",138,89,88,2,1,"PACMA",0
24,"24216",666,453,445,4,8,"PACMA",0
17,"17098",308,232,230,4,2,"PACMA",0
46,"46058",1734,1245,1230,8,15,"PACMA",5
37,"37054",233,190,186,2,4,"PACMA",1
24,"24143",497,344,343,3,1,"PACMA",0
43,"43139",2007,1432,1419,9,13,"PACMA",9
30,"30026",16345,10049,9914,84,135,"PACMA",75
12,"12010",232,191,187,3,4,"PACMA",0
43,"43086",5252,3811,3790,28,21,"PACMA",30
12,"12092",123,95,95,0,0,"PACMA",0
9,"9238",931,473,461,1,12,"PACMA",2
50,"50104",320,251,251,1,0,"PACMA",4
45,"45190",462,361,353,3,8,"PACMA",1
48,"48018",854,563,560,5,3,"PACMA",2
50,"50105",277,203,198,4,5,"PACMA",1
2,"2007",1017,757,746,5,11,"PACMA",5
40,"40061",63,47,44,0,3,"PACMA",0
34,"34217",1269,999,983,14,16,"PACMA",8
37,"37127",205,139,139,1,0,"PACMA",0
37,"37056",39,28,28,0,0,"PACMA",0
31,"31192",160,125,123,0,2,"PACMA",0
34,"34218",437,313,309,3,4,"PACMA",0
10,"10057",126,90,89,1,1,"PACMA",1
46,"46196",134,111,110,0,1,"PACMA",0
9,"9353",74,56,54,1,2,"PACMA",0
33,"33036",11281,7240,7153,96,87,"PACMA",34
23,"23069",5240,4153,4065,26,88,"PACMA",21
22,"22160",207,149,149,1,0,"PACMA",0
18,"18903",852,544,537,9,7,"PACMA",1
47,"47223",148,105,102,4,3,"PACMA",0
34,"34165",57,45,44,1,1,"PACMA",0
44,"44243",25,19,19,0,0,"PACMA",0
21,"21071",206,148,144,4,4,"PACMA",1
46,"46197",1930,1430,1411,11,19,"PACMA",22
14,"14047",1644,1198,1183,14,15,"PACMA",5
34,"34071",158,128,128,2,0,"PACMA",0
46,"46060",9278,6796,6724,49,72,"PACMA",88
31,"31084",1946,1367,1362,9,5,"PACMA",0
39,"39074",7050,5074,5029,26,45,"PACMA",20
48,"48907",343,274,273,0,1,"PACMA",1
9,"9301",658,497,488,5,9,"PACMA",2
30,"30028",6390,4054,3973,25,81,"PACMA",27
42,"42097",14,9,9,1,0,"PACMA",0
6,"6153",20252,14183,13924,154,259,"PACMA",96
17,"17019",1780,1403,1393,5,10,"PACMA",6
47,"47065",820,608,602,2,6,"PACMA",2
43,"43167",391,307,307,2,0,"PACMA",3
21,"21072",10233,7374,7183,116,191,"PACMA",50
24,"24148",1602,1152,1140,11,12,"PACMA",11
44,"44157",61,37,37,0,0,"PACMA",0
48,"48021",1325,891,888,3,3,"PACMA",2
5,"5187",1714,1247,1221,9,26,"PACMA",8
24,"24149",149,123,123,0,0,"PACMA",0
2,"2044",1040,665,656,5,9,"PACMA",1
10,"10143",141,109,105,0,4,"PACMA",1
25,"25909",138,99,98,2,1,"PACMA",0
46,"46107",1857,1421,1402,4,19,"PACMA",16
27,"27033",591,334,328,0,6,"PACMA",2
44,"44066",85,62,62,0,0,"PACMA",0
49,"49210",447,350,348,3,2,"PACMA",1
31,"31196",31,23,23,0,0,"PACMA",0
10,"10184",734,520,511,4,9,"PACMA",1
5,"5092",145,111,107,1,4,"PACMA",0
42,"42103",543,383,374,2,9,"PACMA",0
44,"44245",240,177,174,0,3,"PACMA",0
26,"26031",95,83,83,0,0,"PACMA",3
29,"29065",191,145,143,3,2,"PACMA",0
20,"20071",15062,10442,10407,47,35,"PACMA",30
47,"47067",153,112,112,3,0,"PACMA",0
17,"17021",119,89,87,0,2,"PACMA",0
43,"43012",3700,2882,2858,20,24,"PACMA",40
50,"50161",98,75,74,2,1,"PACMA",1
41,"41019",4931,3323,3251,39,72,"PACMA",31
34,"34224",39,25,25,0,0,"PACMA",0
10,"10063",159,130,130,0,0,"PACMA",0
44,"44246",1599,1012,1001,11,11,"PACMA",6
13,"13046",686,524,521,6,3,"PACMA",1
42,"42105",47,40,40,2,0,"PACMA",0
37,"37257",51,36,36,1,0,"PACMA",0
25,"25113",1114,873,863,3,10,"PACMA",5
5,"5093",362,251,249,0,2,"PACMA",4
15,"15064",2103,1458,1447,20,11,"PACMA",14
40,"40165",73,53,52,0,1,"PACMA",0
34,"34077",395,282,278,7,4,"PACMA",3
13,"13047",5782,4232,4160,27,72,"PACMA",23
10,"10187",431,288,281,0,7,"PACMA",2
19,"19221",31,22,22,1,0,"PACMA",0
43,"43092",7308,4703,4679,33,24,"PACMA",67
40,"40070",143,94,92,1,2,"PACMA",0
21,"21076",2153,1459,1426,31,33,"PACMA",6
32,"32036",1242,856,838,14,18,"PACMA",2
13,"13048",495,392,391,4,1,"PACMA",1
49,"49105",135,94,94,2,0,"PACMA",0
34,"34079",1729,1296,1275,19,21,"PACMA",10
47,"47166",251,183,181,2,2,"PACMA",0
24,"24153",228,171,171,3,0,"PACMA",2
45,"45199",3188,2077,2055,20,22,"PACMA",34
50,"50110",340,248,238,1,10,"PACMA",0
48,"48081",1903,1455,1447,7,8,"PACMA",6
48,"48082",37358,25328,25167,125,161,"PACMA",146
37,"37030",82,60,60,0,0,"PACMA",0
26,"26111",250,191,187,3,4,"PACMA",4
3,"3139",23126,14650,14522,127,128,"PACMA",179
31,"31200",745,489,483,1,6,"PACMA",1
15,"15066",3995,2746,2695,29,51,"PACMA",5
9,"9418",73,54,51,0,3,"PACMA",0
16,"16193",55,50,49,0,1,"PACMA",0
4,"4098",1424,890,885,0,5,"PACMA",8
2,"2049",778,506,496,1,10,"PACMA",1
40,"40168",27,20,20,0,0,"PACMA",0
23,"23042",292,219,219,0,0,"PACMA",1
33,"33043",656,408,401,2,7,"PACMA",0
42,"42110",54,43,43,0,0,"PACMA",0
9,"9090",49,41,39,2,2,"PACMA",0
3,"3140",26036,18637,18267,237,370,"PACMA",215
13,"13051",336,253,249,1,4,"PACMA",0
31,"31092",683,413,413,6,0,"PACMA",0
43,"43015",115,92,91,1,1,"PACMA",0
40,"40170",1302,962,948,6,14,"PACMA",2
10,"10191",511,374,365,5,9,"PACMA",2
5,"5030",40,32,32,0,0,"PACMA",2
37,"37032",553,388,388,2,0,"PACMA",4
38,"38027",5581,3577,3533,22,44,"PACMA",28
20,"20075",4312,2848,2845,8,3,"PACMA",5
9,"9255",83,58,58,0,0,"PACMA",1
37,"37355",159,121,120,1,1,"PACMA",0
18,"18143",945,661,651,2,10,"PACMA",6
12,"12018",279,233,231,3,2,"PACMA",0
48,"48027",22745,16240,16158,74,82,"PACMA",53
45,"45202",3963,2806,2771,10,35,"PACMA",16
28,"28002",3250,2261,2243,14,18,"PACMA",19
26,"26038",76,52,52,0,0,"PACMA",0
24,"24190",146,103,103,2,0,"PACMA",0
46,"46089",2182,1590,1576,9,14,"PACMA",18
34,"34083",1647,1089,1080,2,9,"PACMA",8
43,"43017",112,94,94,1,0,"PACMA",1
9,"9256",330,221,219,0,2,"PACMA",1
44,"44251",239,187,183,1,4,"PACMA",0
10,"10192",777,567,563,3,4,"PACMA",0
32,"32041",752,462,458,4,4,"PACMA",2
5,"5195",199,125,125,1,0,"PACMA",0
42,"42115",89,68,66,0,2,"PACMA",0
17,"17111",984,728,728,7,0,"PACMA",6
49,"49111",119,84,84,3,0,"PACMA",1
16,"16197",67,44,43,0,1,"PACMA",0
45,"45203",2777,1986,1961,18,25,"PACMA",25
45,"45204",630,453,449,1,4,"PACMA",5
4,"4101",4356,2818,2768,32,50,"PACMA",22
34,"34084",158,125,125,1,0,"PACMA",0
37,"37069",981,669,657,3,12,"PACMA",4
4,"4102",14202,9264,9139,57,125,"PACMA",64
9,"9095",103,54,53,3,1,"PACMA",1
26,"26157",283,222,217,0,5,"PACMA",0
18,"18145",10909,7925,7780,67,145,"PACMA",75
39,"39084",868,608,605,3,3,"PACMA",2
25,"25029",1590,1190,1185,4,5,"PACMA",3
44,"44256",36,30,30,2,0,"PACMA",0
37,"37264",56,39,39,0,0,"PACMA",0
3,"3056",8588,6219,6135,29,84,"PACMA",53
19,"19323",36,26,26,0,0,"PACMA",0
24,"24049",1417,983,975,14,8,"PACMA",8
16,"16083",44,24,24,0,0,"PACMA",0
44,"44167",34,26,26,0,0,"PACMA",0
34,"34087",125,99,99,2,0,"PACMA",0
17,"17028",297,216,214,2,2,"PACMA",1
16,"16084",48,34,30,1,4,"PACMA",0
33,"33047",1068,771,759,9,12,"PACMA",4
9,"9427",1363,854,842,7,12,"PACMA",8
13,"13058",4026,2822,2766,29,56,"PACMA",13
19,"19324",164,122,120,4,2,"PACMA",0
16,"16250",67,52,52,1,0,"PACMA",0
42,"42164",1580,1043,1029,8,14,"PACMA",2
30,"30037",19407,13252,13120,99,132,"PACMA",145
19,"19228",27,17,17,1,0,"PACMA",0
19,"19032",145,94,93,2,1,"PACMA",0
3,"3085",271,229,227,5,2,"PACMA",1
3,"3057",174,138,136,0,2,"PACMA",1
16,"16085",131,106,106,0,0,"PACMA",1
5,"5198",70,53,51,0,2,"PACMA",0
10,"10197",106,74,74,0,0,"PACMA",0
50,"50117",123,93,93,4,0,"PACMA",0
23,"23049",1740,1215,1183,12,32,"PACMA",10
22,"22003",135,107,107,0,0,"PACMA",4
25,"25215",339,249,249,5,0,"PACMA",4
47,"47078",157,114,107,0,7,"PACMA",0
2,"2056",1640,1204,1179,11,25,"PACMA",6
30,"30038",15752,10987,10904,39,83,"PACMA",99
39,"39002",3408,2360,2323,7,37,"PACMA",6
26,"26044",51,38,36,0,2,"PACMA",1
37,"37072",144,121,118,5,3,"PACMA",0
16,"16086",872,699,690,7,9,"PACMA",0
13,"13061",5616,3679,3634,51,45,"PACMA",26
23,"23050",90664,65260,64519,581,741,"PACMA",720
9,"9430",25,21,21,0,0,"PACMA",0
25,"25124",160,102,101,1,1,"PACMA",2
31,"31100",256,166,165,0,1,"PACMA",2
50,"50041",16,10,10,0,0,"PACMA",0
43,"43021",349,245,243,2,2,"PACMA",2
42,"42120",131,87,86,1,1,"PACMA",0
4,"4003",17583,11062,10941,77,121,"PACMA",81
28,"28079",2384271,1765443,1753633,13854,11810,"PACMA",13386
18,"18148",787,618,605,5,13,"PACMA",2
36,"36040",2505,1597,1563,15,34,"PACMA",3
7,"7006",5393,3257,3220,34,37,"PACMA",28
9,"9267",117,95,93,1,2,"PACMA",0
46,"46071",471,355,349,1,6,"PACMA",1
32,"32048",846,460,458,1,2,"PACMA",0
28,"28080",49866,39769,39583,346,186,"PACMA",273
10,"10079",848,641,632,2,9,"PACMA",1
42,"42121",54,39,39,0,0,"PACMA",0
26,"26164",50,36,35,0,1,"PACMA",0
4,"4004",405,282,272,2,10,"PACMA",2
13,"13063",3648,2464,2406,28,58,"PACMA",8
26,"26046",1552,1056,1027,11,29,"PACMA",4
15,"15076",2490,1539,1517,25,22,"PACMA",9
25,"25033",1120,838,831,5,7,"PACMA",2
19,"19036",242,202,200,1,2,"PACMA",0
48,"48034",12623,8789,8711,76,78,"PACMA",41
49,"49008",423,263,259,1,4,"PACMA",0
49,"49231",288,208,203,0,5,"PACMA",0
18,"18117",497,360,354,1,6,"PACMA",1
34,"34003",147,104,103,0,1,"PACMA",0
26,"26165",336,248,242,3,6,"PACMA",1
34,"34140",93,57,57,1,0,"PACMA",0
31,"31030",135,94,94,0,0,"PACMA",0
16,"16255",132,99,99,0,0,"PACMA",0
37,"37078",781,626,603,9,23,"PACMA",1
17,"17118",12934,8723,8665,38,58,"PACMA",106
47,"47177",104,78,78,0,0,"PACMA",0
10,"10082",1793,1333,1305,11,28,"PACMA",8
3,"3062",228,173,172,3,1,"PACMA",2
50,"50196",101,73,73,0,0,"PACMA",1
19,"19233",79,65,65,2,0,"PACMA",4
49,"49119",217,158,156,2,2,"PACMA",0
19,"19330",69,62,62,0,0,"PACMA",0
46,"46141",433,340,337,6,3,"PACMA",7
47,"47082",805,641,630,3,11,"PACMA",4
20,"20904",87,56,55,1,1,"PACMA",0
44,"44085",49,29,29,0,0,"PACMA",0
44,"44023",18,15,14,0,1,"PACMA",0
28,"28179",1451,1043,1033,6,10,"PACMA",8
50,"50197",95,69,68,2,1,"PACMA",0
25,"25035",364,257,256,0,1,"PACMA",1
26,"26049",156,120,115,0,5,"PACMA",0
43,"43025",591,448,443,4,5,"PACMA",3
19,"19234",44,30,30,0,0,"PACMA",0
16,"16092",149,108,108,1,0,"PACMA",0
26,"26050",125,92,91,1,1,"PACMA",1
19,"19039",56,48,48,2,0,"PACMA",0
25,"25036",180,124,124,1,0,"PACMA",0
44,"44264",254,170,170,0,0,"PACMA",0
30,"30043",25449,18839,18477,180,362,"PACMA",149
34,"34246",68,52,52,0,0,"PACMA",0
49,"49234",394,282,277,0,5,"PACMA",0
29,"29068",7833,4897,4806,50,91,"PACMA",59
20,"20905",160,123,123,2,0,"PACMA",1
9,"9273",48,40,39,0,1,"PACMA",0
25,"25128",125,85,85,0,0,"PACMA",2
12,"12028",13004,9801,9732,74,69,"PACMA",116
9,"9113",453,321,315,8,6,"PACMA",0
47,"47180",57,41,41,1,0,"PACMA",0
37,"37273",85,58,58,2,0,"PACMA",0
46,"46006",4454,3527,3486,27,41,"PACMA",26
34,"34901",1053,762,759,10,3,"PACMA",4
22,"22011",98,80,79,0,1,"PACMA",3
2,"2064",371,288,283,2,5,"PACMA",1
26,"26015",185,140,138,2,2,"PACMA",0
50,"50071",126,84,84,0,0,"PACMA",0
34,"34101",48,36,36,1,0,"PACMA",0
19,"19145",40,32,32,0,0,"PACMA",0
24,"24169",2777,1908,1880,10,28,"PACMA",10
43,"43026",756,576,574,1,2,"PACMA",5
16,"16215",237,162,158,1,4,"PACMA",0
36,"36046",4073,2887,2818,31,69,"PACMA",24
13,"13071",37945,24340,24091,227,249,"PACMA",205
22,"22221",92,56,55,0,1,"PACMA",1
28,"28086",5446,3643,3600,19,43,"PACMA",43
46,"46007",12333,8890,8803,79,87,"PACMA",101
17,"17205",209,167,166,0,1,"PACMA",2
39,"39009",3325,2306,2293,7,13,"PACMA",11
37,"37180",68,45,44,1,1,"PACMA",0
50,"50199",318,206,201,1,5,"PACMA",7
25,"25130",181,130,128,0,2,"PACMA",1
32,"32055",1216,781,764,10,17,"PACMA",4
26,"26053",191,144,140,2,4,"PACMA",0
26,"26054",291,225,223,3,2,"PACMA",0
46,"46262",206,136,134,1,2,"PACMA",1
43,"43907",4386,3083,3067,24,16,"PACMA",53
15,"15082",15446,10821,10687,130,134,"PACMA",94
45,"45108",465,343,341,0,2,"PACMA",0
31,"31109",1657,1165,1160,12,5,"PACMA",9
9,"9119",42,24,24,0,0,"PACMA",0
49,"49237",142,78,78,0,0,"PACMA",0
26,"26055",39,30,30,0,0,"PACMA",0
5,"5113",62,42,42,0,0,"PACMA",0
17,"17124",1593,1163,1160,8,3,"PACMA",9
49,"49125",1392,883,871,11,12,"PACMA",7
21,"21002",16070,11301,11137,132,164,"PACMA",166
37,"37182",75,47,47,1,0,"PACMA",0
9,"9279",166,116,114,1,2,"PACMA",2
19,"19239",93,70,70,1,0,"PACMA",0
35,"35001",4566,3148,3105,18,43,"PACMA",17
28,"28088",296,196,191,1,5,"PACMA",0
46,"46100",281,190,187,1,3,"PACMA",2
26,"26173",8,8,8,1,0,"PACMA",0
24,"24136",495,347,344,1,3,"PACMA",0
26,"26056",404,312,301,2,11,"PACMA",1
23,"23060",19210,13677,13495,145,182,"PACMA",93
6,"6050",4031,3005,2934,38,71,"PACMA",15
33,"33058",1668,1050,1035,13,15,"PACMA",3
24,"24172",389,208,202,1,6,"PACMA",0
36,"36049",6990,4877,4787,40,90,"PACMA",43
50,"50202",124,76,74,0,2,"PACMA",0
4,"4013",143819,93083,92383,893,700,"PACMA",964
25,"25132",141,106,105,0,1,"PACMA",1
22,"22113",478,335,333,6,2,"PACMA",2
20,"20001",253,163,163,1,0,"PACMA",0
31,"31112",91,56,56,0,0,"PACMA",1
9,"9281",136,97,97,2,0,"PACMA",0
28,"28090",9252,7216,7153,58,63,"PACMA",79
45,"45001",1846,1213,1181,10,32,"PACMA",10
22,"22015",299,218,215,1,3,"PACMA",0
4,"4014",152,105,103,1,2,"PACMA",0
49,"49128",520,384,378,7,6,"PACMA",1
16,"16219",81,58,58,0,0,"PACMA",1
9,"9124",1405,946,928,6,18,"PACMA",5
9,"9283",39,25,24,1,1,"PACMA",0
13,"13078",8946,6166,6103,49,63,"PACMA",32
23,"23062",1410,1094,1076,0,18,"PACMA",0
5,"5116",96,68,68,0,0,"PACMA",0
28,"28091",5491,3709,3650,20,59,"PACMA",39
4,"4015",113,81,81,0,0,"PACMA",3
20,"20002",359,234,231,7,3,"PACMA",0
31,"31004",31,22,22,1,0,"PACMA",0
33,"33060",13991,8629,8481,109,148,"PACMA",53
49,"49241",235,178,177,1,1,"PACMA",0
45,"45002",2619,1676,1663,14,13,"PACMA",6
32,"32024",4817,3064,3014,34,50,"PACMA",17
50,"50101",833,557,550,5,7,"PACMA",4
42,"42185",24,20,20,0,0,"PACMA",0
25,"25226",236,156,155,0,1,"PACMA",0
24,"24030",4158,2746,2696,18,50,"PACMA",12
6,"6009",221,166,166,2,0,"PACMA",0
42,"42049",108,71,71,1,0,"PACMA",0
49,"49020",253,189,187,0,2,"PACMA",1
50,"50278",175,133,131,2,2,"PACMA",0
50,"50052",81,61,61,0,0,"PACMA",0
21,"21067",406,274,271,3,3,"PACMA",2
18,"18033",279,179,174,0,5,"PACMA",0
47,"47092",101,81,79,0,2,"PACMA",0
19,"19047",55,47,47,1,0,"PACMA",1
17,"17129",143,108,108,2,0,"PACMA",0
19,"19117",1632,1187,1167,12,20,"PACMA",13
31,"31006",1877,1328,1310,14,18,"PACMA",7
19,"19243",34,32,31,1,1,"PACMA",0
26,"26061",1542,1104,1079,12,25,"PACMA",3
40,"40190",43,37,35,0,2,"PACMA",0
23,"23065",1530,1068,1054,7,14,"PACMA",1
43,"43033",766,555,555,4,0,"PACMA",7
32,"32063",1795,1135,1119,16,16,"PACMA",1
34,"34215",161,126,125,6,1,"PACMA",0
25,"25014",246,184,178,0,6,"PACMA",0
4,"4018",245,202,197,2,5,"PACMA",0
2,"2072",1528,981,958,7,23,"PACMA",3
16,"16103",235,183,181,2,2,"PACMA",0
23,"23066",4274,3517,3460,16,57,"PACMA",15
50,"50279",74,49,49,0,0,"PACMA",0
7,"7021",229,154,150,3,4,"PACMA",2
32,"32064",453,304,302,0,2,"PACMA",0
37,"37281",39,28,27,0,1,"PACMA",0
40,"40192",134,106,105,1,1,"PACMA",0
13,"13083",2382,1623,1587,12,36,"PACMA",7
29,"29077",207,135,134,1,1,"PACMA",0
37,"37188",158,107,105,3,2,"PACMA",0
18,"18164",1790,1135,1108,11,27,"PACMA",8
14,"14073",2768,1934,1880,33,54,"PACMA",3
45,"45006",1334,866,858,1,8,"PACMA",4
32,"32065",633,422,419,8,3,"PACMA",5
47,"47002",18,18,18,0,0,"PACMA",0
46,"46150",1794,1276,1272,8,4,"PACMA",11
39,"39101",231,134,132,2,2,"PACMA",3
44,"44184",44,37,37,0,0,"PACMA",1
42,"42148",9,9,9,0,0,"PACMA",0
9,"9297",310,233,233,6,0,"PACMA",1
44,"44007",149,112,111,1,1,"PACMA",0
25,"25045",57,26,26,2,0,"PACMA",2
9,"9132",170,121,120,0,1,"PACMA",0
4,"4057",1261,886,872,6,14,"PACMA",4
19,"19308",57,49,49,0,0,"PACMA",0
5,"5121",263,194,189,1,5,"PACMA",3
10,"10902",744,514,498,4,16,"PACMA",2
50,"50030",197,124,124,1,0,"PACMA",0
42,"42149",386,273,270,2,3,"PACMA",1
12,"12118",78,64,63,0,1,"PACMA",1
47,"47004",1135,878,872,5,6,"PACMA",0
31,"31120",376,211,209,7,2,"PACMA",0
31,"31011",715,483,481,5,2,"PACMA",3
45,"45008",144,112,110,1,2,"PACMA",0
1,"1036",14698,10207,10131,51,76,"PACMA",48
9,"9298",72,52,52,1,0,"PACMA",1
39,"39102",2229,1524,1514,10,10,"PACMA",6
19,"19279",54,42,42,0,0,"PACMA",0
42,"42016",20,13,13,0,0,"PACMA",0
22,"22021",1884,1331,1319,26,12,"PACMA",3
22,"22232",88,61,61,2,0,"PACMA",0
19,"19247",140,103,102,1,1,"PACMA",0
49,"49247",412,255,252,2,3,"PACMA",0
50,"50133",98,76,76,0,0,"PACMA",0
37,"37191",102,57,57,1,0,"PACMA",0
1,"1037",589,378,374,1,4,"PACMA",1
24,"24182",410,273,270,7,3,"PACMA",2
21,"21011",3500,2371,2314,23,57,"PACMA",13
4,"4022",356,237,236,5,1,"PACMA",0
47,"47005",506,358,348,3,10,"PACMA",2
10,"10904",714,487,473,8,14,"PACMA",2
5,"5123",106,78,78,0,0,"PACMA",0
46,"46084",1487,1136,1123,4,13,"PACMA",14
18,"18007",730,490,478,3,12,"PACMA",0
12,"12901",3339,2583,2561,25,22,"PACMA",23
44,"44102",26,19,19,0,0,"PACMA",0
40,"40099",54,44,42,0,2,"PACMA",0
5,"5024",193,127,125,2,2,"PACMA",0
28,"28099",1950,1409,1404,16,5,"PACMA",9
32,"32069",4223,3064,3023,31,41,"PACMA",29
35,"35009",20229,13378,13201,95,177,"PACMA",124
48,"48051",220,151,150,0,1,"PACMA",1
1,"1041",150,103,102,1,1,"PACMA",2
17,"17215",2286,1855,1844,13,11,"PACMA",25
6,"6065",293,230,228,2,2,"PACMA",0
16,"16239",118,88,87,0,1,"PACMA",0
47,"47099",154,123,118,0,5,"PACMA",0
33,"33067",751,543,538,7,5,"PACMA",0
45,"45049",419,303,295,1,8,"PACMA",0
42,"42154",103,76,76,1,0,"PACMA",0
7,"7027",22101,13161,13028,140,133,"PACMA",158
50,"50135",85,59,59,0,0,"PACMA",1
46,"46222",402,329,326,0,3,"PACMA",2
26,"26069",230,166,166,0,0,"PACMA",0
37,"37099",63,46,46,1,0,"PACMA",0
44,"44011",47,34,34,0,0,"PACMA",1
18,"18070",287,216,216,3,0,"PACMA",3
4,"4026",57,38,37,0,1,"PACMA",0
42,"42020",4170,2732,2686,35,46,"PACMA",14
1,"1042",911,680,671,8,9,"PACMA",2
2,"2080",498,358,352,0,6,"PACMA",0
40,"40198",24,20,19,0,1,"PACMA",0
26,"26070",152,125,122,1,3,"PACMA",0
12,"12121",1043,878,856,5,22,"PACMA",1
29,"29084",27199,18102,17800,268,302,"PACMA",152
10,"10106",126,102,102,0,0,"PACMA",1
5,"5026",183,149,147,1,2,"PACMA",0
47,"47100",118,93,87,2,6,"PACMA",0
46,"46018",562,442,436,2,6,"PACMA",0
9,"9307",102,76,74,1,2,"PACMA",0
5,"5224",102,85,84,2,1,"PACMA",0
47,"47009",98,84,84,0,0,"PACMA",1
35,"35010",3853,2224,2194,18,30,"PACMA",9
11,"11003",1230,802,787,9,15,"PACMA",1
6,"6069",2985,1921,1874,17,47,"PACMA",7
35,"35011",24859,15025,14833,149,192,"PACMA",154
49,"49141",290,191,191,1,0,"PACMA",0
2,"2048",1173,912,901,9,11,"PACMA",4
23,"23041",489,378,376,1,2,"PACMA",0
12,"12016",1549,1244,1234,9,10,"PACMA",1
40,"40104",283,203,200,0,3,"PACMA",3
33,"33070",3267,2211,2185,27,26,"PACMA",14
18,"18173",8999,5958,5871,50,87,"PACMA",47
4,"4028",207,175,171,1,4,"PACMA",2
6,"6070",7668,5404,5228,59,176,"PACMA",16
2,"2082",98,80,80,0,0,"PACMA",0
37,"37290",130,106,106,0,0,"PACMA",1
9,"9141",617,463,456,5,7,"PACMA",5
45,"45126",234,146,144,2,2,"PACMA",1
33,"33071",546,385,383,7,2,"PACMA",4
13,"13096",7526,5212,5131,25,81,"PACMA",22
35,"35012",10862,5617,5568,40,49,"PACMA",44
13,"13097",2186,1592,1574,5,18,"PACMA",9
26,"26073",92,68,66,1,2,"PACMA",4
32,"32075",4362,3117,3077,30,40,"PACMA",25
37,"37102",375,260,260,4,0,"PACMA",1
50,"50085",182,121,121,0,0,"PACMA",0
48,"48055",2603,1833,1820,14,13,"PACMA",13
44,"44014",2506,1828,1818,8,10,"PACMA",6
17,"17109",704,542,539,2,3,"PACMA",8
9,"9253",101,77,76,0,1,"PACMA",0
25,"25024",352,248,247,0,1,"PACMA",0
32,"32076",1935,1320,1306,15,14,"PACMA",3
11,"11006",24558,15334,15113,231,221,"PACMA",116
44,"44107",212,135,135,0,0,"PACMA",1
43,"43121",593,404,403,1,1,"PACMA",1
42,"42159",39,34,33,0,1,"PACMA",0
47,"47012",100,72,71,0,1,"PACMA",1
29,"29088",2689,1817,1747,15,70,"PACMA",12
37,"37198",202,147,144,2,3,"PACMA",0
16,"16117",1018,723,715,9,8,"PACMA",0
47,"47074",141,110,109,0,1,"PACMA",0
26,"26114",72,61,61,0,0,"PACMA",0
16,"16246",451,327,322,1,5,"PACMA",0
20,"20016",1529,887,883,3,4,"PACMA",8
19,"19059",73,47,47,0,0,"PACMA",0
23,"23080",1720,1313,1294,6,19,"PACMA",3
5,"5228",168,99,98,0,1,"PACMA",0
6,"6074",4720,3355,3271,24,84,"PACMA",28
12,"12048",243,159,155,4,4,"PACMA",0
16,"16247",63,51,50,1,1,"PACMA",0
37,"37199",128,92,92,2,0,"PACMA",0
34,"34131",56,46,46,0,0,"PACMA",0
43,"43122",112,91,91,1,0,"PACMA",1
44,"44195",82,58,57,0,1,"PACMA",0
17,"17141",6019,3855,3833,43,22,"PACMA",47
42,"42162",2298,1493,1462,18,31,"PACMA",10
37,"37003",104,75,75,2,0,"PACMA",0
28,"28034",368,258,255,0,3,"PACMA",1
37,"37106",248,161,160,4,1,"PACMA",0
31,"31023",7778,5977,5948,106,29,"PACMA",68
13,"13904",496,353,342,5,11,"PACMA",2
46,"46159",23038,16719,16596,127,123,"PACMA",254
28,"28109",1651,1131,1116,8,15,"PACMA",14
47,"47106",44,30,30,0,0,"PACMA",0
46,"46022",15392,10624,10546,69,78,"PACMA",116
37,"37294",11750,8395,8280,88,115,"PACMA",49
25,"25244",374,275,270,1,5,"PACMA",0
4,"4033",121,78,77,3,1,"PACMA",0
37,"37200",190,132,131,0,1,"PACMA",0
43,"43044",3962,2751,2719,33,32,"PACMA",22
16,"16119",175,117,115,0,2,"PACMA",0
26,"26078",86,63,63,0,0,"PACMA",0
32,"32080",284,209,209,1,0,"PACMA",0
17,"17223",808,566,563,1,3,"PACMA",2
19,"19168",265,182,175,4,7,"PACMA",0
29,"29016",253,196,194,0,2,"PACMA",1
17,"17142",2713,2166,2159,18,7,"PACMA",24
41,"41054",719,562,546,3,16,"PACMA",4
6,"6124",1635,1158,1119,10,39,"PACMA",2
25,"25180",227,158,155,1,3,"PACMA",1
44,"44111",78,61,61,0,0,"PACMA",0
26,"26079",633,503,499,2,4,"PACMA",0
33,"33076",12115,7519,7456,76,63,"PACMA",40
5,"5102",1681,1252,1228,8,24,"PACMA",4
9,"9318",56,33,33,0,0,"PACMA",0
23,"23084",902,627,621,4,6,"PACMA",2
42,"42165",414,246,237,4,9,"PACMA",2
5,"5231",150,123,122,2,1,"PACMA",1
34,"34135",398,267,264,4,3,"PACMA",3
28,"28037",1570,1135,1123,4,12,"PACMA",4
20,"20019",9892,6740,6717,40,23,"PACMA",19
28,"28112",160,129,129,0,0,"PACMA",0
40,"40206",162,126,123,0,3,"PACMA",1
7,"7038",2046,1416,1406,12,10,"PACMA",8
37,"37297",394,298,297,0,1,"PACMA",0
11,"11011",1726,1124,1084,8,40,"PACMA",5
29,"29018",2009,1421,1362,17,59,"PACMA",5
3,"3086",169,140,140,2,0,"PACMA",4
17,"17225",205,150,150,1,0,"PACMA",0
31,"31026",130,108,107,0,1,"PACMA",0
5,"5135",399,294,292,2,2,"PACMA",0
40,"40013",57,47,47,0,0,"PACMA",0
29,"29092",576,375,366,7,9,"PACMA",4
24,"24088",996,750,745,9,5,"PACMA",5
44,"44112",400,265,265,2,0,"PACMA",0
50,"50218",112,88,88,1,0,"PACMA",0
7,"7039",5019,3066,3017,23,49,"PACMA",23
9,"9325",177,103,101,2,2,"PACMA",0
42,"42167",235,163,161,4,2,"PACMA",2
14,"14004",1963,1465,1437,15,28,"PACMA",3
47,"47018",36,31,31,0,0,"PACMA",0
16,"16011",20,14,14,0,0,"PACMA",0
3,"3004",603,425,423,2,2,"PACMA",6
46,"46094",20805,15353,15211,122,142,"PACMA",176
31,"31028",215,121,121,2,0,"PACMA",1
25,"25153",190,139,136,0,3,"PACMA",1
43,"43127",775,607,606,3,1,"PACMA",6
44,"44021",104,77,77,1,0,"PACMA",0
40,"40208",724,546,543,5,3,"PACMA",0
42,"42033",50,48,48,2,0,"PACMA",0
14,"14005",6298,3905,3828,71,77,"PACMA",21
22,"22249",125,93,92,1,1,"PACMA",0
16,"16125",1607,1166,1150,11,16,"PACMA",8
9,"9007",54,37,35,0,2,"PACMA",0
3,"3089",9496,6617,6484,51,133,"PACMA",58
4,"4038",3105,2020,1984,17,36,"PACMA",12
42,"42034",41,25,25,0,0,"PACMA",0
12,"12053",2040,1587,1579,8,8,"PACMA",4
9,"9009",158,127,124,5,3,"PACMA",2
16,"16126",720,552,545,3,7,"PACMA",0
28,"28147",991,702,698,4,4,"PACMA",5
16,"16013",26,24,24,0,0,"PACMA",0
17,"17061",180,141,139,1,2,"PACMA",2
25,"25218",88,76,75,2,1,"PACMA",0
31,"31212",128,91,91,1,0,"PACMA",0
6,"6085",3429,2439,2382,21,57,"PACMA",9
18,"18182",1926,1222,1204,8,18,"PACMA",1
49,"49266",66,46,45,1,1,"PACMA",0
5,"5235",141,97,97,2,0,"PACMA",0
46,"46095",580,445,438,5,7,"PACMA",5
9,"9058",394,286,284,6,2,"PACMA",2
20,"20024",395,245,245,4,0,"PACMA",1
46,"46232",853,661,648,7,13,"PACMA",2
21,"21027",49,32,32,0,0,"PACMA",0
9,"9010",33,25,25,2,0,"PACMA",0
31,"31140",112,73,73,1,0,"PACMA",0
49,"49267",96,67,63,2,4,"PACMA",0
31,"31031",212,134,132,2,2,"PACMA",0
12,"12082",9602,7323,7248,53,75,"PACMA",81
5,"5236",105,69,69,1,0,"PACMA",0
34,"34005",786,601,593,3,8,"PACMA",0
19,"19264",33,25,25,0,0,"PACMA",0
43,"43051",9194,6133,6048,44,85,"PACMA",93
40,"40018",73,50,50,0,0,"PACMA",0
25,"25155",616,446,443,2,3,"PACMA",0
9,"9330",1481,1050,1037,17,13,"PACMA",4
46,"46096",263,204,202,0,2,"PACMA",6
49,"49156",218,149,144,0,5,"PACMA",0
37,"37116",70,50,50,0,0,"PACMA",0
16,"16263",967,724,721,3,3,"PACMA",3
9,"9168",270,211,210,5,1,"PACMA",2
31,"31033",45,25,25,2,0,"PACMA",0
9,"9013",42,32,32,0,0,"PACMA",1
29,"29023",2330,1441,1429,11,12,"PACMA",25
25,"25156",765,571,567,3,4,"PACMA",3
40,"40119",166,133,132,2,1,"PACMA",0
25,"25252",553,380,379,2,1,"PACMA",2
22,"22252",118,95,91,1,4,"PACMA",0
22,"22142",94,72,70,0,2,"PACMA",0
25,"25063",84,52,51,0,1,"PACMA",0
7,"7045",1317,931,928,8,3,"PACMA",12
25,"25253",147,118,117,0,1,"PACMA",0
9,"9170",207,151,150,1,1,"PACMA",0
25,"25064",96,78,78,0,0,"PACMA",0
5,"5142",88,76,75,0,1,"PACMA",0
50,"50198",47,32,32,0,0,"PACMA",0
34,"34202",28,23,23,2,0,"PACMA",0
43,"43131",4827,3134,3116,32,18,"PACMA",43
31,"31144",760,442,441,4,1,"PACMA",1
44,"44026",100,73,72,0,1,"PACMA",0
22,"22144",255,192,190,2,2,"PACMA",0
16,"16132",33,25,25,1,0,"PACMA",0
37,"37118",117,86,86,3,0,"PACMA",1
29,"29025",41540,27170,26897,271,273,"PACMA",450
42,"42041",31,23,23,0,0,"PACMA",0
49,"49158",206,159,155,0,4,"PACMA",1
5,"5045",81,58,58,0,0,"PACMA",0
41,"41063",2735,1855,1797,30,58,"PACMA",10
38,"38013",3011,1850,1829,14,21,"PACMA",9
45,"45033",297,205,201,1,4,"PACMA",0
17,"17151",179,131,130,0,1,"PACMA",0
23,"23095",8571,6159,6101,37,58,"PACMA",24
9,"9335",86,66,66,3,0,"PACMA",2
14,"14010",3992,2786,2723,14,63,"PACMA",20
29,"29099",969,688,669,11,19,"PACMA",2
9,"9337",113,80,77,2,3,"PACMA",0
40,"40215",79,66,66,2,0,"PACMA",0
50,"50224",61,44,44,2,0,"PACMA",0
35,"35023",11742,7787,7651,95,136,"PACMA",55
34,"34152",124,99,94,0,5,"PACMA",0
25,"25255",390,301,301,0,0,"PACMA",1
5,"5240",3346,2259,2232,11,27,"PACMA",12
7,"7048",18455,9929,9858,116,71,"PACMA",179
40,"40122",524,398,392,2,6,"PACMA",4
17,"17152",11065,6959,6927,68,32,"PACMA",84
44,"44207",125,98,97,2,1,"PACMA",0
31,"31146",30,22,22,1,0,"PACMA",0
1,"1902",723,485,478,8,7,"PACMA",6
37,"37120",98,78,76,0,2,"PACMA",0
50,"50225",1532,983,971,12,12,"PACMA",4
37,"37016",563,419,411,4,8,"PACMA",1
43,"43029",312,241,240,1,1,"PACMA",1
20,"20030",21147,14598,14521,92,77,"PACMA",57
42,"42007",108,80,80,1,0,"PACMA",0
43,"43055",1970,1548,1535,12,13,"PACMA",9
26,"26094",67,51,51,0,0,"PACMA",0
49,"49053",919,676,661,8,15,"PACMA",6
9,"9175",120,78,76,1,2,"PACMA",0
44,"44208",27,17,17,0,0,"PACMA",0
24,"24212",983,693,684,10,9,"PACMA",2
28,"28048",514,386,384,4,2,"PACMA",4
47,"47027",2799,2059,2025,12,34,"PACMA",21
37,"37309",36,21,21,0,0,"PACMA",0
19,"19269",86,61,61,0,0,"PACMA",1
23,"23098",847,704,700,0,4,"PACMA",5
45,"45037",1520,1072,1055,5,17,"PACMA",3
38,"38016",1174,595,589,2,6,"PACMA",1
7,"7050",3513,2036,2013,25,23,"PACMA",17
50,"50001",89,68,68,0,0,"PACMA",0
43,"43135",339,255,255,0,0,"PACMA",2
18,"18192",1462,1125,1103,3,22,"PACMA",1
47,"47028",30,17,17,0,0,"PACMA",0
21,"21035",9766,6114,5998,92,116,"PACMA",53
37,"37122",203,162,161,3,1,"PACMA",2
42,"42046",46,32,32,0,0,"PACMA",0
19,"19270",14,13,13,0,0,"PACMA",0
45,"45148",263,184,184,0,0,"PACMA",0
31,"31150",200,120,119,1,1,"PACMA",0
9,"9345",111,87,86,2,1,"PACMA",0
34,"34157",2353,1697,1669,18,28,"PACMA",6
26,"26098",92,63,63,1,0,"PACMA",0
9,"9023",1190,891,879,17,12,"PACMA",12
9,"9178",39,24,24,0,0,"PACMA",0
28,"28125",3208,2275,2252,5,23,"PACMA",27
44,"44210",750,577,572,2,5,"PACMA",3
19,"19151",1077,703,693,8,10,"PACMA",4
10,"10094",220,167,165,0,2,"PACMA",0
44,"44238",2278,1630,1620,3,10,"PACMA",6
9,"9346",90,61,60,1,1,"PACMA",1
9,"9179",39,30,30,1,0,"PACMA",0
38,"38018",4466,2867,2821,21,46,"PACMA",27
48,"48016",5471,3964,3935,31,29,"PACMA",41
34,"34020",49,37,37,1,0,"PACMA",2
10,"10012",553,427,421,1,6,"PACMA",0
23,"23901",1125,905,895,3,10,"PACMA",0
31,"31115",159,93,93,2,0,"PACMA",0
9,"9127",52,36,35,0,1,"PACMA",0
43,"43058",95,78,78,0,0,"PACMA",0
25,"25166",170,131,130,2,1,"PACMA",0
34,"34159",375,221,214,4,7,"PACMA",1
44,"44182",203,160,158,0,2,"PACMA",1
31,"31043",29,23,23,0,0,"PACMA",0
16,"16025",24,20,20,0,0,"PACMA",0
44,"44124",71,57,57,0,0,"PACMA",1
46,"46240",200,167,155,1,12,"PACMA",0
10,"10014",1816,1285,1254,13,31,"PACMA",2
47,"47031",191,141,140,0,1,"PACMA",0
2,"2006",573,425,424,1,1,"PACMA",0
22,"22157",181,122,121,2,1,"PACMA",1
18,"18003",14454,10162,9935,105,227,"PACMA",108
27,"27028",78725,52642,51965,642,677,"PACMA",402
22,"22905",287,217,217,1,0,"PACMA",2
25,"25167",223,165,164,3,1,"PACMA",1
25,"25073",559,377,377,2,0,"PACMA",1
26,"26101",31,18,17,0,1,"PACMA",1
18,"18901",489,323,322,5,1,"PACMA",1
49,"49168",89,68,68,0,0,"PACMA",0
4,"4055",361,298,290,3,8,"PACMA",0
16,"16276",20,17,17,1,0,"PACMA",0
43,"43060",2672,2032,2015,7,17,"PACMA",8
9,"9027",47,38,34,1,4,"PACMA",0
28,"28128",453,334,331,1,3,"PACMA",2
19,"19277",15,10,10,0,0,"PACMA",0
4,"4056",165,120,120,0,0,"PACMA",1
34,"34024",25,14,14,0,0,"PACMA",0
31,"31154",217,107,104,0,3,"PACMA",0
18,"18902",752,589,568,3,21,"PACMA",0
24,"24217",135,93,93,0,0,"PACMA",0
31,"31045",510,347,345,8,2,"PACMA",2
9,"9352",102,74,74,0,0,"PACMA",0
25,"25906",205,133,131,2,2,"PACMA",0
17,"17159",622,459,459,1,0,"PACMA",2
45,"45154",1491,1033,1024,11,9,"PACMA",16
40,"40129",159,119,117,2,2,"PACMA",0
3,"3103",238,196,194,2,2,"PACMA",2
4,"4090",298,229,225,1,4,"PACMA",1
49,"49024",626,432,426,3,6,"PACMA",0
47,"47033",205,151,150,2,1,"PACMA",0
41,"41071",5571,3608,3516,64,92,"PACMA",24
31,"31010",5719,3799,3770,22,29,"PACMA",17
37,"37221",391,259,257,2,2,"PACMA",2
40,"40224",18,15,15,0,0,"PACMA",0
17,"17187",625,496,492,3,4,"PACMA",1
23,"23034",2480,1923,1882,15,41,"PACMA",3
48,"48076",288,211,211,1,0,"PACMA",0
19,"19088",91,67,66,0,1,"PACMA",0
31,"31156",238,175,174,2,1,"PACMA",3
40,"40225",1085,822,809,5,13,"PACMA",4
37,"37222",78,55,55,2,0,"PACMA",0
13,"13087",23255,15400,15127,213,273,"PACMA",157
35,"35030",10046,5584,5505,44,79,"PACMA",44
44,"44127",57,43,43,0,0,"PACMA",0
24,"24001",165,93,93,0,0,"PACMA",0
29,"29035",1478,1054,1040,3,14,"PACMA",0
11,"11030",22999,14858,14586,207,272,"PACMA",222
47,"47130",94,64,63,0,1,"PACMA",0
42,"42193",14,7,7,0,0,"PACMA",0
24,"24108",348,247,246,4,1,"PACMA",1
20,"20039",2126,1623,1618,9,5,"PACMA",4
9,"9033",80,64,63,1,1,"PACMA",0
41,"41073",1684,1100,1074,7,26,"PACMA",5
37,"37224",189,156,153,2,3,"PACMA",0
37,"37025",245,198,196,5,2,"PACMA",0
5,"5253",75,54,54,0,0,"PACMA",1
9,"9356",43,31,30,0,1,"PACMA",1
9,"9191",33,23,23,1,0,"PACMA",0
37,"37286",204,140,137,2,3,"PACMA",1
9,"9034",291,227,224,1,3,"PACMA",0
28,"28132",12197,8622,8537,75,85,"PACMA",114
15,"15031",23868,16113,15954,207,159,"PACMA",134
21,"21043",1853,1354,1325,23,29,"PACMA",9
46,"46039",2111,1657,1640,16,17,"PACMA",13
34,"34031",26,26,26,1,0,"PACMA",0
20,"20040",15771,10549,10481,54,68,"PACMA",46
33,"33011",10563,5646,5578,92,68,"PACMA",12
16,"16149",147,105,105,2,0,"PACMA",1
48,"48079",397,289,287,1,2,"PACMA",3
5,"5254",184,149,147,1,2,"PACMA",0
23,"23001",912,723,712,2,11,"PACMA",3
36,"36029",16126,10936,10771,96,165,"PACMA",106
43,"43143",50,40,39,0,1,"PACMA",0
10,"10062",389,303,299,2,4,"PACMA",0
35,"35032",3331,2293,2252,23,41,"PACMA",8
46,"46108",420,328,324,1,4,"PACMA",3
11,"11032",54731,31560,31284,492,276,"PACMA",341
37,"37226",152,113,113,2,0,"PACMA",0
25,"25910",91,63,63,0,0,"PACMA",1
45,"45159",83,71,69,0,2,"PACMA",0
26,"26108",309,240,231,2,9,"PACMA",0
5,"5256",110,88,86,1,2,"PACMA",1
31,"31906",2707,1800,1781,22,19,"PACMA",11
34,"34033",18,14,14,0,0,"PACMA",0
6,"6112",379,295,293,0,2,"PACMA",1
42,"42059",20,14,14,0,0,"PACMA",0
41,"41076",2134,1246,1230,11,16,"PACMA",1
6,"6113",2649,1889,1862,16,27,"PACMA",9
47,"47134",150,120,116,2,4,"PACMA",0
44,"44131",26,22,22,0,0,"PACMA",2
16,"16903",992,750,732,8,18,"PACMA",1
31,"31907",11272,8478,8421,97,57,"PACMA",63
40,"40231",100,79,76,0,3,"PACMA",0
44,"44040",189,153,150,1,3,"PACMA",0
22,"22058",193,141,141,0,0,"PACMA",1
31,"31053",509,354,350,4,4,"PACMA",1
18,"18907",1762,1358,1351,4,7,"PACMA",0
45,"45052",3132,2433,2416,29,17,"PACMA",22
37,"37228",324,262,262,1,0,"PACMA",0
49,"49176",605,360,353,0,7,"PACMA",0
28,"28060",1585,1160,1146,5,14,"PACMA",16
34,"34175",87,67,66,1,1,"PACMA",0
44,"44106",151,107,106,0,1,"PACMA",0
15,"15035",11189,7256,7165,104,91,"PACMA",50
19,"19284",10,10,10,0,0,"PACMA",0
14,"14024",1849,1417,1391,5,26,"PACMA",10
18,"18012",2114,1519,1492,9,27,"PACMA",4
11,"11035",13751,8535,8396,125,139,"PACMA",122
47,"47135",82,65,65,3,0,"PACMA",0
3,"3024",3937,2992,2952,19,40,"PACMA",28
6,"6116",1500,1015,998,7,17,"PACMA",1
16,"16905",1302,951,934,10,17,"PACMA",8
29,"29040",1933,1260,1235,11,25,"PACMA",10
19,"19285",20,16,16,0,0,"PACMA",0
9,"9365",26,17,17,0,0,"PACMA",0
31,"31055",267,192,191,0,1,"PACMA",1
50,"50164",381,245,243,3,2,"PACMA",0
10,"10027",77,62,62,0,0,"PACMA",1
49,"49071",716,432,429,6,3,"PACMA",0
45,"45201",3692,2198,2175,15,23,"PACMA",24
10,"10068",707,532,521,4,11,"PACMA",4
16,"16153",924,751,741,4,10,"PACMA",3
31,"31019",1831,1231,1224,17,7,"PACMA",4
49,"49257",305,186,184,0,2,"PACMA",1
1,"1047",982,653,642,6,11,"PACMA",3
37,"37230",220,169,168,1,1,"PACMA",1
28,"28137",1770,1300,1289,6,11,"PACMA",14
6,"6118",155,114,112,0,2,"PACMA",1
41,"41079",9285,6591,6446,101,145,"PACMA",70
34,"34037",301,206,204,1,2,"PACMA",0
42,"42202",19,11,10,0,1,"PACMA",0
37,"37231",236,185,183,5,2,"PACMA",0
50,"50239",63,46,45,1,1,"PACMA",0
12,"12074",756,611,601,3,10,"PACMA",2
49,"49145",208,113,113,1,0,"PACMA",1
43,"43174",144,118,114,0,4,"PACMA",1
43,"43148",91182,65076,64756,441,320,"PACMA",883
44,"44043",86,60,60,0,0,"PACMA",0
6,"6119",674,516,511,1,5,"PACMA",0
19,"19286",772,585,575,3,10,"PACMA",2
30,"30011",4702,3390,3324,8,66,"PACMA",23
19,"19195",36,26,25,2,1,"PACMA",0
43,"43069",183,148,147,2,1,"PACMA",1
10,"10030",455,311,305,2,6,"PACMA",0
32,"32005",810,576,568,9,8,"PACMA",3
26,"26003",379,311,306,1,5,"PACMA",1
29,"29043",2463,1508,1460,20,48,"PACMA",14
40,"40140",76,54,54,0,0,"PACMA",0
47,"47044",323,273,270,4,3,"PACMA",4
37,"37233",53,39,39,1,0,"PACMA",0
44,"44044",82,65,65,2,0,"PACMA",0
15,"15039",1224,802,785,9,17,"PACMA",3
28,"28140",3156,2359,2331,16,28,"PACMA",30
3,"3027",167,142,138,1,4,"PACMA",3
3,"3114",1593,1158,1142,4,16,"PACMA",7
19,"19196",89,70,67,1,3,"PACMA",0
12,"12076",72,54,54,0,0,"PACMA",1
9,"9373",399,254,251,5,3,"PACMA",0
42,"42068",77,58,57,0,1,"PACMA",0
31,"31059",182,121,121,1,0,"PACMA",0
46,"46045",1245,984,961,3,23,"PACMA",8
28,"28065",131232,100864,99883,846,981,"PACMA",991
43,"43150",1233,954,941,6,13,"PACMA",3
19,"19288",21,20,20,2,0,"PACMA",0
31,"31060",14323,9547,9434,79,113,"PACMA",85
44,"44045",360,271,271,0,0,"PACMA",0
43,"43071",896,652,647,3,5,"PACMA",1
31,"31169",2203,1429,1415,15,14,"PACMA",8
25,"25179",169,132,132,0,0,"PACMA",0
6,"6123",4502,2989,2894,29,95,"PACMA",27
31,"31061",48,45,45,2,0,"PACMA",1
41,"41082",3354,2545,2507,11,38,"PACMA",15
49,"49226",240,200,198,2,2,"PACMA",0
46,"46023",322,254,252,1,2,"PACMA",2
38,"38031",29301,20926,20701,157,225,"PACMA",244
28,"28144",6525,5032,4987,39,45,"PACMA",45
9,"9211",1369,938,921,14,17,"PACMA",5
32,"32008",8647,5570,5495,56,75,"PACMA",44
27,"27044",2703,1495,1463,15,32,"PACMA",3
9,"9377",626,468,460,6,8,"PACMA",2
40,"40905",130,95,95,0,0,"PACMA",0
19,"19290",851,551,550,4,1,"PACMA",18
50,"50089",8616,6420,6364,50,56,"PACMA",68
9,"9213",264,182,182,1,0,"PACMA",0
10,"10157",246,163,161,0,2,"PACMA",1
45,"45170",194,146,140,0,6,"PACMA",0
19,"19198",17,14,14,0,0,"PACMA",0
18,"18018",542,384,377,2,7,"PACMA",2
37,"37037",108,72,72,0,0,"PACMA",0
18,"18914",1660,1255,1227,11,28,"PACMA",10
9,"9052",28,21,20,0,1,"PACMA",0
29,"29046",2494,1727,1693,13,34,"PACMA",12
9,"9378",31,20,19,0,1,"PACMA",0
50,"50090",134,96,96,0,0,"PACMA",0
47,"47144",72,54,53,2,1,"PACMA",0
50,"50017",1773,1283,1265,13,18,"PACMA",7
2,"2023",504,419,412,0,7,"PACMA",1
40,"40144",16,15,15,0,0,"PACMA",0
46,"46184",26514,19610,19399,180,211,"PACMA",201
9,"9214",632,409,407,2,2,"PACMA",1
42,"42075",78,50,50,1,0,"PACMA",0
25,"25092",125,93,92,0,1,"PACMA",1
21,"21055",7326,5395,5309,43,86,"PACMA",53
36,"36008",21845,14553,14373,138,180,"PACMA",133
45,"45062",1075,816,808,11,8,"PACMA",0
5,"5266",100,79,79,1,0,"PACMA",0
34,"34186",49,44,44,0,0,"PACMA",0
24,"24053",398,250,248,1,2,"PACMA",0
10,"10037",76966,54717,53914,546,803,"PACMA",479
31,"31065",1843,1311,1300,12,11,"PACMA",7
16,"16162",39,31,31,0,0,"PACMA",0
34,"34189",53,33,33,0,0,"PACMA",0
26,"26123",128,110,110,0,0,"PACMA",0
9,"9216",370,245,241,3,4,"PACMA",3
14,"14033",1239,875,856,8,19,"PACMA",8
10,"10038",83,59,59,0,0,"PACMA",0
46,"46117",493,386,380,2,6,"PACMA",4
5,"5170",47,34,34,1,0,"PACMA",0
42,"42078",1000,653,640,5,13,"PACMA",0
9,"9217",342,240,237,1,3,"PACMA",0
21,"21056",2914,2148,2046,29,102,"PACMA",11
31,"31066",819,577,559,4,18,"PACMA",4
49,"49083",47,37,37,1,0,"PACMA",0
2,"2026",834,644,633,4,11,"PACMA",1
25,"25183",520,372,370,4,2,"PACMA",5
39,"39061",3470,2605,2591,14,14,"PACMA",15
7,"7041",2090,1454,1434,17,20,"PACMA",6
40,"40016",55,44,43,1,1,"PACMA",0
36,"36010",2825,1983,1947,19,36,"PACMA",14
33,"33024",224741,151660,150461,1597,1199,"PACMA",1401
50,"50172",174,125,123,2,2,"PACMA",0
24,"24019",338,259,256,4,3,"PACMA",0
46,"46118",3649,2730,2701,20,29,"PACMA",22
6,"6040",993,679,668,3,11,"PACMA",4
16,"16050",218,172,169,2,3,"PACMA",0
42,"42079",21,17,17,1,0,"PACMA",0
50,"50019",63,46,46,0,0,"PACMA",0
18,"18023",15717,10964,10751,132,213,"PACMA",78
26,"26012",37,28,28,1,0,"PACMA",0
19,"19002",55,45,45,0,0,"PACMA",0
50,"50020",795,548,545,4,3,"PACMA",0
44,"44262",141,104,103,0,1,"PACMA",0
5,"5902",286,214,211,1,3,"PACMA",2
41,"41088",515,368,358,2,10,"PACMA",4
3,"3120",2433,1688,1652,13,36,"PACMA",17
44,"44145",974,698,697,3,1,"PACMA",2
24,"24129",114,79,78,2,1,"PACMA",1
19,"19003",36,30,30,0,0,"PACMA",0
40,"40149",479,345,338,3,7,"PACMA",0
9,"9220",69,52,52,3,0,"PACMA",0
10,"10042",85,58,58,0,0,"PACMA",0
47,"47052",6781,5213,5156,50,57,"PACMA",44
16,"16167",288,225,217,0,8,"PACMA",0
16,"16051",128,96,96,3,0,"PACMA",1
22,"22182",227,132,131,3,1,"PACMA",0
37,"37241",167,121,119,3,2,"PACMA",0
5,"5076",468,376,367,1,9,"PACMA",1
43,"43156",3956,2812,2784,22,28,"PACMA",20
40,"40150",60,42,42,0,0,"PACMA",0
41,"41089",6621,4650,4549,64,101,"PACMA",61
9,"9061",147,119,119,0,0,"PACMA",0
34,"34055",254,185,184,3,1,"PACMA",1
5,"5904",108,70,69,5,1,"PACMA",1
27,"27051",7986,5324,5241,58,83,"PACMA",44
19,"19004",59,44,44,0,0,"PACMA",0
36,"36015",4079,2653,2606,29,47,"PACMA",19
31,"31180",202,144,143,1,1,"PACMA",2
19,"19110",51,39,39,0,0,"PACMA",1
49,"49087",476,246,244,0,2,"PACMA",0
29,"29024",371,216,204,3,12,"PACMA",1
14,"14037",3161,2233,2158,22,75,"PACMA",9
29,"29052",213,129,128,0,1,"PACMA",1
15,"15049",1068,752,747,7,5,"PACMA",0
50,"50175",907,638,632,11,6,"PACMA",11
26,"26016",28,20,18,0,2,"PACMA",0
17,"17177",562,426,423,1,3,"PACMA",3
50,"50096",34,22,22,0,0,"PACMA",0
19,"19111",160,128,125,0,3,"PACMA",0
45,"45180",2850,2044,2023,15,21,"PACMA",17
26,"26130",205,153,150,1,3,"PACMA",0
46,"46121",106,91,90,1,1,"PACMA",0
45,"45071",1779,1374,1342,7,32,"PACMA",3
47,"47151",26,22,22,0,0,"PACMA",0
16,"16055",669,429,426,0,3,"PACMA",1
37,"37046",10648,7396,7241,62,155,"PACMA",41
5,"5079",66,53,52,0,1,"PACMA",0
10,"10046",184,144,140,0,4,"PACMA",0
6,"6138",1021,677,658,5,19,"PACMA",5
22,"22187",288,220,220,2,0,"PACMA",2
50,"50023",199,145,143,2,2,"PACMA",0
2,"2032",259,183,178,2,5,"PACMA",0
31,"31073",298,207,206,1,1,"PACMA",2
3,"3038",330,260,254,3,6,"PACMA",1
26,"26131",34,33,33,0,0,"PACMA",0
16,"16056",442,275,270,4,5,"PACMA",1
29,"29054",42538,28080,27814,225,266,"PACMA",406
32,"32020",2428,1728,1714,10,14,"PACMA",1
45,"45182",996,760,754,5,6,"PACMA",1
23,"23025",2725,1894,1870,11,24,"PACMA",11
10,"10169",497,370,366,0,4,"PACMA",0
42,"42086",33,19,19,1,0,"PACMA",0
36,"36018",3033,1951,1926,9,25,"PACMA",5
4,"4082",275,185,182,2,3,"PACMA",0
50,"50250",54,44,44,2,0,"PACMA",1
19,"19210",18,16,16,0,0,"PACMA",0
39,"39039",540,355,355,1,0,"PACMA",0
2,"2001",687,513,505,1,8,"PACMA",0
28,"28047",42984,30772,30486,270,286,"PACMA",327
17,"17094",1058,757,747,3,10,"PACMA",1
21,"21063",2611,1948,1891,23,57,"PACMA",8
10,"10049",3752,2949,2864,25,85,"PACMA",21
33,"33030",876,632,630,8,2,"PACMA",7
26,"26134",81,67,67,3,0,"PACMA",0
6,"6141",1678,1183,1158,15,25,"PACMA",7
17,"17181",3458,2454,2443,18,11,"PACMA",37
18,"18029",1812,1104,1065,7,39,"PACMA",3
31,"31075",113,69,69,2,0,"PACMA",1
41,"41009",1148,750,732,5,18,"PACMA",1
31,"31076",2543,1965,1956,19,9,"PACMA",12
30,"30023",3874,2831,2788,18,43,"PACMA",33
31,"31185",461,291,290,1,1,"PACMA",0
45,"45185",7573,5422,5320,31,102,"PACMA",28
16,"16174",166,130,129,2,1,"PACMA",3
19,"19303",41,32,32,0,0,"PACMA",0
26,"26021",2742,1967,1932,14,35,"PACMA",7
12,"12006",177,133,133,2,0,"PACMA",0
37,"37247",171,129,128,0,1,"PACMA",0
23,"23028",6103,4369,4286,26,83,"PACMA",39
25,"25012",2349,1563,1556,17,7,"PACMA",24
43,"43005",3677,2505,2493,17,12,"PACMA",21
48,"48902",18987,12762,12670,88,92,"PACMA",86
32,"32023",1130,787,782,2,5,"PACMA",2
10,"10173",558,389,385,5,4,"PACMA",2
26,"26136",90,65,64,2,1,"PACMA",0
29,"29057",330,222,218,2,4,"PACMA",2
6,"6008",615,522,507,2,15,"PACMA",1
34,"34062",148,94,93,0,1,"PACMA",0
36,"36021",12180,8188,8058,115,130,"PACMA",66
45,"45076",574,361,357,1,4,"PACMA",3
24,"24029",686,430,428,6,2,"PACMA",1
37,"37216",294,234,227,5,7,"PACMA",0
14,"14015",2045,1465,1418,16,47,"PACMA",4
9,"9403",103,79,78,1,1,"PACMA",0
31,"31078",2418,1752,1729,16,23,"PACMA",12
18,"18127",17005,11790,11583,150,207,"PACMA",139
34,"34158",283,170,167,0,3,"PACMA",5
2,"2037",22963,14737,14588,68,149,"PACMA",85
9,"9232",139,100,97,1,3,"PACMA",0
46,"46057",463,308,304,1,4,"PACMA",5
5,"5245",353,262,256,0,6,"PACMA",1
17,"17070",110,87,87,0,0,"PACMA",1
49,"49203",280,218,212,1,6,"PACMA",0
12,"12008",228,195,194,1,1,"PACMA",2
24,"24142",24715,16839,16616,159,223,"PACMA",110
50,"50229",65,46,46,1,0,"PACMA",0
43,"43084",514,388,383,2,5,"PACMA",0
22,"22080",263,188,184,3,4,"PACMA",0
20,"20064",12395,7959,7916,42,43,"PACMA",70
34,"34067",129,80,78,1,2,"PACMA",0
12,"12091",171,110,108,4,2,"PACMA",1
21,"21068",973,562,556,11,6,"PACMA",6
40,"40158",15,11,11,0,0,"PACMA",0
45,"45078",1333,1084,1077,6,7,"PACMA",10
22,"22081",247,173,171,3,2,"PACMA",0
45,"45079",355,250,250,0,0,"PACMA",2
5,"5182",721,457,436,3,21,"PACMA",0
4,"4088",2444,1587,1574,17,13,"PACMA",14
10,"10177",1702,1241,1186,10,55,"PACMA",5
50,"50181",999,748,732,3,16,"PACMA",6
13,"13038",1589,1162,1136,21,26,"PACMA",4
37,"37251",108,75,75,0,0,"PACMA",0
24,"24032",99,70,66,1,4,"PACMA",0
48,"48905",2496,1778,1766,12,12,"PACMA",8
31,"31081",338,229,227,1,2,"PACMA",1
45,"45080",3,3,3,0,0,"PACMA",0
17,"17185",2260,1657,1652,8,5,"PACMA",13
23,"23032",529,427,419,5,8,"PACMA",2
41,"41014",2476,1852,1799,10,53,"PACMA",3
44,"44240",151,119,117,0,2,"PACMA",0
46,"46127",2748,2035,2009,6,26,"PACMA",14
19,"19216",127,88,88,0,0,"PACMA",1
3,"3132",512,376,373,2,3,"PACMA",3
16,"16065",370,287,287,3,0,"PACMA",1
50,"50182",3657,2499,2485,23,14,"PACMA",30
22,"22199",6884,4438,4384,71,54,"PACMA",31
44,"44241",500,361,357,0,4,"PACMA",0
5,"5184",238,163,160,2,3,"PACMA",0
25,"25016",2083,1404,1399,3,5,"PACMA",0
22,"22083",447,360,355,6,5,"PACMA",0
43,"43009",1384,966,959,5,7,"PACMA",8
37,"37023",1624,1233,1211,15,22,"PACMA",10
26,"26143",260,197,192,1,5,"PACMA",4
37,"37253",135,109,109,1,0,"PACMA",1
25,"25169",170,117,117,5,0,"PACMA",1
9,"9410",3019,1924,1898,21,26,"PACMA",22
2,"2042",810,581,577,1,4,"PACMA",2
10,"10100",783,494,447,5,47,"PACMA",5
26,"26183",66,48,48,0,0,"PACMA",3
41,"41015",5426,3778,3639,41,139,"PACMA",30
9,"9242",66,53,52,3,1,"PACMA",0
16,"16187",55,38,38,3,0,"PACMA",1
27,"27062",583,403,400,2,3,"PACMA",0
12,"12040",119116,85613,84993,620,620,"PACMA",780
9,"9032",103,62,62,3,0,"PACMA",0
34,"34120",63790,46117,45597,464,520,"PACMA",313
50,"50055",3635,2298,2244,36,54,"PACMA",14
9,"9411",153,105,104,0,1,"PACMA",2
10,"10182",122,81,81,0,0,"PACMA",0
31,"31193",1440,1062,1055,11,7,"PACMA",7
17,"17214",714,516,511,6,5,"PACMA",8
45,"45193",586,478,469,0,9,"PACMA",0
36,"36027",4401,2940,2781,20,159,"PACMA",20
50,"50258",53,25,25,1,0,"PACMA",0
46,"46061",351,276,272,6,4,"PACMA",4
19,"19310",7,7,7,0,0,"PACMA",0
49,"49101",144,88,82,1,6,"PACMA",0
22,"22085",94,78,76,0,2,"PACMA",0
16,"16068",125,88,88,3,0,"PACMA",0
29,"29064",423,291,285,2,6,"PACMA",1
25,"25019",4606,2860,2829,19,31,"PACMA",21
30,"30005",30268,20979,20778,148,201,"PACMA",233
24,"24038",3024,2121,2071,25,50,"PACMA",6
9,"9246",599,381,372,2,9,"PACMA",1
5,"5188",39,33,33,0,0,"PACMA",0
30,"30030",321454,235061,233183,1744,1878,"PACMA",2299
38,"38047",1755,1132,1110,9,22,"PACMA",7
37,"37256",191,123,123,1,0,"PACMA",0
50,"50032",243,167,164,3,3,"PACMA",1
28,"28164",3230,2371,2345,28,26,"PACMA",31
6,"6019",2010,1367,1330,23,37,"PACMA",4
14,"14049",16185,11561,11323,145,238,"PACMA",110
45,"45196",1382,1029,1005,7,24,"PACMA",2
13,"13045",622,459,451,0,8,"PACMA",1
9,"9414",180,137,135,1,2,"PACMA",1
17,"17048",6284,4077,4048,34,29,"PACMA",62
15,"15901",3334,1948,1928,27,20,"PACMA",17
16,"16071",20,16,16,0,0,"PACMA",0
44,"44159",37,27,27,1,0,"PACMA",2
9,"9247",21,18,18,0,0,"PACMA",0
19,"19019",14,11,11,1,0,"PACMA",0
46,"46131",49805,35527,35231,298,296,"PACMA",444
4,"4095",687,462,457,4,5,"PACMA",0
18,"18137",968,733,731,3,2,"PACMA",2
12,"12096",732,526,519,4,7,"PACMA",3
28,"28166",357,281,276,1,5,"PACMA",1
6,"6158",13367,9319,9131,90,188,"PACMA",80
47,"47068",29,21,21,0,0,"PACMA",0
6,"6022",2635,1920,1862,15,58,"PACMA",10
45,"45087",8180,5737,5628,41,109,"PACMA",19
46,"46132",2176,1725,1708,5,17,"PACMA",11
44,"44067",106,75,71,0,4,"PACMA",1
10,"10064",1400,998,972,3,26,"PACMA",0
12,"12015",115,94,94,0,0,"PACMA",0
31,"31198",36,30,30,0,0,"PACMA",0
29,"29066",357,248,246,1,2,"PACMA",2
26,"26149",42,34,34,0,0,"PACMA",0
9,"9249",47,35,35,3,0,"PACMA",0
37,"37164",232,176,175,3,1,"PACMA",0
37,"37258",134,92,92,1,0,"PACMA",1
50,"50034",767,516,511,10,5,"PACMA",4
46,"46250",582242,437146,434438,3315,2708,"PACMA",4878
42,"42107",70,48,47,1,1,"PACMA",0
43,"43145",4209,3193,3170,17,23,"PACMA",28
10,"10066",161,121,120,1,1,"PACMA",3
25,"25912",841,620,619,5,1,"PACMA",5
6,"6161",289,199,197,1,2,"PACMA",1
31,"31090",139,67,67,0,0,"PACMA",0
45,"45089",1432,1076,1064,10,12,"PACMA",3
41,"41094",6496,4733,4628,47,105,"PACMA",47
40,"40071",39,32,26,0,6,"PACMA",0
37,"37063",58,47,47,0,0,"PACMA",0
39,"39080",3477,2404,2388,4,16,"PACMA",17
41,"41021",21410,14369,14139,195,230,"PACMA",196
25,"25118",326,223,218,0,5,"PACMA",0
34,"34080",5231,3207,3161,35,46,"PACMA",12
16,"16194",219,169,161,0,8,"PACMA",0
42,"42108",10,7,7,0,0,"PACMA",0
1,"1001",2020,1385,1372,5,13,"PACMA",6
17,"17107",267,207,205,2,2,"PACMA",1
49,"49108",446,312,309,2,3,"PACMA",0
47,"47071",396,321,316,5,5,"PACMA",0
41,"41050",5173,3954,3878,36,76,"PACMA",34
42,"42062",20,10,10,0,0,"PACMA",0
22,"22090",86,61,61,1,0,"PACMA",0
9,"9419",67,52,49,0,3,"PACMA",0
19,"19319",4609,3303,3273,22,30,"PACMA",56
10,"10151",189,145,142,2,3,"PACMA",0
44,"44163",115,79,78,0,1,"PACMA",0
49,"49221",233,122,120,2,2,"PACMA",0
9,"9421",240,180,180,3,0,"PACMA",0
6,"6027",645,523,513,0,10,"PACMA",4
28,"28170",2495,1714,1695,13,19,"PACMA",9
20,"20076",7013,5011,4991,16,20,"PACMA",20
34,"34082",78,59,58,0,1,"PACMA",0
30,"30034",1067,818,801,8,17,"PACMA",4
32,"32040",1400,1001,990,10,11,"PACMA",7
39,"39082",1611,1108,1102,8,6,"PACMA",4
13,"13901",875,628,619,1,9,"PACMA",3
25,"25209",1586,1115,1102,6,13,"PACMA",10
6,"6028",4098,3457,3350,22,107,"PACMA",8
37,"37262",69,51,51,0,0,"PACMA",0
19,"19024",8561,6015,5942,44,73,"PACMA",79
48,"48915",339,245,243,0,2,"PACMA",0
46,"46253",112,84,84,0,0,"PACMA",2
28,"28171",4410,2921,2889,8,32,"PACMA",22
40,"40172",47,33,32,0,1,"PACMA",0
10,"10193",1392,1045,1025,6,20,"PACMA",5
28,"28003",167,133,131,4,2,"PACMA",1
30,"30035",19432,13174,13013,114,161,"PACMA",156
37,"37357",248,193,192,1,1,"PACMA",0
39,"39083",1063,619,611,2,8,"PACMA",1
36,"36035",14615,10011,9880,103,131,"PACMA",61
31,"31204",36,25,25,0,0,"PACMA",1
9,"9423",27,24,24,1,0,"PACMA",0
12,"12020",118,104,103,1,1,"PACMA",0
46,"46204",6625,4946,4882,52,64,"PACMA",34
28,"28172",9915,7715,7652,60,63,"PACMA",106
34,"34086",102,81,81,2,0,"PACMA",0
47,"47076",17787,13484,13306,179,178,"PACMA",123
38,"38901",1466,908,894,4,14,"PACMA",7
31,"31096",99,79,79,3,0,"PACMA",0
22,"22095",66,52,51,1,1,"PACMA",0
49,"49225",122,68,68,0,0,"PACMA",0
13,"13057",1099,858,849,2,9,"PACMA",0
31,"31205",419,290,289,4,1,"PACMA",4
17,"17112",198,148,147,3,1,"PACMA",0
41,"41098",5161,3792,3732,33,60,"PACMA",63
37,"37170",1361,909,884,9,25,"PACMA",0
37,"37358",159,124,124,0,0,"PACMA",0
43,"43019",1332,911,904,8,7,"PACMA",2
6,"6032",80,68,68,1,0,"PACMA",1
37,"37070",523,371,365,4,6,"PACMA",1
31,"31097",10559,6977,6919,71,58,"PACMA",43
28,"28173",523,384,381,1,3,"PACMA",5
16,"16008",80,63,63,1,0,"PACMA",0
39,"39057",2366,1636,1607,10,29,"PACMA",10
49,"49037",174,139,136,1,3,"PACMA",2
43,"43176",746,564,561,2,3,"PACMA",4
45,"45901",779,542,534,5,8,"PACMA",4
34,"34088",265,195,191,1,4,"PACMA",2
50,"50266",120,77,76,3,1,"PACMA",2
47,"47077",234,172,170,1,2,"PACMA",2
41,"41027",4007,2628,2546,33,82,"PACMA",17
37,"37265",198,167,163,1,4,"PACMA",0
31,"31098",1984,1443,1428,11,15,"PACMA",10
4,"4001",1002,717,710,3,7,"PACMA",3
5,"5103",63,44,44,1,0,"PACMA",0
43,"43099",284,214,214,4,0,"PACMA",1
6,"6034",171,114,114,2,0,"PACMA",0
43,"43177",276,229,227,2,2,"PACMA",2
46,"46206",555,417,408,0,9,"PACMA",6
31,"31099",51,38,38,0,0,"PACMA",0
50,"50040",82,66,66,1,0,"PACMA",0
26,"26161",8,8,8,0,0,"PACMA",0
9,"9429",53,34,34,1,0,"PACMA",0
22,"22102",180,137,136,3,1,"PACMA",0
12,"12024",138,107,107,1,0,"PACMA",0
24,"24052",139,94,93,0,1,"PACMA",0
14,"14059",679,527,521,11,6,"PACMA",2
5,"5104",33,21,19,0,2,"PACMA",0
20,"20081",7690,5382,5363,31,19,"PACMA",24
10,"10077",626,444,441,5,3,"PACMA",1
25,"25216",244,186,186,0,0,"PACMA",1
29,"29019",853,604,588,2,16,"PACMA",2
2,"2057",1947,1358,1333,15,25,"PACMA",1
50,"50268",41,32,32,1,0,"PACMA",0
19,"19230",558,409,406,1,3,"PACMA",13
6,"6037",1656,1033,1018,8,15,"PACMA",3
3,"3059",20710,14788,14685,89,103,"PACMA",133
47,"47080",33,25,24,0,1,"PACMA",0
15,"15012",3603,2484,2422,20,62,"PACMA",13
49,"49007",361,241,233,7,8,"PACMA",0
24,"24054",410,275,271,0,4,"PACMA",1
30,"30040",686,564,560,1,4,"PACMA",3
37,"37174",975,716,705,2,11,"PACMA",0
50,"50195",53,42,38,0,4,"PACMA",0
25,"25125",383,265,265,3,0,"PACMA",1
44,"44172",296,216,216,1,0,"PACMA",2
46,"46003",948,770,757,8,13,"PACMA",4
10,"10201",178,142,141,2,1,"PACMA",0
36,"36041",13691,9022,8916,85,106,"PACMA",87
50,"50119",876,633,625,11,8,"PACMA",0
46,"46140",383,321,321,2,0,"PACMA",0
41,"41901",2692,2101,2051,47,50,"PACMA",13
46,"46258",2617,1925,1914,5,11,"PACMA",15
3,"3061",1060,793,787,5,6,"PACMA",8
40,"40080",51,31,31,0,0,"PACMA",0
14,"14061",687,536,523,1,13,"PACMA",0
30,"30041",14040,8999,8876,94,123,"PACMA",118
25,"25034",2271,1616,1600,12,16,"PACMA",5
39,"39089",131,82,82,0,0,"PACMA",0
31,"31103",40,28,27,0,1,"PACMA",0
37,"37270",184,139,136,2,3,"PACMA",0
16,"16089",381,292,289,8,3,"PACMA",0
10,"10203",4421,2810,2764,15,46,"PACMA",21
22,"22141",115,94,93,0,1,"PACMA",0
9,"9434",1279,966,956,11,10,"PACMA",6
17,"17201",137,103,103,0,0,"PACMA",0
39,"39005",1419,1039,1030,9,9,"PACMA",10
24,"24056",2726,1803,1772,21,31,"PACMA",5
50,"50120",55,42,42,1,0,"PACMA",0
45,"45102",3613,2495,2464,27,31,"PACMA",9
41,"41059",35358,26408,26052,346,356,"PACMA",330
9,"9908",423,254,253,4,1,"PACMA",3
44,"44116",75,58,58,0,0,"PACMA",0
5,"5002",1905,1361,1329,11,32,"PACMA",20
9,"9110",77,50,50,0,0,"PACMA",0
16,"16211",335,228,227,1,1,"PACMA",0
9,"9438",562,447,437,6,10,"PACMA",1
24,"24166",1346,929,916,14,13,"PACMA",2
28,"28180",5317,4011,3959,35,52,"PACMA",11
4,"4007",735,514,509,3,5,"PACMA",11
33,"33053",1078,602,599,10,3,"PACMA",1
37,"37365",162,125,121,0,4,"PACMA",0
16,"16212",233,186,184,0,2,"PACMA",2
47,"47084",1077,794,784,11,10,"PACMA",1
49,"49012",70,34,34,0,0,"PACMA",0
33,"33054",1601,1025,1010,17,15,"PACMA",7
23,"23055",46314,30950,30506,279,444,"PACMA",280
42,"42128",45,40,39,2,1,"PACMA",0
22,"22009",581,387,386,7,1,"PACMA",3
37,"37366",40,34,33,2,1,"PACMA",0
24,"24168",430,325,322,6,3,"PACMA",1
6,"6043",677,493,488,5,5,"PACMA",6
10,"10206",196,135,133,0,2,"PACMA",0
6,"6044",29258,19865,19594,205,271,"PACMA",119
12,"12029",670,524,514,5,10,"PACMA",2
49,"49013",219,160,159,0,1,"PACMA",0
49,"49122",761,517,505,7,12,"PACMA",3
50,"50046",162,125,125,6,0,"PACMA",0
4,"4009",140,109,106,2,3,"PACMA",0
26,"26129",939,657,644,2,13,"PACMA",0
24,"24059",804,466,463,5,3,"PACMA",1
26,"26169",66,51,50,0,1,"PACMA",0
34,"34902",123,91,91,0,0,"PACMA",0
46,"46261",1708,1259,1237,12,22,"PACMA",6
43,"43106",784,605,598,3,7,"PACMA",3
17,"17036",2639,1944,1934,21,10,"PACMA",11
19,"19333",96,68,67,0,1,"PACMA",0
17,"17204",609,429,428,6,1,"PACMA",3
9,"9276",390,256,244,4,12,"PACMA",9
26,"26170",423,303,301,2,2,"PACMA",0
31,"31255",103,79,79,0,0,"PACMA",0
20,"20907",118,82,82,0,0,"PACMA",1
43,"43027",168,129,129,3,0,"PACMA",1
49,"49014",116,83,83,1,0,"PACMA",0
6,"6047",829,618,605,1,13,"PACMA",0
42,"42130",51,42,40,1,2,"PACMA",0
37,"37368",17,12,11,0,1,"PACMA",0
42,"42084",20,15,15,0,0,"PACMA",0
5,"5010",142,102,100,2,2,"PACMA",0
44,"44266",102,81,79,0,2,"PACMA",0
14,"14066",5748,4116,4035,59,81,"PACMA",25
50,"50047",38,24,24,0,0,"PACMA",0
16,"16096",278,219,217,1,2,"PACMA",2
49,"49124",238,170,164,2,6,"PACMA",0
48,"48040",1303,933,926,7,7,"PACMA",3
50,"50124",394,269,266,0,3,"PACMA",0
6,"6048",821,666,653,1,13,"PACMA",0
1,"1021",471,321,319,3,2,"PACMA",1
12,"12032",23728,16870,16726,121,144,"PACMA",167
24,"24062",126,79,79,0,0,"PACMA",1
44,"44001",65,43,43,1,0,"PACMA",1
41,"41036",3903,2708,2645,35,63,"PACMA",26
39,"39095",2266,1637,1619,8,18,"PACMA",7
9,"9444",63,40,40,1,0,"PACMA",0
49,"49126",260,153,150,1,3,"PACMA",0
12,"12111",327,259,255,8,4,"PACMA",1
40,"40055",31,26,26,0,0,"PACMA",1
34,"34104",231,164,162,2,2,"PACMA",0
48,"48041",687,548,547,4,1,"PACMA",3
5,"5013",834,658,653,2,5,"PACMA",1
43,"43108",1787,1293,1282,6,11,"PACMA",18
7,"7016",2970,1891,1865,22,26,"PACMA",25
50,"50125",340,230,229,2,1,"PACMA",0
31,"31111",91,52,52,0,0,"PACMA",0
15,"15084",3039,2002,1981,12,21,"PACMA",4
44,"44268",32,30,30,0,0,"PACMA",0
12,"12060",434,366,360,1,6,"PACMA",1
28,"28017",1280,975,963,10,12,"PACMA",14
49,"49127",2402,1640,1604,18,36,"PACMA",8
50,"50050",87,62,62,1,0,"PACMA",0
17,"17125",136,100,100,3,0,"PACMA",0
45,"45111",56,47,47,1,0,"PACMA",0
37,"37277",74,55,55,0,0,"PACMA",0
5,"5115",509,350,344,0,6,"PACMA",1
6,"6052",3962,2728,2642,26,86,"PACMA",11
19,"19045",122,97,96,0,1,"PACMA",0
7,"7017",899,604,596,10,8,"PACMA",6
21,"21004",1586,994,964,23,30,"PACMA",11
32,"32060",753,520,515,5,5,"PACMA",2
37,"37278",793,570,567,6,3,"PACMA",6
9,"9447",43,37,36,0,1,"PACMA",0
44,"44093",78,62,61,0,1,"PACMA",0
16,"16224",72,60,58,0,2,"PACMA",0
18,"18062",11226,7969,7777,88,192,"PACMA",88
46,"46147",17186,11507,11399,72,108,"PACMA",114
26,"26176",56,43,43,0,0,"PACMA",0
46,"46903",6306,4762,4743,44,19,"PACMA",62
34,"34108",499,391,384,3,7,"PACMA",1
45,"45112",1844,1121,1086,8,35,"PACMA",1
39,"39098",1381,1088,1080,5,8,"PACMA",0
46,"46193",8959,6880,6824,66,56,"PACMA",85
17,"17209",615,472,471,5,1,"PACMA",6
5,"5117",191,155,153,1,2,"PACMA",0
18,"18161",245,199,196,0,3,"PACMA",1
44,"44094",127,103,103,0,0,"PACMA",0
19,"19046",22204,16001,15752,156,249,"PACMA",235
45,"45114",549,400,394,1,6,"PACMA",2
26,"26060",78,51,50,2,1,"PACMA",0
50,"50204",2396,1723,1712,17,11,"PACMA",2
2,"2038",262,197,193,0,4,"PACMA",0
13,"13080",316,226,225,0,1,"PACMA",0
37,"37374",1138,889,872,2,17,"PACMA",3
34,"34109",60,34,34,0,0,"PACMA",0
43,"43032",462,354,350,2,4,"PACMA",0
42,"42142",42,36,36,1,0,"PACMA",0
47,"47187",71,49,49,0,0,"PACMA",0
1,"1031",1136,844,830,1,14,"PACMA",3
41,"41040",11183,8351,8253,71,98,"PACMA",94
31,"31116",57,27,27,3,0,"PACMA",0
25,"25135",997,675,671,3,4,"PACMA",3
19,"19152",540,377,374,2,3,"PACMA",3
21,"21007",6379,4268,4178,66,90,"PACMA",37
22,"22228",532,371,364,4,7,"PACMA",0
50,"50130",354,225,222,1,3,"PACMA",0
40,"40093",74,62,62,1,0,"PACMA",0
24,"24177",467,265,263,2,2,"PACMA",0
14,"14072",983,692,680,6,12,"PACMA",0
22,"22116",1342,915,905,11,10,"PACMA",4
15,"15088",3396,2047,2022,22,25,"PACMA",3
18,"18163",311,206,204,0,2,"PACMA",1
16,"16228",173,147,145,2,2,"PACMA",0
46,"46218",1043,842,829,6,13,"PACMA",4
9,"9129",91,74,74,0,0,"PACMA",0
44,"44183",61,47,47,1,0,"PACMA",0
41,"41042",5872,4477,4424,42,53,"PACMA",31
9,"9294",99,81,78,0,3,"PACMA",2
37,"37282",193,132,131,3,1,"PACMA",1
46,"46082",4981,3547,3523,29,24,"PACMA",30
29,"29004",283,222,218,3,4,"PACMA",1
9,"9130",64,39,39,2,0,"PACMA",0
43,"43034",465,365,365,5,0,"PACMA",1
37,"37377",215,174,173,0,1,"PACMA",0
3,"3073",222,178,178,0,0,"PACMA",1
26,"26063",118,88,88,2,0,"PACMA",0
31,"31119",35,24,24,1,0,"PACMA",0
25,"25230",1541,1105,1099,9,6,"PACMA",3
43,"43035",233,182,182,5,0,"PACMA",1
44,"44099",644,422,421,2,1,"PACMA",1
19,"19050",15,13,13,0,0,"PACMA",0
6,"6014",6503,4235,4181,35,54,"PACMA",17
20,"20007",337,223,221,2,2,"PACMA",1
17,"17133",1262,976,964,7,12,"PACMA",5
16,"16234",23,17,17,0,0,"PACMA",0
44,"44185",88,69,69,2,0,"PACMA",0
36,"36056",4932,3368,3310,24,58,"PACMA",19
10,"10018",1605,974,948,16,26,"PACMA",3
5,"5088",29,22,22,0,0,"PACMA",0
29,"29006",679,461,452,4,9,"PACMA",1
6,"6061",1074,829,819,5,10,"PACMA",0
44,"44100",177,136,135,1,1,"PACMA",1
17,"17046",709,537,531,2,6,"PACMA",3
37,"37128",235,169,168,0,1,"PACMA",0
37,"37284",317,229,222,2,7,"PACMA",0
50,"50233",96,78,78,0,0,"PACMA",1
25,"25170",262,210,210,1,0,"PACMA",0
9,"9458",490,388,385,6,3,"PACMA",8
37,"37378",92,54,54,0,0,"PACMA",0
31,"31121",62,42,42,0,0,"PACMA",1
12,"12069",50,38,38,0,0,"PACMA",0
23,"23070",3813,2384,2354,11,30,"PACMA",5
5,"5022",1580,1202,1193,6,9,"PACMA",5
19,"19051",61,52,52,0,0,"PACMA",0
17,"17134",220,175,174,1,1,"PACMA",4
19,"19248",73,54,54,0,0,"PACMA",0
44,"44009",798,593,589,4,4,"PACMA",1
49,"49026",199,134,134,0,0,"PACMA",1
23,"23071",1704,1278,1258,10,20,"PACMA",3
36,"36058",4957,3043,2994,55,49,"PACMA",23
25,"25140",779,540,539,2,1,"PACMA",1
12,"12041",92,69,69,2,0,"PACMA",0
28,"28026",6767,5058,5024,27,34,"PACMA",47
49,"49249",61,45,45,1,0,"PACMA",0
50,"50057",1331,933,922,10,11,"PACMA",1
42,"42018",127,94,94,1,0,"PACMA",0
20,"20009",11369,7402,7355,32,47,"PACMA",45
31,"31233",91,62,60,2,2,"PACMA",0
45,"45011",279,235,233,4,2,"PACMA",2
34,"34122",83,56,56,0,0,"PACMA",0
40,"40100",262,208,204,4,4,"PACMA",0
32,"32070",495,247,238,4,9,"PACMA",0
50,"50283",69,46,46,0,0,"PACMA",0
25,"25171",2117,1539,1534,5,5,"PACMA",6
49,"49137",167,123,121,0,2,"PACMA",2
9,"9194",1970,1376,1359,15,17,"PACMA",2
40,"40034",74,59,58,0,1,"PACMA",0
6,"6020",1752,1330,1296,6,34,"PACMA",6
49,"49028",108,90,89,1,1,"PACMA",1
5,"5059",92,49,48,0,1,"PACMA",0
36,"36060",30431,19909,19673,206,236,"PACMA",190
5,"5025",78,65,65,0,0,"PACMA",0
40,"40003",116,82,79,3,3,"PACMA",0
29,"29009",1435,971,957,17,14,"PACMA",5
9,"9306",94,69,69,1,0,"PACMA",0
17,"17049",3246,2527,2502,12,25,"PACMA",17
37,"37194",229,161,160,0,1,"PACMA",0
50,"50284",129,98,98,0,0,"PACMA",0
21,"21014",4066,3089,3029,30,60,"PACMA",11
43,"43118",422,338,338,0,0,"PACMA",3
31,"31016",7790,5541,5502,56,39,"PACMA",30
34,"34124",60,45,45,0,0,"PACMA",0
24,"24077",212,166,162,0,4,"PACMA",0
31,"31235",156,112,108,1,4,"PACMA",0
16,"16242",300,245,243,2,2,"PACMA",1
37,"37288",281,220,218,4,2,"PACMA",3
44,"44105",68,53,53,0,0,"PACMA",0
36,"36061",8613,5822,5718,56,104,"PACMA",43
29,"29010",1637,1263,1187,2,76,"PACMA",5
24,"24078",324,228,225,0,3,"PACMA",0
17,"17217",350,287,284,0,3,"PACMA",1
50,"50285",657,448,442,4,6,"PACMA",4
25,"25238",212,161,160,0,1,"PACMA",0
17,"17050",664,554,550,10,4,"PACMA",4
48,"48053",926,704,702,6,2,"PACMA",4
42,"42022",206,147,146,6,1,"PACMA",0
19,"19318",26,18,18,0,0,"PACMA",0
11,"11004",89919,55211,54544,830,667,"PACMA",846
24,"24079",861,601,595,9,6,"PACMA",1
19,"19252",56,44,44,0,0,"PACMA",0
46,"46087",109,94,94,2,0,"PACMA",0
23,"23076",774,606,595,6,11,"PACMA",1
38,"38002",971,577,570,8,7,"PACMA",6
25,"25051",1522,1066,1059,6,7,"PACMA",6
44,"44013",11232,7872,7801,64,71,"PACMA",28
31,"31018",426,287,283,2,4,"PACMA",4
50,"50137",958,740,731,8,9,"PACMA",2
3,"3080",1330,1040,1032,4,8,"PACMA",12
43,"43041",216,156,156,2,0,"PACMA",2
6,"6071",238,192,187,2,5,"PACMA",2
19,"19057",69,51,51,0,0,"PACMA",0
24,"24080",207,155,154,1,1,"PACMA",1
50,"50286",75,54,53,0,1,"PACMA",1
23,"23006",4582,3536,3461,43,75,"PACMA",12
41,"41095",40187,27090,26680,512,410,"PACMA",353
22,"22129",162,110,110,0,0,"PACMA",0
49,"49033",655,440,434,4,6,"PACMA",2
17,"17052",135,93,92,0,1,"PACMA",0
43,"43016",3470,2547,2508,15,39,"PACMA",34
12,"12046",188,135,135,4,0,"PACMA",0
19,"19058",7458,5705,5663,40,42,"PACMA",71
24,"24081",121,72,72,0,0,"PACMA",0
37,"37103",409,295,294,2,1,"PACMA",0
29,"29013",1613,1191,1154,9,37,"PACMA",10
34,"34129",168,118,118,1,0,"PACMA",1
5,"5130",94,77,77,1,0,"PACMA",0
18,"18175",11793,8099,7943,62,156,"PACMA",57
25,"25242",688,494,488,5,6,"PACMA",3
45,"45128",2569,1676,1652,6,24,"PACMA",13
49,"49110",344,196,195,2,1,"PACMA",1
27,"27008",1326,865,853,5,12,"PACMA",7
16,"16004",228,175,174,0,1,"PACMA",0
50,"50139",318,237,237,1,0,"PACMA",0
50,"50288",3440,2513,2486,26,27,"PACMA",24
49,"49258",111,93,93,2,0,"PACMA",0
15,"15006",5159,3008,2960,44,48,"PACMA",16
46,"46021",24053,17331,17194,159,137,"PACMA",160
45,"45019",7560,5216,5135,50,81,"PACMA",51
44,"44109",99,64,64,0,0,"PACMA",0
24,"24083",997,659,647,9,12,"PACMA",4
16,"16118",1351,1022,1009,13,13,"PACMA",7
41,"41052",3032,2162,2092,6,70,"PACMA",15
42,"42161",136,99,99,0,0,"PACMA",0
49,"49146",265,183,181,4,2,"PACMA",0
29,"29089",3138,2262,2186,13,76,"PACMA",10
25,"25243",3729,2370,2349,33,21,"PACMA",18
9,"9151",446,352,346,3,6,"PACMA",3
5,"5034",15,14,13,0,1,"PACMA",0
15,"15007",3164,2081,2060,24,21,"PACMA",4
16,"16248",862,710,700,6,10,"PACMA",7
25,"25055",163,114,114,0,0,"PACMA",1
2,"2086",2389,1567,1554,10,13,"PACMA",2
45,"45130",294,222,222,1,0,"PACMA",2
24,"24084",153,105,102,2,3,"PACMA",0
17,"17056",1780,1379,1374,13,5,"PACMA",10
23,"23082",1850,1292,1279,13,13,"PACMA",3
22,"22133",108,71,71,3,0,"PACMA",0
40,"40010",108,83,82,0,1,"PACMA",0
5,"5035",92,68,68,0,0,"PACMA",0
24,"24194",267,178,177,1,1,"PACMA",0
38,"38006",41593,20823,20624,127,199,"PACMA",295
2,"2901",2196,1441,1419,10,22,"PACMA",3
49,"49260",693,480,473,3,7,"PACMA",0
35,"35015",10752,5289,5222,39,67,"PACMA",61
43,"43124",468,343,339,3,4,"PACMA",2
37,"37005",65,44,44,1,0,"PACMA",0
32,"32007",1413,873,862,2,11,"PACMA",3
39,"39085",7017,5029,4992,23,37,"PACMA",31
31,"31134",172,106,106,1,0,"PACMA",0
34,"34134",44,25,25,0,0,"PACMA",0
25,"25057",208,151,149,4,2,"PACMA",4
17,"17143",145,104,104,0,0,"PACMA",0
42,"42030",91,69,69,2,0,"PACMA",0
46,"46160",1922,1395,1381,4,14,"PACMA",14
22,"22135",173,123,121,0,2,"PACMA",0
24,"24087",582,431,427,3,4,"PACMA",0
50,"50065",56,37,37,0,0,"PACMA",1
45,"45023",2300,1700,1685,19,15,"PACMA",18
16,"16122",244,184,182,1,2,"PACMA",0
25,"25151",731,555,549,1,6,"PACMA",2
12,"12051",437,297,295,3,2,"PACMA",1
15,"15010",1805,1047,1031,19,16,"PACMA",5
27,"27013",3690,2811,2766,30,45,"PACMA",22
46,"46229",903,715,708,5,7,"PACMA",1
6,"6080",1898,1336,1307,6,29,"PACMA",7
10,"10117",238,133,130,0,3,"PACMA",0
32,"32082",1164,736,728,11,8,"PACMA",0
18,"18179",493,315,309,8,6,"PACMA",0
47,"47206",79,66,66,0,0,"PACMA",0
1,"1055",839,557,552,11,5,"PACMA",1
49,"49150",123,95,92,3,3,"PACMA",0
21,"21023",2033,1215,1193,10,22,"PACMA",6
9,"9159",62,49,47,0,2,"PACMA",2
17,"17003",103,85,85,0,0,"PACMA",0
6,"6081",1036,760,745,2,15,"PACMA",5
32,"32010",364,271,267,2,4,"PACMA",1
6,"6082",399,295,291,6,4,"PACMA",0
50,"50067",13928,9831,9699,92,132,"PACMA",55
44,"44113",74,51,51,0,0,"PACMA",1
16,"16253",308,230,228,2,2,"PACMA",0
27,"27014",3144,2009,1985,24,24,"PACMA",4
22,"22248",103,73,73,0,0,"PACMA",0
25,"25182",1043,763,760,8,3,"PACMA",9
50,"50293",392,257,255,2,2,"PACMA",0
6,"6083",46577,31113,30748,338,365,"PACMA",309
34,"34137",24,19,19,2,0,"PACMA",0
37,"37112",158,110,109,2,1,"PACMA",0
24,"24199",398,263,256,4,7,"PACMA",0
45,"45026",219,166,164,1,2,"PACMA",2
9,"9905",373,239,238,2,1,"PACMA",3
17,"17146",3150,2243,2224,8,19,"PACMA",47
47,"47113",134,110,110,0,0,"PACMA",0
45,"45064",3987,2918,2880,33,38,"PACMA",28
6,"6084",1061,780,769,11,11,"PACMA",2
29,"29020",3278,2329,2260,22,69,"PACMA",13
15,"15013",6324,4132,4083,35,49,"PACMA",39
46,"46026",1220,974,965,7,9,"PACMA",7
25,"25060",71,42,42,0,0,"PACMA",0
9,"9907",1526,1140,1119,18,21,"PACMA",12
40,"40210",97,69,69,1,0,"PACMA",0
45,"45138",1058,813,802,5,11,"PACMA",2
35,"35019",32830,18390,18243,87,147,"PACMA",212
44,"44114",233,161,159,0,2,"PACMA",0
28,"28040",16741,10717,10604,79,113,"PACMA",101
48,"48063",354,256,252,1,4,"PACMA",1
26,"26084",7264,5130,5059,61,71,"PACMA",52
15,"15014",3836,2191,2158,27,33,"PACMA",14
19,"19070",65,45,45,0,0,"PACMA",0
45,"45065",264,211,206,1,5,"PACMA",1
2,"2027",274,209,203,1,6,"PACMA",1
37,"37301",84,64,64,1,0,"PACMA",0
46,"46164",12145,8373,8248,44,125,"PACMA",89
6,"6086",1174,767,750,6,17,"PACMA",4
38,"38010",3969,2463,2418,11,45,"PACMA",25
31,"31251",3144,2197,2164,18,33,"PACMA",21
30,"30017",11428,8196,8113,44,83,"PACMA",65
48,"48008",609,415,407,4,8,"PACMA",5
25,"25006",319,229,229,2,0,"PACMA",0
50,"50295",48,41,41,0,0,"PACMA",0
5,"5140",99,83,81,0,2,"PACMA",0
17,"17230",504,383,382,3,1,"PACMA",5
25,"25251",708,526,524,1,2,"PACMA",6
24,"24203",88,62,62,1,0,"PACMA",0
40,"40118",46,32,32,1,0,"PACMA",1
32,"32088",1636,955,944,17,11,"PACMA",4
44,"44203",9,9,9,0,0,"PACMA",3
48,"48064",608,461,461,0,0,"PACMA",3
3,"3035",627,485,485,2,0,"PACMA",4
16,"16015",349,242,239,6,3,"PACMA",1
45,"45030",471,346,334,4,12,"PACMA",2
47,"47116",396,304,302,2,2,"PACMA",0
31,"31252",80,52,52,1,0,"PACMA",0
39,"39035",9142,6574,6517,24,57,"PACMA",42
35,"35020",5941,3740,3702,27,38,"PACMA",34
27,"27019",8188,5478,5395,88,83,"PACMA",40
38,"38012",2286,1520,1510,8,10,"PACMA",5
15,"15016",4558,2747,2705,16,42,"PACMA",11
21,"21029",1514,1036,1003,14,33,"PACMA",4
28,"28043",6190,4031,3969,33,62,"PACMA",34
50,"50148",304,213,211,2,2,"PACMA",0
6,"6090",827,570,553,3,17,"PACMA",3
34,"34147",164,120,120,1,0,"PACMA",0
3,"3008",158,120,118,1,2,"PACMA",0
19,"19074",67,57,57,1,0,"PACMA",0
41,"41034",23576,15461,15214,264,247,"PACMA",156
18,"18088",1526,1000,993,10,7,"PACMA",5
40,"40214",198,160,154,0,6,"PACMA",0
4,"4046",849,617,612,6,5,"PACMA",8
44,"44118",154,109,106,1,3,"PACMA",0
22,"22044",234,166,164,1,2,"PACMA",1
49,"49048",113,88,88,0,0,"PACMA",1
45,"45143",1192,877,865,9,12,"PACMA",5
24,"24207",276,215,215,2,0,"PACMA",0
34,"34010",550,407,399,7,8,"PACMA",0
16,"16265",22,18,18,0,0,"PACMA",0
50,"50022",504,373,369,12,4,"PACMA",3
7,"7046",16884,9184,9097,97,87,"PACMA",142
37,"37014",1140,747,737,7,10,"PACMA",0
49,"49271",176,128,127,3,1,"PACMA",0
43,"43132",375,295,291,1,4,"PACMA",2
10,"10128",5618,3799,3630,37,169,"PACMA",22
34,"34205",55,38,38,0,0,"PACMA",1
44,"44148",74,56,54,0,2,"PACMA",0
42,"42177",61,42,41,0,1,"PACMA",0
16,"16266",356,269,265,4,4,"PACMA",1
34,"34011",379,290,284,2,6,"PACMA",0
46,"46167",342,240,239,0,1,"PACMA",3
37,"37306",238,140,136,3,4,"PACMA",0
47,"47119",89,59,58,2,1,"PACMA",0
4,"4048",1499,964,957,4,7,"PACMA",3
18,"18188",1646,1224,1202,10,22,"PACMA",7
26,"26093",48,34,33,0,1,"PACMA",0
28,"28046",4824,3726,3707,33,19,"PACMA",50
19,"19267",20,15,14,0,1,"PACMA",1
22,"22045",65,52,52,0,0,"PACMA",0
25,"25161",339,221,221,0,0,"PACMA",1
44,"44120",219,147,145,3,2,"PACMA",0
17,"17901",987,733,725,5,8,"PACMA",9
43,"43134",281,217,215,5,2,"PACMA",5
49,"49273",165,90,90,0,0,"PACMA",0
25,"25224",122,94,94,0,0,"PACMA",1
22,"22150",459,325,321,8,4,"PACMA",5
47,"47122",2007,1520,1492,8,28,"PACMA",4
42,"42044",53,37,35,1,2,"PACMA",0
3,"3011",8014,5278,5212,50,66,"PACMA",68
49,"49162",170,117,116,1,1,"PACMA",0
22,"22901",714,433,423,6,10,"PACMA",0
6,"6095",9506,6616,6425,109,191,"PACMA",45
26,"26095",93,71,68,0,3,"PACMA",2
46,"46032",5719,4297,4262,35,35,"PACMA",51
13,"13030",115,81,81,0,0,"PACMA",0
17,"17068",253,191,191,0,0,"PACMA",0
31,"31258",7879,5668,5631,50,37,"PACMA",44
19,"19079",7,6,6,0,0,"PACMA",0
16,"16271",612,482,481,3,1,"PACMA",0
49,"49054",847,576,569,8,7,"PACMA",2
35,"35025",1752,1113,1095,5,18,"PACMA",5
45,"45147",592,449,443,2,6,"PACMA",1
23,"23099",4824,3523,3435,35,88,"PACMA",18
48,"48070",527,357,355,0,2,"PACMA",1
19,"19008",36,30,30,0,0,"PACMA",2
22,"22047",248,202,201,1,1,"PACMA",1
44,"44122",1277,939,934,5,5,"PACMA",3
10,"10010",2206,1308,1281,8,27,"PACMA",5
24,"24101",370,219,213,4,6,"PACMA",1
18,"18095",2054,1475,1433,14,42,"PACMA",29
26,"26096",257,198,193,2,5,"PACMA",2
40,"40025",129,109,107,1,2,"PACMA",0
16,"16272",201,149,147,2,2,"PACMA",0
41,"41067",7273,5114,5036,59,78,"PACMA",46
23,"23101",351,238,238,3,0,"PACMA",0
46,"46170",3417,2618,2577,11,41,"PACMA",8
20,"20032",8654,6000,5972,21,28,"PACMA",25
29,"29029",383,256,254,4,2,"PACMA",2
17,"17128",321,239,238,1,1,"PACMA",4
18,"18096",340,227,226,0,1,"PACMA",0
49,"49165",55,52,52,1,0,"PACMA",0
44,"44123",95,68,68,0,0,"PACMA",0
31,"31041",1671,1118,1105,15,13,"PACMA",13
3,"3099",43101,30222,29885,196,337,"PACMA",248
16,"16273",300,214,211,3,3,"PACMA",0
25,"25165",271,210,208,0,2,"PACMA",0
46,"46239",446,357,352,1,5,"PACMA",1
31,"31151",53,37,37,0,0,"PACMA",0
13,"13081",584,412,405,0,7,"PACMA",2
33,"33005",1357,832,825,11,7,"PACMA",0
43,"43137",1890,1373,1353,8,20,"PACMA",16
9,"9180",132,94,91,1,3,"PACMA",0
4,"4053",12545,8864,8744,67,120,"PACMA",47
45,"45150",428,322,319,3,3,"PACMA",0
24,"24215",149,116,115,0,1,"PACMA",0
37,"37344",229,157,147,2,10,"PACMA",0
6,"6010",1063,760,732,2,28,"PACMA",2
40,"40221",50,38,35,0,3,"PACMA",0
41,"41069",29669,20316,19848,381,468,"PACMA",205
29,"29031",1555,1015,986,6,29,"PACMA",7
3,"3015",12818,9127,9017,46,110,"PACMA",76
40,"40127",36,25,23,0,2,"PACMA",1
5,"5246",48,35,35,0,0,"PACMA",0
50,"50004",475,360,356,2,4,"PACMA",0
5,"5053",76,48,48,0,0,"PACMA",0
21,"21038",1082,688,676,4,12,"PACMA",3
50,"50077",201,140,140,1,0,"PACMA",0
22,"22050",93,77,77,0,0,"PACMA",0
6,"6103",4756,3285,3224,38,61,"PACMA",19
50,"50230",1140,771,767,11,4,"PACMA",2
39,"39044",3921,2805,2783,18,22,"PACMA",20
31,"31190",44,30,30,1,0,"PACMA",0
18,"18034",484,345,342,3,3,"PACMA",1
44,"44034",124,90,90,0,0,"PACMA",0
24,"24105",1512,1054,1047,10,7,"PACMA",7
12,"12065",167,142,141,0,1,"PACMA",0
20,"20036",13208,9102,9056,59,46,"PACMA",61
42,"42052",16,14,14,0,0,"PACMA",0
31,"31264",179,91,90,2,1,"PACMA",2
46,"46241",388,288,283,5,5,"PACMA",2
37,"37219",169,88,85,1,3,"PACMA",0
40,"40030",419,317,314,3,3,"PACMA",0
9,"9029",151,111,108,2,3,"PACMA",3
26,"26103",814,617,603,10,14,"PACMA",2
42,"42053",21,17,17,0,0,"PACMA",0
15,"15028",1392,944,936,4,8,"PACMA",3
34,"34025",52,34,34,1,0,"PACMA",0
42,"42191",183,116,114,5,2,"PACMA",0
12,"12141",92,72,72,0,0,"PACMA",0
11,"11028",32829,21934,21654,310,280,"PACMA",330
12,"12067",514,381,373,3,8,"PACMA",2
30,"30003",25200,16249,16120,159,129,"PACMA",106
42,"42054",18,12,12,0,0,"PACMA",0
40,"40031",546,410,406,3,4,"PACMA",3
48,"48020",272771,184893,183922,1227,971,"PACMA",1182
9,"9456",130,86,86,1,0,"PACMA",0
12,"12011",4583,3228,3177,24,51,"PACMA",39
19,"19120",107,86,86,1,0,"PACMA",2
13,"13041",236,155,155,3,0,"PACMA",0
20,"20068",179,119,119,2,0,"PACMA",1
47,"47064",37,30,29,1,1,"PACMA",0
36,"36057",238417,165843,164264,1641,1579,"PACMA",1701
49,"49025",157,121,118,0,3,"PACMA",0
21,"21041",113074,73295,72313,1063,982,"PACMA",978
5,"5056",91,71,70,0,1,"PACMA",0
15,"15029",5354,3082,3050,46,32,"PACMA",9
2,"2076",313,233,230,2,3,"PACMA",3
19,"19187",42,32,32,0,0,"PACMA",0
46,"46175",429,362,355,3,7,"PACMA",7
46,"46038",302,221,220,1,1,"PACMA",0
34,"34168",45,39,39,1,0,"PACMA",0
50,"50080",34,27,27,0,0,"PACMA",0
34,"34028",132,95,92,2,3,"PACMA",0
38,"38022",18630,11420,11284,87,136,"PACMA",106
44,"44216",27003,19997,19909,80,88,"PACMA",52
22,"22163",426,338,335,0,3,"PACMA",2
24,"24109",857,534,528,8,6,"PACMA",0
44,"44037",447,288,288,1,0,"PACMA",2
18,"18006",4062,2765,2711,25,54,"PACMA",16
21,"21042",15610,8112,8011,164,101,"PACMA",117
9,"9192",54,46,45,1,1,"PACMA",0
45,"45157",2288,1490,1472,5,18,"PACMA",15
11,"11031",76427,49773,49248,654,525,"PACMA",857
3,"3020",94,84,84,1,0,"PACMA",2
45,"45048",360,276,271,2,5,"PACMA",0
48,"48078",37858,25959,25819,157,140,"PACMA",159
47,"47132",39,32,32,1,0,"PACMA",0
49,"49173",335,165,163,4,2,"PACMA",0
22,"22164",42,28,28,0,0,"PACMA",0
45,"45085",1535,1061,1052,11,9,"PACMA",6
47,"47226",148,115,115,1,0,"PACMA",0
36,"36059",4641,2844,2796,29,48,"PACMA",19
4,"4094",215,156,156,0,0,"PACMA",0
7,"7060",2713,1796,1772,17,24,"PACMA",12
14,"14050",2350,1774,1720,20,54,"PACMA",13
31,"31087",179,124,124,3,0,"PACMA",0
29,"29037",215,156,153,1,3,"PACMA",0
19,"19092",395,286,279,2,7,"PACMA",0
34,"34032",38,30,30,0,0,"PACMA",0
9,"9360",26,19,19,0,0,"PACMA",0
14,"14022",3881,2888,2853,15,35,"PACMA",14
16,"16902",124,86,86,1,0,"PACMA",0
49,"49066",437,276,272,2,4,"PACMA",0
45,"45050",505,338,332,2,6,"PACMA",5
13,"13001",1188,865,858,4,7,"PACMA",3
45,"45197",1888,1446,1426,5,20,"PACMA",2
9,"9037",105,94,93,0,1,"PACMA",3
46,"46177",4832,3592,3539,20,53,"PACMA",29
44,"44219",173,118,115,1,3,"PACMA",0
30,"30007",6474,4354,4317,26,37,"PACMA",35
39,"39050",260,164,164,1,0,"PACMA",0
49,"49067",329,200,198,4,2,"PACMA",0
16,"16151",61,51,51,1,0,"PACMA",0
45,"45161",15469,10281,10167,68,114,"PACMA",167
20,"20042",3180,2056,2053,7,3,"PACMA",8
19,"19095",11,7,6,0,1,"PACMA",0
25,"25173",1646,1180,1169,6,11,"PACMA",9
22,"22167",465,358,356,8,2,"PACMA",0
25,"25174",390,312,312,1,0,"PACMA",2
46,"46246",1049,808,793,3,15,"PACMA",0
37,"37322",2462,1580,1537,14,43,"PACMA",3
50,"50237",100,75,75,2,0,"PACMA",0
25,"25081",281,195,193,3,2,"PACMA",1
9,"9197",144,105,103,2,2,"PACMA",1
10,"10026",647,464,452,6,12,"PACMA",0
6,"6115",1243,808,798,8,10,"PACMA",6
32,"32001",5100,3377,3333,32,44,"PACMA",15
4,"4064",2878,1937,1924,16,13,"PACMA",13
24,"24114",2866,1753,1742,15,11,"PACMA",12
5,"5161",545,395,395,0,0,"PACMA",4
37,"37134",209,143,141,3,2,"PACMA",1
47,"47229",221,150,149,0,1,"PACMA",0
34,"34176",127,95,90,3,5,"PACMA",0
16,"16038",27,20,20,0,0,"PACMA",0
46,"46247",972,649,646,3,3,"PACMA",3
20,"20044",355,261,261,1,0,"PACMA",1
37,"37031",329,241,238,3,3,"PACMA",0
22,"22059",1135,765,752,2,13,"PACMA",8
24,"24228",619,370,364,2,6,"PACMA",0
31,"31201",151450,105649,104976,1004,673,"PACMA",616
40,"40037",30,17,17,0,0,"PACMA",0
37,"37354",5479,3969,3905,37,64,"PACMA",36
46,"46179",2136,1624,1596,17,28,"PACMA",14
7,"7065",2319,1429,1411,15,18,"PACMA",15
43,"43042",2215,1723,1710,18,13,"PACMA",19
2,"2017",760,498,493,1,5,"PACMA",0
16,"16906",70,44,44,1,0,"PACMA",0
47,"47138",224,169,166,0,3,"PACMA",0
44,"44042",114,82,81,0,1,"PACMA",0
46,"46180",659,509,500,7,9,"PACMA",15
42,"42064",83,65,65,1,0,"PACMA",0
32,"32003",863,632,619,3,13,"PACMA",3
50,"50086",176,106,102,1,4,"PACMA",1
16,"16908",166,133,132,2,1,"PACMA",0
45,"45055",1004,768,755,4,13,"PACMA",1
20,"20015",1245,880,876,5,4,"PACMA",2
13,"13008",422,280,272,2,8,"PACMA",1
33,"33017",2969,1787,1768,38,19,"PACMA",11
34,"34038",259,183,178,0,5,"PACMA",0
24,"24230",403,268,265,3,3,"PACMA",0
10,"10029",380,284,276,0,8,"PACMA",1
24,"24010",8251,5357,5275,40,82,"PACMA",27
25,"25177",356,252,250,1,2,"PACMA",0
13,"13009",1383,1081,1070,3,11,"PACMA",5
25,"25086",525,410,407,3,3,"PACMA",0
24,"24118",101,72,72,0,0,"PACMA",0
7,"7902",1091,663,645,13,18,"PACMA",5
46,"46181",16967,11951,11835,98,116,"PACMA",124
34,"34039",58,48,47,0,1,"PACMA",0
36,"36003",10023,6877,6789,66,88,"PACMA",45
9,"9372",204,175,169,2,6,"PACMA",0
34,"34041",82,64,64,3,0,"PACMA",0
50,"50013",199,158,158,0,0,"PACMA",1
24,"24119",695,464,458,7,6,"PACMA",4
50,"50166",235,186,186,0,0,"PACMA",2
50,"50240",943,693,683,12,10,"PACMA",5
9,"9047",52,42,41,1,1,"PACMA",0
50,"50241",582,414,406,2,8,"PACMA",2
37,"37327",179,148,147,2,1,"PACMA",0
33,"33018",2804,1830,1806,30,24,"PACMA",11
50,"50903",2268,1685,1670,16,15,"PACMA",11
34,"34181",422,289,285,0,4,"PACMA",3
16,"16910",75,44,44,1,0,"PACMA",0
10,"10155",1073,735,717,6,18,"PACMA",0
37,"37328",159,112,110,1,2,"PACMA",0
36,"36004",10109,6611,6502,79,109,"PACMA",70
37,"37035",162,115,115,1,0,"PACMA",1
25,"25087",54,45,45,0,0,"PACMA",0
13,"13012",381,265,261,1,4,"PACMA",0
34,"34182",746,558,553,9,5,"PACMA",8
16,"16043",88,60,60,3,0,"PACMA",0
47,"47141",112,90,89,0,1,"PACMA",0
18,"18146",930,645,629,10,16,"PACMA",1
6,"6078",500,363,359,1,4,"PACMA",3
40,"40044",134,101,101,3,0,"PACMA",0
17,"17002",578,477,474,2,3,"PACMA",1
44,"44138",120,92,92,0,0,"PACMA",0
49,"49079",104,79,76,0,3,"PACMA",0
17,"17085",293,239,238,0,1,"PACMA",3
5,"5069",73,59,59,0,0,"PACMA",0
47,"47046",124,99,99,1,0,"PACMA",0
37,"37036",55,36,34,0,2,"PACMA",0
47,"47142",121,85,85,0,0,"PACMA",1
46,"46183",6036,4276,4213,21,63,"PACMA",41
48,"48003",14518,10375,10310,49,65,"PACMA",55
4,"4071",362,286,281,2,5,"PACMA",1
9,"9051",164,125,125,0,0,"PACMA",0
17,"17171",177,138,137,0,1,"PACMA",2
5,"5265",83,59,58,1,1,"PACMA",0
48,"48088",134,95,95,0,0,"PACMA",2
42,"42209",134,86,84,4,2,"PACMA",0
34,"34047",1711,1275,1248,18,27,"PACMA",3
41,"41084",2799,2029,1937,9,92,"PACMA",8
30,"30014",1587,1150,1134,4,16,"PACMA",19
34,"34185",69,36,35,0,1,"PACMA",0
28,"28068",11740,8615,8543,72,72,"PACMA",85
20,"20051",6736,4829,4804,22,25,"PACMA",13
37,"37331",186,115,114,2,1,"PACMA",0
22,"22004",123,83,83,0,0,"PACMA",0
6,"6127",2809,2105,2074,9,31,"PACMA",8
49,"49116",356,239,234,4,5,"PACMA",1
44,"44199",39,37,37,2,0,"PACMA",0
42,"42211",84,67,67,0,0,"PACMA",2
4,"4073",327,224,223,0,1,"PACMA",3
18,"18020",489,318,310,2,8,"PACMA",0
3,"3117",377,306,302,2,4,"PACMA",1
23,"23015",1316,979,973,18,6,"PACMA",4
37,"37362",4783,3469,3420,44,49,"PACMA",19
49,"49117",431,294,289,0,5,"PACMA",0
22,"22006",268,167,164,4,3,"PACMA",1
15,"15043",4944,3184,3117,27,67,"PACMA",20
9,"9381",28,19,19,0,0,"PACMA",0
50,"50244",192,131,130,1,1,"PACMA",0
6,"6129",577,438,416,1,22,"PACMA",1
42,"42212",57,45,45,2,0,"PACMA",0
40,"40047",37,23,23,0,0,"PACMA",1
26,"26010",85,66,63,1,3,"PACMA",0
49,"49230",84,69,69,0,0,"PACMA",0
50,"50092",290,218,214,0,4,"PACMA",0
44,"44143",388,298,298,2,0,"PACMA",3
50,"50018",883,622,616,5,6,"PACMA",1
25,"25093",629,455,443,5,12,"PACMA",5
37,"37333",203,125,124,2,1,"PACMA",0
47,"47049",91,58,58,0,0,"PACMA",0
41,"41002",1421,938,911,7,27,"PACMA",3
42,"42213",25,17,16,1,1,"PACMA",0
22,"22178",105,89,89,1,0,"PACMA",0
25,"25094",138,96,93,2,3,"PACMA",2
41,"41003",2373,1747,1708,18,39,"PACMA",16
16,"16165",56,45,45,0,0,"PACMA",1
19,"19001",43,32,32,0,0,"PACMA",0
37,"37040",376,291,288,0,3,"PACMA",0
19,"19138",215,158,154,4,4,"PACMA",0
20,"20903",5033,3355,3341,18,14,"PACMA",28
14,"14034",302,222,215,1,7,"PACMA",1
11,"11903",1769,1116,1101,22,15,"PACMA",9
49,"49084",266,197,195,11,2,"PACMA",1
18,"18119",1708,1264,1240,7,24,"PACMA",6
34,"34051",91,72,70,0,2,"PACMA",1
25,"25154",117,86,85,0,1,"PACMA",0
37,"37010",925,645,638,5,7,"PACMA",1
31,"31213",99,50,50,0,0,"PACMA",1
31,"31177",245,161,159,1,2,"PACMA",1
32,"32014",1028,719,708,6,11,"PACMA",6
10,"10123",575,450,438,1,12,"PACMA",1
4,"4077",296,270,268,3,2,"PACMA",1
38,"38035",10518,5870,5819,37,51,"PACMA",60
15,"15047",2256,1429,1405,25,24,"PACMA",2
37,"37335",384,282,279,1,3,"PACMA",1
25,"25186",207,162,161,0,1,"PACMA",1
34,"34199",1150,767,754,14,13,"PACMA",6
9,"9272",251,166,166,1,0,"PACMA",1
17,"17007",1763,1367,1359,9,8,"PACMA",9
2,"2029",3333,2363,2320,13,43,"PACMA",32
25,"25189",2181,1468,1461,11,7,"PACMA",14
17,"17091",391,296,290,3,6,"PACMA",0
9,"9388",31,26,25,0,1,"PACMA",0
28,"28073",12707,9198,9080,94,118,"PACMA",121
43,"43904",2864,1881,1851,20,30,"PACMA",8
37,"37147",184,126,124,1,2,"PACMA",0
48,"48094",3121,2201,2188,7,13,"PACMA",5
29,"29051",42179,27231,26724,282,507,"PACMA",366
9,"9221",498,380,377,8,3,"PACMA",4
47,"47149",46,33,32,1,1,"PACMA",2
20,"20057",198,148,147,1,1,"PACMA",0
18,"18121",119,79,79,1,0,"PACMA",1
44,"44146",164,133,133,2,0,"PACMA",0
49,"49193",428,261,253,3,8,"PACMA",0
44,"44147",401,264,256,7,8,"PACMA",1
22,"22184",167,132,130,4,2,"PACMA",1
6,"6136",1489,1086,1060,11,26,"PACMA",1
16,"16053",388,306,303,3,3,"PACMA",0
23,"23021",512,406,399,2,7,"PACMA",0
34,"34056",1926,1335,1311,10,24,"PACMA",8
43,"43079",364,290,289,2,1,"PACMA",4
32,"32018",1181,883,871,5,12,"PACMA",1
24,"24023",264,188,185,1,3,"PACMA",0
41,"41006",2733,1776,1742,17,34,"PACMA",10
39,"39093",297,216,214,1,2,"PACMA",0
38,"38038",165135,101564,100807,709,757,"PACMA",1732
20,"20058",740,523,522,3,1,"PACMA",3
41,"41007",12488,7657,7421,126,236,"PACMA",84
31,"31181",133,87,84,1,3,"PACMA",0
48,"48011",9640,6753,6722,41,31,"PACMA",64
15,"15081",976,713,695,4,18,"PACMA",6
23,"23058",8832,6528,6407,57,121,"PACMA",48
46,"46053",525,433,428,2,5,"PACMA",7
43,"43158",74,52,50,0,2,"PACMA",1
17,"17010",332,252,251,2,1,"PACMA",4
20,"20059",8892,6505,6490,18,15,"PACMA",9
5,"5176",221,163,159,0,4,"PACMA",0
42,"42085",179,107,106,2,1,"PACMA",0
37,"37339",295,219,219,5,0,"PACMA",1
34,"34058",182,152,152,0,0,"PACMA",0
19,"19209",40,30,29,0,1,"PACMA",0
6,"6139",498,402,395,4,7,"PACMA",0
9,"9226",54,45,45,2,0,"PACMA",0
43,"43107",387,285,285,3,0,"PACMA",3
17,"17037",112,86,86,1,0,"PACMA",1
25,"25192",727,527,524,4,3,"PACMA",2
10,"10170",231,164,162,2,2,"PACMA",1
12,"12087",26,16,16,0,0,"PACMA",0
43,"43081",629,500,499,2,1,"PACMA",10
28,"28154",5570,3999,3961,29,38,"PACMA",42
16,"16134",4368,3143,3102,22,41,"PACMA",21
9,"9066",54,37,37,0,0,"PACMA",0
22,"22188",75,50,50,1,0,"PACMA",0
46,"46191",1956,1439,1414,8,25,"PACMA",9
9,"9395",121,74,74,1,0,"PACMA",2
6,"6004",1561,1130,1111,7,19,"PACMA",7
45,"45183",2378,1555,1525,16,30,"PACMA",35
4,"4083",1727,1265,1250,8,15,"PACMA",2
34,"34208",48,40,40,1,0,"PACMA",0
45,"45184",204,123,122,0,1,"PACMA",1
25,"25069",426,296,294,0,2,"PACMA",0
34,"34060",133,109,107,0,2,"PACMA",2
16,"16173",175,128,127,0,1,"PACMA",0
44,"44236",60,38,38,0,0,"PACMA",0
43,"43004",6288,4314,4262,36,52,"PACMA",19
48,"48014",1229,845,843,8,2,"PACMA",6
32,"32022",1238,840,835,10,5,"PACMA",2
46,"46192",786,534,519,7,15,"PACMA",8
12,"12088",57,53,53,0,0,"PACMA",0
33,"33031",33775,20484,20184,276,300,"PACMA",166
42,"42183",102,74,74,1,0,"PACMA",0
5,"5212",197,117,117,0,0,"PACMA",0
43,"43161",17103,11905,11838,82,67,"PACMA",118
16,"16099",179,108,105,0,3,"PACMA",2
10,"10051",421,316,308,0,8,"PACMA",0
18,"18030",566,382,380,2,2,"PACMA",0
17,"17013",2765,1999,1985,15,14,"PACMA",27
16,"16175",5071,3807,3732,43,75,"PACMA",15
43,"43083",146,110,109,0,1,"PACMA",2
5,"5180",76,55,53,0,2,"PACMA",0
16,"16060",715,519,513,3,6,"PACMA",0
40,"40058",306,244,240,1,4,"PACMA",0
6,"6145",900,683,669,7,14,"PACMA",2
44,"44152",70,46,46,0,0,"PACMA",0
34,"34213",53,46,46,0,0,"PACMA",0
49,"49095",282,202,201,6,1,"PACMA",2
9,"9071",39,29,29,1,0,"PACMA",0
37,"37155",68,48,48,0,0,"PACMA",0
48,"48903",1800,1358,1353,4,5,"PACMA",5
46,"46125",852,660,650,5,10,"PACMA",6
27,"27058",3283,2275,2241,12,34,"PACMA",14
14,"14043",7406,5323,5211,63,112,"PACMA",21
32,"32025",1014,731,718,5,13,"PACMA",4
29,"29030",770,618,611,4,7,"PACMA",2
13,"13035",947,704,690,6,14,"PACMA",2
36,"36022",9046,5834,5720,37,114,"PACMA",35
22,"22193",272,199,194,4,5,"PACMA",1
12,"12090",102,79,78,1,1,"PACMA",0
36,"36023",8258,5504,5384,44,120,"PACMA",55
50,"50129",212,129,127,0,2,"PACMA",2
31,"31226",572,347,343,4,4,"PACMA",2
41,"41012",3375,2259,2214,26,45,"PACMA",20
37,"37156",4261,2928,2869,23,59,"PACMA",9
48,"48017",13121,8929,8886,45,43,"PACMA",31
39,"39015",828,559,556,3,3,"PACMA",3
12,"12009",17943,12389,12292,102,97,"PACMA",95
28,"28159",589,455,447,4,8,"PACMA",3
47,"47158",859,618,608,4,10,"PACMA",0
31,"31080",486,362,361,4,1,"PACMA",2
13,"13037",776,573,563,2,10,"PACMA",1
26,"26025",84,69,65,2,4,"PACMA",1
9,"9073",964,713,706,3,7,"PACMA",6
6,"6148",957,682,665,1,17,"PACMA",5
25,"25200",318,245,245,0,0,"PACMA",0
39,"39100",849,567,565,5,2,"PACMA",3
5,"5216",209,149,149,0,0,"PACMA",0
34,"34068",29,25,24,0,1,"PACMA",0
44,"44154",240,164,161,1,3,"PACMA",0
22,"22082",288,217,214,0,3,"PACMA",1
46,"46195",2000,1540,1532,3,8,"PACMA",16
25,"25015",336,234,233,3,1,"PACMA",2
6,"6150",777,592,588,0,4,"PACMA",2
42,"42095",1909,1345,1326,32,19,"PACMA",15
36,"36025",2127,1235,1221,5,14,"PACMA",7
26,"26142",789,572,564,6,8,"PACMA",10
49,"49099",96,67,67,0,0,"PACMA",0
13,"13039",14195,10104,9933,122,171,"PACMA",54
45,"45191",524,437,432,2,5,"PACMA",0
9,"9409",117,80,80,0,0,"PACMA",0
48,"48906",736,550,548,2,2,"PACMA",2
39,"39073",10260,7537,7482,42,55,"PACMA",50
15,"15059",10229,6900,6734,85,166,"PACMA",27
9,"9241",244,171,169,6,2,"PACMA",4
40,"40062",56,43,42,0,1,"PACMA",0
16,"16186",403,309,305,3,4,"PACMA",4
3,"3046",1636,1073,1061,7,12,"PACMA",10
49,"49100",281,164,157,2,7,"PACMA",0
24,"24070",3886,2677,2625,18,52,"PACMA",20
50,"50157",289,199,196,1,3,"PACMA",1
15,"15090",1115,711,701,19,10,"PACMA",2
7,"7024",7283,3574,3538,36,36,"PACMA",73
25,"25138",558,427,424,2,3,"PACMA",3
26,"26065",63,46,43,0,3,"PACMA",0
45,"45118",2124,1403,1380,8,23,"PACMA",11
37,"37159",74,59,59,0,0,"PACMA",0
49,"49171",603,433,427,4,6,"PACMA",0
18,"18005",363,232,230,3,2,"PACMA",0
12,"12142",142,113,113,0,0,"PACMA",0
3,"3134",139,107,107,0,0,"PACMA",1
26,"26029",34,26,26,1,0,"PACMA",0
20,"20038",387,294,293,2,1,"PACMA",2
9,"9134",217,142,138,1,4,"PACMA",3
9,"9460",162,141,140,0,1,"PACMA",0
3,"3047",9768,6220,6144,41,76,"PACMA",83
5,"5089",455,342,324,0,18,"PACMA",2
31,"31085",500,365,362,2,3,"PACMA",2
50,"50107",988,758,755,8,3,"PACMA",5
3,"3135",195,134,131,1,3,"PACMA",2
49,"49102",182,130,130,2,0,"PACMA",0
18,"18037",535,417,410,2,7,"PACMA",7
32,"32032",7900,5186,5091,48,95,"PACMA",26
36,"36028",4049,2783,2739,22,44,"PACMA",12
47,"47066",1482,1096,1086,14,10,"PACMA",12
33,"33039",1646,1118,1110,8,8,"PACMA",6
12,"12013",135,106,106,1,0,"PACMA",0
9,"9413",405,267,263,0,4,"PACMA",4
40,"40065",467,338,329,1,9,"PACMA",2
44,"44158",1153,879,872,6,7,"PACMA",3
37,"37350",403,281,274,1,7,"PACMA",2
15,"15062",5597,3406,3360,16,46,"PACMA",25
34,"34074",690,502,490,13,12,"PACMA",0
24,"24150",226,163,162,0,1,"PACMA",2
31,"31123",615,350,347,4,3,"PACMA",1
26,"26147",34,26,25,0,1,"PACMA",0
46,"46176",2077,1362,1348,14,14,"PACMA",20
6,"6110",138,105,102,0,3,"PACMA",0
24,"24223",2533,1727,1705,40,22,"PACMA",7
19,"19311",85,60,59,0,1,"PACMA",0
25,"25112",269,205,200,2,5,"PACMA",0
30,"30031",497,387,382,1,5,"PACMA",4
18,"18039",3343,2293,2252,22,41,"PACMA",11
25,"25205",563,412,407,3,5,"PACMA",3
37,"37351",268,229,226,0,3,"PACMA",0
41,"41092",7681,5408,5299,79,109,"PACMA",38
50,"50260",35,31,31,0,0,"PACMA",0
26,"26033",162,133,132,3,1,"PACMA",3
9,"9415",275,178,178,3,0,"PACMA",1
34,"34225",5016,3708,3650,41,58,"PACMA",30
23,"23074",2984,2271,2236,20,35,"PACMA",11
3,"3050",19420,13210,13116,70,94,"PACMA",173
44,"44247",291,207,206,4,1,"PACMA",0
46,"46200",1840,1475,1455,5,20,"PACMA",6
18,"18040",237,146,145,0,1,"PACMA",0
50,"50186",37,26,26,1,0,"PACMA",0
25,"25022",105,80,79,0,1,"PACMA",0
43,"43170",877,664,661,4,3,"PACMA",5
23,"23040",1438,1175,1159,3,16,"PACMA",12
49,"49216",147,115,109,0,6,"PACMA",1
15,"15065",7134,4869,4785,53,84,"PACMA",32
4,"4096",285,222,222,0,0,"PACMA",2
12,"12097",62,53,51,0,2,"PACMA",1
17,"17191",163,140,140,1,0,"PACMA",0
31,"31199",138,86,84,0,2,"PACMA",0
36,"36032",3527,2407,2369,24,38,"PACMA",12
48,"48912",2321,1684,1670,8,14,"PACMA",11
27,"27901",2249,1373,1360,22,13,"PACMA",9
40,"40166",251,201,201,0,0,"PACMA",1
19,"19126",1701,1223,1207,6,16,"PACMA",20
25,"25207",6443,4525,4492,31,33,"PACMA",14
34,"34228",77,59,59,1,0,"PACMA",1
24,"24042",60,47,47,2,0,"PACMA",0
4,"4097",231,173,173,1,0,"PACMA",0
37,"37165",31,22,22,0,0,"PACMA",0
24,"24154",952,625,618,5,7,"PACMA",1
37,"37260",137,110,109,0,1,"PACMA",0
18,"18141",382,240,237,0,3,"PACMA",0
50,"50111",181,130,130,1,0,"PACMA",0
6,"6162",2885,2067,2032,19,35,"PACMA",13
34,"34229",58,47,47,1,0,"PACMA",0
10,"10189",2499,1747,1700,15,47,"PACMA",7
21,"21077",1739,1266,1235,13,31,"PACMA",4
43,"43120",421,256,254,1,2,"PACMA",1
37,"37166",196,134,133,1,1,"PACMA",0
37,"37323",474,335,325,5,10,"PACMA",2
49,"49109",561,419,415,6,4,"PACMA",0
37,"37065",276,167,167,2,0,"PACMA",0
5,"5096",76,62,62,0,0,"PACMA",1
19,"19023",119,87,85,0,2,"PACMA",2
21,"21078",2641,1718,1670,10,48,"PACMA",11
10,"10110",2226,1431,1400,7,31,"PACMA",9
9,"9144",44,31,31,0,0,"PACMA",0
24,"24155",441,340,334,2,6,"PACMA",2
16,"16195",458,343,338,0,5,"PACMA",0
6,"6901",2125,1549,1520,28,29,"PACMA",14
49,"49143",201,119,118,1,1,"PACMA",1
43,"43173",98,70,68,0,2,"PACMA",1
3,"3901",1137,783,776,9,7,"PACMA",11
24,"24156",220,135,133,0,2,"PACMA",2
26,"26153",10,10,10,1,0,"PACMA",0
25,"25119",2258,1701,1686,11,15,"PACMA",5
48,"48028",682,551,548,3,3,"PACMA",0
41,"41096",6178,4739,4655,60,84,"PACMA",46
22,"22207",121,66,65,0,1,"PACMA",0
19,"19226",37,22,22,0,0,"PACMA",0
24,"24046",893,595,583,6,12,"PACMA",1
50,"50037",125,85,80,0,5,"PACMA",0
46,"46135",9817,7596,7558,58,38,"PACMA",71
40,"40074",246,193,189,2,4,"PACMA",2
1,"1004",1357,952,945,5,7,"PACMA",3
19,"19322",26,20,19,1,1,"PACMA",0
33,"33045",4359,2819,2787,32,32,"PACMA",13
43,"43096",97,76,76,0,0,"PACMA",0
10,"10071",126,78,71,0,7,"PACMA",0
20,"20077",5269,3845,3830,9,15,"PACMA",13
23,"23081",1494,1084,1061,9,23,"PACMA",5
49,"49112",118,72,72,2,0,"PACMA",0
19,"19027",129,97,95,1,2,"PACMA",0
5,"5100",260,193,192,3,1,"PACMA",0
2,"2053",2888,2086,2042,14,44,"PACMA",15
7,"7002",6678,4149,4108,31,41,"PACMA",47
6,"6031",462,285,280,2,5,"PACMA",1
13,"13056",11706,8399,8288,88,111,"PACMA",70
22,"22208",192,150,147,1,3,"PACMA",2
42,"42116",37,30,29,2,1,"PACMA",0
45,"45094",365,274,271,3,3,"PACMA",2
19,"19227",68,42,41,1,1,"PACMA",0
9,"9098",470,318,309,3,9,"PACMA",0
23,"23047",1558,1203,1186,8,17,"PACMA",4
12,"12049",415,317,305,4,12,"PACMA",0
11,"11009",579,399,390,0,9,"PACMA",0
24,"24050",105,77,77,2,0,"PACMA",0
9,"9100",55,33,33,0,0,"PACMA",0
2,"2054",375,288,283,0,5,"PACMA",1
31,"31206",2077,1433,1417,15,16,"PACMA",15
9,"9154",123,90,90,7,0,"PACMA",0
34,"34042",294,224,221,1,3,"PACMA",4
16,"16007",1153,857,847,3,10,"PACMA",5
21,"21022",187,121,116,0,5,"PACMA",2
40,"40205",228,159,157,1,2,"PACMA",0
9,"9317",20,18,18,0,0,"PACMA",0
17,"17114",23268,16423,16333,111,90,"PACMA",92
4,"4901",490,343,343,2,0,"PACMA",1
49,"49227",317,245,244,4,1,"PACMA",1
47,"47173",879,627,622,9,5,"PACMA",6
10,"10075",238,150,148,0,2,"PACMA",0
25,"25212",219,176,176,1,0,"PACMA",1
2,"2055",1055,672,668,2,4,"PACMA",1
9,"9262",160,122,120,2,2,"PACMA",0
37,"37172",846,530,524,6,6,"PACMA",0
12,"12103",87,61,60,0,1,"PACMA",0
22,"22099",490,349,343,2,6,"PACMA",0
19,"19033",47,38,37,1,1,"PACMA",0
43,"43020",2291,1712,1688,19,24,"PACMA",26
39,"39086",358,236,235,2,1,"PACMA",1
42,"42119",141,78,78,1,0,"PACMA",0
9,"9102",33,22,22,0,0,"PACMA",0
47,"47174",271,215,213,4,2,"PACMA",7
3,"3058",4976,3733,3669,20,64,"PACMA",20
37,"37361",84,55,54,1,1,"PACMA",0
4,"4002",1013,711,699,1,12,"PACMA",2
48,"48032",5762,4287,4262,14,25,"PACMA",9
10,"10158",344,247,246,7,1,"PACMA",0
28,"28176",13980,10765,10701,72,64,"PACMA",112
37,"37203",151,114,113,1,1,"PACMA",0
17,"17115",276,208,208,4,0,"PACMA",1
34,"34136",143,89,89,1,0,"PACMA",0
44,"44171",176,115,115,0,0,"PACMA",1
18,"18049",588,418,415,4,3,"PACMA",2
1,"1011",213,162,160,3,2,"PACMA",0
25,"25032",65,53,52,0,1,"PACMA",2
5,"5039",47,43,43,0,0,"PACMA",0
5,"5233",223,174,173,0,1,"PACMA",0
9,"9162",130,102,100,1,2,"PACMA",1
17,"17116",351,261,261,2,0,"PACMA",1
37,"37268",106,62,61,1,1,"PACMA",0
22,"22214",117,92,89,0,3,"PACMA",0
49,"49041",409,287,282,1,5,"PACMA",1
37,"37363",104,81,80,0,1,"PACMA",0
17,"17031",178,117,117,0,0,"PACMA",2
12,"12130",414,329,327,0,2,"PACMA",0
13,"13064",1845,1314,1298,10,16,"PACMA",15
7,"7007",416,277,275,4,2,"PACMA",3
46,"46231",2403,1670,1652,11,18,"PACMA",14
20,"20902",14282,9670,9618,52,52,"PACMA",53
19,"19329",58,46,46,0,0,"PACMA",1
31,"31102",135,60,60,1,0,"PACMA",0
43,"43023",211,171,169,2,2,"PACMA",2
28,"28082",6110,4622,4581,41,41,"PACMA",59
18,"18050",1649,1113,1095,5,18,"PACMA",8
19,"19037",131,109,108,0,1,"PACMA",3
44,"44084",54,46,46,1,0,"PACMA",0
34,"34094",61,45,45,2,0,"PACMA",0
22,"22007",751,527,520,1,7,"PACMA",3
46,"46209",1903,1406,1383,5,23,"PACMA",6
41,"41031",1204,780,769,5,11,"PACMA",2
25,"25061",80,51,51,0,0,"PACMA",0
7,"7042",10846,6354,6299,77,55,"PACMA",86
7,"7009",737,495,488,3,7,"PACMA",6
22,"22217",370,274,269,4,5,"PACMA",0
24,"24165",317,202,199,1,3,"PACMA",0
43,"43903",2332,1502,1487,18,15,"PACMA",8
43,"43024",1545,1019,1014,14,5,"PACMA",23
46,"46050",185,141,141,1,0,"PACMA",0
23,"23017",1498,1153,1129,11,24,"PACMA",0
40,"40115",142,100,100,0,0,"PACMA",0
34,"34143",161,115,112,2,3,"PACMA",0
49,"49044",78,56,53,0,3,"PACMA",0
47,"47147",103,86,82,0,4,"PACMA",0
29,"29067",431757,290824,287855,3289,2969,"PACMA",5011
34,"34245",307,212,212,0,0,"PACMA",0
31,"31104",1751,1147,1125,8,22,"PACMA",5
7,"7010",5078,3353,3318,30,35,"PACMA",56
22,"22107",102,53,53,0,0,"PACMA",0
50,"50121",270,209,208,3,1,"PACMA",1
7,"7043",3431,2196,2166,21,30,"PACMA",19
25,"25220",991,768,762,1,6,"PACMA",3
10,"10205",1934,1071,1042,4,29,"PACMA",7
31,"31215",4670,3270,3219,33,51,"PACMA",27
18,"18054",820,573,569,2,4,"PACMA",0
39,"39091",1881,1297,1291,8,6,"PACMA",1
22,"22218",39,34,34,0,0,"PACMA",0
49,"49121",372,239,233,1,6,"PACMA",1
10,"10002",360,239,236,1,3,"PACMA",1
41,"41904",1789,1125,1109,31,16,"PACMA",8
44,"44175",112,76,75,1,1,"PACMA",0
19,"19332",85,59,57,4,2,"PACMA",1
31,"31216",3867,2592,2566,37,26,"PACMA",13
29,"29069",87188,54019,53240,633,779,"PACMA",740
15,"15079",1437,887,868,8,19,"PACMA",3
42,"42129",678,485,480,6,5,"PACMA",2
5,"5207",645,485,478,4,7,"PACMA",0
34,"34100",132,96,95,1,1,"PACMA",1
37,"37081",879,680,674,2,6,"PACMA",2
20,"20906",128,87,87,0,0,"PACMA",2
44,"44088",24,23,23,0,0,"PACMA",0
5,"5008",202,158,155,0,3,"PACMA",0
31,"31217",327,204,196,1,8,"PACMA",2
23,"23057",727,582,572,7,10,"PACMA",1
25,"25129",161,113,112,0,1,"PACMA",1
5,"5044",244,170,170,1,0,"PACMA",1
3,"3009",46125,33613,33319,315,294,"PACMA",430
24,"24060",561,297,296,2,1,"PACMA",0
46,"46235",21229,15171,15011,126,160,"PACMA",137
40,"40120",195,169,163,0,6,"PACMA",1
18,"18025",277,198,197,0,1,"PACMA",1
5,"5112",95,59,58,0,1,"PACMA",0
7,"7013",7353,4725,4639,43,86,"PACMA",49
44,"44177",101,68,68,1,0,"PACMA",0
28,"28120",1220,910,897,5,13,"PACMA",1
5,"5239",215,163,163,3,0,"PACMA",0
30,"30020",6503,4521,4484,35,37,"PACMA",19
42,"42131",50,39,39,2,0,"PACMA",0
18,"18154",982,668,668,4,0,"PACMA",2
37,"37083",181,155,153,1,2,"PACMA",0
39,"39094",840,611,611,2,0,"PACMA",4
50,"50274",64,46,43,1,3,"PACMA",0
13,"13073",501,392,385,2,7,"PACMA",0
47,"47121",517,410,398,2,12,"PACMA",0
5,"5209",74,58,58,1,0,"PACMA",0
29,"29071",980,580,564,11,16,"PACMA",4
10,"10089",1334,864,837,8,27,"PACMA",1
46,"46099",744,539,535,2,4,"PACMA",11
36,"36048",5248,3429,3378,25,51,"PACMA",23
37,"37276",125,92,92,0,0,"PACMA",0
24,"24171",337,136,134,4,2,"PACMA",0
29,"29072",3291,2360,2307,19,53,"PACMA",13
9,"9120",41,34,33,3,1,"PACMA",0
39,"39011",1587,1178,1178,6,0,"PACMA",6
46,"46077",7338,5447,5356,44,91,"PACMA",30
47,"47183",135,100,100,1,0,"PACMA",0
28,"28089",3856,2866,2829,21,37,"PACMA",28
15,"15083",1029,627,614,5,13,"PACMA",1
31,"31221",1228,823,815,6,8,"PACMA",3
12,"12033",1953,1391,1368,6,23,"PACMA",12
50,"50201",449,345,344,4,1,"PACMA",0
17,"17207",2420,1920,1901,9,19,"PACMA",9
13,"13076",455,359,356,0,3,"PACMA",0
19,"19240",49,36,36,0,0,"PACMA",0
50,"50177",288,196,193,0,3,"PACMA",0
25,"25901",289,214,211,4,3,"PACMA",2
10,"10212",1658,1113,1068,19,45,"PACMA",7
41,"41037",3201,2306,2260,22,46,"PACMA",6
3,"3068",41,38,37,0,1,"PACMA",0
9,"9446",10,7,7,0,0,"PACMA",0
29,"29073",1657,1082,1069,15,13,"PACMA",11
34,"34106",110,92,92,3,0,"PACMA",0
2,"2068",323,239,239,3,0,"PACMA",1
17,"17039",1726,1306,1297,7,9,"PACMA",8
22,"22189",175,142,142,1,0,"PACMA",2
43,"43082",350,276,271,5,5,"PACMA",1
18,"18159",989,765,762,2,3,"PACMA",1
50,"50025",4541,3110,3083,39,27,"PACMA",8
49,"49240",185,125,123,3,2,"PACMA",1
37,"37087",911,675,665,5,10,"PACMA",8
43,"43110",247,178,178,2,0,"PACMA",2
37,"37372",133,99,98,0,1,"PACMA",0
31,"31113",130,77,76,0,1,"PACMA",0
40,"40188",83,63,60,0,3,"PACMA",1
40,"40189",471,344,329,1,15,"PACMA",0
50,"50277",45,34,34,0,0,"PACMA",0
9,"9125",555,386,382,4,4,"PACMA",1
7,"7018",389,238,236,1,2,"PACMA",1
46,"46079",314,244,240,0,4,"PACMA",1
25,"25134",605,457,456,5,1,"PACMA",1
22,"22114",124,75,72,1,3,"PACMA",0
50,"50128",26,23,23,0,0,"PACMA",0
46,"46011",7523,5154,5077,34,77,"PACMA",59
49,"49129",810,541,527,4,14,"PACMA",2
36,"36052",7266,4772,4685,43,87,"PACMA",22
37,"37279",713,488,480,4,8,"PACMA",3
29,"29002",1143,777,766,6,11,"PACMA",2
6,"6055",1976,1343,1313,11,30,"PACMA",4
31,"31225",35,29,28,0,1,"PACMA",0
22,"22016",558,384,382,5,2,"PACMA",8
42,"42011",16,11,11,0,0,"PACMA",0
48,"48044",61957,45253,45063,299,190,"PACMA",230
5,"5017",84,70,67,2,3,"PACMA",0
10,"10095",317,245,239,0,6,"PACMA",0
49,"49166",1193,835,821,7,14,"PACMA",7
9,"9348",131,103,101,0,2,"PACMA",0
13,"13036",752,552,546,1,6,"PACMA",0
14,"14044",1613,1186,1164,10,22,"PACMA",16
16,"16227",109,78,76,0,2,"PACMA",1
37,"37280",70,47,46,0,1,"PACMA",0
5,"5052",85,70,69,0,1,"PACMA",0
47,"47093",795,585,573,7,12,"PACMA",0
9,"9292",72,55,55,3,0,"PACMA",0
47,"47188",98,73,70,0,3,"PACMA",0
6,"6057",530,409,400,0,9,"PACMA",1
42,"42144",419,302,298,6,4,"PACMA",1
10,"10096",3311,2248,2201,15,47,"PACMA",15
50,"50205",72,51,49,0,2,"PACMA",0
5,"5215",156,120,113,0,7,"PACMA",0
22,"22018",303,216,215,3,1,"PACMA",0
39,"39016",23850,17235,17106,70,129,"PACMA",83
10,"10178",724,499,494,3,5,"PACMA",1
18,"18132",3101,2418,2382,23,36,"PACMA",9
46,"46081",9999,7486,7412,47,74,"PACMA",74
47,"47189",151,128,122,1,6,"PACMA",0
12,"12140",1147,849,841,5,8,"PACMA",2
10,"10219",1184,698,686,9,12,"PACMA",1
49,"49023",899,627,620,3,7,"PACMA",3
29,"29079",2326,1609,1582,12,27,"PACMA",8
16,"16104",53,42,42,0,0,"PACMA",0
7,"7022",11659,7045,6965,84,80,"PACMA",75
23,"23067",2405,1765,1724,14,41,"PACMA",9
9,"9455",45,34,33,0,1,"PACMA",0
29,"29005",4507,3012,2965,29,47,"PACMA",27
15,"15089",4299,2924,2887,41,37,"PACMA",19
12,"12116",61,49,49,0,0,"PACMA",0
28,"28023",5159,4052,4019,27,33,"PACMA",44
9,"9131",485,390,388,7,2,"PACMA",0
32,"32066",547,396,396,0,0,"PACMA",0
14,"14074",2225,1775,1743,17,32,"PACMA",3
7,"7023",3776,2425,2386,34,39,"PACMA",28
42,"42015",30,20,20,0,0,"PACMA",0
46,"46014",3156,2324,2294,13,30,"PACMA",18
18,"18165",4265,2870,2820,22,50,"PACMA",44
22,"22907",1463,1016,1006,21,10,"PACMA",1
40,"40161",32,24,23,1,1,"PACMA",0
10,"10181",676,470,462,2,8,"PACMA",1
49,"49207",215,144,143,1,1,"PACMA",0
25,"25017",228,175,174,0,1,"PACMA",2
44,"44064",62,46,46,0,0,"PACMA",0
43,"43088",2013,1429,1420,11,9,"PACMA",17
43,"43166",1646,1183,1176,4,7,"PACMA",23
6,"6015",118127,79482,78553,855,929,"PACMA",797
16,"16236",857,615,608,1,7,"PACMA",1
43,"43036",869,565,557,7,8,"PACMA",9
40,"40097",130,103,102,5,1,"PACMA",0
10,"10101",178,129,125,0,4,"PACMA",0
37,"37024",89,60,60,0,0,"PACMA",0
45,"45156",3334,2561,2502,23,59,"PACMA",11
5,"5057",2418,1785,1748,9,37,"PACMA",8
6,"6063",2924,2141,2108,8,33,"PACMA",3
31,"31232",25687,17548,17304,243,244,"PACMA",155
44,"44101",55,41,40,1,1,"PACMA",0
46,"46152",90,63,63,0,0,"PACMA",0
28,"28097",126,87,87,2,0,"PACMA",0
22,"22233",81,53,53,0,0,"PACMA",0
3,"3105",5510,3879,3792,27,87,"PACMA",26
49,"49136",313,218,217,5,1,"PACMA",0
21,"21012",285,224,221,0,3,"PACMA",0
43,"43116",465,356,352,0,4,"PACMA",1
19,"19157",53,37,37,0,0,"PACMA",1
22,"22022",542,405,403,2,2,"PACMA",5
44,"44189",44,35,35,0,0,"PACMA",0
5,"5220",364,277,274,0,3,"PACMA",2
37,"37098",290,197,197,1,0,"PACMA",0
47,"47193",1625,1251,1236,10,15,"PACMA",7
46,"46221",348,292,290,1,2,"PACMA",3
13,"13090",1005,754,733,4,21,"PACMA",0
40,"40196",30,24,24,0,0,"PACMA",0
27,"27003",1743,1161,1134,18,27,"PACMA",9
30,"30006",833,699,695,1,4,"PACMA",5
5,"5158",346,263,261,0,2,"PACMA",0
22,"22202",147,128,128,3,0,"PACMA",1
6,"6064",847,616,601,3,15,"PACMA",4
16,"16901",624,443,438,5,5,"PACMA",2
38,"38023",126137,79423,78706,605,717,"PACMA",1270
21,"21054",8175,6014,5887,41,127,"PACMA",39
26,"26007",482,360,348,0,12,"PACMA",3
43,"43117",147,119,119,0,0,"PACMA",0
10,"10104",5123,3470,3396,21,74,"PACMA",24
13,"13092",1703,1327,1307,4,20,"PACMA",0
31,"31015",1989,1399,1386,17,13,"PACMA",8
32,"32034",1062,763,753,6,10,"PACMA",1
16,"16111",168,114,111,2,3,"PACMA",2
16,"16240",98,71,69,0,2,"PACMA",0
5,"5125",56,47,46,0,1,"PACMA",1
24,"24112",288,188,186,2,2,"PACMA",0
24,"24184",177,106,105,0,1,"PACMA",0
19,"19160",883,535,530,11,5,"PACMA",8
17,"17136",196,150,150,0,0,"PACMA",3
33,"33069",3379,2249,2231,41,18,"PACMA",15
39,"39022",970,673,668,2,5,"PACMA",1
12,"12043",570,405,397,1,8,"PACMA",2
21,"21045",231,177,174,4,3,"PACMA",2
22,"22126",89,64,64,0,0,"PACMA",0
6,"6068",427,298,294,5,4,"PACMA",1
18,"18071",5636,3909,3807,45,102,"PACMA",42
41,"41048",2195,1445,1400,13,45,"PACMA",4
50,"50136",532,366,361,3,5,"PACMA",0
21,"21015",645,361,356,8,5,"PACMA",0
40,"40199",101,76,72,2,4,"PACMA",0
50,"50211",236,174,173,0,1,"PACMA",0
28,"28104",15528,12342,12234,103,108,"PACMA",113
9,"9140",117,78,77,1,1,"PACMA",1
16,"16001",62,45,45,0,0,"PACMA",0
36,"36901",4154,3094,3029,21,65,"PACMA",16
1,"1044",232,151,148,2,3,"PACMA",1
27,"27006",2441,1479,1460,11,19,"PACMA",10
49,"49031",148,107,105,2,2,"PACMA",0
42,"42061",270,188,186,5,2,"PACMA",1
20,"20013",5433,3906,3893,24,13,"PACMA",8
9,"9039",54,38,37,0,1,"PACMA",0
9,"9473",85,68,64,0,4,"PACMA",0
22,"22128",188,145,143,3,2,"PACMA",2
31,"31127",131,90,86,0,4,"PACMA",1
46,"46019",8932,6721,6647,40,74,"PACMA",43
46,"46224",156,125,124,0,1,"PACMA",1
7,"7031",24972,14866,14757,127,109,"PACMA",197
25,"25240",1366,1030,1021,4,9,"PACMA",4
47,"47198",64,43,43,0,0,"PACMA",0
5,"5063",31,26,26,0,0,"PACMA",1
31,"31128",349,217,215,4,2,"PACMA",1
45,"45200",4471,3351,3269,25,82,"PACMA",15
44,"44050",3113,2173,2154,14,19,"PACMA",0
5,"5129",111,70,69,0,1,"PACMA",0
5,"5226",63,43,42,0,1,"PACMA",0
44,"44193",73,60,60,1,0,"PACMA",0
12,"12123",40,32,32,0,0,"PACMA",0
21,"21048",318,234,229,3,5,"PACMA",4
25,"25913",88,72,72,1,0,"PACMA",0
25,"25146",223,158,155,3,3,"PACMA",0
38,"38003",1517,899,890,5,9,"PACMA",11
46,"46020",3757,2834,2783,16,51,"PACMA",19
45,"45164",166,143,142,1,1,"PACMA",0
44,"44108",306,209,205,1,4,"PACMA",1
37,"37292",91,65,65,0,0,"PACMA",0
10,"10111",1297,888,872,11,16,"PACMA",5
19,"19165",45,39,39,0,0,"PACMA",0
44,"44194",103,67,64,0,3,"PACMA",0
42,"42160",246,177,175,3,2,"PACMA",2
11,"11007",18032,9872,9745,213,127,"PACMA",124
4,"4031",2238,1649,1645,15,4,"PACMA",8
31,"31130",321,203,203,0,0,"PACMA",0
9,"9314",90,75,75,2,0,"PACMA",0
32,"32077",1104,703,700,9,3,"PACMA",5
2,"2085",306,232,226,2,6,"PACMA",0
37,"37293",102,68,68,1,0,"PACMA",0
50,"50214",18,18,14,1,4,"PACMA",0
31,"31131",913,672,664,8,8,"PACMA",4
28,"28033",4177,2972,2936,20,36,"PACMA",46
22,"22243",43,32,31,0,1,"PACMA",0
7,"7034",1074,796,779,9,17,"PACMA",2
21,"21019",592,397,389,6,8,"PACMA",2
49,"49181",333,197,195,2,2,"PACMA",2
19,"19099",286,179,175,1,4,"PACMA",1
47,"47203",54,40,40,0,0,"PACMA",0
40,"40107",90,67,67,0,0,"PACMA",0
38,"38005",5646,3302,3283,24,19,"PACMA",29
33,"33074",3366,2042,2011,35,31,"PACMA",10
26,"26077",16,16,16,0,0,"PACMA",0
13,"13903",498,395,394,0,1,"PACMA",1
20,"20017",8462,5944,5917,11,27,"PACMA",18
50,"50289",53,42,42,1,0,"PACMA",0
22,"22244",42,33,32,1,1,"PACMA",0
50,"50215",20,14,14,0,0,"PACMA",0
43,"43123",71435,49166,48873,318,293,"PACMA",741
48,"48002",7791,5510,5471,42,39,"PACMA",41
17,"17001",575,428,426,4,2,"PACMA",2
37,"37234",314,194,192,3,2,"PACMA",0
16,"16121",227,160,152,0,8,"PACMA",0
37,"37201",238,170,168,0,2,"PACMA",0
19,"19064",64,56,56,0,0,"PACMA",0
40,"40204",145,102,101,0,1,"PACMA",0
42,"42069",1483,896,878,2,18,"PACMA",5
25,"25245",427,312,308,4,4,"PACMA",0
44,"44224",21,14,14,2,0,"PACMA",0
50,"50141",104,80,78,0,2,"PACMA",0
45,"45132",2387,1765,1754,13,11,"PACMA",7
27,"27043",1222,746,737,12,9,"PACMA",0
29,"29017",6404,4575,4468,48,107,"PACMA",41
47,"47109",161,120,120,1,0,"PACMA",0
22,"22246",63,43,43,0,0,"PACMA",0
40,"40109",69,51,50,3,1,"PACMA",0
50,"50142",23,16,16,1,0,"PACMA",0
5,"5134",47,40,40,0,0,"PACMA",0
25,"25247",142,89,89,2,0,"PACMA",0
16,"16009",54,44,44,2,0,"PACMA",0
49,"49149",368,270,266,1,4,"PACMA",1
49,"49185",156,120,116,0,4,"PACMA",0
45,"45133",2798,1957,1922,11,35,"PACMA",11
43,"43125",884,658,645,12,13,"PACMA",4
19,"19065",109,86,85,1,1,"PACMA",0
31,"31245",76,51,48,2,3,"PACMA",0
5,"5232",104,86,83,1,3,"PACMA",0
39,"39030",1874,1199,1187,6,12,"PACMA",1
50,"50143",541,373,367,2,6,"PACMA",1
50,"50066",2903,2095,2078,19,17,"PACMA",31
31,"31002",431,294,290,3,4,"PACMA",2
23,"23012",4004,2726,2689,21,37,"PACMA",3
46,"46047",540,428,420,1,8,"PACMA",6
18,"18114",585,425,424,7,1,"PACMA",1
50,"50169",333,231,230,0,1,"PACMA",0
45,"45171",1329,958,940,4,18,"PACMA",5
18,"18180",636,410,401,2,9,"PACMA",1
16,"16010",134,92,88,0,4,"PACMA",0
46,"46025",2445,1875,1853,16,22,"PACMA",18
47,"47207",256,198,195,3,3,"PACMA",0
46,"46230",14116,10038,9946,63,92,"PACMA",104
10,"10159",314,207,207,2,0,"PACMA",0
43,"43153",11197,7685,7649,53,36,"PACMA",86
39,"39003",261,189,187,2,2,"PACMA",0
28,"28039",134,93,93,1,0,"PACMA",0
27,"27015",3995,2518,2460,25,58,"PACMA",10
46,"46162",1168,839,832,3,7,"PACMA",2
26,"26082",101,79,79,0,0,"PACMA",0
49,"49188",111,75,73,0,2,"PACMA",0
16,"16048",404,300,298,2,2,"PACMA",1
5,"5138",283,218,217,1,1,"PACMA",0
5,"5073",282,210,207,1,3,"PACMA",0
29,"29048",1364,1053,1039,8,14,"PACMA",1
23,"23016",386,313,305,4,8,"PACMA",0
25,"25004",582,437,432,3,5,"PACMA",4
40,"40113",404,308,304,2,4,"PACMA",1
28,"28115",62612,50619,50431,399,188,"PACMA",274
45,"45027",315,249,246,2,3,"PACMA",1
39,"39033",536,375,372,1,3,"PACMA",0
36,"36009",4401,2712,2649,33,63,"PACMA",17
29,"29021",155,111,109,1,2,"PACMA",2
27,"27016",6958,4697,4616,50,81,"PACMA",28
37,"37114",74,58,55,1,3,"PACMA",0
22,"22040",149,119,119,3,0,"PACMA",0
43,"43128",910,665,658,6,7,"PACMA",6
15,"15045",3610,2057,2044,15,13,"PACMA",9
32,"32086",2531,1348,1332,11,16,"PACMA",10
19,"19201",60,44,44,0,0,"PACMA",0
34,"34192",76,59,59,0,0,"PACMA",0
50,"50093",87,66,64,1,2,"PACMA",1
25,"25250",327,269,265,1,4,"PACMA",0
46,"46027",924,746,737,2,9,"PACMA",0
47,"47209",32,23,23,0,0,"PACMA",0
50,"50294",65,45,45,0,0,"PACMA",0
2,"2060",1268,953,939,7,14,"PACMA",2
50,"50146",189,149,149,3,0,"PACMA",1
21,"21037",462,320,313,1,7,"PACMA",0
42,"42172",28,26,26,0,0,"PACMA",0
37,"37334",71,30,30,0,0,"PACMA",0
40,"40017",83,71,68,2,3,"PACMA",0
3,"3091",244,194,193,2,1,"PACMA",2
37,"37207",336,244,240,4,4,"PACMA",1
37,"37115",108,67,65,0,2,"PACMA",0
24,"24093",342,214,212,2,2,"PACMA",2
28,"28042",1261,918,908,9,10,"PACMA",15
39,"39034",255,133,128,2,5,"PACMA",0
2,"2028",111,81,81,0,0,"PACMA",0
42,"42217",33,25,25,0,0,"PACMA",0
42,"42174",174,121,118,4,3,"PACMA",0
3,"3092",6712,4924,4858,35,66,"PACMA",54
17,"17063",179,153,149,0,4,"PACMA",0
28,"28117",99,87,86,0,1,"PACMA",0
3,"3007",173,141,139,0,2,"PACMA",2
31,"31142",1389,909,900,9,9,"PACMA",1
16,"16093",54,45,45,0,0,"PACMA",0
10,"10084",1266,755,717,7,38,"PACMA",0
26,"26128",94,71,71,1,0,"PACMA",0
34,"34201",171,131,130,1,1,"PACMA",1
31,"31253",121,100,100,0,0,"PACMA",0
32,"32089",1206,740,726,8,14,"PACMA",4
42,"42039",216,144,141,1,3,"PACMA",0
26,"26089",111981,80365,79216,893,1149,"PACMA",569
32,"32090",734,448,441,2,7,"PACMA",0
5,"5238",728,529,525,1,4,"PACMA",0
27,"27020",3365,2544,2500,42,44,"PACMA",11
34,"34009",30,26,26,0,0,"PACMA",0
6,"6091",3669,2581,2525,20,56,"PACMA",4
29,"29098",1228,902,876,11,26,"PACMA",3
47,"47023",3057,2369,2359,20,10,"PACMA",24
43,"43052",927,680,674,7,6,"PACMA",9
44,"44205",619,420,415,5,5,"PACMA",1
10,"10167",301,198,198,0,0,"PACMA",0
2,"2031",535,406,401,4,5,"PACMA",4
15,"15018",1087,680,670,13,10,"PACMA",1
24,"24132",610,330,329,5,1,"PACMA",1
16,"16170",646,451,449,5,2,"PACMA",3
22,"22186",189,148,145,3,3,"PACMA",2
19,"19075",58,38,37,3,1,"PACMA",0
17,"17234",181,129,129,1,0,"PACMA",1
37,"37211",208,148,148,0,0,"PACMA",0
9,"9391",347,247,246,2,1,"PACMA",3
49,"49088",80,51,51,0,0,"PACMA",0
49,"49194",331,198,197,0,1,"PACMA",0
40,"40152",732,575,565,10,10,"PACMA",3
21,"21061",5083,3325,3255,36,70,"PACMA",23
37,"37119",99,78,78,1,0,"PACMA",0
40,"40121",249,188,178,1,10,"PACMA",1
49,"49159",269,182,182,2,0,"PACMA",3
29,"29100",2379,1582,1551,22,31,"PACMA",8
44,"44234",71,49,49,0,0,"PACMA",0
3,"3095",4807,3453,3410,31,43,"PACMA",33
34,"34012",342,237,232,3,5,"PACMA",2
10,"10007",627,457,447,3,10,"PACMA",0
49,"49197",155,109,104,0,5,"PACMA",0
6,"6093",4325,3176,3073,26,103,"PACMA",14
50,"50151",607,450,449,12,1,"PACMA",0
3,"3010",332,275,268,1,7,"PACMA",3
3,"3096",5786,4355,4281,38,74,"PACMA",35
37,"37213",83,64,64,0,0,"PACMA",2
42,"42181",384,281,278,3,3,"PACMA",0
40,"40022",195,144,141,2,3,"PACMA",0
47,"47026",50,37,37,1,0,"PACMA",0
15,"15020",3568,2226,2217,19,9,"PACMA",11
19,"19178",27,17,16,0,1,"PACMA",0
46,"46168",2004,1463,1447,12,16,"PACMA",17
38,"38015",4055,2635,2601,16,34,"PACMA",16
10,"10008",1274,921,908,1,13,"PACMA",3
31,"31257",915,654,642,9,12,"PACMA",8
17,"17067",704,551,549,6,2,"PACMA",3
44,"44121",52,42,42,1,0,"PACMA",0
29,"29036",614,393,387,1,6,"PACMA",1
46,"46256",7280,4996,4940,32,56,"PACMA",48
45,"45036",638,455,449,1,6,"PACMA",1
31,"31148",92,62,59,2,3,"PACMA",0
22,"22902",206,147,144,1,3,"PACMA",4
25,"25902",536,406,403,1,3,"PACMA",0
5,"5147",144,101,99,0,2,"PACMA",0
25,"25164",353,259,255,0,4,"PACMA",0
9,"9177",1140,790,780,7,10,"PACMA",5
22,"22151",85,60,60,0,0,"PACMA",0
10,"10213",533,397,385,0,12,"PACMA",0
31,"31149",2285,1531,1520,10,11,"PACMA",0
26,"26174",134,100,99,3,1,"PACMA",0
15,"15033",2421,1673,1655,6,18,"PACMA",9
44,"44209",799,584,573,2,11,"PACMA",1
16,"16023",513,367,367,3,0,"PACMA",2
37,"37310",166,116,115,3,1,"PACMA",0
49,"49164",141,95,92,1,3,"PACMA",1
36,"36051",14358,9408,9255,86,153,"PACMA",82
2,"2003",134196,96374,95521,913,853,"PACMA",921
24,"24213",158,127,126,1,1,"PACMA",1
12,"12063",41,31,31,1,0,"PACMA",0
17,"17903",883,681,676,3,5,"PACMA",6
24,"24214",626,438,433,8,5,"PACMA",0
22,"22903",618,484,482,5,2,"PACMA",0
42,"42048",60,52,52,0,0,"PACMA",0
5,"5051",157,117,115,1,2,"PACMA",1
25,"25071",41,31,30,0,1,"PACMA",0
21,"21036",204,128,121,1,7,"PACMA",2
18,"18193",14934,10301,10127,116,174,"PACMA",118
33,"33004",65304,43473,43153,563,320,"PACMA",424
38,"38017",30964,16228,16102,108,126,"PACMA",248
21,"21066",490,394,389,4,5,"PACMA",1
27,"27026",2299,1385,1368,9,17,"PACMA",3
50,"50154",114,92,92,1,0,"PACMA",0
3,"3014",238937,161861,160809,1308,1052,"PACMA",1934
34,"34214",176,121,120,1,1,"PACMA",0
20,"20033",858,644,638,1,6,"PACMA",4
41,"41068",13963,9596,9407,96,189,"PACMA",57
30,"30025",5016,3663,3623,22,40,"PACMA",31
47,"47157",490,398,397,2,1,"PACMA",2
7,"7053",1209,870,864,10,6,"PACMA",9
23,"23030",1207,998,977,7,21,"PACMA",1
35,"35027",10502,6831,6750,67,81,"PACMA",49
41,"41013",4836,3174,3124,41,50,"PACMA",6
23,"23031",764,660,640,6,20,"PACMA",7
43,"43067",526,426,424,3,2,"PACMA",1
38,"38043",19365,12355,12212,126,143,"PACMA",154
42,"42051",15,9,9,0,0,"PACMA",0
20,"20035",480,361,361,0,0,"PACMA",1
5,"5152",644,498,496,3,2,"PACMA",1
16,"16275",12,12,12,1,0,"PACMA",0
37,"37313",535,395,394,1,1,"PACMA",0
17,"17158",565,296,295,2,1,"PACMA",1
45,"45041",3967,2723,2689,18,34,"PACMA",26
16,"16142",119,90,90,0,0,"PACMA",0
12,"12038",157,101,100,3,1,"PACMA",0
44,"44006",220,152,151,1,1,"PACMA",0
26,"26026",1268,986,970,4,16,"PACMA",6
17,"17099",78,55,55,0,0,"PACMA",0
17,"17016",737,570,563,2,7,"PACMA",5
37,"37126",30,25,25,0,0,"PACMA",0
47,"47222",85,70,70,1,0,"PACMA",1
45,"45153",1568,1168,1162,8,6,"PACMA",3
11,"11027",68774,45571,45137,567,434,"PACMA",573
48,"48075",2066,1524,1508,9,16,"PACMA",2
27,"27029",1425,925,910,11,15,"PACMA",4
33,"33007",1382,804,795,4,9,"PACMA",2
24,"24218",451,310,308,3,2,"PACMA",3
3,"3102",7181,5126,5073,36,53,"PACMA",39
23,"23904",2570,1583,1562,10,21,"PACMA",2
49,"49061",143,98,97,1,1,"PACMA",0
44,"44035",102,82,80,1,2,"PACMA",0
31,"31155",246,165,161,3,4,"PACMA",2
10,"10139",92,66,65,1,1,"PACMA",0
18,"18099",1582,1184,1156,13,28,"PACMA",5
16,"16030",24,18,18,1,0,"PACMA",0
45,"45045",1338,926,915,9,11,"PACMA",2
46,"46105",16126,10958,10847,76,111,"PACMA",131
3,"3133",41333,24527,24340,146,187,"PACMA",296
28,"28024",168,137,136,2,1,"PACMA",0
22,"22119",1267,880,871,4,9,"PACMA",2
14,"14075",552,413,391,5,22,"PACMA",0
10,"10099",563,369,358,3,11,"PACMA",0
46,"46219",125,107,104,0,3,"PACMA",0
41,"41043",669,447,436,11,11,"PACMA",0
13,"13040",839,639,623,7,16,"PACMA",1
25,"25202",108,72,72,2,0,"PACMA",2
22,"22053",783,494,492,6,2,"PACMA",1
4,"4058",342,238,236,3,2,"PACMA",2
37,"37129",248,181,181,1,0,"PACMA",0
44,"44215",167,113,113,2,0,"PACMA",0
29,"29081",250,185,182,2,3,"PACMA",0
50,"50208",1761,1267,1250,16,17,"PACMA",1
17,"17161",1023,844,843,5,1,"PACMA",8
47,"47035",901,659,653,4,6,"PACMA",0
44,"44128",58,39,37,0,2,"PACMA",0
5,"5156",242,145,145,1,0,"PACMA",0
46,"46243",124,93,90,1,3,"PACMA",0
16,"16279",173,109,108,0,1,"PACMA",0
2,"2011",556,429,427,1,2,"PACMA",0
49,"49172",474,278,271,1,7,"PACMA",1
43,"43063",544,376,374,2,2,"PACMA",0
40,"40163",42,35,35,1,0,"PACMA",0
49,"49064",478,297,296,6,1,"PACMA",0
40,"40033",70,55,52,1,3,"PACMA",0
37,"37318",196,132,132,0,0,"PACMA",0
31,"31049",679,461,453,2,8,"PACMA",2
28,"28057",1556,1155,1141,7,14,"PACMA",16
42,"42057",145,70,70,0,0,"PACMA",0
31,"31905",2992,1994,1984,9,10,"PACMA",30
5,"5157",227,146,146,3,0,"PACMA",0
31,"31050",6016,3675,3612,41,63,"PACMA",16
25,"25020",270,202,201,2,1,"PACMA",0
34,"34073",180,123,120,3,3,"PACMA",1
2,"2012",1835,1462,1420,9,42,"PACMA",3
15,"15032",3430,2243,2197,12,46,"PACMA",2
40,"40195",776,573,565,4,8,"PACMA",2
25,"25181",172,137,137,1,0,"PACMA",1
2,"2067",1137,808,794,2,14,"PACMA",6
25,"25031",57,32,32,0,0,"PACMA",0
19,"19091",23,17,17,0,0,"PACMA",0
28,"28058",141836,104142,103011,896,1131,"PACMA",1398
19,"19282",138,107,106,0,1,"PACMA",0
31,"31160",104,83,82,1,1,"PACMA",0
45,"45012",623,482,472,0,10,"PACMA",0
47,"47037",161,128,125,1,3,"PACMA",0
18,"18906",903,641,639,2,2,"PACMA",5
37,"37320",85,65,64,1,1,"PACMA",0
31,"31088",5656,3929,3893,56,36,"PACMA",47
32,"32035",1352,782,768,6,14,"PACMA",4
44,"44082",84,66,66,0,0,"PACMA",0
19,"19190",2284,1632,1613,16,19,"PACMA",8
3,"3107",2785,1766,1746,13,20,"PACMA",26
34,"34174",172,142,136,0,6,"PACMA",1
40,"40134",692,522,509,10,13,"PACMA",3
5,"5190",53,44,43,0,1,"PACMA",0
18,"18011",4403,3002,2947,24,55,"PACMA",36
35,"35033",6393,4147,4072,38,75,"PACMA",29
50,"50010",67,52,52,1,0,"PACMA",0
24,"24226",194,118,118,1,0,"PACMA",0
13,"13003",448,329,319,1,10,"PACMA",2
30,"30008",14560,9974,9840,79,134,"PACMA",99
50,"50163",3846,2863,2840,25,23,"PACMA",25
11,"11034",2319,1520,1487,17,33,"PACMA",5
21,"21046",1729,1212,1187,14,25,"PACMA",5
13,"13004",976,698,694,6,4,"PACMA",1
3,"3109",3003,2186,2151,14,35,"PACMA",18
10,"10025",377,308,299,3,9,"PACMA",1
16,"16152",32,26,26,3,0,"PACMA",0
7,"7063",1434,1025,1016,10,9,"PACMA",14
18,"18908",776,553,528,3,25,"PACMA",1
44,"44070",55,49,49,0,0,"PACMA",0
49,"49220",146,102,98,3,4,"PACMA",0
22,"22088",143,98,97,1,1,"PACMA",0
5,"5062",163,121,119,3,2,"PACMA",0
20,"20043",1718,1189,1183,2,6,"PACMA",1
28,"28061",22757,17091,16965,115,126,"PACMA",155
44,"44220",113,82,82,1,0,"PACMA",0
10,"10149",432,284,280,2,4,"PACMA",0
40,"40136",102,79,77,3,2,"PACMA",0
17,"17080",144,113,113,1,0,"PACMA",0
22,"22168",22,20,19,0,1,"PACMA",0
16,"16244",698,598,585,7,13,"PACMA",0
31,"31164",542,410,408,5,2,"PACMA",1
44,"44144",319,225,223,0,2,"PACMA",0
22,"22250",346,241,241,0,0,"PACMA",4
41,"41022",4255,2735,2667,32,68,"PACMA",11
18,"18909",514,403,403,0,0,"PACMA",0
9,"9043",172,112,111,1,1,"PACMA",1
13,"13007",1219,871,852,4,19,"PACMA",5
45,"45091",376,270,269,3,1,"PACMA",5
40,"40201",42,37,37,0,0,"PACMA",0
47,"47011",554,466,462,7,4,"PACMA",0
18,"18910",710,439,434,1,5,"PACMA",2
27,"27039",4467,3179,3121,47,58,"PACMA",11
46,"46111",11367,7995,7908,66,87,"PACMA",80
46,"46043",135,119,118,0,1,"PACMA",4
30,"30010",6852,5161,5106,25,55,"PACMA",61
24,"24044",150,91,89,2,2,"PACMA",0
5,"5163",1702,1258,1233,5,25,"PACMA",1
24,"24229",376,275,269,2,6,"PACMA",0
19,"19098",20,17,17,0,0,"PACMA",0
44,"44222",125,92,92,0,0,"PACMA",0
31,"31057",1741,1237,1219,6,18,"PACMA",4
10,"10152",444,312,309,2,3,"PACMA",0
25,"25176",307,241,238,3,3,"PACMA",1
5,"5099",451,350,344,3,6,"PACMA",1
18,"18015",424,331,330,4,1,"PACMA",0
49,"49076",330,230,226,9,4,"PACMA",2
3,"3113",4339,2978,2935,23,43,"PACMA",30
44,"44136",48,43,43,1,0,"PACMA",0
17,"17082",435,308,307,1,1,"PACMA",3
46,"46249",9136,6538,6439,73,99,"PACMA",45
22,"22172",520,373,369,5,4,"PACMA",0
9,"9206",52,43,43,0,0,"PACMA",0
47,"47043",306,241,240,4,1,"PACMA",0
24,"24011",182,104,102,3,2,"PACMA",0
38,"38029",1475,752,744,10,8,"PACMA",14
37,"37033",94,67,67,0,0,"PACMA",2
2,"2020",425,336,332,4,4,"PACMA",2
13,"13010",872,615,601,3,14,"PACMA",6
49,"49077",157,80,80,0,0,"PACMA",0
30,"30012",9085,6704,6599,46,105,"PACMA",47
18,"18912",1352,926,912,7,14,"PACMA",3
40,"40141",822,584,568,9,16,"PACMA",0
46,"46113",2558,1791,1773,7,18,"PACMA",25
9,"9425",472,311,309,3,2,"PACMA",0
50,"50191",446,327,326,1,1,"PACMA",1
46,"46136",2598,1875,1851,14,24,"PACMA",27
9,"9208",176,121,120,4,1,"PACMA",3
10,"10032",1588,1114,1099,6,15,"PACMA",2
50,"50088",274,195,191,2,4,"PACMA",0
12,"12021",4398,3314,3277,32,37,"PACMA",15
49,"49183",90,67,65,2,2,"PACMA",0
9,"9485",55,41,41,0,0,"PACMA",0
28,"28066",7575,5771,5718,58,53,"PACMA",69
50,"50290",360,260,255,5,5,"PACMA",0
9,"9209",4404,2997,2950,31,47,"PACMA",15
13,"13028",10230,7682,7559,65,123,"PACMA",33
3,"3001",337,260,258,0,2,"PACMA",2
21,"21052",4403,2688,2631,26,57,"PACMA",12
43,"43072",90,69,67,1,2,"PACMA",0
43,"43151",107,88,88,0,0,"PACMA",1
15,"15041",9569,6362,6269,104,93,"PACMA",36
42,"42070",31,23,23,1,0,"PACMA",0
26,"26006",1833,1358,1335,7,23,"PACMA",11
28,"28067",4416,3359,3311,18,48,"PACMA",19
19,"19103",247,205,202,1,3,"PACMA",0
10,"10076",791,537,525,10,12,"PACMA",0
21,"21053",3306,2161,2106,11,55,"PACMA",13
46,"46115",330,219,213,0,6,"PACMA",0
47,"47143",104,67,67,0,0,"PACMA",0
37,"37330",314,227,223,2,4,"PACMA",1
16,"16045",180,128,127,0,1,"PACMA",0
24,"24122",1292,818,810,7,8,"PACMA",4
4,"4072",311,212,211,0,1,"PACMA",2
39,"39068",642,442,438,1,4,"PACMA",7
19,"19229",58,53,53,0,0,"PACMA",0
7,"7049",1479,935,918,5,17,"PACMA",4
6,"6035",851,630,620,0,10,"PACMA",3
31,"31208",2568,1855,1835,24,20,"PACMA",9
17,"17198",437,307,306,0,1,"PACMA",2
44,"44258",53,46,46,0,0,"PACMA",0
38,"38032",13579,8941,8880,92,61,"PACMA",114
37,"37142",554,396,394,5,2,"PACMA",1
48,"48005",116,80,79,0,1,"PACMA",0
18,"18115",2635,1766,1738,13,28,"PACMA",7
14,"14032",388,302,293,0,9,"PACMA",0
17,"17012",1175,845,842,4,3,"PACMA",11
46,"46139",4520,3486,3457,18,29,"PACMA",17
23,"23087",11169,8193,8045,79,148,"PACMA",79
43,"43101",146,112,112,2,0,"PACMA",0
10,"10160",240,179,177,2,2,"PACMA",1
20,"20052",1050,746,743,4,3,"PACMA",3
32,"32011",916,512,507,3,5,"PACMA",2
46,"46257",5436,3972,3933,28,39,"PACMA",47
19,"19293",1945,1402,1388,19,14,"PACMA",27
48,"48006",307,242,240,3,2,"PACMA",1
26,"26083",337,255,250,3,5,"PACMA",1
3,"3060",105,78,77,0,1,"PACMA",0
46,"46208",1071,854,845,2,9,"PACMA",3
9,"9268",89,62,62,0,0,"PACMA",0
12,"12080",1883,1472,1438,8,34,"PACMA",4
34,"34050",187,136,136,1,0,"PACMA",0
34,"34190",50,33,33,1,0,"PACMA",0
50,"50042",19,17,17,1,0,"PACMA",1
17,"17032",1745,1139,1133,6,6,"PACMA",14
17,"17200",624,469,467,6,2,"PACMA",9
9,"9269",29,24,23,0,1,"PACMA",0
43,"43154",126,104,104,0,0,"PACMA",1
29,"29049",2890,2069,2034,12,35,"PACMA",9
50,"50245",74,51,51,0,0,"PACMA",0
36,"36042",18125,11975,11775,126,200,"PACMA",96
45,"45175",603,476,473,1,3,"PACMA",0
16,"16206",184,126,125,4,1,"PACMA",0
13,"13065",2777,1766,1728,10,38,"PACMA",6
41,"41902",4599,2906,2868,50,38,"PACMA",18
9,"9218",350,254,252,5,2,"PACMA",1
37,"37041",71,53,53,0,0,"PACMA",0
31,"31176",2919,1974,1933,27,41,"PACMA",24
6,"6132",823,543,533,4,10,"PACMA",2
31,"31250",2761,1776,1759,13,17,"PACMA",7
49,"49096",155,113,112,2,1,"PACMA",0
31,"31152",1255,826,817,8,9,"PACMA",0
44,"44229",141,99,98,1,1,"PACMA",0
47,"47115",276,212,211,1,1,"PACMA",0
43,"43155",22586,15295,15204,120,91,"PACMA",124
47,"47021",73,57,55,0,2,"PACMA",0
26,"26013",330,243,242,2,1,"PACMA",5
25,"25219",146,111,111,1,0,"PACMA",0
30,"30018",8399,6226,6148,28,78,"PACMA",44
13,"13022",348,244,239,1,5,"PACMA",1
10,"10164",707,391,382,4,9,"PACMA",0
42,"42127",37,26,26,1,0,"PACMA",0
17,"17202",3848,2632,2615,16,17,"PACMA",36
46,"46119",761,587,580,6,7,"PACMA",6
17,"17175",559,348,343,5,5,"PACMA",3
36,"36014",1867,1265,1243,16,22,"PACMA",11
13,"13023",8944,6251,6165,50,86,"PACMA",32
33,"33026",8201,5014,4974,74,40,"PACMA",19
46,"46260",2685,2072,2053,14,19,"PACMA",26
37,"37012",144,111,111,0,0,"PACMA",0
46,"46028",383,305,299,8,6,"PACMA",2
15,"15058",28761,20250,20098,261,152,"PACMA",167
47,"47063",86,68,68,0,0,"PACMA",0
32,"32016",714,494,493,12,1,"PACMA",0
25,"25097",89,71,71,2,0,"PACMA",0
44,"44052",75,54,54,0,0,"PACMA",0
32,"32017",1193,735,724,3,11,"PACMA",1
28,"28151",3274,2344,2310,16,34,"PACMA",19
19,"19204",150,105,104,3,1,"PACMA",1
17,"17008",3605,2595,2577,8,18,"PACMA",13
50,"50174",80,58,57,0,1,"PACMA",0
10,"10166",307,197,195,0,2,"PACMA",1
44,"44232",364,255,255,3,0,"PACMA",1
44,"44053",103,87,85,1,2,"PACMA",0
40,"40151",43,31,31,0,0,"PACMA",0
19,"19208",39,32,32,0,0,"PACMA",0
10,"10086",304,228,225,4,3,"PACMA",1
12,"12003",954,710,702,6,8,"PACMA",1
10,"10045",971,686,682,4,4,"PACMA",1
45,"45106",7418,5380,5306,34,74,"PACMA",23
34,"34149",23,20,20,0,0,"PACMA",0
12,"12058",59,47,45,1,2,"PACMA",1
9,"9063",215,184,181,2,3,"PACMA",3
45,"45070",1412,1158,1136,7,22,"PACMA",5
10,"10209",259,151,149,0,2,"PACMA",0
46,"46212",1620,1130,1112,12,18,"PACMA",5
24,"24096",105,56,54,1,2,"PACMA",1
17,"17092",3462,2414,2389,14,25,"PACMA",33
43,"43062",269,229,226,5,3,"PACMA",2
43,"43080",230,192,192,2,0,"PACMA",0
48,"48096",6516,4862,4816,33,46,"PACMA",31
22,"22076",285,207,203,4,4,"PACMA",0
12,"12004",4149,2945,2910,25,35,"PACMA",23
43,"43028",2770,1784,1770,7,14,"PACMA",33
41,"41017",15907,11486,11302,158,184,"PACMA",163
27,"27053",497,342,334,2,8,"PACMA",0
21,"21062",1403,849,838,10,11,"PACMA",1
34,"34904",300,188,186,0,2,"PACMA",1
25,"25131",394,281,279,3,2,"PACMA",0
19,"19042",22,18,17,0,1,"PACMA",0
17,"17038",377,303,301,0,2,"PACMA",3
19,"19007",433,316,310,1,6,"PACMA",1
16,"16057",62,45,45,0,0,"PACMA",1
30,"30022",17108,11041,10851,100,190,"PACMA",63
24,"24134",3287,2278,2226,18,52,"PACMA",5
44,"44235",87,65,64,1,1,"PACMA",0
2,"2034",1323,1024,1018,6,6,"PACMA",4
37,"37340",141,97,97,1,0,"PACMA",0
40,"40155",3897,2920,2880,56,40,"PACMA",33
31,"31184",65,41,40,0,1,"PACMA",0
17,"17011",645,518,514,10,4,"PACMA",3
31,"31074",394,293,292,5,1,"PACMA",2
15,"15052",4070,2512,2488,18,24,"PACMA",15
24,"24161",294,208,204,3,4,"PACMA",1
9,"9445",41,28,27,1,1,"PACMA",0
9,"9321",1576,1151,1135,10,16,"PACMA",5
40,"40056",31,21,20,0,1,"PACMA",0
37,"37049",125,76,76,0,0,"PACMA",0
29,"29056",1047,708,696,5,12,"PACMA",3
50,"50100",304,215,212,1,3,"PACMA",0
37,"37050",66,52,52,1,0,"PACMA",0
48,"48023",579,451,448,0,3,"PACMA",1
13,"13031",2475,1855,1834,9,21,"PACMA",10
34,"34210",98,82,82,1,0,"PACMA",0
9,"9343",92,66,65,0,1,"PACMA",0
21,"21064",6674,4503,4426,68,77,"PACMA",41
25,"25234",4139,2786,2772,13,14,"PACMA",26
25,"25021",2513,1668,1662,17,6,"PACMA",7
43,"43030",483,356,351,2,5,"PACMA",4
12,"12034",1389,1022,1002,5,20,"PACMA",3
24,"24139",2071,1371,1346,15,25,"PACMA",5
2,"2036",93,66,66,0,0,"PACMA",0
24,"24100",737,506,502,9,4,"PACMA",2
46,"46056",176,142,142,0,0,"PACMA",0
37,"37342",250,190,189,3,1,"PACMA",2
47,"47090",2447,1823,1784,15,39,"PACMA",9
40,"40220",64,46,45,0,1,"PACMA",2
28,"28157",690,471,467,1,4,"PACMA",3
40,"40157",39,30,30,0,0,"PACMA",1
9,"9231",57,35,35,2,0,"PACMA",0
47,"47059",94,64,64,0,0,"PACMA",1
13,"13034",58768,42473,42028,359,445,"PACMA",337
10,"10174",171,112,110,0,2,"PACMA",2
41,"41011",15462,11019,10696,183,323,"PACMA",47
49,"49202",173,103,101,0,2,"PACMA",0
25,"25013",2099,1430,1414,13,16,"PACMA",9
44,"44181",65,57,57,0,0,"PACMA",0
17,"17097",200,170,167,2,3,"PACMA",1
37,"37249",37,28,28,0,0,"PACMA",0
43,"43163",26162,17276,17128,98,148,"PACMA",262
26,"26059",1109,801,791,6,10,"PACMA",4
33,"33033",9381,5848,5770,88,78,"PACMA",28
10,"10176",344,223,213,2,10,"PACMA",1
50,"50254",179,115,113,0,2,"PACMA",1
24,"24066",439,274,273,3,1,"PACMA",1
50,"50076",70,56,56,0,0,"PACMA",1
19,"19305",139,104,103,1,1,"PACMA",0
31,"31188",319,197,191,3,6,"PACMA",2
16,"16274",97,76,75,1,1,"PACMA",0
25,"25052",1541,1183,1176,7,7,"PACMA",4
28,"28001",70,48,47,1,1,"PACMA",0
5,"5118",64,41,41,1,0,"PACMA",0
6,"6056",447,351,340,2,11,"PACMA",2
43,"43007",631,479,474,1,5,"PACMA",5
5,"5119",24,17,17,1,0,"PACMA",0
13,"13082",25917,16834,16670,137,164,"PACMA",176
35,"35005",1009,680,668,2,12,"PACMA",1
20,"20065",2921,1983,1970,16,13,"PACMA",5
5,"5183",123,103,100,0,3,"PACMA",0
33,"33035",11214,7359,7303,102,56,"PACMA",59
50,"50255",199,152,147,3,5,"PACMA",2
17,"17211",837,677,674,6,3,"PACMA",3
28,"28160",8709,6507,6460,62,47,"PACMA",73
37,"37090",68,47,47,0,0,"PACMA",0
15,"15057",12077,8109,8018,83,91,"PACMA",61
29,"29032",6655,4900,4775,36,125,"PACMA",31
6,"6013",261,209,204,4,5,"PACMA",0
43,"43165",571,469,467,2,2,"PACMA",2
40,"40160",93,65,62,0,3,"PACMA",1
37,"37168",397,271,266,3,5,"PACMA",0
9,"9093",162,131,131,1,0,"PACMA",3
21,"21070",6294,4232,4124,64,108,"PACMA",12
5,"5087",147,108,107,3,1,"PACMA",0
23,"23033",1325,1008,989,11,19,"PACMA",5
46,"46059",1244,1007,995,5,12,"PACMA",10
45,"45081",19268,13690,13516,104,174,"PACMA",196
38,"38045",3542,1825,1801,7,24,"PACMA",17
27,"27061",1018,704,683,12,21,"PACMA",5
16,"16066",2280,1765,1734,18,31,"PACMA",13
5,"5185",96,63,61,1,2,"PACMA",1
18,"18036",3986,2956,2917,22,39,"PACMA",28
4,"4020",302,207,206,2,1,"PACMA",0
10,"10140",1109,778,769,7,9,"PACMA",1
31,"31901",15487,11077,10991,117,86,"PACMA",82
44,"44156",47,31,31,0,0,"PACMA",0
31,"31083",49,39,39,1,0,"PACMA",3
25,"25110",2745,1943,1927,13,16,"PACMA",16
6,"6152",1273,888,867,7,21,"PACMA",6
12,"12093",161,111,109,2,2,"PACMA",1
10,"10180",4206,2609,2574,13,35,"PACMA",11
24,"24193",363,264,264,1,0,"PACMA",0
37,"37004",25,18,18,0,0,"PACMA",0
26,"26105",2188,1564,1536,24,28,"PACMA",9
37,"37096",203,144,144,2,0,"PACMA",0
28,"28130",28569,22050,21799,187,251,"PACMA",271
45,"45046",2369,1679,1651,11,28,"PACMA",9
7,"7035",1595,1095,1078,13,17,"PACMA",4
20,"20008",713,424,424,5,0,"PACMA",0
44,"44244",67,40,40,0,0,"PACMA",0
6,"6154",2799,1851,1782,20,69,"PACMA",4
23,"23037",518,403,398,10,5,"PACMA",1
28,"28110",2029,1498,1478,9,20,"PACMA",7
13,"13089",1609,1248,1228,10,20,"PACMA",1
18,"18135",4385,2882,2798,24,84,"PACMA",12
45,"45084",2103,1533,1508,7,25,"PACMA",6
31,"31195",169,108,108,0,0,"PACMA",0
26,"26067",22,18,18,3,0,"PACMA",0
9,"9244",45,31,31,2,0,"PACMA",0
43,"43011",1086,862,860,5,2,"PACMA",3
48,"48022",2305,1434,1425,11,9,"PACMA",5
23,"23038",3786,2934,2900,21,34,"PACMA",20
18,"18136",1778,1320,1284,14,36,"PACMA",7
10,"10061",1591,1010,992,9,18,"PACMA",6
48,"48909",201,158,157,0,1,"PACMA",0
19,"19220",2608,1673,1653,10,20,"PACMA",45
34,"34223",203,147,143,1,4,"PACMA",0
50,"50134",120,85,82,4,3,"PACMA",0
9,"9303",73,58,58,0,0,"PACMA",0
9,"9035",284,191,190,2,1,"PACMA",0
4,"4060",416,286,282,2,4,"PACMA",0
22,"22014",227,164,162,5,2,"PACMA",0
44,"44141",122,88,85,0,3,"PACMA",0
20,"20060",87,75,75,0,0,"PACMA",0
41,"41101",6025,4299,4213,53,86,"PACMA",26
43,"43178",1435,1071,1066,2,5,"PACMA",12
26,"26032",43,36,35,0,1,"PACMA",0
17,"17105",248,187,186,2,1,"PACMA",2
21,"21074",2736,1826,1790,19,36,"PACMA",5
10,"10091",351,275,271,2,4,"PACMA",1
39,"39078",1410,1004,997,5,7,"PACMA",1
24,"24040",416,293,292,2,1,"PACMA",2
9,"9084",165,116,111,1,5,"PACMA",0
42,"42155",146,83,80,2,3,"PACMA",0
39,"39087",41241,29341,29084,152,257,"PACMA",176
1,"1056",202,107,107,0,0,"PACMA",0
2,"2046",1125,892,870,12,22,"PACMA",9
10,"10186",951,756,735,6,21,"PACMA",4
18,"18138",2470,1597,1573,25,24,"PACMA",3
31,"31089",236,168,167,1,1,"PACMA",0
28,"28059",4516,3343,3299,30,44,"PACMA",26
16,"16191",850,664,653,11,11,"PACMA",2
31,"31125",271,173,171,3,2,"PACMA",0
24,"24041",513,312,305,4,7,"PACMA",0
36,"36031",563,426,420,7,6,"PACMA",5
50,"50187",55,42,42,0,0,"PACMA",0
16,"16073",190,153,153,1,0,"PACMA",0
3,"3138",3190,2244,2207,9,37,"PACMA",16
49,"49107",115,70,70,0,0,"PACMA",0
49,"49219",7196,4613,4528,64,85,"PACMA",26
37,"37353",122,82,80,0,2,"PACMA",1
9,"9086",652,479,471,3,8,"PACMA",2
44,"44249",40,30,30,0,0,"PACMA",0
9,"9417",42,31,31,1,0,"PACMA",0
44,"44161",428,294,292,2,2,"PACMA",0
5,"5191",121,99,99,0,0,"PACMA",0
39,"39023",6563,4788,4753,14,35,"PACMA",24
9,"9363",906,660,655,5,5,"PACMA",1
16,"16113",3065,2142,2108,13,34,"PACMA",9
10,"10067",10210,7090,6946,62,144,"PACMA",21
32,"32038",387,253,251,4,2,"PACMA",3
48,"48026",1132,834,832,2,2,"PACMA",5
26,"26151",412,317,317,4,0,"PACMA",2
25,"25023",4560,3350,3334,24,16,"PACMA",15
9,"9088",63,31,30,0,1,"PACMA",0
37,"37196",70,50,50,0,0,"PACMA",0
30,"30033",10377,7330,7215,59,115,"PACMA",51
36,"36902",5028,3453,3396,19,57,"PACMA",29
18,"18022",13875,8948,8764,98,184,"PACMA",95
32,"32050",2254,1630,1612,15,18,"PACMA",3
10,"10163",348,239,238,2,1,"PACMA",1
9,"9025",110,61,58,0,3,"PACMA",1
28,"28169",1577,1214,1209,7,5,"PACMA",17
37,"37261",213,153,149,0,4,"PACMA",0
25,"25208",337,242,241,2,1,"PACMA",2
9,"9311",59,45,45,0,0,"PACMA",0
11,"11036",683,401,395,15,6,"PACMA",5
40,"40234",375,278,269,3,9,"PACMA",0
46,"46225",351,267,262,1,5,"PACMA",7
31,"31202",4360,2806,2767,30,39,"PACMA",10
43,"43095",2583,1864,1854,12,10,"PACMA",24
40,"40039",180,133,133,0,0,"PACMA",0
41,"41023",7999,5500,5435,60,65,"PACMA",32
42,"42025",1125,741,732,12,9,"PACMA",4
19,"19225",851,618,611,2,7,"PACMA",9
2,"2051",1654,1115,1101,13,14,"PACMA",0
19,"19321",34,28,28,0,0,"PACMA",0
17,"17194",73,56,56,0,0,"PACMA",1
13,"13054",4870,3630,3575,26,55,"PACMA",14
31,"31118",156,104,104,3,0,"PACMA",0
42,"42145",129,105,104,1,1,"PACMA",0
45,"45165",62598,43750,43259,329,491,"PACMA",325
47,"47169",62,52,52,0,0,"PACMA",0
9,"9094",53,42,42,0,0,"PACMA",0
26,"26154",10,10,9,1,1,"PACMA",0
6,"6029",1174,873,865,5,8,"PACMA",4
18,"18045",1065,720,690,11,30,"PACMA",2
7,"7001",3647,2430,2383,26,47,"PACMA",24
41,"41024",22819,14767,14455,169,312,"PACMA",143
17,"17195",338,274,272,1,2,"PACMA",0
15,"15038",2126,1312,1296,12,16,"PACMA",6
50,"50087",28,19,19,0,0,"PACMA",0
34,"34232",725,505,492,13,13,"PACMA",1
17,"17027",2857,2236,2229,9,7,"PACMA",20
25,"25027",978,695,690,3,5,"PACMA",2
16,"16198",1281,938,928,6,10,"PACMA",3
49,"49002",58,43,40,0,3,"PACMA",0
10,"10072",837,545,539,5,6,"PACMA",3
33,"33046",480,334,329,0,5,"PACMA",0
9,"9258",165,128,127,0,1,"PACMA",0
36,"36036",2546,1763,1742,14,21,"PACMA",19
36,"36016",1069,639,633,5,6,"PACMA",1
37,"37274",118296,84144,83280,880,864,"PACMA",458
22,"22131",84,62,58,5,4,"PACMA",1
45,"45058",344,245,236,1,9,"PACMA",1
30,"30036",15432,10030,9879,64,151,"PACMA",92
21,"21021",12545,7816,7696,104,120,"PACMA",53
16,"16146",85,49,49,0,0,"PACMA",0
7,"7036",28132,18650,18510,222,140,"PACMA",272
43,"43098",362,274,274,1,0,"PACMA",5
1,"1053",596,364,362,1,2,"PACMA",4
31,"31024",100,52,52,0,0,"PACMA",0
33,"33075",244,125,122,3,3,"PACMA",0
16,"16133",4399,3317,3256,34,61,"PACMA",26
16,"16019",187,141,141,1,0,"PACMA",1
10,"10115",3460,2584,2503,15,81,"PACMA",10
31,"31244",157,69,69,0,0,"PACMA",0
37,"37329",38,29,28,1,1,"PACMA",0
34,"34236",147,104,104,0,0,"PACMA",0
37,"37359",165,105,103,0,2,"PACMA",0
5,"5197",100,82,79,1,3,"PACMA",0
3,"3904",1434,1032,1022,8,10,"PACMA",7
40,"40176",372,288,287,2,1,"PACMA",0
48,"48031",303,221,221,0,0,"PACMA",0
41,"41055",14791,10197,10000,125,197,"PACMA",81
10,"10116",3737,2579,2507,34,72,"PACMA",19
40,"40077",966,718,704,10,14,"PACMA",12
28,"28174",1858,1284,1273,1,11,"PACMA",11
38,"38007",1619,1053,1043,3,10,"PACMA",6
16,"16123",66,42,41,0,1,"PACMA",0
16,"16203",10221,6960,6883,42,77,"PACMA",51
17,"17103",5057,3196,3174,21,22,"PACMA",54
10,"10130",1754,1199,1189,10,10,"PACMA",5
15,"15011",15501,9988,9846,78,142,"PACMA",93
46,"46054",11389,8266,8190,54,76,"PACMA",106
18,"18189",785,598,592,9,6,"PACMA",6
10,"10009",255,165,162,1,3,"PACMA",2
22,"22066",755,529,520,8,9,"PACMA",5
3,"3031",42046,25035,24819,168,216,"PACMA",243
6,"6066",1708,1180,1171,6,9,"PACMA",2
19,"19148",42,29,28,1,1,"PACMA",0
39,"39031",1237,870,865,1,5,"PACMA",8
26,"26045",11,10,10,1,0,"PACMA",0
37,"37173",1412,951,937,15,14,"PACMA",2
37,"37371",252,156,155,0,1,"PACMA",0
17,"17095",20044,12638,12576,88,62,"PACMA",191
49,"49151",591,389,388,3,1,"PACMA",1
11,"11901",5739,3759,3686,99,73,"PACMA",18
11,"11012",97338,67120,66466,861,654,"PACMA",1227
16,"16087",238,184,184,6,0,"PACMA",1
48,"48033",217,162,162,1,0,"PACMA",1
5,"5105",330,247,242,2,5,"PACMA",0
33,"33078",127,81,81,0,0,"PACMA",0
34,"34211",171,154,153,2,1,"PACMA",0
44,"44261",713,553,549,3,4,"PACMA",0
41,"41001",1558,1129,1104,6,25,"PACMA",6
9,"9326",156,111,110,1,1,"PACMA",1
42,"42076",200,149,143,2,6,"PACMA",0
17,"17173",181,143,143,1,0,"PACMA",0
38,"38009",4315,2846,2817,27,29,"PACMA",16
9,"9432",170,125,123,0,2,"PACMA",0
34,"34001",39,27,27,1,0,"PACMA",0
9,"9906",1185,883,877,16,6,"PACMA",7
5,"5234",45,38,38,0,0,"PACMA",0
31,"31211",17,15,14,3,1,"PACMA",0
19,"19172",51,38,38,0,0,"PACMA",0
33,"33051",6787,4318,4268,48,50,"PACMA",30
43,"43102",458,331,324,2,7,"PACMA",3
26,"26047",1852,1449,1434,6,15,"PACMA",1
17,"17147",7916,5672,5641,41,31,"PACMA",46
24,"24055",674,484,482,8,2,"PACMA",2
4,"4075",5462,3714,3676,19,38,"PACMA",36
16,"16258",172,124,119,0,5,"PACMA",1
19,"19262",125,98,98,0,0,"PACMA",0
48,"48035",406,314,314,0,0,"PACMA",1
37,"37176",128,99,98,1,1,"PACMA",0
26,"26048",21,21,21,0,0,"PACMA",0
44,"44061",77,60,58,1,2,"PACMA",0
16,"16091",63,43,42,1,1,"PACMA",0
3,"3130",28,19,19,0,0,"PACMA",0
18,"18128",332,263,260,1,3,"PACMA",2
45,"45115",2602,2013,1969,12,44,"PACMA",8
19,"19184",59,47,47,0,0,"PACMA",0
13,"13067",334,279,271,2,8,"PACMA",1
41,"41060",15058,10551,10302,122,249,"PACMA",85
45,"45139",144,111,111,0,0,"PACMA",1
44,"44086",410,302,298,3,4,"PACMA",1
12,"12107",350,299,295,3,4,"PACMA",0
22,"22042",116,91,89,1,2,"PACMA",0
31,"31105",1471,1144,1124,10,20,"PACMA",5
19,"19331",2677,1892,1841,18,51,"PACMA",11
45,"45104",419,328,324,1,4,"PACMA",3
39,"39007",386,265,264,0,1,"PACMA",1
1,"1018",1399,953,947,1,6,"PACMA",4
47,"47179",368,256,254,2,2,"PACMA",0
49,"49046",246,174,169,0,5,"PACMA",0
9,"9112",102,73,73,0,0,"PACMA",1
25,"25053",1100,819,811,7,8,"PACMA",5
27,"27040",3008,2071,2046,21,25,"PACMA",4
50,"50280",290,220,216,1,4,"PACMA",0
43,"43105",155,126,123,4,3,"PACMA",1
5,"5206",26,17,17,0,0,"PACMA",0
32,"32053",1362,1001,989,10,12,"PACMA",5
37,"37178",98,70,70,0,0,"PACMA",0
10,"10085",310,219,219,1,0,"PACMA",0
5,"5109",445,334,329,4,5,"PACMA",0
44,"44265",175,138,136,1,2,"PACMA",0
9,"9275",167,114,114,1,0,"PACMA",0
48,"48038",1151,829,829,1,0,"PACMA",4
39,"39008",13900,9814,9734,63,80,"PACMA",56
40,"40084",52,41,41,2,0,"PACMA",0
9,"9440",80,61,61,0,0,"PACMA",0
28,"28182",203,167,163,1,4,"PACMA",1
22,"22253",56,40,40,1,0,"PACMA",1
33,"33055",1485,992,966,14,26,"PACMA",2
46,"46166",8214,6093,6031,38,62,"PACMA",72
25,"25098",227,160,158,1,2,"PACMA",0
4,"4079",54675,35691,35365,328,326,"PACMA",372
17,"17018",494,377,372,4,5,"PACMA",2
42,"42096",244,132,129,2,3,"PACMA",0
37,"37138",222,163,159,3,4,"PACMA",0
33,"33056",4850,3068,3044,25,24,"PACMA",17
26,"26091",147,115,114,0,1,"PACMA",0
41,"41062",2151,1619,1589,12,30,"PACMA",3
3,"3123",7579,5491,5416,50,75,"PACMA",51
26,"26004",69,47,46,0,1,"PACMA",0
10,"10141",284,207,205,1,2,"PACMA",0
26,"26017",364,274,269,2,5,"PACMA",2
45,"45034",1290,968,948,7,20,"PACMA",6
10,"10088",198,112,112,1,0,"PACMA",0
18,"18187",510,350,350,2,0,"PACMA",3
7,"7025",443,313,310,5,3,"PACMA",1
27,"27063",1699,1131,1109,7,22,"PACMA",3
49,"49272",73,49,46,2,3,"PACMA",0
46,"46213",15499,10610,10482,173,128,"PACMA",91
47,"47214",1349,1036,1019,5,17,"PACMA",0
25,"25068",515,359,358,0,1,"PACMA",1
31,"31220",742,551,539,6,12,"PACMA",2
9,"9443",151,113,112,0,1,"PACMA",0
42,"42132",140,102,101,2,1,"PACMA",0
16,"16097",139,117,116,0,1,"PACMA",0
31,"31110",83,61,61,1,0,"PACMA",0
22,"22112",9525,6317,6245,91,72,"PACMA",35
18,"18059",4265,2960,2886,23,74,"PACMA",24
46,"46263",235,182,180,2,2,"PACMA",0
22,"22223",77,60,59,2,1,"PACMA",1
19,"19043",99,80,79,0,1,"PACMA",0
13,"13075",196,147,146,2,1,"PACMA",0
18,"18157",1148,843,827,7,16,"PACMA",4
28,"28902",521,394,389,3,5,"PACMA",3
44,"44020",22,21,21,0,0,"PACMA",0
37,"37380",55,41,40,2,1,"PACMA",0
19,"19301",37,26,26,0,0,"PACMA",0
10,"10035",1798,1201,1171,8,30,"PACMA",1
25,"25002",465,324,323,4,1,"PACMA",5
49,"49115",167,121,121,2,0,"PACMA",0
50,"50126",2240,1528,1509,24,19,"PACMA",1
46,"46146",1647,1241,1229,12,12,"PACMA",10
22,"22176",171,140,138,2,2,"PACMA",1
9,"9176",58,46,45,2,1,"PACMA",0
46,"46902",352,283,283,0,0,"PACMA",0
42,"42008",54,41,41,0,0,"PACMA",0
23,"23027",711,547,539,5,8,"PACMA",1
19,"19314",44,33,33,0,0,"PACMA",0
17,"17022",7043,4940,4903,34,37,"PACMA",35
27,"27066",12588,8116,7954,109,162,"PACMA",63
19,"19054",161,136,135,3,1,"PACMA",0
46,"46215",1407,1088,1068,10,20,"PACMA",14
44,"44003",17,15,15,0,0,"PACMA",0
32,"32059",1686,1099,1082,20,17,"PACMA",1
6,"6144",504,391,382,6,9,"PACMA",0
25,"25225",531,395,393,0,2,"PACMA",2
25,"25911",419,298,297,3,1,"PACMA",2
16,"16139",317,226,222,1,4,"PACMA",0
17,"17137",3486,2812,2808,15,4,"PACMA",19
12,"12138",19207,13018,12891,87,127,"PACMA",155
9,"9448",203,159,157,0,2,"PACMA",0
24,"24065",2164,1524,1492,12,32,"PACMA",17
42,"42140",15,11,11,1,0,"PACMA",0
37,"37123",159,124,123,2,1,"PACMA",0
29,"29001",4207,3002,2959,40,43,"PACMA",10
1,"1030",141,102,102,0,0,"PACMA",0
24,"24175",1821,1316,1305,15,11,"PACMA",11
12,"12036",541,401,395,6,6,"PACMA",0
19,"19271",41,22,21,1,1,"PACMA",0
17,"17041",217,150,146,1,4,"PACMA",1
21,"21006",3321,2197,2125,19,72,"PACMA",12
33,"33061",344,174,174,1,0,"PACMA",2
40,"40026",112,101,99,0,2,"PACMA",1
42,"42141",101,59,59,0,0,"PACMA",0
15,"15055",4446,2829,2762,50,67,"PACMA",26
17,"17184",1261,1016,1010,7,6,"PACMA",4
46,"46171",16446,11616,11499,94,117,"PACMA",151
50,"50027",223,166,161,2,5,"PACMA",0
45,"45188",2770,1925,1886,12,39,"PACMA",20
26,"26139",58,43,43,2,0,"PACMA",1
50,"50180",107,85,85,1,0,"PACMA",0
20,"20023",441,254,251,1,3,"PACMA",4
10,"10053",279,171,169,1,2,"PACMA",0
34,"34141",176,149,146,0,3,"PACMA",0
6,"6131",1057,809,800,6,9,"PACMA",3
16,"16177",83,65,65,1,0,"PACMA",2
37,"37197",88,53,53,1,0,"PACMA",0
11,"11005",4508,2978,2900,34,78,"PACMA",8
16,"16141",131,98,96,1,2,"PACMA",0
37,"37125",231,154,148,1,6,"PACMA",0
46,"46149",350,252,249,3,3,"PACMA",3
26,"26179",39,27,27,0,0,"PACMA",0
23,"23903",3498,2633,2601,28,32,"PACMA",13
31,"31189",1125,702,698,6,4,"PACMA",4
10,"10055",697,488,473,3,15,"PACMA",1
25,"25105",105,88,87,4,1,"PACMA",0
37,"37055",117,97,93,0,4,"PACMA",0
40,"40159",130,94,93,2,1,"PACMA",0
50,"50078",227,168,166,0,2,"PACMA",1
21,"21069",1681,1073,1056,9,17,"PACMA",2
48,"48046",12626,9300,9250,31,50,"PACMA",44
9,"9295",52,36,35,1,1,"PACMA",0
19,"19142",263,179,179,1,0,"PACMA",4
37,"37314",81,65,65,0,0,"PACMA",0
22,"22028",358,237,233,1,4,"PACMA",0
21,"21008",2604,1663,1626,10,37,"PACMA",8
22,"22051",90,72,72,2,0,"PACMA",0
31,"31229",39,32,32,0,0,"PACMA",0
29,"29033",1084,733,722,5,11,"PACMA",3
22,"22019",176,128,126,1,2,"PACMA",2
28,"28095",1719,1236,1226,5,10,"PACMA",11
6,"6059",1724,1084,1067,6,17,"PACMA",2
22,"22230",291,209,207,4,2,"PACMA",0
21,"21010",15011,8812,8694,174,118,"PACMA",110
17,"17212",145,111,109,0,2,"PACMA",1
50,"50207",87,58,58,1,0,"PACMA",0
6,"6106",407,261,258,4,3,"PACMA",5
24,"24146",254,202,201,1,1,"PACMA",0
6,"6151",1049,746,741,5,5,"PACMA",3
19,"19155",64,49,49,0,0,"PACMA",0
49,"49134",158,100,99,1,1,"PACMA",1
29,"29062",658,557,551,2,6,"PACMA",0
37,"37057",208,151,149,0,2,"PACMA",0
50,"50167",208,166,163,1,3,"PACMA",0
14,"14028",302,241,240,3,1,"PACMA",0
46,"46189",469,374,367,2,7,"PACMA",12
28,"28004",6618,4502,4457,28,45,"PACMA",30
34,"34027",1049,677,665,15,12,"PACMA",4
10,"10019",1412,948,934,2,14,"PACMA",2
29,"29053",1717,1133,1116,12,17,"PACMA",15
14,"14029",4001,2855,2821,30,34,"PACMA",12
9,"9355",85,67,67,1,0,"PACMA",0
25,"25232",1357,1012,1007,6,5,"PACMA",9
32,"32068",1401,882,878,4,4,"PACMA",2
45,"45010",383,258,257,3,1,"PACMA",1
25,"25099",1285,908,904,6,4,"PACMA",1
25,"25056",209,145,145,0,0,"PACMA",1
19,"19218",43,31,31,0,0,"PACMA",0
26,"26106",79,67,67,0,0,"PACMA",0
9,"9302",96,66,66,0,0,"PACMA",0
49,"49248",171,128,128,1,0,"PACMA",0
7,"7059",3074,1973,1948,17,25,"PACMA",18
37,"37192",361,200,198,3,2,"PACMA",1
7,"7026",31129,17489,17342,178,147,"PACMA",280
35,"35008",6214,4193,4143,33,50,"PACMA",33
46,"46153",443,353,349,2,4,"PACMA",1
31,"31122",4981,3539,3504,38,35,"PACMA",33
10,"10905",636,443,433,7,10,"PACMA",4
23,"23072",1879,1389,1363,3,26,"PACMA",2
4,"4023",118,84,82,2,2,"PACMA",0
5,"5124",87,67,67,2,0,"PACMA",0
37,"37319",88,68,64,2,4,"PACMA",0
46,"46244",59910,42120,41826,338,294,"PACMA",485
37,"37060",283,205,202,1,3,"PACMA",6
29,"29901",44757,29291,28960,307,331,"PACMA",512
31,"31135",111,73,72,3,1,"PACMA",1
16,"16251",1805,1318,1302,9,16,"PACMA",8
19,"19104",19,15,14,0,1,"PACMA",0
43,"43100",3557,2666,2649,22,17,"PACMA",41
4,"4050",742,465,464,0,1,"PACMA",2
49,"49200",936,679,670,9,9,"PACMA",5
23,"23073",4363,3214,3176,24,38,"PACMA",20
5,"5242",679,571,562,9,9,"PACMA",0
41,"41075",10320,7159,6972,88,187,"PACMA",52
39,"39077",237,151,148,1,3,"PACMA",0
32,"32071",1351,821,814,6,7,"PACMA",3
19,"19250",16,12,12,0,0,"PACMA",0
16,"16124",1807,1367,1347,14,20,"PACMA",5
49,"49264",529,334,329,2,5,"PACMA",2
9,"9904",464,344,339,3,5,"PACMA",0
25,"25152",148,106,106,0,0,"PACMA",1
44,"44103",122,96,96,3,0,"PACMA",0
49,"49139",149,112,112,0,0,"PACMA",1
20,"20011",1624,1234,1225,3,9,"PACMA",2
45,"45198",1808,1442,1428,6,14,"PACMA",5
37,"37132",317,211,207,0,4,"PACMA",0
43,"43074",1818,1341,1336,2,5,"PACMA",7
45,"45124",2080,1628,1595,15,33,"PACMA",13
49,"49187",1197,839,819,12,20,"PACMA",1
23,"23075",3222,2513,2475,19,38,"PACMA",14
37,"37195",39,31,31,0,0,"PACMA",0
1,"1043",2340,1487,1468,11,19,"PACMA",5
37,"37289",210,147,144,0,3,"PACMA",0
22,"22025",1022,705,694,14,11,"PACMA",3
19,"19161",212,158,157,3,1,"PACMA",0
16,"16112",1466,972,957,12,15,"PACMA",3
25,"25239",582,330,330,3,0,"PACMA",2
12,"12122",754,608,600,3,8,"PACMA",2
15,"15003",1675,1029,1020,9,9,"PACMA",2
42,"42157",10,9,9,0,0,"PACMA",0
46,"46178",5001,3513,3477,26,36,"PACMA",45
46,"46201",62,40,40,0,0,"PACMA",0
34,"34035",97,76,75,3,1,"PACMA",0
9,"9198",100,75,74,2,1,"PACMA",0
21,"21047",1878,1144,1112,12,32,"PACMA",7
24,"24188",3795,2877,2825,40,52,"PACMA",13
44,"44192",341,274,272,2,2,"PACMA",0
17,"17051",202,161,160,0,1,"PACMA",3
32,"32037",679,454,446,6,8,"PACMA",1
42,"42200",74,49,46,0,3,"PACMA",0
39,"39024",1802,1325,1314,7,11,"PACMA",2
4,"4086",1631,1128,1114,3,14,"PACMA",4
40,"40049",37,27,27,0,0,"PACMA",0
25,"25126",281,211,210,1,1,"PACMA",3
38,"38034",3997,2687,2648,19,39,"PACMA",24
40,"40180",276,215,210,2,5,"PACMA",0
9,"9384",292,199,193,3,6,"PACMA",0
37,"37021",66,45,44,0,1,"PACMA",0
39,"39025",8637,6256,6179,33,77,"PACMA",23
42,"42201",23,21,21,0,0,"PACMA",0
18,"18174",435,324,320,3,4,"PACMA",2
16,"16245",396,304,298,1,6,"PACMA",2
45,"45127",775,510,502,1,8,"PACMA",15
31,"31239",282,196,193,6,3,"PACMA",1
19,"19254",43,34,34,0,0,"PACMA",0
42,"42037",28,13,13,2,0,"PACMA",0
19,"19255",74,37,37,0,0,"PACMA",0
43,"43068",484,322,317,2,5,"PACMA",0
45,"45018",550,385,380,1,5,"PACMA",1
41,"41051",2317,1715,1688,4,27,"PACMA",20
39,"39026",1702,1160,1151,11,9,"PACMA",3
9,"9480",105,84,84,0,0,"PACMA",0
9,"9351",61,46,45,1,1,"PACMA",1
28,"28138",60,43,42,0,1,"PACMA",0
6,"6104",648,470,459,2,11,"PACMA",4
40,"40171",40,32,32,1,0,"PACMA",0
49,"49034",408,282,281,2,1,"PACMA",0
16,"16005",234,163,160,1,3,"PACMA",0
19,"19166",154,110,108,0,2,"PACMA",1
50,"50063",64,49,49,0,0,"PACMA",0
49,"49259",79,59,59,0,0,"PACMA",0
31,"31021",59,42,42,1,0,"PACMA",0
17,"17054",342,250,250,2,0,"PACMA",4
10,"10112",1495,1071,1049,7,22,"PACMA",4
31,"31167",833,581,573,2,8,"PACMA",0
19,"19176",227,172,172,0,0,"PACMA",0
34,"34180",68,54,54,1,0,"PACMA",2
9,"9149",36,29,29,0,0,"PACMA",0
47,"47013",91,77,77,1,0,"PACMA",0
18,"18177",375,235,231,5,4,"PACMA",2
22,"22032",102,69,68,1,1,"PACMA",0
31,"31132",147,100,100,2,0,"PACMA",0
25,"25148",224,158,158,0,0,"PACMA",0
18,"18134",6104,4049,3972,39,77,"PACMA",37
23,"23046",2334,1880,1855,9,25,"PACMA",11
37,"37263",339,215,210,0,5,"PACMA",1
25,"25008",1081,803,799,4,4,"PACMA",2
25,"25211",680,470,470,3,0,"PACMA",1
19,"19132",86,65,63,0,2,"PACMA",0
34,"34204",50,35,35,0,0,"PACMA",0
17,"17009",4068,3061,3050,16,11,"PACMA",18
18,"18904",741,500,498,1,2,"PACMA",0
45,"45021",2639,1798,1755,22,43,"PACMA",13
43,"43045",143,114,113,0,1,"PACMA",0
9,"9316",104,80,80,0,0,"PACMA",2
44,"44036",22,20,20,0,0,"PACMA",0
18,"18122",15994,11009,10773,109,236,"PACMA",76
43,"43002",1890,1233,1210,12,23,"PACMA",15
31,"31182",29,25,25,0,0,"PACMA",0
46,"46228",2426,1819,1802,19,17,"PACMA",9
39,"39038",1512,992,983,5,9,"PACMA",7
7,"7037",3448,1875,1856,18,19,"PACMA",28
44,"44019",70,42,42,0,0,"PACMA",0
47,"47015",177,129,129,0,0,"PACMA",0
49,"49262",367,263,261,1,2,"PACMA",2
11,"11010",6327,3998,3928,112,70,"PACMA",25
32,"32081",2057,1466,1445,17,21,"PACMA",9
5,"5264",54,32,31,4,1,"PACMA",0
23,"23011",2138,1536,1507,17,29,"PACMA",6
1,"1009",1258,839,833,2,6,"PACMA",4
19,"19134",23,14,14,0,0,"PACMA",0
20,"20050",275,174,174,2,0,"PACMA",0
39,"39058",806,556,554,2,2,"PACMA",2
40,"40045",119,93,93,1,0,"PACMA",1
43,"43037",18216,11749,11672,70,77,"PACMA",162
28,"28078",40,38,38,0,0,"PACMA",0
9,"9122",86,55,55,0,0,"PACMA",0
16,"16098",521,418,415,2,3,"PACMA",3
34,"34089",141,102,101,4,1,"PACMA",0
31,"31172",370,257,250,6,7,"PACMA",2
3,"3116",1155,819,805,5,14,"PACMA",4
6,"6142",257,203,194,1,9,"PACMA",0
37,"37162",212,139,137,3,2,"PACMA",1
5,"5081",37,21,21,3,0,"PACMA",0
2,"2002",427,340,337,2,3,"PACMA",0
9,"9003",182,134,132,1,2,"PACMA",2
40,"40207",802,593,590,11,3,"PACMA",9
46,"46078",28484,19694,19520,173,174,"PACMA",257
5,"5082",491,379,369,2,10,"PACMA",4
47,"47195",426,314,310,2,4,"PACMA",2
5,"5222",140,118,118,0,0,"PACMA",0
24,"24163",4076,2979,2954,35,25,"PACMA",15
4,"4903",4320,2907,2873,18,34,"PACMA",10
37,"37204",253,176,173,2,3,"PACMA",0
43,"43048",768,564,554,7,10,"PACMA",7
25,"25249",176,129,127,2,2,"PACMA",0
46,"46124",786,638,625,1,13,"PACMA",5
50,"50033",61,44,44,1,0,"PACMA",1
21,"21065",259,178,175,0,3,"PACMA",1
26,"26009",394,282,278,1,4,"PACMA",2
50,"50171",99,69,69,2,0,"PACMA",0
40,"40079",229,160,159,2,1,"PACMA",0
31,"31174",100,55,55,0,0,"PACMA",2
4,"4074",2910,1813,1789,15,24,"PACMA",31
18,"18181",194,134,133,0,1,"PACMA",0
18,"18116",2856,2027,1979,13,48,"PACMA",7
40,"40048",35,27,27,0,0,"PACMA",0
7,"7008",6113,4003,3961,26,42,"PACMA",44
21,"21025",3886,2489,2431,31,58,"PACMA",13
12,"12106",1151,928,908,9,20,"PACMA",9
47,"47019",92,68,68,1,0,"PACMA",0
46,"46163",1883,1471,1460,8,11,"PACMA",10
29,"29095",3285,2313,2224,39,89,"PACMA",21
24,"24127",263,183,181,1,2,"PACMA",1
49,"49189",186,104,104,1,0,"PACMA",0
22,"22068",64,41,41,1,0,"PACMA",1
42,"42215",723,468,452,10,16,"PACMA",2
20,"20054",461,294,294,1,0,"PACMA",0
3,"3033",101,82,78,0,4,"PACMA",2
17,"17006",1178,826,818,9,8,"PACMA",11
27,"27048",1992,1317,1285,21,32,"PACMA",2
47,"47041",147,105,103,3,2,"PACMA",0
17,"17014",66,51,49,0,2,"PACMA",0
46,"46133",462,359,352,1,7,"PACMA",2
37,"37239",203,175,174,2,1,"PACMA",0
19,"19294",26,18,18,0,0,"PACMA",0
25,"25005",269,193,193,3,0,"PACMA",0
43,"43094",2143,1558,1541,6,17,"PACMA",8
43,"43112",245,179,179,3,0,"PACMA",0
1,"1060",204,159,151,0,8,"PACMA",1
9,"9011",70,42,40,0,2,"PACMA",0
19,"19173",47,40,40,0,0,"PACMA",1
21,"21028",370,265,259,2,6,"PACMA",0
23,"23092",27717,19749,19490,217,259,"PACMA",191
41,"41004",57692,38578,37814,696,764,"PACMA",629
5,"5162",76,47,45,1,2,"PACMA",0
34,"34053",194,156,154,3,2,"PACMA",2
31,"31178",476,323,320,7,3,"PACMA",3
10,"10124",867,622,612,1,10,"PACMA",0
17,"17232",146,111,111,0,0,"PACMA",2
6,"6088",12527,8326,8198,89,128,"PACMA",67
24,"24130",415,291,289,2,2,"PACMA",1
5,"5261",32,25,25,0,0,"PACMA",0
45,"45140",1075,788,772,10,16,"PACMA",1
4,"4100",9433,5599,5556,48,43,"PACMA",38
32,"32028",1537,1012,1004,5,8,"PACMA",6
23,"23020",1510,1263,1253,16,10,"PACMA",9
49,"49192",123,93,90,2,3,"PACMA",0
24,"24206",1594,1104,1093,11,11,"PACMA",6
16,"16131",123,84,84,0,0,"PACMA",1
41,"41061",2141,1661,1621,7,40,"PACMA",5
45,"45141",848,626,615,0,11,"PACMA",1
37,"37013",104,72,70,2,2,"PACMA",0
28,"28044",6266,4693,4642,36,51,"PACMA",32
16,"16017",336,276,270,1,6,"PACMA",0
35,"35029",4415,2498,2472,29,26,"PACMA",12
45,"45032",445,290,286,2,4,"PACMA",1
50,"50149",34,25,25,0,0,"PACMA",0
10,"10126",1455,966,948,9,18,"PACMA",5
31,"31071",13,11,11,0,0,"PACMA",0
9,"9223",42,36,36,0,0,"PACMA",1
13,"13025",290,233,231,0,2,"PACMA",0
48,"48095",2324,1568,1555,13,13,"PACMA",2
11,"11039",9957,6134,6043,152,91,"PACMA",67
19,"19217",43,36,36,0,0,"PACMA",0
21,"21051",222,171,168,3,3,"PACMA",0
45,"45205",7438,4772,4701,27,71,"PACMA",47
27,"27052",860,564,558,7,6,"PACMA",5
34,"34057",464,308,302,4,6,"PACMA",1
39,"39046",1342,910,902,3,8,"PACMA",5
43,"43141",109,85,84,0,1,"PACMA",0
48,"48029",8681,6057,6027,41,30,"PACMA",48
31,"31902",4661,3228,3201,39,27,"PACMA",37
45,"45119",3499,2217,2190,3,27,"PACMA",34
22,"22096",332,248,241,10,7,"PACMA",1
25,"25254",704,511,508,2,3,"PACMA",1
49,"49090",190,135,134,3,1,"PACMA",1
48,"48908",250,212,210,1,2,"PACMA",1
24,"24073",437,285,282,1,3,"PACMA",0
10,"10183",950,696,684,3,12,"PACMA",2
43,"43054",2807,1972,1957,14,15,"PACMA",11
17,"17076",119,95,94,2,1,"PACMA",2
25,"25158",1605,1193,1180,8,13,"PACMA",4
23,"23096",2543,2029,1986,16,43,"PACMA",8
4,"4011",2744,2010,1984,20,26,"PACMA",18
5,"5012",117,88,88,1,0,"PACMA",0
27,"27022",4654,2760,2696,20,64,"PACMA",7
31,"31147",110,79,78,1,1,"PACMA",1
9,"9019",146,105,103,4,2,"PACMA",0
50,"50073",2122,1559,1540,14,19,"PACMA",7
16,"16270",154,123,122,1,1,"PACMA",1
4,"4049",5711,3766,3732,25,34,"PACMA",35
9,"9339",128,106,105,0,1,"PACMA",0
24,"24211",259,199,198,3,1,"PACMA",0
34,"34154",77,48,48,1,0,"PACMA",0
9,"9001",32,25,25,0,0,"PACMA",0
35,"35031",7456,4938,4868,39,70,"PACMA",39
5,"5058",71,45,43,0,2,"PACMA",0
48,"48060",3625,2429,2418,12,11,"PACMA",1
17,"17180",8508,5977,5953,38,24,"PACMA",63
23,"23085",2171,1587,1575,7,12,"PACMA",5
43,"43046",88,69,68,1,1,"PACMA",6
6,"6096",206,158,153,0,5,"PACMA",1
3,"3097",1014,778,764,5,14,"PACMA",2
17,"17089",5749,3973,3949,17,24,"PACMA",41
37,"37341",47,29,29,0,0,"PACMA",0
25,"25193",768,567,563,4,4,"PACMA",1
14,"14013",16619,11968,11719,153,249,"PACMA",157
26,"26148",154,125,122,3,3,"PACMA",1
40,"40101",918,672,665,11,7,"PACMA",5
46,"46116",13606,10262,10200,87,62,"PACMA",121
9,"9054",89,65,63,4,2,"PACMA",1
37,"37352",209,157,155,3,2,"PACMA",2
50,"50153",914,683,675,9,8,"PACMA",8
31,"31259",475,313,311,5,2,"PACMA",0
24,"24064",1501,1030,1012,2,18,"PACMA",4
22,"22087",60,46,46,0,0,"PACMA",0
5,"5200",41,26,26,0,0,"PACMA",0
40,"40069",68,59,59,0,0,"PACMA",0
26,"26109",73,68,68,0,0,"PACMA",0
22,"22155",66,52,52,0,0,"PACMA",0
47,"47124",383,302,300,3,2,"PACMA",0
10,"10011",518,385,370,2,15,"PACMA",0
17,"17155",14957,9519,9410,71,109,"PACMA",140
22,"22190",123,77,77,1,0,"PACMA",0
28,"28050",4406,3202,3167,29,35,"PACMA",31
4,"4052",12882,8400,8322,93,78,"PACMA",86
19,"19081",27,21,21,0,0,"PACMA",0
29,"29904",418,328,322,1,6,"PACMA",2
5,"5084",66,44,44,0,0,"PACMA",0
19,"19010",9,9,9,0,0,"PACMA",0
50,"50026",418,292,288,4,4,"PACMA",0
15,"15024",4314,2859,2790,44,69,"PACMA",11
26,"26023",433,316,314,3,2,"PACMA",2
43,"43111",2129,1412,1401,8,11,"PACMA",24
29,"29058",1542,994,979,5,15,"PACMA",7
42,"42092",61,40,39,0,1,"PACMA",0
6,"6146",1039,764,752,7,12,"PACMA",0
7,"7019",161,104,102,0,2,"PACMA",0
16,"16074",30,25,25,0,0,"PACMA",0
9,"9251",362,258,256,3,2,"PACMA",2
36,"36043",4696,3038,3003,21,35,"PACMA",26
50,"50061",190,157,155,2,2,"PACMA",0
45,"45142",7792,5717,5624,62,93,"PACMA",32
37,"37169",177,122,122,0,0,"PACMA",0
43,"43075",86,65,63,0,2,"PACMA",0
40,"40903",75,61,59,0,2,"PACMA",0
26,"26124",768,603,590,4,13,"PACMA",0
15,"15005",25347,15441,15211,226,230,"PACMA",152
19,"19244",74,55,55,3,0,"PACMA",0
25,"25228",3143,2261,2250,18,11,"PACMA",10
30,"30001",4507,3357,3331,17,26,"PACMA",16
42,"42188",46,35,35,1,0,"PACMA",0
39,"39072",325,184,182,0,2,"PACMA",1
26,"26178",72,56,56,1,0,"PACMA",0
25,"25127",217,145,145,1,0,"PACMA",1
5,"5018",23,17,17,2,0,"PACMA",0
32,"32027",989,670,660,5,10,"PACMA",4
29,"29060",665,454,450,1,4,"PACMA",0
19,"19215",135,109,109,0,0,"PACMA",0
43,"43164",310,235,231,3,4,"PACMA",4
10,"10015",630,429,424,1,5,"PACMA",3
13,"13068",1023,737,722,2,15,"PACMA",0
6,"6058",1984,1372,1331,13,41,"PACMA",9
50,"50054",55,37,37,2,0,"PACMA",0
34,"34179",25,18,16,0,2,"PACMA",0
29,"29061",1043,803,773,9,30,"PACMA",9
24,"24033",209,149,149,0,0,"PACMA",1
45,"45043",776,608,598,3,10,"PACMA",2
37,"37158",230,149,149,1,0,"PACMA",0
37,"37315",89,65,64,0,1,"PACMA",1
25,"25168",496,399,399,6,0,"PACMA",0
9,"9184",6,6,6,0,0,"PACMA",0
46,"46173",1309,1029,1010,13,19,"PACMA",7
2,"2008",1103,737,722,8,15,"PACMA",2
45,"45166",1575,1231,1210,5,21,"PACMA",4
33,"33008",1679,1140,1133,10,7,"PACMA",1
26,"26027",139,99,97,0,2,"PACMA",0
38,"38021",1609,900,876,2,24,"PACMA",7
19,"19246",42,27,27,1,0,"PACMA",0
50,"50183",316,227,223,1,4,"PACMA",1
32,"32030",945,642,641,8,1,"PACMA",1
18,"18067",682,442,437,2,5,"PACMA",1
45,"45146",101,79,79,0,0,"PACMA",0
45,"45174",300,218,217,2,1,"PACMA",0
10,"10154",177,117,116,0,1,"PACMA",0
43,"43169",445,388,388,3,0,"PACMA",2
10,"10194",524,408,404,2,4,"PACMA",2
17,"17196",252,200,200,1,0,"PACMA",4
16,"16082",272,194,192,1,2,"PACMA",1
46,"46254",944,673,661,6,12,"PACMA",2
6,"6137",934,696,693,3,3,"PACMA",3
10,"10119",574,417,414,2,3,"PACMA",1
43,"43126",1230,937,933,3,4,"PACMA",11
42,"42192",36,22,22,2,0,"PACMA",0
31,"31157",3447,2182,2160,29,22,"PACMA",13
37,"37223",106,75,74,0,1,"PACMA",0
37,"37338",77,58,58,0,0,"PACMA",0
43,"43133",5627,3794,3773,31,21,"PACMA",24
39,"39010",610,457,453,1,4,"PACMA",2
37,"37161",123,86,86,0,0,"PACMA",0
31,"31133",34,27,27,1,0,"PACMA",0
14,"14020",336,227,225,0,2,"PACMA",0
37,"37255",43,33,31,1,2,"PACMA",0
26,"26146",84,56,55,0,1,"PACMA",1
27,"27064",1505,972,951,9,21,"PACMA",13
31,"31159",1097,813,812,2,1,"PACMA",2
34,"34169",371,263,259,5,4,"PACMA",1
4,"4093",1916,1143,1130,5,13,"PACMA",6
19,"19090",90,69,68,1,1,"PACMA",0
9,"9358",247,165,161,3,4,"PACMA",0
16,"16148",544,452,451,2,1,"PACMA",0
50,"50234",242,159,154,4,5,"PACMA",1
17,"17189",1481,1228,1223,5,5,"PACMA",3
22,"22086",194,137,137,1,0,"PACMA",1
26,"26019",346,260,251,2,9,"PACMA",0
39,"39001",2063,1474,1467,5,7,"PACMA",5
21,"21033",569,410,405,3,5,"PACMA",1
16,"16020",9,5,5,1,0,"PACMA",0
37,"37307",146,94,91,1,3,"PACMA",0
17,"17086",1769,1116,1109,6,7,"PACMA",12
26,"26018",10443,7664,7538,80,126,"PACMA",39
43,"43160",1324,967,956,6,11,"PACMA",15
41,"41087",10557,7217,7029,67,188,"PACMA",74
20,"20067",30609,20017,19927,111,90,"PACMA",149
23,"23039",2170,1502,1460,10,42,"PACMA",9
27,"27041",2216,1463,1445,19,18,"PACMA",15
10,"10023",842,597,589,2,8,"PACMA",0
31,"31136",461,294,293,3,1,"PACMA",5
41,"41085",4182,3258,3181,43,77,"PACMA",34
37,"37215",133,93,90,1,3,"PACMA",1
49,"49104",326,218,216,0,2,"PACMA",0
31,"31165",2772,1946,1930,16,16,"PACMA",4
10,"10028",83,62,61,1,1,"PACMA",1
9,"9416",52,30,30,0,0,"PACMA",1
23,"23003",8639,6296,6226,41,70,"PACMA",28
25,"25142",359,283,283,2,0,"PACMA",1
16,"16205",106,73,73,1,0,"PACMA",0
37,"37184",289,178,177,1,1,"PACMA",0
16,"16254",199,159,159,0,0,"PACMA",1
37,"37143",384,273,273,2,0,"PACMA",2
46,"46109",6248,4516,4440,37,76,"PACMA",31
24,"24006",488,356,347,4,9,"PACMA",2
17,"17164",3918,2856,2838,17,18,"PACMA",22
47,"47039",162,119,117,0,2,"PACMA",0
50,"50297",503800,365284,362768,3385,2516,"PACMA",2730
46,"46110",21364,15132,15019,120,113,"PACMA",209
39,"39051",73,64,64,1,0,"PACMA",0
10,"10148",33054,21731,21379,231,352,"PACMA",162
23,"23004",407,321,315,2,6,"PACMA",2
17,"17165",645,502,502,2,0,"PACMA",4
26,"26150",97,77,77,1,0,"PACMA",0
41,"41049",9515,6961,6843,115,118,"PACMA",43
17,"17023",27314,18677,18546,117,131,"PACMA",252
13,"13050",475,348,345,1,3,"PACMA",2
25,"25115",803,601,593,4,8,"PACMA",6
19,"19223",99,66,65,1,1,"PACMA",1
6,"6024",1123,876,849,3,27,"PACMA",3
3,"3052",959,747,735,4,12,"PACMA",2
34,"34242",91,65,62,2,3,"PACMA",0
49,"49010",350,260,256,8,4,"PACMA",3
46,"46186",19689,14688,14576,118,112,"PACMA",187
23,"23009",12849,9722,9572,99,150,"PACMA",55
46,"46004",1932,1530,1512,10,18,"PACMA",17
24,"24145",612,338,337,1,1,"PACMA",0
16,"16135",115,76,76,0,0,"PACMA",0
38,"38053",3768,2275,2244,16,31,"PACMA",19
41,"41090",3489,2560,2467,27,93,"PACMA",20
3,"3037",340,261,255,3,6,"PACMA",1
43,"43138",2636,1761,1745,11,16,"PACMA",12
21,"21017",2302,1469,1452,18,17,"PACMA",15
12,"12052",537,409,398,5,11,"PACMA",0
37,"37061",195,136,136,1,0,"PACMA",0
16,"16039",365,241,238,3,3,"PACMA",1
50,"50138",45,37,37,3,0,"PACMA",0
50,"50155",95,65,65,0,0,"PACMA",0
32,"32015",817,454,452,2,2,"PACMA",0
39,"39006",1729,1207,1192,1,15,"PACMA",3
47,"47083",81,63,61,0,2,"PACMA",0
16,"16079",28,16,16,0,0,"PACMA",0
33,"33044",177059,121380,120421,1543,959,"PACMA",955
36,"36002",3049,1994,1968,22,26,"PACMA",11
9,"9182",74,54,54,0,0,"PACMA",0
5,"5033",169,135,134,0,1,"PACMA",0
42,"42026",28,25,25,0,0,"PACMA",0
17,"17043",165,133,133,0,0,"PACMA",2
2,"2018",789,611,606,3,5,"PACMA",0
21,"21902",1136,744,739,2,5,"PACMA",2
10,"10070",667,493,489,1,4,"PACMA",0
3,"3026",1331,987,975,7,12,"PACMA",7
18,"18911",7933,5464,5348,53,116,"PACMA",68
44,"44223",73,48,48,0,0,"PACMA",0
26,"26115",23,22,21,3,1,"PACMA",0
42,"42205",77,59,57,3,2,"PACMA",0
21,"21050",12567,8522,8392,89,130,"PACMA",59
38,"38037",12817,7582,7494,55,88,"PACMA",72
47,"47085",16330,11556,11419,121,137,"PACMA",58
28,"28064",125,98,95,3,3,"PACMA",1
24,"24901",853,517,513,4,4,"PACMA",4
5,"5164",18,12,12,0,0,"PACMA",0
41,"41081",30061,21488,21059,331,429,"PACMA",303
45,"45057",224,177,173,0,4,"PACMA",0
37,"37245",331,221,220,4,1,"PACMA",0
37,"37243",89,66,66,0,0,"PACMA",0
5,"5074",668,540,537,5,3,"PACMA",0
40,"40009",41,35,34,0,1,"PACMA",0
26,"26020",449,319,313,1,6,"PACMA",2
34,"34155",122,95,95,0,0,"PACMA",0
34,"34061",91,70,69,1,1,"PACMA",0
50,"50123",430,304,297,3,7,"PACMA",1
10,"10168",320,210,206,1,4,"PACMA",0
43,"43050",2695,1742,1730,10,12,"PACMA",21
6,"6102",1027,834,815,3,19,"PACMA",0
50,"50109",95,65,62,2,3,"PACMA",0
38,"38008",5699,3719,3669,26,50,"PACMA",31
37,"37073",613,448,440,4,8,"PACMA",1
19,"19034",25,22,21,0,1,"PACMA",0
37,"37348",100,76,76,0,0,"PACMA",0
3,"3075",154,117,115,1,2,"PACMA",2
12,"12094",871,671,661,1,10,"PACMA",6
19,"19076",29,23,23,0,0,"PACMA",0
5,"5177",136,117,116,0,1,"PACMA",0
38,"38014",1342,943,930,6,13,"PACMA",7
31,"31170",44,31,30,2,1,"PACMA",0
36,"36006",11502,8057,7927,53,130,"PACMA",69
44,"44225",105,82,81,2,1,"PACMA",0
26,"26119",178,132,132,0,0,"PACMA",1
31,"31171",670,466,462,1,4,"PACMA",2
11,"11041",9869,6438,6295,100,143,"PACMA",37
14,"14058",7866,5451,5334,69,117,"PACMA",33
50,"50116",169,124,123,0,1,"PACMA",0
34,"34045",72,62,62,0,0,"PACMA",0
17,"17029",207,154,154,1,0,"PACMA",3
32,"32045",2346,1604,1579,20,25,"PACMA",1
7,"7004",4069,2652,2624,27,28,"PACMA",28
25,"25048",1641,1207,1194,13,13,"PACMA",8
44,"44090",66,49,49,0,0,"PACMA",0
40,"40164",186,131,130,0,1,"PACMA",0
12,"12070",505,407,398,2,9,"PACMA",0
3,"3039",89,65,65,0,0,"PACMA",0
48,"48097",1314,886,882,6,4,"PACMA",6
37,"37047",215,89,89,0,0,"PACMA",0
3,"3119",17253,12346,12258,81,88,"PACMA",133
47,"47225",73,61,59,1,2,"PACMA",1
44,"44252",73,56,55,0,1,"PACMA",1
48,"48066",344,246,246,2,0,"PACMA",0
49,"49224",166,102,100,0,2,"PACMA",2
24,"24047",708,462,459,1,3,"PACMA",1
50,"50014",119,81,81,0,0,"PACMA",1
15,"15021",5254,3473,3422,58,51,"PACMA",18
43,"43091",125,90,90,1,0,"PACMA",2
26,"26040",64,47,47,1,0,"PACMA",1
46,"46093",2151,1652,1640,10,12,"PACMA",12
9,"9166",96,77,77,0,0,"PACMA",0
18,"18183",623,380,376,0,4,"PACMA",3
45,"45067",2267,1722,1675,14,47,"PACMA",7
4,"4066",13438,8615,8519,78,96,"PACMA",44
19,"19124",378,230,229,2,1,"PACMA",0
49,"49175",204,136,135,3,1,"PACMA",0
9,"9248",80,62,61,1,1,"PACMA",0
6,"6007",1418,984,968,13,16,"PACMA",2
20,"20072",4762,3175,3153,21,22,"PACMA",28
22,"22137",1009,671,665,1,6,"PACMA",2
37,"37009",197,145,144,1,1,"PACMA",0
44,"44059",562,411,407,2,4,"PACMA",1
43,"43901",8796,5431,5390,41,41,"PACMA",19
30,"30016",153034,101232,100202,776,1030,"PACMA",1499
41,"41058",17956,12890,12553,200,337,"PACMA",146
29,"29094",59795,39350,38854,454,496,"PACMA",502
50,"50068",1943,1299,1287,10,12,"PACMA",3
9,"9163",573,436,432,7,4,"PACMA",1
7,"7040",289448,169300,167908,1594,1392,"PACMA",2497
12,"12026",828,577,566,11,11,"PACMA",0
24,"24164",351,175,174,0,1,"PACMA",0
40,"40146",260,206,204,0,2,"PACMA",1
45,"45101",3671,2842,2808,13,34,"PACMA",17
42,"42124",56,27,27,0,0,"PACMA",0
5,"5171",67,49,47,0,2,"PACMA",0
17,"17005",457,322,320,3,2,"PACMA",2
37,"37206",87,65,54,0,11,"PACMA",1
25,"25196",108,75,75,1,0,"PACMA",0
13,"13020",4701,3114,3069,42,45,"PACMA",30
15,"15080",1637,1009,992,11,17,"PACMA",4
16,"16163",64,51,51,0,0,"PACMA",0
48,"48091",1078,758,757,5,1,"PACMA",3
25,"25210",1073,791,780,3,11,"PACMA",2
10,"10004",692,482,473,8,9,"PACMA",0
16,"16022",76,63,63,0,0,"PACMA",1
24,"24173",896,590,583,2,7,"PACMA",2
46,"46068",345,283,279,2,4,"PACMA",3
20,"20078",1143,819,816,1,3,"PACMA",1
24,"24089",101036,71905,71305,744,600,"PACMA",437
25,"25905",366,281,276,4,5,"PACMA",1
21,"21024",464,328,312,1,16,"PACMA",1
49,"49186",230,172,170,0,2,"PACMA",0
9,"9138",84,67,66,1,1,"PACMA",0
26,"26057",50,45,45,2,0,"PACMA",0
42,"42173",29860,19581,19206,337,375,"PACMA",99
45,"45189",633,462,459,7,3,"PACMA",9
17,"17034",7289,4880,4862,23,18,"PACMA",66
43,"43077",453,306,304,1,2,"PACMA",0
18,"18024",837,651,639,11,12,"PACMA",4
50,"50094",1500,1041,1022,12,19,"PACMA",8
21,"21018",1719,1048,1029,12,19,"PACMA",10
43,"43130",169,131,130,2,1,"PACMA",0
24,"24167",703,436,430,3,6,"PACMA",2
40,"40008",42,36,36,1,0,"PACMA",0
37,"37376",2130,1446,1423,18,23,"PACMA",2
10,"10098",387,272,267,0,5,"PACMA",1
10,"10056",533,377,371,2,6,"PACMA",1
43,"43078",835,610,605,7,5,"PACMA",1
21,"21060",12287,7761,7638,134,123,"PACMA",122
45,"45069",1820,1370,1355,1,15,"PACMA",4
42,"42082",8,8,8,0,0,"PACMA",0
43,"43157",339,279,279,1,0,"PACMA",1
23,"23056",3052,2279,2207,26,72,"PACMA",15
2,"2041",316,238,236,0,2,"PACMA",1
34,"34070",131,98,96,0,2,"PACMA",0
16,"16094",121,86,84,0,2,"PACMA",0
16,"16169",49,28,28,0,0,"PACMA",0
44,"44176",152,114,113,1,1,"PACMA",0
10,"10048",202,141,139,0,2,"PACMA",0
18,"18004",669,467,466,6,1,"PACMA",1
13,"13085",2265,1768,1735,5,33,"PACMA",1
42,"42175",22,16,16,0,0,"PACMA",0
10,"10058",979,628,599,6,29,"PACMA",2
31,"31034",31,24,24,0,0,"PACMA",0
43,"43175",534,363,359,5,4,"PACMA",1
31,"31197",67,51,51,2,0,"PACMA",0
42,"42196",7,7,7,1,0,"PACMA",0
37,"37337",137,104,103,0,1,"PACMA",0
46,"46055",1298,992,977,9,15,"PACMA",16
50,"50099",3036,2137,2113,17,24,"PACMA",12
24,"24068",430,289,281,0,8,"PACMA",0
37,"37375",678,539,523,8,16,"PACMA",1
45,"45005",225,170,167,3,3,"PACMA",0
39,"39069",1934,1475,1458,2,17,"PACMA",15
20,"20028",2254,1442,1441,6,1,"PACMA",1
40,"40001",708,544,536,3,8,"PACMA",1
25,"25191",321,227,222,2,5,"PACMA",1
31,"31012",763,550,542,7,8,"PACMA",1
18,"18167",1839,1243,1224,9,19,"PACMA",4
32,"32031",997,684,680,5,4,"PACMA",4
47,"47025",114,85,85,3,0,"PACMA",0
25,"25223",890,673,666,7,7,"PACMA",6
31,"31036",879,601,589,5,12,"PACMA",1
7,"7014",7885,3934,3893,43,41,"PACMA",56
17,"17206",158,111,109,0,2,"PACMA",0
26,"26132",106,73,70,2,3,"PACMA",1
22,"22077",362,280,272,5,8,"PACMA",0
43,"43003",349,257,255,3,2,"PACMA",1
41,"41008",1044,788,766,3,22,"PACMA",3
14,"14040",3749,2905,2845,53,60,"PACMA",17
9,"9227",112,89,89,1,0,"PACMA",0
38,"38039",11149,7375,7326,68,49,"PACMA",84
25,"25089",93,70,68,1,2,"PACMA",0
45,"45158",2545,1805,1786,9,19,"PACMA",7
26,"26043",346,243,235,2,8,"PACMA",1
6,"6049",956,625,604,8,21,"PACMA",2
17,"17162",153,106,105,1,1,"PACMA",0
34,"34059",411,304,292,6,12,"PACMA",0
18,"18032",247,164,163,1,1,"PACMA",0
42,"42152",67,47,44,1,3,"PACMA",0
9,"9424",31,24,23,0,1,"PACMA",0
31,"31058",199,134,133,2,1,"PACMA",0
49,"49047",98,74,72,1,2,"PACMA",1
17,"17074",536,403,401,1,2,"PACMA",4
14,"14065",1820,1374,1352,13,22,"PACMA",12
50,"50265",74,54,54,1,0,"PACMA",0
47,"47171",375,295,290,9,5,"PACMA",1
10,"10172",696,447,443,5,4,"PACMA",1
40,"40173",140,120,118,2,2,"PACMA",4
38,"38048",3952,2543,2519,22,24,"PACMA",22
28,"28101",226,174,172,1,2,"PACMA",3
50,"50210",37,26,26,0,0,"PACMA",0
25,"25248",870,676,675,5,1,"PACMA",1
46,"46210",338,256,251,0,5,"PACMA",1
31,"31003",121,71,71,0,0,"PACMA",0
26,"26162",108,90,89,1,1,"PACMA",0
10,"10105",2442,1541,1515,11,26,"PACMA",5
32,"32047",1761,1192,1175,10,17,"PACMA",4
26,"26062",85,62,62,1,0,"PACMA",0
43,"43039",101,77,77,0,0,"PACMA",0
14,"14014",2496,1962,1907,20,55,"PACMA",12
6,"6023",4138,2811,2749,12,62,"PACMA",10
37,"37248",150,116,116,1,0,"PACMA",0
47,"47186",244314,182449,180833,1818,1616,"PACMA",1296
12,"12089",4555,3070,3045,22,25,"PACMA",34
47,"47060",224,171,168,1,3,"PACMA",1
38,"38042",3778,2410,2386,11,24,"PACMA",16
10,"10175",1351,918,901,8,17,"PACMA",2
28,"28020",193,96,93,0,3,"PACMA",0
45,"45113",1770,1189,1171,5,18,"PACMA",7
49,"49242",439,342,336,2,6,"PACMA",1
14,"14071",874,551,540,5,11,"PACMA",2
9,"9449",91,78,76,1,2,"PACMA",0
16,"16101",137,111,109,1,2,"PACMA",0
28,"28092",153631,112460,111341,913,1119,"PACMA",1222
37,"37052",287,192,191,2,1,"PACMA",0
25,"25197",140,109,109,0,0,"PACMA",0
34,"34126",248,177,176,3,1,"PACMA",0
5,"5249",96,63,63,0,0,"PACMA",1
20,"20074",11520,8379,8357,19,22,"PACMA",34
26,"26011",7251,4807,4711,47,96,"PACMA",33
9,"9108",433,315,311,3,4,"PACMA",0
47,"47160",395,296,294,3,2,"PACMA",0
25,"25149",1377,1034,1028,9,6,"PACMA",9
10,"10153",281,183,181,0,2,"PACMA",0
17,"17055",142,124,124,0,0,"PACMA",1
27,"27055",1191,773,764,7,9,"PACMA",0
17,"17169",2511,1901,1890,8,11,"PACMA",26
24,"24151",433,307,304,1,3,"PACMA",0
25,"25157",159,127,126,1,1,"PACMA",0
16,"16277",105,74,74,0,0,"PACMA",0
16,"16115",49,32,32,0,0,"PACMA",0
18,"18107",920,643,626,1,17,"PACMA",0
7,"7028",944,635,628,2,7,"PACMA",10
26,"26087",180,123,123,3,0,"PACMA",0
47,"47178",170,128,124,2,4,"PACMA",0
9,"9236",34,25,25,1,0,"PACMA",0
29,"29026",1021,703,698,15,5,"PACMA",5
28,"28032",5090,3716,3675,22,41,"PACMA",43
46,"46142",778,536,524,3,12,"PACMA",2
47,"47062",155,128,128,0,0,"PACMA",0
19,"19185",26,15,15,1,0,"PACMA",0
46,"46203",3546,2717,2689,28,28,"PACMA",25
22,"22061",6567,4446,4410,48,36,"PACMA",27
9,"9239",47,31,31,0,0,"PACMA",0
10,"10016",329,242,232,2,10,"PACMA",1
19,"19119",76,65,65,0,0,"PACMA",0
37,"37252",99,65,65,1,0,"PACMA",0
25,"25109",211,155,154,1,1,"PACMA",0
18,"18176",242,164,161,2,3,"PACMA",0
31,"31107",1671,1204,1182,12,22,"PACMA",5
46,"46128",1569,1216,1179,7,37,"PACMA",5
48,"48047",147,105,105,2,0,"PACMA",0
45,"45192",2380,1890,1854,8,36,"PACMA",8
44,"44055",75,52,50,0,2,"PACMA",0
9,"9114",77,60,59,0,1,"PACMA",1
21,"21009",834,527,508,4,19,"PACMA",7
7,"7012",1908,1301,1282,12,19,"PACMA",7
24,"24095",317,228,228,3,0,"PACMA",2
31,"31046",53,38,38,0,0,"PACMA",0
22,"22043",93,53,53,0,0,"PACMA",1
9,"9014",182,101,101,0,0,"PACMA",0
45,"45167",1370,1078,1065,1,13,"PACMA",5
34,"34132",106,73,72,0,1,"PACMA",0
20,"20006",261,154,153,1,1,"PACMA",4
10,"10017",775,554,545,1,9,"PACMA",0
26,"26008",1821,1310,1290,15,20,"PACMA",3
35,"35017",27498,15513,15240,121,273,"PACMA",156
18,"18074",265,205,205,0,0,"PACMA",0
16,"16192",42,28,28,0,0,"PACMA",0
49,"49029",609,435,419,6,16,"PACMA",1
48,"48024",1000,761,752,1,9,"PACMA",3
27,"27001",2187,1111,1102,17,9,"PACMA",7
42,"42106",13,11,11,0,0,"PACMA",0
19,"19334",43,35,35,0,0,"PACMA",0
5,"5046",38,35,35,0,0,"PACMA",0
49,"49209",451,274,269,7,5,"PACMA",0
50,"50081",487,355,349,5,6,"PACMA",1
16,"16238",461,380,378,1,2,"PACMA",0
29,"29008",15249,10396,10234,108,162,"PACMA",96
14,"14048",1199,883,866,4,17,"PACMA",7
39,"39076",3512,2517,2491,13,26,"PACMA",12
1,"1039",188,150,147,2,3,"PACMA",0
12,"12095",950,723,712,5,11,"PACMA",4
15,"15061",5149,3221,3168,44,53,"PACMA",10
50,"50108",50,37,37,0,0,"PACMA",0
31,"31086",13781,10133,10054,114,79,"PACMA",100
47,"47006",182,149,145,1,4,"PACMA",2
37,"37246",5146,3791,3737,42,54,"PACMA",21
31,"31207",280,194,191,3,3,"PACMA",1
29,"29027",2325,1543,1516,13,27,"PACMA",19
42,"42153",12,10,10,0,0,"PACMA",0
23,"23026",3431,2430,2375,25,55,"PACMA",11
10,"10040",426,301,289,2,12,"PACMA",1
16,"16172",325,233,228,1,5,"PACMA",2
20,"20070",1084,798,795,7,3,"PACMA",5
9,"9079",47,38,38,0,0,"PACMA",0
43,"43014",14386,9542,9464,74,78,"PACMA",67
14,"14009",2653,1658,1631,24,27,"PACMA",4
29,"29015",32093,22044,21716,253,328,"PACMA",173
45,"45105",376,277,268,5,9,"PACMA",0
10,"10207",455,298,291,0,7,"PACMA",0
16,"16042",1091,832,823,4,9,"PACMA",4
31,"31143",91,44,41,1,3,"PACMA",1
40,"40019",29,23,23,1,0,"PACMA",0
17,"17186",3834,2980,2954,17,26,"PACMA",36
39,"39036",965,707,703,4,4,"PACMA",5
9,"9451",237,196,189,1,7,"PACMA",1
47,"47017",190,146,146,0,0,"PACMA",0
7,"7054",23257,12613,12464,111,149,"PACMA",199
50,"50053",643,476,466,3,10,"PACMA",2
50,"50147",744,508,506,5,2,"PACMA",3
11,"11016",15079,9353,9192,137,161,"PACMA",144
50,"50173",156,114,114,0,0,"PACMA",0
46,"46248",4868,3434,3374,16,60,"PACMA",20
38,"38049",2690,1406,1389,27,17,"PACMA",12
29,"29085",138,98,93,1,5,"PACMA",0
17,"17004",529,411,410,3,1,"PACMA",2
22,"22204",1117,728,723,14,5,"PACMA",7
37,"37259",39,28,28,1,0,"PACMA",1
34,"34125",105,80,80,2,0,"PACMA",0
46,"46064",532,395,387,3,8,"PACMA",2
33,"33042",4237,2862,2816,49,46,"PACMA",22
39,"39079",8850,6247,6175,28,72,"PACMA",47
17,"17106",142,114,114,0,0,"PACMA",1
41,"41020",13012,8148,7999,135,149,"PACMA",37
32,"32073",1273,863,857,6,6,"PACMA",1
12,"12098",529,417,413,3,4,"PACMA",0
26,"26071",8644,5668,5591,53,77,"PACMA",55
21,"21026",262,172,168,2,4,"PACMA",2
26,"26035",16,12,11,0,1,"PACMA",0
31,"31005",279,183,183,4,0,"PACMA",2
19,"19107",306,245,244,0,1,"PACMA",0
42,"42065",23,18,18,1,0,"PACMA",0
16,"16176",29,20,20,0,0,"PACMA",0
47,"47050",3908,2713,2673,39,40,"PACMA",20
50,"50203",1065,817,804,5,13,"PACMA",8
28,"28054",11943,8800,8731,72,69,"PACMA",78
37,"37189",114,75,74,1,1,"PACMA",0
48,"48019",3429,2424,2411,14,13,"PACMA",9
12,"12057",572,456,437,1,19,"PACMA",1
19,"19266",229,184,182,1,2,"PACMA",1
18,"18035",1179,882,870,7,12,"PACMA",0
26,"26052",146,106,105,0,1,"PACMA",0
11,"11017",3198,2054,2004,37,50,"PACMA",8
24,"24106",218,139,139,1,0,"PACMA",0
49,"49179",337,210,209,3,1,"PACMA",3
7,"7056",5271,3429,3386,44,43,"PACMA",53
31,"31153",2174,1417,1415,12,2,"PACMA",1
17,"17087",219,179,177,0,2,"PACMA",4
25,"25059",800,546,534,5,12,"PACMA",8
37,"37299",230,148,147,0,1,"PACMA",0
19,"19260",38,27,27,1,0,"PACMA",0
39,"39047",1998,1408,1392,8,16,"PACMA",7
40,"40194",39173,28641,28260,353,381,"PACMA",181
14,"14064",296,211,208,6,3,"PACMA",0
48,"48914",332,276,275,0,1,"PACMA",0
46,"46066",1274,972,970,4,2,"PACMA",8
23,"23007",3015,2252,2229,14,23,"PACMA",25
37,"37209",415,276,275,2,1,"PACMA",2
21,"21039",303,211,210,6,1,"PACMA",0
25,"25136",95,74,74,2,0,"PACMA",0
50,"50206",457,349,345,5,4,"PACMA",2
31,"31094",105,70,70,1,0,"PACMA",1
40,"40073",387,327,323,1,4,"PACMA",0
37,"37068",337,240,236,1,4,"PACMA",0
17,"17026",549,421,415,3,6,"PACMA",1
42,"42113",510,370,366,2,4,"PACMA",0
28,"28108",3736,2681,2652,21,29,"PACMA",44
44,"44025",5804,4024,3991,11,33,"PACMA",18
26,"26181",15,14,14,0,0,"PACMA",0
21,"21030",1887,1493,1458,12,35,"PACMA",8
29,"29045",1679,1162,1144,5,18,"PACMA",15
31,"31904",1559,989,972,11,17,"PACMA",7
49,"49235",415,300,290,4,10,"PACMA",0
44,"44155",1063,779,778,3,1,"PACMA",3
46,"46211",1862,1395,1381,12,14,"PACMA",20
41,"41030",501,376,366,9,10,"PACMA",4
18,"18056",3382,2397,2350,30,47,"PACMA",9
15,"15017",19866,13497,13344,195,153,"PACMA",146
46,"46143",4274,3027,2995,19,32,"PACMA",36
40,"40193",219,156,155,3,1,"PACMA",0
31,"31254",1916,1336,1322,9,14,"PACMA",2
43,"43140",2433,1685,1674,11,11,"PACMA",31
38,"38046",9267,6652,6594,55,58,"PACMA",64
40,"40068",22,21,21,0,0,"PACMA",0
6,"6094",1457,868,858,5,10,"PACMA",3
16,"16202",733,533,526,4,7,"PACMA",2
44,"44063",63,52,52,0,0,"PACMA",0
9,"9329",113,76,75,5,1,"PACMA",1
9,"9200",48,29,29,0,0,"PACMA",0
42,"42012",29,22,22,0,0,"PACMA",0
6,"6087",1999,1472,1455,13,17,"PACMA",4
17,"17148",1550,1121,1114,15,7,"PACMA",13
4,"4081",351,264,263,0,1,"PACMA",0
31,"31194",328,224,222,3,2,"PACMA",2
40,"40154",22,18,18,1,0,"PACMA",0
38,"38033",3593,2277,2242,15,35,"PACMA",9
45,"45073",288,214,210,2,4,"PACMA",0
10,"10215",438,266,262,2,4,"PACMA",1
12,"12022",323,257,254,5,3,"PACMA",1
36,"36038",66807,46235,45781,493,454,"PACMA",338
9,"9101",72,52,52,0,0,"PACMA",1
6,"6125",1644,1251,1222,7,29,"PACMA",2
3,"3067",91,78,78,0,0,"PACMA",3
44,"44168",181,119,117,1,2,"PACMA",0
33,"33020",12981,8550,8453,120,97,"PACMA",94
10,"10198",1053,897,889,4,8,"PACMA",2
10,"10021",4987,3574,3475,31,99,"PACMA",22
26,"26064",2335,1617,1584,28,33,"PACMA",8
15,"15023",6277,4021,3968,34,53,"PACMA",19
10,"10133",1159,914,893,4,21,"PACMA",1
50,"50075",70,55,55,1,0,"PACMA",0
46,"46198",862,670,660,3,10,"PACMA",25
31,"31013",615,371,365,1,6,"PACMA",0
19,"19122",81,62,60,2,2,"PACMA",0
14,"14046",4442,3283,3190,34,93,"PACMA",17
17,"17079",65572,47740,47502,279,238,"PACMA",512
19,"19015",82,74,73,1,1,"PACMA",0
37,"37347",463,349,345,9,4,"PACMA",3
19,"19278",24,20,20,0,0,"PACMA",0
43,"43905",15100,9689,9630,43,59,"PACMA",177
49,"49205",359,252,251,7,1,"PACMA",0
41,"41070",6451,4715,4632,70,83,"PACMA",75
47,"47146",275,215,214,1,1,"PACMA",6
46,"46072",3522,2792,2741,25,51,"PACMA",27
46,"46185",361,301,299,5,2,"PACMA",1
22,"22067",70,52,52,0,0,"PACMA",1
43,"43047",4234,2590,2564,19,26,"PACMA",47
47,"47164",349,283,281,1,2,"PACMA",0
5,"5189",397,293,291,3,2,"PACMA",0
4,"4037",1212,890,875,17,15,"PACMA",4
31,"31007",122,88,82,1,6,"PACMA",0
50,"50221",29,18,18,0,0,"PACMA",0
50,"50271",246,179,173,4,6,"PACMA",0
47,"47081",39,32,32,0,0,"PACMA",0
9,"9407",25,19,17,0,2,"PACMA",0
16,"16166",240,173,171,0,2,"PACMA",0
7,"7044",8812,5679,5569,67,110,"PACMA",56
3,"3074",1766,1347,1336,4,11,"PACMA",13
9,"9433",52,40,40,0,0,"PACMA",0
37,"37332",65,49,49,0,0,"PACMA",0
45,"45173",9756,6811,6720,49,91,"PACMA",38
13,"13019",5101,3502,3468,33,34,"PACMA",24
33,"33023",3249,2127,2097,30,30,"PACMA",4
28,"28070",105,80,80,3,0,"PACMA",2
42,"42171",111,72,71,1,1,"PACMA",0
16,"16012",76,66,66,0,0,"PACMA",0
37,"37179",197,167,165,0,2,"PACMA",0
19,"19265",134,97,97,5,0,"PACMA",0
6,"6105",592,367,363,1,4,"PACMA",2
16,"16909",655,493,488,4,5,"PACMA",2
40,"40082",104,84,84,2,0,"PACMA",0
15,"15027",1563,1159,1140,23,19,"PACMA",8
31,"31249",1798,1235,1227,13,8,"PACMA",3
2,"2070",373,306,301,6,5,"PACMA",3
45,"45088",2366,1526,1501,8,25,"PACMA",19
3,"3045",216,176,172,1,4,"PACMA",2
40,"40125",76,48,46,0,2,"PACMA",0
10,"10003",543,350,335,0,15,"PACMA",1
43,"43061",40,27,27,3,0,"PACMA",0
28,"28052",3961,2700,2659,14,41,"PACMA",17
12,"12039",792,665,659,2,6,"PACMA",0
11,"11024",6550,4500,4402,67,98,"PACMA",17
48,"48093",891,669,666,5,3,"PACMA",3
24,"24179",287,207,207,2,0,"PACMA",0
29,"29082",34683,24751,24495,263,256,"PACMA",395
18,"18014",6938,4864,4742,64,122,"PACMA",58
38,"38028",22144,14312,14174,89,138,"PACMA",179
3,"3072",352,281,277,3,4,"PACMA",4
3,"3101",4933,3502,3462,16,40,"PACMA",24
37,"37267",177,130,129,0,1,"PACMA",1
7,"7011",28971,17082,16964,164,118,"PACMA",237
29,"29022",177,137,136,1,1,"PACMA",2
16,"16016",217,157,157,1,0,"PACMA",2
43,"43059",250,193,192,1,1,"PACMA",0
45,"45035",286,206,204,2,2,"PACMA",4
9,"9065",136,112,111,0,1,"PACMA",1
6,"6017",250,202,198,0,4,"PACMA",0
24,"24002",224,165,162,1,3,"PACMA",0
37,"37336",56,45,43,2,2,"PACMA",0
50,"50079",226,162,160,1,2,"PACMA",1
9,"9369",419,288,284,3,4,"PACMA",1
50,"50902",77,65,62,0,3,"PACMA",0
13,"13069",613,438,419,2,19,"PACMA",0
20,"20046",1243,822,816,1,6,"PACMA",5
31,"31265",76,43,40,0,3,"PACMA",0
17,"17149",370,302,300,1,2,"PACMA",2
5,"5114",1257,989,968,5,21,"PACMA",3
38,"38050",2417,1288,1273,9,15,"PACMA",7
45,"45187",3967,3133,3074,16,59,"PACMA",18
46,"46130",862,633,625,6,8,"PACMA",4
37,"37071",76,64,62,1,2,"PACMA",0
42,"42021",65,46,45,2,1,"PACMA",0
40,"40086",656,513,496,7,17,"PACMA",1
46,"46234",317,247,245,1,2,"PACMA",4
28,"28053",6956,5475,5414,44,61,"PACMA",61
29,"29903",485,326,324,2,2,"PACMA",6
16,"16026",91,69,68,0,1,"PACMA",0
3,"3013",1063,809,794,3,15,"PACMA",7
45,"45151",544,413,409,0,4,"PACMA",1
38,"38020",16057,9921,9809,66,112,"PACMA",127
16,"16024",121,85,84,0,1,"PACMA",0
5,"5244",39,29,29,0,0,"PACMA",0
31,"31214",87,55,54,0,1,"PACMA",0
19,"19306",24,18,18,0,0,"PACMA",0
1,"1014",366,271,266,2,5,"PACMA",2
22,"22054",1614,1029,1009,19,20,"PACMA",16
46,"46008",2617,1954,1931,17,23,"PACMA",18
21,"21001",621,431,418,0,13,"PACMA",3
45,"45025",1218,849,844,9,5,"PACMA",10
50,"50200",479,389,383,5,6,"PACMA",0
18,"18069",484,356,356,5,0,"PACMA",1
49,"49238",273,205,200,4,5,"PACMA",0
46,"46102",19696,14700,14579,125,121,"PACMA",183
43,"43043",3317,2457,2445,12,12,"PACMA",26
34,"34063",84,74,74,1,0,"PACMA",0
10,"10147",1277,873,837,6,36,"PACMA",4
37,"37321",150,118,115,0,3,"PACMA",0
39,"39063",936,618,616,4,2,"PACMA",0
34,"34222",107,71,68,1,3,"PACMA",0
48,"48050",188,141,141,0,0,"PACMA",0
37,"37370",316,238,237,2,1,"PACMA",0
46,"46226",29,20,19,0,1,"PACMA",0
14,"14052",9039,5579,5478,79,101,"PACMA",31
37,"37325",88,63,63,0,0,"PACMA",0
31,"31261",240,161,158,2,3,"PACMA",3
9,"9408",40,29,29,0,0,"PACMA",0
18,"18077",471,350,343,1,7,"PACMA",0
10,"10179",272,209,209,2,0,"PACMA",1
5,"5217",54,42,41,0,1,"PACMA",0
46,"46148",1515,1131,1113,5,18,"PACMA",13
37,"37304",156,97,96,1,1,"PACMA",0
37,"37373",692,451,442,4,9,"PACMA",1
43,"43136",10489,7029,6996,47,33,"PACMA",32
45,"45121",7345,4949,4899,24,50,"PACMA",38
36,"36054",11107,7027,6894,57,133,"PACMA",52
6,"6054",5452,3773,3657,34,116,"PACMA",17
32,"32061",1078,777,770,5,7,"PACMA",2
25,"25201",110,81,81,0,0,"PACMA",1
31,"31082",627,385,385,5,0,"PACMA",0
42,"42208",20,12,12,1,0,"PACMA",0
18,"18168",783,566,561,11,5,"PACMA",2
46,"46016",1070,827,814,10,13,"PACMA",4
40,"40181",4182,3102,3038,35,64,"PACMA",15
49,"49085",904,583,579,5,4,"PACMA",1
26,"26022",177,130,128,0,2,"PACMA",1
50,"50220",45,38,38,0,0,"PACMA",0
16,"16225",55,30,30,0,0,"PACMA",0
31,"31163",2011,1422,1404,6,18,"PACMA",8
31,"31070",2633,1714,1682,16,32,"PACMA",12
39,"39014",882,538,536,0,2,"PACMA",2
16,"16280",163,122,119,2,3,"PACMA",0
43,"43171",14849,10140,10081,76,59,"PACMA",185
10,"10052",172,114,113,3,1,"PACMA",3
31,"31126",352,223,223,3,0,"PACMA",0
26,"26002",821,611,597,1,14,"PACMA",2
9,"9389",63,45,45,0,0,"PACMA",1
17,"17102",556,398,396,1,2,"PACMA",1
44,"44074",440,314,308,2,6,"PACMA",1
42,"42090",83,65,64,1,1,"PACMA",0
10,"10065",199,135,135,0,0,"PACMA",0
45,"45042",172,122,121,0,1,"PACMA",0
16,"16155",490,389,388,7,1,"PACMA",4
9,"9463",246,174,174,4,0,"PACMA",0
45,"45039",201,157,157,0,0,"PACMA",2
46,"46155",972,731,716,3,15,"PACMA",10
16,"16243",376,316,309,4,7,"PACMA",1
45,"45186",2943,2142,2121,12,21,"PACMA",8
11,"11001",4360,2810,2744,32,66,"PACMA",9
44,"44129",35,29,29,1,0,"PACMA",0
12,"12005",8049,5643,5552,71,91,"PACMA",47
49,"49169",38,33,32,0,1,"PACMA",0
17,"17130",325,270,270,1,0,"PACMA",1
37,"37091",161,104,104,0,0,"PACMA",1
24,"24157",2542,1846,1809,16,37,"PACMA",7
27,"27037",1001,714,707,11,7,"PACMA",1
10,"10107",1019,766,755,12,11,"PACMA",0
47,"47228",432,324,320,2,4,"PACMA",0
5,"5149",101,72,71,2,1,"PACMA",0
18,"18106",413,270,261,3,9,"PACMA",0
18,"18108",822,604,599,2,5,"PACMA",2
31,"31017",375,250,250,10,0,"PACMA",2
29,"29039",2759,1900,1860,23,40,"PACMA",21
10,"10083",96,76,74,0,2,"PACMA",0
19,"19297",32,28,28,0,0,"PACMA",0
47,"47139",997,728,719,4,9,"PACMA",1
28,"28161",52164,38607,38193,306,414,"PACMA",449
19,"19219",9,8,7,0,1,"PACMA",0
37,"37285",360,271,270,0,1,"PACMA",0
9,"9362",198,156,156,4,0,"PACMA",1
40,"40135",277,212,210,3,2,"PACMA",0
16,"16081",50,37,36,0,1,"PACMA",0
50,"50156",212,156,151,2,5,"PACMA",0
2,"2014",354,254,252,3,2,"PACMA",0
15,"15069",6604,4587,4520,55,67,"PACMA",36
26,"26014",443,278,273,3,5,"PACMA",0
12,"12059",220,183,183,2,0,"PACMA",0
9,"9057",147,110,108,0,2,"PACMA",0
43,"43104",1767,1285,1271,4,14,"PACMA",4
6,"6109",3821,2943,2813,16,130,"PACMA",7
16,"16189",264,196,194,4,2,"PACMA",1
44,"44031",83,50,50,0,0,"PACMA",0
31,"31114",388,272,271,3,1,"PACMA",5
22,"22060",1167,817,808,14,9,"PACMA",2
10,"10024",672,492,480,6,12,"PACMA",3
47,"47110",445,335,327,1,8,"PACMA",0
39,"39029",629,476,469,1,7,"PACMA",2
31,"31077",5416,3840,3794,38,46,"PACMA",24
3,"3125",332,226,226,2,0,"PACMA",0
25,"25143",82,63,62,0,1,"PACMA",0
24,"24201",1029,683,676,9,7,"PACMA",4
10,"10103",422,290,286,1,4,"PACMA",2
13,"13029",89,67,65,0,2,"PACMA",0
3,"3079",18422,13560,13378,152,182,"PACMA",160
24,"24187",834,559,549,11,10,"PACMA",0
37,"37311",201,157,156,1,1,"PACMA",2
7,"7052",4853,2765,2743,33,22,"PACMA",40
24,"24196",1907,1322,1299,4,23,"PACMA",3
40,"40145",1098,824,820,4,4,"PACMA",2
5,"5083",137,92,91,0,1,"PACMA",0
50,"50168",29,20,20,0,0,"PACMA",1
37,"37113",404,286,285,13,1,"PACMA",0
27,"27009",2005,1324,1303,11,21,"PACMA",7
19,"19060",157,123,122,0,1,"PACMA",1
50,"50029",594,432,431,3,1,"PACMA",0
13,"13088",585,413,409,3,4,"PACMA",1
19,"19232",56,40,40,0,0,"PACMA",0
43,"43040",325,268,267,1,1,"PACMA",0
31,"31241",126,86,85,2,1,"PACMA",0
3,"3063",27209,18236,18101,164,135,"PACMA",181
9,"9375",42,35,35,0,0,"PACMA",1
50,"50253",379,294,290,1,4,"PACMA",2
31,"31162",48,28,27,1,1,"PACMA",2
13,"13033",1544,1231,1196,5,35,"PACMA",5
7,"7055",8062,4546,4492,40,54,"PACMA",47
50,"50024",543,400,397,3,3,"PACMA",1
18,"18028",898,723,718,3,5,"PACMA",4
17,"17176",128,111,111,0,0,"PACMA",2
12,"12114",200,144,140,0,4,"PACMA",0
41,"41097",3131,2197,2140,13,57,"PACMA",7
26,"26167",50,34,33,1,1,"PACMA",0
45,"45195",2064,1519,1481,9,38,"PACMA",5
19,"19021",978,678,662,3,16,"PACMA",5
10,"10188",483,354,340,0,14,"PACMA",2
28,"28006",80903,60936,60508,482,428,"PACMA",533
7,"7029",4393,2888,2855,37,33,"PACMA",24
49,"49059",84,61,58,0,3,"PACMA",0
44,"44119",116,80,79,1,1,"PACMA",0
10,"10120",153,97,97,0,0,"PACMA",2
11,"11902",3664,2123,2094,46,29,"PACMA",14
23,"23097",6346,4243,4194,31,49,"PACMA",21
25,"25204",1187,858,849,13,9,"PACMA",7
20,"20003",549,360,355,1,5,"PACMA",2
46,"46097",948,670,663,1,7,"PACMA",8
49,"49068",422,263,261,4,2,"PACMA",0
5,"5016",6355,4677,4584,28,93,"PACMA",12
34,"34069",2184,1555,1517,17,38,"PACMA",6
9,"9288",87,64,64,0,0,"PACMA",0
14,"14045",2997,2329,2287,30,42,"PACMA",11
46,"46223",7776,5848,5798,36,50,"PACMA",72
2,"2047",110,83,81,0,2,"PACMA",0
50,"50165",1768,1255,1222,20,33,"PACMA",10
24,"24009",274,136,135,1,1,"PACMA",0
46,"46216",5277,4146,4111,42,35,"PACMA",41
47,"47153",101,69,69,1,0,"PACMA",0
28,"28010",10649,8167,8098,76,69,"PACMA",92
24,"24026",1085,724,712,14,12,"PACMA",3
13,"13044",2582,1838,1804,13,34,"PACMA",3
41,"41080",1231,832,815,14,17,"PACMA",4
46,"46062",4552,3402,3362,27,40,"PACMA",27
28,"28167",8640,6564,6504,51,60,"PACMA",92
12,"12075",110,85,83,3,2,"PACMA",0
17,"17057",968,770,769,7,1,"PACMA",9
29,"29074",771,561,555,1,6,"PACMA",3
37,"37212",104,76,76,0,0,"PACMA",0
9,"9277",103,84,82,1,2,"PACMA",0
37,"37136",625,388,387,7,1,"PACMA",0
43,"43162",4436,3191,3163,24,28,"PACMA",36
32,"32029",441,286,283,2,3,"PACMA",0
5,"5055",532,417,413,3,4,"PACMA",5
37,"37130",173,135,134,2,1,"PACMA",0
19,"19242",74,53,53,1,0,"PACMA",0
37,"37346",251,208,207,1,1,"PACMA",1
39,"39020",23993,15944,15792,89,152,"PACMA",149
47,"47029",50,37,35,1,2,"PACMA",0
30,"30029",12122,8231,8125,54,106,"PACMA",61
6,"6160",3005,2083,2056,9,27,"PACMA",3
7,"7051",5484,3133,3094,43,39,"PACMA",44
43,"43066",158,108,108,1,0,"PACMA",1
37,"37275",98,67,67,0,0,"PACMA",0
31,"31191",3024,2156,2133,23,23,"PACMA",10
47,"47163",277,208,205,3,3,"PACMA",0
20,"20056",4077,2796,2781,12,15,"PACMA",6
26,"26110",149,116,114,0,2,"PACMA",0
37,"37029",186,125,124,1,1,"PACMA",0
6,"6903",2011,1443,1416,18,27,"PACMA",5
7,"7015",22248,12375,12286,202,89,"PACMA",163
31,"31187",99,53,52,0,1,"PACMA",0
11,"11037",5656,4374,4273,24,101,"PACMA",20
10,"10020",1571,1135,1117,2,18,"PACMA",3
6,"6018",727,483,476,0,7,"PACMA",3
41,"41039",31538,22078,21717,278,361,"PACMA",263
3,"3051",342,288,286,4,2,"PACMA",1
37,"37059",117,95,95,3,0,"PACMA",0
18,"18001",222,147,146,0,1,"PACMA",1
32,"32004",1608,835,824,5,11,"PACMA",1
37,"37356",84,58,58,0,0,"PACMA",0
24,"24051",389,275,269,1,6,"PACMA",1
15,"15034",2712,1605,1585,15,20,"PACMA",3
19,"19335",51,39,38,0,1,"PACMA",0
25,"25085",141,109,108,2,1,"PACMA",0
16,"16109",41,30,30,0,0,"PACMA",0
25,"25088",96,73,73,0,0,"PACMA",0
44,"44049",784,539,532,3,7,"PACMA",2
42,"42098",8,7,7,0,0,"PACMA",0
45,"45149",517,400,393,2,7,"PACMA",3
43,"43168",83,55,55,1,0,"PACMA",1
49,"49056",285,191,190,3,1,"PACMA",1
5,"5127",600,472,469,7,3,"PACMA",3
24,"24160",633,404,403,2,1,"PACMA",5
16,"16036",120,94,93,0,1,"PACMA",1
16,"16044",43,29,28,0,1,"PACMA",0
6,"6099",1156,683,652,5,31,"PACMA",0
32,"32012",708,448,440,2,8,"PACMA",1
26,"26066",263,201,194,5,7,"PACMA",0
43,"43093",3863,2728,2716,22,12,"PACMA",30
24,"24015",2193,1532,1500,12,32,"PACMA",6
19,"19182",37,32,32,0,0,"PACMA",0
10,"10102",496,378,377,1,1,"PACMA",0
9,"9400",307,225,224,4,1,"PACMA",0
6,"6155",1810,1172,1140,23,32,"PACMA",3
48,"48077",3366,2483,2467,9,16,"PACMA",15
24,"24121",599,422,418,3,4,"PACMA",1
4,"4027",218,130,130,0,0,"PACMA",5
3,"3118",2446,1617,1598,8,19,"PACMA",12
16,"16188",74,57,57,1,0,"PACMA",0
19,"19017",56,47,47,0,0,"PACMA",1
6,"6098",530,379,376,4,3,"PACMA",0
44,"44065",55,33,32,0,1,"PACMA",0
19,"19080",67,47,47,0,0,"PACMA",0
28,"28111",629,479,475,2,4,"PACMA",3
37,"37133",101,73,69,1,4,"PACMA",0
45,"45051",1678,1238,1209,13,29,"PACMA",2
9,"9308",58,34,34,1,0,"PACMA",0
14,"14023",1999,1629,1593,11,36,"PACMA",5
26,"26034",606,457,440,5,17,"PACMA",1
31,"31908",1076,763,762,5,1,"PACMA",5
28,"28135",998,712,703,2,9,"PACMA",5
47,"47008",22,13,13,0,0,"PACMA",0
37,"37154",129,97,94,1,3,"PACMA",0
19,"19213",67,53,52,1,1,"PACMA",0
20,"20073",4707,3272,3260,14,12,"PACMA",13
50,"50228",249,207,207,3,0,"PACMA",0
17,"17182",269,195,195,0,0,"PACMA",5
45,"45038",3528,2556,2521,26,35,"PACMA",24
19,"19283",29,26,26,0,0,"PACMA",0
25,"25076",131,91,91,0,0,"PACMA",0
20,"20080",7705,5276,5244,21,32,"PACMA",25
8,"8079",333,260,258,2,2,"PACMA",1
8,"8047",3751,2600,2578,26,22,"PACMA",15
8,"8153",573,457,452,3,5,"PACMA",2
8,"8195",75,62,62,0,0,"PACMA",0
8,"8011",1739,1360,1353,10,7,"PACMA",3
8,"8255",133,100,100,2,0,"PACMA",0
8,"8282",6731,5333,5317,40,16,"PACMA",57
8,"8262",6945,4649,4599,38,50,"PACMA",41
8,"8171",2046,1520,1510,13,10,"PACMA",10
8,"8004",208,177,177,1,0,"PACMA",0
8,"8085",986,769,767,6,2,"PACMA",5
8,"8055",542,426,424,3,2,"PACMA",4
8,"8123",19570,15378,15316,91,62,"PACMA",151
8,"8075",4144,2951,2943,20,8,"PACMA",52
8,"8271",66,48,47,2,1,"PACMA",0
8,"8138",4461,3286,3259,27,27,"PACMA",22
8,"8115",3826,2777,2770,31,7,"PACMA",36
8,"8286",2943,2051,2042,12,9,"PACMA",43
8,"8070",269,215,211,1,4,"PACMA",0
8,"8031",2339,1760,1750,15,10,"PACMA",9
8,"8261",2405,1726,1718,11,8,"PACMA",25
8,"8223",1897,1345,1341,10,4,"PACMA",17
8,"8251",5130,3719,3698,20,21,"PACMA",54
8,"8216",25,17,17,0,0,"PACMA",0
8,"8902",3941,2974,2962,16,12,"PACMA",29
8,"8148",2344,1655,1646,13,9,"PACMA",32
8,"8232",1773,1368,1362,9,6,"PACMA",9
8,"8146",1384,1030,1027,8,3,"PACMA",13
8,"8202",12943,9408,9358,58,50,"PACMA",98
8,"8054",9215,6994,6943,38,51,"PACMA",98
8,"8183",4573,3406,3398,14,8,"PACMA",29
8,"8184",55053,38519,38323,298,196,"PACMA",631
8,"8100",2083,1707,1699,13,8,"PACMA",4
8,"8203",2466,1678,1675,7,3,"PACMA",25
8,"8198",4679,3491,3469,12,22,"PACMA",35
8,"8191",5302,3872,3860,21,12,"PACMA",32
8,"8266",43422,32827,32696,241,131,"PACMA",415
8,"8159",14343,10656,10603,87,53,"PACMA",139
8,"8103",652,476,474,1,2,"PACMA",2
8,"8068",6863,5064,5041,40,23,"PACMA",92
8,"8032",2100,1472,1465,12,7,"PACMA",19
8,"8201",455,319,318,12,1,"PACMA",5
8,"8208",5793,4267,4244,21,23,"PACMA",82
8,"8077",34690,25896,25767,164,129,"PACMA",288
8,"8117",2489,1954,1941,21,13,"PACMA",9
8,"8080",40,27,27,3,0,"PACMA",0
8,"8061",1628,1154,1151,15,3,"PACMA",12
8,"8197",7986,5829,5805,37,24,"PACMA",68
8,"8196",19542,14264,14185,123,79,"PACMA",195
8,"8249",274,238,237,0,1,"PACMA",5
8,"8901",240,200,195,2,5,"PACMA",1
8,"8162",2118,1581,1576,13,5,"PACMA",29
8,"8154",697,541,539,3,2,"PACMA",10
8,"8209",6925,4976,4948,39,28,"PACMA",66
8,"8062",1009,778,776,9,2,"PACMA",9
8,"8045",65,44,43,0,1,"PACMA",0
8,"8131",745,552,550,3,2,"PACMA",1
8,"8030",5208,4045,4033,25,12,"PACMA",44
8,"8269",2729,2114,2105,9,9,"PACMA",10
8,"8106",7500,5442,5410,43,32,"PACMA",77
8,"8218",8091,5899,5869,50,30,"PACMA",49
8,"8287",1067,853,844,4,9,"PACMA",7
8,"8135",6770,5187,5158,42,29,"PACMA",67
8,"8065",1183,920,913,8,7,"PACMA",10
8,"8150",258,207,207,1,0,"PACMA",2
8,"8213",6600,4925,4906,30,19,"PACMA",55
8,"8147",17389,12679,12601,102,78,"PACMA",195
8,"8905",2329,1872,1863,7,9,"PACMA",22
8,"8298",27148,19655,19568,102,87,"PACMA",151
8,"8168",388,280,279,3,1,"PACMA",4
8,"8007",6795,5099,5081,29,18,"PACMA",49
8,"8098",2438,1781,1778,21,3,"PACMA",28
8,"8304",822,655,655,5,0,"PACMA",4
8,"8238",14946,11911,11873,85,38,"PACMA",132
8,"8023",7029,5027,5000,39,27,"PACMA",70
8,"8125",25583,18334,18225,122,109,"PACMA",246
8,"8124",37157,27139,26994,179,145,"PACMA",363
8,"8270",19014,13635,13594,74,41,"PACMA",207
8,"8214",7007,5390,5371,25,19,"PACMA",66
8,"8130",110,81,81,2,0,"PACMA",0
8,"8120",7129,5649,5621,51,28,"PACMA",46
8,"8279",156327,112605,112030,952,575,"PACMA",1698
8,"8192",5701,4366,4349,15,17,"PACMA",33
8,"8190",255,184,182,1,2,"PACMA",0
8,"8233",1872,1428,1420,15,8,"PACMA",3
8,"8274",4640,3385,3363,24,22,"PACMA",29
8,"8017",2808,2033,2016,16,17,"PACMA",14
8,"8096",43926,32120,31960,217,160,"PACMA",379
8,"8241",70,52,52,0,0,"PACMA",0
8,"8109",207,176,174,0,2,"PACMA",1
8,"8102",28940,21108,21014,157,94,"PACMA",194
8,"8245",77841,53719,53443,430,276,"PACMA",690
8,"8199",648,509,508,3,1,"PACMA",0
8,"8025",1573,1170,1160,9,10,"PACMA",17
8,"8285",10349,7630,7599,48,31,"PACMA",53
8,"8305",27661,20346,20221,118,125,"PACMA",181
8,"8012",1726,1323,1309,17,14,"PACMA",9
8,"8267",6789,4975,4935,41,40,"PACMA",71
8,"8188",115,89,89,0,0,"PACMA",0
8,"8210",4640,3226,3200,24,26,"PACMA",37
8,"8033",13262,9887,9833,64,54,"PACMA",106
8,"8048",580,427,426,1,1,"PACMA",0
8,"8295",11290,8091,8054,72,37,"PACMA",121
8,"8083",1672,1433,1430,6,3,"PACMA",2
8,"8289",4473,3379,3371,25,8,"PACMA",32
8,"8071",249,209,208,0,1,"PACMA",0
8,"8301",49348,36261,36045,292,216,"PACMA",555
8,"8252",24885,18507,18383,162,124,"PACMA",284
8,"8022",12213,8594,8558,42,36,"PACMA",56
8,"8217",25466,19864,19773,129,91,"PACMA",237
8,"8145",2712,2060,2049,8,11,"PACMA",28
8,"8121",87515,62961,62574,429,387,"PACMA",837
8,"8169",48478,35283,35114,278,169,"PACMA",464
8,"8101",175048,121359,120620,830,739,"PACMA",1493
8,"8256",693,542,542,3,0,"PACMA",9
8,"8132",356,265,265,1,0,"PACMA",2
8,"8034",820,644,640,0,4,"PACMA",9
8,"8037",1947,1547,1543,11,4,"PACMA",7
8,"8237",1644,1263,1254,9,9,"PACMA",9
8,"8060",139,110,108,1,2,"PACMA",0
8,"8069",3323,2555,2540,21,15,"PACMA",36
8,"8236",1564,1145,1133,4,12,"PACMA",11
8,"8158",3094,2261,2251,11,10,"PACMA",35
8,"8078",216,154,154,2,0,"PACMA",0
8,"8200",62225,45235,44991,306,244,"PACMA",614
8,"8128",579,428,423,4,5,"PACMA",1
8,"8228",292,234,233,0,1,"PACMA",3
8,"8290",1549,1254,1248,6,6,"PACMA",13
8,"8015",156540,109145,108440,957,705,"PACMA",1522
8,"8239",467,362,361,3,1,"PACMA",5
8,"8006",11774,8375,8329,53,46,"PACMA",96
8,"8114",18838,13519,13442,81,77,"PACMA",171
8,"8229",521,418,417,3,1,"PACMA",3
8,"8113",52589,36864,36690,244,174,"PACMA",346
8,"8134",848,618,609,4,9,"PACMA",11
8,"8035",13006,8957,8918,50,39,"PACMA",128
8,"8009",9531,7200,7171,47,29,"PACMA",74
8,"8049",1309,910,903,3,7,"PACMA",2
8,"8082",1164,796,780,5,16,"PACMA",15
8,"8026",195,148,146,0,2,"PACMA",1
8,"8005",6425,4830,4816,28,14,"PACMA",62
8,"8093",25,22,22,0,0,"PACMA",0
8,"8139",172,148,147,2,1,"PACMA",0
8,"8170",442,322,320,0,2,"PACMA",3
8,"8221",12793,10123,10079,73,44,"PACMA",99
8,"8086",14137,9971,9912,77,59,"PACMA",139
8,"8275",247,218,218,3,0,"PACMA",0
8,"8018",2540,1862,1855,7,7,"PACMA",16
8,"8258",815,636,632,5,4,"PACMA",0
8,"8278",4925,3820,3804,22,16,"PACMA",20
8,"8189",119,96,96,1,0,"PACMA",0
8,"8303",257,207,205,1,2,"PACMA",0
8,"8194",25680,16465,16376,131,89,"PACMA",275
8,"8179",636,466,465,2,1,"PACMA",11
8,"8248",5687,4187,4165,21,22,"PACMA",51
8,"8040",11116,7923,7891,49,32,"PACMA",95
8,"8178",444,363,361,2,2,"PACMA",5
8,"8212",491,393,386,6,7,"PACMA",0
8,"8094",1588,1258,1252,7,6,"PACMA",13
8,"8161",11826,8001,7951,58,50,"PACMA",142
8,"8024",357,282,282,2,0,"PACMA",1
8,"8112",12926,9268,9230,61,38,"PACMA",70
8,"8074",11190,7698,7651,51,47,"PACMA",99
8,"8207",2026,1667,1659,12,8,"PACMA",8
8,"8176",158,119,119,0,0,"PACMA",1
8,"8140",4816,3541,3520,25,21,"PACMA",30
8,"8073",62934,45699,45407,281,292,"PACMA",529
8,"8250",7235,4917,4876,41,41,"PACMA",58
8,"8280",93,76,75,1,1,"PACMA",0
8,"8157",8574,6514,6472,47,42,"PACMA",72
8,"8206",744,604,599,5,5,"PACMA",4
8,"8277",168,148,146,1,2,"PACMA",0
8,"8063",469,390,390,4,0,"PACMA",6
8,"8187",153822,113081,112470,758,611,"PACMA",1479
8,"8234",3443,2561,2550,15,11,"PACMA",42
8,"8300",5927,4609,4589,41,20,"PACMA",74
8,"8059",340,255,250,1,5,"PACMA",0
8,"8052",140,102,102,1,0,"PACMA",1
8,"8193",988,739,737,10,2,"PACMA",9
8,"8019",1122912,824423,821037,5287,3386,"PACMA",8237
8,"8050",139,118,115,4,3,"PACMA",1
8,"8116",557,449,449,1,0,"PACMA",2
8,"8129",486,399,398,0,1,"PACMA",5
8,"8185",197,162,162,1,0,"PACMA",1
8,"8247",982,799,798,4,1,"PACMA",4
8,"8281",4858,3783,3762,19,21,"PACMA",49
8,"8057",61,47,47,1,0,"PACMA",0
8,"8046",13541,10510,10455,73,55,"PACMA",95
8,"8263",21208,15014,14890,111,124,"PACMA",219
8,"8126",8906,6673,6646,41,27,"PACMA",92
8,"8043",3414,2429,2422,15,7,"PACMA",30
8,"8056",42897,30873,30757,259,116,"PACMA",455
8,"8164",936,750,747,6,3,"PACMA",5
8,"8308",139,109,109,1,0,"PACMA",0
8,"8272",164,128,128,1,0,"PACMA",0
8,"8014",2013,1526,1521,4,5,"PACMA",23
8,"8095",66,49,49,0,0,"PACMA",1
8,"8136",11692,8527,8456,98,71,"PACMA",122
8,"8151",450,351,346,5,5,"PACMA",0
8,"8180",27198,19822,19704,160,118,"PACMA",277
8,"8090",142,116,116,0,0,"PACMA",1
8,"8294",2093,1546,1534,11,12,"PACMA",20
8,"8084",1172,902,894,9,8,"PACMA",15
8,"8293",227,177,177,0,0,"PACMA",3
8,"8010",4224,3109,3090,22,19,"PACMA",34
8,"8038",1541,1129,1120,6,9,"PACMA",17
8,"8013",1287,982,972,6,10,"PACMA",12
8,"8133",123,96,94,5,2,"PACMA",0
8,"8273",2390,1871,1855,14,16,"PACMA",18
8,"8220",2411,2010,2001,8,9,"PACMA",3
8,"8108",5181,3880,3861,30,19,"PACMA",43
8,"8242",223,159,159,0,0,"PACMA",1
8,"8039",413,322,321,1,1,"PACMA",4
8,"8029",3586,2868,2862,20,6,"PACMA",28
8,"8284",12597,8244,8183,60,61,"PACMA",108
8,"8105",9741,6946,6896,62,50,"PACMA",103
8,"8118",17634,13450,13402,80,48,"PACMA",167
8,"8240",9469,7351,7327,39,24,"PACMA",46
8,"8001",9097,6860,6818,39,42,"PACMA",131
8,"8137",272,208,207,2,1,"PACMA",2
8,"8302",9359,6483,6430,78,53,"PACMA",68
8,"8111",216,195,194,2,1,"PACMA",0
8,"8224",885,653,652,6,1,"PACMA",6
8,"8143",2727,1989,1977,19,12,"PACMA",26
8,"8175",3369,2388,2372,18,16,"PACMA",24
8,"8067",5746,4299,4270,24,29,"PACMA",36
8,"8165",1680,1177,1171,7,6,"PACMA",20
8,"8155",7056,5050,5011,38,39,"PACMA",86
8,"8097",1103,845,840,4,5,"PACMA",11
8,"8163",19672,13421,13364,70,57,"PACMA",169
8,"8204",3141,2395,2383,16,12,"PACMA",32
8,"8064",1956,1439,1423,7,16,"PACMA",17
8,"8041",10698,7324,7258,57,66,"PACMA",88
8,"8002",217,172,172,2,0,"PACMA",0
8,"8211",33934,26136,26000,198,136,"PACMA",306
8,"8156",11254,8440,8411,58,29,"PACMA",103
8,"8227",2420,1775,1769,11,6,"PACMA",13
8,"8166",964,700,697,7,3,"PACMA",3
8,"8177",36,27,27,1,0,"PACMA",1
8,"8264",4608,3459,3444,30,15,"PACMA",35
8,"8259",6979,5362,5341,27,21,"PACMA",56
8,"8244",6099,4733,4706,39,27,"PACMA",61
8,"8904",10516,7068,7025,54,43,"PACMA",131
8,"8072",10769,7632,7600,56,32,"PACMA",102
8,"8253",132,103,102,0,1,"PACMA",2
8,"8299",380,301,300,4,1,"PACMA",2
8,"8225",94,83,82,1,1,"PACMA",0
8,"8222",1821,1439,1424,7,15,"PACMA",15
8,"8292",1074,796,790,2,6,"PACMA",21
8,"8042",2390,1772,1764,12,8,"PACMA",29
8,"8254",1766,1433,1427,16,6,"PACMA",9
8,"8104",657,496,493,4,3,"PACMA",5
8,"8182",2922,2041,2031,10,10,"PACMA",24
8,"8246",1692,1345,1340,7,5,"PACMA",11
8,"8110",13671,9362,9311,60,51,"PACMA",121
8,"8160",317,234,234,0,0,"PACMA",1
8,"8230",7648,5797,5774,40,23,"PACMA",68
8,"8089",34190,24548,24404,194,144,"PACMA",368
8,"8122",1733,1179,1175,4,4,"PACMA",17
8,"8307",49499,35471,35312,199,159,"PACMA",393
8,"8149",980,702,694,6,8,"PACMA",2
8,"8127",2254,1548,1544,10,4,"PACMA",22
8,"8141",4578,3369,3357,28,12,"PACMA",24
8,"8219",15755,12235,12206,72,29,"PACMA",115
8,"8088",12347,9316,9270,75,46,"PACMA",68
8,"8044",4156,2991,2976,16,15,"PACMA",24
8,"8016",1803,1371,1363,11,8,"PACMA",8
8,"8297",138,99,99,0,0,"PACMA",1
8,"8028",1125,744,743,7,1,"PACMA",10
8,"8087",144,120,120,0,0,"PACMA",1
8,"8152",117,94,94,0,0,"PACMA",1
8,"8283",6165,4546,4524,33,22,"PACMA",39
8,"8091",5428,4048,4024,20,24,"PACMA",51
8,"8053",2896,1939,1929,13,10,"PACMA",16
8,"8288",1696,1103,1096,9,7,"PACMA",22
8,"8226",929,748,747,10,1,"PACMA",4
8,"8903",201,181,181,1,0,"PACMA",2
8,"8268",975,729,723,6,6,"PACMA",9
8,"8099",753,529,529,4,0,"PACMA",2
8,"8231",21269,14655,14573,111,82,"PACMA",219
8,"8021",60,44,44,1,0,"PACMA",0
8,"8092",3713,2758,2745,9,13,"PACMA",8
8,"8215",2617,1954,1946,22,8,"PACMA",11
8,"8235",3875,3004,2996,19,8,"PACMA",19
8,"8036",163,122,122,0,0,"PACMA",1
8,"8167",6056,4520,4500,38,20,"PACMA",84
8,"8276",241,179,179,3,0,"PACMA",3
8,"8051",18570,14112,14054,86,58,"PACMA",186
8,"8076",16526,11988,11893,90,95,"PACMA",223
8,"8172",20543,15191,15140,85,51,"PACMA",171
8,"8243",154,125,125,2,0,"PACMA",0
8,"8181",8133,5949,5924,31,25,"PACMA",89
8,"8142",136,117,117,3,0,"PACMA",0
8,"8119",6897,5096,5052,31,44,"PACMA",75
8,"8265",1597,1262,1260,4,2,"PACMA",4
8,"8296",1869,1412,1408,10,4,"PACMA",21
8,"8205",61957,49325,49196,441,129,"PACMA",508
8,"8291",4972,3531,3519,23,12,"PACMA",49
8,"8174",388,322,318,2,4,"PACMA",4
8,"8058",1808,1280,1262,6,18,"PACMA",14
8,"8257",103,82,82,0,0,"PACMA",0
8,"8144",722,551,545,3,6,"PACMA",0
8,"8008",175,136,136,2,0,"PACMA",1
8,"8260",18515,13563,13487,84,76,"PACMA",211
8,"8066",1466,1109,1104,7,5,"PACMA",17
8,"8003",7213,5425,5409,41,16,"PACMA",51
8,"8020",5243,4117,4100,29,17,"PACMA",43
8,"8306",535,368,368,5,0,"PACMA",9
8,"8107",11965,8604,8554,67,50,"PACMA",131
8,"8027",724,584,582,1,2,"PACMA",7
8,"8081",349,274,270,0,4,"PACMA",4
40,"40035",135,110,110,2,0,"PCOE",0
44,"44024",31,26,25,0,1,"PCOE",0
29,"29031",1555,1015,986,6,29,"PCOE",1
19,"19092",395,286,279,2,7,"PCOE",1
19,"19105",2550,1913,1889,10,24,"PCOE",4
11,"11032",54731,31560,31284,492,276,"PCOE",119
41,"41001",1558,1129,1104,6,25,"PCOE",0
29,"29065",191,145,143,3,2,"PCOE",0
19,"19296",29,24,24,0,0,"PCOE",0
40,"40190",43,37,35,0,2,"PCOE",0
40,"40123",141,98,94,4,4,"PCOE",1
29,"29075",12886,8292,8191,63,101,"PCOE",14
14,"14006",1319,1088,1057,8,31,"PCOE",1
12,"12009",17943,12389,12292,102,97,"PCOE",12
29,"29002",1143,777,766,6,11,"PCOE",1
27,"27027",1791,1198,1167,17,31,"PCOE",0
41,"41043",669,447,436,11,11,"PCOE",0
44,"44124",71,57,57,0,0,"PCOE",0
44,"44142",29,21,21,0,0,"PCOE",0
19,"19046",22204,16001,15752,156,249,"PCOE",26
19,"19263",21,15,15,0,0,"PCOE",0
40,"40115",142,100,100,0,0,"PCOE",0
40,"40003",116,82,79,3,3,"PCOE",0
21,"21068",973,562,556,11,6,"PCOE",2
40,"40080",51,31,31,0,0,"PCOE",0
29,"29030",770,618,611,4,7,"PCOE",0
15,"15015",2877,1845,1821,26,24,"PCOE",1
15,"15064",2103,1458,1447,20,11,"PCOE",0
27,"27056",1218,787,778,6,9,"PCOE",0
44,"44115",102,91,91,0,0,"PCOE",0
12,"12007",724,622,614,2,8,"PCOE",1
30,"30016",153034,101232,100202,776,1030,"PCOE",139
40,"40189",471,344,329,1,15,"PCOE",2
40,"40216",785,633,621,9,12,"PCOE",1
29,"29019",853,604,588,2,16,"PCOE",0
40,"40113",404,308,304,2,4,"PCOE",1
44,"44168",181,119,117,1,2,"PCOE",0
15,"15084",3039,2002,1981,12,21,"PCOE",3
29,"29018",2009,1421,1362,17,59,"PCOE",8
15,"15025",986,529,517,6,12,"PCOE",1
12,"12079",414,310,305,2,5,"PCOE",0
44,"44147",401,264,256,7,8,"PCOE",1
29,"29084",27199,18102,17800,268,302,"PCOE",18
30,"30010",6852,5161,5106,25,55,"PCOE",6
40,"40146",260,206,204,0,2,"PCOE",1
12,"12121",1043,878,856,5,22,"PCOE",0
19,"19335",51,39,38,0,1,"PCOE",0
15,"15076",2490,1539,1517,25,22,"PCOE",1
21,"21027",49,32,32,0,0,"PCOE",0
14,"14067",3842,2863,2800,42,63,"PCOE",4
40,"40904",344,286,284,8,2,"PCOE",1
19,"19187",42,32,32,0,0,"PCOE",1
44,"44258",53,46,46,0,0,"PCOE",0
15,"15011",15501,9988,9846,78,142,"PCOE",27
14,"14034",302,222,215,1,7,"PCOE",2
19,"19190",2284,1632,1613,16,19,"PCOE",4
11,"11901",5739,3759,3686,99,73,"PCOE",14
19,"19304",224,169,166,3,3,"PCOE",2
41,"41002",1421,938,911,7,27,"PCOE",1
12,"12106",1151,928,908,9,20,"PCOE",2
44,"44143",388,298,298,2,0,"PCOE",0
41,"41064",5602,3520,3417,56,103,"PCOE",2
40,"40193",219,156,155,3,1,"PCOE",1
40,"40091",109,87,85,0,2,"PCOE",0
27,"27047",1517,955,940,12,15,"PCOE",0
19,"19044",275,186,182,0,4,"PCOE",0
19,"19011",237,165,162,3,3,"PCOE",0
12,"12099",597,444,436,6,8,"PCOE",0
29,"29033",1084,733,722,5,11,"PCOE",1
40,"40028",103,88,87,2,1,"PCOE",0
19,"19282",138,107,106,0,1,"PCOE",0
12,"12123",40,32,32,0,0,"PCOE",0
12,"12043",570,405,397,1,8,"PCOE",2
19,"19301",37,26,26,0,0,"PCOE",0
12,"12087",26,16,16,0,0,"PCOE",0
11,"11040",396,332,324,3,8,"PCOE",0
19,"19170",189,115,115,1,0,"PCOE",0
40,"40211",66,54,54,1,0,"PCOE",0
12,"12082",9602,7323,7248,53,75,"PCOE",9
40,"40059",109,92,91,2,1,"PCOE",1
44,"44185",88,69,69,2,0,"PCOE",0
12,"12024",138,107,107,1,0,"PCOE",0
41,"41058",17956,12890,12553,200,337,"PCOE",23
14,"14022",3881,2888,2853,15,35,"PCOE",9
19,"19034",25,22,21,0,1,"PCOE",0
11,"11902",3664,2123,2094,46,29,"PCOE",7
41,"41079",9285,6591,6446,101,145,"PCOE",6
27,"27045",926,588,583,6,5,"PCOE",0
11,"11024",6550,4500,4402,67,98,"PCOE",3
44,"44160",438,287,285,4,2,"PCOE",0
44,"44137",187,139,139,0,0,"PCOE",0
19,"19168",265,182,175,4,7,"PCOE",2
12,"12119",139,97,94,3,3,"PCOE",0
19,"19161",212,158,157,3,1,"PCOE",0
29,"29062",658,557,551,2,6,"PCOE",1
21,"21040",3193,2219,2123,32,96,"PCOE",2
40,"40906",2149,1701,1662,18,39,"PCOE",4
30,"30040",686,564,560,1,4,"PCOE",0
44,"44020",22,21,21,0,0,"PCOE",0
19,"19210",18,16,16,0,0,"PCOE",0
40,"40145",1098,824,820,4,4,"PCOE",3
44,"44094",127,103,103,0,0,"PCOE",0
40,"40185",800,560,553,4,7,"PCOE",1
19,"19178",27,17,16,0,1,"PCOE",0
27,"27026",2299,1385,1368,9,17,"PCOE",2
21,"21066",490,394,389,4,5,"PCOE",0
44,"44049",784,539,532,3,7,"PCOE",2
44,"44012",303,215,215,2,0,"PCOE",0
44,"44005",48,36,36,0,0,"PCOE",0
44,"44040",189,153,150,1,3,"PCOE",4
14,"14046",4442,3283,3190,34,93,"PCOE",5
29,"29006",679,461,452,4,9,"PCOE",0
40,"40107",90,67,67,0,0,"PCOE",0
19,"19260",38,27,27,1,0,"PCOE",0
11,"11012",97338,67120,66466,861,654,"PCOE",174
44,"44203",9,9,9,0,0,"PCOE",0
44,"44112",400,265,265,2,0,"PCOE",0
44,"44215",167,113,113,2,0,"PCOE",0
41,"41018",9432,6463,6368,86,95,"PCOE",10
19,"19230",558,409,406,1,3,"PCOE",3
27,"27033",591,334,328,0,6,"PCOE",0
44,"44131",26,22,22,0,0,"PCOE",0
44,"44017",269,217,216,0,1,"PCOE",0
19,"19082",100,72,71,1,1,"PCOE",0
27,"27017",952,568,562,3,6,"PCOE",0
15,"15014",3836,2191,2158,27,33,"PCOE",18
44,"44260",137,93,93,1,0,"PCOE",0
12,"12014",164,111,111,0,0,"PCOE",0
15,"15902",4507,2885,2837,34,48,"PCOE",12
40,"40043",1773,1376,1345,21,31,"PCOE",1
40,"40010",108,83,82,0,1,"PCOE",0
29,"29025",41540,27170,26897,271,273,"PCOE",41
19,"19241",35,26,25,2,1,"PCOE",0
44,"44225",105,82,81,2,1,"PCOE",0
14,"14012",6046,4215,4120,56,95,"PCOE",11
41,"41065",22527,14684,14463,205,221,"PCOE",18
27,"27035",183,110,110,3,0,"PCOE",0
19,"19095",11,7,6,0,1,"PCOE",0
15,"15083",1029,627,614,5,13,"PCOE",4
29,"29049",2890,2069,2034,12,35,"PCOE",6
40,"40087",85,70,70,0,0,"PCOE",1
15,"15034",2712,1605,1585,15,20,"PCOE",8
19,"19037",131,109,108,0,1,"PCOE",0
40,"40109",69,51,50,3,1,"PCOE",0
19,"19213",67,53,52,1,1,"PCOE",0
41,"41030",501,376,366,9,10,"PCOE",0
19,"19122",81,62,60,2,2,"PCOE",0
40,"40199",101,76,72,2,4,"PCOE",1
29,"29057",330,222,218,2,4,"PCOE",0
19,"19111",160,128,125,0,3,"PCOE",0
14,"14055",18411,13054,12798,192,256,"PCOE",28
40,"40150",60,42,42,0,0,"PCOE",0
12,"12068",41,22,21,0,1,"PCOE",0
29,"29083",2063,1471,1444,14,27,"PCOE",2
40,"40165",73,53,52,0,1,"PCOE",0
12,"12011",4583,3228,3177,24,51,"PCOE",3
40,"40196",30,24,24,0,0,"PCOE",0
19,"19152",540,377,374,2,3,"PCOE",0
44,"44239",21,19,19,0,0,"PCOE",0
12,"12090",102,79,78,1,1,"PCOE",0
44,"44126",314,222,221,0,1,"PCOE",0
44,"44201",477,399,395,1,4,"PCOE",0
14,"14069",7340,5100,5000,69,100,"PCOE",9
44,"44029",585,454,451,2,3,"PCOE",1
44,"44039",204,144,143,1,1,"PCOE",0
44,"44107",212,135,135,0,0,"PCOE",1
29,"29047",1082,860,846,0,14,"PCOE",1
12,"12046",188,135,135,4,0,"PCOE",0
15,"15043",4944,3184,3117,27,67,"PCOE",13
44,"44191",714,509,500,5,9,"PCOE",0
11,"11002",4218,3176,3149,16,27,"PCOE",4
29,"29016",253,196,194,0,2,"PCOE",0
44,"44219",173,118,115,1,3,"PCOE",0
41,"41087",10557,7217,7029,67,188,"PCOE",5
41,"41082",3354,2545,2507,11,38,"PCOE",5
19,"19080",67,47,47,0,0,"PCOE",0
14,"14051",1323,975,951,7,24,"PCOE",3
44,"44068",634,497,493,2,4,"PCOE",0
19,"19043",99,80,79,0,1,"PCOE",0
41,"41093",19064,14867,14700,151,167,"PCOE",7
11,"11034",2319,1520,1487,17,33,"PCOE",0
14,"14045",2997,2329,2287,30,42,"PCOE",9
14,"14008",2758,1880,1836,21,44,"PCOE",5
19,"19329",58,46,46,0,0,"PCOE",0
14,"14014",2496,1962,1907,20,55,"PCOE",1
44,"44120",219,147,145,3,2,"PCOE",0
19,"19055",44,32,31,2,1,"PCOE",0
12,"12048",243,159,155,4,4,"PCOE",2
30,"30035",19432,13174,13013,114,161,"PCOE",20
12,"12125",215,179,179,2,0,"PCOE",0
19,"19217",43,36,36,0,0,"PCOE",0
14,"14902",1113,877,851,15,26,"PCOE",7
40,"40120",195,169,163,0,6,"PCOE",1
12,"12084",17785,12557,12422,108,135,"PCOE",9
15,"15001",4697,3069,3022,45,47,"PCOE",12
40,"40111",50,39,39,0,0,"PCOE",0
12,"12040",119116,85613,84993,620,620,"PCOE",99
29,"29034",461,333,332,2,1,"PCOE",0
41,"41062",2151,1619,1589,12,30,"PCOE",0
27,"27061",1018,704,683,12,21,"PCOE",1
29,"29080",6940,4676,4617,36,59,"PCOE",6
19,"19088",91,67,66,0,1,"PCOE",0
40,"40201",42,37,37,0,0,"PCOE",0
21,"21006",3321,2197,2125,19,72,"PCOE",6
19,"19243",34,32,31,1,1,"PCOE",0
44,"44208",27,17,17,0,0,"PCOE",0
41,"41031",1204,780,769,5,11,"PCOE",0
19,"19212",678,501,491,1,10,"PCOE",1
21,"21017",2302,1469,1452,18,17,"PCOE",4
21,"21001",621,431,418,0,13,"PCOE",2
44,"44167",34,26,26,0,0,"PCOE",0
15,"15018",1087,680,670,13,10,"PCOE",2
44,"44089",49,41,41,0,0,"PCOE",0
19,"19102",88,75,73,0,2,"PCOE",0
44,"44059",562,411,407,2,4,"PCOE",0
15,"15061",5149,3221,3168,44,53,"PCOE",7
19,"19251",39,30,30,0,0,"PCOE",0
40,"40231",100,79,76,0,3,"PCOE",0
14,"14033",1239,875,856,8,19,"PCOE",0
15,"15078",78810,55693,55183,569,510,"PCOE",115
15,"15082",15446,10821,10687,130,134,"PCOE",25
41,"41045",5873,3901,3802,53,99,"PCOE",9
44,"44178",52,34,34,0,0,"PCOE",0
44,"44111",78,61,61,0,0,"PCOE",0
15,"15066",3995,2746,2695,29,51,"PCOE",6
29,"29048",1364,1053,1039,8,14,"PCOE",1
40,"40058",306,244,240,1,4,"PCOE",0
19,"19222",95,70,70,2,0,"PCOE",0
27,"27013",3690,2811,2766,30,45,"PCOE",1
41,"41089",6621,4650,4549,64,101,"PCOE",8
30,"30003",25200,16249,16120,159,129,"PCOE",27
29,"29043",2463,1508,1460,20,48,"PCOE",3
19,"19208",39,32,32,0,0,"PCOE",0
41,"41075",10320,7159,6972,88,187,"PCOE",7
12,"12128",1365,990,972,16,18,"PCOE",1
12,"12118",78,64,63,0,1,"PCOE",0
40,"40034",74,59,58,0,1,"PCOE",0
44,"44080",281,202,199,0,3,"PCOE",2
41,"41074",2994,2154,2105,19,49,"PCOE",5
21,"21024",464,328,312,1,16,"PCOE",1
41,"41056",3687,2836,2779,37,57,"PCOE",2
19,"19220",2608,1673,1653,10,20,"PCOE",1
21,"21053",3306,2161,2106,11,55,"PCOE",4
27,"27065",12055,7566,7379,119,187,"PCOE",5
30,"30031",497,387,382,1,5,"PCOE",0
44,"44145",974,698,697,3,1,"PCOE",1
15,"15053",7469,4622,4579,44,43,"PCOE",11
19,"19306",24,18,18,0,0,"PCOE",0
27,"27034",1010,565,558,3,7,"PCOE",0
40,"40230",93,66,64,0,2,"PCOE",0
19,"19115",29,23,23,0,0,"PCOE",0
12,"12102",518,424,417,4,7,"PCOE",1
44,"44157",61,37,37,0,0,"PCOE",0
40,"40156",272,194,190,4,4,"PCOE",0
14,"14047",1644,1198,1183,14,15,"PCOE",2
15,"15002",24040,16302,16117,183,185,"PCOE",26
29,"29081",250,185,182,2,3,"PCOE",0
40,"40089",209,155,148,2,7,"PCOE",1
29,"29072",3291,2360,2307,19,53,"PCOE",6
27,"27043",1222,746,737,12,9,"PCOE",2
19,"19293",1945,1402,1388,19,14,"PCOE",3
19,"19327",385,313,308,2,5,"PCOE",0
19,"19231",10,6,6,0,0,"PCOE",0
29,"29904",418,328,322,1,6,"PCOE",0
44,"44090",66,49,49,0,0,"PCOE",0
19,"19268",50,37,35,0,2,"PCOE",0
44,"44181",65,57,57,0,0,"PCOE",0
21,"21076",2153,1459,1426,31,33,"PCOE",3
11,"11014",17203,10923,10805,222,118,"PCOE",28
21,"21005",15754,9502,9340,84,162,"PCOE",27
29,"29095",3285,2313,2224,39,89,"PCOE",6
19,"19259",28,22,22,0,0,"PCOE",0
44,"44035",102,82,80,1,2,"PCOE",0
19,"19204",150,105,104,3,1,"PCOE",0
19,"19240",49,36,36,0,0,"PCOE",0
30,"30006",833,699,695,1,4,"PCOE",2
27,"27062",583,403,400,2,3,"PCOE",0
12,"12064",80,71,69,0,2,"PCOE",0
44,"44061",77,60,58,1,2,"PCOE",0
19,"19108",95,78,78,0,0,"PCOE",0
40,"40006",22,19,19,0,0,"PCOE",0
44,"44182",203,160,158,0,2,"PCOE",1
41,"41040",11183,8351,8253,71,98,"PCOE",6
12,"12081",606,454,446,2,8,"PCOE",0
11,"11005",4508,2978,2900,34,78,"PCOE",6
40,"40101",918,672,665,11,7,"PCOE",0
27,"27059",2035,1356,1322,7,34,"PCOE",0
19,"19061",56,42,41,0,1,"PCOE",1
40,"40039",180,133,133,0,0,"PCOE",0
40,"40007",68,55,55,1,0,"PCOE",1
15,"15036",56053,36487,36175,501,312,"PCOE",94
40,"40057",1397,1081,1067,15,14,"PCOE",2
44,"44151",180,134,134,1,0,"PCOE",0
40,"40162",380,273,265,1,8,"PCOE",0
29,"29066",357,248,246,1,2,"PCOE",0
15,"15027",1563,1159,1140,23,19,"PCOE",1
15,"15003",1675,1029,1020,9,9,"PCOE",3
27,"27005",2560,1691,1662,19,29,"PCOE",2
44,"44031",83,50,50,0,0,"PCOE",0
44,"44105",68,53,53,0,0,"PCOE",0
44,"44222",125,92,92,0,0,"PCOE",0
12,"12028",13004,9801,9732,74,69,"PCOE",12
27,"27008",1326,865,853,5,12,"PCOE",0
19,"19116",12,10,10,0,0,"PCOE",0
15,"15013",6324,4132,4083,35,49,"PCOE",4
44,"44267",70,47,46,0,1,"PCOE",0
44,"44075",321,255,252,1,3,"PCOE",0
21,"21902",1136,744,739,2,5,"PCOE",4
40,"40172",47,33,32,0,1,"PCOE",0
44,"44007",149,112,111,1,1,"PCOE",0
41,"41024",22819,14767,14455,169,312,"PCOE",21
30,"30038",15752,10987,10904,39,83,"PCOE",2
11,"11027",68774,45571,45137,567,434,"PCOE",153
19,"19266",229,184,182,1,2,"PCOE",0
14,"14074",2225,1775,1743,17,32,"PCOE",2
19,"19281",19,18,18,0,0,"PCOE",0
40,"40129",159,119,117,2,2,"PCOE",0
21,"21010",15011,8812,8694,174,118,"PCOE",16
14,"14065",1820,1374,1352,13,22,"PCOE",3
15,"15007",3164,2081,2060,24,21,"PCOE",4
19,"19278",24,20,20,0,0,"PCOE",0
27,"27042",1639,1120,1107,8,13,"PCOE",0
44,"44008",1556,1109,1100,7,9,"PCOE",2
15,"15059",10229,6900,6734,85,166,"PCOE",15
44,"44193",73,60,60,1,0,"PCOE",0
44,"44190",63,45,45,0,0,"PCOE",0
19,"19314",44,33,33,0,0,"PCOE",0
15,"15040",2647,1779,1762,15,17,"PCOE",8
19,"19288",21,20,20,2,0,"PCOE",0
19,"19167",129,104,103,1,1,"PCOE",0
44,"44234",71,49,49,0,0,"PCOE",0
12,"12059",220,183,183,2,0,"PCOE",0
44,"44003",17,15,15,0,0,"PCOE",0
19,"19196",89,70,67,1,3,"PCOE",0
19,"19289",23,16,16,0,0,"PCOE",0
40,"40076",6576,4700,4607,32,93,"PCOE",9
44,"44101",55,41,40,1,1,"PCOE",0
19,"19265",134,97,97,5,0,"PCOE",0
29,"29014",218,122,121,3,1,"PCOE",0
40,"40194",39173,28641,28260,353,381,"PCOE",73
29,"29082",34683,24751,24495,263,256,"PCOE",30
21,"21022",187,121,116,0,5,"PCOE",0
29,"29091",9490,6428,6304,61,124,"PCOE",3
21,"21063",2611,1948,1891,23,57,"PCOE",1
41,"41054",719,562,546,3,16,"PCOE",0
41,"41067",7273,5114,5036,59,78,"PCOE",4
19,"19188",36,31,31,0,0,"PCOE",0
44,"44207",125,98,97,2,1,"PCOE",0
12,"12135",36287,25912,25655,184,257,"PCOE",34
41,"41100",954,670,635,7,35,"PCOE",0
12,"12078",334,224,221,2,3,"PCOE",1
30,"30027",50067,36417,36074,242,343,"PCOE",30
44,"44195",82,58,57,0,1,"PCOE",0
41,"41047",10449,7884,7770,119,114,"PCOE",7
21,"21003",684,476,452,4,24,"PCOE",0
40,"40224",18,15,15,0,0,"PCOE",0
41,"41084",2799,2029,1937,9,92,"PCOE",0
41,"41037",3201,2306,2260,22,46,"PCOE",0
19,"19189",114,87,84,0,3,"PCOE",0
44,"44092",70,53,52,0,1,"PCOE",0
29,"29073",1657,1082,1069,15,13,"PCOE",0
44,"44226",123,85,84,0,1,"PCOE",0
21,"21044",18061,11170,11003,123,167,"PCOE",22
14,"14059",679,527,521,11,6,"PCOE",0
15,"15021",5254,3473,3422,58,51,"PCOE",9
12,"12139",299,202,200,3,2,"PCOE",0
29,"29050",392,229,227,3,2,"PCOE",1
40,"40177",139,106,105,0,1,"PCOE",0
44,"44113",74,51,51,0,0,"PCOE",0
40,"40046",83,67,67,1,0,"PCOE",1
12,"12096",732,526,519,4,7,"PCOE",0
21,"21075",338,243,235,3,8,"PCOE",0
30,"30036",15432,10030,9879,64,151,"PCOE",17
27,"27004",1143,640,625,2,15,"PCOE",0
15,"15075",12871,8751,8637,129,114,"PCOE",25
40,"40079",229,160,159,2,1,"PCOE",0
21,"21035",9766,6114,5998,92,116,"PCOE",3
19,"19283",29,26,26,0,0,"PCOE",0
40,"40228",493,362,361,3,1,"PCOE",0
19,"19171",5380,3964,3919,22,45,"PCOE",6
19,"19181",50,34,34,0,0,"PCOE",0
29,"29038",18908,12122,11931,197,191,"PCOE",18
44,"44247",291,207,206,4,1,"PCOE",0
14,"14032",388,302,293,0,9,"PCOE",0
40,"40048",35,27,27,0,0,"PCOE",0
19,"19147",42,32,32,0,0,"PCOE",0
40,"40071",39,32,26,0,6,"PCOE",0
29,"29094",59795,39350,38854,454,496,"PCOE",54
30,"30024",60389,42200,41831,281,369,"PCOE",50
11,"11003",1230,802,787,9,15,"PCOE",1
12,"12036",541,401,395,6,6,"PCOE",1
44,"44066",85,62,62,0,0,"PCOE",0
14,"14049",16185,11561,11323,145,238,"PCOE",47
19,"19120",107,86,86,1,0,"PCOE",1
12,"12033",1953,1391,1368,6,23,"PCOE",3
21,"21030",1887,1493,1458,12,35,"PCOE",1
19,"19244",74,55,55,3,0,"PCOE",0
19,"19214",74,51,51,0,0,"PCOE",0
40,"40126",67,44,42,0,2,"PCOE",0
19,"19202",16,13,13,1,0,"PCOE",0
44,"44050",3113,2173,2154,14,19,"PCOE",1
29,"29067",431757,290824,287855,3289,2969,"PCOE",487
44,"44004",379,275,275,2,0,"PCOE",1
41,"41902",4599,2906,2868,50,38,"PCOE",4
19,"19901",35,27,27,0,0,"PCOE",0
40,"40014",56,39,38,0,1,"PCOE",0
19,"19183",70,59,58,0,1,"PCOE",0
14,"14063",994,731,719,8,12,"PCOE",0
40,"40092",105,75,75,2,0,"PCOE",0
40,"40138",2102,1585,1565,13,20,"PCOE",1
19,"19285",20,16,16,0,0,"PCOE",0
19,"19250",16,12,12,0,0,"PCOE",0
40,"40105",43,35,35,0,0,"PCOE",0
19,"19224",106,83,83,1,0,"PCOE",0
40,"40072",224,175,171,1,4,"PCOE",0
12,"12074",756,611,601,3,10,"PCOE",1
29,"29903",485,326,324,2,2,"PCOE",0
40,"40025",129,109,107,1,2,"PCOE",0
15,"15079",1437,887,868,8,19,"PCOE",3
11,"11017",3198,2054,2004,37,50,"PCOE",6
19,"19264",33,25,25,0,0,"PCOE",0
14,"14007",15016,10248,10043,99,205,"PCOE",23
14,"14036",3677,2619,2555,39,64,"PCOE",14
19,"19307",25,23,23,0,0,"PCOE",0
44,"44210",750,577,572,2,5,"PCOE",0
29,"29042",14586,9793,9649,95,144,"PCOE",15
40,"40192",134,106,105,1,1,"PCOE",0
19,"19216",127,88,88,0,0,"PCOE",0
15,"15049",1068,752,747,7,5,"PCOE",1
19,"19226",37,22,22,0,0,"PCOE",0
19,"19332",85,59,57,4,2,"PCOE",1
19,"19287",134,100,98,2,2,"PCOE",0
41,"41097",3131,2197,2140,13,57,"PCOE",3
19,"19053",1906,1323,1304,12,19,"PCOE",5
44,"44109",99,64,64,0,0,"PCOE",0
11,"11021",4914,3187,3069,61,118,"PCOE",6
15,"15029",5354,3082,3050,46,32,"PCOE",4
14,"14009",2653,1658,1631,24,27,"PCOE",4
41,"41015",5426,3778,3639,41,139,"PCOE",1
29,"29024",371,216,204,3,12,"PCOE",4
40,"40084",52,41,41,2,0,"PCOE",0
19,"19176",227,172,172,0,0,"PCOE",0
40,"40095",453,341,329,2,12,"PCOE",0
19,"19308",57,49,49,0,0,"PCOE",0
40,"40148",231,165,163,4,2,"PCOE",1
44,"44196",121,88,88,0,0,"PCOE",0
41,"41025",2031,1409,1349,11,60,"PCOE",4
19,"19031",8,8,8,0,0,"PCOE",0
44,"44045",360,271,271,0,0,"PCOE",0
29,"29007",28907,20371,20129,254,242,"PCOE",63
11,"11039",9957,6134,6043,152,91,"PCOE",17
29,"29071",980,580,564,11,16,"PCOE",0
41,"41035",1051,733,722,10,11,"PCOE",1
11,"11019",1757,1233,1172,13,61,"PCOE",6
44,"44266",102,81,79,0,2,"PCOE",0
19,"19324",164,122,120,4,2,"PCOE",0
44,"44128",58,39,37,0,2,"PCOE",0
15,"15041",9569,6362,6269,104,93,"PCOE",16
29,"29017",6404,4575,4468,48,107,"PCOE",13
11,"11030",22999,14858,14586,207,272,"PCOE",54
21,"21002",16070,11301,11137,132,164,"PCOE",18
44,"44149",99,74,73,4,1,"PCOE",0
19,"19064",64,56,56,0,0,"PCOE",0
44,"44055",75,52,50,0,2,"PCOE",0
19,"19103",247,205,202,1,3,"PCOE",0
19,"19177",60,45,45,0,0,"PCOE",0
21,"21043",1853,1354,1325,23,29,"PCOE",3
19,"19290",851,551,550,4,1,"PCOE",0
14,"14030",7761,5711,5588,84,123,"PCOE",8
41,"41027",4007,2628,2546,33,82,"PCOE",5
27,"27051",7986,5324,5241,58,83,"PCOE",10
21,"21060",12287,7761,7638,134,123,"PCOE",12
30,"30030",321454,235061,233183,1744,1878,"PCOE",316
44,"44026",100,73,72,0,1,"PCOE",0
44,"44028",171,136,136,0,0,"PCOE",1
44,"44010",185,144,143,0,1,"PCOE",0
19,"19078",47,37,36,0,1,"PCOE",0
44,"44159",37,27,27,1,0,"PCOE",0
19,"19123",37,30,28,0,2,"PCOE",0
40,"40186",35,29,29,0,0,"PCOE",0
19,"19134",23,14,14,0,0,"PCOE",0
19,"19079",7,6,6,0,0,"PCOE",0
41,"41028",2108,1652,1632,22,20,"PCOE",2
29,"29009",1435,971,957,17,14,"PCOE",0
27,"27024",1447,1048,1032,6,16,"PCOE",1
30,"30023",3874,2831,2788,18,43,"PCOE",6
19,"19008",36,30,30,0,0,"PCOE",0
21,"21065",259,178,175,0,3,"PCOE",0
44,"44048",52,47,47,0,0,"PCOE",0
44,"44237",367,267,262,0,5,"PCOE",0
11,"11023",9386,6363,6248,116,115,"PCOE",15
44,"44122",1277,939,934,5,5,"PCOE",1
40,"40219",573,382,366,5,16,"PCOE",0
12,"12034",1389,1022,1002,5,20,"PCOE",1
41,"41048",2195,1445,1400,13,45,"PCOE",1
30,"30032",2864,2154,2129,18,25,"PCOE",3
27,"27025",2731,2047,2006,18,41,"PCOE",1
40,"40103",139,113,113,0,0,"PCOE",0
41,"41086",16199,10227,10105,137,122,"PCOE",10
19,"19067",68,46,44,0,2,"PCOE",0
19,"19036",242,202,200,1,2,"PCOE",0
12,"12063",41,31,31,1,0,"PCOE",1
29,"29020",3278,2329,2260,22,69,"PCOE",1
15,"15044",1194,806,788,7,18,"PCOE",8
27,"27057",11047,7078,6941,64,137,"PCOE",8
21,"21015",645,361,356,8,5,"PCOE",0
44,"44228",96,75,74,0,1,"PCOE",0
41,"41039",31538,22078,21717,278,361,"PCOE",29
30,"30008",14560,9974,9840,79,134,"PCOE",16
44,"44198",182,138,135,0,3,"PCOE",0
15,"15901",3334,1948,1928,27,20,"PCOE",5
41,"41005",9285,6637,6497,83,140,"PCOE",11
41,"41046",3005,2241,2198,11,43,"PCOE",2
29,"29098",1228,902,876,11,26,"PCOE",1
12,"12091",171,110,108,4,2,"PCOE",0
30,"30025",5016,3663,3623,22,40,"PCOE",5
40,"40037",30,17,17,0,0,"PCOE",0
29,"29059",2662,1950,1895,16,55,"PCOE",5
19,"19305",139,104,103,1,1,"PCOE",0
44,"44041",60,48,48,0,0,"PCOE",0
41,"41050",5173,3954,3878,36,76,"PCOE",8
19,"19192",1762,1251,1240,5,11,"PCOE",1
19,"19319",4609,3303,3273,22,30,"PCOE",6
21,"21078",2641,1718,1670,10,48,"PCOE",1
40,"40017",83,71,68,2,3,"PCOE",2
44,"44042",114,82,81,0,1,"PCOE",0
29,"29012",9718,6664,6553,85,111,"PCOE",3
44,"44230",149,111,110,2,1,"PCOE",0
19,"19163",60,49,49,0,0,"PCOE",0
29,"29096",2757,1847,1790,19,57,"PCOE",8
19,"19153",22,20,20,2,0,"PCOE",0
40,"40149",479,345,338,3,7,"PCOE",0
19,"19331",2677,1892,1841,18,51,"PCOE",7
44,"44212",41,29,29,0,0,"PCOE",1
30,"30026",16345,10049,9914,84,135,"PCOE",14
19,"19048",19,14,13,1,1,"PCOE",0
14,"14017",10953,7929,7791,84,138,"PCOE",19
44,"44062",31,20,20,0,0,"PCOE",0
19,"19119",76,65,65,0,0,"PCOE",0
12,"12092",123,95,95,0,0,"PCOE",0
44,"44175",112,76,75,1,1,"PCOE",1
19,"19256",46,36,36,0,0,"PCOE",0
27,"27029",1425,925,910,11,15,"PCOE",1
29,"29032",6655,4900,4775,36,125,"PCOE",3
12,"12075",110,85,83,3,2,"PCOE",0
15,"15028",1392,944,936,4,8,"PCOE",1
19,"19175",29,18,17,1,1,"PCOE",0
19,"19277",15,10,10,0,0,"PCOE",0
29,"29005",4507,3012,2965,29,47,"PCOE",5
29,"29061",1043,803,773,9,30,"PCOE",0
41,"41091",539590,389351,384943,4676,4408,"PCOE",471
30,"30019",25911,17485,17264,157,221,"PCOE",16
40,"40155",3897,2920,2880,56,40,"PCOE",4
41,"41014",2476,1852,1799,10,53,"PCOE",0
41,"41034",23576,15461,15214,264,247,"PCOE",30
11,"11038",13632,10047,9812,99,235,"PCOE",18
27,"27030",3117,1945,1898,19,47,"PCOE",3
41,"41071",5571,3608,3516,64,92,"PCOE",5
12,"12039",792,665,659,2,6,"PCOE",0
44,"44127",57,43,43,0,0,"PCOE",0
11,"11028",32829,21934,21654,310,280,"PCOE",76
19,"19186",76,60,60,0,0,"PCOE",0
27,"27011",2341,1387,1362,7,25,"PCOE",2
14,"14001",3423,2563,2515,11,48,"PCOE",3
44,"44148",74,56,54,0,2,"PCOE",0
11,"11009",579,399,390,0,9,"PCOE",2
12,"12004",4149,2945,2910,25,35,"PCOE",0
30,"30012",9085,6704,6599,46,105,"PCOE",14
15,"15050",1732,931,917,15,14,"PCOE",3
21,"21041",113074,73295,72313,1063,982,"PCOE",134
19,"19279",54,42,42,0,0,"PCOE",0
15,"15092",6220,3810,3756,30,54,"PCOE",7
40,"40097",130,103,102,5,1,"PCOE",0
41,"41072",4031,2969,2933,15,36,"PCOE",1
41,"41099",3961,2448,2413,14,35,"PCOE",3
27,"27001",2187,1111,1102,17,9,"PCOE",1
19,"19248",73,54,54,0,0,"PCOE",0
12,"12022",323,257,254,5,3,"PCOE",0
40,"40195",776,573,565,4,8,"PCOE",1
19,"19219",9,8,7,0,1,"PCOE",0
44,"44027",144,113,113,2,0,"PCOE",1
14,"14901",932,753,750,6,3,"PCOE",1
11,"11020",166773,111205,109956,1580,1249,"PCOE",283
19,"19280",3669,2622,2597,24,25,"PCOE",5
19,"19228",27,17,17,1,0,"PCOE",0
29,"29036",614,393,387,1,6,"PCOE",0
27,"27023",2453,1674,1644,25,30,"PCOE",0
19,"19065",109,86,85,1,1,"PCOE",0
19,"19019",14,11,11,1,0,"PCOE",0
40,"40068",22,21,21,0,0,"PCOE",0
44,"44002",47,41,41,0,0,"PCOE",0
15,"15056",5615,3697,3646,31,51,"PCOE",7
15,"15093",4012,2413,2386,24,27,"PCOE",5
27,"27055",1191,773,764,7,9,"PCOE",0
12,"12902",2250,1557,1532,16,25,"PCOE",2
44,"44268",32,30,30,0,0,"PCOE",0
44,"44141",122,88,85,0,3,"PCOE",0
44,"44217",32,25,25,0,0,"PCOE",0
19,"19148",42,29,28,1,1,"PCOE",0
21,"21054",8175,6014,5887,41,127,"PCOE",14
19,"19211",350,272,269,0,3,"PCOE",0
29,"29902",2593,1561,1533,15,28,"PCOE",7
44,"44218",28,24,24,3,0,"PCOE",0
21,"21014",4066,3089,3029,30,60,"PCOE",2
12,"12071",1272,936,925,3,11,"PCOE",2
19,"19326",2463,1671,1650,13,21,"PCOE",2
14,"14050",2350,1774,1720,20,54,"PCOE",7
44,"44011",47,34,34,0,0,"PCOE",0
19,"19160",883,535,530,11,5,"PCOE",0
19,"19020",46,31,31,0,0,"PCOE",0
19,"19124",378,230,229,2,1,"PCOE",0
29,"29010",1637,1263,1187,2,76,"PCOE",1
30,"30007",6474,4354,4317,26,37,"PCOE",9
19,"19303",41,32,32,0,0,"PCOE",0
40,"40188",83,63,60,0,3,"PCOE",0
40,"40005",25,23,23,1,0,"PCOE",0
15,"15012",3603,2484,2422,20,62,"PCOE",10
19,"19261",33,23,23,0,0,"PCOE",0
27,"27066",12588,8116,7954,109,162,"PCOE",5
21,"21056",2914,2148,2046,29,102,"PCOE",6
29,"29085",138,98,93,1,5,"PCOE",1
12,"12089",4555,3070,3045,22,25,"PCOE",11
44,"44238",2278,1630,1620,3,10,"PCOE",3
19,"19125",45,23,23,0,0,"PCOE",0
44,"44200",39,26,26,0,0,"PCOE",0
29,"29029",383,256,254,4,2,"PCOE",1
40,"40036",496,395,380,8,15,"PCOE",3
19,"19021",978,678,662,3,16,"PCOE",3
41,"41901",2692,2101,2051,47,50,"PCOE",2
40,"40206",162,126,123,0,3,"PCOE",0
44,"44063",63,52,52,0,0,"PCOE",0
21,"21070",6294,4232,4124,64,108,"PCOE",4
44,"44096",155,115,114,1,1,"PCOE",0
21,"21007",6379,4268,4178,66,90,"PCOE",11
44,"44013",11232,7872,7801,64,71,"PCOE",11
41,"41068",13963,9596,9407,96,189,"PCOE",4
30,"30009",12728,9487,9365,46,122,"PCOE",12
40,"40136",102,79,77,3,2,"PCOE",0
19,"19002",55,45,45,0,0,"PCOE",0
41,"41003",2373,1747,1708,18,39,"PCOE",1
40,"40081",117,80,76,1,4,"PCOE",1
19,"19232",56,40,40,0,0,"PCOE",0
27,"27007",2723,1822,1776,23,46,"PCOE",0
41,"41059",35358,26408,26052,346,356,"PCOE",36
12,"12131",97,87,87,0,0,"PCOE",0
21,"21058",2567,1806,1766,32,40,"PCOE",1
44,"44221",386,307,304,1,3,"PCOE",2
19,"19193",22,21,21,1,0,"PCOE",0
19,"19139",26,19,19,2,0,"PCOE",0
44,"44033",243,165,165,3,0,"PCOE",0
44,"44071",585,419,418,6,1,"PCOE",1
19,"19118",11,10,9,0,1,"PCOE",0
15,"15057",12077,8109,8018,83,91,"PCOE",16
40,"40170",1302,962,948,6,14,"PCOE",1
19,"19059",73,47,47,0,0,"PCOE",0
12,"12124",1842,1343,1328,13,15,"PCOE",0
44,"44135",99,73,73,1,0,"PCOE",0
40,"40901",413,320,315,7,5,"PCOE",0
15,"15006",5159,3008,2960,44,48,"PCOE",12
44,"44125",63,41,41,0,0,"PCOE",0
40,"40094",353,265,263,3,2,"PCOE",0
44,"44016",424,299,297,1,2,"PCOE",0
41,"41080",1231,832,815,14,17,"PCOE",1
15,"15058",28761,20250,20098,261,152,"PCOE",43
44,"44184",44,37,37,0,0,"PCOE",0
40,"40030",419,317,314,3,3,"PCOE",0
19,"19130",61556,45926,45388,408,538,"PCOE",60
11,"11008",17923,11702,11464,192,238,"PCOE",28
44,"44165",168,125,125,2,0,"PCOE",0
12,"12042",574,459,446,9,13,"PCOE",1
15,"15062",5597,3406,3360,16,46,"PCOE",19
19,"19099",286,179,175,1,4,"PCOE",0
27,"27009",2005,1324,1303,11,21,"PCOE",1
21,"21009",834,527,508,4,19,"PCOE",2
44,"44118",154,109,106,1,3,"PCOE",0
19,"19195",36,26,25,2,1,"PCOE",0
14,"14056",23477,15826,15470,177,356,"PCOE",33
19,"19060",157,123,122,0,1,"PCOE",0
40,"40903",75,61,59,0,2,"PCOE",0
14,"14028",302,241,240,3,1,"PCOE",0
19,"19155",64,49,49,0,0,"PCOE",0
29,"29099",969,688,669,11,19,"PCOE",1
44,"44054",95,82,81,0,1,"PCOE",0
19,"19016",57,40,40,0,0,"PCOE",0
44,"44100",177,136,135,1,1,"PCOE",0
21,"21072",10233,7374,7183,116,191,"PCOE",22
19,"19121",265,205,204,0,1,"PCOE",0
21,"21051",222,171,168,3,3,"PCOE",0
19,"19075",58,38,37,3,1,"PCOE",0
41,"41063",2735,1855,1797,30,58,"PCOE",0
14,"14029",4001,2855,2821,30,34,"PCOE",8
29,"29053",1717,1133,1116,12,17,"PCOE",0
19,"19309",20,15,14,0,1,"PCOE",0
27,"27063",1699,1131,1109,7,22,"PCOE",1
19,"19133",78,64,64,2,0,"PCOE",0
44,"44216",27003,19997,19909,80,88,"PCOE",20
40,"40044",134,101,101,3,0,"PCOE",1
44,"44257",149,92,91,0,1,"PCOE",0
44,"44037",447,288,288,1,0,"PCOE",0
41,"41026",4302,3355,3288,26,67,"PCOE",3
41,"41055",14791,10197,10000,125,197,"PCOE",14
12,"12103",87,61,60,0,1,"PCOE",0
14,"14039",2577,1858,1801,29,57,"PCOE",4
27,"27064",1505,972,951,9,21,"PCOE",1
30,"30013",7421,5171,5094,32,77,"PCOE",5
40,"40045",119,93,93,1,0,"PCOE",0
11,"11041",9869,6438,6295,100,143,"PCOE",8
40,"40022",195,144,141,2,3,"PCOE",2
40,"40213",93,78,78,1,0,"PCOE",0
21,"21019",592,397,389,6,8,"PCOE",1
12,"12051",437,297,295,3,2,"PCOE",0
19,"19169",30,27,27,0,0,"PCOE",0
40,"40154",22,18,18,1,0,"PCOE",0
44,"44001",65,43,43,1,0,"PCOE",0
21,"21074",2736,1826,1790,19,36,"PCOE",2
44,"44169",298,216,216,0,0,"PCOE",0
11,"11031",76427,49773,49248,654,525,"PCOE",168
41,"41092",7681,5408,5299,79,109,"PCOE",6
19,"19229",58,53,53,0,0,"PCOE",0
11,"11042",1158,806,793,6,13,"PCOE",1
44,"44236",60,38,38,0,0,"PCOE",0
44,"44227",72,58,58,0,0,"PCOE",0
30,"30039",20442,13299,13167,84,132,"PCOE",17
14,"14041",3113,2234,2160,43,74,"PCOE",10
44,"44047",225,103,103,0,0,"PCOE",0
44,"44171",176,115,115,0,0,"PCOE",0
40,"40144",16,15,15,0,0,"PCOE",0
44,"44082",84,66,66,0,0,"PCOE",0
40,"40078",150,123,123,6,0,"PCOE",0
41,"41029",13520,9849,9663,134,186,"PCOE",16
40,"40047",37,23,23,0,0,"PCOE",0
15,"15033",2421,1673,1655,6,18,"PCOE",5
29,"29011",2893,1763,1736,12,27,"PCOE",0
14,"14004",1963,1465,1437,15,28,"PCOE",2
41,"41010",4586,3218,3157,42,61,"PCOE",4
29,"29074",771,561,555,1,6,"PCOE",0
11,"11013",2352,1564,1522,13,42,"PCOE",2
19,"19294",26,18,18,0,0,"PCOE",0
41,"41085",4182,3258,3181,43,77,"PCOE",4
27,"27901",2249,1373,1360,22,13,"PCOE",0
12,"12138",19207,13018,12891,87,127,"PCOE",14
12,"12053",2040,1587,1579,8,8,"PCOE",1
19,"19271",41,22,21,1,1,"PCOE",0
41,"41020",13012,8148,7999,135,149,"PCOE",13
12,"12130",414,329,327,0,2,"PCOE",0
40,"40125",76,48,46,0,2,"PCOE",0
27,"27002",1535,990,968,13,22,"PCOE",0
14,"14040",3749,2905,2845,53,60,"PCOE",8
40,"40158",15,11,11,0,0,"PCOE",0
44,"44249",40,30,30,0,0,"PCOE",0
44,"44211",33,22,22,0,0,"PCOE",0
40,"40233",399,279,273,0,6,"PCOE",1
44,"44144",319,225,223,0,2,"PCOE",0
40,"40180",276,215,210,2,5,"PCOE",0
15,"15087",5710,3436,3392,31,44,"PCOE",23
19,"19252",56,44,44,0,0,"PCOE",0
12,"12073",133,97,97,0,0,"PCOE",2
15,"15067",7933,5329,5282,43,47,"PCOE",18
41,"41077",8631,5788,5598,51,190,"PCOE",10
19,"19022",592,423,420,6,3,"PCOE",1
15,"15005",25347,15441,15211,226,230,"PCOE",58
19,"19058",7458,5705,5663,40,42,"PCOE",3
14,"14016",1273,936,922,5,14,"PCOE",4
44,"44051",2579,1924,1901,10,23,"PCOE",3
19,"19254",43,34,34,0,0,"PCOE",0
40,"40234",375,278,269,3,9,"PCOE",0
11,"11026",4700,3387,3293,17,94,"PCOE",5
44,"44163",115,79,78,0,1,"PCOE",0
21,"21048",318,234,229,3,5,"PCOE",2
15,"15047",2256,1429,1405,25,24,"PCOE",0
40,"40061",63,47,44,0,3,"PCOE",0
44,"44154",240,164,161,1,3,"PCOE",1
40,"40118",46,32,32,1,0,"PCOE",0
29,"29068",7833,4897,4806,50,91,"PCOE",10
44,"44264",254,170,170,0,0,"PCOE",0
21,"21008",2604,1663,1626,10,37,"PCOE",3
29,"29004",283,222,218,3,4,"PCOE",0
44,"44108",306,209,205,1,4,"PCOE",1
27,"27019",8188,5478,5395,88,83,"PCOE",2
44,"44099",644,422,421,2,1,"PCOE",1
40,"40008",42,36,36,1,0,"PCOE",0
27,"27040",3008,2071,2046,21,25,"PCOE",1
40,"40074",246,193,189,2,4,"PCOE",2
12,"12057",572,456,437,1,19,"PCOE",1
19,"19074",67,57,57,1,0,"PCOE",0
44,"44052",75,54,54,0,0,"PCOE",0
12,"12141",92,72,72,0,0,"PCOE",0
12,"12029",670,524,514,5,10,"PCOE",1
19,"19004",59,44,44,0,0,"PCOE",0
40,"40083",73,52,52,1,0,"PCOE",0
19,"19143",1781,1278,1266,18,12,"PCOE",0
27,"27020",3365,2544,2500,42,44,"PCOE",1
12,"12133",59,46,45,0,1,"PCOE",0
19,"19145",40,32,32,0,0,"PCOE",0
40,"40053",79,56,56,1,0,"PCOE",0
12,"12058",59,47,45,1,2,"PCOE",0
44,"44205",619,420,415,5,5,"PCOE",1
41,"41090",3489,2560,2467,27,93,"PCOE",1
44,"44053",103,87,85,1,2,"PCOE",0
19,"19050",15,13,13,0,0,"PCOE",0
12,"12085",5081,3271,3235,17,36,"PCOE",5
29,"29090",1649,1138,1124,10,14,"PCOE",0
40,"40173",140,120,118,2,2,"PCOE",0
40,"40141",822,584,568,9,16,"PCOE",1
14,"14010",3992,2786,2723,14,63,"PCOE",6
41,"41044",7753,5636,5547,55,89,"PCOE",7
12,"12012",2622,2084,2056,12,28,"PCOE",6
44,"44206",100,73,73,3,0,"PCOE",0
29,"29063",305,244,242,2,2,"PCOE",0
40,"40205",228,159,157,1,2,"PCOE",0
12,"12021",4398,3314,3277,32,37,"PCOE",0
12,"12134",135,95,95,1,0,"PCOE",0
15,"15009",10605,7245,7133,101,112,"PCOE",9
41,"41073",1684,1100,1074,7,26,"PCOE",1
19,"19113",454,327,322,4,5,"PCOE",3
29,"29045",1679,1162,1144,5,18,"PCOE",4
19,"19209",40,30,29,0,1,"PCOE",0
40,"40021",18,15,15,0,0,"PCOE",0
40,"40055",31,26,26,0,0,"PCOE",0
21,"21042",15610,8112,8011,164,101,"PCOE",20
12,"12050",1226,904,891,3,13,"PCOE",2
40,"40002",32,22,21,0,1,"PCOE",0
12,"12070",505,407,398,2,9,"PCOE",1
14,"14002",10895,7599,7479,109,120,"PCOE",23
11,"11001",4360,2810,2744,32,66,"PCOE",9
14,"14058",7866,5451,5334,69,117,"PCOE",18
40,"40100",262,208,204,4,4,"PCOE",0
29,"29055",1892,1425,1394,3,31,"PCOE",1
19,"19114",30,22,21,1,1,"PCOE",0
40,"40077",966,718,704,10,14,"PCOE",2
12,"12120",149,125,121,3,4,"PCOE",0
19,"19249",29,26,26,0,0,"PCOE",0
40,"40132",45,26,25,0,1,"PCOE",0
19,"19269",86,61,61,0,0,"PCOE",0
12,"12104",6843,5181,5111,32,70,"PCOE",6
19,"19033",47,38,37,1,1,"PCOE",0
19,"19091",23,17,17,0,0,"PCOE",0
29,"29037",215,156,153,1,3,"PCOE",0
40,"40056",31,21,20,0,1,"PCOE",0
11,"11022",48785,24758,24422,398,336,"PCOE",78
40,"40218",80,56,55,0,1,"PCOE",0
44,"44067",106,75,71,0,4,"PCOE",0
12,"12088",57,53,53,0,0,"PCOE",0
41,"41066",1307,927,898,7,29,"PCOE",0
12,"12006",177,133,133,2,0,"PCOE",0
44,"44209",799,584,573,2,11,"PCOE",0
44,"44121",52,42,42,1,0,"PCOE",0
12,"12061",374,263,261,4,2,"PCOE",0
19,"19270",14,13,13,0,0,"PCOE",0
29,"29001",4207,3002,2959,40,43,"PCOE",13
15,"15022",5580,3508,3472,47,36,"PCOE",5
40,"40070",143,94,92,1,2,"PCOE",1
40,"40134",692,522,509,10,13,"PCOE",1
19,"19045",122,97,96,0,1,"PCOE",0
12,"12025",116,82,79,1,3,"PCOE",0
44,"44172",296,216,216,1,0,"PCOE",1
14,"14070",1280,911,902,4,9,"PCOE",0
44,"44093",78,62,61,0,1,"PCOE",0
12,"12114",200,144,140,0,4,"PCOE",0
41,"41076",2134,1246,1230,11,16,"PCOE",0
19,"19010",9,9,9,0,0,"PCOE",0
15,"15054",31805,19579,19321,335,258,"PCOE",62
19,"19317",124,83,82,0,1,"PCOE",0
29,"29021",155,111,109,1,2,"PCOE",1
27,"27006",2441,1479,1460,11,19,"PCOE",1
41,"41078",2445,1722,1689,12,33,"PCOE",1
14,"14025",2834,2352,2299,9,53,"PCOE",2
12,"12045",333,243,235,2,8,"PCOE",0
15,"15035",11189,7256,7165,104,91,"PCOE",12
15,"15046",6157,3965,3865,23,100,"PCOE",18
29,"29058",1542,994,979,5,15,"PCOE",1
19,"19117",1632,1187,1167,12,20,"PCOE",2
29,"29040",1933,1260,1235,11,25,"PCOE",0
19,"19001",43,32,32,0,0,"PCOE",0
30,"30041",14040,8999,8876,94,123,"PCOE",17
44,"44229",141,99,98,1,1,"PCOE",0
40,"40179",620,500,490,3,10,"PCOE",0
41,"41022",4255,2735,2667,32,68,"PCOE",5
44,"44192",341,274,272,2,2,"PCOE",0
44,"44250",20,15,15,0,0,"PCOE",0
19,"19023",119,87,85,0,2,"PCOE",0
41,"41013",4836,3174,3124,41,50,"PCOE",6
40,"40127",36,25,23,0,2,"PCOE",0
30,"30017",11428,8196,8113,44,83,"PCOE",4
41,"41903",6776,4616,4494,72,122,"PCOE",4
44,"44097",126,76,73,0,3,"PCOE",0
40,"40082",104,84,84,2,0,"PCOE",0
14,"14072",983,692,680,6,12,"PCOE",0
12,"12038",157,101,100,3,1,"PCOE",0
21,"21059",221,169,163,1,6,"PCOE",3
19,"19165",45,39,39,0,0,"PCOE",0
19,"19013",111,89,89,0,0,"PCOE",0
12,"12140",1147,849,841,5,8,"PCOE",3
40,"40040",2489,1766,1744,26,22,"PCOE",3
40,"40139",255,194,192,2,2,"PCOE",0
19,"19109",33,26,26,2,0,"PCOE",0
15,"15089",4299,2924,2887,41,37,"PCOE",3
21,"21049",3262,2028,1977,15,51,"PCOE",5
19,"19049",8,8,7,0,1,"PCOE",0
19,"19245",1138,798,778,6,20,"PCOE",1
44,"44117",327,258,258,0,0,"PCOE",0
41,"41070",6451,4715,4632,70,83,"PCOE",3
12,"12117",3532,2512,2479,12,33,"PCOE",4
29,"29079",2326,1609,1582,12,27,"PCOE",4
29,"29088",2689,1817,1747,15,70,"PCOE",2
19,"19185",26,15,15,1,0,"PCOE",0
12,"12010",232,191,187,3,4,"PCOE",0
44,"44146",164,133,133,2,0,"PCOE",0
44,"44252",73,56,55,0,1,"PCOE",0
40,"40062",56,43,42,0,1,"PCOE",0
15,"15090",1115,711,701,19,10,"PCOE",2
12,"12093",161,111,109,2,2,"PCOE",0
19,"19246",42,27,27,1,0,"PCOE",0
15,"15070",8778,5802,5656,131,146,"PCOE",18
40,"40183",117,105,99,1,6,"PCOE",1
40,"40041",966,729,716,8,13,"PCOE",0
11,"11018",1434,1001,977,8,24,"PCOE",0
15,"15081",976,713,695,4,18,"PCOE",3
27,"27052",860,564,558,7,6,"PCOE",1
44,"44088",24,23,23,0,0,"PCOE",0
29,"29070",43686,27672,27323,290,349,"PCOE",51
19,"19006",755,506,494,4,12,"PCOE",1
19,"19300",782,591,588,5,3,"PCOE",3
14,"14075",552,413,391,5,22,"PCOE",0
27,"27021",1632,962,935,23,27,"PCOE",1
27,"27031",15107,9759,9593,87,166,"PCOE",12
40,"40063",6913,4948,4838,57,110,"PCOE",10
29,"29044",749,477,473,1,4,"PCOE",0
40,"40001",708,544,536,3,8,"PCOE",1
19,"19089",23,17,17,0,0,"PCOE",0
12,"12041",92,69,69,2,0,"PCOE",0
19,"19017",56,47,47,0,0,"PCOE",0
41,"41083",1145,821,814,6,7,"PCOE",4
14,"14020",336,227,225,0,2,"PCOE",0
27,"27054",1135,807,782,5,25,"PCOE",1
19,"19310",7,7,7,0,0,"PCOE",0
30,"30029",12122,8231,8125,54,106,"PCOE",16
12,"12901",3339,2583,2561,25,22,"PCOE",3
44,"44019",70,42,42,0,0,"PCOE",0
40,"40174",319,229,227,3,2,"PCOE",1
12,"12032",23728,16870,16726,121,144,"PCOE",22
19,"19197",28,22,22,1,0,"PCOE",0
12,"12060",434,366,360,1,6,"PCOE",0
30,"30014",1587,1150,1134,4,16,"PCOE",0
19,"19159",87,73,72,1,1,"PCOE",0
40,"40013",57,47,47,0,0,"PCOE",0
12,"12013",135,106,106,1,0,"PCOE",0
29,"29008",15249,10396,10234,108,162,"PCOE",12
41,"41008",1044,788,766,3,22,"PCOE",1
12,"12112",102,79,79,1,0,"PCOE",0
29,"29046",2494,1727,1693,13,34,"PCOE",4
27,"27003",1743,1161,1134,18,27,"PCOE",1
44,"44245",240,177,174,0,3,"PCOE",0
29,"29027",2325,1543,1516,13,27,"PCOE",1
15,"15020",3568,2226,2217,19,9,"PCOE",7
19,"19198",17,14,14,0,0,"PCOE",0
15,"15042",2928,1879,1853,11,26,"PCOE",6
19,"19325",154,86,86,1,0,"PCOE",0
21,"21013",10626,6990,6807,99,183,"PCOE",10
19,"19054",161,136,135,3,1,"PCOE",0
12,"12136",2603,2151,2119,20,32,"PCOE",3
44,"44103",122,96,96,3,0,"PCOE",0
44,"44014",2506,1828,1818,8,10,"PCOE",3
40,"40207",802,593,590,11,3,"PCOE",2
41,"41019",4931,3323,3251,39,72,"PCOE",4
40,"40069",68,59,59,0,0,"PCOE",0
40,"40004",436,330,319,2,11,"PCOE",1
12,"12015",115,94,94,0,0,"PCOE",0
19,"19221",31,22,22,1,0,"PCOE",0
11,"11033",21804,13361,13133,213,228,"PCOE",36
40,"40166",251,201,201,0,0,"PCOE",0
21,"21025",3886,2489,2431,31,58,"PCOE",1
27,"27015",3995,2518,2460,25,58,"PCOE",1
14,"14005",6298,3905,3828,71,77,"PCOE",11
12,"12080",1883,1472,1438,8,34,"PCOE",1
19,"19106",77,57,57,0,0,"PCOE",0
14,"14042",18695,13788,13514,206,274,"PCOE",37
41,"41011",15462,11019,10696,183,323,"PCOE",10
11,"11004",89919,55211,54544,830,667,"PCOE",132
44,"44261",713,553,549,3,4,"PCOE",1
15,"15065",7134,4869,4785,53,84,"PCOE",13
27,"27037",1001,714,707,11,7,"PCOE",3
40,"40220",64,46,45,0,1,"PCOE",0
40,"40157",39,30,30,0,0,"PCOE",1
19,"19191",13,12,12,0,0,"PCOE",0
21,"21026",262,172,168,2,4,"PCOE",1
40,"40200",38,28,28,0,0,"PCOE",0
12,"12122",754,608,600,3,8,"PCOE",1
19,"19096",105,72,70,0,2,"PCOE",0
19,"19272",66,55,55,2,0,"PCOE",0
11,"11035",13751,8535,8396,125,139,"PCOE",13
12,"12016",1549,1244,1234,9,10,"PCOE",1
21,"21057",995,600,590,8,10,"PCOE",0
44,"44173",103,81,79,0,2,"PCOE",0
19,"19138",215,158,154,4,4,"PCOE",2
44,"44161",428,294,292,2,2,"PCOE",1
19,"19201",60,44,44,0,0,"PCOE",0
12,"12098",529,417,413,3,4,"PCOE",0
19,"19057",69,51,51,0,0,"PCOE",0
44,"44070",55,49,49,0,0,"PCOE",0
29,"29087",363,249,243,4,6,"PCOE",0
30,"30028",6390,4054,3973,25,81,"PCOE",6
29,"29041",3697,2406,2361,47,45,"PCOE",4
40,"40222",161,134,131,1,3,"PCOE",1
19,"19184",59,47,47,0,0,"PCOE",0
19,"19297",32,28,28,0,0,"PCOE",0
12,"12037",17,13,13,1,0,"PCOE",0
19,"19073",16,15,15,1,0,"PCOE",0
11,"11036",683,401,395,15,6,"PCOE",1
27,"27039",4467,3179,3121,47,58,"PCOE",4
27,"27049",1324,847,829,8,18,"PCOE",1
19,"19098",20,17,17,0,0,"PCOE",0
41,"41096",6178,4739,4655,60,84,"PCOE",3
29,"29023",2330,1441,1429,11,12,"PCOE",3
12,"12116",61,49,49,0,0,"PCOE",0
27,"27060",2434,1458,1434,17,24,"PCOE",2
11,"11006",24558,15334,15113,231,221,"PCOE",32
27,"27050",2821,1980,1954,11,26,"PCOE",0
44,"44251",239,187,183,1,4,"PCOE",0
44,"44043",86,60,60,0,0,"PCOE",0
40,"40160",93,65,62,0,3,"PCOE",0
44,"44074",440,314,308,2,6,"PCOE",0
19,"19322",26,20,19,1,1,"PCOE",0
40,"40171",40,32,32,1,0,"PCOE",0
40,"40182",169,112,112,1,0,"PCOE",0
40,"40052",72,55,55,0,0,"PCOE",0
21,"21029",1514,1036,1003,14,33,"PCOE",1
14,"14037",3161,2233,2158,22,75,"PCOE",8
40,"40019",29,23,23,1,0,"PCOE",0
19,"19166",154,110,108,0,2,"PCOE",1
29,"29089",3138,2262,2186,13,76,"PCOE",3
40,"40902",113,78,76,1,2,"PCOE",0
44,"44136",48,43,43,1,0,"PCOE",0
29,"29069",87188,54019,53240,633,779,"PCOE",97
40,"40203",987,753,740,13,13,"PCOE",0
21,"21061",5083,3325,3255,36,70,"PCOE",7
44,"44232",364,255,255,3,0,"PCOE",0
41,"41081",30061,21488,21059,331,429,"PCOE",31
12,"12109",646,489,482,4,7,"PCOE",1
41,"41016",7820,5523,5407,57,116,"PCOE",171
12,"12094",871,671,661,1,10,"PCOE",1
21,"21034",1155,768,748,5,20,"PCOE",2
15,"15060",5871,4044,3978,58,66,"PCOE",7
41,"41098",5161,3792,3732,33,60,"PCOE",9
44,"44036",22,20,20,0,0,"PCOE",1
12,"12031",3960,2913,2869,13,44,"PCOE",2
40,"40020",149,112,111,1,1,"PCOE",0
21,"21062",1403,849,838,10,11,"PCOE",2
40,"40215",79,66,66,2,0,"PCOE",0
15,"15071",7780,4937,4848,34,89,"PCOE",13
44,"44119",116,80,79,1,1,"PCOE",0
14,"14057",6157,4773,4707,59,66,"PCOE",12
19,"19051",61,52,52,0,0,"PCOE",0
44,"44046",44,33,33,0,0,"PCOE",0
29,"29035",1478,1054,1040,3,14,"PCOE",0
44,"44077",68,52,51,0,1,"PCOE",0
40,"40012",241,160,156,7,4,"PCOE",0
19,"19112",53,35,34,0,1,"PCOE",0
19,"19258",84,63,62,0,1,"PCOE",0
44,"44114",233,161,159,0,2,"PCOE",0
27,"27032",3197,1979,1956,30,23,"PCOE",2
11,"11010",6327,3998,3928,112,70,"PCOE",9
21,"21032",1827,1337,1314,13,23,"PCOE",0
40,"40122",524,398,392,2,6,"PCOE",2
19,"19311",85,60,59,0,1,"PCOE",0
40,"40176",372,288,287,2,1,"PCOE",0
15,"15073",21725,13008,12820,126,188,"PCOE",24
15,"15031",23868,16113,15954,207,159,"PCOE",56
40,"40088",272,192,192,0,0,"PCOE",1
30,"30022",17108,11041,10851,100,190,"PCOE",23
27,"27044",2703,1495,1463,15,32,"PCOE",2
29,"29092",576,375,366,7,9,"PCOE",0
40,"40229",26,22,22,0,0,"PCOE",0
44,"44038",101,85,83,1,2,"PCOE",0
41,"41101",6025,4299,4213,53,86,"PCOE",3
21,"21023",2033,1215,1193,10,22,"PCOE",3
15,"15032",3430,2243,2197,12,46,"PCOE",4
19,"19179",74,64,64,3,0,"PCOE",0
29,"29028",1215,803,779,9,24,"PCOE",5
19,"19302",52,42,42,1,0,"PCOE",0
30,"30033",10377,7330,7215,59,115,"PCOE",12
29,"29013",1613,1191,1154,9,37,"PCOE",3
44,"44056",446,327,325,1,2,"PCOE",0
19,"19199",19,15,15,0,0,"PCOE",0
19,"19291",1143,803,794,2,9,"PCOE",2
19,"19066",51,42,42,0,0,"PCOE",0
12,"12105",825,602,598,6,4,"PCOE",1
14,"14060",3715,2714,2641,41,73,"PCOE",10
40,"40178",85,61,60,0,1,"PCOE",0
40,"40112",2813,2126,2087,26,39,"PCOE",4
44,"44180",74,56,56,0,0,"PCOE",0
14,"14023",1999,1629,1593,11,36,"PCOE",1
40,"40124",234,169,164,0,5,"PCOE",0
27,"27046",1444,945,921,7,24,"PCOE",1
19,"19255",74,37,37,0,0,"PCOE",0
21,"21055",7326,5395,5309,43,86,"PCOE",10
41,"41102",14773,10377,10028,174,349,"PCOE",24
19,"19009",263,186,184,0,2,"PCOE",0
15,"15023",6277,4021,3968,34,53,"PCOE",10
12,"12056",257,205,199,1,6,"PCOE",0
19,"19242",74,53,53,1,0,"PCOE",0
12,"12108",443,354,352,4,2,"PCOE",0
44,"44087",67,52,50,0,2,"PCOE",0
15,"15016",4558,2747,2705,16,42,"PCOE",6
44,"44022",464,330,325,1,5,"PCOE",0
19,"19162",67,41,41,0,0,"PCOE",0
12,"12044",442,371,368,1,3,"PCOE",2
41,"41094",6496,4733,4628,47,105,"PCOE",3
40,"40168",27,20,20,0,0,"PCOE",0
41,"41021",21410,14369,14139,195,230,"PCOE",19
19,"19233",79,65,65,2,0,"PCOE",0
40,"40049",37,27,27,0,0,"PCOE",0
44,"44032",17,13,13,0,0,"PCOE",0
21,"21067",406,274,271,3,3,"PCOE",1
44,"44084",54,46,46,1,0,"PCOE",0
12,"12026",828,577,566,11,11,"PCOE",1
19,"19005",91,63,62,0,1,"PCOE",0
12,"12049",415,317,305,4,12,"PCOE",0
41,"41095",40187,27090,26680,512,410,"PCOE",41
40,"40151",43,31,31,0,0,"PCOE",0
44,"44256",36,30,30,2,0,"PCOE",0
21,"21037",462,320,313,1,7,"PCOE",0
19,"19097",14,14,13,0,1,"PCOE",0
15,"15068",4824,2976,2937,54,39,"PCOE",9
19,"19086",1371,1003,996,9,7,"PCOE",1
19,"19127",88,60,60,1,0,"PCOE",0
41,"41041",9765,7172,6943,63,229,"PCOE",3
19,"19142",263,179,179,1,0,"PCOE",0
30,"30018",8399,6226,6148,28,78,"PCOE",8
40,"40029",25,21,19,0,2,"PCOE",0
19,"19234",44,30,30,0,0,"PCOE",0
40,"40212",26,19,19,1,0,"PCOE",0
44,"44006",220,152,151,1,1,"PCOE",0
15,"15072",9434,6304,6228,48,76,"PCOE",20
21,"21039",303,211,210,6,1,"PCOE",0
30,"30002",9701,6794,6717,27,77,"PCOE",12
12,"12083",88,69,67,9,2,"PCOE",0
12,"12002",114,96,94,1,2,"PCOE",2
19,"19076",29,23,23,0,0,"PCOE",1
14,"14027",7890,5841,5726,78,115,"PCOE",15
44,"44213",68,47,47,0,0,"PCOE",0
19,"19052",21,16,16,0,0,"PCOE",0
44,"44102",26,19,19,0,0,"PCOE",0
44,"44164",19,16,16,1,0,"PCOE",0
14,"14018",3617,2632,2568,31,64,"PCOE",8
40,"40161",32,24,23,1,1,"PCOE",0
19,"19087",17,16,16,0,0,"PCOE",0
19,"19040",53,43,42,1,1,"PCOE",0
44,"44223",73,48,48,0,0,"PCOE",0
19,"19235",98,77,76,1,1,"PCOE",0
40,"40119",166,133,132,2,1,"PCOE",0
15,"15017",19866,13497,13344,195,153,"PCOE",46
27,"27041",2216,1463,1445,19,18,"PCOE",1
15,"15080",1637,1009,992,11,17,"PCOE",3
29,"29052",213,129,128,0,1,"PCOE",0
12,"12101",354,274,270,5,4,"PCOE",0
11,"11903",1769,1116,1101,22,15,"PCOE",2
12,"12003",954,710,702,6,8,"PCOE",3
12,"12110",222,156,155,3,1,"PCOE",0
41,"41009",1148,750,732,5,18,"PCOE",0
19,"19126",1701,1223,1207,6,16,"PCOE",2
15,"15008",5646,3859,3836,52,23,"PCOE",9
41,"41007",12488,7657,7421,126,236,"PCOE",13
41,"41006",2733,1776,1742,17,34,"PCOE",3
19,"19132",86,65,63,0,2,"PCOE",0
15,"15030",199701,137611,136590,1540,1021,"PCOE",413
11,"11029",5442,2826,2765,44,61,"PCOE",9
21,"21011",3500,2371,2314,23,57,"PCOE",3
19,"19334",43,35,35,0,0,"PCOE",0
19,"19218",43,31,31,0,0,"PCOE",0
27,"27053",497,342,334,2,8,"PCOE",1
12,"12142",142,113,113,0,0,"PCOE",0
30,"30005",30268,20979,20778,148,201,"PCOE",21
40,"40106",179,140,139,2,1,"PCOE",0
19,"19042",22,18,17,0,1,"PCOE",0
27,"27022",4654,2760,2696,20,64,"PCOE",1
30,"30021",9498,6251,6193,36,58,"PCOE",17
44,"44244",67,40,40,0,0,"PCOE",1
11,"11007",18032,9872,9745,213,127,"PCOE",33
14,"14073",2768,1934,1880,33,54,"PCOE",4
21,"21079",678,428,417,2,11,"PCOE",0
40,"40128",123,88,87,1,1,"PCOE",0
30,"30011",4702,3390,3324,8,66,"PCOE",5
21,"21012",285,224,221,0,3,"PCOE",1
21,"21052",4403,2688,2631,26,57,"PCOE",4
21,"21033",569,410,405,3,5,"PCOE",2
44,"44150",28,17,17,0,0,"PCOE",0
15,"15010",1805,1047,1031,19,16,"PCOE",6
19,"19007",433,316,310,1,6,"PCOE",0
40,"40110",316,237,234,4,3,"PCOE",0
14,"14068",517,388,378,3,10,"PCOE",1
44,"44235",87,65,64,1,1,"PCOE",0
15,"15074",3902,2629,2589,23,40,"PCOE",11
11,"11011",1726,1124,1084,8,40,"PCOE",3
14,"14031",556,462,456,5,6,"PCOE",1
40,"40143",82,68,67,2,1,"PCOE",0
29,"29901",44757,29291,28960,307,331,"PCOE",38
40,"40026",112,101,99,0,2,"PCOE",0
29,"29056",1047,708,696,5,12,"PCOE",1
40,"40204",145,102,101,0,1,"PCOE",0
15,"15039",1224,802,785,9,17,"PCOE",3
21,"21077",1739,1266,1235,13,31,"PCOE",1
27,"27038",923,624,619,8,5,"PCOE",2
40,"40024",823,582,575,8,7,"PCOE",0
19,"19150",116,89,89,0,0,"PCOE",0
27,"27014",3144,2009,1985,24,24,"PCOE",0
21,"21004",1586,994,964,23,30,"PCOE",4
40,"40198",24,20,19,0,1,"PCOE",0
15,"15085",3176,2073,2047,29,26,"PCOE",5
41,"41038",102752,71545,70538,980,1007,"PCOE",93
44,"44130",28,23,23,0,0,"PCOE",0
19,"19136",11,10,10,0,0,"PCOE",0
44,"44110",37,30,30,0,0,"PCOE",0
19,"19039",56,48,48,2,0,"PCOE",0
15,"15069",6604,4587,4520,55,67,"PCOE",7
40,"40202",56,33,33,0,0,"PCOE",0
30,"30015",19344,13502,13347,107,155,"PCOE",17
27,"27012",1264,658,650,6,8,"PCOE",2
29,"29100",2379,1582,1551,22,31,"PCOE",4
12,"12100",1273,1069,1052,5,17,"PCOE",1
40,"40073",387,327,323,1,4,"PCOE",0
30,"30037",19407,13252,13120,99,132,"PCOE",27
12,"12067",514,381,373,3,8,"PCOE",0
14,"14024",1849,1417,1391,5,26,"PCOE",3
29,"29086",770,479,476,5,3,"PCOE",0
19,"19172",51,38,38,0,0,"PCOE",0
14,"14043",7406,5323,5211,63,112,"PCOE",9
11,"11025",4374,2808,2759,30,49,"PCOE",8
44,"44023",18,15,14,0,1,"PCOE",0
14,"14071",874,551,540,5,11,"PCOE",1
19,"19047",55,47,47,1,0,"PCOE",0
19,"19318",26,18,18,0,0,"PCOE",0
27,"27048",1992,1317,1285,21,32,"PCOE",0
14,"14003",1245,925,907,5,18,"PCOE",1
44,"44060",32,25,25,0,0,"PCOE",0
15,"15077",8103,4893,4818,61,75,"PCOE",20
14,"14062",945,700,693,2,7,"PCOE",1
44,"44176",152,114,113,1,1,"PCOE",0
40,"40140",76,54,54,0,0,"PCOE",0
19,"19299",100,72,71,1,1,"PCOE",0
14,"14038",32742,23345,22974,242,371,"PCOE",53
30,"30020",6503,4521,4484,35,37,"PCOE",4
12,"12017",145,111,110,2,1,"PCOE",1
19,"19330",69,62,62,0,0,"PCOE",0
12,"12001",1028,783,768,6,15,"PCOE",0
19,"19215",135,109,109,0,0,"PCOE",0
40,"40051",34,25,25,0,0,"PCOE",0
29,"29003",916,677,666,4,11,"PCOE",3
40,"40159",130,94,93,2,1,"PCOE",0
44,"44174",402,289,288,1,1,"PCOE",0
19,"19321",34,28,28,0,0,"PCOE",0
21,"21069",1681,1073,1056,9,17,"PCOE",0
40,"40135",277,212,210,3,2,"PCOE",0
40,"40131",51,45,45,0,0,"PCOE",0
14,"14048",1199,883,866,4,17,"PCOE",1
44,"44034",124,90,90,0,0,"PCOE",0
15,"15037",4026,2375,2349,10,26,"PCOE",8
40,"40223",235,177,174,1,3,"PCOE",0
44,"44076",2089,1577,1565,8,12,"PCOE",2
44,"44204",27,18,18,0,0,"PCOE",0
14,"14054",13775,10464,10165,105,299,"PCOE",18
40,"40905",130,95,95,0,0,"PCOE",0
44,"44231",35,30,30,0,0,"PCOE",0
41,"41033",4958,3299,3250,38,49,"PCOE",3
14,"14021",260521,185270,183300,2192,1970,"PCOE",406
40,"40099",54,44,42,0,2,"PCOE",0
44,"44155",1063,779,778,3,1,"PCOE",1
40,"40065",467,338,329,1,9,"PCOE",0
19,"19027",129,97,95,1,2,"PCOE",0
40,"40031",546,410,406,3,4,"PCOE",2
29,"29015",32093,22044,21716,253,328,"PCOE",34
29,"29093",2150,1543,1520,8,23,"PCOE",3
15,"15045",3610,2057,2044,15,13,"PCOE",4
14,"14052",9039,5579,5478,79,101,"PCOE",13
15,"15055",4446,2829,2762,50,67,"PCOE",6
19,"19267",20,15,14,0,1,"PCOE",0
19,"19333",96,68,67,0,1,"PCOE",0
19,"19182",37,32,32,0,0,"PCOE",0
21,"21036",204,128,121,1,7,"PCOE",0
19,"19041",163,118,117,1,1,"PCOE",0
14,"14053",5918,4054,3968,92,86,"PCOE",12
44,"44243",25,19,19,0,0,"PCOE",0
21,"21071",206,148,144,4,4,"PCOE",0
19,"19257",3279,2233,2206,21,27,"PCOE",3
19,"19247",140,103,102,1,1,"PCOE",0
12,"12052",537,409,398,5,11,"PCOE",1
21,"21031",1166,773,736,11,37,"PCOE",1
44,"44156",47,31,31,0,0,"PCOE",0
14,"14064",296,211,208,6,3,"PCOE",1
40,"40032",368,247,244,5,3,"PCOE",0
40,"40184",245,196,194,0,2,"PCOE",1
21,"21018",1719,1048,1029,12,19,"PCOE",3
21,"21028",370,265,259,2,6,"PCOE",0
29,"29060",665,454,450,1,4,"PCOE",0
27,"27028",78725,52642,51965,642,677,"PCOE",62
41,"41017",15907,11486,11302,158,184,"PCOE",12
40,"40142",52,39,37,0,2,"PCOE",0
15,"15051",4545,2978,2945,47,33,"PCOE",6
44,"44138",120,92,92,0,0,"PCOE",0
30,"30034",1067,818,801,8,17,"PCOE",0
19,"19298",53,43,41,0,2,"PCOE",0
19,"19081",27,21,21,0,0,"PCOE",0
12,"12095",950,723,712,5,11,"PCOE",2
40,"40164",186,131,130,0,1,"PCOE",0
12,"12072",1083,852,827,10,25,"PCOE",1
41,"41049",9515,6961,6843,115,118,"PCOE",13
15,"15052",4070,2512,2488,18,24,"PCOE",11
19,"19223",99,66,65,1,1,"PCOE",1
21,"21064",6674,4503,4426,68,77,"PCOE",7
19,"19104",19,15,14,0,1,"PCOE",0
27,"27902",7122,4472,4385,43,87,"PCOE",7
44,"44262",141,104,103,0,1,"PCOE",0
44,"44179",324,201,201,2,0,"PCOE",0
44,"44085",49,29,29,0,0,"PCOE",0
12,"12097",62,53,51,0,2,"PCOE",0
44,"44246",1599,1012,1001,11,11,"PCOE",4
27,"27016",6958,4697,4616,50,81,"PCOE",5
12,"12113",90,59,59,1,0,"PCOE",1
12,"12069",50,38,38,0,0,"PCOE",0
44,"44065",55,33,32,0,1,"PCOE",0
14,"14019",6380,4933,4831,71,102,"PCOE",11
15,"15091",1097,705,686,17,19,"PCOE",2
19,"19227",68,42,41,1,1,"PCOE",0
12,"12137",40,28,28,0,0,"PCOE",0
29,"29077",207,135,134,1,1,"PCOE",0
44,"44086",410,302,298,3,4,"PCOE",2
40,"40093",74,62,62,1,0,"PCOE",0
44,"44194",103,67,64,0,3,"PCOE",0
19,"19110",51,39,39,0,0,"PCOE",0
40,"40208",724,546,543,5,3,"PCOE",0
12,"12018",279,233,231,3,2,"PCOE",0
40,"40033",70,55,52,1,3,"PCOE",0
41,"41036",3903,2708,2645,35,63,"PCOE",0
12,"12127",63,45,44,1,1,"PCOE",0
12,"12077",4828,3395,3357,28,38,"PCOE",7
19,"19129",25,21,21,0,0,"PCOE",0
44,"44240",151,119,117,0,2,"PCOE",0
41,"41051",2317,1715,1688,4,27,"PCOE",0
19,"19238",43,30,28,0,2,"PCOE",0
40,"40054",108,79,78,3,1,"PCOE",0
14,"14061",687,536,523,1,13,"PCOE",0
41,"41088",515,368,358,2,10,"PCOE",1
11,"11037",5656,4374,4273,24,101,"PCOE",7
27,"27058",3283,2275,2241,12,34,"PCOE",3
12,"12027",17506,11776,11649,84,127,"PCOE",25
21,"21045",231,177,174,4,3,"PCOE",1
44,"44220",113,82,82,1,0,"PCOE",0
19,"19018",142,112,112,1,0,"PCOE",0
41,"41012",3375,2259,2214,26,45,"PCOE",1
11,"11015",64414,39635,39220,776,415,"PCOE",122
41,"41052",3032,2162,2092,6,70,"PCOE",4
44,"44241",500,361,357,0,4,"PCOE",0
44,"44123",95,68,68,0,0,"PCOE",0
19,"19135",90,71,69,1,2,"PCOE",0
19,"19032",145,94,93,2,1,"PCOE",0
14,"14026",2000,1294,1253,20,41,"PCOE",1
44,"44263",373,267,267,2,0,"PCOE",0
41,"41061",2141,1661,1621,7,40,"PCOE",2
30,"30043",25449,18839,18477,180,362,"PCOE",35
44,"44021",104,77,77,1,0,"PCOE",0
40,"40009",41,35,34,0,1,"PCOE",0
40,"40214",198,160,154,0,6,"PCOE",0
41,"41053",21693,15843,15379,171,464,"PCOE",19
14,"14044",1613,1186,1164,10,22,"PCOE",8
21,"21047",1878,1144,1112,12,32,"PCOE",1
40,"40075",152,116,116,0,0,"PCOE",0
19,"19146",47,35,35,0,0,"PCOE",1
29,"29039",2759,1900,1860,23,40,"PCOE",2
12,"12065",167,142,141,0,1,"PCOE",0
19,"19015",82,74,73,1,1,"PCOE",0
19,"19200",66,53,52,0,1,"PCOE",0
44,"44177",101,68,68,1,0,"PCOE",0
41,"41904",1789,1125,1109,31,16,"PCOE",1
40,"40060",67,40,40,1,0,"PCOE",0
19,"19286",772,585,575,3,10,"PCOE",0
44,"44197",51,35,35,1,0,"PCOE",0
14,"14011",580,444,443,3,1,"PCOE",0
30,"30902",8294,5235,5174,29,61,"PCOE",25
19,"19107",306,245,244,0,1,"PCOE",2
21,"21050",12567,8522,8392,89,130,"PCOE",10
41,"41069",29669,20316,19848,381,468,"PCOE",37
19,"19071",8277,5838,5763,53,75,"PCOE",7
40,"40121",249,188,178,1,10,"PCOE",0
19,"19154",58,45,45,0,0,"PCOE",0
29,"29097",4160,2872,2800,56,72,"PCOE",7
19,"19274",953,693,676,9,17,"PCOE",0
12,"12005",8049,5643,5552,71,91,"PCOE",10
21,"21016",985,703,680,5,23,"PCOE",3
40,"40163",42,35,35,1,0,"PCOE",0
15,"15038",2126,1312,1296,12,16,"PCOE",5
12,"12111",327,259,255,8,4,"PCOE",1
44,"44265",175,138,136,1,2,"PCOE",0
44,"44183",61,47,47,1,0,"PCOE",0
12,"12008",228,195,194,1,1,"PCOE",0
40,"40152",732,575,565,10,10,"PCOE",2
29,"29026",1021,703,698,15,5,"PCOE",0
41,"41057",258,174,170,3,4,"PCOE",0
19,"19174",90,65,64,0,1,"PCOE",0
19,"19194",91,69,69,0,0,"PCOE",0
41,"41060",15058,10551,10302,122,249,"PCOE",12
44,"44064",62,46,46,0,0,"PCOE",1
19,"19237",39,34,34,0,0,"PCOE",0
21,"21020",349,230,228,2,2,"PCOE",1
44,"44224",21,14,14,2,0,"PCOE",0
21,"21021",12545,7816,7696,104,120,"PCOE",15
44,"44044",82,65,65,2,0,"PCOE",0
44,"44133",15,12,12,0,0,"PCOE",0
19,"19323",36,26,26,0,0,"PCOE",0
30,"30001",4507,3357,3331,17,26,"PCOE",1
40,"40108",109,85,85,2,0,"PCOE",1
19,"19225",851,618,611,2,7,"PCOE",0
40,"40015",23,19,19,0,0,"PCOE",0
44,"44025",5804,4024,3991,11,33,"PCOE",9
15,"15086",2760,1829,1810,26,19,"PCOE",2
29,"29054",42538,28080,27814,225,266,"PCOE",40
27,"27018",3211,1830,1800,17,30,"PCOE",3
40,"40086",656,513,496,7,17,"PCOE",0
15,"15024",4314,2859,2790,44,69,"PCOE",4
30,"30004",1129,838,833,1,5,"PCOE",1
40,"40016",55,44,43,1,1,"PCOE",0
14,"14015",2045,1465,1418,16,47,"PCOE",0
12,"12076",72,54,54,0,0,"PCOE",0
12,"12126",24374,17741,17553,111,188,"PCOE",27
44,"44153",1733,1131,1125,0,6,"PCOE",2
41,"41023",7999,5500,5435,60,65,"PCOE",7
40,"40130",127,95,87,1,8,"PCOE",0
44,"44187",193,147,146,0,1,"PCOE",0
44,"44158",1153,879,872,6,7,"PCOE",0
29,"29076",2354,1498,1444,21,54,"PCOE",5
21,"21073",1902,1073,1043,13,30,"PCOE",0
44,"44152",70,46,46,0,0,"PCOE",0
30,"30901",10556,7862,7775,58,87,"PCOE",10
19,"19156",917,686,679,2,7,"PCOE",0
19,"19151",1077,703,693,8,10,"PCOE",1
12,"12020",118,104,103,1,1,"PCOE",0
41,"41032",3842,2800,2704,24,96,"PCOE",1
11,"11016",15079,9353,9192,137,161,"PCOE",33
41,"41042",5872,4477,4424,42,53,"PCOE",4
19,"19003",36,30,30,0,0,"PCOE",0
40,"40225",1085,822,809,5,13,"PCOE",2
19,"19038",19,16,15,0,1,"PCOE",0
19,"19239",93,70,70,1,0,"PCOE",0
19,"19070",65,45,45,0,0,"PCOE",0
44,"44116",75,58,58,0,0,"PCOE",0
15,"15004",4924,3333,3292,38,41,"PCOE",8
40,"40210",97,69,69,1,0,"PCOE",0
44,"44018",16,16,16,0,0,"PCOE",0
40,"40181",4182,3102,3038,35,64,"PCOE",4
44,"44009",798,593,589,4,4,"PCOE",0
40,"40191",198,143,138,0,5,"PCOE",0
29,"29022",177,137,136,1,1,"PCOE",0
19,"19284",10,10,10,0,0,"PCOE",0
12,"12055",103,77,76,2,1,"PCOE",0
40,"40104",283,203,200,0,3,"PCOE",0
29,"29064",423,291,285,2,6,"PCOE",0
29,"29051",42179,27231,26724,282,507,"PCOE",56
12,"12132",477,391,385,3,6,"PCOE",0
14,"14066",5748,4116,4035,59,81,"PCOE",17
27,"27010",4378,2719,2670,49,49,"PCOE",4
19,"19173",47,40,40,0,0,"PCOE",0
19,"19262",125,98,98,0,0,"PCOE",0
44,"44199",39,37,37,2,0,"PCOE",0
12,"12129",1783,1207,1184,16,23,"PCOE",0
44,"44132",54,49,49,0,0,"PCOE",0
19,"19157",53,37,37,0,0,"PCOE",0
15,"15019",25981,15866,15672,207,194,"PCOE",58
19,"19090",90,69,68,1,1,"PCOE",0
19,"19203",29,25,25,0,0,"PCOE",0
40,"40221",50,38,35,0,3,"PCOE",0
14,"14013",16619,11968,11719,153,249,"PCOE",35
15,"15048",5087,3426,3383,40,43,"PCOE",3
21,"21046",1729,1212,1187,14,25,"PCOE",2
44,"44189",44,35,35,0,0,"PCOE",0
40,"40018",73,50,50,0,0,"PCOE",0
44,"44129",35,29,29,1,0,"PCOE",0
14,"14035",5774,4076,4017,35,59,"PCOE",6
44,"44106",151,107,106,0,1,"PCOE",0
12,"12107",350,299,295,3,4,"PCOE",1
41,"41004",57692,38578,37814,696,764,"PCOE",62
12,"12115",205,161,161,1,0,"PCOE",0
30,"30042",2218,1645,1625,10,20,"PCOE",0
21,"21038",1082,688,676,4,12,"PCOE",1
19,"19024",8561,6015,5942,44,73,"PCOE",10
15,"15088",3396,2047,2022,22,25,"PCOE",2
18,"18040",237,146,145,0,1,"PCPA",0
11,"11902",3664,2123,2094,46,29,"PCPA",2
29,"29903",485,326,324,2,2,"PCPA",0
41,"41066",1307,927,898,7,29,"PCPA",1
14,"14010",3992,2786,2723,14,63,"PCPA",3
18,"18057",5584,4042,3958,51,84,"PCPA",2
21,"21011",3500,2371,2314,23,57,"PCPA",1
41,"41035",1051,733,722,10,11,"PCPA",0
29,"29043",2463,1508,1460,20,48,"PCPA",2
4,"4033",121,78,77,3,1,"PCPA",0
21,"21035",9766,6114,5998,92,116,"PCPA",1
41,"41002",1421,938,911,7,27,"PCPA",0
41,"41038",102752,71545,70538,980,1007,"PCPA",76
29,"29048",1364,1053,1039,8,14,"PCPA",0
14,"14060",3715,2714,2641,41,73,"PCPA",12
4,"4010",587,421,409,5,12,"PCPA",0
18,"18145",10909,7925,7780,67,145,"PCPA",10
21,"21041",113074,73295,72313,1063,982,"PCPA",55
4,"4102",14202,9264,9139,57,125,"PCPA",10
29,"29044",749,477,473,1,4,"PCPA",1
18,"18078",714,546,538,5,8,"PCPA",0
11,"11020",166773,111205,109956,1580,1249,"PCPA",110
18,"18116",2856,2027,1979,13,48,"PCPA",1
4,"4080",196,148,147,2,1,"PCPA",1
11,"11019",1757,1233,1172,13,61,"PCPA",0
14,"14061",687,536,523,1,13,"PCPA",0
18,"18188",1646,1224,1202,10,22,"PCPA",0
21,"21001",621,431,418,0,13,"PCPA",0
11,"11023",9386,6363,6248,116,115,"PCPA",5
41,"41030",501,376,366,9,10,"PCPA",0
21,"21025",3886,2489,2431,31,58,"PCPA",1
4,"4069",4742,3364,3325,46,39,"PCPA",5
41,"41055",14791,10197,10000,125,197,"PCPA",11
41,"41021",21410,14369,14139,195,230,"PCPA",15
4,"4091",318,251,250,0,1,"PCPA",0
21,"21061",5083,3325,3255,36,70,"PCPA",3
4,"4026",57,38,37,0,1,"PCPA",0
29,"29902",2593,1561,1533,15,28,"PCPA",0
21,"21051",222,171,168,3,3,"PCPA",0
29,"29084",27199,18102,17800,268,302,"PCPA",10
29,"29020",3278,2329,2260,22,69,"PCPA",1
18,"18146",930,645,629,10,16,"PCPA",0
41,"41011",15462,11019,10696,183,323,"PCPA",5
21,"21021",12545,7816,7696,104,120,"PCPA",2
18,"18072",655,452,445,4,7,"PCPA",1
41,"41072",4031,2969,2933,15,36,"PCPA",0
29,"29057",330,222,218,2,4,"PCPA",0
18,"18032",247,164,163,1,1,"PCPA",1
21,"21066",490,394,389,4,5,"PCPA",0
4,"4903",4320,2907,2873,18,34,"PCPA",1
41,"41098",5161,3792,3732,33,60,"PCPA",1
18,"18068",1638,1197,1167,12,30,"PCPA",0
14,"14013",16619,11968,11719,153,249,"PCPA",6
4,"4070",1529,1088,1076,8,12,"PCPA",0
4,"4904",1900,1308,1299,4,9,"PCPA",1
4,"4038",3105,2020,1984,17,36,"PCPA",5
18,"18141",382,240,237,0,3,"PCPA",0
4,"4004",405,282,272,2,10,"PCPA",0
18,"18010",527,398,394,5,4,"PCPA",3
21,"21072",10233,7374,7183,116,191,"PCPA",5
18,"18094",2299,1712,1652,20,60,"PCPA",3
29,"29026",1021,703,698,15,5,"PCPA",1
4,"4022",356,237,236,5,1,"PCPA",1
18,"18161",245,199,196,0,3,"PCPA",0
18,"18020",489,318,310,2,8,"PCPA",0
29,"29058",1542,994,979,5,15,"PCPA",2
18,"18021",17929,12165,11949,139,216,"PCPA",7
18,"18916",1815,1093,1086,6,7,"PCPA",1
41,"41001",1558,1129,1104,6,25,"PCPA",0
4,"4011",2744,2010,1984,20,26,"PCPA",2
11,"11013",2352,1564,1522,13,42,"PCPA",1
21,"21032",1827,1337,1314,13,23,"PCPA",1
18,"18179",493,315,309,8,6,"PCPA",0
18,"18122",15994,11009,10773,109,236,"PCPA",10
14,"14057",6157,4773,4707,59,66,"PCPA",4
41,"41901",2692,2101,2051,47,50,"PCPA",0
18,"18187",510,350,350,2,0,"PCPA",1
4,"4017",1276,833,818,4,15,"PCPA",0
14,"14042",18695,13788,13514,206,274,"PCPA",23
21,"21055",7326,5395,5309,43,86,"PCPA",4
21,"21056",2914,2148,2046,29,102,"PCPA",2
18,"18029",1812,1104,1065,7,39,"PCPA",0
4,"4064",2878,1937,1924,16,13,"PCPA",2
14,"14066",5748,4116,4035,59,81,"PCPA",12
21,"21022",187,121,116,0,5,"PCPA",0
41,"41058",17956,12890,12553,200,337,"PCPA",12
21,"21002",16070,11301,11137,132,164,"PCPA",8
41,"41025",2031,1409,1349,11,60,"PCPA",2
41,"41039",31538,22078,21717,278,361,"PCPA",10
21,"21043",1853,1354,1325,23,29,"PCPA",1
18,"18905",15688,10406,10200,122,206,"PCPA",10
18,"18030",566,382,380,2,2,"PCPA",0
41,"41099",3961,2448,2413,14,35,"PCPA",0
29,"29066",357,248,246,1,2,"PCPA",0
29,"29091",9490,6428,6304,61,124,"PCPA",4
21,"21015",645,361,356,8,5,"PCPA",0
11,"11010",6327,3998,3928,112,70,"PCPA",2
4,"4053",12545,8864,8744,67,120,"PCPA",6
14,"14038",32742,23345,22974,242,371,"PCPA",16
14,"14059",679,527,521,11,6,"PCPA",0
41,"41036",3903,2708,2645,35,63,"PCPA",5
18,"18013",4154,2892,2812,28,80,"PCPA",3
21,"21075",338,243,235,3,8,"PCPA",0
29,"29025",41540,27170,26897,271,273,"PCPA",10
4,"4901",490,343,343,2,0,"PCPA",1
14,"14067",3842,2863,2800,42,63,"PCPA",2
18,"18149",5408,3926,3859,42,67,"PCPA",1
41,"41013",4836,3174,3124,41,50,"PCPA",1
18,"18106",413,270,261,3,9,"PCPA",0
18,"18100",7997,5523,5367,66,156,"PCPA",6
21,"21063",2611,1948,1891,23,57,"PCPA",1
4,"4027",218,130,130,0,0,"PCPA",0
29,"29071",980,580,564,11,16,"PCPA",0
18,"18088",1526,1000,993,10,7,"PCPA",4
29,"29008",15249,10396,10234,108,162,"PCPA",7
4,"4059",1000,676,666,3,10,"PCPA",0
18,"18011",4403,3002,2947,24,55,"PCPA",1
29,"29017",6404,4575,4468,48,107,"PCPA",4
4,"4071",362,286,281,2,5,"PCPA",0
18,"18189",785,598,592,9,6,"PCPA",0
14,"14032",388,302,293,0,9,"PCPA",0
14,"14029",4001,2855,2821,30,34,"PCPA",3
18,"18114",585,425,424,7,1,"PCPA",1
18,"18036",3986,2956,2917,22,39,"PCPA",1
4,"4902",45571,29423,29169,272,254,"PCPA",37
41,"41020",13012,8148,7999,135,149,"PCPA",7
11,"11006",24558,15334,15113,231,221,"PCPA",11
18,"18074",265,205,205,0,0,"PCPA",0
11,"11039",9957,6134,6043,152,91,"PCPA",9
18,"18193",14934,10301,10127,116,174,"PCPA",13
21,"21045",231,177,174,4,3,"PCPA",0
21,"21062",1403,849,838,10,11,"PCPA",0
11,"11033",21804,13361,13133,213,228,"PCPA",19
14,"14050",2350,1774,1720,20,54,"PCPA",2
11,"11015",64414,39635,39220,776,415,"PCPA",36
18,"18907",1762,1358,1351,4,7,"PCPA",3
14,"14004",1963,1465,1437,15,28,"PCPA",1
18,"18079",3466,2391,2333,22,58,"PCPA",7
14,"14051",1323,975,951,7,24,"PCPA",1
29,"29029",383,256,254,4,2,"PCPA",0
4,"4063",1058,766,750,6,16,"PCPA",1
4,"4003",17583,11062,10941,77,121,"PCPA",7
29,"29100",2379,1582,1551,22,31,"PCPA",0
4,"4048",1499,964,957,4,7,"PCPA",1
4,"4103",1432,1003,993,10,10,"PCPA",2
18,"18171",2098,1521,1460,11,61,"PCPA",3
21,"21034",1155,768,748,5,20,"PCPA",0
14,"14015",2045,1465,1418,16,47,"PCPA",1
14,"14019",6380,4933,4831,71,102,"PCPA",3
18,"18181",194,134,133,0,1,"PCPA",0
18,"18121",119,79,79,1,0,"PCPA",2
41,"41090",3489,2560,2467,27,93,"PCPA",60
18,"18046",1738,1042,1023,7,19,"PCPA",0
4,"4008",466,374,371,3,3,"PCPA",0
29,"29041",3697,2406,2361,47,45,"PCPA",4
41,"41019",4931,3323,3251,39,72,"PCPA",4
18,"18049",588,418,415,4,3,"PCPA",0
18,"18124",355,232,231,1,1,"PCPA",0
11,"11041",9869,6438,6295,100,143,"PCPA",5
21,"21065",259,178,175,0,3,"PCPA",0
18,"18112",104,68,66,2,2,"PCPA",0
41,"41057",258,174,170,3,4,"PCPA",1
18,"18194",2038,1373,1348,12,25,"PCPA",0
4,"4081",351,264,263,0,1,"PCPA",0
4,"4034",169,91,91,1,0,"PCPA",0
18,"18102",8233,5424,5266,46,158,"PCPA",10
14,"14035",5774,4076,4017,35,59,"PCPA",1
29,"29082",34683,24751,24495,263,256,"PCPA",13
4,"4047",2224,1649,1627,13,22,"PCPA",0
4,"4035",8439,5822,5768,45,54,"PCPA",4
21,"21004",1586,994,964,23,30,"PCPA",2
29,"29022",177,137,136,1,1,"PCPA",0
21,"21064",6674,4503,4426,68,77,"PCPA",5
41,"41094",6496,4733,4628,47,105,"PCPA",4
21,"21053",3306,2161,2106,11,55,"PCPA",0
41,"41086",16199,10227,10105,137,122,"PCPA",6
18,"18127",17005,11790,11583,150,207,"PCPA",16
18,"18153",8834,6174,6063,54,111,"PCPA",6
18,"18025",277,198,197,0,1,"PCPA",1
18,"18902",752,589,568,3,21,"PCPA",1
14,"14056",23477,15826,15470,177,356,"PCPA",26
11,"11003",1230,802,787,9,15,"PCPA",0
18,"18070",287,216,216,3,0,"PCPA",0
29,"29094",59795,39350,38854,454,496,"PCPA",25
4,"4066",13438,8615,8519,78,96,"PCPA",8
4,"4018",245,202,197,2,5,"PCPA",0
29,"29004",283,222,218,3,4,"PCPA",0
4,"4001",1002,717,710,3,7,"PCPA",0
4,"4072",311,212,211,0,1,"PCPA",0
14,"14001",3423,2563,2515,11,48,"PCPA",7
4,"4085",360,291,289,0,2,"PCPA",0
14,"14070",1280,911,902,4,9,"PCPA",0
41,"41081",30061,21488,21059,331,429,"PCPA",18
29,"29035",1478,1054,1040,3,14,"PCPA",1
18,"18115",2635,1766,1738,13,28,"PCPA",0
41,"41102",14773,10377,10028,174,349,"PCPA",6
41,"41041",9765,7172,6943,63,229,"PCPA",4
14,"14008",2758,1880,1836,21,44,"PCPA",1
18,"18184",2193,1542,1511,16,31,"PCPA",2
41,"41083",1145,821,814,6,7,"PCPA",0
29,"29063",305,244,242,2,2,"PCPA",0
18,"18167",1839,1243,1224,9,19,"PCPA",0
29,"29053",1717,1133,1116,12,17,"PCPA",0
4,"4101",4356,2818,2768,32,50,"PCPA",0
29,"29076",2354,1498,1444,21,54,"PCPA",1
14,"14014",2496,1962,1907,20,55,"PCPA",0
4,"4054",363,279,278,2,1,"PCPA",0
41,"41029",13520,9849,9663,134,186,"PCPA",4
4,"4019",236,174,172,0,2,"PCPA",1
18,"18173",8999,5958,5871,50,87,"PCPA",11
29,"29047",1082,860,846,0,14,"PCPA",0
14,"14022",3881,2888,2853,15,35,"PCPA",3
21,"21077",1739,1266,1235,13,31,"PCPA",1
18,"18136",1778,1320,1284,14,36,"PCPA",2
29,"29052",213,129,128,0,1,"PCPA",1
18,"18912",1352,926,912,7,14,"PCPA",1
18,"18017",18201,11500,11358,94,142,"PCPA",11
18,"18178",664,474,467,1,7,"PCPA",0
29,"29070",43686,27672,27323,290,349,"PCPA",21
21,"21073",1902,1073,1043,13,30,"PCPA",0
18,"18159",989,765,762,2,3,"PCPA",2
29,"29056",1047,708,696,5,12,"PCPA",0
4,"4006",7192,4389,4335,39,54,"PCPA",7
18,"18089",14504,9854,9746,100,108,"PCPA",4
41,"41063",2735,1855,1797,30,58,"PCPA",2
41,"41037",3201,2306,2260,22,46,"PCPA",1
4,"4098",1424,890,885,0,5,"PCPA",0
4,"4065",365,273,271,1,2,"PCPA",0
41,"41101",6025,4299,4213,53,86,"PCPA",3
41,"41056",3687,2836,2779,37,57,"PCPA",3
18,"18101",9449,6688,6568,77,120,"PCPA",2
18,"18911",7933,5464,5348,53,116,"PCPA",2
18,"18016",297,200,198,3,2,"PCPA",0
18,"18107",920,643,626,1,17,"PCPA",0
41,"41078",2445,1722,1689,12,33,"PCPA",0
11,"11030",22999,14858,14586,207,272,"PCPA",10
14,"14901",932,753,750,6,3,"PCPA",0
41,"41017",15907,11486,11302,158,184,"PCPA",4
4,"4051",404,323,319,2,4,"PCPA",0
18,"18095",2054,1475,1433,14,42,"PCPA",0
14,"14023",1999,1629,1593,11,36,"PCPA",0
41,"41010",4586,3218,3157,42,61,"PCPA",2
18,"18126",1436,1024,1002,9,22,"PCPA",0
14,"14028",302,241,240,3,1,"PCPA",0
18,"18047",6103,3992,3922,61,70,"PCPA",1
29,"29001",4207,3002,2959,40,43,"PCPA",9
21,"21029",1514,1036,1003,14,33,"PCPA",3
4,"4092",2791,2058,2023,4,35,"PCPA",2
11,"11002",4218,3176,3149,16,27,"PCPA",4
14,"14041",3113,2234,2160,43,74,"PCPA",6
4,"4043",517,398,395,1,3,"PCPA",0
4,"4015",113,81,81,0,0,"PCPA",0
4,"4074",2910,1813,1789,15,24,"PCPA",2
41,"41027",4007,2628,2546,33,82,"PCPA",1
14,"14030",7761,5711,5588,84,123,"PCPA",5
29,"29088",2689,1817,1747,15,70,"PCPA",0
18,"18180",636,410,401,2,9,"PCPA",0
11,"11038",13632,10047,9812,99,235,"PCPA",11
18,"18177",375,235,231,5,4,"PCPA",0
18,"18071",5636,3909,3807,45,102,"PCPA",3
18,"18043",129,74,71,0,3,"PCPA",0
4,"4014",152,105,103,1,2,"PCPA",0
29,"29037",215,156,153,1,3,"PCPA",0
41,"41009",1148,750,732,5,18,"PCPA",1
18,"18909",514,403,403,0,0,"PCPA",0
14,"14075",552,413,391,5,22,"PCPA",2
4,"4079",54675,35691,35365,328,326,"PCPA",32
4,"4028",207,175,171,1,4,"PCPA",0
4,"4087",157,115,113,0,2,"PCPA",0
18,"18148",787,618,605,5,13,"PCPA",0
4,"4037",1212,890,875,17,15,"PCPA",0
18,"18056",3382,2397,2350,30,47,"PCPA",4
29,"29099",969,688,669,11,19,"PCPA",0
29,"29074",771,561,555,1,6,"PCPA",1
18,"18062",11226,7969,7777,88,192,"PCPA",2
21,"21005",15754,9502,9340,84,162,"PCPA",8
14,"14063",994,731,719,8,12,"PCPA",0
21,"21008",2604,1663,1626,10,37,"PCPA",2
18,"18014",6938,4864,4742,64,122,"PCPA",2
18,"18910",710,439,434,1,5,"PCPA",0
18,"18132",3101,2418,2382,23,36,"PCPA",0
41,"41026",4302,3355,3288,26,67,"PCPA",26
18,"18048",2494,1708,1657,18,51,"PCPA",6
29,"29002",1143,777,766,6,11,"PCPA",0
14,"14073",2768,1934,1880,33,54,"PCPA",2
41,"41045",5873,3901,3802,53,99,"PCPA",2
41,"41059",35358,26408,26052,346,356,"PCPA",16
21,"21068",973,562,556,11,6,"PCPA",0
21,"21027",49,32,32,0,0,"PCPA",0
41,"41033",4958,3299,3250,38,49,"PCPA",0
18,"18152",928,663,660,3,3,"PCPA",0
18,"18054",820,573,569,2,4,"PCPA",0
41,"41089",6621,4650,4549,64,101,"PCPA",2
21,"21902",1136,744,739,2,5,"PCPA",1
29,"29023",2330,1441,1429,11,12,"PCPA",1
21,"21052",4403,2688,2631,26,57,"PCPA",4
18,"18135",4385,2882,2798,24,84,"PCPA",2
18,"18015",424,331,330,4,1,"PCPA",0
41,"41085",4182,3258,3181,43,77,"PCPA",3
18,"18111",2863,2038,2001,29,37,"PCPA",1
14,"14074",2225,1775,1743,17,32,"PCPA",0
14,"14054",13775,10464,10165,105,299,"PCPA",9
18,"18039",3343,2293,2252,22,41,"PCPA",1
14,"14006",1319,1088,1057,8,31,"PCPA",0
18,"18027",2598,1730,1706,12,24,"PCPA",0
18,"18914",1660,1255,1227,11,28,"PCPA",0
18,"18018",542,384,377,2,7,"PCPA",1
41,"41053",21693,15843,15379,171,464,"PCPA",9
14,"14018",3617,2632,2568,31,64,"PCPA",3
21,"21050",12567,8522,8392,89,130,"PCPA",2
18,"18913",771,530,514,2,16,"PCPA",0
14,"14009",2653,1658,1631,24,27,"PCPA",2
29,"29093",2150,1543,1520,8,23,"PCPA",1
21,"21009",834,527,508,4,19,"PCPA",0
41,"41904",1789,1125,1109,31,16,"PCPA",1
21,"21047",1878,1144,1112,12,32,"PCPA",3
18,"18192",1462,1125,1103,3,22,"PCPA",2
21,"21031",1166,773,736,11,37,"PCPA",1
41,"41062",2151,1619,1589,12,30,"PCPA",0
11,"11029",5442,2826,2765,44,61,"PCPA",3
29,"29016",253,196,194,0,2,"PCPA",0
29,"29038",18908,12122,11931,197,191,"PCPA",9
29,"29054",42538,28080,27814,225,266,"PCPA",18
11,"11018",1434,1001,977,8,24,"PCPA",0
14,"14048",1199,883,866,4,17,"PCPA",0
29,"29010",1637,1263,1187,2,76,"PCPA",1
41,"41075",10320,7159,6972,88,187,"PCPA",2
11,"11042",1158,806,793,6,13,"PCPA",1
21,"21042",15610,8112,8011,164,101,"PCPA",5
18,"18006",4062,2765,2711,25,54,"PCPA",0
18,"18904",741,500,498,1,2,"PCPA",0
18,"18037",535,417,410,2,7,"PCPA",1
18,"18069",484,356,356,5,0,"PCPA",0
41,"41064",5602,3520,3417,56,103,"PCPA",4
14,"14011",580,444,443,3,1,"PCPA",4
41,"41042",5872,4477,4424,42,53,"PCPA",2
18,"18083",232,181,179,1,2,"PCPA",0
4,"4032",5716,3727,3696,43,31,"PCPA",2
4,"4009",140,109,106,2,3,"PCPA",1
11,"11008",17923,11702,11464,192,238,"PCPA",11
18,"18063",1232,687,678,9,9,"PCPA",0
41,"41031",1204,780,769,5,11,"PCPA",2
21,"21078",2641,1718,1670,10,48,"PCPA",1
41,"41028",2108,1652,1632,22,20,"PCPA",0
18,"18137",968,733,731,3,2,"PCPA",0
41,"41050",5173,3954,3878,36,76,"PCPA",5
41,"41040",11183,8351,8253,71,98,"PCPA",3
18,"18147",3655,2273,2241,16,32,"PCPA",4
18,"18157",1148,843,827,7,16,"PCPA",0
11,"11012",97338,67120,66466,861,654,"PCPA",65
41,"41008",1044,788,766,3,22,"PCPA",0
18,"18024",837,651,639,11,12,"PCPA",0
41,"41073",1684,1100,1074,7,26,"PCPA",0
21,"21026",262,172,168,2,4,"PCPA",0
14,"14005",6298,3905,3828,71,77,"PCPA",5
18,"18163",311,206,204,0,2,"PCPA",0
14,"14069",7340,5100,5000,69,100,"PCPA",4
4,"4062",4457,3241,3197,22,44,"PCPA",2
18,"18138",2470,1597,1573,25,24,"PCPA",1
11,"11022",48785,24758,24422,398,336,"PCPA",23
4,"4055",361,298,290,3,8,"PCPA",0
41,"41048",2195,1445,1400,13,45,"PCPA",0
21,"21030",1887,1493,1458,12,35,"PCPA",1
18,"18185",545,434,424,5,10,"PCPA",1
11,"11016",15079,9353,9192,137,161,"PCPA",8
18,"18182",1926,1222,1204,8,18,"PCPA",0
4,"4089",687,484,479,2,5,"PCPA",3
29,"29051",42179,27231,26724,282,507,"PCPA",13
4,"4052",12882,8400,8322,93,78,"PCPA",13
41,"41093",19064,14867,14700,151,167,"PCPA",5
41,"41067",7273,5114,5036,59,78,"PCPA",2
14,"14033",1239,875,856,8,19,"PCPA",1
29,"29904",418,328,322,1,6,"PCPA",0
21,"21067",406,274,271,3,3,"PCPA",0
11,"11011",1726,1124,1084,8,40,"PCPA",2
18,"18154",982,668,668,4,0,"PCPA",0
18,"18087",182877,131811,130184,1106,1627,"PCPA",58
4,"4068",170,129,128,0,1,"PCPA",0
14,"14031",556,462,456,5,6,"PCPA",1
4,"4002",1013,711,699,1,12,"PCPA",2
4,"4084",337,238,232,0,6,"PCPA",0
14,"14034",302,222,215,1,7,"PCPA",0
29,"29013",1613,1191,1154,9,37,"PCPA",2
29,"29073",1657,1082,1069,15,13,"PCPA",3
18,"18165",4265,2870,2820,22,50,"PCPA",2
18,"18128",332,263,260,1,3,"PCPA",0
21,"21007",6379,4268,4178,66,90,"PCPA",4
4,"4075",5462,3714,3676,19,38,"PCPA",6
41,"41077",8631,5788,5598,51,190,"PCPA",9
4,"4077",296,270,268,3,2,"PCPA",0
14,"14020",336,227,225,0,2,"PCPA",0
29,"29095",3285,2313,2224,39,89,"PCPA",0
29,"29011",2893,1763,1736,12,27,"PCPA",0
21,"21016",985,703,680,5,23,"PCPA",0
29,"29085",138,98,93,1,5,"PCPA",0
18,"18098",5959,3816,3749,33,67,"PCPA",1
18,"18119",1708,1264,1240,7,24,"PCPA",1
21,"21038",1082,688,676,4,12,"PCPA",1
4,"4088",2444,1587,1574,17,13,"PCPA",2
18,"18005",363,232,230,3,2,"PCPA",0
29,"29081",250,185,182,2,3,"PCPA",0
4,"4021",179,132,129,2,3,"PCPA",0
21,"21006",3321,2197,2125,19,72,"PCPA",0
18,"18086",338,253,247,1,6,"PCPA",0
29,"29007",28907,20371,20129,254,242,"PCPA",27
14,"14036",3677,2619,2555,39,64,"PCPA",0
21,"21012",285,224,221,0,3,"PCPA",0
21,"21059",221,169,163,1,6,"PCPA",0
4,"4056",165,120,120,0,0,"PCPA",0
29,"29068",7833,4897,4806,50,91,"PCPA",2
18,"18003",14454,10162,9935,105,227,"PCPA",8
29,"29097",4160,2872,2800,56,72,"PCPA",1
18,"18045",1065,720,690,11,30,"PCPA",1
4,"4067",504,340,330,4,10,"PCPA",1
14,"14037",3161,2233,2158,22,75,"PCPA",0
11,"11009",579,399,390,0,9,"PCPA",1
29,"29069",87188,54019,53240,633,779,"PCPA",42
41,"41084",2799,2029,1937,9,92,"PCPA",1
29,"29087",363,249,243,4,6,"PCPA",2
21,"21017",2302,1469,1452,18,17,"PCPA",5
41,"41095",40187,27090,26680,512,410,"PCPA",21
4,"4036",239,178,176,0,2,"PCPA",0
11,"11025",4374,2808,2759,30,49,"PCPA",1
18,"18082",810,503,500,3,3,"PCPA",1
29,"29080",6940,4676,4617,36,59,"PCPA",9
41,"41034",23576,15461,15214,264,247,"PCPA",14
11,"11028",32829,21934,21654,310,280,"PCPA",36
29,"29098",1228,902,876,11,26,"PCPA",1
14,"14039",2577,1858,1801,29,57,"PCPA",2
18,"18064",366,289,286,0,3,"PCPA",0
21,"21046",1729,1212,1187,14,25,"PCPA",0
41,"41049",9515,6961,6843,115,118,"PCPA",4
14,"14052",9039,5579,5478,79,101,"PCPA",2
29,"29040",1933,1260,1235,11,25,"PCPA",0
14,"14072",983,692,680,6,12,"PCPA",0
29,"29019",853,604,588,2,16,"PCPA",0
21,"21024",464,328,312,1,16,"PCPA",0
18,"18915",726,474,467,4,7,"PCPA",0
29,"29028",1215,803,779,9,24,"PCPA",1
18,"18105",3827,2436,2392,22,44,"PCPA",0
29,"29006",679,461,452,4,9,"PCPA",0
14,"14064",296,211,208,6,3,"PCPA",0
18,"18175",11793,8099,7943,62,156,"PCPA",5
29,"29045",1679,1162,1144,5,18,"PCPA",0
18,"18150",6964,4717,4622,51,95,"PCPA",9
18,"18066",2095,1401,1378,12,23,"PCPA",2
14,"14017",10953,7929,7791,84,138,"PCPA",13
41,"41004",57692,38578,37814,696,764,"PCPA",39
29,"29079",2326,1609,1582,12,27,"PCPA",1
21,"21076",2153,1459,1426,31,33,"PCPA",0
14,"14058",7866,5451,5334,69,117,"PCPA",5
41,"41100",954,670,635,7,35,"PCPA",0
14,"14027",7890,5841,5726,78,115,"PCPA",15
41,"41082",3354,2545,2507,11,38,"PCPA",0
41,"41092",7681,5408,5299,79,109,"PCPA",7
41,"41903",6776,4616,4494,72,122,"PCPA",5
18,"18170",317,212,209,0,3,"PCPA",1
4,"4044",1542,1092,1080,8,12,"PCPA",1
41,"41047",10449,7884,7770,119,114,"PCPA",7
4,"4029",8830,5546,5482,43,64,"PCPA",6
18,"18051",1092,735,718,8,17,"PCPA",0
41,"41016",7820,5523,5407,57,116,"PCPA",1
14,"14053",5918,4054,3968,92,86,"PCPA",7
21,"21054",8175,6014,5887,41,127,"PCPA",4
4,"4061",625,489,479,5,10,"PCPA",0
29,"29092",576,375,366,7,9,"PCPA",0
18,"18906",903,641,639,2,2,"PCPA",0
18,"18059",4265,2960,2886,23,74,"PCPA",4
41,"41097",3131,2197,2140,13,57,"PCPA",0
11,"11903",1769,1116,1101,22,15,"PCPA",0
18,"18061",999,781,770,5,11,"PCPA",0
11,"11017",3198,2054,2004,37,50,"PCPA",2
14,"14007",15016,10248,10043,99,205,"PCPA",10
29,"29060",665,454,450,1,4,"PCPA",0
41,"41022",4255,2735,2667,32,68,"PCPA",0
18,"18002",529,387,384,1,3,"PCPA",0
41,"41069",29669,20316,19848,381,468,"PCPA",18
14,"14026",2000,1294,1253,20,41,"PCPA",0
14,"14016",1273,936,922,5,14,"PCPA",0
11,"11036",683,401,395,15,6,"PCPA",0
41,"41054",719,562,546,3,16,"PCPA",0
4,"4095",687,462,457,4,5,"PCPA",1
18,"18099",1582,1184,1156,13,28,"PCPA",2
11,"11901",5739,3759,3686,99,73,"PCPA",4
41,"41003",2373,1747,1708,18,39,"PCPA",1
4,"4073",327,224,223,0,1,"PCPA",0
21,"21069",1681,1073,1056,9,17,"PCPA",1
4,"4078",1127,725,718,8,7,"PCPA",0
4,"4031",2238,1649,1645,15,4,"PCPA",2
4,"4096",285,222,222,0,0,"PCPA",0
18,"18050",1649,1113,1095,5,18,"PCPA",2
21,"21033",569,410,405,3,5,"PCPA",0
18,"18164",1790,1135,1108,11,27,"PCPA",1
18,"18085",690,440,432,1,8,"PCPA",1
18,"18103",714,500,498,3,2,"PCPA",0
41,"41060",15058,10551,10302,122,249,"PCPA",8
11,"11040",396,332,324,3,8,"PCPA",1
41,"41007",12488,7657,7421,126,236,"PCPA",8
18,"18183",623,380,376,0,4,"PCPA",0
41,"41074",2994,2154,2105,19,49,"PCPA",3
11,"11032",54731,31560,31284,492,276,"PCPA",70
18,"18134",6104,4049,3972,39,77,"PCPA",3
18,"18053",1554,1001,985,9,16,"PCPA",0
41,"41087",10557,7217,7029,67,188,"PCPA",2
29,"29059",2662,1950,1895,16,55,"PCPA",1
4,"4086",1631,1128,1114,3,14,"PCPA",1
11,"11026",4700,3387,3293,17,94,"PCPA",2
18,"18158",7978,4861,4771,43,90,"PCPA",7
29,"29015",32093,22044,21716,253,328,"PCPA",12
4,"4023",118,84,82,2,2,"PCPA",1
4,"4013",143819,93083,92383,893,700,"PCPA",87
21,"21037",462,320,313,1,7,"PCPA",1
14,"14045",2997,2329,2287,30,42,"PCPA",1
18,"18143",945,661,651,2,10,"PCPA",2
14,"14044",1613,1186,1164,10,22,"PCPA",0
29,"29077",207,135,134,1,1,"PCPA",0
18,"18034",484,345,342,3,3,"PCPA",1
4,"4058",342,238,236,3,2,"PCPA",0
29,"29090",1649,1138,1124,10,14,"PCPA",0
18,"18109",597,430,422,5,8,"PCPA",0
41,"41052",3032,2162,2092,6,70,"PCPA",1
21,"21057",995,600,590,8,10,"PCPA",0
29,"29021",155,111,109,1,2,"PCPA",0
4,"4007",735,514,509,3,5,"PCPA",1
21,"21058",2567,1806,1766,32,40,"PCPA",0
11,"11005",4508,2978,2900,34,78,"PCPA",1
4,"4076",1209,873,850,7,23,"PCPA",1
18,"18065",588,464,451,2,13,"PCPA",1
4,"4045",1696,1268,1254,17,14,"PCPA",2
18,"18108",822,604,599,2,5,"PCPA",0
41,"41096",6178,4739,4655,60,84,"PCPA",4
14,"14055",18411,13054,12798,192,256,"PCPA",6
4,"4020",302,207,206,2,1,"PCPA",0
18,"18035",1179,882,870,7,12,"PCPA",0
41,"41079",9285,6591,6446,101,145,"PCPA",4
41,"41051",2317,1715,1688,4,27,"PCPA",1
4,"4024",3241,2315,2290,34,25,"PCPA",2
4,"4083",1727,1265,1250,8,15,"PCPA",4
18,"18023",15717,10964,10751,132,213,"PCPA",18
4,"4030",1052,690,678,6,12,"PCPA",1
29,"29003",916,677,666,4,11,"PCPA",0
29,"29018",2009,1421,1362,17,59,"PCPA",0
18,"18067",682,442,437,2,5,"PCPA",0
29,"29005",4507,3012,2965,29,47,"PCPA",3
29,"29024",371,216,204,3,12,"PCPA",0
14,"14003",1245,925,907,5,18,"PCPA",0
21,"21036",204,128,121,1,7,"PCPA",0
14,"14062",945,700,693,2,7,"PCPA",0
14,"14040",3749,2905,2845,53,60,"PCPA",4
4,"4097",231,173,173,1,0,"PCPA",2
41,"41032",3842,2800,2704,24,96,"PCPA",2
21,"21014",4066,3089,3029,30,60,"PCPA",1
11,"11031",76427,49773,49248,654,525,"PCPA",40
21,"21018",1719,1048,1029,12,19,"PCPA",0
41,"41023",7999,5500,5435,60,65,"PCPA",6
11,"11027",68774,45571,45137,567,434,"PCPA",52
18,"18076",789,534,532,2,2,"PCPA",0
29,"29031",1555,1015,986,6,29,"PCPA",0
18,"18093",2751,1693,1674,18,19,"PCPA",0
18,"18042",417,332,330,4,2,"PCPA",1
18,"18144",816,592,582,3,10,"PCPA",0
21,"21049",3262,2028,1977,15,51,"PCPA",2
11,"11007",18032,9872,9745,213,127,"PCPA",13
29,"29050",392,229,227,3,2,"PCPA",0
21,"21013",10626,6990,6807,99,183,"PCPA",4
4,"4050",742,465,464,0,1,"PCPA",0
14,"14047",1644,1198,1183,14,15,"PCPA",3
18,"18117",497,360,354,1,6,"PCPA",0
41,"41065",22527,14684,14463,205,221,"PCPA",10
18,"18176",242,164,161,2,3,"PCPA",0
18,"18033",279,179,174,0,5,"PCPA",0
41,"41068",13963,9596,9407,96,189,"PCPA",3
41,"41061",2141,1661,1621,7,40,"PCPA",0
18,"18007",730,490,478,3,12,"PCPA",0
18,"18077",471,350,343,1,7,"PCPA",0
41,"41018",9432,6463,6368,86,95,"PCPA",8
21,"21019",592,397,389,6,8,"PCPA",0
21,"21028",370,265,259,2,6,"PCPA",0
29,"29096",2757,1847,1790,19,57,"PCPA",1
18,"18151",261,167,166,4,1,"PCPA",0
4,"4099",4930,3526,3462,22,64,"PCPA",2
29,"29072",3291,2360,2307,19,53,"PCPA",2
18,"18901",489,323,322,5,1,"PCPA",0
18,"18140",42474,26967,26648,225,319,"PCPA",14
18,"18120",266,204,204,4,0,"PCPA",0
18,"18133",2101,1496,1477,6,19,"PCPA",2
18,"18044",161,91,91,0,0,"PCPA",0
29,"29039",2759,1900,1860,23,40,"PCPA",3
18,"18028",898,723,718,3,5,"PCPA",0
21,"21039",303,211,210,6,1,"PCPA",0
29,"29036",614,393,387,1,6,"PCPA",0
4,"4012",184,151,150,3,1,"PCPA",0
4,"4094",215,156,156,0,0,"PCPA",0
21,"21010",15011,8812,8694,174,118,"PCPA",4
29,"29032",6655,4900,4775,36,125,"PCPA",11
41,"41005",9285,6637,6497,83,140,"PCPA",4
21,"21070",6294,4232,4124,64,108,"PCPA",0
4,"4041",344,227,222,4,5,"PCPA",0
18,"18022",13875,8948,8764,98,184,"PCPA",13
29,"29075",12886,8292,8191,63,101,"PCPA",5
11,"11037",5656,4374,4273,24,101,"PCPA",7
4,"4100",9433,5599,5556,48,43,"PCPA",3
41,"41091",539590,389351,384943,4676,4408,"PCPA",254
21,"21044",18061,11170,11003,123,167,"PCPA",5
4,"4090",298,229,225,1,4,"PCPA",0
41,"41088",515,368,358,2,10,"PCPA",0
29,"29086",770,479,476,5,3,"PCPA",1
41,"41902",4599,2906,2868,50,38,"PCPA",2
4,"4046",849,617,612,6,5,"PCPA",0
11,"11034",2319,1520,1487,17,33,"PCPA",0
41,"41070",6451,4715,4632,70,83,"PCPA",3
14,"14046",4442,3283,3190,34,93,"PCPA",4
18,"18012",2114,1519,1492,9,27,"PCPA",0
14,"14043",7406,5323,5211,63,112,"PCPA",7
29,"29009",1435,971,957,17,14,"PCPA",2
29,"29065",191,145,143,3,2,"PCPA",0
29,"29062",658,557,551,2,6,"PCPA",0
41,"41044",7753,5636,5547,55,89,"PCPA",3
21,"21074",2736,1826,1790,19,36,"PCPA",0
41,"41043",669,447,436,11,11,"PCPA",0
4,"4049",5711,3766,3732,25,34,"PCPA",5
4,"4016",2136,1486,1467,13,19,"PCPA",2
21,"21020",349,230,228,2,2,"PCPA",0
4,"4005",534,422,419,3,3,"PCPA",0
11,"11035",13751,8535,8396,125,139,"PCPA",6
29,"29014",218,122,121,3,1,"PCPA",1
18,"18096",340,227,226,0,1,"PCPA",0
4,"4093",1916,1143,1130,5,13,"PCPA",0
29,"29042",14586,9793,9649,95,144,"PCPA",6
29,"29033",1084,733,722,5,11,"PCPA",0
14,"14068",517,388,378,3,10,"PCPA",0
29,"29901",44757,29291,28960,307,331,"PCPA",19
14,"14071",874,551,540,5,11,"PCPA",1
18,"18903",852,544,537,9,7,"PCPA",0
21,"21023",2033,1215,1193,10,22,"PCPA",0
14,"14065",1820,1374,1352,13,22,"PCPA",2
4,"4060",416,286,282,2,4,"PCPA",0
14,"14024",1849,1417,1391,5,26,"PCPA",0
14,"14025",2834,2352,2299,9,53,"PCPA",0
18,"18908",776,553,528,3,25,"PCPA",0
21,"21048",318,234,229,3,5,"PCPA",0
21,"21079",678,428,417,2,11,"PCPA",0
18,"18123",284,202,200,5,2,"PCPA",0
11,"11021",4914,3187,3069,61,118,"PCPA",4
41,"41071",5571,3608,3516,64,92,"PCPA",1
18,"18097",947,633,631,0,2,"PCPA",1
4,"4057",1261,886,872,6,14,"PCPA",1
11,"11001",4360,2810,2744,32,66,"PCPA",4
21,"21071",206,148,144,4,4,"PCPA",0
41,"41046",3005,2241,2198,11,43,"PCPA",0
18,"18174",435,324,320,3,4,"PCPA",0
11,"11004",89919,55211,54544,830,667,"PCPA",28
14,"14021",260521,185270,183300,2192,1970,"PCPA",187
29,"29012",9718,6664,6553,85,111,"PCPA",4
29,"29061",1043,803,773,9,30,"PCPA",4
29,"29049",2890,2069,2034,12,35,"PCPA",1
21,"21003",684,476,452,4,24,"PCPA",0
29,"29034",461,333,332,2,1,"PCPA",0
18,"18168",783,566,561,11,5,"PCPA",1
41,"41015",5426,3778,3639,41,139,"PCPA",5
29,"29083",2063,1471,1444,14,27,"PCPA",0
41,"41012",3375,2259,2214,26,45,"PCPA",0
29,"29067",431757,290824,287855,3289,2969,"PCPA",230
18,"18084",4533,3233,3178,35,55,"PCPA",3
14,"14002",10895,7599,7479,109,120,"PCPA",70
18,"18162",919,664,652,3,12,"PCPA",0
14,"14012",6046,4215,4120,56,95,"PCPA",1
29,"29055",1892,1425,1394,3,31,"PCPA",0
41,"41024",22819,14767,14455,169,312,"PCPA",7
18,"18004",669,467,466,6,1,"PCPA",0
14,"14902",1113,877,851,15,26,"PCPA",1
4,"4082",275,185,182,2,3,"PCPA",1
41,"41080",1231,832,815,14,17,"PCPA",0
41,"41006",2733,1776,1742,17,34,"PCPA",2
29,"29027",2325,1543,1516,13,27,"PCPA",0
41,"41014",2476,1852,1799,10,53,"PCPA",1
29,"29064",423,291,285,2,6,"PCPA",1
14,"14049",16185,11561,11323,145,238,"PCPA",23
11,"11024",6550,4500,4402,67,98,"PCPA",4
29,"29030",770,618,611,4,7,"PCPA",1
18,"18038",1042,782,760,5,22,"PCPA",0
11,"11014",17203,10923,10805,222,118,"PCPA",14
21,"21040",3193,2219,2123,32,96,"PCPA",2
21,"21060",12287,7761,7638,134,123,"PCPA",1
29,"29089",3138,2262,2186,13,76,"PCPA",13
41,"41076",2134,1246,1230,11,16,"PCPA",13
18,"18001",222,147,146,0,1,"PCPA",0
29,"29046",2494,1727,1693,13,34,"PCPA",0
35,"35021",15072,9791,9696,80,95,"PCPC",23
35,"35022",51765,29309,29034,184,275,"PCPC",30
38,"38028",22144,14312,14174,89,138,"PCPC",15
38,"38042",3778,2410,2386,11,24,"PCPC",4
35,"35017",27498,15513,15240,121,273,"PCPC",33
38,"38032",13579,8941,8880,92,61,"PCPC",6
35,"35032",3331,2293,2252,23,41,"PCPC",3
38,"38045",3542,1825,1801,7,24,"PCPC",2
38,"38046",9267,6652,6594,55,58,"PCPC",4
38,"38050",2417,1288,1273,9,15,"PCPC",3
38,"38018",4466,2867,2821,21,46,"PCPC",2
35,"35004",41975,20773,20602,156,171,"PCPC",32
35,"35001",4566,3148,3105,18,43,"PCPC",3
35,"35003",5644,2987,2943,20,44,"PCPC",0
38,"38027",5581,3577,3533,22,44,"PCPC",3
35,"35018",13153,7742,7674,80,68,"PCPC",9
35,"35005",1009,680,668,2,12,"PCPC",0
38,"38053",3768,2275,2244,16,31,"PCPC",3
38,"38006",41593,20823,20624,127,199,"PCPC",29
38,"38001",21069,10844,10777,63,67,"PCPC",14
38,"38043",19365,12355,12212,126,143,"PCPC",12
38,"38051",7328,5017,4969,32,48,"PCPC",1
38,"38026",33585,24091,23889,170,202,"PCPC",12
38,"38020",16057,9921,9809,66,112,"PCPC",8
38,"38034",3997,2687,2648,19,39,"PCPC",2
38,"38044",2215,1270,1257,5,13,"PCPC",0
35,"35031",7456,4938,4868,39,70,"PCPC",7
35,"35015",10752,5289,5222,39,67,"PCPC",9
35,"35019",32830,18390,18243,87,147,"PCPC",28
35,"35034",8392,3946,3908,27,38,"PCPC",8
35,"35016",300581,181532,179831,1458,1701,"PCPC",310
38,"38017",30964,16228,16102,108,126,"PCPC",14
38,"38901",1466,908,894,4,14,"PCPC",2
38,"38010",3969,2463,2418,11,45,"PCPC",1
35,"35008",6214,4193,4143,33,50,"PCPC",8
38,"38016",1174,595,589,2,6,"PCPC",1
38,"38052",1283,806,794,3,12,"PCPC",0
38,"38014",1342,943,930,6,13,"PCPC",0
38,"38038",165135,101564,100807,709,757,"PCPC",97
38,"38019",13884,7888,7809,49,79,"PCPC",6
38,"38040",5482,3094,3060,14,34,"PCPC",5
38,"38012",2286,1520,1510,8,10,"PCPC",0
35,"35011",24859,15025,14833,149,192,"PCPC",31
38,"38047",1755,1132,1110,9,22,"PCPC",0
35,"35026",83172,48751,48109,449,642,"PCPC",47
35,"35025",1752,1113,1095,5,18,"PCPC",1
38,"38048",3952,2543,2519,22,24,"PCPC",4
38,"38002",971,577,570,8,7,"PCPC",0
35,"35013",6593,4596,4516,47,80,"PCPC",5
35,"35033",6393,4147,4072,38,75,"PCPC",4
38,"38004",4536,2914,2887,28,27,"PCPC",4
38,"38022",18630,11420,11284,87,136,"PCPC",10
35,"35027",10502,6831,6750,67,81,"PCPC",12
38,"38003",1517,899,890,5,9,"PCPC",1
35,"35012",10862,5617,5568,40,49,"PCPC",5
38,"38025",7065,4657,4590,34,67,"PCPC",2
38,"38007",1619,1053,1043,3,10,"PCPC",3
38,"38015",4055,2635,2601,16,34,"PCPC",2
35,"35020",5941,3740,3702,27,38,"PCPC",4
35,"35024",14323,8360,8289,81,71,"PCPC",6
38,"38035",10518,5870,5819,37,51,"PCPC",12
38,"38049",2690,1406,1389,27,17,"PCPC",2
38,"38036",6857,4170,4090,37,80,"PCPC",9
38,"38013",3011,1850,1829,14,21,"PCPC",0
38,"38039",11149,7375,7326,68,49,"PCPC",2
38,"38023",126137,79423,78706,605,717,"PCPC",100
35,"35028",10156,5483,5425,56,58,"PCPC",7
38,"38030",1962,1332,1318,9,14,"PCPC",2
38,"38005",5646,3302,3283,24,19,"PCPC",1
38,"38031",29301,20926,20701,157,225,"PCPC",18
38,"38008",5699,3719,3669,26,50,"PCPC",4
35,"35002",24229,15311,15133,101,178,"PCPC",27
38,"38024",15316,9131,9005,60,126,"PCPC",5
35,"35006",31373,20764,20476,189,288,"PCPC",28
35,"35023",11742,7787,7651,95,136,"PCPC",7
35,"35029",4415,2498,2472,29,26,"PCPC",2
38,"38041",7025,4729,4684,42,45,"PCPC",7
38,"38011",21655,13974,13831,106,143,"PCPC",11
35,"35007",517,347,345,2,2,"PCPC",1
38,"38037",12817,7582,7494,55,88,"PCPC",6
38,"38033",3593,2277,2242,15,35,"PCPC",3
35,"35030",10046,5584,5505,44,79,"PCPC",9
38,"38029",1475,752,744,10,8,"PCPC",0
35,"35009",20229,13378,13201,95,177,"PCPC",15
35,"35010",3853,2224,2194,18,30,"PCPC",2
38,"38009",4315,2846,2817,27,29,"PCPC",5
35,"35014",11962,5994,5888,60,106,"PCPC",7
38,"38021",1609,900,876,2,24,"PCPC",2
25,"25072",5881,4059,4031,30,28,"PCPC",4
25,"25102",647,484,482,5,2,"PCPC",0
8,"8277",168,148,146,1,2,"PCPC",0
43,"43050",2695,1742,1730,10,12,"PCPC",1
17,"17078",335,245,245,0,0,"PCPC",0
8,"8201",455,319,318,12,1,"PCPC",0
8,"8047",3751,2600,2578,26,22,"PCPC",2
8,"8062",1009,778,776,9,2,"PCPC",1
43,"43138",2636,1761,1745,11,16,"PCPC",0
25,"25172",1762,1332,1323,8,9,"PCPC",1
8,"8115",3826,2777,2770,31,7,"PCPC",1
17,"17087",219,179,177,0,2,"PCPC",0
8,"8241",70,52,52,0,0,"PCPC",0
8,"8228",292,234,233,0,1,"PCPC",0
17,"17004",529,411,410,3,1,"PCPC",0
17,"17172",452,336,335,5,1,"PCPC",0
25,"25113",1114,873,863,3,10,"PCPC",0
25,"25126",281,211,210,1,1,"PCPC",0
17,"17198",437,307,306,0,1,"PCPC",0
43,"43021",349,245,243,2,2,"PCPC",0
25,"25092",125,93,92,0,1,"PCPC",0
17,"17217",350,287,284,0,3,"PCPC",0
8,"8161",11826,8001,7951,58,50,"PCPC",5
8,"8208",5793,4267,4244,21,23,"PCPC",0
25,"25031",57,32,32,0,0,"PCPC",0
25,"25049",156,110,109,1,1,"PCPC",0
8,"8145",2712,2060,2049,8,11,"PCPC",0
8,"8069",3323,2555,2540,21,15,"PCPC",1
43,"43076",454,336,335,1,1,"PCPC",0
17,"17121",225,166,163,2,3,"PCPC",0
8,"8150",258,207,207,1,0,"PCPC",0
8,"8122",1733,1179,1175,4,4,"PCPC",0
8,"8269",2729,2114,2105,9,9,"PCPC",1
25,"25008",1081,803,799,4,4,"PCPC",0
8,"8193",988,739,737,10,2,"PCPC",0
25,"25011",5271,3529,3505,21,24,"PCPC",2
43,"43158",74,52,50,0,2,"PCPC",0
17,"17077",565,395,394,2,1,"PCPC",0
17,"17136",196,150,150,0,0,"PCPC",0
25,"25055",163,114,114,0,0,"PCPC",0
8,"8061",1628,1154,1151,15,3,"PCPC",1
25,"25043",800,584,581,2,3,"PCPC",0
17,"17106",142,114,114,0,0,"PCPC",0
8,"8085",986,769,767,6,2,"PCPC",0
43,"43901",8796,5431,5390,41,41,"PCPC",6
25,"25234",4139,2786,2772,13,14,"PCPC",1
43,"43052",927,680,674,7,6,"PCPC",0
25,"25152",148,106,106,0,0,"PCPC",0
25,"25132",141,106,105,0,1,"PCPC",0
8,"8143",2727,1989,1977,19,12,"PCPC",0
43,"43126",1230,937,933,3,4,"PCPC",0
17,"17129",143,108,108,2,0,"PCPC",0
17,"17207",2420,1920,1901,9,19,"PCPC",0
43,"43136",10489,7029,6996,47,33,"PCPC",0
25,"25135",997,675,671,3,4,"PCPC",0
43,"43063",544,376,374,2,2,"PCPC",0
8,"8281",4858,3783,3762,19,21,"PCPC",2
8,"8216",25,17,17,0,0,"PCPC",0
25,"25911",419,298,297,3,1,"PCPC",0
25,"25124",160,102,101,1,1,"PCPC",0
17,"17021",119,89,87,0,2,"PCPC",0
8,"8118",17634,13450,13402,80,48,"PCPC",4
8,"8258",815,636,632,5,4,"PCPC",1
25,"25217",10891,7651,7610,63,41,"PCPC",3
17,"17047",5016,3087,3068,22,19,"PCPC",2
17,"17173",181,143,143,1,0,"PCPC",0
8,"8019",1122912,824423,821037,5287,3386,"PCPC",369
25,"25227",656,476,476,2,0,"PCPC",0
43,"43026",756,576,574,1,2,"PCPC",0
8,"8192",5701,4366,4349,15,17,"PCPC",5
43,"43007",631,479,474,1,5,"PCPC",0
17,"17012",1175,845,842,4,3,"PCPC",0
8,"8176",158,119,119,0,0,"PCPC",0
17,"17204",609,429,428,6,1,"PCPC",2
8,"8284",12597,8244,8183,60,61,"PCPC",3
17,"17128",321,239,238,1,1,"PCPC",0
8,"8261",2405,1726,1718,11,8,"PCPC",1
8,"8162",2118,1581,1576,13,5,"PCPC",1
8,"8190",255,184,182,1,2,"PCPC",0
43,"43054",2807,1972,1957,14,15,"PCPC",2
8,"8214",7007,5390,5371,25,19,"PCPC",0
25,"25111",114,86,86,2,0,"PCPC",0
43,"43109",2706,1751,1738,17,13,"PCPC",0
8,"8188",115,89,89,0,0,"PCPC",0
25,"25040",10651,7041,6987,57,54,"PCPC",6
25,"25014",246,184,178,0,6,"PCPC",0
17,"17009",4068,3061,3050,16,11,"PCPC",1
25,"25004",582,437,432,3,5,"PCPC",0
43,"43001",708,510,507,0,3,"PCPC",0
8,"8237",1644,1263,1254,9,9,"PCPC",0
25,"25141",154,105,104,3,1,"PCPC",0
17,"17112",198,148,147,3,1,"PCPC",0
43,"43110",247,178,178,2,0,"PCPC",0
17,"17183",253,197,197,2,0,"PCPC",0
8,"8086",14137,9971,9912,77,59,"PCPC",5
43,"43116",465,356,352,0,4,"PCPC",1
17,"17190",834,624,619,1,5,"PCPC",0
43,"43129",4607,3284,3261,21,23,"PCPC",3
25,"25032",65,53,52,0,1,"PCPC",0
43,"43031",1447,1085,1072,13,13,"PCPC",0
8,"8246",1692,1345,1340,7,5,"PCPC",0
17,"17013",2765,1999,1985,15,14,"PCPC",3
25,"25033",1120,838,831,5,7,"PCPC",0
8,"8131",745,552,550,3,2,"PCPC",0
8,"8178",444,363,361,2,2,"PCPC",0
43,"43152",435,348,342,2,6,"PCPC",0
17,"17213",5567,3654,3630,19,24,"PCPC",2
43,"43009",1384,966,959,5,7,"PCPC",0
8,"8253",132,103,102,0,1,"PCPC",0
8,"8226",929,748,747,10,1,"PCPC",0
17,"17018",494,377,372,4,5,"PCPC",0
43,"43103",908,705,701,9,4,"PCPC",0
8,"8100",2083,1707,1699,13,8,"PCPC",1
8,"8225",94,83,82,1,1,"PCPC",0
25,"25013",2099,1430,1414,13,16,"PCPC",2
8,"8169",48478,35283,35114,278,169,"PCPC",22
17,"17005",457,322,320,3,2,"PCPC",0
17,"17133",1262,976,964,7,12,"PCPC",0
17,"17142",2713,2166,2159,18,7,"PCPC",0
43,"43907",4386,3083,3067,24,16,"PCPC",1
17,"17161",1023,844,843,5,1,"PCPC",1
8,"8267",6789,4975,4935,41,40,"PCPC",1
43,"43024",1545,1019,1014,14,5,"PCPC",0
17,"17214",714,516,511,6,5,"PCPC",0
8,"8079",333,260,258,2,2,"PCPC",0
43,"43059",250,193,192,1,1,"PCPC",0
43,"43039",101,77,77,0,0,"PCPC",0
43,"43118",422,338,338,0,0,"PCPC",0
25,"25075",132,101,101,0,0,"PCPC",0
43,"43098",362,274,274,1,0,"PCPC",0
8,"8298",27148,19655,19568,102,87,"PCPC",8
8,"8012",1726,1323,1309,17,14,"PCPC",1
25,"25060",71,42,42,0,0,"PCPC",0
25,"25023",4560,3350,3334,24,16,"PCPC",1
25,"25254",704,511,508,2,3,"PCPC",0
43,"43119",849,591,588,8,3,"PCPC",2
25,"25037",361,270,269,4,1,"PCPC",0
8,"8184",55053,38519,38323,298,196,"PCPC",30
43,"43117",147,119,119,0,0,"PCPC",0
8,"8223",1897,1345,1341,10,4,"PCPC",0
25,"25134",605,457,456,5,1,"PCPC",0
43,"43045",143,114,113,0,1,"PCPC",0
25,"25183",520,372,370,4,2,"PCPC",0
25,"25205",563,412,407,3,5,"PCPC",1
8,"8026",195,148,146,0,2,"PCPC",0
43,"43029",312,241,240,1,1,"PCPC",0
43,"43012",3700,2882,2858,20,24,"PCPC",1
43,"43088",2013,1429,1420,11,9,"PCPC",0
25,"25909",138,99,98,2,1,"PCPC",0
25,"25129",161,113,112,0,1,"PCPC",0
43,"43131",4827,3134,3116,32,18,"PCPC",1
8,"8044",4156,2991,2976,16,15,"PCPC",0
17,"17105",248,187,186,2,1,"PCPC",0
8,"8232",1773,1368,1362,9,6,"PCPC",1
17,"17225",205,150,150,1,0,"PCPC",0
17,"17022",7043,4940,4903,34,37,"PCPC",2
43,"43083",146,110,109,0,1,"PCPC",0
8,"8285",10349,7630,7599,48,31,"PCPC",4
8,"8282",6731,5333,5317,40,16,"PCPC",1
43,"43167",391,307,307,2,0,"PCPC",0
8,"8229",521,418,417,3,1,"PCPC",0
43,"43071",896,652,647,3,5,"PCPC",0
8,"8291",4972,3531,3519,23,12,"PCPC",2
43,"43041",216,156,156,2,0,"PCPC",0
17,"17098",308,232,230,4,2,"PCPC",0
25,"25206",247,188,188,2,0,"PCPC",0
43,"43123",71435,49166,48873,318,293,"PCPC",24
43,"43161",17103,11905,11838,82,67,"PCPC",3
25,"25252",553,380,379,2,1,"PCPC",0
8,"8063",469,390,390,4,0,"PCPC",0
25,"25131",394,281,279,3,2,"PCPC",1
25,"25247",142,89,89,2,0,"PCPC",0
43,"43134",281,217,215,5,2,"PCPC",0
17,"17023",27314,18677,18546,117,131,"PCPC",20
25,"25114",96,83,82,1,1,"PCPC",0
17,"17039",1726,1306,1297,7,9,"PCPC",2
43,"43157",339,279,279,1,0,"PCPC",1
8,"8174",388,322,318,2,4,"PCPC",1
25,"25118",326,223,218,0,5,"PCPC",1
25,"25153",190,139,136,0,3,"PCPC",1
43,"43047",4234,2590,2564,19,26,"PCPC",0
8,"8094",1588,1258,1252,7,6,"PCPC",0
43,"43035",233,182,182,5,0,"PCPC",0
8,"8156",11254,8440,8411,58,29,"PCPC",2
43,"43146",40,32,32,0,0,"PCPC",0
8,"8105",9741,6946,6896,62,50,"PCPC",5
25,"25910",91,63,63,0,0,"PCPC",0
17,"17088",599,467,465,3,2,"PCPC",0
8,"8301",49348,36261,36045,292,216,"PCPC",11
25,"25163",230,162,161,0,1,"PCPC",0
8,"8239",467,362,361,3,1,"PCPC",0
43,"43148",91182,65076,64756,441,320,"PCPC",32
43,"43105",155,126,123,4,3,"PCPC",0
17,"17068",253,191,191,0,0,"PCPC",1
25,"25240",1366,1030,1021,4,9,"PCPC",0
25,"25082",292,197,197,2,0,"PCPC",2
25,"25087",54,45,45,0,0,"PCPC",0
25,"25182",1043,763,760,8,3,"PCPC",2
25,"25038",1478,1057,1048,10,9,"PCPC",0
43,"43113",387,305,303,1,2,"PCPC",0
25,"25232",1357,1012,1007,6,5,"PCPC",1
25,"25170",262,210,210,1,0,"PCPC",2
17,"17210",572,414,411,2,3,"PCPC",0
8,"8251",5130,3719,3698,20,21,"PCPC",1
8,"8110",13671,9362,9311,60,51,"PCPC",3
17,"17086",1769,1116,1109,6,7,"PCPC",0
8,"8040",11116,7923,7891,49,32,"PCPC",3
8,"8159",14343,10656,10603,87,53,"PCPC",8
43,"43034",465,365,365,5,0,"PCPC",0
17,"17200",624,469,467,6,2,"PCPC",0
43,"43128",910,665,658,6,7,"PCPC",0
8,"8217",25466,19864,19773,129,91,"PCPC",14
25,"25165",271,210,208,0,2,"PCPC",0
8,"8046",13541,10510,10455,73,55,"PCPC",3
8,"8209",6925,4976,4948,39,28,"PCPC",8
43,"43171",14849,10140,10081,76,59,"PCPC",2
8,"8294",2093,1546,1534,11,12,"PCPC",1
8,"8127",2254,1548,1544,10,4,"PCPC",0
8,"8005",6425,4830,4816,28,14,"PCPC",3
25,"25016",2083,1404,1399,3,5,"PCPC",0
25,"25231",483,387,385,0,2,"PCPC",0
17,"17195",338,274,272,1,2,"PCPC",0
17,"17058",176,128,128,0,0,"PCPC",0
43,"43132",375,295,291,1,4,"PCPC",0
8,"8097",1103,845,840,4,5,"PCPC",0
25,"25089",93,70,68,1,2,"PCPC",0
8,"8148",2344,1655,1646,13,9,"PCPC",1
8,"8904",10516,7068,7025,54,43,"PCPC",7
8,"8220",2411,2010,2001,8,9,"PCPC",1
8,"8028",1125,744,743,7,1,"PCPC",1
17,"17065",321,264,263,3,1,"PCPC",0
43,"43061",40,27,27,3,0,"PCPC",0
25,"25052",1541,1183,1176,7,7,"PCPC",2
8,"8153",573,457,452,3,5,"PCPC",0
8,"8039",413,322,321,1,1,"PCPC",0
25,"25222",69,58,58,0,0,"PCPC",0
8,"8032",2100,1472,1465,12,7,"PCPC",1
17,"17220",801,649,647,2,2,"PCPC",0
8,"8902",3941,2974,2962,16,12,"PCPC",0
43,"43115",128,106,106,0,0,"PCPC",0
17,"17019",1780,1403,1393,5,10,"PCPC",0
8,"8199",648,509,508,3,1,"PCPC",0
43,"43168",83,55,55,1,0,"PCPC",0
8,"8146",1384,1030,1027,8,3,"PCPC",0
17,"17092",3462,2414,2389,14,25,"PCPC",2
25,"25042",204,149,149,5,0,"PCPC",0
8,"8262",6945,4649,4599,38,50,"PCPC",1
8,"8300",5927,4609,4589,41,20,"PCPC",4
25,"25223",890,673,666,7,7,"PCPC",0
17,"17180",8508,5977,5953,38,24,"PCPC",4
25,"25255",390,301,301,0,0,"PCPC",0
8,"8048",580,427,426,1,1,"PCPC",0
43,"43055",1970,1548,1535,12,13,"PCPC",0
25,"25226",236,156,155,0,1,"PCPC",0
43,"43072",90,69,67,1,2,"PCPC",0
8,"8112",12926,9268,9230,61,38,"PCPC",1
25,"25243",3729,2370,2349,33,21,"PCPC",3
8,"8119",6897,5096,5052,31,44,"PCPC",3
43,"43140",2433,1685,1674,11,11,"PCPC",0
17,"17074",536,403,401,1,2,"PCPC",0
43,"43149",690,512,509,3,3,"PCPC",0
17,"17226",884,603,600,4,3,"PCPC",1
25,"25005",269,193,193,3,0,"PCPC",0
17,"17163",2868,2281,2268,13,13,"PCPC",0
17,"17125",136,100,100,3,0,"PCPC",0
8,"8203",2466,1678,1675,7,3,"PCPC",0
8,"8181",8133,5949,5924,31,25,"PCPC",2
43,"43073",80,67,65,0,2,"PCPC",0
8,"8003",7213,5425,5409,41,16,"PCPC",0
8,"8130",110,81,81,2,0,"PCPC",0
17,"17103",5057,3196,3174,21,22,"PCPC",5
43,"43020",2291,1712,1688,19,24,"PCPC",0
43,"43135",339,255,255,0,0,"PCPC",0
17,"17081",252,186,185,2,1,"PCPC",0
17,"17184",1261,1016,1010,7,6,"PCPC",0
43,"43178",1435,1071,1066,2,5,"PCPC",1
8,"8125",25583,18334,18225,122,109,"PCPC",7
8,"8001",9097,6860,6818,39,42,"PCPC",2
17,"17084",228,163,162,1,1,"PCPC",0
25,"25078",995,746,743,7,3,"PCPC",0
17,"17137",3486,2812,2808,15,4,"PCPC",2
17,"17223",808,566,563,1,3,"PCPC",0
17,"17196",252,200,200,1,0,"PCPC",0
8,"8244",6099,4733,4706,39,27,"PCPC",2
25,"25173",1646,1180,1169,6,11,"PCPC",0
43,"43111",2129,1412,1401,8,11,"PCPC",1
8,"8295",11290,8091,8054,72,37,"PCPC",6
8,"8157",8574,6514,6472,47,42,"PCPC",4
25,"25142",359,283,283,2,0,"PCPC",0
43,"43074",1818,1341,1336,2,5,"PCPC",0
17,"17117",14497,9438,9382,66,56,"PCPC",3
25,"25068",515,359,358,0,1,"PCPC",0
8,"8071",249,209,208,0,1,"PCPC",0
17,"17170",173,140,140,2,0,"PCPC",0
8,"8278",4925,3820,3804,22,16,"PCPC",1
17,"17903",883,681,676,3,5,"PCPC",1
8,"8248",5687,4187,4165,21,22,"PCPC",1
8,"8056",42897,30873,30757,259,116,"PCPC",16
8,"8099",753,529,529,4,0,"PCPC",0
8,"8109",207,176,174,0,2,"PCPC",0
17,"17083",2971,2164,2154,13,10,"PCPC",0
25,"25157",159,127,126,1,1,"PCPC",0
17,"17150",1444,1177,1163,13,14,"PCPC",0
43,"43112",245,179,179,3,0,"PCPC",0
8,"8210",4640,3226,3200,24,26,"PCPC",3
25,"25064",96,78,78,0,0,"PCPC",0
8,"8160",317,234,234,0,0,"PCPC",0
43,"43023",211,171,169,2,2,"PCPC",0
8,"8132",356,265,265,1,0,"PCPC",0
17,"17051",202,161,160,0,1,"PCPC",0
17,"17033",5647,3879,3852,25,27,"PCPC",3
8,"8901",240,200,195,2,5,"PCPC",0
17,"17193",4351,2945,2927,21,18,"PCPC",1
25,"25901",289,214,211,4,3,"PCPC",1
8,"8307",49499,35471,35312,199,159,"PCPC",23
43,"43121",593,404,403,1,1,"PCPC",0
8,"8198",4679,3491,3469,12,22,"PCPC",1
8,"8011",1739,1360,1353,10,7,"PCPC",0
8,"8070",269,215,211,1,4,"PCPC",0
8,"8218",8091,5899,5869,50,30,"PCPC",4
25,"25167",223,165,164,3,1,"PCPC",0
17,"17208",978,723,719,6,4,"PCPC",0
43,"43027",168,129,129,3,0,"PCPC",0
25,"25158",1605,1193,1180,8,13,"PCPC",0
8,"8101",175048,121359,120620,830,739,"PCPC",68
8,"8055",542,426,424,3,2,"PCPC",0
17,"17040",551,440,439,5,1,"PCPC",0
17,"17050",664,554,550,10,4,"PCPC",0
17,"17034",7289,4880,4862,23,18,"PCPC",6
17,"17175",559,348,343,5,5,"PCPC",1
8,"8234",3443,2561,2550,15,11,"PCPC",0
8,"8194",25680,16465,16376,131,89,"PCPC",9
25,"25168",496,399,399,6,0,"PCPC",1
25,"25196",108,75,75,1,0,"PCPC",0
8,"8303",257,207,205,1,2,"PCPC",0
8,"8116",557,449,449,1,0,"PCPC",0
8,"8183",4573,3406,3398,14,8,"PCPC",0
25,"25025",1362,909,898,15,11,"PCPC",0
43,"43017",112,94,94,1,0,"PCPC",1
8,"8288",1696,1103,1096,9,7,"PCPC",1
8,"8066",1466,1109,1104,7,5,"PCPC",0
8,"8135",6770,5187,5158,42,29,"PCPC",1
8,"8299",380,301,300,4,1,"PCPC",0
17,"17055",142,124,124,0,0,"PCPC",0
17,"17187",625,496,492,3,4,"PCPC",0
43,"43064",2027,1456,1445,19,11,"PCPC",3
43,"43006",676,462,462,3,0,"PCPC",0
17,"17100",193,147,141,0,6,"PCPC",1
25,"25253",147,118,117,0,1,"PCPC",0
8,"8165",1680,1177,1171,7,6,"PCPC",0
8,"8236",1564,1145,1133,4,12,"PCPC",0
25,"25179",169,132,132,0,0,"PCPC",0
43,"43079",364,290,289,2,1,"PCPC",0
17,"17109",704,542,539,2,3,"PCPC",1
8,"8286",2943,2051,2042,12,9,"PCPC",1
8,"8123",19570,15378,15316,91,62,"PCPC",10
17,"17049",3246,2527,2502,12,25,"PCPC",0
25,"25913",88,72,72,1,0,"PCPC",0
17,"17080",144,113,113,1,0,"PCPC",0
17,"17123",343,286,284,2,2,"PCPC",0
25,"25211",680,470,470,3,0,"PCPC",0
8,"8182",2922,2041,2031,10,10,"PCPC",1
43,"43013",4406,3004,2975,19,29,"PCPC",3
17,"17139",1407,1128,1119,8,9,"PCPC",0
8,"8259",6979,5362,5341,27,21,"PCPC",2
17,"17188",171,134,134,1,0,"PCPC",0
43,"43008",305,171,171,7,0,"PCPC",1
8,"8073",62934,45699,45407,281,292,"PCPC",27
25,"25001",143,102,102,1,0,"PCPC",0
8,"8290",1549,1254,1248,6,6,"PCPC",0
8,"8230",7648,5797,5774,40,23,"PCPC",5
8,"8191",5302,3872,3860,21,12,"PCPC",8
43,"43066",158,108,108,1,0,"PCPC",0
17,"17091",391,296,290,3,6,"PCPC",0
17,"17102",556,398,396,1,2,"PCPC",0
25,"25204",1187,858,849,13,9,"PCPC",1
17,"17029",207,154,154,1,0,"PCPC",0
17,"17114",23268,16423,16333,111,90,"PCPC",23
8,"8076",16526,11988,11893,90,95,"PCPC",8
8,"8107",11965,8604,8554,67,50,"PCPC",5
17,"17186",3834,2980,2954,17,26,"PCPC",1
43,"43905",15100,9689,9630,43,59,"PCPC",5
8,"8031",2339,1760,1750,15,10,"PCPC",1
17,"17153",189,150,149,1,1,"PCPC",0
43,"43903",2332,1502,1487,18,15,"PCPC",0
8,"8158",3094,2261,2251,11,10,"PCPC",0
8,"8077",34690,25896,25767,164,129,"PCPC",10
25,"25069",426,296,294,0,2,"PCPC",0
43,"43169",445,388,388,3,0,"PCPC",0
25,"25181",172,137,137,1,0,"PCPC",0
17,"17144",211,162,159,3,3,"PCPC",0
17,"17030",654,460,459,1,1,"PCPC",0
25,"25101",536,412,411,5,1,"PCPC",0
25,"25250",327,269,265,1,4,"PCPC",0
25,"25145",75,59,59,0,0,"PCPC",0
8,"8034",820,644,640,0,4,"PCPC",0
17,"17037",112,86,86,1,0,"PCPC",0
8,"8274",4640,3385,3363,24,22,"PCPC",2
17,"17073",1939,1649,1640,11,9,"PCPC",2
43,"43153",11197,7685,7649,53,36,"PCPC",5
8,"8004",208,177,177,1,0,"PCPC",0
17,"17151",179,131,130,0,1,"PCPC",0
8,"8009",9531,7200,7171,47,29,"PCPC",2
25,"25047",956,745,736,14,9,"PCPC",1
25,"25225",531,395,393,0,2,"PCPC",0
8,"8121",87515,62961,62574,429,387,"PCPC",30
25,"25022",105,80,79,0,1,"PCPC",0
8,"8025",1573,1170,1160,9,10,"PCPC",1
8,"8202",12943,9408,9358,58,50,"PCPC",2
8,"8093",25,22,22,0,0,"PCPC",0
17,"17146",3150,2243,2224,8,19,"PCPC",0
8,"8038",1541,1129,1120,6,9,"PCPC",0
25,"25039",259,197,196,7,1,"PCPC",0
43,"43093",3863,2728,2716,22,12,"PCPC",2
8,"8204",3141,2395,2383,16,12,"PCPC",2
25,"25012",2349,1563,1556,17,7,"PCPC",0
43,"43069",183,148,147,2,1,"PCPC",0
8,"8212",491,393,386,6,7,"PCPC",0
8,"8270",19014,13635,13594,74,41,"PCPC",3
17,"17024",281,203,201,4,2,"PCPC",0
8,"8168",388,280,279,3,1,"PCPC",0
8,"8138",4461,3286,3259,27,27,"PCPC",5
8,"8205",61957,49325,49196,441,129,"PCPC",14
17,"17174",164,130,130,4,0,"PCPC",0
8,"8104",657,496,493,4,3,"PCPC",0
8,"8238",14946,11911,11873,85,38,"PCPC",1
25,"25034",2271,1616,1600,12,16,"PCPC",2
17,"17070",110,87,87,0,0,"PCPC",0
8,"8013",1287,982,972,6,10,"PCPC",0
25,"25218",88,76,75,2,1,"PCPC",0
8,"8271",66,48,47,2,1,"PCPC",0
8,"8155",7056,5050,5011,38,39,"PCPC",4
17,"17192",143,107,104,0,3,"PCPC",0
25,"25221",115,82,81,1,1,"PCPC",0
43,"43100",3557,2666,2649,22,17,"PCPC",1
17,"17052",135,93,92,0,1,"PCPC",0
8,"8054",9215,6994,6943,38,51,"PCPC",2
17,"17169",2511,1901,1890,8,11,"PCPC",0
8,"8049",1309,910,903,3,7,"PCPC",0
25,"25096",885,597,591,2,6,"PCPC",1
43,"43092",7308,4703,4679,33,24,"PCPC",1
25,"25041",525,375,370,4,5,"PCPC",0
8,"8139",172,148,147,2,1,"PCPC",1
25,"25203",8809,5813,5770,40,43,"PCPC",1
17,"17191",163,140,140,1,0,"PCPC",0
25,"25085",141,109,108,2,1,"PCPC",0
17,"17221",4138,2999,2988,23,11,"PCPC",3
17,"17211",837,677,674,6,3,"PCPC",0
25,"25053",1100,819,811,7,8,"PCPC",0
43,"43147",528,425,420,3,5,"PCPC",0
8,"8224",885,653,652,6,1,"PCPC",0
43,"43005",3677,2505,2493,17,12,"PCPC",1
25,"25074",179,155,151,2,4,"PCPC",0
8,"8037",1947,1547,1543,11,4,"PCPC",0
8,"8053",2896,1939,1929,13,10,"PCPC",0
43,"43011",1086,862,860,5,2,"PCPC",0
8,"8120",7129,5649,5621,51,28,"PCPC",2
25,"25907",500,366,364,5,2,"PCPC",0
25,"25109",211,155,154,1,1,"PCPC",0
25,"25190",262,202,202,2,0,"PCPC",0
43,"43143",50,40,39,0,1,"PCPC",0
17,"17222",104,87,87,1,0,"PCPC",0
25,"25112",269,205,200,2,5,"PCPC",0
25,"25104",120,88,88,0,0,"PCPC",0
17,"17233",2347,1853,1840,11,13,"PCPC",0
25,"25086",525,410,407,3,3,"PCPC",0
43,"43166",1646,1183,1176,4,7,"PCPC",0
8,"8266",43422,32827,32696,241,131,"PCPC",14
25,"25120",92888,62740,62389,450,351,"PCPC",52
8,"8089",34190,24548,24404,194,144,"PCPC",9
17,"17177",562,426,423,1,3,"PCPC",1
25,"25058",4345,3058,3045,13,13,"PCPC",1
43,"43015",115,92,91,1,1,"PCPC",0
17,"17107",267,207,205,2,2,"PCPC",0
8,"8151",450,351,346,5,5,"PCPC",0
8,"8072",10769,7632,7600,56,32,"PCPC",4
43,"43068",484,322,317,2,5,"PCPC",0
43,"43150",1233,954,941,6,13,"PCPC",1
17,"17234",181,129,129,1,0,"PCPC",0
17,"17036",2639,1944,1934,21,10,"PCPC",2
43,"43036",869,565,557,7,8,"PCPC",1
43,"43033",766,555,555,4,0,"PCPC",0
8,"8060",139,110,108,1,2,"PCPC",0
8,"8103",652,476,474,1,2,"PCPC",0
17,"17020",3677,2851,2835,14,16,"PCPC",2
17,"17076",119,95,94,2,1,"PCPC",0
25,"25139",477,348,346,3,2,"PCPC",0
8,"8017",2808,2033,2016,16,17,"PCPC",1
43,"43108",1787,1293,1282,6,11,"PCPC",0
17,"17094",1058,757,747,3,10,"PCPC",0
43,"43002",1890,1233,1210,12,23,"PCPC",0
25,"25180",227,158,155,1,3,"PCPC",0
17,"17096",159,116,116,3,0,"PCPC",0
8,"8015",156540,109145,108440,957,705,"PCPC",61
17,"17044",6938,5245,5212,33,33,"PCPC",3
25,"25201",110,81,81,0,0,"PCPC",0
25,"25057",208,151,149,4,2,"PCPC",0
8,"8306",535,368,368,5,0,"PCPC",1
8,"8167",6056,4520,4500,38,20,"PCPC",2
8,"8243",154,125,125,2,0,"PCPC",0
43,"43096",97,76,76,0,0,"PCPC",1
8,"8092",3713,2758,2745,9,13,"PCPC",0
43,"43163",26162,17276,17128,98,148,"PCPC",11
8,"8197",7986,5829,5805,37,24,"PCPC",3
17,"17038",377,303,301,0,2,"PCPC",0
17,"17902",1294,992,990,9,2,"PCPC",0
8,"8018",2540,1862,1855,7,7,"PCPC",1
8,"8084",1172,902,894,9,8,"PCPC",1
8,"8256",693,542,542,3,0,"PCPC",0
8,"8200",62225,45235,44991,306,244,"PCPC",25
17,"17166",547,442,440,0,2,"PCPC",0
8,"8057",61,47,47,1,0,"PCPC",0
17,"17027",2857,2236,2229,9,7,"PCPC",0
17,"17095",20044,12638,12576,88,62,"PCPC",17
25,"25098",227,160,158,1,2,"PCPC",0
25,"25029",1590,1190,1185,4,5,"PCPC",1
17,"17101",566,389,382,1,7,"PCPC",0
25,"25175",173,119,119,2,0,"PCPC",0
25,"25164",353,259,255,0,4,"PCPC",0
43,"43082",350,276,271,5,5,"PCPC",0
8,"8185",197,162,162,1,0,"PCPC",0
43,"43089",279,201,201,1,0,"PCPC",1
8,"8292",1074,796,790,2,6,"PCPC",0
17,"17028",297,216,214,2,2,"PCPC",0
25,"25070",817,619,617,11,2,"PCPC",0
25,"25079",276,202,202,0,0,"PCPC",0
43,"43170",877,664,661,4,3,"PCPC",0
17,"17079",65572,47740,47502,279,238,"PCPC",28
8,"8293",227,177,177,0,0,"PCPC",0
17,"17182",269,195,195,0,0,"PCPC",0
25,"25125",383,265,265,3,0,"PCPC",0
8,"8078",216,154,154,2,0,"PCPC",0
8,"8051",18570,14112,14054,86,58,"PCPC",6
8,"8305",27661,20346,20221,118,125,"PCPC",14
17,"17224",299,226,222,2,4,"PCPC",0
43,"43142",1069,783,774,3,9,"PCPC",0
8,"8081",349,274,270,0,4,"PCPC",0
43,"43014",14386,9542,9464,74,78,"PCPC",12
43,"43145",4209,3193,3170,17,23,"PCPC",3
17,"17189",1481,1228,1223,5,5,"PCPC",0
17,"17215",2286,1855,1844,13,11,"PCPC",0
17,"17054",342,250,250,2,0,"PCPC",0
17,"17035",544,447,447,2,0,"PCPC",0
25,"25224",122,94,94,0,0,"PCPC",0
8,"8133",123,96,94,5,2,"PCPC",0
17,"17014",66,51,49,0,2,"PCPC",0
8,"8006",11774,8375,8329,53,46,"PCPC",3
17,"17118",12934,8723,8665,38,58,"PCPC",107
17,"17212",145,111,109,0,2,"PCPC",0
43,"43102",458,331,324,2,7,"PCPC",0
25,"25045",57,26,26,2,0,"PCPC",0
43,"43070",243,194,193,0,1,"PCPC",0
8,"8268",975,729,723,6,6,"PCPC",0
8,"8090",142,116,116,0,0,"PCPC",0
43,"43032",462,354,350,2,4,"PCPC",1
8,"8287",1067,853,844,4,9,"PCPC",0
8,"8136",11692,8527,8456,98,71,"PCPC",0
43,"43107",387,285,285,3,0,"PCPC",0
8,"8264",4608,3459,3444,30,15,"PCPC",2
8,"8196",19542,14264,14185,123,79,"PCPC",9
25,"25044",178,144,142,0,2,"PCPC",0
17,"17031",178,117,117,0,0,"PCPC",0
43,"43095",2583,1864,1854,12,10,"PCPC",3
25,"25238",212,161,160,0,1,"PCPC",0
17,"17016",737,570,563,2,7,"PCPC",0
17,"17025",1182,943,938,5,5,"PCPC",0
25,"25200",318,245,245,0,0,"PCPC",2
17,"17140",635,506,505,2,1,"PCPC",0
8,"8088",12347,9316,9270,75,46,"PCPC",10
17,"17148",1550,1121,1114,15,7,"PCPC",3
25,"25097",89,71,71,2,0,"PCPC",0
17,"17159",622,459,459,1,0,"PCPC",1
25,"25100",184,137,136,1,1,"PCPC",0
17,"17176",128,111,111,0,0,"PCPC",0
8,"8043",3414,2429,2422,15,7,"PCPC",1
25,"25906",205,133,131,2,2,"PCPC",0
43,"43177",276,229,227,2,2,"PCPC",1
17,"17203",165,126,126,0,0,"PCPC",0
17,"17111",984,728,728,7,0,"PCPC",0
8,"8036",163,122,122,0,0,"PCPC",0
43,"43078",835,610,605,7,5,"PCPC",0
17,"17048",6284,4077,4048,34,29,"PCPC",2
17,"17135",393,307,303,0,4,"PCPC",0
43,"43094",2143,1558,1541,6,17,"PCPC",2
17,"17168",373,309,308,3,1,"PCPC",0
8,"8213",6600,4925,4906,30,19,"PCPC",3
8,"8029",3586,2868,2862,20,6,"PCPC",0
25,"25210",1073,791,780,3,11,"PCPC",0
17,"17171",177,138,137,0,1,"PCPC",0
8,"8304",822,655,655,5,0,"PCPC",0
43,"43075",86,65,63,0,2,"PCPC",0
43,"43154",126,104,104,0,0,"PCPC",1
17,"17201",137,103,103,0,0,"PCPC",0
25,"25115",803,601,593,4,8,"PCPC",0
8,"8175",3369,2388,2372,18,16,"PCPC",1
8,"8905",2329,1872,1863,7,9,"PCPC",0
43,"43906",2113,1490,1480,12,10,"PCPC",1
43,"43120",421,256,254,1,2,"PCPC",0
8,"8022",12213,8594,8558,42,36,"PCPC",2
25,"25017",228,175,174,0,1,"PCPC",0
43,"43062",269,229,226,5,3,"PCPC",0
43,"43053",186,135,134,0,1,"PCPC",0
25,"25908",217,136,136,0,0,"PCPC",0
8,"8252",24885,18507,18383,162,124,"PCPC",12
43,"43028",2770,1784,1770,7,14,"PCPC",0
8,"8030",5208,4045,4033,25,12,"PCPC",0
17,"17134",220,175,174,1,1,"PCPC",1
17,"17085",293,239,238,0,1,"PCPC",0
25,"25212",219,176,176,1,0,"PCPC",0
8,"8083",1672,1433,1430,6,3,"PCPC",0
25,"25076",131,91,91,0,0,"PCPC",0
8,"8106",7500,5442,5410,43,32,"PCPC",1
17,"17032",1745,1139,1133,6,6,"PCPC",1
8,"8245",77841,53719,53443,430,276,"PCPC",69
43,"43019",1332,911,904,8,7,"PCPC",2
8,"8142",136,117,117,3,0,"PCPC",0
17,"17167",2585,2015,1998,11,17,"PCPC",1
43,"43037",18216,11749,11672,70,77,"PCPC",4
17,"17003",103,85,85,0,0,"PCPC",0
25,"25030",117,76,76,0,0,"PCPC",0
43,"43106",784,605,598,3,7,"PCPC",0
25,"25036",180,124,124,1,0,"PCPC",0
8,"8211",33934,26136,26000,198,136,"PCPC",15
17,"17149",370,302,300,1,2,"PCPC",0
25,"25048",1641,1207,1194,13,13,"PCPC",1
17,"17216",158,122,121,0,1,"PCPC",0
25,"25002",465,324,323,4,1,"PCPC",0
8,"8023",7029,5027,5000,39,27,"PCPC",2
25,"25166",170,131,130,2,1,"PCPC",0
8,"8064",1956,1439,1423,7,16,"PCPC",0
17,"17071",1134,943,940,1,3,"PCPC",1
8,"8255",133,100,100,2,0,"PCPC",0
17,"17006",1178,826,818,9,8,"PCPC",0
43,"43057",38,32,32,1,0,"PCPC",0
43,"43144",1245,975,966,1,9,"PCPC",0
25,"25904",160,134,133,2,1,"PCPC",0
43,"43127",775,607,606,3,1,"PCPC",0
8,"8067",5746,4299,4270,24,29,"PCPC",0
17,"17202",3848,2632,2615,16,17,"PCPC",0
17,"17042",410,299,297,5,2,"PCPC",0
8,"8082",1164,796,780,5,16,"PCPC",1
43,"43056",803,566,558,6,8,"PCPC",0
25,"25133",671,481,479,1,2,"PCPC",0
43,"43030",483,356,351,2,5,"PCPC",0
25,"25050",3256,2260,2249,20,11,"PCPC",2
43,"43048",768,564,554,7,10,"PCPC",0
8,"8020",5243,4117,4100,29,17,"PCPC",2
8,"8041",10698,7324,7258,57,66,"PCPC",8
8,"8154",697,541,539,3,2,"PCPC",0
25,"25123",189,135,133,0,2,"PCPC",0
8,"8247",982,799,798,4,1,"PCPC",0
25,"25093",629,455,443,5,12,"PCPC",0
25,"25242",688,494,488,5,6,"PCPC",0
17,"17119",71,53,52,3,1,"PCPC",0
25,"25015",336,234,233,3,1,"PCPC",0
43,"43080",230,192,192,2,0,"PCPC",0
8,"8007",6795,5099,5081,29,18,"PCPC",3
17,"17064",324,249,247,2,2,"PCPC",0
17,"17026",549,421,415,3,6,"PCPC",1
17,"17155",14957,9519,9410,71,109,"PCPC",8
8,"8117",2489,1954,1941,21,13,"PCPC",2
8,"8215",2617,1954,1946,22,8,"PCPC",0
43,"43139",2007,1432,1419,9,13,"PCPC",0
17,"17143",145,104,104,0,0,"PCPC",0
8,"8263",21208,15014,14890,111,124,"PCPC",18
17,"17097",200,170,167,2,3,"PCPC",0
43,"43172",334,248,243,4,5,"PCPC",0
8,"8279",156327,112605,112030,952,575,"PCPC",62
25,"25151",731,555,549,1,6,"PCPC",0
43,"43043",3317,2457,2445,12,12,"PCPC",0
43,"43058",95,78,78,0,0,"PCPC",0
17,"17147",7916,5672,5641,41,31,"PCPC",1
25,"25209",1586,1115,1102,6,13,"PCPC",1
8,"8134",848,618,609,4,9,"PCPC",0
8,"8149",980,702,694,6,8,"PCPC",0
8,"8235",3875,3004,2996,19,8,"PCPC",1
43,"43086",5252,3811,3790,28,21,"PCPC",1
25,"25099",1285,908,904,6,4,"PCPC",0
8,"8098",2438,1781,1778,21,3,"PCPC",1
17,"17075",340,257,256,2,1,"PCPC",0
43,"43016",3470,2547,2508,15,39,"PCPC",3
17,"17158",565,296,295,2,1,"PCPC",2
8,"8302",9359,6483,6430,78,53,"PCPC",5
25,"25155",616,446,443,2,3,"PCPC",1
25,"25208",337,242,241,2,1,"PCPC",0
25,"25230",1541,1105,1099,9,6,"PCPC",0
17,"17152",11065,6959,6927,68,32,"PCPC",6
8,"8250",7235,4917,4876,41,41,"PCPC",3
17,"17066",27378,16755,16644,122,111,"PCPC",14
43,"43025",591,448,443,4,5,"PCPC",0
8,"8180",27198,19822,19704,160,118,"PCPC",6
8,"8249",274,238,237,0,1,"PCPC",0
8,"8045",65,44,43,0,1,"PCPC",0
8,"8129",486,399,398,0,1,"PCPC",0
8,"8114",18838,13519,13442,81,77,"PCPC",8
8,"8265",1597,1262,1260,4,2,"PCPC",2
43,"43042",2215,1723,1710,18,13,"PCPC",0
25,"25019",4606,2860,2829,19,31,"PCPC",3
17,"17061",180,141,139,1,2,"PCPC",0
25,"25197",140,109,109,0,0,"PCPC",0
8,"8187",153822,113081,112470,758,611,"PCPC",73
25,"25233",289,219,218,6,1,"PCPC",0
25,"25067",702,500,494,8,6,"PCPC",0
8,"8140",4816,3541,3520,25,21,"PCPC",0
8,"8172",20543,15191,15140,85,51,"PCPC",3
17,"17115",276,208,208,4,0,"PCPC",0
8,"8059",340,255,250,1,5,"PCPC",0
8,"8903",201,181,181,1,0,"PCPC",0
25,"25094",138,96,93,2,3,"PCPC",0
43,"43155",22586,15295,15204,120,91,"PCPC",4
43,"43003",349,257,255,3,2,"PCPC",0
17,"17160",14756,9892,9852,58,40,"PCPC",4
17,"17046",709,537,531,2,6,"PCPC",0
17,"17126",316,269,269,1,0,"PCPC",0
8,"8087",144,120,120,0,0,"PCPC",0
25,"25077",435,312,312,1,0,"PCPC",0
25,"25088",96,73,73,0,0,"PCPC",0
8,"8002",217,172,172,2,0,"PCPC",0
25,"25110",2745,1943,1927,13,16,"PCPC",2
43,"43067",526,426,424,3,2,"PCPC",1
17,"17056",1780,1379,1374,13,5,"PCPC",0
17,"17001",575,428,426,4,2,"PCPC",0
8,"8052",140,102,102,1,0,"PCPC",0
25,"25003",3717,2577,2561,15,16,"PCPC",1
25,"25137",8684,5802,5757,48,45,"PCPC",2
8,"8275",247,218,218,3,0,"PCPC",0
17,"17082",435,308,307,1,1,"PCPC",0
43,"43085",237,190,185,1,5,"PCPC",0
43,"43065",379,281,277,4,4,"PCPC",0
43,"43125",884,658,645,12,13,"PCPC",1
8,"8144",722,551,545,3,6,"PCPC",0
17,"17057",968,770,769,7,1,"PCPC",0
43,"43162",4436,3191,3163,24,28,"PCPC",2
17,"17116",351,261,261,2,0,"PCPC",0
25,"25245",427,312,308,4,4,"PCPC",0
25,"25161",339,221,221,0,0,"PCPC",0
8,"8233",1872,1428,1420,15,8,"PCPC",1
8,"8124",37157,27139,26994,179,145,"PCPC",36
25,"25103",133,88,87,0,1,"PCPC",0
25,"25177",356,252,250,1,2,"PCPC",0
25,"25007",1378,1010,999,12,11,"PCPC",0
25,"25249",176,129,127,2,2,"PCPC",0
25,"25146",223,158,155,3,3,"PCPC",0
17,"17901",987,733,725,5,8,"PCPC",0
25,"25081",281,195,193,3,2,"PCPC",0
17,"17181",3458,2454,2443,18,11,"PCPC",0
8,"8231",21269,14655,14573,111,82,"PCPC",11
17,"17011",645,518,514,10,4,"PCPC",0
8,"8276",241,179,179,3,0,"PCPC",0
17,"17157",122,104,103,0,1,"PCPC",0
43,"43022",1436,1028,1024,13,4,"PCPC",0
25,"25216",244,186,186,0,0,"PCPC",0
25,"25185",680,452,451,0,1,"PCPC",0
25,"25903",226,169,169,1,0,"PCPC",0
25,"25119",2258,1701,1686,11,15,"PCPC",0
8,"8058",1808,1280,1262,6,18,"PCPC",1
17,"17194",73,56,56,0,0,"PCPC",0
17,"17178",1065,774,771,9,3,"PCPC",0
8,"8221",12793,10123,10079,73,44,"PCPC",0
8,"8195",75,62,62,0,0,"PCPC",0
8,"8016",1803,1371,1363,11,8,"PCPC",2
17,"17199",6984,4919,4894,39,25,"PCPC",2
43,"43049",727,557,555,3,2,"PCPC",1
8,"8096",43926,32120,31960,217,160,"PCPC",21
8,"8035",13006,8957,8918,50,39,"PCPC",4
8,"8095",66,49,49,0,0,"PCPC",0
17,"17060",409,300,298,1,2,"PCPC",0
8,"8050",139,118,115,4,3,"PCPC",0
43,"43165",571,469,467,2,2,"PCPC",0
8,"8283",6165,4546,4524,33,22,"PCPC",7
25,"25194",410,292,289,3,3,"PCPC",0
8,"8111",216,195,194,2,1,"PCPC",0
8,"8242",223,159,159,0,0,"PCPC",0
25,"25192",727,527,524,4,3,"PCPC",1
43,"43159",76,60,60,0,0,"PCPC",0
25,"25186",207,162,161,0,1,"PCPC",0
43,"43137",1890,1373,1353,8,20,"PCPC",1
8,"8102",28940,21108,21014,157,94,"PCPC",7
17,"17008",3605,2595,2577,8,18,"PCPC",2
25,"25063",84,52,51,0,1,"PCPC",0
8,"8222",1821,1439,1424,7,15,"PCPC",2
43,"43099",284,214,214,4,0,"PCPC",0
25,"25130",181,130,128,0,2,"PCPC",0
17,"17062",5982,4025,4001,19,24,"PCPC",4
8,"8207",2026,1667,1659,12,8,"PCPC",0
8,"8147",17389,12679,12601,102,78,"PCPC",8
25,"25061",80,51,51,0,0,"PCPC",0
43,"43084",514,388,383,2,5,"PCPC",0
8,"8141",4578,3369,3357,28,12,"PCPC",1
43,"43141",109,85,84,0,1,"PCPC",0
17,"17043",165,133,133,0,0,"PCPC",1
8,"8240",9469,7351,7327,39,24,"PCPC",3
8,"8308",139,109,109,1,0,"PCPC",0
25,"25912",841,620,619,5,1,"PCPC",0
25,"25021",2513,1668,1662,17,6,"PCPC",0
8,"8068",6863,5064,5041,40,23,"PCPC",1
8,"8113",52589,36864,36690,244,174,"PCPC",17
25,"25105",105,88,87,4,1,"PCPC",0
25,"25191",321,227,222,2,5,"PCPC",0
25,"25202",108,72,72,2,0,"PCPC",0
8,"8080",40,27,27,3,0,"PCPC",0
25,"25010",194,138,136,0,2,"PCPC",0
17,"17124",1593,1163,1160,8,3,"PCPC",0
8,"8272",164,128,128,1,0,"PCPC",0
8,"8254",1766,1433,1427,16,6,"PCPC",0
25,"25169",170,117,117,5,0,"PCPC",0
43,"43173",98,70,68,0,2,"PCPC",0
17,"17232",146,111,111,0,0,"PCPC",0
25,"25248",870,676,675,5,1,"PCPC",0
17,"17227",147,104,104,0,0,"PCPC",0
17,"17067",704,551,549,6,2,"PCPC",0
43,"43124",468,343,339,3,4,"PCPC",0
43,"43133",5627,3794,3773,31,21,"PCPC",1
25,"25062",691,498,491,4,7,"PCPC",2
8,"8074",11190,7698,7651,51,47,"PCPC",4
8,"8297",138,99,99,0,0,"PCPC",0
43,"43160",1324,967,956,6,11,"PCPC",0
25,"25056",209,145,145,0,0,"PCPC",0
17,"17185",2260,1657,1652,8,5,"PCPC",1
8,"8257",103,82,82,0,0,"PCPC",0
43,"43164",310,235,231,3,4,"PCPC",0
8,"8008",175,136,136,2,0,"PCPC",0
17,"17154",101,76,76,0,0,"PCPC",0
8,"8227",2420,1775,1769,11,6,"PCPC",0
25,"25051",1522,1066,1059,6,7,"PCPC",1
8,"8152",117,94,94,0,0,"PCPC",0
25,"25148",224,158,158,0,0,"PCPC",0
17,"17205",209,167,166,0,1,"PCPC",0
25,"25239",582,330,330,3,0,"PCPC",0
43,"43004",6288,4314,4262,36,52,"PCPC",0
17,"17041",217,150,146,1,4,"PCPC",0
17,"17164",3918,2856,2838,17,18,"PCPC",1
8,"8024",357,282,282,2,0,"PCPC",0
43,"43122",112,91,91,1,0,"PCPC",0
25,"25127",217,145,145,1,0,"PCPC",0
17,"17120",823,560,558,5,2,"PCPC",0
8,"8273",2390,1871,1855,14,16,"PCPC",0
25,"25150",167,132,130,2,2,"PCPC",3
43,"43010",334,262,262,2,0,"PCPC",0
8,"8128",579,428,423,4,5,"PCPC",0
17,"17162",153,106,105,1,1,"PCPC",0
8,"8206",744,604,599,5,5,"PCPC",0
17,"17165",645,502,502,2,0,"PCPC",1
25,"25138",558,427,424,2,3,"PCPC",0
25,"25228",3143,2261,2250,18,11,"PCPC",0
25,"25009",596,448,442,1,6,"PCPC",0
43,"43904",2864,1881,1851,20,30,"PCPC",0
43,"43051",9194,6133,6048,44,85,"PCPC",3
8,"8126",8906,6673,6646,41,27,"PCPC",1
8,"8171",2046,1520,1510,13,10,"PCPC",0
25,"25143",82,63,62,0,1,"PCPC",0
25,"25059",800,546,534,5,12,"PCPC",1
17,"17145",1410,1040,1032,6,8,"PCPC",0
25,"25128",125,85,85,0,0,"PCPC",0
17,"17099",78,55,55,0,0,"PCPC",0
43,"43175",534,363,359,5,4,"PCPC",0
8,"8137",272,208,207,2,1,"PCPC",0
43,"43091",125,90,90,1,0,"PCPC",0
25,"25046",410,331,326,4,5,"PCPC",0
25,"25121",632,380,374,3,6,"PCPC",1
25,"25027",978,695,690,3,5,"PCPC",0
25,"25171",2117,1539,1534,5,5,"PCPC",0
17,"17002",578,477,474,2,3,"PCPC",0
43,"43156",3956,2812,2784,22,28,"PCPC",2
8,"8260",18515,13563,13487,84,76,"PCPC",11
25,"25154",117,86,85,0,1,"PCPC",0
43,"43090",1199,689,686,5,3,"PCPC",0
25,"25207",6443,4525,4492,31,33,"PCPC",0
43,"43081",629,500,499,2,1,"PCPC",0
43,"43176",746,564,561,2,3,"PCPC",0
8,"8289",4473,3379,3371,25,8,"PCPC",1
17,"17209",615,472,471,5,1,"PCPC",0
43,"43018",384,297,297,2,0,"PCPC",0
25,"25902",536,406,403,1,3,"PCPC",0
17,"17007",1763,1367,1359,9,8,"PCPC",0
43,"43101",146,112,112,2,0,"PCPC",0
25,"25215",339,249,249,5,0,"PCPC",0
8,"8042",2390,1772,1764,12,8,"PCPC",0
25,"25176",307,241,238,3,3,"PCPC",0
17,"17093",913,637,634,5,3,"PCPC",2
17,"17010",332,252,251,2,1,"PCPC",1
43,"43044",3962,2751,2719,33,32,"PCPC",1
43,"43902",2751,1794,1776,21,18,"PCPC",1
17,"17228",285,218,217,0,1,"PCPC",0
8,"8021",60,44,44,1,0,"PCPC",0
8,"8033",13262,9887,9833,64,54,"PCPC",5
25,"25189",2181,1468,1461,11,7,"PCPC",4
17,"17110",1332,990,981,3,9,"PCPC",0
17,"17069",359,270,267,2,3,"PCPC",1
25,"25020",270,202,201,2,1,"PCPC",0
17,"17138",836,591,584,7,7,"PCPC",0
8,"8091",5428,4048,4024,20,24,"PCPC",1
17,"17218",576,456,451,3,5,"PCPC",0
8,"8027",724,584,582,1,2,"PCPC",0
25,"25174",390,312,312,1,0,"PCPC",0
8,"8075",4144,2951,2943,20,8,"PCPC",0
8,"8010",4224,3109,3090,22,19,"PCPC",0
25,"25122",1929,1408,1398,21,10,"PCPC",0
43,"43040",325,268,267,1,1,"PCPC",0
25,"25244",374,275,270,1,5,"PCPC",0
25,"25219",146,111,111,1,0,"PCPC",0
25,"25156",765,571,567,3,4,"PCPC",0
8,"8177",36,27,27,1,0,"PCPC",0
43,"43060",2672,2032,2015,7,17,"PCPC",1
8,"8280",93,76,75,1,1,"PCPC",1
25,"25136",95,74,74,2,0,"PCPC",0
25,"25193",768,567,563,4,4,"PCPC",0
17,"17090",539,440,440,2,0,"PCPC",1
8,"8170",442,322,320,0,2,"PCPC",0
8,"8179",636,466,465,2,1,"PCPC",0
8,"8164",936,750,747,6,3,"PCPC",1
43,"43114",370,281,278,1,3,"PCPC",1
43,"43097",407,331,328,4,3,"PCPC",0
17,"17130",325,270,270,1,0,"PCPC",0
8,"8296",1869,1412,1408,10,4,"PCPC",0
43,"43077",453,306,304,1,2,"PCPC",0
25,"25071",41,31,30,0,1,"PCPC",0
17,"17132",1344,1019,1009,12,10,"PCPC",0
8,"8166",964,700,697,7,3,"PCPC",0
8,"8189",119,96,96,1,0,"PCPC",0
43,"43151",107,88,88,0,0,"PCPC",0
25,"25140",779,540,539,2,1,"PCPC",0
8,"8014",2013,1526,1521,4,5,"PCPC",1
17,"17230",504,383,382,3,1,"PCPC",0
43,"43104",1767,1285,1271,4,14,"PCPC",0
43,"43130",169,131,130,2,1,"PCPC",0
17,"17141",6019,3855,3833,43,22,"PCPC",3
43,"43038",22070,15127,15018,113,109,"PCPC",3
25,"25220",991,768,762,1,6,"PCPC",0
17,"17206",158,111,109,0,2,"PCPC",0
43,"43174",144,118,114,0,4,"PCPC",0
25,"25149",1377,1034,1028,9,6,"PCPC",0
8,"8219",15755,12235,12206,72,29,"PCPC",5
17,"17015",12829,9612,9580,51,32,"PCPC",2
17,"17089",5749,3973,3949,17,24,"PCPC",2
43,"43046",88,69,68,1,1,"PCPC",1
17,"17063",179,153,149,0,4,"PCPC",0
25,"25006",319,229,229,2,0,"PCPC",0
8,"8108",5181,3880,3861,30,19,"PCPC",4
25,"25024",352,248,247,0,1,"PCPC",0
25,"25251",708,526,524,1,2,"PCPC",0
8,"8065",1183,920,913,8,7,"PCPC",0
25,"25073",559,377,377,2,0,"PCPC",1
25,"25905",366,281,276,4,5,"PCPC",0
17,"17197",128,97,97,0,0,"PCPC",0
8,"8163",19672,13421,13364,70,57,"PCPC",6
25,"25035",364,257,256,0,1,"PCPC",0
30,"30013",7421,5171,5094,32,77,"PCPE",1
47,"47110",445,335,327,1,8,"PCPE",0
19,"19301",37,26,26,0,0,"PCPE",0
19,"19136",11,10,10,0,0,"PCPE",0
50,"50100",304,215,212,1,3,"PCPE",0
50,"50168",29,20,20,0,0,"PCPE",0
44,"44207",125,98,97,2,1,"PCPE",0
28,"28166",357,281,276,1,5,"PCPE",0
46,"46124",786,638,625,1,13,"PCPE",1
19,"19064",64,56,56,0,0,"PCPE",0
33,"33013",430,294,292,1,2,"PCPE",1
50,"50266",120,77,76,3,1,"PCPE",0
3,"3128",4285,2849,2819,18,30,"PCPE",1
46,"46137",248,201,197,3,4,"PCPE",0
47,"47109",161,120,120,1,0,"PCPE",0
16,"16242",300,245,243,2,2,"PCPE",0
19,"19218",43,31,31,0,0,"PCPE",0
47,"47087",362,272,268,1,4,"PCPE",0
44,"44077",68,52,51,0,1,"PCPE",0
46,"46048",3504,2609,2576,17,33,"PCPE",11
50,"50153",914,683,675,9,8,"PCPE",2
46,"46182",1312,908,904,5,4,"PCPE",1
44,"44082",84,66,66,0,0,"PCPE",0
50,"50119",876,633,625,11,8,"PCPE",1
33,"33016",18848,12845,12737,173,108,"PCPE",17
2,"2003",134196,96374,95521,913,853,"PCPE",96
16,"16250",67,52,52,1,0,"PCPE",0
47,"47178",170,128,124,2,4,"PCPE",0
47,"47138",224,169,166,0,3,"PCPE",0
30,"30036",15432,10030,9879,64,151,"PCPE",8
16,"16111",168,114,111,2,3,"PCPE",1
2,"2055",1055,672,668,2,4,"PCPE",1
19,"19230",558,409,406,1,3,"PCPE",1
16,"16047",214,154,148,3,6,"PCPE",0
45,"45072",653,469,462,1,7,"PCPE",0
46,"46010",943,691,681,7,10,"PCPE",0
47,"47124",383,302,300,3,2,"PCPE",0
3,"3050",19420,13210,13116,70,94,"PCPE",13
22,"22182",227,132,131,3,1,"PCPE",0
16,"16011",20,14,14,0,0,"PCPE",0
45,"45103",363,286,283,0,3,"PCPE",0
46,"46099",744,539,535,2,4,"PCPE",0
50,"50280",290,220,216,1,4,"PCPE",0
22,"22249",125,93,92,1,1,"PCPE",0
3,"3029",236,174,172,2,2,"PCPE",0
22,"22126",89,64,64,0,0,"PCPE",1
46,"46205",14237,10641,10533,77,108,"PCPE",5
46,"46246",1049,808,793,3,15,"PCPE",0
47,"47024",223,170,168,1,2,"PCPE",1
44,"44148",74,56,54,0,2,"PCPE",0
22,"22209",161,121,121,3,0,"PCPE",0
28,"28156",1082,788,784,3,4,"PCPE",0
44,"44054",95,82,81,0,1,"PCPE",0
19,"19190",2284,1632,1613,16,19,"PCPE",0
50,"50107",988,758,755,8,3,"PCPE",0
16,"16018",376,290,290,2,0,"PCPE",0
45,"45169",179,114,111,1,3,"PCPE",0
22,"22212",69,52,52,1,0,"PCPE",0
47,"47039",162,119,117,0,2,"PCPE",1
2,"2901",2196,1441,1419,10,22,"PCPE",3
16,"16271",612,482,481,3,1,"PCPE",0
50,"50271",246,179,173,4,6,"PCPE",0
47,"47185",82,62,61,1,1,"PCPE",0
19,"19076",29,23,23,0,0,"PCPE",0
22,"22135",173,123,121,0,2,"PCPE",0
3,"3010",332,275,268,1,7,"PCPE",0
46,"46122",2726,1957,1934,13,23,"PCPE",0
46,"46054",11389,8266,8190,54,76,"PCPE",9
50,"50075",70,55,55,1,0,"PCPE",0
50,"50238",84,65,65,0,0,"PCPE",0
50,"50170",357,245,242,6,3,"PCPE",0
22,"22188",75,50,50,1,0,"PCPE",0
47,"47182",1328,940,934,8,6,"PCPE",0
47,"47100",118,93,87,2,6,"PCPE",0
50,"50124",394,269,266,0,3,"PCPE",0
47,"47151",26,22,22,0,0,"PCPE",1
16,"16181",54,40,40,0,0,"PCPE",0
47,"47119",89,59,58,2,1,"PCPE",2
46,"46020",3757,2834,2783,16,51,"PCPE",2
45,"45033",297,205,201,1,4,"PCPE",0
2,"2028",111,81,81,0,0,"PCPE",1
16,"16174",166,130,129,2,1,"PCPE",0
45,"45181",2330,1693,1661,10,32,"PCPE",0
16,"16249",1938,1422,1406,6,16,"PCPE",0
45,"45121",7345,4949,4899,24,50,"PCPE",3
50,"50141",104,80,78,0,2,"PCPE",0
47,"47155",3454,2445,2405,26,40,"PCPE",4
39,"39094",840,611,611,2,0,"PCPE",0
19,"19124",378,230,229,2,1,"PCPE",0
16,"16122",244,184,182,1,2,"PCPE",0
44,"44257",149,92,91,0,1,"PCPE",0
50,"50200",479,389,383,5,6,"PCPE",0
16,"16134",4368,3143,3102,22,41,"PCPE",3
44,"44200",39,26,26,0,0,"PCPE",0
50,"50039",462,339,333,1,6,"PCPE",0
2,"2035",1946,1494,1473,5,21,"PCPE",0
19,"19079",7,6,6,0,0,"PCPE",0
50,"50162",135,100,99,3,1,"PCPE",0
44,"44028",171,136,136,0,0,"PCPE",0
44,"44180",74,56,56,0,0,"PCPE",0
45,"45186",2943,2142,2121,12,21,"PCPE",10
50,"50091",39,32,32,0,0,"PCPE",0
22,"22149",301,211,210,1,1,"PCPE",0
19,"19054",161,136,135,3,1,"PCPE",0
46,"46018",562,442,436,2,6,"PCPE",0
22,"22008",144,113,112,2,1,"PCPE",0
19,"19160",883,535,530,11,5,"PCPE",1
2,"2021",1013,806,798,6,8,"PCPE",0
19,"19274",953,693,676,9,17,"PCPE",0
19,"19215",135,109,109,0,0,"PCPE",0
45,"45160",1097,838,824,4,14,"PCPE",0
28,"28121",209,156,152,1,4,"PCPE",0
33,"33001",1475,758,753,15,5,"PCPE",0
44,"44178",52,34,34,0,0,"PCPE",0
50,"50015",81,57,56,0,1,"PCPE",0
16,"16148",544,452,451,2,1,"PCPE",0
44,"44168",181,119,117,1,2,"PCPE",0
16,"16199",27,18,18,0,0,"PCPE",0
28,"28009",14593,11026,10913,73,113,"PCPE",4
45,"45133",2798,1957,1922,11,35,"PCPE",1
30,"30025",5016,3663,3623,22,40,"PCPE",0
50,"50115",3279,2170,2131,27,39,"PCPE",1
46,"46215",1407,1088,1068,10,20,"PCPE",1
50,"50142",23,16,16,1,0,"PCPE",0
19,"19197",28,22,22,1,0,"PCPE",0
46,"46023",322,254,252,1,2,"PCPE",0
45,"45075",120,77,74,0,3,"PCPE",0
28,"28110",2029,1498,1478,9,20,"PCPE",0
28,"28101",226,174,172,1,2,"PCPE",0
33,"33053",1078,602,599,10,3,"PCPE",4
46,"46225",351,267,262,1,5,"PCPE",0
39,"39038",1512,992,983,5,9,"PCPE",2
16,"16064",651,556,550,4,6,"PCPE",1
50,"50089",8616,6420,6364,50,56,"PCPE",2
50,"50048",33,25,25,0,0,"PCPE",0
44,"44051",2579,1924,1901,10,23,"PCPE",1
19,"19150",116,89,89,0,0,"PCPE",0
47,"47172",135,114,113,0,1,"PCPE",0
50,"50128",26,23,23,0,0,"PCPE",0
22,"22111",143,96,95,2,1,"PCPE",0
28,"28015",20885,16237,16104,134,133,"PCPE",4
16,"16084",48,34,30,1,4,"PCPE",0
33,"33041",7101,4564,4513,58,51,"PCPE",3
16,"16012",76,66,66,0,0,"PCPE",0
50,"50241",582,414,406,2,8,"PCPE",0
16,"16902",124,86,86,1,0,"PCPE",0
47,"47025",114,85,85,3,0,"PCPE",0
19,"19121",265,205,204,0,1,"PCPE",1
50,"50165",1768,1255,1222,20,33,"PCPE",1
3,"3098",523,382,378,1,4,"PCPE",1
16,"16276",20,17,17,1,0,"PCPE",0
39,"39057",2366,1636,1607,10,29,"PCPE",1
19,"19238",43,30,28,0,2,"PCPE",0
2,"2014",354,254,252,3,2,"PCPE",0
30,"30042",2218,1645,1625,10,20,"PCPE",0
50,"50044",224,159,159,2,0,"PCPE",2
47,"47171",375,295,290,9,5,"PCPE",1
46,"46157",2959,2145,2126,11,19,"PCPE",2
19,"19171",5380,3964,3919,22,45,"PCPE",1
44,"44084",54,46,46,1,0,"PCPE",0
44,"44190",63,45,45,0,0,"PCPE",0
16,"16067",123,91,90,1,1,"PCPE",0
19,"19142",263,179,179,1,0,"PCPE",0
19,"19334",43,35,35,0,0,"PCPE",0
39,"39101",231,134,132,2,2,"PCPE",0
50,"50284",129,98,98,0,0,"PCPE",0
50,"50078",227,168,166,0,2,"PCPE",0
50,"50297",503800,365284,362768,3385,2516,"PCPE",235
45,"45005",225,170,167,3,3,"PCPE",0
22,"22117",2384,1606,1596,18,10,"PCPE",1
33,"33063",375,269,267,5,2,"PCPE",0
47,"47011",554,466,462,7,4,"PCPE",0
19,"19043",99,80,79,0,1,"PCPE",0
50,"50210",37,26,26,0,0,"PCPE",0
33,"33066",42818,27780,27466,425,314,"PCPE",19
3,"3137",654,449,443,7,6,"PCPE",2
16,"16216",272,207,204,0,3,"PCPE",0
47,"47081",39,32,32,0,0,"PCPE",0
28,"28057",1556,1155,1141,7,14,"PCPE",1
16,"16245",396,304,298,1,6,"PCPE",0
16,"16266",356,269,265,4,4,"PCPE",0
33,"33056",4850,3068,3044,25,24,"PCPE",1
39,"39006",1729,1207,1192,1,15,"PCPE",0
33,"33022",802,460,452,4,8,"PCPE",1
46,"46255",3220,2361,2340,20,21,"PCPE",3
44,"44048",52,47,47,0,0,"PCPE",0
28,"28070",105,80,80,3,0,"PCPE",0
33,"33069",3379,2249,2231,41,18,"PCPE",3
19,"19001",43,32,32,0,0,"PCPE",0
44,"44159",37,27,27,1,0,"PCPE",0
16,"16211",335,228,227,1,1,"PCPE",0
19,"19039",56,48,48,2,0,"PCPE",0
46,"46140",383,321,321,2,0,"PCPE",0
45,"45132",2387,1765,1754,13,11,"PCPE",0
50,"50064",439,348,346,1,2,"PCPE",0
28,"28035",1404,981,966,4,15,"PCPE",1
44,"44171",176,115,115,0,0,"PCPE",0
46,"46259",457,374,371,2,3,"PCPE",0
33,"33057",1525,1005,988,17,17,"PCPE",1
22,"22090",86,61,61,1,0,"PCPE",0
47,"47073",116,80,79,2,1,"PCPE",0
28,"28032",5090,3716,3675,22,41,"PCPE",2
16,"16269",378,287,285,2,2,"PCPE",0
16,"16048",404,300,298,2,2,"PCPE",0
3,"3001",337,260,258,0,2,"PCPE",0
46,"46068",345,283,279,2,4,"PCPE",0
30,"30018",8399,6226,6148,28,78,"PCPE",1
28,"28013",41661,29431,29168,241,263,"PCPE",24
22,"22181",86,55,54,2,1,"PCPE",0
39,"39029",629,476,469,1,7,"PCPE",2
44,"44187",193,147,146,0,1,"PCPE",0
44,"44137",187,139,139,0,0,"PCPE",0
50,"50042",19,17,17,1,0,"PCPE",0
16,"16172",325,233,228,1,5,"PCPE",0
28,"28016",79,55,55,0,0,"PCPE",1
19,"19254",43,34,34,0,0,"PCPE",0
50,"50014",119,81,81,0,0,"PCPE",0
46,"46082",4981,3547,3523,29,24,"PCPE",3
3,"3060",105,78,77,0,1,"PCPE",0
16,"16116",76,59,58,1,1,"PCPE",0
19,"19038",19,16,15,0,1,"PCPE",0
47,"47175",6755,4950,4870,49,80,"PCPE",4
46,"46012",965,689,675,4,14,"PCPE",0
47,"47080",33,25,24,0,1,"PCPE",0
30,"30017",11428,8196,8113,44,83,"PCPE",5
39,"39075",136789,95707,95089,478,618,"PCPE",67
47,"47053",123,101,97,3,4,"PCPE",0
28,"28047",42984,30772,30486,270,286,"PCPE",12
19,"19105",2550,1913,1889,10,24,"PCPE",1
19,"19234",44,30,30,0,0,"PCPE",0
39,"39088",59,40,40,2,0,"PCPE",0
16,"16204",237,179,177,1,2,"PCPE",1
45,"45109",2791,2123,2072,20,51,"PCPE",0
16,"16087",238,184,184,6,0,"PCPE",0
50,"50195",53,42,38,0,4,"PCPE",0
50,"50150",624,387,384,2,3,"PCPE",1
39,"39032",1420,1032,1027,7,5,"PCPE",0
50,"50151",607,450,449,12,1,"PCPE",0
22,"22105",102,65,65,0,0,"PCPE",0
47,"47044",323,273,270,4,3,"PCPE",0
47,"47144",72,54,53,2,1,"PCPE",0
16,"16133",4399,3317,3256,34,61,"PCPE",12
46,"46025",2445,1875,1853,16,22,"PCPE",0
47,"47117",287,199,197,6,2,"PCPE",0
44,"44090",66,49,49,0,0,"PCPE",0
50,"50017",1773,1283,1265,13,18,"PCPE",0
39,"39003",261,189,187,2,2,"PCPE",1
50,"50236",95,77,75,0,2,"PCPE",0
45,"45175",603,476,473,1,3,"PCPE",0
46,"46167",342,240,239,0,1,"PCPE",0
50,"50252",5019,3486,3456,53,30,"PCPE",0
39,"39061",3470,2605,2591,14,14,"PCPE",1
46,"46084",1487,1136,1123,4,13,"PCPE",0
22,"22141",115,94,93,0,1,"PCPE",0
28,"28088",296,196,191,1,5,"PCPE",0
46,"46232",853,661,648,7,13,"PCPE",1
19,"19296",29,24,24,0,0,"PCPE",0
44,"44135",99,73,73,1,0,"PCPE",0
28,"28042",1261,918,908,9,10,"PCPE",0
16,"16908",166,133,132,2,1,"PCPE",0
44,"44100",177,136,135,1,1,"PCPE",0
28,"28097",126,87,87,2,0,"PCPE",0
22,"22002",99,81,81,0,0,"PCPE",0
45,"45026",219,166,164,1,2,"PCPE",0
33,"33050",548,316,314,1,2,"PCPE",0
22,"22250",346,241,241,0,0,"PCPE",0
16,"16255",132,99,99,0,0,"PCPE",0
19,"19233",79,65,65,2,0,"PCPE",0
39,"39062",1864,1395,1376,3,19,"PCPE",3
30,"30010",6852,5161,5106,25,55,"PCPE",2
22,"22215",127,81,81,0,0,"PCPE",1
3,"3033",101,82,78,0,4,"PCPE",0
39,"39073",10260,7537,7482,42,55,"PCPE",6
39,"39053",212,133,133,4,0,"PCPE",1
22,"22102",180,137,136,3,1,"PCPE",0
19,"19309",20,15,14,0,1,"PCPE",0
45,"45172",640,475,462,6,13,"PCPE",1
19,"19157",53,37,37,0,0,"PCPE",0
45,"45173",9756,6811,6720,49,91,"PCPE",3
2,"2061",605,464,458,3,6,"PCPE",1
22,"22139",80,57,57,1,0,"PCPE",0
28,"28040",16741,10717,10604,79,113,"PCPE",14
22,"22909",307,219,217,0,2,"PCPE",0
46,"46184",26514,19610,19399,180,211,"PCPE",22
47,"47161",3970,3111,3089,24,22,"PCPE",2
16,"16050",218,172,169,2,3,"PCPE",0
45,"45188",2770,1925,1886,12,39,"PCPE",0
19,"19264",33,25,25,0,0,"PCPE",0
39,"39060",6704,4959,4887,23,72,"PCPE",5
19,"19200",66,53,52,0,1,"PCPE",0
46,"46050",185,141,141,1,0,"PCPE",0
3,"3034",1404,1028,1010,5,18,"PCPE",1
3,"3056",8588,6219,6135,29,84,"PCPE",1
16,"16236",857,615,608,1,7,"PCPE",0
19,"19331",2677,1892,1841,18,51,"PCPE",1
44,"44179",324,201,201,2,0,"PCPE",0
50,"50249",283,202,200,0,2,"PCPE",0
22,"22222",516,379,377,6,2,"PCPE",0
3,"3123",7579,5491,5416,50,75,"PCPE",3
44,"44234",71,49,49,0,0,"PCPE",0
45,"45036",638,455,449,1,6,"PCPE",0
3,"3053",7568,5551,5468,40,83,"PCPE",4
47,"47048",175,124,122,0,2,"PCPE",0
47,"47193",1625,1251,1236,10,15,"PCPE",1
19,"19017",56,47,47,0,0,"PCPE",0
22,"22233",81,53,53,0,0,"PCPE",0
22,"22003",135,107,107,0,0,"PCPE",0
44,"44266",102,81,79,0,2,"PCPE",0
19,"19005",91,63,62,0,1,"PCPE",0
19,"19172",51,38,38,0,0,"PCPE",0
16,"16065",370,287,287,3,0,"PCPE",0
50,"50005",228,185,184,2,1,"PCPE",0
44,"44245",240,177,174,0,3,"PCPE",0
19,"19146",47,35,35,0,0,"PCPE",0
2,"2066",222,165,163,1,2,"PCPE",0
47,"47174",271,215,213,4,2,"PCPE",0
3,"3006",493,365,360,2,5,"PCPE",1
22,"22016",558,384,382,5,2,"PCPE",0
28,"28068",11740,8615,8543,72,72,"PCPE",6
46,"46073",1066,823,817,11,6,"PCPE",0
22,"22133",108,71,71,3,0,"PCPE",0
3,"3904",1434,1032,1022,8,10,"PCPE",1
19,"19173",47,40,40,0,0,"PCPE",0
22,"22116",1342,915,905,11,10,"PCPE",0
16,"16046",213,142,142,0,0,"PCPE",0
45,"45119",3499,2217,2190,3,27,"PCPE",7
16,"16030",24,18,18,1,0,"PCPE",0
47,"47071",396,321,316,5,5,"PCPE",0
39,"39001",2063,1474,1467,5,7,"PCPE",3
46,"46228",2426,1819,1802,19,17,"PCPE",0
19,"19901",35,27,27,0,0,"PCPE",0
16,"16161",51,44,44,1,0,"PCPE",0
46,"46063",1786,1270,1255,8,15,"PCPE",0
28,"28048",514,386,384,4,2,"PCPE",0
19,"19011",237,165,162,3,3,"PCPE",0
19,"19115",29,23,23,0,0,"PCPE",0
47,"47058",199,126,125,3,1,"PCPE",0
28,"28018",4121,3174,3151,22,23,"PCPE",2
47,"47090",2447,1823,1784,15,39,"PCPE",0
44,"44092",70,53,52,0,1,"PCPE",0
50,"50228",249,207,207,3,0,"PCPE",0
3,"3046",1636,1073,1061,7,12,"PCPE",1
50,"50066",2903,2095,2078,19,17,"PCPE",1
44,"44156",47,31,31,0,0,"PCPE",0
22,"22124",183,119,119,0,0,"PCPE",0
22,"22177",96,69,68,0,1,"PCPE",0
28,"28069",58,44,42,1,2,"PCPE",0
22,"22151",85,60,60,0,0,"PCPE",1
3,"3118",2446,1617,1598,8,19,"PCPE",1
16,"16051",128,96,96,3,0,"PCPE",0
50,"50250",54,44,44,2,0,"PCPE",0
28,"28132",12197,8622,8537,75,85,"PCPE",5
50,"50101",833,557,550,5,7,"PCPE",0
50,"50171",99,69,69,2,0,"PCPE",0
50,"50121",270,209,208,3,1,"PCPE",0
22,"22165",449,305,300,3,5,"PCPE",0
22,"22113",478,335,333,6,2,"PCPE",0
46,"46207",6761,4966,4909,46,57,"PCPE",3
33,"33021",4304,2643,2610,32,33,"PCPE",8
16,"16088",100,86,86,0,0,"PCPE",0
46,"46002",1253,946,940,4,6,"PCPE",5
28,"28038",5213,3801,3753,24,48,"PCPE",3
22,"22213",2918,2084,2062,20,22,"PCPE",0
50,"50011",117,90,89,3,1,"PCPE",0
46,"46146",1647,1241,1229,12,12,"PCPE",0
50,"50058",63,45,43,0,2,"PCPE",0
44,"44026",100,73,72,0,1,"PCPE",0
19,"19181",50,34,34,0,0,"PCPE",0
44,"44002",47,41,41,0,0,"PCPE",0
30,"30023",3874,2831,2788,18,43,"PCPE",0
3,"3100",499,384,378,0,6,"PCPE",0
19,"19306",24,18,18,0,0,"PCPE",0
46,"46058",1734,1245,1230,8,15,"PCPE",1
45,"45041",3967,2723,2689,18,34,"PCPE",5
46,"46035",6828,5155,5089,33,66,"PCPE",2
44,"44086",410,302,298,3,4,"PCPE",0
46,"46005",23129,16610,16437,148,173,"PCPE",16
16,"16142",119,90,90,0,0,"PCPE",0
50,"50279",74,49,49,0,0,"PCPE",0
3,"3031",42046,25035,24819,168,216,"PCPE",26
30,"30028",6390,4054,3973,25,81,"PCPE",1
45,"45042",172,122,121,0,1,"PCPE",0
19,"19327",385,313,308,2,5,"PCPE",0
47,"47141",112,90,89,0,1,"PCPE",0
19,"19103",247,205,202,1,3,"PCPE",0
39,"39017",550,378,372,1,6,"PCPE",0
19,"19042",22,18,17,0,1,"PCPE",0
47,"47183",135,100,100,1,0,"PCPE",0
16,"16049",137,98,98,2,0,"PCPE",0
30,"30024",60389,42200,41831,281,369,"PCPE",17
45,"45068",179,129,127,0,2,"PCPE",0
39,"39092",863,534,533,3,1,"PCPE",0
16,"16275",12,12,12,1,0,"PCPE",0
30,"30002",9701,6794,6717,27,77,"PCPE",2
50,"50291",95,76,76,0,0,"PCPE",0
47,"47164",349,283,281,1,2,"PCPE",0
47,"47132",39,32,32,1,0,"PCPE",0
39,"39040",4271,3103,3080,18,23,"PCPE",0
44,"44050",3113,2173,2154,14,19,"PCPE",1
30,"30033",10377,7330,7215,59,115,"PCPE",6
19,"19058",7458,5705,5663,40,42,"PCPE",3
47,"47157",490,398,397,2,1,"PCPE",0
45,"45074",397,300,293,2,7,"PCPE",1
47,"47147",103,86,82,0,4,"PCPE",0
22,"22080",263,188,184,3,4,"PCPE",0
22,"22037",112,87,87,2,0,"PCPE",0
28,"28011",417,295,292,6,3,"PCPE",0
2,"2068",323,239,239,3,0,"PCPE",0
28,"28093",2177,1681,1658,11,23,"PCPE",1
22,"22020",115,83,80,3,3,"PCPE",0
16,"16158",513,371,366,5,5,"PCPE",0
47,"47181",165,136,135,1,1,"PCPE",0
44,"44045",360,271,271,0,0,"PCPE",0
22,"22084",571,400,391,5,9,"PCPE",1
45,"45193",586,478,469,0,9,"PCPE",1
3,"3134",139,107,107,0,0,"PCPE",0
39,"39047",1998,1408,1392,8,16,"PCPE",1
46,"46243",124,93,90,1,3,"PCPE",0
22,"22053",783,494,492,6,2,"PCPE",1
50,"50159",640,493,486,3,7,"PCPE",0
19,"19279",54,42,42,0,0,"PCPE",0
47,"47192",89,78,76,3,2,"PCPE",0
19,"19156",917,686,679,2,7,"PCPE",1
44,"44143",388,298,298,2,0,"PCPE",2
44,"44181",65,57,57,0,0,"PCPE",0
50,"50098",162,119,118,1,1,"PCPE",0
47,"47009",98,84,84,0,0,"PCPE",0
39,"39004",1479,1050,1031,5,19,"PCPE",0
22,"22051",90,72,72,2,0,"PCPE",0
22,"22107",102,53,53,0,0,"PCPE",0
22,"22045",65,52,52,0,0,"PCPE",0
46,"46213",15499,10610,10482,173,128,"PCPE",4
19,"19268",50,37,35,0,2,"PCPE",0
46,"46139",4520,3486,3457,18,29,"PCPE",1
28,"28074",141137,106626,105602,885,1024,"PCPE",93
46,"46161",1467,1129,1113,5,16,"PCPE",1
19,"19135",90,71,69,1,2,"PCPE",0
33,"33077",1097,688,683,4,5,"PCPE",0
39,"39072",325,184,182,0,2,"PCPE",0
3,"3136",399,302,301,3,1,"PCPE",5
19,"19044",275,186,182,0,4,"PCPE",0
22,"22189",175,142,142,1,0,"PCPE",0
50,"50901",133,96,96,0,0,"PCPE",1
33,"33039",1646,1118,1110,8,8,"PCPE",0
22,"22004",123,83,83,0,0,"PCPE",0
45,"45090",370,262,261,2,1,"PCPE",1
22,"22052",874,660,652,7,8,"PCPE",0
22,"22905",287,217,217,1,0,"PCPE",0
22,"22012",102,75,75,2,0,"PCPE",0
46,"46222",402,329,326,0,3,"PCPE",1
50,"50041",16,10,10,0,0,"PCPE",0
19,"19034",25,22,21,0,1,"PCPE",0
47,"47195",426,314,310,2,4,"PCPE",0
50,"50260",35,31,31,0,0,"PCPE",0
28,"28028",1836,1374,1363,3,11,"PCPE",0
2,"2080",498,358,352,0,6,"PCPE",0
44,"44011",47,34,34,0,0,"PCPE",0
19,"19282",138,107,106,0,1,"PCPE",0
45,"45123",3196,2252,2218,11,34,"PCPE",2
19,"19283",29,26,26,0,0,"PCPE",0
46,"46177",4832,3592,3539,20,53,"PCPE",4
47,"47134",150,120,116,2,4,"PCPE",0
30,"30037",19407,13252,13120,99,132,"PCPE",10
30,"30021",9498,6251,6193,36,58,"PCPE",5
47,"47049",91,58,58,0,0,"PCPE",0
2,"2074",5890,4054,4010,39,44,"PCPE",3
19,"19049",8,8,7,0,1,"PCPE",0
39,"39076",3512,2517,2491,13,26,"PCPE",0
44,"44129",35,29,29,1,0,"PCPE",0
46,"46250",582242,437146,434438,3315,2708,"PCPE",331
19,"19125",45,23,23,0,0,"PCPE",0
44,"44227",72,58,58,0,0,"PCPE",0
39,"39095",2266,1637,1619,8,18,"PCPE",2
3,"3036",82,73,71,1,2,"PCPE",0
16,"16219",81,58,58,0,0,"PCPE",0
28,"28123",62178,49883,49515,397,368,"PCPE",37
47,"47089",133,111,111,2,0,"PCPE",0
44,"44005",48,36,36,0,0,"PCPE",0
44,"44004",379,275,275,2,0,"PCPE",0
3,"3062",228,173,172,3,1,"PCPE",0
45,"45086",483,339,332,0,7,"PCPE",0
39,"39090",773,557,553,2,4,"PCPE",0
47,"47220",151,106,105,1,1,"PCPE",0
46,"46015",7519,5575,5532,34,43,"PCPE",4
50,"50149",34,25,25,0,0,"PCPE",0
19,"19019",14,11,11,1,0,"PCPE",0
46,"46156",2017,1538,1524,9,14,"PCPE",0
47,"47103",252,195,192,1,3,"PCPE",0
19,"19319",4609,3303,3273,22,30,"PCPE",3
28,"28107",442,316,310,5,6,"PCPE",0
50,"50138",45,37,37,3,0,"PCPE",0
50,"50189",678,494,487,6,7,"PCPE",0
19,"19127",88,60,60,1,0,"PCPE",0
2,"2051",1654,1115,1101,13,14,"PCPE",0
39,"39081",440,330,327,1,3,"PCPE",1
45,"45202",3963,2806,2771,10,35,"PCPE",0
19,"19286",772,585,575,3,10,"PCPE",0
19,"19193",22,21,21,1,0,"PCPE",0
47,"47168",30,26,26,1,0,"PCPE",0
28,"28063",252,188,187,1,1,"PCPE",0
45,"45124",2080,1628,1595,15,33,"PCPE",0
3,"3022",140,125,121,1,4,"PCPE",0
39,"39066",866,616,606,6,10,"PCPE",0
3,"3076",8846,6105,6029,40,76,"PCPE",0
33,"33010",1722,1085,1069,15,16,"PCPE",1
45,"45125",2256,1711,1689,16,22,"PCPE",3
2,"2059",320,225,217,0,8,"PCPE",0
50,"50131",212,152,147,4,5,"PCPE",0
47,"47002",18,18,18,0,0,"PCPE",0
19,"19245",1138,798,778,6,20,"PCPE",1
3,"3093",19702,13903,13728,113,175,"PCPE",20
46,"46211",1862,1395,1381,12,14,"PCPE",0
44,"44232",364,255,255,3,0,"PCPE",0
22,"22136",749,524,518,5,6,"PCPE",0
19,"19220",2608,1673,1653,10,20,"PCPE",0
39,"39058",806,556,554,2,2,"PCPE",1
44,"44169",298,216,216,0,0,"PCPE",0
22,"22202",147,128,128,3,0,"PCPE",0
3,"3043",2906,2360,2334,27,26,"PCPE",2
44,"44258",53,46,46,0,0,"PCPE",0
47,"47122",2007,1520,1492,8,28,"PCPE",0
22,"22225",2606,1638,1612,20,26,"PCPE",4
28,"28149",6298,4751,4699,35,52,"PCPE",3
22,"22164",42,28,28,0,0,"PCPE",0
16,"16905",1302,951,934,10,17,"PCPE",0
50,"50257",159,128,125,2,3,"PCPE",0
44,"44118",154,109,106,1,3,"PCPE",0
16,"16107",94,56,56,0,0,"PCPE",0
50,"50207",87,58,58,1,0,"PCPE",0
22,"22110",700,476,473,3,3,"PCPE",1
16,"16083",44,24,24,0,0,"PCPE",0
50,"50088",274,195,191,2,4,"PCPE",0
19,"19323",36,26,26,0,0,"PCPE",0
44,"44110",37,30,30,0,0,"PCPE",0
47,"47106",44,30,30,0,0,"PCPE",0
45,"45901",779,542,534,5,8,"PCPE",0
19,"19227",68,42,41,1,1,"PCPE",0
19,"19167",129,104,103,1,1,"PCPE",1
46,"46091",110,100,100,0,0,"PCPE",0
30,"30005",30268,20979,20778,148,201,"PCPE",10
50,"50187",55,42,42,0,0,"PCPE",0
46,"46216",5277,4146,4111,42,35,"PCPE",0
47,"47113",134,110,110,0,0,"PCPE",1
46,"46173",1309,1029,1010,13,19,"PCPE",0
50,"50045",1217,891,878,10,13,"PCPE",0
47,"47015",177,129,129,0,0,"PCPE",1
50,"50160",2140,1421,1394,14,27,"PCPE",2
16,"16189",264,196,194,4,2,"PCPE",2
39,"39048",1772,1311,1295,8,16,"PCPE",3
22,"22901",714,433,423,6,10,"PCPE",0
16,"16081",50,37,36,0,1,"PCPE",1
19,"19004",59,44,44,0,0,"PCPE",0
46,"46040",993,745,733,3,12,"PCPE",0
3,"3011",8014,5278,5212,50,66,"PCPE",3
22,"22086",194,137,137,1,0,"PCPE",0
50,"50074",6156,4100,4022,33,78,"PCPE",3
50,"50035",74,57,57,0,0,"PCPE",0
16,"16251",1805,1318,1302,9,16,"PCPE",1
47,"47197",875,659,656,9,3,"PCPE",0
33,"33034",9979,5937,5873,64,64,"PCPE",3
46,"46042",3335,2655,2620,12,35,"PCPE",1
47,"47191",111,81,81,0,0,"PCPE",0
50,"50027",223,166,161,2,5,"PCPE",0
3,"3074",1766,1347,1336,4,11,"PCPE",1
2,"2023",504,419,412,0,7,"PCPE",0
39,"39087",41241,29341,29084,152,257,"PCPE",26
47,"47143",104,67,67,0,0,"PCPE",0
3,"3117",377,306,302,2,4,"PCPE",0
3,"3003",449,368,367,1,1,"PCPE",0
19,"19326",2463,1671,1650,13,21,"PCPE",1
2,"2024",3361,2444,2411,24,33,"PCPE",3
50,"50067",13928,9831,9699,92,132,"PCPE",4
46,"46230",14116,10038,9946,63,92,"PCPE",9
44,"44113",74,51,51,0,0,"PCPE",0
16,"16254",199,159,159,0,0,"PCPE",0
22,"22103",664,489,489,4,0,"PCPE",1
22,"22067",70,52,52,0,0,"PCPE",0
2,"2025",7345,5388,5278,51,110,"PCPE",4
30,"30015",19344,13502,13347,107,155,"PCPE",4
16,"16125",1607,1166,1150,11,16,"PCPE",1
45,"45157",2288,1490,1472,5,18,"PCPE",1
47,"47036",204,159,156,1,3,"PCPE",0
47,"47033",205,151,150,2,1,"PCPE",0
45,"45022",395,292,292,2,0,"PCPE",0
19,"19258",84,63,62,0,1,"PCPE",0
47,"47196",29,21,21,0,0,"PCPE",0
3,"3089",9496,6617,6484,51,133,"PCPE",5
47,"47019",92,68,68,1,0,"PCPE",0
22,"22006",268,167,164,4,3,"PCPE",1
50,"50068",1943,1299,1287,10,12,"PCPE",0
46,"46130",862,633,625,6,8,"PCPE",0
44,"44165",168,125,125,2,0,"PCPE",0
16,"16213",34,27,26,0,1,"PCPE",0
46,"46176",2077,1362,1348,14,14,"PCPE",0
3,"3002",3649,2568,2542,11,26,"PCPE",10
16,"16102",1159,815,767,9,48,"PCPE",0
46,"46169",32403,23890,23698,222,192,"PCPE",14
50,"50204",2396,1723,1712,17,11,"PCPE",2
50,"50050",87,62,62,1,0,"PCPE",0
46,"46062",4552,3402,3362,27,40,"PCPE",0
45,"45049",419,303,295,1,8,"PCPE",0
44,"44218",28,24,24,3,0,"PCPE",0
45,"45008",144,112,110,1,2,"PCPE",0
46,"46047",540,428,420,1,8,"PCPE",0
46,"46164",12145,8373,8248,44,125,"PCPE",9
44,"44085",49,29,29,0,0,"PCPE",0
47,"47210",399,278,275,3,3,"PCPE",0
16,"16165",56,45,45,0,0,"PCPE",0
46,"46027",924,746,737,2,9,"PCPE",0
22,"22251",327,259,256,0,3,"PCPE",0
19,"19071",8277,5838,5763,53,75,"PCPE",6
44,"44203",9,9,9,0,0,"PCPE",0
44,"44263",373,267,267,2,0,"PCPE",0
19,"19002",55,45,45,0,0,"PCPE",0
46,"46187",1292,924,920,4,4,"PCPE",0
44,"44230",149,111,110,2,1,"PCPE",0
39,"39035",9142,6574,6517,24,57,"PCPE",5
46,"46142",778,536,524,3,12,"PCPE",0
46,"46096",263,204,202,0,2,"PCPE",0
2,"2040",548,476,474,1,2,"PCPE",1
47,"47208",53,35,35,1,0,"PCPE",0
46,"46208",1071,854,845,2,9,"PCPE",1
19,"19133",78,64,64,2,0,"PCPE",0
44,"44261",713,553,549,3,4,"PCPE",0
50,"50293",392,257,255,2,2,"PCPE",1
50,"50105",277,203,198,4,5,"PCPE",1
22,"22130",10146,6505,6436,57,69,"PCPE",6
19,"19265",134,97,97,5,0,"PCPE",0
44,"44087",67,52,50,0,2,"PCPE",0
45,"45043",776,608,598,3,10,"PCPE",1
45,"45117",718,552,548,0,4,"PCPE",1
44,"44198",182,138,135,0,3,"PCPE",0
3,"3122",43774,30060,29834,230,226,"PCPE",32
45,"45024",1034,742,733,1,9,"PCPE",3
28,"28903",35555,28875,28671,341,204,"PCPE",14
28,"28165",1917,1339,1321,2,18,"PCPE",1
16,"16190",4930,3747,3688,26,59,"PCPE",2
50,"50161",98,75,74,2,1,"PCPE",0
22,"22059",1135,765,752,2,13,"PCPE",1
50,"50270",38,26,25,0,1,"PCPE",0
19,"19057",69,51,51,0,0,"PCPE",0
44,"44173",103,81,79,0,2,"PCPE",0
19,"19259",28,22,22,0,0,"PCPE",0
22,"22089",274,195,193,2,2,"PCPE",0
19,"19299",100,72,71,1,1,"PCPE",0
45,"45070",1412,1158,1136,7,22,"PCPE",3
46,"46060",9278,6796,6724,49,72,"PCPE",4
28,"28130",28569,22050,21799,187,251,"PCPE",24
50,"50038",1404,1024,1007,15,17,"PCPE",1
19,"19050",15,13,13,0,0,"PCPE",0
3,"3037",340,261,255,3,6,"PCPE",1
46,"46007",12333,8890,8803,79,87,"PCPE",7
30,"30901",10556,7862,7775,58,87,"PCPE",7
47,"47214",1349,1036,1019,5,17,"PCPE",0
28,"28075",6020,4521,4469,37,52,"PCPE",0
47,"47086",3818,2835,2784,36,51,"PCPE",2
46,"46144",628,483,478,4,5,"PCPE",0
2,"2032",259,183,178,2,5,"PCPE",0
44,"44177",101,68,68,1,0,"PCPE",0
28,"28183",1162,823,813,9,10,"PCPE",3
28,"28066",7575,5771,5718,58,53,"PCPE",5
22,"22035",225,153,152,1,1,"PCPE",1
16,"16205",106,73,73,1,0,"PCPE",1
3,"3035",627,485,485,2,0,"PCPE",4
45,"45006",1334,866,858,1,8,"PCPE",0
47,"47215",48,43,43,0,0,"PCPE",0
16,"16019",187,141,141,1,0,"PCPE",1
45,"45108",465,343,341,0,2,"PCPE",0
22,"22254",1084,744,735,10,9,"PCPE",0
16,"16217",91,72,72,0,0,"PCPE",0
3,"3020",94,84,84,1,0,"PCPE",0
3,"3073",222,178,178,0,0,"PCPE",0
47,"47085",16330,11556,11419,121,137,"PCPE",6
47,"47206",79,66,66,0,0,"PCPE",0
16,"16149",147,105,105,2,0,"PCPE",0
3,"3106",559,469,465,3,4,"PCPE",1
33,"33043",656,408,401,2,7,"PCPE",0
47,"47061",237,185,184,0,1,"PCPE",0
47,"47111",1001,738,732,5,6,"PCPE",1
50,"50152",1351,942,932,14,10,"PCPE",0
19,"19229",58,53,53,0,0,"PCPE",0
46,"46116",13606,10262,10200,87,62,"PCPE",4
50,"50229",65,46,46,1,0,"PCPE",0
3,"3065",169894,121210,120342,1045,868,"PCPE",95
39,"39012",6772,4807,4755,31,52,"PCPE",1
47,"47057",272,200,199,0,1,"PCPE",0
19,"19269",86,61,61,0,0,"PCPE",0
50,"50099",3036,2137,2113,17,24,"PCPE",0
19,"19148",42,29,28,1,1,"PCPE",0
44,"44151",180,134,134,1,0,"PCPE",1
33,"33031",33775,20484,20184,276,300,"PCPE",29
50,"50178",269,165,163,6,2,"PCPE",0
46,"46101",819,670,663,8,7,"PCPE",1
44,"44121",52,42,42,1,0,"PCPE",0
47,"47123",461,360,358,2,2,"PCPE",0
16,"16099",179,108,105,0,3,"PCPE",0
19,"19212",678,501,491,1,10,"PCPE",0
3,"3069",3329,2102,2077,11,25,"PCPE",1
50,"50126",2240,1528,1509,24,19,"PCPE",0
50,"50276",118,91,91,0,0,"PCPE",1
44,"44122",1277,939,934,5,5,"PCPE",0
19,"19080",67,47,47,0,0,"PCPE",0
2,"2054",375,288,283,0,5,"PCPE",0
50,"50176",220,142,142,3,0,"PCPE",0
30,"30902",8294,5235,5174,29,61,"PCPE",4
28,"28019",1272,926,914,6,12,"PCPE",0
46,"46231",2403,1670,1652,11,18,"PCPE",1
22,"22226",761,537,530,13,7,"PCPE",0
16,"16061",939,746,727,16,19,"PCPE",0
44,"44094",127,103,103,0,0,"PCPE",1
50,"50245",74,51,51,0,0,"PCPE",0
16,"16096",278,219,217,1,2,"PCPE",1
19,"19078",47,37,36,0,1,"PCPE",0
39,"39064",1352,1007,990,3,17,"PCPE",6
50,"50174",80,58,57,0,1,"PCPE",0
47,"47037",161,128,125,1,3,"PCPE",0
50,"50292",130,108,107,0,1,"PCPE",0
45,"45135",4152,3118,3066,21,52,"PCPE",2
45,"45127",775,510,502,1,8,"PCPE",2
46,"46080",979,720,712,2,8,"PCPE",0
50,"50155",95,65,65,0,0,"PCPE",0
46,"46118",3649,2730,2701,20,29,"PCPE",1
47,"47216",111,94,91,0,3,"PCPE",0
39,"39096",669,451,450,1,1,"PCPE",0
50,"50093",87,66,64,1,2,"PCPE",0
50,"50076",70,56,56,0,0,"PCPE",0
3,"3130",28,19,19,0,0,"PCPE",0
45,"45077",546,413,409,0,4,"PCPE",1
28,"28051",1644,1231,1220,9,11,"PCPE",1
46,"46126",5580,4361,4328,36,33,"PCPE",1
22,"22081",247,173,171,3,2,"PCPE",0
2,"2006",573,425,424,1,1,"PCPE",0
16,"16063",112,81,81,1,0,"PCPE",0
44,"44154",240,164,161,1,3,"PCPE",0
28,"28127",66793,53258,53009,458,249,"PCPE",16
50,"50230",1140,771,767,11,4,"PCPE",1
46,"46013",17761,13652,13548,144,104,"PCPE",10
22,"22050",93,77,77,0,0,"PCPE",0
44,"44097",126,76,73,0,3,"PCPE",0
39,"39016",23850,17235,17106,70,129,"PCPE",20
19,"19048",19,14,13,1,1,"PCPE",0
19,"19013",111,89,89,0,0,"PCPE",0
19,"19045",122,97,96,0,1,"PCPE",0
19,"19270",14,13,13,0,0,"PCPE",0
16,"16100",642,518,514,2,4,"PCPE",0
50,"50148",304,213,211,2,2,"PCPE",0
28,"28181",20801,16353,16243,97,110,"PCPE",0
45,"45030",471,346,334,4,12,"PCPE",0
16,"16231",45,38,38,0,0,"PCPE",0
47,"47127",138,89,88,2,1,"PCPE",0
22,"22142",94,72,70,0,2,"PCPE",0
39,"39007",386,265,264,0,1,"PCPE",0
44,"44117",327,258,258,0,0,"PCPE",0
19,"19256",46,36,36,0,0,"PCPE",0
46,"46135",9817,7596,7558,58,38,"PCPE",4
44,"44252",73,56,55,0,1,"PCPE",0
39,"39077",237,151,148,1,3,"PCPE",0
19,"19243",34,32,31,1,1,"PCPE",0
2,"2045",3609,2797,2752,38,45,"PCPE",6
44,"44029",585,454,451,2,3,"PCPE",0
50,"50185",140,93,92,1,1,"PCPE",0
33,"33059",4359,2651,2625,33,26,"PCPE",4
3,"3110",312,258,258,0,0,"PCPE",1
28,"28024",168,137,136,2,1,"PCPE",0
47,"47034",75,58,58,2,0,"PCPE",0
46,"46197",1930,1430,1411,11,19,"PCPE",5
19,"19145",40,32,32,0,0,"PCPE",0
28,"28120",1220,910,897,5,13,"PCPE",1
46,"46083",15372,10939,10815,78,124,"PCPE",4
50,"50191",446,327,326,1,1,"PCPE",0
16,"16146",85,49,49,0,0,"PCPE",0
47,"47096",127,94,93,1,1,"PCPE",0
50,"50282",55,38,38,1,0,"PCPE",0
44,"44243",25,19,19,0,0,"PCPE",0
44,"44215",167,113,113,2,0,"PCPE",0
16,"16279",173,109,108,0,1,"PCPE",0
28,"28025",405,294,291,5,3,"PCPE",0
28,"28056",946,664,660,2,4,"PCPE",2
47,"47065",820,608,602,2,6,"PCPE",0
19,"19051",61,52,52,0,0,"PCPE",0
39,"39019",2232,1628,1603,10,25,"PCPE",1
47,"47162",70,57,57,2,0,"PCPE",0
47,"47152",67,59,59,0,0,"PCPE",0
16,"16143",15,10,10,1,0,"PCPE",0
2,"2011",556,429,427,1,2,"PCPE",0
45,"45010",383,258,257,3,1,"PCPE",0
44,"44101",55,41,40,1,1,"PCPE",0
46,"46061",351,276,272,6,4,"PCPE",0
19,"19018",142,112,112,1,0,"PCPE",0
44,"44217",32,25,25,0,0,"PCPE",0
19,"19147",42,32,32,0,0,"PCPE",0
44,"44065",55,33,32,0,1,"PCPE",0
22,"22230",291,209,207,4,2,"PCPE",0
50,"50021",25,21,21,0,0,"PCPE",0
16,"16034",155,116,113,0,3,"PCPE",0
45,"45180",2850,2044,2023,15,21,"PCPE",3
46,"46199",5878,4217,4182,21,35,"PCPE",3
39,"39015",828,559,556,3,3,"PCPE",0
45,"45053",7820,5814,5712,56,102,"PCPE",1
46,"46194",15852,11124,11009,86,115,"PCPE",10
44,"44042",114,82,81,0,1,"PCPE",0
46,"46220",49112,33766,33424,312,342,"PCPE",48
16,"16188",74,57,57,1,0,"PCPE",0
44,"44038",101,85,83,1,2,"PCPE",0
46,"46245",527,407,404,2,3,"PCPE",0
19,"19189",114,87,84,0,3,"PCPE",0
28,"28058",141836,104142,103011,896,1131,"PCPE",84
46,"46108",420,328,324,1,4,"PCPE",1
39,"39078",1410,1004,997,5,7,"PCPE",2
2,"2046",1125,892,870,12,22,"PCPE",1
33,"33012",5085,3158,3142,27,16,"PCPE",4
47,"47038",100,61,61,0,0,"PCPE",0
44,"44039",204,144,143,1,1,"PCPE",0
46,"46154",795,619,608,5,11,"PCPE",0
50,"50186",37,26,26,1,0,"PCPE",1
16,"16903",992,750,732,8,18,"PCPE",0
22,"22087",60,46,46,0,0,"PCPE",0
22,"22203",77,62,62,2,0,"PCPE",0
39,"39050",260,164,164,1,0,"PCPE",1
45,"45197",1888,1446,1426,5,20,"PCPE",2
16,"16151",61,51,51,1,0,"PCPE",0
50,"50083",81,64,64,2,0,"PCPE",0
44,"44105",68,53,53,0,0,"PCPE",0
2,"2077",52,41,41,0,0,"PCPE",0
19,"19055",44,32,31,2,1,"PCPE",0
50,"50136",532,366,361,3,5,"PCPE",2
47,"47101",1634,1278,1262,7,16,"PCPE",2
3,"3079",18422,13560,13378,152,182,"PCPE",37
16,"16243",376,316,309,4,7,"PCPE",0
50,"50211",236,174,173,0,1,"PCPE",0
46,"46003",948,770,757,8,13,"PCPE",0
46,"46049",268,221,217,2,4,"PCPE",0
16,"16033",1633,1199,1174,8,25,"PCPE",1
19,"19211",350,272,269,0,3,"PCPE",0
3,"3008",158,120,118,1,2,"PCPE",0
16,"16901",624,443,438,5,5,"PCPE",0
44,"44235",87,65,64,1,1,"PCPE",0
50,"50108",50,37,37,0,0,"PCPE",0
44,"44055",75,52,50,0,2,"PCPE",0
19,"19249",29,26,26,0,0,"PCPE",0
16,"16022",76,63,63,0,0,"PCPE",0
28,"28100",4482,3146,3113,21,33,"PCPE",2
45,"45011",279,235,233,4,2,"PCPE",0
45,"45028",3613,2675,2647,22,28,"PCPE",2
39,"39071",410,251,250,1,1,"PCPE",0
44,"44193",73,60,60,1,0,"PCPE",0
45,"45200",4471,3351,3269,25,82,"PCPE",3
46,"46202",17801,13010,12906,87,104,"PCPE",13
47,"47137",29,25,25,0,0,"PCPE",0
16,"16003",134,108,105,0,3,"PCPE",0
16,"16078",41384,28809,28500,322,309,"PCPE",27
45,"45201",3692,2198,2175,15,23,"PCPE",0
44,"44107",212,135,135,0,0,"PCPE",0
46,"46065",1584,1199,1183,11,16,"PCPE",0
44,"44014",2506,1828,1818,8,10,"PCPE",1
16,"16195",458,343,338,0,5,"PCPE",0
50,"50061",190,157,155,2,2,"PCPE",0
19,"19224",106,83,83,1,0,"PCPE",0
44,"44071",585,419,418,6,1,"PCPE",0
19,"19285",20,16,16,0,0,"PCPE",0
3,"3025",1304,944,934,4,10,"PCPE",0
45,"45055",1004,768,755,4,13,"PCPE",0
2,"2030",2949,2158,2122,16,36,"PCPE",1
50,"50059",757,556,551,5,5,"PCPE",0
50,"50094",1500,1041,1022,12,19,"PCPE",1
44,"44099",644,422,421,2,1,"PCPE",0
16,"16029",104,76,74,0,2,"PCPE",0
19,"19216",127,88,88,0,0,"PCPE",0
50,"50214",18,18,14,1,4,"PCPE",0
19,"19255",74,37,37,0,0,"PCPE",0
44,"44034",124,90,90,0,0,"PCPE",0
46,"46196",134,111,110,0,1,"PCPE",1
44,"44035",102,82,80,1,2,"PCPE",0
50,"50190",669,532,518,10,14,"PCPE",0
46,"46143",4274,3027,2995,19,32,"PCPE",5
3,"3055",5265,3741,3697,16,44,"PCPE",2
46,"46067",1753,1356,1341,8,15,"PCPE",1
50,"50180",107,85,85,1,0,"PCPE",0
28,"28106",78872,54111,53443,412,668,"PCPE",38
50,"50052",81,61,61,0,0,"PCPE",0
50,"50298",5439,4053,4007,41,46,"PCPE",4
50,"50183",316,227,223,1,4,"PCPE",0
28,"28095",1719,1236,1226,5,10,"PCPE",1
16,"16119",175,117,115,0,2,"PCPE",0
19,"19060",157,123,122,0,1,"PCPE",0
19,"19246",42,27,27,1,0,"PCPE",0
50,"50132",780,549,538,7,11,"PCPE",0
22,"22044",234,166,164,1,2,"PCPE",2
45,"45205",7438,4772,4701,27,71,"PCPE",1
19,"19196",89,70,67,1,3,"PCPE",0
3,"3903",2612,1838,1814,7,24,"PCPE",1
3,"3084",501,413,413,1,0,"PCPE",0
44,"44076",2089,1577,1565,8,12,"PCPE",0
16,"16157",183,150,148,0,2,"PCPE",0
45,"45058",344,245,236,1,9,"PCPE",1
33,"33075",244,125,122,3,3,"PCPE",0
16,"16007",1153,857,847,3,10,"PCPE",1
33,"33047",1068,771,759,9,12,"PCPE",2
47,"47204",235,159,157,3,2,"PCPE",0
50,"50192",227,182,181,0,1,"PCPE",1
44,"44009",798,593,589,4,4,"PCPE",0
16,"16044",43,29,28,0,1,"PCPE",0
19,"19324",164,122,120,4,2,"PCPE",0
50,"50167",208,166,163,1,3,"PCPE",0
19,"19228",27,17,17,1,0,"PCPE",0
46,"46229",903,715,708,5,7,"PCPE",0
28,"28174",1858,1284,1273,1,11,"PCPE",1
30,"30030",321454,235061,233183,1744,1878,"PCPE",168
19,"19168",265,182,175,4,7,"PCPE",0
28,"28067",4416,3359,3311,18,48,"PCPE",3
50,"50182",3657,2499,2485,23,14,"PCPE",0
39,"39067",753,476,474,1,2,"PCPE",1
28,"28155",487,374,369,0,5,"PCPE",1
30,"30022",17108,11041,10851,100,190,"PCPE",12
44,"44052",75,54,54,0,0,"PCPE",0
39,"39011",1587,1178,1178,6,0,"PCPE",0
44,"44080",281,202,199,0,3,"PCPE",0
22,"22200",239,165,164,2,1,"PCPE",0
3,"3047",9768,6220,6144,41,76,"PCPE",4
50,"50016",44,31,31,0,0,"PCPE",0
46,"46256",7280,4996,4940,32,56,"PCPE",3
47,"47047",199,136,135,4,1,"PCPE",0
45,"45171",1329,958,940,4,18,"PCPE",1
44,"44226",123,85,84,0,1,"PCPE",0
19,"19065",109,86,85,1,1,"PCPE",0
3,"3049",12103,8872,8785,57,87,"PCPE",8
30,"30039",20442,13299,13167,84,132,"PCPE",10
19,"19291",1143,803,794,2,9,"PCPE",0
39,"39059",7518,5327,5287,23,40,"PCPE",6
3,"3059",20710,14788,14685,89,103,"PCPE",11
50,"50194",80,51,51,0,0,"PCPE",0
3,"3088",5895,4030,3961,29,69,"PCPE",8
47,"47112",2561,1960,1933,13,27,"PCPE",0
44,"44260",137,93,93,1,0,"PCPE",0
50,"50118",2101,1484,1477,17,7,"PCPE",0
46,"46071",471,355,349,1,6,"PCPE",0
22,"22214",117,92,89,0,3,"PCPE",0
44,"44199",39,37,37,2,0,"PCPE",0
44,"44142",29,21,21,0,0,"PCPE",0
22,"22137",1009,671,665,1,6,"PCPE",0
50,"50144",31,24,24,0,0,"PCPE",0
50,"50018",883,622,616,5,6,"PCPE",0
45,"45136",5827,3908,3864,22,44,"PCPE",2
46,"46185",361,301,299,5,2,"PCPE",0
3,"3032",97,82,82,0,0,"PCPE",0
50,"50092",290,218,214,0,4,"PCPE",0
45,"45064",3987,2918,2880,33,38,"PCPE",4
45,"45137",1541,1007,998,8,9,"PCPE",0
45,"45101",3671,2842,2808,13,34,"PCPE",3
28,"28010",10649,8167,8098,76,69,"PCPE",2
44,"44046",44,33,33,0,0,"PCPE",0
30,"30011",4702,3390,3324,8,66,"PCPE",1
19,"19129",25,21,21,0,0,"PCPE",0
39,"39008",13900,9814,9734,63,80,"PCPE",12
19,"19008",36,30,30,0,0,"PCPE",0
45,"45004",546,400,398,2,2,"PCPE",0
44,"44220",113,82,82,1,0,"PCPE",0
16,"16071",20,16,16,0,0,"PCPE",0
3,"3058",4976,3733,3669,20,64,"PCPE",1
3,"3071",4000,2858,2813,27,45,"PCPE",2
39,"39014",882,538,536,0,2,"PCPE",0
44,"44013",11232,7872,7801,64,71,"PCPE",8
44,"44115",102,91,91,0,0,"PCPE",1
28,"28116",748,576,569,2,7,"PCPE",0
28,"28082",6110,4622,4581,41,41,"PCPE",2
46,"46141",433,340,337,6,3,"PCPE",0
47,"47082",805,641,630,3,11,"PCPE",0
50,"50147",744,508,506,5,2,"PCPE",2
47,"47051",324,261,258,6,3,"PCPE",0
47,"47031",191,141,140,0,1,"PCPE",0
47,"47115",276,212,211,1,1,"PCPE",0
50,"50020",795,548,545,4,3,"PCPE",0
28,"28083",9836,7278,7206,64,72,"PCPE",7
19,"19139",26,19,19,2,0,"PCPE",0
50,"50069",66,33,33,1,0,"PCPE",0
16,"16259",28,22,22,0,0,"PCPE",0
28,"28117",99,87,86,0,1,"PCPE",1
33,"33025",8956,5493,5453,81,40,"PCPE",4
16,"16129",88,72,72,0,0,"PCPE",0
50,"50028",78,53,53,0,0,"PCPE",0
45,"45105",376,277,268,5,9,"PCPE",1
19,"19307",25,23,23,0,0,"PCPE",0
19,"19003",36,30,30,0,0,"PCPE",0
16,"16247",63,51,50,1,1,"PCPE",0
16,"16005",234,163,160,1,3,"PCPE",0
44,"44146",164,133,133,2,0,"PCPE",0
47,"47084",1077,794,784,11,10,"PCPE",0
46,"46074",2687,2033,2020,18,13,"PCPE",1
16,"16052",539,422,419,3,3,"PCPE",1
22,"22019",176,128,126,1,2,"PCPE",0
2,"2063",1358,987,973,3,14,"PCPE",1
50,"50177",288,196,193,0,3,"PCPE",0
28,"28154",5570,3999,3961,29,38,"PCPE",1
22,"22014",227,164,162,5,2,"PCPE",0
45,"45078",1333,1084,1077,6,7,"PCPE",0
16,"16197",67,44,43,0,1,"PCPE",0
45,"45069",1820,1370,1355,1,15,"PCPE",0
22,"22017",826,613,608,2,5,"PCPE",0
30,"30009",12728,9487,9365,46,122,"PCPE",5
33,"33037",33074,20693,20412,259,281,"PCPE",51
50,"50063",64,49,49,0,0,"PCPE",0
19,"19333",96,68,67,0,1,"PCPE",0
28,"28044",6266,4693,4642,36,51,"PCPE",2
47,"47213",104,78,78,0,0,"PCPE",0
50,"50030",197,124,124,1,0,"PCPE",0
47,"47076",17787,13484,13306,179,178,"PCPE",7
47,"47118",147,97,97,2,0,"PCPE",0
44,"44053",103,87,85,1,2,"PCPE",0
28,"28045",35523,26213,25966,212,247,"PCPE",13
46,"46030",810,641,625,7,16,"PCPE",0
33,"33065",1077,670,657,11,13,"PCPE",0
3,"3009",46125,33613,33319,315,294,"PCPE",37
46,"46235",21229,15171,15011,126,160,"PCPE",9
39,"39009",3325,2306,2293,7,13,"PCPE",0
45,"45107",3463,2621,2585,23,36,"PCPE",2
30,"30020",6503,4521,4484,35,37,"PCPE",2
2,"2065",441,368,361,0,7,"PCPE",0
28,"28087",3301,2539,2519,20,20,"PCPE",0
47,"47045",732,558,549,3,9,"PCPE",1
44,"44267",70,47,46,0,1,"PCPE",0
3,"3066",41762,28723,28388,358,335,"PCPE",31
2,"2033",1864,1352,1315,12,37,"PCPE",0
28,"28901",890,624,618,5,6,"PCPE",0
47,"47121",517,410,398,2,12,"PCPE",0
45,"45035",286,206,204,2,2,"PCPE",1
3,"3095",4807,3453,3410,31,43,"PCPE",7
44,"44027",144,113,113,2,0,"PCPE",0
46,"46008",2617,1954,1931,17,23,"PCPE",2
47,"47225",73,61,59,1,2,"PCPE",0
50,"50248",501,344,328,3,16,"PCPE",0
46,"46097",948,670,663,1,7,"PCPE",1
33,"33027",752,412,405,11,7,"PCPE",0
45,"45019",7560,5216,5135,50,81,"PCPE",13
33,"33076",12115,7519,7456,76,63,"PCPE",3
46,"46214",16637,12113,12014,84,99,"PCPE",7
16,"16135",115,76,76,0,0,"PCPE",1
44,"44064",62,46,46,0,0,"PCPE",0
45,"45073",288,214,210,2,4,"PCPE",0
46,"46237",7172,5199,5146,53,53,"PCPE",2
50,"50275",111,50,50,0,0,"PCPE",0
46,"46168",2004,1463,1447,12,16,"PCPE",0
47,"47184",537,411,402,1,9,"PCPE",0
50,"50201",449,345,344,4,1,"PCPE",0
33,"33030",876,632,630,8,2,"PCPE",0
22,"22902",206,147,144,1,3,"PCPE",1
44,"44268",32,30,30,0,0,"PCPE",0
44,"44209",799,584,573,2,11,"PCPE",0
22,"22047",248,202,201,1,1,"PCPE",1
39,"39068",642,442,438,1,4,"PCPE",0
46,"46902",352,283,283,0,0,"PCPE",0
22,"22015",299,218,215,1,3,"PCPE",0
46,"46192",786,534,519,7,15,"PCPE",0
44,"44150",28,17,17,0,0,"PCPE",0
45,"45111",56,47,47,1,0,"PCPE",0
22,"22057",364,253,248,4,5,"PCPE",0
50,"50001",89,68,68,0,0,"PCPE",0
19,"19009",263,186,184,0,2,"PCPE",0
45,"45112",1844,1121,1086,8,35,"PCPE",2
46,"46238",13117,9172,9088,50,84,"PCPE",10
46,"46056",176,142,142,0,0,"PCPE",0
45,"45002",2619,1676,1663,14,13,"PCPE",2
19,"19241",35,26,25,2,1,"PCPE",0
22,"22114",124,75,72,1,3,"PCPE",0
2,"2069",11401,8055,7975,30,80,"PCPE",5
16,"16176",29,20,20,0,0,"PCPE",0
16,"16175",5071,3807,3732,43,75,"PCPE",0
44,"44114",233,161,159,0,2,"PCPE",0
22,"22068",64,41,41,1,0,"PCPE",1
50,"50125",340,230,229,2,1,"PCPE",0
39,"39030",1874,1199,1187,6,12,"PCPE",0
47,"47099",154,123,118,0,5,"PCPE",0
50,"50117",123,93,93,4,0,"PCPE",1
19,"19047",55,47,47,1,0,"PCPE",0
47,"47188",98,73,70,0,3,"PCPE",0
47,"47092",101,81,79,0,2,"PCPE",0
28,"28175",940,740,730,2,10,"PCPE",1
19,"19010",9,9,9,0,0,"PCPE",0
28,"28061",22757,17091,16965,115,126,"PCPE",7
44,"44106",151,107,106,0,1,"PCPE",0
46,"46186",19689,14688,14576,118,112,"PCPE",9
44,"44153",1733,1131,1125,0,6,"PCPE",0
22,"22193",272,199,194,4,5,"PCPE",0
16,"16177",83,65,65,1,0,"PCPE",0
19,"19117",1632,1187,1167,12,20,"PCPE",0
33,"33033",9381,5848,5770,88,78,"PCPE",21
46,"46103",1354,993,978,8,15,"PCPE",1
47,"47001",52,43,42,1,1,"PCPE",0
3,"3081",1492,1070,1044,12,26,"PCPE",0
33,"33006",1476,862,857,9,5,"PCPE",0
46,"46240",200,167,155,1,12,"PCPE",0
47,"47158",859,618,608,4,10,"PCPE",1
50,"50231",253,199,195,4,4,"PCPE",0
46,"46104",1906,1422,1409,5,13,"PCPE",0
45,"45152",545,402,393,1,9,"PCPE",0
28,"28094",988,711,707,5,4,"PCPE",0
44,"44006",220,152,151,1,1,"PCPE",0
2,"2073",4825,3433,3394,35,39,"PCPE",1
33,"33035",11214,7359,7303,102,56,"PCPE",6
47,"47063",86,68,68,0,0,"PCPE",0
22,"22184",167,132,130,4,2,"PCPE",0
47,"47179",368,256,254,2,2,"PCPE",0
47,"47222",85,70,70,1,0,"PCPE",0
19,"19087",17,16,16,0,0,"PCPE",0
50,"50256",70,43,43,0,0,"PCPE",0
50,"50288",3440,2513,2486,26,27,"PCPE",1
19,"19119",76,65,65,0,0,"PCPE",1
2,"2008",1103,737,722,8,15,"PCPE",0
44,"44007",149,112,111,1,1,"PCPE",0
28,"28159",589,455,447,4,8,"PCPE",0
46,"46120",1179,903,880,5,23,"PCPE",3
47,"47149",46,33,32,1,1,"PCPE",0
47,"47105",169,138,137,2,1,"PCPE",0
50,"50137",958,740,731,8,9,"PCPE",0
44,"44036",22,20,20,0,0,"PCPE",0
22,"22232",88,61,61,2,0,"PCPE",0
19,"19176",227,172,172,0,0,"PCPE",0
28,"28152",16986,13444,13366,111,78,"PCPE",4
19,"19088",91,67,66,0,1,"PCPE",0
30,"30027",50067,36417,36074,242,343,"PCPE",24
2,"2009",19495,13877,13663,134,214,"PCPE",11
45,"45082",1145,904,893,7,11,"PCPE",0
2,"2064",371,288,283,2,5,"PCPE",0
22,"22144",255,192,190,2,2,"PCPE",0
50,"50106",123,78,78,0,0,"PCPE",0
19,"19016",57,40,40,0,0,"PCPE",0
28,"28096",20022,14440,14238,115,202,"PCPE",3
22,"22122",69,52,50,2,2,"PCPE",0
3,"3028",959,780,767,7,13,"PCPE",1
47,"47129",855,660,648,7,12,"PCPE",0
3,"3018",12433,8582,8502,54,80,"PCPE",3
50,"50006",913,670,654,13,16,"PCPE",0
3,"3075",154,117,115,1,2,"PCPE",1
22,"22908",190,135,134,0,1,"PCPE",0
3,"3104",27072,19732,19477,218,255,"PCPE",21
28,"28163",429,332,326,0,6,"PCPE",0
45,"45120",113,86,86,0,0,"PCPE",0
16,"16108",44,35,34,1,1,"PCPE",0
19,"19188",36,31,31,0,0,"PCPE",0
19,"19280",3669,2622,2597,24,25,"PCPE",1
45,"45047",2694,1733,1706,24,27,"PCPE",1
47,"47224",93,75,75,1,0,"PCPE",0
19,"19122",81,62,60,2,2,"PCPE",0
45,"45083",568,433,429,2,4,"PCPE",0
22,"22163",426,338,335,0,3,"PCPE",0
47,"47142",121,85,85,0,0,"PCPE",0
46,"46153",443,353,349,2,4,"PCPE",0
3,"3067",91,78,78,0,0,"PCPE",0
46,"46150",1794,1276,1272,8,4,"PCPE",0
47,"47194",295,228,227,1,1,"PCPE",0
44,"44236",60,38,38,0,0,"PCPE",0
50,"50135",85,59,59,0,0,"PCPE",0
50,"50024",543,400,397,3,3,"PCPE",1
50,"50251",8209,5732,5658,66,74,"PCPE",2
46,"46085",11089,7581,7503,60,78,"PCPE",2
47,"47067",153,112,112,3,0,"PCPE",0
46,"46039",2111,1657,1640,16,17,"PCPE",1
22,"22054",1614,1029,1009,19,20,"PCPE",0
19,"19281",19,18,18,0,0,"PCPE",0
39,"39049",304,198,195,2,3,"PCPE",0
50,"50169",333,231,230,0,1,"PCPE",0
16,"16218",184,134,133,1,1,"PCPE",0
16,"16110",90,70,70,1,0,"PCPE",0
3,"3078",468,340,336,0,4,"PCPE",0
50,"50259",82,55,55,2,0,"PCPE",0
46,"46131",49805,35527,35231,298,296,"PCPE",31
3,"3021",5573,4423,4343,23,80,"PCPE",2
22,"22235",88,69,68,1,1,"PCPE",0
46,"46223",7776,5848,5798,36,50,"PCPE",9
47,"47165",6823,4999,4906,48,93,"PCPE",5
39,"39022",970,673,668,2,5,"PCPE",1
22,"22024",220,159,158,1,1,"PCPE",4
44,"44219",173,118,115,1,3,"PCPE",0
16,"16072",132,84,84,1,0,"PCPE",0
45,"45013",1679,1266,1248,5,18,"PCPE",1
47,"47228",432,324,320,2,4,"PCPE",0
47,"47133",2776,2096,2073,28,23,"PCPE",1
19,"19021",978,678,662,3,16,"PCPE",0
22,"22236",232,190,188,2,2,"PCPE",0
22,"22088",143,98,97,1,1,"PCPE",0
44,"44191",714,509,500,5,9,"PCPE",2
19,"19161",212,158,157,3,1,"PCPE",0
30,"30032",2864,2154,2129,18,25,"PCPE",0
46,"46064",532,395,387,3,8,"PCPE",1
44,"44228",96,75,74,0,1,"PCPE",0
16,"16002",192,160,158,2,2,"PCPE",0
16,"16244",698,598,585,7,13,"PCPE",0
19,"19104",19,15,14,0,1,"PCPE",0
47,"47230",285,209,206,1,3,"PCPE",0
19,"19152",540,377,374,2,3,"PCPE",0
45,"45114",549,400,394,1,6,"PCPE",0
50,"50212",32,26,26,0,0,"PCPE",0
47,"47187",71,49,49,0,0,"PCPE",0
16,"16038",27,20,20,0,0,"PCPE",0
44,"44174",402,289,288,1,1,"PCPE",0
50,"50197",95,69,68,2,1,"PCPE",0
45,"45150",428,322,319,3,3,"PCPE",1
46,"46247",972,649,646,3,3,"PCPE",3
47,"47229",221,150,149,0,1,"PCPE",0
39,"39024",1802,1325,1314,7,11,"PCPE",1
19,"19126",1701,1223,1207,6,16,"PCPE",3
44,"44250",20,15,15,0,0,"PCPE",0
44,"44163",115,79,78,0,1,"PCPE",0
33,"33052",681,418,416,3,2,"PCPE",1
3,"3140",26036,18637,18267,237,370,"PCPE",12
19,"19163",60,49,49,0,0,"PCPE",1
19,"19023",119,87,85,0,2,"PCPE",0
45,"45091",376,270,269,3,1,"PCPE",0
16,"16079",28,16,16,0,0,"PCPE",0
50,"50062",1885,1332,1308,15,24,"PCPE",1
22,"22170",672,460,456,5,4,"PCPE",1
16,"16040",91,76,76,2,0,"PCPE",0
47,"47041",147,105,103,3,2,"PCPE",0
19,"19225",851,618,611,2,7,"PCPE",3
46,"46036",558,339,331,6,8,"PCPE",0
45,"45179",493,362,357,5,5,"PCPE",1
46,"46188",693,565,560,2,5,"PCPE",0
46,"46127",2748,2035,2009,6,26,"PCPE",3
46,"46241",388,288,283,5,5,"PCPE",0
47,"47074",141,110,109,0,1,"PCPE",0
45,"45203",2777,1986,1961,18,25,"PCPE",1
19,"19165",45,39,39,0,0,"PCPE",0
16,"16117",1018,723,715,9,8,"PCPE",1
30,"30043",25449,18839,18477,180,362,"PCPE",26
46,"46253",112,84,84,0,0,"PCPE",0
2,"2052",466,371,370,6,1,"PCPE",0
3,"3902",10640,7024,6952,36,72,"PCPE",3
19,"19322",26,20,19,1,1,"PCPE",0
47,"47200",70,60,60,0,0,"PCPE",0
44,"44223",73,48,48,0,0,"PCPE",0
19,"19143",1781,1278,1266,18,12,"PCPE",0
50,"50140",153,96,95,1,1,"PCPE",0
3,"3083",5479,3736,3674,39,62,"PCPE",6
39,"39027",3045,2231,2199,23,32,"PCPE",1
39,"39046",1342,910,902,3,8,"PCPE",0
46,"46204",6625,4946,4882,52,64,"PCPE",5
45,"45094",365,274,271,3,3,"PCPE",0
19,"19257",3279,2233,2206,21,27,"PCPE",1
46,"46227",893,687,675,6,12,"PCPE",0
46,"46128",1569,1216,1179,7,37,"PCPE",1
16,"16187",55,38,38,3,0,"PCPE",0
30,"30012",9085,6704,6599,46,105,"PCPE",6
28,"28065",131232,100864,99883,846,981,"PCPE",76
46,"46136",2598,1875,1851,14,24,"PCPE",3
19,"19061",56,42,41,0,1,"PCPE",0
50,"50199",318,206,201,1,5,"PCPE",1
28,"28141",6284,4617,4570,42,47,"PCPE",2
44,"44167",34,26,26,0,0,"PCPE",0
44,"44196",121,88,88,0,0,"PCPE",0
50,"50116",169,124,123,0,1,"PCPE",0
28,"28005",136518,101397,100485,871,912,"PCPE",72
28,"28143",77,58,58,0,0,"PCPE",1
45,"45059",1702,1315,1303,1,12,"PCPE",2
45,"45021",2639,1798,1755,22,43,"PCPE",0
44,"44225",105,82,81,2,1,"PCPE",0
2,"2022",341,243,243,2,0,"PCPE",0
33,"33019",2844,1702,1680,11,22,"PCPE",0
45,"45168",62836,46917,46353,424,564,"PCPE",29
3,"3124",459,360,358,0,2,"PCPE",1
28,"28111",629,479,475,2,4,"PCPE",0
45,"45096",987,748,725,9,23,"PCPE",1
16,"16121",227,160,152,0,8,"PCPE",0
16,"16009",54,44,44,2,0,"PCPE",1
28,"28026",6767,5058,5024,27,34,"PCPE",2
16,"16008",80,63,63,1,0,"PCPE",0
46,"46092",262,176,174,2,2,"PCPE",1
16,"16045",180,128,127,0,1,"PCPE",0
45,"45012",623,482,472,0,10,"PCPE",0
3,"3077",1391,1052,1032,10,20,"PCPE",1
16,"16160",58,41,41,1,0,"PCPE",0
16,"16085",131,106,106,0,0,"PCPE",0
46,"46070",17824,12888,12802,106,86,"PCPE",12
16,"16203",10221,6960,6883,42,77,"PCPE",2
50,"50267",565,380,375,4,5,"PCPE",0
16,"16123",66,42,41,0,1,"PCPE",0
3,"3116",1155,819,805,5,14,"PCPE",0
22,"22176",171,140,138,2,2,"PCPE",0
16,"16098",521,418,415,2,3,"PCPE",2
45,"45110",1685,1288,1274,5,14,"PCPE",0
33,"33011",10563,5646,5578,92,68,"PCPE",6
45,"45098",2090,1488,1469,7,19,"PCPE",0
47,"47079",55,44,43,1,1,"PCPE",0
16,"16023",513,367,367,3,0,"PCPE",1
33,"33003",603,322,317,7,5,"PCPE",0
19,"19066",51,42,42,0,0,"PCPE",0
50,"50218",112,88,88,1,0,"PCPE",0
28,"28176",13980,10765,10701,72,64,"PCPE",3
19,"19170",189,115,115,1,0,"PCPE",0
50,"50219",4283,3034,2990,30,44,"PCPE",2
28,"28090",9252,7216,7153,58,63,"PCPE",2
45,"45063",375,268,264,0,4,"PCPE",0
33,"33078",127,81,81,0,0,"PCPE",0
28,"28177",10851,8550,8485,89,65,"PCPE",0
16,"16162",39,31,31,0,0,"PCPE",0
28,"28008",2008,1333,1323,7,10,"PCPE",3
50,"50244",192,131,130,1,1,"PCPE",0
19,"19036",242,202,200,1,2,"PCPE",0
46,"46257",5436,3972,3933,28,39,"PCPE",3
19,"19106",77,57,57,0,0,"PCPE",0
44,"44172",296,216,216,1,0,"PCPE",0
28,"28080",49866,39769,39583,346,186,"PCPE",8
3,"3004",603,425,423,2,2,"PCPE",0
19,"19070",65,45,45,0,0,"PCPE",0
44,"44022",464,330,325,1,5,"PCPE",0
16,"16227",109,78,76,0,2,"PCPE",0
22,"22239",85,67,65,0,2,"PCPE",0
45,"45163",8326,5835,5693,48,142,"PCPE",4
22,"22027",311,210,209,1,1,"PCPE",0
46,"46217",900,672,667,7,5,"PCPE",1
39,"39052",19005,13859,13748,83,111,"PCPE",10
22,"22115",348,263,261,3,2,"PCPE",0
46,"46148",1515,1131,1113,5,18,"PCPE",0
46,"46171",16446,11616,11499,94,117,"PCPE",11
33,"33015",1396,849,842,7,7,"PCPE",2
22,"22217",370,274,269,4,5,"PCPE",0
50,"50220",45,38,38,0,0,"PCPE",0
16,"16091",63,43,42,1,1,"PCPE",0
19,"19107",306,245,244,0,1,"PCPE",0
19,"19232",56,40,40,0,0,"PCPE",0
50,"50120",55,42,42,1,0,"PCPE",0
50,"50043",241,155,154,1,1,"PCPE",0
22,"22049",73,62,62,0,0,"PCPE",0
16,"16274",97,76,75,1,1,"PCPE",0
3,"3091",244,194,193,2,1,"PCPE",0
28,"28179",1451,1043,1033,6,10,"PCPE",1
22,"22069",423,296,294,4,2,"PCPE",0
19,"19108",95,78,78,0,0,"PCPE",0
28,"28072",6176,4716,4673,44,43,"PCPE",2
3,"3120",2433,1688,1652,13,36,"PCPE",1
44,"44116",75,58,58,0,0,"PCPE",0
39,"39063",936,618,616,4,2,"PCPE",0
39,"39091",1881,1297,1291,8,6,"PCPE",4
46,"46180",659,509,500,7,9,"PCPE",0
47,"47221",97,85,84,1,1,"PCPE",0
44,"44240",151,119,117,0,2,"PCPE",0
44,"44204",27,18,18,0,0,"PCPE",0
45,"45129",98,77,77,1,0,"PCPE",0
28,"28118",61,52,50,0,2,"PCPE",0
16,"16093",54,45,45,0,0,"PCPE",0
47,"47052",6781,5213,5156,50,57,"PCPE",1
47,"47211",48,37,37,1,0,"PCPE",0
2,"2007",1017,757,746,5,11,"PCPE",1
50,"50037",125,85,80,0,5,"PCPE",0
22,"22061",6567,4446,4410,48,36,"PCPE",4
50,"50272",13226,9250,9153,97,97,"PCPE",7
50,"50198",47,32,32,0,0,"PCPE",0
28,"28084",16243,11562,11408,90,154,"PCPE",3
33,"33054",1601,1025,1010,17,15,"PCPE",1
50,"50087",28,19,19,0,0,"PCPE",0
30,"30019",25911,17485,17264,157,221,"PCPE",6
47,"47150",253,193,187,3,6,"PCPE",2
22,"22244",42,33,32,1,1,"PCPE",0
16,"16145",413,333,326,6,7,"PCPE",0
33,"33074",3366,2042,2011,35,31,"PCPE",1
22,"22253",56,40,40,1,0,"PCPE",0
28,"28119",2294,1760,1738,12,22,"PCPE",1
22,"22075",116,71,69,1,2,"PCPE",0
16,"16170",646,451,449,5,2,"PCPE",1
19,"19208",39,32,32,0,0,"PCPE",0
16,"16055",669,429,426,0,3,"PCPE",0
16,"16095",82,70,70,1,0,"PCPE",0
46,"46166",8214,6093,6031,38,62,"PCPE",8
39,"39065",222,166,163,0,3,"PCPE",0
22,"22186",189,148,145,3,3,"PCPE",0
50,"50055",3635,2298,2244,36,54,"PCPE",1
46,"46151",757,560,552,2,8,"PCPE",1
50,"50072",183,131,129,0,2,"PCPE",0
46,"46037",1120,891,879,7,12,"PCPE",0
44,"44119",116,80,79,1,1,"PCPE",0
28,"28055",944,636,627,4,9,"PCPE",0
50,"50047",38,24,24,0,0,"PCPE",0
19,"19006",755,506,494,4,12,"PCPE",0
45,"45182",996,760,754,5,6,"PCPE",0
16,"16056",442,275,270,4,5,"PCPE",0
19,"19177",60,45,45,0,0,"PCPE",0
19,"19300",782,591,588,5,3,"PCPE",1
46,"46236",929,723,716,2,7,"PCPE",0
47,"47130",94,64,63,0,1,"PCPE",0
45,"45145",2631,1746,1707,12,39,"PCPE",2
19,"19219",9,8,7,0,1,"PCPE",0
50,"50258",53,25,25,1,0,"PCPE",0
46,"46069",152,112,111,1,1,"PCPE",0
22,"22085",94,78,76,0,2,"PCPE",0
50,"50073",2122,1559,1540,14,19,"PCPE",0
2,"2067",1137,808,794,2,14,"PCPE",1
19,"19134",23,14,14,0,0,"PCPE",0
22,"22064",155,100,100,2,0,"PCPE",0
44,"44056",446,327,325,1,2,"PCPE",0
2,"2034",1323,1024,1018,6,6,"PCPE",3
50,"50227",107,62,62,1,0,"PCPE",0
47,"47027",2799,2059,2025,12,34,"PCPE",1
46,"46191",1956,1439,1414,8,25,"PCPE",0
28,"28089",3856,2866,2829,21,37,"PCPE",0
44,"44120",219,147,145,3,2,"PCPE",0
28,"28902",521,394,389,3,5,"PCPE",0
22,"22150",459,325,321,8,4,"PCPE",0
22,"22036",84,71,71,1,0,"PCPE",0
44,"44047",225,103,103,0,0,"PCPE",0
46,"46115",330,219,213,0,6,"PCPE",0
19,"19114",30,22,21,1,1,"PCPE",0
46,"46032",5719,4297,4262,35,35,"PCPE",5
47,"47226",148,115,115,1,0,"PCPE",0
46,"46017",33041,23469,23277,173,192,"PCPE",13
39,"39097",666,342,335,2,7,"PCPE",0
45,"45037",1520,1072,1055,5,17,"PCPE",0
2,"2002",427,340,337,2,3,"PCPE",0
46,"46078",28484,19694,19520,173,174,"PCPE",28
30,"30031",497,387,382,1,5,"PCPE",0
46,"46109",6248,4516,4440,37,76,"PCPE",6
19,"19250",16,12,12,0,0,"PCPE",0
47,"47018",36,31,31,0,0,"PCPE",0
45,"45148",263,184,184,0,0,"PCPE",0
47,"47028",30,17,17,0,0,"PCPE",0
45,"45185",7573,5422,5320,31,102,"PCPE",5
45,"45001",1846,1213,1181,10,32,"PCPE",1
33,"33060",13991,8629,8481,109,148,"PCPE",18
50,"50026",418,292,288,4,4,"PCPE",0
3,"3070",2115,1399,1376,9,23,"PCPE",0
28,"28124",73,51,50,0,1,"PCPE",0
46,"46079",314,244,240,0,4,"PCPE",0
28,"28050",4406,3202,3167,29,35,"PCPE",3
46,"46193",8959,6880,6824,66,56,"PCPE",6
47,"47091",76,60,59,2,1,"PCPE",1
19,"19294",26,18,18,0,0,"PCPE",0
46,"46087",109,94,94,2,0,"PCPE",0
16,"16115",49,32,32,0,0,"PCPE",0
28,"28031",2129,1501,1486,8,15,"PCPE",0
33,"33062",385,194,187,4,7,"PCPE",0
50,"50085",182,121,121,0,0,"PCPE",0
50,"50003",117,89,89,1,0,"PCPE",0
16,"16074",30,25,25,0,0,"PCPE",0
47,"47167",245,198,198,1,0,"PCPE",0
46,"46224",156,125,124,0,1,"PCPE",0
44,"44144",319,225,223,0,2,"PCPE",0
50,"50102",815,594,584,7,10,"PCPE",0
22,"22195",238,190,186,0,4,"PCPE",0
28,"28158",694,501,495,2,6,"PCPE",0
2,"2038",262,197,193,0,4,"PCPE",0
50,"50164",381,245,243,3,2,"PCPE",0
50,"50111",181,130,130,1,0,"PCPE",0
45,"45016",4486,3288,3251,19,37,"PCPE",0
50,"50287",253,189,188,11,1,"PCPE",0
28,"28001",70,48,47,1,1,"PCPE",0
22,"22157",181,122,121,2,1,"PCPE",0
45,"45151",544,413,409,0,4,"PCPE",0
16,"16141",131,98,96,1,2,"PCPE",0
19,"19118",11,10,9,0,1,"PCPE",0
46,"46218",1043,842,829,6,13,"PCPE",0
47,"47093",795,585,573,7,12,"PCPE",0
50,"50130",354,225,222,1,3,"PCPE",0
47,"47032",147,102,102,0,0,"PCPE",0
44,"44061",77,60,58,1,2,"PCPE",0
19,"19086",1371,1003,996,9,7,"PCPE",1
47,"47094",120,100,100,0,0,"PCPE",0
22,"22042",116,91,89,1,2,"PCPE",0
46,"46195",2000,1540,1532,3,8,"PCPE",1
45,"45140",1075,788,772,10,16,"PCPE",2
30,"30026",16345,10049,9914,84,135,"PCPE",3
47,"47062",155,128,128,0,0,"PCPE",0
28,"28053",6956,5475,5414,44,61,"PCPE",0
50,"50206",457,349,345,5,4,"PCPE",0
33,"33045",4359,2819,2787,32,32,"PCPE",2
16,"16130",533,407,404,0,3,"PCPE",0
50,"50263",171,110,108,1,2,"PCPE",1
19,"19277",15,10,10,0,0,"PCPE",0
44,"44126",314,222,221,0,1,"PCPE",0
28,"28128",453,334,331,1,3,"PCPE",0
47,"47160",395,296,294,3,2,"PCPE",0
16,"16094",121,86,84,0,2,"PCPE",0
19,"19226",37,22,22,0,0,"PCPE",0
19,"19027",129,97,95,1,2,"PCPE",0
50,"50123",430,304,297,3,7,"PCPE",0
16,"16132",33,25,25,1,0,"PCPE",0
19,"19237",39,34,34,0,0,"PCPE",0
16,"16278",61,45,45,0,0,"PCPE",0
44,"44185",88,69,69,2,0,"PCPE",0
16,"16106",2701,2029,2001,6,28,"PCPE",0
22,"22083",447,360,355,6,5,"PCPE",0
39,"39018",4284,3211,3177,22,34,"PCPE",5
3,"3133",41333,24527,24340,146,187,"PCPE",37
22,"22131",84,62,58,5,4,"PCPE",0
45,"45131",259,219,216,1,3,"PCPE",0
19,"19132",86,65,63,0,2,"PCPE",0
28,"28109",1651,1131,1116,8,15,"PCPE",1
46,"46045",1245,984,961,3,23,"PCPE",2
46,"46022",15392,10624,10546,69,78,"PCPE",15
44,"44256",36,30,30,2,0,"PCPE",0
50,"50290",360,260,255,5,5,"PCPE",0
22,"22162",125,94,94,0,0,"PCPE",0
39,"39028",3892,2905,2878,20,27,"PCPE",1
45,"45009",455,277,274,2,3,"PCPE",0
16,"16147",54,34,33,0,1,"PCPE",0
2,"2076",313,233,230,2,3,"PCPE",0
16,"16031",35,26,26,0,0,"PCPE",0
47,"47035",901,659,653,4,6,"PCPE",0
47,"47005",506,358,348,3,10,"PCPE",0
50,"50208",1761,1267,1250,16,17,"PCPE",1
22,"22174",462,352,350,0,2,"PCPE",0
16,"16032",284,220,220,1,0,"PCPE",1
16,"16280",163,122,119,2,3,"PCPE",0
22,"22099",490,349,343,2,6,"PCPE",0
44,"44111",78,61,61,0,0,"PCPE",1
44,"44157",61,37,37,0,0,"PCPE",0
19,"19032",145,94,93,2,1,"PCPE",0
50,"50184",87,70,70,0,0,"PCPE",0
28,"28164",3230,2371,2345,28,26,"PCPE",2
47,"47163",277,208,205,3,3,"PCPE",0
16,"16070",29,27,27,0,0,"PCPE",0
33,"33068",1031,518,510,5,8,"PCPE",0
16,"16239",118,88,87,0,1,"PCPE",0
19,"19053",1906,1323,1304,12,19,"PCPE",0
19,"19123",37,30,28,0,2,"PCPE",0
28,"28133",6146,4245,4180,25,65,"PCPE",4
28,"28027",1215,836,826,8,10,"PCPE",0
22,"22125",39530,27358,27075,344,283,"PCPE",17
50,"50143",541,373,367,2,6,"PCPE",0
19,"19178",27,17,16,0,1,"PCPE",0
46,"46138",361,289,287,1,2,"PCPE",0
19,"19169",30,27,27,0,0,"PCPE",0
47,"47068",29,21,21,0,0,"PCPE",0
28,"28145",2671,1927,1895,21,32,"PCPE",2
46,"46123",1926,1392,1368,11,24,"PCPE",1
33,"33040",4556,2837,2784,58,53,"PCPE",3
30,"30006",833,699,695,1,4,"PCPE",1
16,"16191",850,664,653,11,11,"PCPE",0
44,"44103",122,96,96,3,0,"PCPE",0
28,"28079",2384271,1765443,1753633,13854,11810,"PCPE",971
45,"45099",3700,2524,2501,9,23,"PCPE",4
39,"39031",1237,870,865,1,5,"PCPE",0
47,"47227",53,36,35,0,1,"PCPE",0
16,"16035",224,177,174,2,3,"PCPE",0
28,"28134",63936,48022,47631,421,391,"PCPE",44
2,"2047",110,83,81,0,2,"PCPE",0
45,"45088",2366,1526,1501,8,25,"PCPE",5
3,"3107",2785,1766,1746,13,20,"PCPE",2
45,"45014",4039,2606,2552,35,54,"PCPE",1
47,"47008",22,13,13,0,0,"PCPE",0
44,"44068",634,497,493,2,4,"PCPE",0
50,"50034",767,516,511,10,5,"PCPE",0
28,"28029",576,443,443,4,0,"PCPE",0
2,"2048",1173,912,901,9,11,"PCPE",0
46,"46132",2176,1725,1708,5,17,"PCPE",0
19,"19182",37,32,32,0,0,"PCPE",0
28,"28147",991,702,698,4,4,"PCPE",0
50,"50010",67,52,52,1,0,"PCPE",1
46,"46019",8932,6721,6647,40,74,"PCPE",1
46,"46179",2136,1624,1596,17,28,"PCPE",1
19,"19183",70,59,58,0,1,"PCPE",0
2,"2082",98,80,80,0,0,"PCPE",0
19,"19305",139,104,103,1,1,"PCPE",1
50,"50154",114,92,92,1,0,"PCPE",0
45,"45066",7815,5540,5447,25,93,"PCPE",0
45,"45003",554,398,393,2,5,"PCPE",1
44,"44229",141,99,98,1,1,"PCPE",0
19,"19252",56,44,44,0,0,"PCPE",0
3,"3080",1330,1040,1032,4,8,"PCPE",0
44,"44041",60,48,48,0,0,"PCPE",0
44,"44070",55,49,49,0,0,"PCPE",0
3,"3061",1060,793,787,5,6,"PCPE",0
45,"45102",3613,2495,2464,27,31,"PCPE",5
16,"16089",381,292,289,8,3,"PCPE",1
47,"47126",42,35,35,1,0,"PCPE",0
22,"22129",162,110,110,0,0,"PCPE",1
45,"45054",3798,2612,2587,10,25,"PCPE",1
2,"2083",209,181,181,0,0,"PCPE",1
16,"16153",924,751,741,4,10,"PCPE",0
22,"22206",179,138,137,0,1,"PCPE",0
47,"47042",51,39,39,0,0,"PCPE",0
50,"50113",587,471,461,2,10,"PCPE",0
16,"16906",70,44,44,1,0,"PCPE",0
50,"50070",50,30,29,0,1,"PCPE",0
3,"3082",12941,8399,8304,51,95,"PCPE",4
50,"50012",94,76,72,0,4,"PCPE",1
47,"47159",825,672,661,0,11,"PCPE",0
47,"47022",59,52,48,1,4,"PCPE",0
16,"16104",53,42,42,0,0,"PCPE",0
50,"50264",151,111,110,0,1,"PCPE",2
46,"46158",1047,771,763,7,8,"PCPE",0
22,"22028",358,237,233,1,4,"PCPE",0
45,"45093",147,115,114,0,1,"PCPE",0
46,"46260",2685,2072,2053,14,19,"PCPE",1
16,"16196",589,490,476,3,14,"PCPE",0
2,"2029",3333,2363,2320,13,43,"PCPE",3
44,"44195",82,58,57,0,1,"PCPE",0
44,"44075",321,255,252,1,3,"PCPE",0
22,"22243",43,32,31,0,1,"PCPE",0
16,"16156",84,64,64,0,0,"PCPE",0
50,"50139",318,237,237,1,0,"PCPE",0
28,"28182",203,167,163,1,4,"PCPE",0
47,"47180",57,41,41,1,0,"PCPE",0
50,"50289",53,42,42,1,0,"PCPE",0
28,"28004",6618,4502,4457,28,45,"PCPE",2
33,"33009",878,545,542,4,3,"PCPE",1
19,"19287",134,100,98,2,2,"PCPE",0
47,"47203",54,40,40,0,0,"PCPE",0
45,"45204",630,453,449,1,4,"PCPE",0
16,"16082",272,194,192,1,2,"PCPE",0
46,"46090",1631,1360,1339,6,21,"PCPE",1
45,"45130",294,222,222,1,0,"PCPE",0
19,"19041",163,118,117,1,1,"PCPE",0
19,"19266",229,184,182,1,2,"PCPE",0
46,"46075",144,125,122,2,3,"PCPE",0
46,"46189",469,374,367,2,7,"PCPE",0
44,"44089",49,41,41,0,0,"PCPE",0
46,"46098",2405,1778,1751,7,27,"PCPE",0
33,"33028",1143,519,518,7,1,"PCPE",0
2,"2053",2888,2086,2042,14,44,"PCPE",3
46,"46113",2558,1791,1773,7,18,"PCPE",1
2,"2010",1784,1374,1349,12,25,"PCPE",0
22,"22063",161,128,126,0,2,"PCPE",0
22,"22096",332,248,241,10,7,"PCPE",0
19,"19247",140,103,102,1,1,"PCPE",1
28,"28173",523,384,381,1,3,"PCPE",0
19,"19289",23,16,16,0,0,"PCPE",0
50,"50023",199,145,143,2,2,"PCPE",0
46,"46114",552,417,412,6,5,"PCPE",0
16,"16171",1728,1334,1313,10,21,"PCPE",0
45,"45144",736,562,557,1,5,"PCPE",0
3,"3048",4993,3549,3502,13,47,"PCPE",2
46,"46031",10574,7233,7158,58,75,"PCPE",7
19,"19089",23,17,17,0,0,"PCPE",0
44,"44018",16,16,16,0,0,"PCPE",0
2,"2044",1040,665,656,5,9,"PCPE",0
47,"47078",157,114,107,0,7,"PCPE",0
45,"45023",2300,1700,1685,19,15,"PCPE",1
28,"28112",160,129,129,0,0,"PCPE",0
50,"50065",56,37,37,0,0,"PCPE",0
46,"46206",555,417,408,0,9,"PCPE",0
47,"47173",879,627,622,9,5,"PCPE",0
30,"30038",15752,10987,10904,39,83,"PCPE",2
22,"22247",28,18,18,0,0,"PCPE",0
3,"3086",169,140,140,2,0,"PCPE",0
28,"28007",127491,96937,96102,810,835,"PCPE",64
44,"44020",22,21,21,0,0,"PCPE",0
50,"50090",134,96,96,0,0,"PCPE",0
39,"39039",540,355,355,1,0,"PCPE",0
50,"50243",307,227,224,2,3,"PCPE",0
33,"33002",9403,5920,5839,69,81,"PCPE",52
16,"16086",872,699,690,7,9,"PCPE",2
19,"19290",851,551,550,4,1,"PCPE",0
19,"19199",19,15,15,0,0,"PCPE",0
44,"44246",1599,1012,1001,11,11,"PCPE",1
3,"3012",1138,863,846,4,17,"PCPE",1
45,"45062",1075,816,808,11,8,"PCPE",0
19,"19179",74,64,64,3,0,"PCPE",0
16,"16253",308,230,228,2,2,"PCPE",0
50,"50025",4541,3110,3083,39,27,"PCPE",3
47,"47007",4051,2987,2954,27,33,"PCPE",2
47,"47154",146,115,111,6,4,"PCPE",1
47,"47017",190,146,146,0,0,"PCPE",0
19,"19092",395,286,279,2,7,"PCPE",0
22,"22039",813,635,634,4,1,"PCPE",0
46,"46162",1168,839,832,3,7,"PCPE",1
19,"19231",10,6,6,0,0,"PCPE",0
45,"45025",1218,849,844,9,5,"PCPE",0
30,"30040",686,564,560,1,4,"PCPE",1
47,"47145",583,430,426,6,4,"PCPE",0
28,"28146",1806,1232,1218,3,14,"PCPE",0
39,"39070",126,91,89,0,2,"PCPE",0
45,"45027",315,249,246,2,3,"PCPE",0
19,"19067",68,46,44,0,2,"PCPE",0
16,"16024",121,85,84,0,1,"PCPE",0
44,"44160",438,287,285,4,2,"PCPE",0
50,"50294",65,45,45,0,0,"PCPE",0
19,"19037",131,109,108,0,1,"PCPE",0
22,"22228",532,371,364,4,7,"PCPE",0
50,"50286",75,54,53,0,1,"PCPE",0
16,"16152",32,26,26,3,0,"PCPE",0
44,"44032",17,13,13,0,0,"PCPE",0
22,"22168",22,20,19,0,1,"PCPE",0
28,"28104",15528,12342,12234,103,108,"PCPE",6
22,"22156",289,216,213,1,3,"PCPE",0
28,"28136",693,538,533,2,5,"PCPE",0
50,"50278",175,133,131,2,2,"PCPE",0
3,"3005",7937,5907,5869,40,38,"PCPE",5
39,"39005",1419,1039,1030,9,9,"PCPE",0
50,"50196",101,73,73,0,0,"PCPE",0
2,"2027",274,209,203,1,6,"PCPE",1
45,"45089",1432,1076,1064,10,12,"PCPE",2
28,"28169",1577,1214,1209,7,5,"PCPE",0
44,"44133",15,12,12,0,0,"PCPE",0
19,"19318",26,18,18,0,0,"PCPE",0
30,"30001",4507,3357,3331,17,26,"PCPE",0
44,"44124",71,57,57,0,0,"PCPE",0
16,"16128",50,38,38,0,0,"PCPE",0
19,"19330",69,62,62,0,0,"PCPE",0
19,"19202",16,13,13,1,0,"PCPE",0
16,"16026",91,69,68,0,1,"PCPE",0
39,"39100",849,567,565,5,2,"PCPE",0
16,"16014",558,419,417,6,2,"PCPE",0
46,"46149",350,252,249,3,3,"PCPE",0
45,"45029",186,154,154,2,0,"PCPE",0
39,"39034",255,133,128,2,5,"PCPE",0
22,"22060",1167,817,808,14,9,"PCPE",0
50,"50104",320,251,251,1,0,"PCPE",1
46,"46233",3766,2688,2650,14,38,"PCPE",1
47,"47116",396,304,302,2,2,"PCPE",0
16,"16167",288,225,217,0,8,"PCPE",0
46,"46165",7349,5460,5412,39,48,"PCPE",5
22,"22218",39,34,34,0,0,"PCPE",0
33,"33007",1382,804,795,4,9,"PCPE",0
22,"22072",197,127,126,1,1,"PCPE",0
19,"19059",73,47,47,0,0,"PCPE",0
19,"19321",34,28,28,0,0,"PCPE",0
19,"19175",29,18,17,1,1,"PCPE",0
45,"45141",848,626,615,0,11,"PCPE",0
46,"46029",20448,14673,14556,99,117,"PCPE",6
44,"44025",5804,4024,3991,11,33,"PCPE",3
19,"19099",286,179,175,1,4,"PCPE",0
50,"50114",132,108,108,0,0,"PCPE",0
22,"22074",303,209,208,5,1,"PCPE",1
47,"47170",43,36,30,0,6,"PCPE",0
28,"28034",368,258,255,0,3,"PCPE",0
46,"46121",106,91,90,1,1,"PCPE",0
22,"22109",261,184,183,1,1,"PCPE",0
45,"45106",7418,5380,5306,34,74,"PCPE",6
45,"45142",7792,5717,5624,62,93,"PCPE",3
46,"46261",1708,1259,1237,12,22,"PCPE",3
44,"44205",619,420,415,5,5,"PCPE",3
19,"19031",8,8,8,0,0,"PCPE",0
3,"3113",4339,2978,2935,23,43,"PCPE",1
16,"16006",113,100,100,1,0,"PCPE",0
46,"46159",23038,16719,16596,127,123,"PCPE",20
22,"22173",219,147,141,3,6,"PCPE",0
22,"22001",212,147,146,0,1,"PCPE",0
45,"45095",663,496,492,2,4,"PCPE",0
46,"46212",1620,1130,1112,12,18,"PCPE",0
47,"47014",48,39,39,1,0,"PCPE",0
22,"22245",303,222,213,3,9,"PCPE",0
30,"30004",1129,838,833,1,5,"PCPE",1
28,"28131",13510,9647,9544,89,103,"PCPE",7
50,"50133",98,76,76,0,0,"PCPE",0
50,"50274",64,46,43,1,3,"PCPE",0
46,"46076",610,500,494,1,6,"PCPE",0
46,"46129",511,389,379,9,10,"PCPE",1
39,"39010",610,457,453,1,4,"PCPE",0
44,"44037",447,288,288,1,0,"PCPE",1
46,"46152",90,63,63,0,0,"PCPE",0
19,"19090",90,69,68,1,1,"PCPE",0
30,"30029",12122,8231,8125,54,106,"PCPE",3
46,"46160",1922,1395,1381,4,14,"PCPE",3
46,"46053",525,433,428,2,5,"PCPE",0
3,"3085",271,229,227,5,2,"PCPE",0
19,"19310",7,7,7,0,0,"PCPE",0
16,"16238",461,380,378,1,2,"PCPE",0
47,"47088",101,79,79,0,0,"PCPE",0
44,"44001",65,43,43,1,0,"PCPE",0
3,"3068",41,38,37,0,1,"PCPE",0
28,"28017",1280,975,963,10,12,"PCPE",1
46,"46009",3144,2473,2449,22,24,"PCPE",2
3,"3039",89,65,65,0,0,"PCPE",0
44,"44149",99,74,73,4,1,"PCPE",0
46,"46100",281,190,187,1,3,"PCPE",0
16,"16057",62,45,45,0,0,"PCPE",0
33,"33058",1668,1050,1035,13,15,"PCPE",6
47,"47131",167,122,120,2,2,"PCPE",0
44,"44208",27,17,17,0,0,"PCPE",0
22,"22066",755,529,520,8,9,"PCPE",1
19,"19325",154,86,86,1,0,"PCPE",0
46,"46088",152,114,110,1,4,"PCPE",0
30,"30016",153034,101232,100202,776,1030,"PCPE",74
16,"16150",98,66,66,2,0,"PCPE",0
19,"19302",52,42,42,1,0,"PCPE",0
2,"2013",125,90,88,0,2,"PCPE",0
19,"19240",49,36,36,0,0,"PCPE",0
19,"19303",41,32,32,0,0,"PCPE",0
50,"50033",61,44,44,1,0,"PCPE",0
47,"47207",256,198,195,3,3,"PCPE",0
28,"28113",36951,27912,27604,241,308,"PCPE",10
16,"16058",94,71,71,1,0,"PCPE",0
44,"44021",104,77,77,1,0,"PCPE",1
16,"16137",37,27,25,0,2,"PCPE",0
16,"16224",72,60,58,0,2,"PCPE",0
46,"46033",196,155,153,0,2,"PCPE",0
46,"46147",17186,11507,11399,72,108,"PCPE",12
2,"2036",93,66,66,0,0,"PCPE",0
44,"44003",17,15,15,0,0,"PCPE",0
46,"46903",6306,4762,4743,44,19,"PCPE",3
50,"50285",657,448,442,4,6,"PCPE",0
28,"28157",690,471,467,1,4,"PCPE",2
22,"22079",118,85,84,1,1,"PCPE",0
46,"46041",313,229,228,1,1,"PCPE",7
22,"22190",123,77,77,1,0,"PCPE",0
19,"19081",27,21,21,0,0,"PCPE",0
47,"47156",150,117,117,0,0,"PCPE",0
46,"46133",462,359,352,1,7,"PCPE",1
47,"47030",935,680,669,5,11,"PCPE",0
28,"28126",50,36,36,0,0,"PCPE",1
33,"33070",3267,2211,2185,27,26,"PCPE",2
16,"16062",25,20,20,0,0,"PCPE",0
44,"44210",750,577,572,2,5,"PCPE",1
45,"45162",630,448,438,1,10,"PCPE",0
44,"44023",18,15,14,0,1,"PCPE",0
44,"44249",40,30,30,0,0,"PCPE",0
46,"46904",812,615,605,2,10,"PCPE",0
45,"45113",1770,1189,1171,5,18,"PCPE",1
44,"44132",54,49,49,0,0,"PCPE",0
50,"50262",1161,849,832,11,17,"PCPE",1
45,"45192",2380,1890,1854,8,36,"PCPE",0
22,"22106",20,13,13,2,0,"PCPE",0
45,"45065",264,211,206,1,5,"PCPE",1
22,"22128",188,145,143,3,2,"PCPE",0
39,"39080",3477,2404,2388,4,16,"PCPE",0
19,"19082",100,72,71,1,1,"PCPE",1
44,"44033",243,165,165,3,0,"PCPE",0
44,"44211",33,22,22,0,0,"PCPE",0
2,"2050",85,66,66,1,0,"PCPE",0
50,"50036",100,76,76,1,0,"PCPE",0
44,"44125",63,41,41,0,0,"PCPE",0
2,"2017",760,498,493,1,5,"PCPE",1
44,"44096",155,115,114,1,1,"PCPE",0
45,"45189",633,462,459,7,3,"PCPE",0
22,"22906",177,123,122,6,1,"PCPE",1
3,"3121",21997,14689,14572,103,117,"PCPE",9
47,"47189",151,128,122,1,6,"PCPE",0
19,"19185",26,15,15,1,0,"PCPE",0
44,"44184",44,37,37,0,0,"PCPE",0
3,"3016",88,66,66,0,0,"PCPE",0
19,"19154",58,45,45,0,0,"PCPE",0
44,"44074",440,314,308,2,6,"PCPE",0
50,"50054",55,37,37,2,0,"PCPE",0
28,"28180",5317,4011,3959,35,52,"PCPE",3
28,"28170",2495,1714,1695,13,19,"PCPE",0
28,"28138",60,43,42,0,1,"PCPE",0
45,"45080",3,3,3,0,0,"PCPE",0
16,"16185",36,31,31,0,0,"PCPE",0
3,"3045",216,176,172,1,4,"PCPE",1
50,"50071",126,84,84,0,0,"PCPE",0
16,"16053",388,306,303,3,3,"PCPE",0
46,"46021",24053,17331,17194,159,137,"PCPE",24
50,"50022",504,373,369,12,4,"PCPE",1
28,"28086",5446,3643,3600,19,43,"PCPE",4
47,"47223",148,105,102,4,3,"PCPE",0
45,"45045",1338,926,915,9,11,"PCPE",0
46,"46174",942,746,736,1,10,"PCPE",1
28,"28162",2784,2143,2131,20,12,"PCPE",0
46,"46014",3156,2324,2294,13,30,"PCPE",1
33,"33024",224741,151660,150461,1597,1199,"PCPE",150
46,"46163",1883,1471,1460,8,11,"PCPE",2
3,"3094",9795,6528,6481,37,47,"PCPE",3
19,"19111",160,128,125,0,3,"PCPE",0
19,"19075",58,38,37,3,1,"PCPE",1
3,"3114",1593,1158,1142,4,16,"PCPE",2
50,"50096",34,22,22,0,0,"PCPE",0
44,"44147",401,264,256,7,8,"PCPE",1
22,"22095",66,52,51,1,1,"PCPE",0
47,"47054",599,465,460,1,5,"PCPE",0
19,"19288",21,20,20,2,0,"PCPE",0
50,"50216",236,169,167,0,2,"PCPE",0
16,"16248",862,710,700,6,10,"PCPE",0
19,"19244",74,55,55,3,0,"PCPE",0
50,"50007",51,34,34,1,0,"PCPE",0
2,"2043",1165,872,858,6,14,"PCPE",1
22,"22187",288,220,220,2,0,"PCPE",0
16,"16068",125,88,88,3,0,"PCPE",0
3,"3038",330,260,254,3,6,"PCPE",0
16,"16043",88,60,60,3,0,"PCPE",0
44,"44206",100,73,73,3,0,"PCPE",0
3,"3105",5510,3879,3792,27,87,"PCPE",1
50,"50080",34,27,27,0,0,"PCPE",0
39,"39079",8850,6247,6175,28,72,"PCPE",5
45,"45194",64,45,44,1,1,"PCPE",0
44,"44019",70,42,42,0,0,"PCPE",0
50,"50217",426,333,333,1,0,"PCPE",0
50,"50234",242,159,154,4,5,"PCPE",1
22,"22201",264,188,186,3,2,"PCPE",0
45,"45195",2064,1519,1481,9,38,"PCPE",5
47,"47098",567,452,446,4,6,"PCPE",0
39,"39021",464,370,364,1,6,"PCPE",0
44,"44010",185,144,143,0,1,"PCPE",0
50,"50283",69,46,46,0,0,"PCPE",0
22,"22234",743,498,491,5,7,"PCPE",0
2,"2078",891,650,642,4,8,"PCPE",1
2,"2012",1835,1462,1420,9,42,"PCPE",0
16,"16010",134,92,88,0,4,"PCPE",1
39,"39002",3408,2360,2323,7,37,"PCPE",0
44,"44141",122,88,85,0,3,"PCPE",1
22,"22208",192,150,147,1,3,"PCPE",0
47,"47075",4772,3557,3512,34,45,"PCPE",2
50,"50172",174,125,123,2,2,"PCPE",0
46,"46251",2465,1938,1903,19,35,"PCPE",0
45,"45184",204,123,122,0,1,"PCPE",0
45,"45050",505,338,332,2,6,"PCPE",1
50,"50235",2421,1721,1702,18,19,"PCPE",1
22,"22023",385,293,283,2,10,"PCPE",0
46,"46093",2151,1652,1640,10,12,"PCPE",0
3,"3040",264,227,221,1,6,"PCPE",0
50,"50109",95,65,62,2,3,"PCPE",0
2,"2057",1947,1358,1333,15,25,"PCPE",0
19,"19184",59,47,47,0,0,"PCPE",0
45,"45051",1678,1238,1209,13,29,"PCPE",0
50,"50009",97,61,61,1,0,"PCPE",0
44,"44130",28,23,23,0,0,"PCPE",0
19,"19261",33,23,23,0,0,"PCPE",0
16,"16192",42,28,28,0,0,"PCPE",0
16,"16112",1466,972,957,12,15,"PCPE",0
16,"16193",55,50,49,0,1,"PCPE",0
45,"45100",178,141,138,0,3,"PCPE",0
39,"39023",6563,4788,4753,14,35,"PCPE",5
3,"3007",173,141,139,0,2,"PCPE",0
39,"39069",1934,1475,1458,2,17,"PCPE",2
45,"45198",1808,1442,1428,6,14,"PCPE",0
44,"44238",2278,1630,1620,3,10,"PCPE",1
16,"16139",317,226,222,1,4,"PCPE",0
47,"47209",32,23,23,0,0,"PCPE",0
47,"47010",14718,11521,11392,137,129,"PCPE",6
33,"33071",546,385,383,7,2,"PCPE",0
22,"22904",751,516,511,3,5,"PCPE",1
2,"2015",1432,1163,1148,8,15,"PCPE",0
46,"46155",972,731,716,3,15,"PCPE",0
46,"46034",1826,1345,1335,3,10,"PCPE",1
33,"33061",344,174,174,1,0,"PCPE",1
47,"47050",3908,2713,2673,39,40,"PCPE",3
45,"45138",1058,813,802,5,11,"PCPE",0
19,"19192",1762,1251,1240,5,11,"PCPE",0
47,"47020",270,212,207,5,5,"PCPE",0
46,"46221",348,292,290,1,2,"PCPE",1
28,"28092",153631,112460,111341,913,1119,"PCPE",65
45,"45007",656,502,497,0,5,"PCPE",0
47,"47013",91,77,77,1,0,"PCPE",0
22,"22032",102,69,68,1,1,"PCPE",0
50,"50188",26,23,23,0,0,"PCPE",0
47,"47198",64,43,43,0,0,"PCPE",0
22,"22205",448,294,292,0,2,"PCPE",0
46,"46111",11367,7995,7908,66,87,"PCPE",6
44,"44145",974,698,697,3,1,"PCPE",0
28,"28021",571,365,364,1,1,"PCPE",0
28,"28022",37338,30620,30455,229,165,"PCPE",12
3,"3111",5579,3777,3737,23,40,"PCPE",4
19,"19314",44,33,33,0,0,"PCPE",0
45,"45139",144,111,111,0,0,"PCPE",0
19,"19097",14,14,13,0,1,"PCPE",0
46,"46051",8469,6120,6070,40,50,"PCPE",4
45,"45116",666,492,489,4,3,"PCPE",0
50,"50086",176,106,102,1,4,"PCPE",1
2,"2085",306,232,226,2,6,"PCPE",0
47,"47012",100,72,71,0,1,"PCPE",0
22,"22029",118,85,83,1,2,"PCPE",0
16,"16246",451,327,322,1,5,"PCPE",0
28,"28046",4824,3726,3707,33,19,"PCPE",4
44,"44108",306,209,205,1,4,"PCPE",0
3,"3101",4933,3502,3462,16,40,"PCPE",1
28,"28012",929,707,698,7,9,"PCPE",0
33,"33044",177059,121380,120421,1543,959,"PCPE",74
22,"22207",121,66,65,0,1,"PCPE",0
33,"33017",2969,1787,1768,38,19,"PCPE",4
28,"28003",167,133,131,4,2,"PCPE",0
50,"50166",235,186,186,0,0,"PCPE",0
46,"46226",29,20,19,0,1,"PCPE",0
50,"50122",68,43,42,1,1,"PCPE",0
22,"22094",102,69,69,3,0,"PCPE",0
30,"30035",19432,13174,13013,114,161,"PCPE",12
19,"19166",154,110,108,0,2,"PCPE",0
28,"28171",4410,2921,2889,8,32,"PCPE",1
50,"50240",943,693,683,12,10,"PCPE",0
50,"50215",20,14,14,0,0,"PCPE",0
2,"2071",1027,800,795,7,5,"PCPE",0
22,"22220",147,106,105,1,1,"PCPE",0
3,"3024",3937,2992,2952,19,40,"PCPE",4
22,"22178",105,89,89,1,0,"PCPE",0
28,"28071",63,46,45,0,1,"PCPE",1
39,"39084",868,608,605,3,3,"PCPE",0
19,"19102",88,75,73,0,2,"PCPE",1
46,"46254",944,673,661,6,12,"PCPE",0
45,"45020",1240,905,900,5,5,"PCPE",0
16,"16198",1281,938,928,6,10,"PCPE",0
16,"16910",75,44,44,1,0,"PCPE",0
50,"50273",33,24,24,1,0,"PCPE",0
45,"45155",311,240,240,0,0,"PCPE",0
45,"45159",83,71,69,0,2,"PCPE",0
16,"16154",4739,3416,3379,33,37,"PCPE",2
45,"45046",2369,1679,1651,11,28,"PCPE",1
39,"39056",2262,1683,1671,14,12,"PCPE",1
47,"47097",305,239,237,0,2,"PCPE",0
45,"45034",1290,968,948,7,20,"PCPE",6
22,"22013",271,200,197,3,3,"PCPE",0
28,"28076",432,330,327,4,3,"PCPE",0
44,"44216",27003,19997,19909,80,88,"PCPE",4
39,"39041",1753,1285,1269,7,16,"PCPE",0
47,"47029",50,37,35,1,2,"PCPE",0
19,"19209",40,30,29,0,1,"PCPE",0
45,"45084",2103,1533,1508,7,25,"PCPE",0
44,"44244",67,40,40,0,0,"PCPE",0
45,"45170",194,146,140,0,6,"PCPE",0
30,"30014",1587,1150,1134,4,16,"PCPE",1
16,"16159",198,135,135,2,0,"PCPE",0
44,"44197",51,35,35,1,0,"PCPE",0
46,"46001",771,562,560,3,2,"PCPE",0
28,"28006",80903,60936,60508,482,428,"PCPE",33
45,"45061",2490,1690,1669,9,21,"PCPE",1
45,"45134",1622,1187,1177,8,10,"PCPE",1
50,"50193",664,487,475,4,12,"PCPE",0
2,"2056",1640,1204,1179,11,25,"PCPE",0
22,"22046",713,555,549,9,6,"PCPE",0
47,"47026",50,37,37,1,0,"PCPE",0
50,"50223",906,702,693,9,9,"PCPE",0
19,"19223",99,66,65,1,1,"PCPE",0
16,"16265",22,18,18,0,0,"PCPE",0
44,"44017",269,217,216,0,1,"PCPE",0
44,"44265",175,138,136,1,2,"PCPE",0
45,"45174",300,218,217,2,1,"PCPE",0
19,"19091",23,17,17,0,0,"PCPE",0
45,"45147",592,449,443,2,6,"PCPE",0
46,"46055",1298,992,977,9,15,"PCPE",0
3,"3097",1014,778,764,5,14,"PCPE",1
22,"22078",431,285,285,4,0,"PCPE",0
16,"16240",98,71,69,0,2,"PCPE",0
22,"22248",103,73,73,0,0,"PCPE",0
45,"45081",19268,13690,13516,104,174,"PCPE",12
2,"2018",789,611,606,3,5,"PCPE",1
16,"16124",1807,1367,1347,14,20,"PCPE",4
28,"28059",4516,3343,3299,30,44,"PCPE",0
28,"28039",134,93,93,1,0,"PCPE",1
39,"39013",517,359,356,1,3,"PCPE",0
46,"46094",20805,15353,15211,122,142,"PCPE",12
19,"19293",1945,1402,1388,19,14,"PCPE",0
2,"2058",300,186,177,1,9,"PCPE",0
3,"3041",6132,4204,4167,22,37,"PCPE",6
28,"28150",3191,2423,2401,13,22,"PCPE",0
50,"50004",475,360,356,2,4,"PCPE",0
19,"19251",39,30,30,0,0,"PCPE",0
44,"44237",367,267,262,0,5,"PCPE",0
19,"19020",46,31,31,0,0,"PCPE",1
19,"19222",95,70,70,2,0,"PCPE",0
47,"47219",39,31,28,1,3,"PCPE",0
2,"2005",554,426,419,8,7,"PCPE",0
16,"16013",26,24,24,0,0,"PCPE",0
46,"46110",21364,15132,15019,120,113,"PCPE",19
19,"19329",58,46,46,0,0,"PCPE",0
2,"2060",1268,953,939,7,14,"PCPE",1
2,"2016",528,353,352,4,1,"PCPE",0
47,"47102",257,212,210,2,2,"PCPE",0
47,"47125",49,42,42,0,0,"PCPE",0
50,"50253",379,294,290,1,4,"PCPE",0
50,"50019",63,46,46,0,0,"PCPE",1
44,"44112",400,265,265,2,0,"PCPE",0
19,"19155",64,49,49,0,0,"PCPE",0
50,"50246",37,24,24,0,0,"PCPE",0
46,"46095",580,445,438,5,7,"PCPE",0
19,"19201",60,44,44,0,0,"PCPE",0
50,"50265",74,54,54,1,0,"PCPE",0
44,"44161",428,294,292,2,2,"PCPE",0
45,"45143",1192,877,865,9,12,"PCPE",0
19,"19272",66,55,55,2,0,"PCPE",0
19,"19263",21,15,15,0,0,"PCPE",0
39,"39043",1517,1167,1154,3,13,"PCPE",1
50,"50295",48,41,41,0,0,"PCPE",0
28,"28137",1770,1300,1289,6,11,"PCPE",0
33,"33036",11281,7240,7153,96,87,"PCPE",12
39,"39045",352,238,234,0,4,"PCPE",0
2,"2072",1528,981,958,7,23,"PCPE",2
50,"50173",156,114,114,0,0,"PCPE",0
16,"16103",235,183,181,2,2,"PCPE",0
45,"45165",62598,43750,43259,329,491,"PCPE",28
16,"16263",967,724,721,3,3,"PCPE",0
16,"16015",349,242,239,6,3,"PCPE",0
44,"44231",35,30,30,0,0,"PCPE",0
19,"19298",53,43,41,0,2,"PCPE",0
46,"46190",50042,35290,35066,284,224,"PCPE",28
47,"47055",188,147,147,2,0,"PCPE",0
46,"46119",761,587,580,6,7,"PCPE",4
33,"33072",1443,816,814,8,2,"PCPE",2
39,"39082",1611,1108,1102,8,6,"PCPE",2
3,"3901",1137,783,776,9,7,"PCPE",1
46,"46112",533,435,432,7,3,"PCPE",0
33,"33026",8201,5014,4974,74,40,"PCPE",8
46,"46234",317,247,245,1,2,"PCPE",0
19,"19204",150,105,104,3,1,"PCPE",0
50,"50095",12149,8322,8239,91,83,"PCPE",5
16,"16118",1351,1022,1009,13,13,"PCPE",0
50,"50046",162,125,125,6,0,"PCPE",0
28,"28014",34522,25016,24748,229,268,"PCPE",17
28,"28085",4194,3126,3091,24,35,"PCPE",0
44,"44176",152,114,113,1,1,"PCPE",0
2,"2031",535,406,401,4,5,"PCPE",0
3,"3014",238937,161861,160809,1308,1052,"PCPE",221
28,"28122",578,404,401,1,3,"PCPE",0
28,"28023",5159,4052,4019,27,33,"PCPE",2
47,"47003",206,167,166,5,1,"PCPE",0
46,"46052",515,423,419,4,4,"PCPE",0
33,"33023",3249,2127,2097,30,30,"PCPE",1
39,"39093",297,216,214,1,2,"PCPE",0
33,"33018",2804,1830,1806,30,24,"PCPE",1
28,"28172",9915,7715,7652,60,63,"PCPE",3
44,"44224",21,14,14,2,0,"PCPE",0
47,"47217",1984,1460,1437,11,23,"PCPE",0
47,"47140",106,83,83,0,0,"PCPE",0
45,"45167",1370,1078,1065,1,13,"PCPE",1
22,"22907",1463,1016,1006,21,10,"PCPE",0
19,"19015",82,74,73,1,1,"PCPE",0
44,"44183",61,47,47,1,0,"PCPE",0
45,"45115",2602,2013,1969,12,44,"PCPE",2
45,"45071",1779,1374,1342,7,32,"PCPE",2
44,"44128",58,39,37,0,2,"PCPE",0
16,"16237",98,82,82,1,0,"PCPE",0
19,"19112",53,35,34,0,1,"PCPE",0
46,"46038",302,221,220,1,1,"PCPE",0
47,"47004",1135,878,872,5,6,"PCPE",2
2,"2081",18287,12910,12675,130,235,"PCPE",6
44,"44247",291,207,206,4,1,"PCPE",0
47,"47069",115,87,87,0,0,"PCPE",0
45,"45087",8180,5737,5628,41,109,"PCPE",4
39,"39085",7017,5029,4992,23,37,"PCPE",4
33,"33048",132,86,85,1,1,"PCPE",0
46,"46175",429,362,355,3,7,"PCPE",1
39,"39020",23993,15944,15792,89,152,"PCPE",18
19,"19335",51,39,38,0,1,"PCPE",0
22,"22112",9525,6317,6245,91,72,"PCPE",3
46,"46263",235,182,180,2,2,"PCPE",1
19,"19007",433,316,310,1,6,"PCPE",0
16,"16097",139,117,116,0,1,"PCPE",0
3,"3096",5786,4355,4281,38,74,"PCPE",1
28,"28078",40,38,38,0,0,"PCPE",0
50,"50225",1532,983,971,12,12,"PCPE",0
46,"46107",1857,1421,1402,4,19,"PCPE",0
39,"39102",2229,1524,1514,10,10,"PCPE",2
28,"28148",89174,65500,64784,566,716,"PCPE",40
44,"44201",477,399,395,1,4,"PCPE",0
28,"28020",193,96,93,0,3,"PCPE",0
46,"46258",2617,1925,1914,5,11,"PCPE",1
45,"45057",224,177,173,0,4,"PCPE",1
16,"16163",64,51,51,0,0,"PCPE",0
44,"44175",112,76,75,1,1,"PCPE",0
19,"19221",31,22,22,1,0,"PCPE",0
50,"50008",5187,3334,3288,37,46,"PCPE",5
50,"50077",201,140,140,1,0,"PCPE",0
50,"50082",82,57,57,0,0,"PCPE",0
3,"3127",350,260,255,1,5,"PCPE",1
16,"16066",2280,1765,1734,18,31,"PCPE",0
19,"19278",24,20,20,0,0,"PCPE",0
50,"50157",289,199,196,1,3,"PCPE",0
50,"50261",201,154,151,0,3,"PCPE",0
3,"3015",12818,9127,9017,46,110,"PCPE",11
30,"30007",6474,4354,4317,26,37,"PCPE",0
28,"28114",141,97,97,0,0,"PCPE",0
45,"45038",3528,2556,2521,26,35,"PCPE",0
44,"44093",78,62,61,0,1,"PCPE",0
28,"28160",8709,6507,6460,62,47,"PCPE",4
3,"3072",352,281,277,3,4,"PCPE",2
33,"33073",8096,4377,4320,59,57,"PCPE",1
46,"46081",9999,7486,7412,47,74,"PCPE",7
3,"3138",3190,2244,2207,9,37,"PCPE",0
28,"28049",57814,44977,44559,385,418,"PCPE",38
3,"3027",167,142,138,1,4,"PCPE",0
19,"19116",12,10,10,0,0,"PCPE",0
44,"44049",784,539,532,3,7,"PCPE",0
50,"50002",125,91,86,0,5,"PCPE",0
2,"2026",834,644,633,4,11,"PCPE",0
16,"16273",300,214,211,3,3,"PCPE",0
46,"46102",19696,14700,14579,125,121,"PCPE",11
33,"33005",1357,832,825,11,7,"PCPE",0
3,"3119",17253,12346,12258,81,88,"PCPE",12
19,"19096",105,72,70,0,2,"PCPE",0
16,"16258",172,124,119,0,5,"PCPE",0
39,"39086",358,236,235,2,1,"PCPE",0
44,"44044",82,65,65,2,0,"PCPE",0
3,"3063",27209,18236,18101,164,135,"PCPE",19
28,"28064",125,98,95,3,3,"PCPE",0
16,"16042",1091,832,823,4,9,"PCPE",0
22,"22041",145,116,116,2,0,"PCPE",0
50,"50175",907,638,632,11,6,"PCPE",1
47,"47176",199,110,110,0,0,"PCPE",0
33,"33046",480,334,329,0,5,"PCPE",0
19,"19162",67,41,41,0,0,"PCPE",0
2,"2020",425,336,332,4,4,"PCPE",0
45,"45040",1247,727,715,3,12,"PCPE",0
28,"28129",8589,6397,6338,46,59,"PCPE",3
16,"16036",120,94,93,0,1,"PCPE",0
45,"45067",2267,1722,1675,14,47,"PCPE",0
19,"19113",454,327,322,4,5,"PCPE",1
16,"16212",233,186,184,0,2,"PCPE",0
19,"19024",8561,6015,5942,44,73,"PCPE",5
16,"16039",365,241,238,3,3,"PCPE",0
45,"45176",3859,2694,2662,24,32,"PCPE",2
28,"28052",3961,2700,2659,14,41,"PCPE",1
39,"39044",3921,2805,2783,18,22,"PCPE",1
50,"50181",999,748,732,3,16,"PCPE",0
46,"46200",1840,1475,1455,5,20,"PCPE",1
28,"28153",816,547,544,3,3,"PCPE",2
50,"50203",1065,817,804,5,13,"PCPE",1
33,"33032",11056,7052,6905,109,147,"PCPE",11
19,"19214",74,51,51,0,0,"PCPE",0
46,"46043",135,119,118,0,1,"PCPE",0
47,"47006",182,149,145,1,4,"PCPE",0
39,"39098",1381,1088,1080,5,8,"PCPE",0
44,"44109",99,64,64,0,0,"PCPE",0
39,"39054",4541,3271,3252,30,19,"PCPE",2
45,"45153",1568,1168,1162,8,6,"PCPE",1
19,"19040",53,43,42,1,1,"PCPE",0
19,"19130",61556,45926,45388,408,538,"PCPE",29
19,"19235",98,77,76,1,1,"PCPE",0
44,"44127",57,43,43,0,0,"PCPE",0
50,"50232",160,93,92,1,1,"PCPE",0
3,"3109",3003,2186,2151,14,35,"PCPE",1
2,"2019",2352,1806,1766,9,40,"PCPE",0
50,"50031",134,78,75,0,3,"PCPE",0
39,"39089",131,82,82,0,0,"PCPE",0
16,"16234",23,17,17,0,0,"PCPE",0
28,"28041",4805,3666,3634,38,32,"PCPE",2
44,"44136",48,43,43,1,0,"PCPE",0
50,"50903",2268,1685,1670,16,15,"PCPE",1
39,"39083",1063,619,611,2,8,"PCPE",0
45,"45196",1382,1029,1005,7,24,"PCPE",0
3,"3102",7181,5126,5073,36,53,"PCPE",1
50,"50247",852,600,594,8,6,"PCPE",1
46,"46028",383,305,299,8,6,"PCPE",0
44,"44012",303,215,215,2,0,"PCPE",0
50,"50129",212,129,127,0,2,"PCPE",0
3,"3030",559,442,433,2,9,"PCPE",4
50,"50056",399,296,296,3,0,"PCPE",0
19,"19073",16,15,15,1,0,"PCPE",0
46,"46262",206,136,134,1,2,"PCPE",0
50,"50233",96,78,78,0,0,"PCPE",0
19,"19267",20,15,14,0,1,"PCPE",1
28,"28062",306,232,227,0,5,"PCPE",0
19,"19098",20,17,17,0,0,"PCPE",0
45,"45018",550,385,380,1,5,"PCPE",1
22,"22055",305,242,235,2,7,"PCPE",0
47,"47114",3900,2549,2514,18,35,"PCPE",3
46,"46086",80,66,65,1,1,"PCPE",0
44,"44031",83,50,50,0,0,"PCPE",0
22,"22221",92,56,55,0,1,"PCPE",0
16,"16202",733,533,526,4,7,"PCPE",0
50,"50057",1331,933,922,10,11,"PCPE",1
44,"44158",1153,879,872,6,7,"PCPE",2
46,"46016",1070,827,814,10,13,"PCPE",0
50,"50032",243,167,164,3,3,"PCPE",0
2,"2079",2807,2000,1978,17,22,"PCPE",4
44,"44067",106,75,71,0,4,"PCPE",0
45,"45085",1535,1061,1052,11,9,"PCPE",1
47,"47095",41,29,28,0,1,"PCPE",0
33,"33008",1679,1140,1133,10,7,"PCPE",1
28,"28037",1570,1135,1123,4,12,"PCPE",0
16,"16169",49,28,28,0,0,"PCPE",0
47,"47059",94,64,64,0,0,"PCPE",0
16,"16215",237,162,158,1,4,"PCPE",1
19,"19046",22204,16001,15752,156,249,"PCPE",11
22,"22043",93,53,53,0,0,"PCPE",0
30,"30041",14040,8999,8876,94,123,"PCPE",12
22,"22062",154,107,107,1,0,"PCPE",0
16,"16264",385,311,305,1,6,"PCPE",0
50,"50296",385,240,235,3,5,"PCPE",0
44,"44221",386,307,304,1,3,"PCPE",0
22,"22021",1884,1331,1319,26,12,"PCPE",1
45,"45104",419,328,324,1,4,"PCPE",0
50,"50205",72,51,49,0,2,"PCPE",0
44,"44213",68,47,47,0,0,"PCPE",0
44,"44088",24,23,23,0,0,"PCPE",0
44,"44182",203,160,158,0,2,"PCPE",0
46,"46106",1471,1033,1028,8,5,"PCPE",3
50,"50053",643,476,466,3,10,"PCPE",0
19,"19260",38,27,27,1,0,"PCPE",0
50,"50202",124,76,74,0,2,"PCPE",0
19,"19187",42,32,32,0,0,"PCPE",0
50,"50268",41,32,32,1,0,"PCPE",0
50,"50254",179,115,113,0,2,"PCPE",0
45,"45166",1575,1231,1210,5,21,"PCPE",0
3,"3103",238,196,194,2,2,"PCPE",0
2,"2004",597,459,455,3,4,"PCPE",0
16,"16027",691,500,495,1,5,"PCPE",1
28,"28099",1950,1409,1404,16,5,"PCPE",0
22,"22903",618,484,482,5,2,"PCPE",1
46,"46026",1220,974,965,7,9,"PCPE",0
28,"28115",62612,50619,50431,399,188,"PCPE",11
19,"19242",74,53,53,1,0,"PCPE",0
45,"45015",656,449,438,2,11,"PCPE",1
19,"19284",10,10,10,0,0,"PCPE",0
50,"50084",67,47,47,1,0,"PCPE",0
50,"50156",212,156,151,2,5,"PCPE",0
30,"30003",25200,16249,16120,159,129,"PCPE",21
46,"46219",125,107,104,0,3,"PCPE",0
46,"46248",4868,3434,3374,16,60,"PCPE",2
16,"16020",9,5,5,1,0,"PCPE",0
2,"2084",298,197,191,2,6,"PCPE",0
39,"39033",536,375,372,1,3,"PCPE",1
19,"19074",67,57,57,1,0,"PCPE",0
50,"50269",287,172,167,2,5,"PCPE",0
47,"47212",356,289,287,4,2,"PCPE",0
16,"16017",336,276,270,1,6,"PCPE",0
39,"39036",965,707,703,4,4,"PCPE",0
28,"28043",6190,4031,3969,33,62,"PCPE",5
16,"16166",240,173,171,0,2,"PCPE",0
22,"22076",285,207,203,4,4,"PCPE",1
50,"50051",802,551,550,2,1,"PCPE",1
22,"22229",107,70,70,2,0,"PCPE",0
50,"50081",487,355,349,5,6,"PCPE",0
45,"45128",2569,1676,1652,6,24,"PCPE",2
47,"47104",2816,2153,2099,20,54,"PCPE",0
22,"22018",303,216,215,3,1,"PCPE",1
16,"16228",173,147,145,2,2,"PCPE",0
44,"44222",125,92,92,0,0,"PCPE",0
22,"22009",581,387,386,7,1,"PCPE",3
22,"22011",98,80,79,0,1,"PCPE",0
46,"46077",7338,5447,5356,44,91,"PCPE",8
2,"2001",687,513,505,1,8,"PCPE",0
3,"3064",5015,3514,3461,15,53,"PCPE",5
28,"28108",3736,2681,2652,21,29,"PCPE",3
3,"3092",6712,4924,4858,35,66,"PCPE",6
44,"44262",141,104,103,0,1,"PCPE",0
46,"46242",326,260,257,3,3,"PCPE",0
46,"46066",1274,972,970,4,2,"PCPE",1
19,"19332",85,59,57,4,2,"PCPE",0
19,"19195",36,26,25,2,1,"PCPE",0
44,"44016",424,299,297,1,2,"PCPE",0
45,"45154",1491,1033,1024,11,9,"PCPE",1
19,"19120",107,86,86,1,0,"PCPE",0
46,"46105",16126,10958,10847,76,111,"PCPE",7
3,"3044",4608,3437,3391,13,46,"PCPE",1
3,"3019",15501,11261,11106,86,155,"PCPE",17
45,"45052",3132,2433,2416,29,17,"PCPE",0
30,"30034",1067,818,801,8,17,"PCPE",1
22,"22246",63,43,43,0,0,"PCPE",0
16,"16209",110,95,94,2,1,"PCPE",0
2,"2086",2389,1567,1554,10,13,"PCPE",0
3,"3090",18095,12539,12412,75,127,"PCPE",8
28,"28135",998,712,703,2,9,"PCPE",0
22,"22119",1267,880,871,4,9,"PCPE",1
44,"44008",1556,1109,1100,7,9,"PCPE",0
16,"16101",137,111,109,1,2,"PCPE",0
22,"22197",436,327,325,3,2,"PCPE",2
28,"28178",1149,869,853,4,16,"PCPE",0
28,"28030",1832,1319,1297,13,22,"PCPE",0
47,"47169",62,52,52,0,0,"PCPE",0
46,"46004",1932,1530,1512,10,18,"PCPE",2
19,"19186",76,60,60,0,0,"PCPE",0
46,"46046",901,623,609,2,14,"PCPE",0
46,"46198",862,670,660,3,10,"PCPE",1
45,"45097",1037,834,819,7,15,"PCPE",0
45,"45156",3334,2561,2502,23,59,"PCPE",1
50,"50224",61,44,44,2,0,"PCPE",0
50,"50040",82,66,66,1,0,"PCPE",0
16,"16909",655,493,488,4,5,"PCPE",0
46,"46209",1903,1406,1383,5,23,"PCPE",0
28,"28140",3156,2359,2331,16,28,"PCPE",1
19,"19217",43,36,36,0,0,"PCPE",0
19,"19159",87,73,72,1,1,"PCPE",0
16,"16060",715,519,513,3,6,"PCPE",2
22,"22082",288,217,214,0,3,"PCPE",0
46,"46244",59910,42120,41826,338,294,"PCPE",27
22,"22160",207,149,149,1,0,"PCPE",1
16,"16126",720,552,545,3,7,"PCPE",0
47,"47016",65,55,55,0,0,"PCPE",0
19,"19033",47,38,37,1,1,"PCPE",0
28,"28161",52164,38607,38193,306,414,"PCPE",29
47,"47083",81,63,61,0,2,"PCPE",0
22,"22143",190,118,115,1,3,"PCPE",0
22,"22252",118,95,91,1,4,"PCPE",0
33,"33038",2218,1501,1477,17,24,"PCPE",0
47,"47021",73,57,55,0,2,"PCPE",0
28,"28054",11943,8800,8731,72,69,"PCPE",5
50,"50079",226,162,160,1,2,"PCPE",0
22,"22058",193,141,141,0,0,"PCPE",1
19,"19109",33,26,26,2,0,"PCPE",0
46,"46181",16967,11951,11835,98,116,"PCPE",7
47,"47190",95,75,75,1,0,"PCPE",0
16,"16272",201,149,147,2,2,"PCPE",0
44,"44264",254,170,170,0,0,"PCPE",0
45,"45031",2861,1894,1858,13,36,"PCPE",2
39,"39037",2033,1431,1420,3,11,"PCPE",2
22,"22172",520,373,369,5,4,"PCPE",0
28,"28151",3274,2344,2310,16,34,"PCPE",1
50,"50221",29,18,18,0,0,"PCPE",0
44,"44194",103,67,64,0,3,"PCPE",0
33,"33049",5973,3569,3518,48,51,"PCPE",3
39,"39099",3193,2363,2346,10,17,"PCPE",1
50,"50146",189,149,149,3,0,"PCPE",0
45,"45187",3967,3133,3074,16,59,"PCPE",1
19,"19153",22,20,20,2,0,"PCPE",0
3,"3129",1224,934,923,4,11,"PCPE",0
16,"16131",123,84,84,0,0,"PCPE",0
45,"45161",15469,10281,10167,68,114,"PCPE",10
22,"22077",362,280,272,5,8,"PCPE",0
33,"33064",240,151,151,0,0,"PCPE",1
46,"46011",7523,5154,5077,34,77,"PCPE",2
47,"47153",101,69,69,1,0,"PCPE",0
47,"47148",419,332,324,3,8,"PCPE",1
2,"2062",382,261,256,2,5,"PCPE",0
44,"44059",562,411,407,2,4,"PCPE",1
2,"2041",316,238,236,0,2,"PCPE",1
16,"16140",18,14,14,1,0,"PCPE",0
47,"47146",275,215,214,1,1,"PCPE",0
28,"28036",2699,1977,1957,20,20,"PCPE",1
19,"19210",18,16,16,0,0,"PCPE",0
45,"45118",2124,1403,1380,8,23,"PCPE",0
22,"22223",77,60,59,2,1,"PCPE",0
47,"47199",71,57,57,2,0,"PCPE",0
47,"47232",96,67,65,0,2,"PCPE",0
45,"45122",5605,4321,4288,33,33,"PCPE",10
44,"44239",21,19,19,0,0,"PCPE",0
46,"46006",4454,3527,3486,27,41,"PCPE",1
3,"3054",334,248,245,2,3,"PCPE",0
22,"22040",149,119,119,3,0,"PCPE",0
3,"3026",1331,987,975,7,12,"PCPE",2
33,"33014",8735,5744,5689,67,55,"PCPE",10
39,"39042",5910,4354,4315,14,39,"PCPE",2
19,"19304",224,169,166,3,3,"PCPE",0
30,"30008",14560,9974,9840,79,134,"PCPE",11
44,"44102",26,19,19,0,0,"PCPE",0
44,"44040",189,153,150,1,3,"PCPE",0
46,"46057",463,308,304,1,4,"PCPE",0
44,"44164",19,16,16,1,0,"PCPE",0
16,"16092",149,108,108,1,0,"PCPE",0
45,"45177",1998,1557,1525,10,32,"PCPE",0
39,"39055",1065,747,736,4,11,"PCPE",1
46,"46252",125,89,86,1,3,"PCPE",0
50,"50281",68,52,50,0,2,"PCPE",0
19,"19317",124,83,82,0,1,"PCPE",0
50,"50277",45,34,34,0,0,"PCPE",0
39,"39074",7050,5074,5029,26,45,"PCPE",2
19,"19022",592,423,420,6,3,"PCPE",0
16,"16186",403,309,305,3,4,"PCPE",0
19,"19213",67,53,52,1,1,"PCPE",0
47,"47070",29,24,24,0,0,"PCPE",0
16,"16001",62,45,45,0,0,"PCPE",0
46,"46072",3522,2792,2741,25,51,"PCPE",2
16,"16277",105,74,74,0,0,"PCPE",0
28,"28033",4177,2972,2936,20,36,"PCPE",2
22,"22227",200,140,140,2,0,"PCPE",0
47,"47046",124,99,99,1,0,"PCPE",1
3,"3042",1475,1053,1043,7,10,"PCPE",2
47,"47128",53,45,43,0,2,"PCPE",0
46,"46203",3546,2717,2689,28,28,"PCPE",4
47,"47135",82,65,65,3,0,"PCPE",0
45,"45126",234,146,144,2,2,"PCPE",0
2,"2075",1700,1357,1347,6,10,"PCPE",1
46,"46059",1244,1007,995,5,12,"PCPE",0
16,"16270",154,123,122,1,1,"PCPE",0
19,"19174",90,65,64,0,1,"PCPE",0
2,"2039",945,745,734,8,11,"PCPE",1
45,"45158",2545,1805,1786,9,19,"PCPE",0
47,"47066",1482,1096,1086,14,10,"PCPE",1
45,"45032",445,290,286,2,4,"PCPE",0
39,"39026",1702,1160,1151,11,9,"PCPE",2
28,"28002",3250,2261,2243,14,18,"PCPE",1
16,"16025",24,20,20,0,0,"PCPE",0
44,"44251",239,187,183,1,4,"PCPE",0
50,"50029",594,432,431,3,1,"PCPE",0
50,"50902",77,65,62,0,3,"PCPE",0
44,"44241",500,361,357,0,4,"PCPE",1
19,"19110",51,39,39,0,0,"PCPE",0
44,"44155",1063,779,778,3,1,"PCPE",2
44,"44043",86,60,60,0,0,"PCPE",0
47,"47231",4439,3359,3323,36,36,"PCPE",0
16,"16904",453,348,345,11,3,"PCPE",0
46,"46089",2182,1590,1576,9,14,"PCPE",5
33,"33067",751,543,538,7,5,"PCPE",0
33,"33055",1485,992,966,14,26,"PCPE",1
3,"3131",176,129,126,1,3,"PCPE",0
19,"19138",215,158,154,4,4,"PCPE",0
46,"46044",4159,3062,2997,26,65,"PCPE",2
50,"50060",171,126,125,1,1,"PCPE",0
50,"50134",120,85,82,4,3,"PCPE",0
39,"39051",73,64,64,1,0,"PCPE",0
22,"22127",521,353,352,5,1,"PCPE",0
19,"19297",32,28,28,0,0,"PCPE",0
44,"44066",85,62,62,0,0,"PCPE",0
44,"44062",31,20,20,0,0,"PCPE",0
3,"3017",379,320,314,4,6,"PCPE",1
45,"45164",166,143,142,1,1,"PCPE",0
45,"45092",223,193,190,1,3,"PCPE",0
33,"33051",6787,4318,4268,48,50,"PCPE",2
45,"45076",574,361,357,1,4,"PCPE",0
2,"2042",810,581,577,1,4,"PCPE",0
45,"45048",360,276,271,2,5,"PCPE",0
19,"19248",73,54,54,0,0,"PCPE",0
45,"45146",101,79,79,0,0,"PCPE",0
44,"44189",44,35,35,0,0,"PCPE",0
19,"19311",85,60,59,0,1,"PCPE",0
16,"16113",3065,2142,2108,13,34,"PCPE",1
46,"46210",338,256,251,0,5,"PCPE",0
3,"3125",332,226,226,2,0,"PCPE",0
22,"22007",751,527,520,1,7,"PCPE",0
50,"50255",199,152,147,3,5,"PCPE",0
3,"3132",512,376,373,2,3,"PCPE",0
3,"3135",195,134,131,1,3,"PCPE",1
46,"46125",852,660,650,5,10,"PCPE",0
22,"22048",12635,8889,8807,98,82,"PCPE",9
3,"3023",1377,1138,1122,9,16,"PCPE",1
2,"2070",373,306,301,6,5,"PCPE",0
19,"19194",91,69,69,0,0,"PCPE",0
19,"19151",1077,703,693,8,10,"PCPE",0
44,"44212",41,29,29,0,0,"PCPE",0
19,"19308",57,49,49,0,0,"PCPE",0
50,"50213",92,70,70,2,0,"PCPE",0
46,"46134",2419,1697,1678,14,19,"PCPE",3
19,"19052",21,16,16,0,0,"PCPE",0
16,"16004",228,175,174,0,1,"PCPE",0
47,"47064",37,30,29,1,1,"PCPE",0
50,"50179",255,197,197,0,0,"PCPE",0
44,"44063",63,52,52,0,0,"PCPE",0
45,"45039",201,157,157,0,0,"PCPE",0
22,"22155",66,52,52,0,0,"PCPE",0
33,"33042",4237,2862,2816,49,46,"PCPE",2
46,"46024",454,343,339,1,4,"PCPE",0
44,"44060",32,25,25,0,0,"PCPE",0
46,"46172",5488,3724,3674,26,50,"PCPE",3
16,"16173",175,128,127,0,1,"PCPE",0
19,"19191",13,12,12,0,0,"PCPE",0
22,"22199",6884,4438,4384,71,54,"PCPE",4
45,"45190",462,361,353,3,8,"PCPE",0
19,"19095",11,7,6,0,1,"PCPE",0
39,"39025",8637,6256,6179,33,77,"PCPE",3
28,"28060",1585,1160,1146,5,14,"PCPE",1
16,"16016",217,157,157,1,0,"PCPE",0
47,"47023",3057,2369,2359,20,10,"PCPE",3
47,"47043",306,241,240,4,1,"PCPE",1
19,"19262",125,98,98,0,0,"PCPE",0
45,"45191",524,437,432,2,5,"PCPE",0
33,"33029",315,145,142,1,3,"PCPE",0
47,"47060",224,171,168,1,3,"PCPE",0
47,"47056",81,57,57,0,0,"PCPE",0
19,"19203",29,25,25,0,0,"PCPE",0
22,"22242",60,41,40,0,1,"PCPE",0
47,"47177",104,78,78,0,0,"PCPE",0
16,"16206",184,126,125,4,1,"PCPE",0
50,"50163",3846,2863,2840,25,23,"PCPE",3
22,"22025",1022,705,694,14,11,"PCPE",0
33,"33020",12981,8550,8453,120,97,"PCPE",7
22,"22158",11994,8115,8049,79,66,"PCPE",7
16,"16041",334,244,243,2,1,"PCPE",0
3,"3052",959,747,735,4,12,"PCPE",0
46,"46178",5001,3513,3477,26,36,"PCPE",5
46,"46249",9136,6538,6439,73,99,"PCPE",6
46,"46117",493,386,380,2,6,"PCPE",1
45,"45079",355,250,250,0,0,"PCPE",0
47,"47040",56,42,41,0,1,"PCPE",0
44,"44131",26,22,22,0,0,"PCPE",0
45,"45017",264,199,196,4,3,"PCPE",0
28,"28091",5491,3709,3650,20,59,"PCPE",2
47,"47205",355,248,244,2,4,"PCPE",0
45,"45199",3188,2077,2055,20,22,"PCPE",1
46,"46239",446,357,352,1,5,"PCPE",0
50,"50242",99,74,74,0,0,"PCPE",0
46,"46145",22215,15688,15538,127,150,"PCPE",10
50,"50239",63,46,45,1,1,"PCPE",0
47,"47139",997,728,719,4,9,"PCPE",2
50,"50237",100,75,75,2,0,"PCPE",0
50,"50209",2785,1893,1865,24,28,"PCPE",1
33,"33004",65304,43473,43153,563,320,"PCPE",47
45,"45183",2378,1555,1525,16,30,"PCPE",1
16,"16225",55,30,30,0,0,"PCPE",0
44,"44024",31,26,25,0,1,"PCPE",0
28,"28125",3208,2275,2252,5,23,"PCPE",1
28,"28168",1347,933,918,6,15,"PCPE",0
28,"28144",6525,5032,4987,39,45,"PCPE",1
50,"50222",1574,1024,1008,12,16,"PCPE",0
45,"45056",2341,1315,1295,11,20,"PCPE",1
2,"2037",22963,14737,14588,68,149,"PCPE",3
22,"22022",542,405,403,2,2,"PCPE",2
46,"46183",6036,4276,4213,21,63,"PCPE",2
28,"28073",12707,9198,9080,94,118,"PCPE",10
19,"19271",41,22,21,1,1,"PCPE",0
44,"44123",95,68,68,0,0,"PCPE",0
3,"3013",1063,809,794,3,15,"PCPE",0
46,"46201",62,40,40,0,0,"PCPE",0
22,"22204",1117,728,723,14,5,"PCPE",1
16,"16073",190,153,153,1,0,"PCPE",0
47,"47166",251,183,181,2,2,"PCPE",2
16,"16194",219,169,161,0,8,"PCPE",0
19,"19198",17,14,14,0,0,"PCPE",0
19,"19239",93,70,70,1,0,"PCPE",0
16,"16109",41,30,30,0,0,"PCPE",0
44,"44152",70,46,46,0,0,"PCPE",0
47,"47077",234,172,170,1,2,"PCPE",0
3,"3139",23126,14650,14522,127,128,"PCPE",20
46,"46170",3417,2618,2577,11,41,"PCPE",2
3,"3099",43101,30222,29885,196,337,"PCPE",39
22,"22167",465,358,356,8,2,"PCPE",0
44,"44192",341,274,272,2,2,"PCPE",0
45,"45149",517,400,393,2,7,"PCPE",0
47,"47218",981,728,723,4,5,"PCPE",0
50,"50013",199,158,158,0,0,"PCPE",0
45,"45060",152,109,109,1,0,"PCPE",0
3,"3112",650,503,497,3,6,"PCPE",0
50,"50110",340,248,238,1,10,"PCPE",1
28,"28167",8640,6564,6504,51,60,"PCPE",4
2,"2049",778,506,496,1,10,"PCPE",1
47,"47186",244314,182449,180833,1818,1616,"PCPE",141
3,"3057",174,138,136,0,2,"PCPE",0
28,"28102",880,639,621,7,18,"PCPE",0
3,"3051",342,288,286,4,2,"PCPE",0
16,"16155",490,389,388,7,1,"PCPE",0
44,"44138",120,92,92,0,0,"PCPE",0
3,"3115",255,213,213,3,0,"PCPE",0
22,"22175",184,129,128,0,1,"PCPE",1
12,"12011",4583,3228,3177,24,51,"PCPE",2
12,"12101",354,274,270,5,4,"PCPE",0
12,"12106",1151,928,908,9,20,"PCPE",0
12,"12104",6843,5181,5111,32,70,"PCPE",2
12,"12014",164,111,111,0,0,"PCPE",0
12,"12128",1365,990,972,16,18,"PCPE",2
12,"12090",102,79,78,1,1,"PCPE",0
12,"12020",118,104,103,1,1,"PCPE",0
12,"12098",529,417,413,3,4,"PCPE",0
12,"12139",299,202,200,3,2,"PCPE",0
12,"12093",161,111,109,2,2,"PCPE",0
12,"12026",828,577,566,11,11,"PCPE",0
12,"12016",1549,1244,1234,9,10,"PCPE",0
12,"12036",541,401,395,6,6,"PCPE",0
12,"12073",133,97,97,0,0,"PCPE",1
12,"12068",41,22,21,0,1,"PCPE",0
12,"12024",138,107,107,1,0,"PCPE",0
12,"12027",17506,11776,11649,84,127,"PCPE",7
12,"12141",92,72,72,0,0,"PCPE",0
12,"12079",414,310,305,2,5,"PCPE",0
12,"12078",334,224,221,2,3,"PCPE",0
12,"12008",228,195,194,1,1,"PCPE",0
12,"12022",323,257,254,5,3,"PCPE",0
12,"12131",97,87,87,0,0,"PCPE",0
12,"12009",17943,12389,12292,102,97,"PCPE",9
12,"12005",8049,5643,5552,71,91,"PCPE",3
12,"12124",1842,1343,1328,13,15,"PCPE",1
12,"12064",80,71,69,0,2,"PCPE",1
12,"12080",1883,1472,1438,8,34,"PCPE",0
12,"12114",200,144,140,0,4,"PCPE",0
12,"12002",114,96,94,1,2,"PCPE",0
12,"12045",333,243,235,2,8,"PCPE",0
12,"12070",505,407,398,2,9,"PCPE",1
12,"12122",754,608,600,3,8,"PCPE",0
12,"12127",63,45,44,1,1,"PCPE",0
12,"12118",78,64,63,0,1,"PCPE",0
12,"12072",1083,852,827,10,25,"PCPE",2
12,"12138",19207,13018,12891,87,127,"PCPE",12
12,"12123",40,32,32,0,0,"PCPE",0
12,"12085",5081,3271,3235,17,36,"PCPE",1
12,"12117",3532,2512,2479,12,33,"PCPE",0
12,"12059",220,183,183,2,0,"PCPE",0
12,"12071",1272,936,925,3,11,"PCPE",3
12,"12084",17785,12557,12422,108,135,"PCPE",10
12,"12052",537,409,398,5,11,"PCPE",0
12,"12902",2250,1557,1532,16,25,"PCPE",0
12,"12103",87,61,60,0,1,"PCPE",0
12,"12031",3960,2913,2869,13,44,"PCPE",4
12,"12135",36287,25912,25655,184,257,"PCPE",12
12,"12133",59,46,45,0,1,"PCPE",0
12,"12060",434,366,360,1,6,"PCPE",0
12,"12012",2622,2084,2056,12,28,"PCPE",2
12,"12082",9602,7323,7248,53,75,"PCPE",7
12,"12134",135,95,95,1,0,"PCPE",0
12,"12077",4828,3395,3357,28,38,"PCPE",2
12,"12025",116,82,79,1,3,"PCPE",0
12,"12007",724,622,614,2,8,"PCPE",2
12,"12067",514,381,373,3,8,"PCPE",0
12,"12013",135,106,106,1,0,"PCPE",0
12,"12029",670,524,514,5,10,"PCPE",0
12,"12038",157,101,100,3,1,"PCPE",0
12,"12096",732,526,519,4,7,"PCPE",0
12,"12032",23728,16870,16726,121,144,"PCPE",8
12,"12040",119116,85613,84993,620,620,"PCPE",44
12,"12063",41,31,31,1,0,"PCPE",0
12,"12140",1147,849,841,5,8,"PCPE",0
12,"12075",110,85,83,3,2,"PCPE",0
12,"12021",4398,3314,3277,32,37,"PCPE",1
12,"12010",232,191,187,3,4,"PCPE",0
12,"12121",1043,878,856,5,22,"PCPE",1
12,"12034",1389,1022,1002,5,20,"PCPE",0
12,"12129",1783,1207,1184,16,23,"PCPE",3
12,"12017",145,111,110,2,1,"PCPE",0
12,"12088",57,53,53,0,0,"PCPE",0
12,"12089",4555,3070,3045,22,25,"PCPE",0
12,"12042",574,459,446,9,13,"PCPE",0
12,"12081",606,454,446,2,8,"PCPE",0
12,"12006",177,133,133,2,0,"PCPE",0
12,"12126",24374,17741,17553,111,188,"PCPE",23
12,"12076",72,54,54,0,0,"PCPE",0
12,"12004",4149,2945,2910,25,35,"PCPE",0
12,"12018",279,233,231,3,2,"PCPE",0
12,"12057",572,456,437,1,19,"PCPE",0
12,"12132",477,391,385,3,6,"PCPE",0
12,"12094",871,671,661,1,10,"PCPE",0
12,"12056",257,205,199,1,6,"PCPE",0
12,"12901",3339,2583,2561,25,22,"PCPE",4
12,"12028",13004,9801,9732,74,69,"PCPE",7
12,"12050",1226,904,891,3,13,"PCPE",0
12,"12048",243,159,155,4,4,"PCPE",0
12,"12041",92,69,69,2,0,"PCPE",0
12,"12111",327,259,255,8,4,"PCPE",1
12,"12136",2603,2151,2119,20,32,"PCPE",1
12,"12003",954,710,702,6,8,"PCPE",1
12,"12092",123,95,95,0,0,"PCPE",1
12,"12074",756,611,601,3,10,"PCPE",0
12,"12037",17,13,13,1,0,"PCPE",0
12,"12083",88,69,67,9,2,"PCPE",0
12,"12049",415,317,305,4,12,"PCPE",0
12,"12033",1953,1391,1368,6,23,"PCPE",1
12,"12095",950,723,712,5,11,"PCPE",0
12,"12039",792,665,659,2,6,"PCPE",0
12,"12115",205,161,161,1,0,"PCPE",1
12,"12125",215,179,179,2,0,"PCPE",0
12,"12061",374,263,261,4,2,"PCPE",0
12,"12130",414,329,327,0,2,"PCPE",1
12,"12099",597,444,436,6,8,"PCPE",1
12,"12097",62,53,51,0,2,"PCPE",1
12,"12113",90,59,59,1,0,"PCPE",0
12,"12100",1273,1069,1052,5,17,"PCPE",1
12,"12102",518,424,417,4,7,"PCPE",0
12,"12119",139,97,94,3,3,"PCPE",0
12,"12058",59,47,45,1,2,"PCPE",0
12,"12055",103,77,76,2,1,"PCPE",0
12,"12001",1028,783,768,6,15,"PCPE",0
12,"12108",443,354,352,4,2,"PCPE",0
12,"12015",115,94,94,0,0,"PCPE",0
12,"12053",2040,1587,1579,8,8,"PCPE",1
12,"12046",188,135,135,4,0,"PCPE",0
12,"12069",50,38,38,0,0,"PCPE",0
12,"12120",149,125,121,3,4,"PCPE",0
12,"12043",570,405,397,1,8,"PCPE",0
12,"12112",102,79,79,1,0,"PCPE",0
12,"12044",442,371,368,1,3,"PCPE",0
12,"12116",61,49,49,0,0,"PCPE",0
12,"12109",646,489,482,4,7,"PCPE",0
12,"12107",350,299,295,3,4,"PCPE",0
12,"12087",26,16,16,0,0,"PCPE",0
12,"12051",437,297,295,3,2,"PCPE",0
12,"12091",171,110,108,4,2,"PCPE",0
12,"12065",167,142,141,0,1,"PCPE",0
12,"12137",40,28,28,0,0,"PCPE",0
12,"12142",142,113,113,0,0,"PCPE",0
12,"12110",222,156,155,3,1,"PCPE",0
12,"12105",825,602,598,6,4,"PCPE",2
43,"43045",143,114,113,0,1,"PCTC",0
8,"8037",1947,1547,1543,11,4,"PCTC",1
8,"8032",2100,1472,1465,12,7,"PCTC",0
17,"17158",565,296,295,2,1,"PCTC",0
43,"43019",1332,911,904,8,7,"PCTC",0
8,"8216",25,17,17,0,0,"PCTC",0
25,"25122",1929,1408,1398,21,10,"PCTC",2
17,"17902",1294,992,990,9,2,"PCTC",0
8,"8290",1549,1254,1248,6,6,"PCTC",0
25,"25078",995,746,743,7,3,"PCTC",1
25,"25118",326,223,218,0,5,"PCTC",0
8,"8106",7500,5442,5410,43,32,"PCTC",3
8,"8303",257,207,205,1,2,"PCTC",1
8,"8093",25,22,22,0,0,"PCTC",0
8,"8169",48478,35283,35114,278,169,"PCTC",24
8,"8200",62225,45235,44991,306,244,"PCTC",27
17,"17105",248,187,186,2,1,"PCTC",0
25,"25047",956,745,736,14,9,"PCTC",0
25,"25101",536,412,411,5,1,"PCTC",0
8,"8077",34690,25896,25767,164,129,"PCTC",17
17,"17068",253,191,191,0,0,"PCTC",0
25,"25130",181,130,128,0,2,"PCTC",0
43,"43095",2583,1864,1854,12,10,"PCTC",0
17,"17047",5016,3087,3068,22,19,"PCTC",3
25,"25103",133,88,87,0,1,"PCTC",0
8,"8175",3369,2388,2372,18,16,"PCTC",2
43,"43124",468,343,339,3,4,"PCTC",0
8,"8267",6789,4975,4935,41,40,"PCTC",1
8,"8307",49499,35471,35312,199,159,"PCTC",18
25,"25022",105,80,79,0,1,"PCTC",0
17,"17903",883,681,676,3,5,"PCTC",1
8,"8300",5927,4609,4589,41,20,"PCTC",1
25,"25194",410,292,289,3,3,"PCTC",0
17,"17056",1780,1379,1374,13,5,"PCTC",0
43,"43082",350,276,271,5,5,"PCTC",0
8,"8193",988,739,737,10,2,"PCTC",0
25,"25142",359,283,283,2,0,"PCTC",1
25,"25226",236,156,155,0,1,"PCTC",0
43,"43902",2751,1794,1776,21,18,"PCTC",0
8,"8277",168,148,146,1,2,"PCTC",1
17,"17142",2713,2166,2159,18,7,"PCTC",1
25,"25902",536,406,403,1,3,"PCTC",0
17,"17208",978,723,719,6,4,"PCTC",0
8,"8100",2083,1707,1699,13,8,"PCTC",1
43,"43039",101,77,77,0,0,"PCTC",0
43,"43063",544,376,374,2,2,"PCTC",0
43,"43173",98,70,68,0,2,"PCTC",0
8,"8098",2438,1781,1778,21,3,"PCTC",2
17,"17190",834,624,619,1,5,"PCTC",0
8,"8144",722,551,545,3,6,"PCTC",1
25,"25032",65,53,52,0,1,"PCTC",0
17,"17029",207,154,154,1,0,"PCTC",0
17,"17125",136,100,100,3,0,"PCTC",0
8,"8146",1384,1030,1027,8,3,"PCTC",0
8,"8004",208,177,177,1,0,"PCTC",0
8,"8138",4461,3286,3259,27,27,"PCTC",0
43,"43108",1787,1293,1282,6,11,"PCTC",2
8,"8022",12213,8594,8558,42,36,"PCTC",4
25,"25049",156,110,109,1,1,"PCTC",0
8,"8196",19542,14264,14185,123,79,"PCTC",7
25,"25212",219,176,176,1,0,"PCTC",0
17,"17220",801,649,647,2,2,"PCTC",0
25,"25110",2745,1943,1927,13,16,"PCTC",0
25,"25039",259,197,196,7,1,"PCTC",0
25,"25161",339,221,221,0,0,"PCTC",0
25,"25068",515,359,358,0,1,"PCTC",0
8,"8141",4578,3369,3357,28,12,"PCTC",4
43,"43101",146,112,112,2,0,"PCTC",0
43,"43073",80,67,65,0,2,"PCTC",0
25,"25911",419,298,297,3,1,"PCTC",0
8,"8073",62934,45699,45407,281,292,"PCTC",34
8,"8084",1172,902,894,9,8,"PCTC",1
8,"8133",123,96,94,5,2,"PCTC",0
43,"43004",6288,4314,4262,36,52,"PCTC",0
43,"43002",1890,1233,1210,12,23,"PCTC",0
8,"8151",450,351,346,5,5,"PCTC",0
8,"8264",4608,3459,3444,30,15,"PCTC",0
8,"8092",3713,2758,2745,9,13,"PCTC",1
25,"25134",605,457,456,5,1,"PCTC",0
25,"25050",3256,2260,2249,20,11,"PCTC",0
25,"25203",8809,5813,5770,40,43,"PCTC",1
25,"25150",167,132,130,2,2,"PCTC",0
8,"8302",9359,6483,6430,78,53,"PCTC",2
8,"8239",467,362,361,3,1,"PCTC",0
17,"17227",147,104,104,0,0,"PCTC",0
8,"8129",486,399,398,0,1,"PCTC",0
17,"17057",968,770,769,7,1,"PCTC",0
17,"17015",12829,9612,9580,51,32,"PCTC",38
17,"17146",3150,2243,2224,8,19,"PCTC",2
43,"43072",90,69,67,1,2,"PCTC",0
8,"8159",14343,10656,10603,87,53,"PCTC",4
25,"25158",1605,1193,1180,8,13,"PCTC",0
25,"25209",1586,1115,1102,6,13,"PCTC",0
43,"43150",1233,954,941,6,13,"PCTC",0
8,"8011",1739,1360,1353,10,7,"PCTC",0
17,"17224",299,226,222,2,4,"PCTC",0
17,"17084",228,163,162,1,1,"PCTC",0
43,"43089",279,201,201,1,0,"PCTC",0
17,"17049",3246,2527,2502,12,25,"PCTC",1
17,"17178",1065,774,771,9,3,"PCTC",3
25,"25153",190,139,136,0,3,"PCTC",0
43,"43012",3700,2882,2858,20,24,"PCTC",1
8,"8208",5793,4267,4244,21,23,"PCTC",3
43,"43161",17103,11905,11838,82,67,"PCTC",3
8,"8048",580,427,426,1,1,"PCTC",1
8,"8136",11692,8527,8456,98,71,"PCTC",4
25,"25132",141,106,105,0,1,"PCTC",0
8,"8308",139,109,109,1,0,"PCTC",1
25,"25113",1114,873,863,3,10,"PCTC",1
17,"17216",158,122,121,0,1,"PCTC",0
43,"43054",2807,1972,1957,14,15,"PCTC",1
8,"8101",175048,121359,120620,830,739,"PCTC",103
43,"43171",14849,10140,10081,76,59,"PCTC",8
43,"43100",3557,2666,2649,22,17,"PCTC",2
8,"8041",10698,7324,7258,57,66,"PCTC",6
8,"8244",6099,4733,4706,39,27,"PCTC",8
17,"17172",452,336,335,5,1,"PCTC",0
17,"17066",27378,16755,16644,122,111,"PCTC",18
17,"17211",837,677,674,6,3,"PCTC",0
8,"8026",195,148,146,0,2,"PCTC",0
43,"43118",422,338,338,0,0,"PCTC",0
17,"17217",350,287,284,0,3,"PCTC",0
17,"17109",704,542,539,2,3,"PCTC",0
43,"43141",109,85,84,0,1,"PCTC",0
17,"17101",566,389,382,1,7,"PCTC",0
43,"43033",766,555,555,4,0,"PCTC",0
8,"8282",6731,5333,5317,40,16,"PCTC",0
25,"25251",708,526,524,1,2,"PCTC",2
17,"17006",1178,826,818,9,8,"PCTC",0
8,"8152",117,94,94,0,0,"PCTC",0
43,"43143",50,40,39,0,1,"PCTC",0
8,"8191",5302,3872,3860,21,12,"PCTC",0
43,"43167",391,307,307,2,0,"PCTC",0
17,"17173",181,143,143,1,0,"PCTC",0
8,"8233",1872,1428,1420,15,8,"PCTC",0
43,"43093",3863,2728,2716,22,12,"PCTC",5
25,"25136",95,74,74,2,0,"PCTC",1
43,"43086",5252,3811,3790,28,21,"PCTC",0
17,"17199",6984,4919,4894,39,25,"PCTC",5
8,"8063",469,390,390,4,0,"PCTC",0
17,"17011",645,518,514,10,4,"PCTC",1
17,"17079",65572,47740,47502,279,238,"PCTC",39
43,"43085",237,190,185,1,5,"PCTC",0
25,"25140",779,540,539,2,1,"PCTC",0
43,"43013",4406,3004,2975,19,29,"PCTC",1
17,"17031",178,117,117,0,0,"PCTC",0
43,"43164",310,235,231,3,4,"PCTC",0
17,"17052",135,93,92,0,1,"PCTC",0
25,"25163",230,162,161,0,1,"PCTC",0
25,"25089",93,70,68,1,2,"PCTC",0
17,"17151",179,131,130,0,1,"PCTC",0
25,"25024",352,248,247,0,1,"PCTC",1
8,"8115",3826,2777,2770,31,7,"PCTC",1
8,"8251",5130,3719,3698,20,21,"PCTC",5
17,"17124",1593,1163,1160,8,3,"PCTC",0
17,"17012",1175,845,842,4,3,"PCTC",5
8,"8245",77841,53719,53443,430,276,"PCTC",38
25,"25903",226,169,169,1,0,"PCTC",0
25,"25913",88,72,72,1,0,"PCTC",0
25,"25033",1120,838,831,5,7,"PCTC",0
8,"8080",40,27,27,3,0,"PCTC",0
25,"25087",54,45,45,0,0,"PCTC",0
8,"8198",4679,3491,3469,12,22,"PCTC",1
8,"8148",2344,1655,1646,13,9,"PCTC",0
8,"8045",65,44,43,0,1,"PCTC",0
43,"43107",387,285,285,3,0,"PCTC",0
25,"25249",176,129,127,2,2,"PCTC",0
25,"25191",321,227,222,2,5,"PCTC",0
17,"17137",3486,2812,2808,15,4,"PCTC",4
8,"8057",61,47,47,1,0,"PCTC",0
17,"17016",737,570,563,2,7,"PCTC",1
8,"8225",94,83,82,1,1,"PCTC",0
43,"43092",7308,4703,4679,33,24,"PCTC",5
8,"8158",3094,2261,2251,11,10,"PCTC",0
43,"43057",38,32,32,1,0,"PCTC",0
43,"43015",115,92,91,1,1,"PCTC",0
17,"17106",142,114,114,0,0,"PCTC",0
8,"8218",8091,5899,5869,50,30,"PCTC",1
25,"25129",161,113,112,0,1,"PCTC",0
25,"25219",146,111,111,1,0,"PCTC",0
17,"17088",599,467,465,3,2,"PCTC",0
43,"43036",869,565,557,7,8,"PCTC",1
25,"25100",184,137,136,1,1,"PCTC",1
17,"17061",180,141,139,1,2,"PCTC",0
43,"43176",746,564,561,2,3,"PCTC",0
17,"17046",709,537,531,2,6,"PCTC",0
25,"25009",596,448,442,1,6,"PCTC",0
17,"17181",3458,2454,2443,18,11,"PCTC",1
8,"8161",11826,8001,7951,58,50,"PCTC",6
43,"43009",1384,966,959,5,7,"PCTC",0
43,"43065",379,281,277,4,4,"PCTC",0
25,"25173",1646,1180,1169,6,11,"PCTC",2
25,"25125",383,265,265,3,0,"PCTC",0
17,"17022",7043,4940,4903,34,37,"PCTC",5
17,"17004",529,411,410,3,1,"PCTC",0
8,"8034",820,644,640,0,4,"PCTC",0
17,"17001",575,428,426,4,2,"PCTC",0
25,"25223",890,673,666,7,7,"PCTC",0
8,"8298",27148,19655,19568,102,87,"PCTC",10
43,"43046",88,69,68,1,1,"PCTC",0
8,"8185",197,162,162,1,0,"PCTC",0
43,"43031",1447,1085,1072,13,13,"PCTC",1
25,"25015",336,234,233,3,1,"PCTC",0
43,"43088",2013,1429,1420,11,9,"PCTC",0
8,"8289",4473,3379,3371,25,8,"PCTC",1
43,"43135",339,255,255,0,0,"PCTC",0
25,"25238",212,161,160,0,1,"PCTC",0
8,"8039",413,322,321,1,1,"PCTC",1
17,"17037",112,86,86,1,0,"PCTC",0
25,"25060",71,42,42,0,0,"PCTC",0
8,"8042",2390,1772,1764,12,8,"PCTC",0
43,"43147",528,425,420,3,5,"PCTC",0
25,"25124",160,102,101,1,1,"PCTC",0
8,"8232",1773,1368,1362,9,6,"PCTC",0
8,"8211",33934,26136,26000,198,136,"PCTC",18
17,"17206",158,111,109,0,2,"PCTC",0
17,"17043",165,133,133,0,0,"PCTC",0
17,"17130",325,270,270,1,0,"PCTC",0
25,"25186",207,162,161,0,1,"PCTC",0
17,"17018",494,377,372,4,5,"PCTC",0
8,"8199",648,509,508,3,1,"PCTC",0
25,"25141",154,105,104,3,1,"PCTC",0
8,"8145",2712,2060,2049,8,11,"PCTC",0
17,"17076",119,95,94,2,1,"PCTC",0
25,"25218",88,76,75,2,1,"PCTC",0
43,"43056",803,566,558,6,8,"PCTC",0
43,"43120",421,256,254,1,2,"PCTC",0
25,"25044",178,144,142,0,2,"PCTC",0
17,"17044",6938,5245,5212,33,33,"PCTC",4
17,"17077",565,395,394,2,1,"PCTC",0
8,"8192",5701,4366,4349,15,17,"PCTC",2
8,"8047",3751,2600,2578,26,22,"PCTC",1
25,"25128",125,85,85,0,0,"PCTC",0
43,"43006",676,462,462,3,0,"PCTC",0
8,"8010",4224,3109,3090,22,19,"PCTC",2
17,"17182",269,195,195,0,0,"PCTC",0
17,"17193",4351,2945,2927,21,18,"PCTC",2
8,"8904",10516,7068,7025,54,43,"PCTC",4
25,"25196",108,75,75,1,0,"PCTC",0
43,"43068",484,322,317,2,5,"PCTC",0
43,"43116",465,356,352,0,4,"PCTC",0
25,"25245",427,312,308,4,4,"PCTC",0
43,"43132",375,295,291,1,4,"PCTC",0
43,"43027",168,129,129,3,0,"PCTC",0
43,"43028",2770,1784,1770,7,14,"PCTC",1
8,"8301",49348,36261,36045,292,216,"PCTC",25
8,"8280",93,76,75,1,1,"PCTC",0
43,"43067",526,426,424,3,2,"PCTC",0
43,"43094",2143,1558,1541,6,17,"PCTC",1
25,"25111",114,86,86,2,0,"PCTC",0
43,"43005",3677,2505,2493,17,12,"PCTC",0
25,"25211",680,470,470,3,0,"PCTC",0
8,"8053",2896,1939,1929,13,10,"PCTC",0
8,"8254",1766,1433,1427,16,6,"PCTC",0
8,"8012",1726,1323,1309,17,14,"PCTC",1
8,"8078",216,154,154,2,0,"PCTC",0
43,"43023",211,171,169,2,2,"PCTC",0
17,"17117",14497,9438,9382,66,56,"PCTC",8
17,"17133",1262,976,964,7,12,"PCTC",1
25,"25077",435,312,312,1,0,"PCTC",0
8,"8178",444,363,361,2,2,"PCTC",0
17,"17005",457,322,320,3,2,"PCTC",1
25,"25121",632,380,374,3,6,"PCTC",0
17,"17009",4068,3061,3050,16,11,"PCTC",1
17,"17161",1023,844,843,5,1,"PCTC",0
25,"25052",1541,1183,1176,7,7,"PCTC",0
17,"17205",209,167,166,0,1,"PCTC",0
8,"8163",19672,13421,13364,70,57,"PCTC",12
8,"8160",317,234,234,0,0,"PCTC",0
25,"25904",160,134,133,2,1,"PCTC",0
25,"25126",281,211,210,1,1,"PCTC",0
17,"17118",12934,8723,8665,38,58,"PCTC",42
25,"25232",1357,1012,1007,6,5,"PCTC",0
25,"25244",374,275,270,1,5,"PCTC",0
17,"17075",340,257,256,2,1,"PCTC",1
17,"17123",343,286,284,2,2,"PCTC",0
8,"8224",885,653,652,6,1,"PCTC",2
43,"43170",877,664,661,4,3,"PCTC",1
25,"25003",3717,2577,2561,15,16,"PCTC",2
17,"17191",163,140,140,1,0,"PCTC",0
25,"25175",173,119,119,2,0,"PCTC",0
17,"17081",252,186,185,2,1,"PCTC",0
25,"25059",800,546,534,5,12,"PCTC",2
43,"43074",1818,1341,1336,2,5,"PCTC",2
25,"25070",817,619,617,11,2,"PCTC",0
8,"8021",60,44,44,1,0,"PCTC",0
8,"8075",4144,2951,2943,20,8,"PCTC",1
25,"25180",227,158,155,1,3,"PCTC",0
8,"8291",4972,3531,3519,23,12,"PCTC",0
43,"43050",2695,1742,1730,10,12,"PCTC",0
8,"8229",521,418,417,3,1,"PCTC",0
8,"8155",7056,5050,5011,38,39,"PCTC",3
8,"8292",1074,796,790,2,6,"PCTC",0
25,"25019",4606,2860,2829,19,31,"PCTC",2
17,"17114",23268,16423,16333,111,90,"PCTC",11
8,"8905",2329,1872,1863,7,9,"PCTC",0
8,"8217",25466,19864,19773,129,91,"PCTC",21
43,"43136",10489,7029,6996,47,33,"PCTC",3
17,"17200",624,469,467,6,2,"PCTC",1
25,"25135",997,675,671,3,4,"PCTC",0
17,"17152",11065,6959,6927,68,32,"PCTC",6
43,"43144",1245,975,966,1,9,"PCTC",0
25,"25093",629,455,443,5,12,"PCTC",0
8,"8156",11254,8440,8411,58,29,"PCTC",7
17,"17013",2765,1999,1985,15,14,"PCTC",6
17,"17223",808,566,563,1,3,"PCTC",0
25,"25206",247,188,188,2,0,"PCTC",0
8,"8213",6600,4925,4906,30,19,"PCTC",1
25,"25105",105,88,87,4,1,"PCTC",0
25,"25075",132,101,101,0,0,"PCTC",0
8,"8143",2727,1989,1977,19,12,"PCTC",2
8,"8182",2922,2041,2031,10,10,"PCTC",0
17,"17145",1410,1040,1032,6,8,"PCTC",3
17,"17154",101,76,76,0,0,"PCTC",0
8,"8286",2943,2051,2042,12,9,"PCTC",1
43,"43084",514,388,383,2,5,"PCTC",0
8,"8214",7007,5390,5371,25,19,"PCTC",1
8,"8044",4156,2991,2976,16,15,"PCTC",0
17,"17196",252,200,200,1,0,"PCTC",0
8,"8274",4640,3385,3363,24,22,"PCTC",2
8,"8001",9097,6860,6818,39,42,"PCTC",6
43,"43098",362,274,274,1,0,"PCTC",0
17,"17175",559,348,343,5,5,"PCTC",1
43,"43138",2636,1761,1745,11,16,"PCTC",1
8,"8149",980,702,694,6,8,"PCTC",1
8,"8284",12597,8244,8183,60,61,"PCTC",4
25,"25179",169,132,132,0,0,"PCTC",0
8,"8287",1067,853,844,4,9,"PCTC",0
8,"8204",3141,2395,2383,16,12,"PCTC",0
43,"43906",2113,1490,1480,12,10,"PCTC",1
25,"25012",2349,1563,1556,17,7,"PCTC",3
25,"25017",228,175,174,0,1,"PCTC",0
8,"8270",19014,13635,13594,74,41,"PCTC",3
17,"17096",159,116,116,3,0,"PCTC",0
25,"25092",125,93,92,0,1,"PCTC",0
8,"8209",6925,4976,4948,39,28,"PCTC",1
8,"8222",1821,1439,1424,7,15,"PCTC",3
25,"25131",394,281,279,3,2,"PCTC",0
25,"25200",318,245,245,0,0,"PCTC",0
17,"17034",7289,4880,4862,23,18,"PCTC",6
25,"25189",2181,1468,1461,11,7,"PCTC",0
8,"8062",1009,778,776,9,2,"PCTC",0
8,"8027",724,584,582,1,2,"PCTC",2
43,"43901",8796,5431,5390,41,41,"PCTC",2
43,"43156",3956,2812,2784,22,28,"PCTC",1
8,"8201",455,319,318,12,1,"PCTC",0
25,"25104",120,88,88,0,0,"PCTC",0
25,"25031",57,32,32,0,0,"PCTC",0
43,"43115",128,106,106,0,0,"PCTC",0
43,"43117",147,119,119,0,0,"PCTC",0
8,"8176",158,119,119,0,0,"PCTC",0
17,"17058",176,128,128,0,0,"PCTC",0
8,"8013",1287,982,972,6,10,"PCTC",0
43,"43055",1970,1548,1535,12,13,"PCTC",3
43,"43097",407,331,328,4,3,"PCTC",0
43,"43001",708,510,507,0,3,"PCTC",1
25,"25171",2117,1539,1534,5,5,"PCTC",1
17,"17209",615,472,471,5,1,"PCTC",0
43,"43058",95,78,78,0,0,"PCTC",0
17,"17204",609,429,428,6,1,"PCTC",0
17,"17184",1261,1016,1010,7,6,"PCTC",0
25,"25127",217,145,145,1,0,"PCTC",0
25,"25222",69,58,58,0,0,"PCTC",0
8,"8252",24885,18507,18383,162,124,"PCTC",10
8,"8259",6979,5362,5341,27,21,"PCTC",3
25,"25908",217,136,136,0,0,"PCTC",0
17,"17010",332,252,251,2,1,"PCTC",0
17,"17160",14756,9892,9852,58,40,"PCTC",7
17,"17093",913,637,634,5,3,"PCTC",0
8,"8002",217,172,172,2,0,"PCTC",0
17,"17134",220,175,174,1,1,"PCTC",0
25,"25170",262,210,210,1,0,"PCTC",16
8,"8121",87515,62961,62574,429,387,"PCTC",38
17,"17234",181,129,129,1,0,"PCTC",0
25,"25057",208,151,149,4,2,"PCTC",0
8,"8207",2026,1667,1659,12,8,"PCTC",0
8,"8162",2118,1581,1576,13,5,"PCTC",1
17,"17032",1745,1139,1133,6,6,"PCTC",0
25,"25183",520,372,370,4,2,"PCTC",0
25,"25210",1073,791,780,3,11,"PCTC",0
25,"25157",159,127,126,1,1,"PCTC",0
8,"8220",2411,2010,2001,8,9,"PCTC",0
8,"8054",9215,6994,6943,38,51,"PCTC",5
43,"43152",435,348,342,2,6,"PCTC",1
8,"8261",2405,1726,1718,11,8,"PCTC",0
17,"17087",219,179,177,0,2,"PCTC",0
17,"17003",103,85,85,0,0,"PCTC",0
8,"8016",1803,1371,1363,11,8,"PCTC",1
25,"25152",148,106,106,0,0,"PCTC",0
25,"25043",800,584,581,2,3,"PCTC",0
25,"25227",656,476,476,2,0,"PCTC",0
43,"43137",1890,1373,1353,8,20,"PCTC",2
43,"43114",370,281,278,1,3,"PCTC",0
25,"25014",246,184,178,0,6,"PCTC",0
17,"17225",205,150,150,1,0,"PCTC",0
43,"43064",2027,1456,1445,19,11,"PCTC",1
25,"25072",5881,4059,4031,30,28,"PCTC",3
17,"17168",373,309,308,3,1,"PCTC",0
8,"8150",258,207,207,1,0,"PCTC",0
25,"25008",1081,803,799,4,4,"PCTC",0
8,"8052",140,102,102,1,0,"PCTC",0
8,"8305",27661,20346,20221,118,125,"PCTC",17
8,"8188",115,89,89,0,0,"PCTC",0
25,"25155",616,446,443,2,3,"PCTC",0
17,"17157",122,104,103,0,1,"PCTC",0
8,"8285",10349,7630,7599,48,31,"PCTC",2
25,"25021",2513,1668,1662,17,6,"PCTC",3
25,"25225",531,395,393,0,2,"PCTC",0
17,"17078",335,245,245,0,0,"PCTC",0
8,"8123",19570,15378,15316,91,62,"PCTC",8
8,"8116",557,449,449,1,0,"PCTC",0
17,"17116",351,261,261,2,0,"PCTC",0
8,"8040",11116,7923,7891,49,32,"PCTC",3
8,"8070",269,215,211,1,4,"PCTC",0
25,"25114",96,83,82,1,1,"PCTC",0
8,"8068",6863,5064,5041,40,23,"PCTC",5
43,"43145",4209,3193,3170,17,23,"PCTC",4
8,"8131",745,552,550,3,2,"PCTC",1
8,"8147",17389,12679,12601,102,78,"PCTC",8
25,"25217",10891,7651,7610,63,41,"PCTC",5
43,"43026",756,576,574,1,2,"PCTC",0
25,"25190",262,202,202,2,0,"PCTC",0
8,"8299",380,301,300,4,1,"PCTC",0
17,"17095",20044,12638,12576,88,62,"PCTC",11
17,"17163",2868,2281,2268,13,13,"PCTC",0
25,"25166",170,131,130,2,1,"PCTC",0
43,"43047",4234,2590,2564,19,26,"PCTC",1
8,"8029",3586,2868,2862,20,6,"PCTC",0
8,"8228",292,234,233,0,1,"PCTC",0
17,"17064",324,249,247,2,2,"PCTC",0
43,"43061",40,27,27,3,0,"PCTC",0
17,"17039",1726,1306,1297,7,9,"PCTC",1
8,"8235",3875,3004,2996,19,8,"PCTC",0
25,"25115",803,601,593,4,8,"PCTC",0
8,"8094",1588,1258,1252,7,6,"PCTC",1
8,"8105",9741,6946,6896,62,50,"PCTC",9
43,"43126",1230,937,933,3,4,"PCTC",0
17,"17128",321,239,238,1,1,"PCTC",1
8,"8137",272,208,207,2,1,"PCTC",0
43,"43123",71435,49166,48873,318,293,"PCTC",24
25,"25029",1590,1190,1185,4,5,"PCTC",0
43,"43133",5627,3794,3773,31,21,"PCTC",1
17,"17019",1780,1403,1393,5,10,"PCTC",0
17,"17073",1939,1649,1640,11,9,"PCTC",2
43,"43121",593,404,403,1,1,"PCTC",0
43,"43103",908,705,701,9,4,"PCTC",0
17,"17230",504,383,382,3,1,"PCTC",0
8,"8134",848,618,609,4,9,"PCTC",0
25,"25006",319,229,229,2,0,"PCTC",0
43,"43104",1767,1285,1271,4,14,"PCTC",2
8,"8249",274,238,237,0,1,"PCTC",0
43,"43078",835,610,605,7,5,"PCTC",0
8,"8295",11290,8091,8054,72,37,"PCTC",1
8,"8272",164,128,128,1,0,"PCTC",0
17,"17020",3677,2851,2835,14,16,"PCTC",1
25,"25067",702,500,494,8,6,"PCTC",0
8,"8114",18838,13519,13442,81,77,"PCTC",3
25,"25097",89,71,71,2,0,"PCTC",0
8,"8293",227,177,177,0,0,"PCTC",0
43,"43154",126,104,104,0,0,"PCTC",0
25,"25182",1043,763,760,8,3,"PCTC",1
25,"25164",353,259,255,0,4,"PCTC",0
25,"25205",563,412,407,3,5,"PCTC",0
43,"43010",334,262,262,2,0,"PCTC",0
17,"17136",196,150,150,0,0,"PCTC",0
17,"17226",884,603,600,4,3,"PCTC",0
25,"25151",731,555,549,1,6,"PCTC",0
17,"17207",2420,1920,1901,9,19,"PCTC",2
17,"17192",143,107,104,0,3,"PCTC",1
25,"25172",1762,1332,1323,8,9,"PCTC",1
43,"43149",690,512,509,3,3,"PCTC",0
8,"8304",822,655,655,5,0,"PCTC",0
25,"25069",426,296,294,0,2,"PCTC",0
17,"17024",281,203,201,4,2,"PCTC",0
8,"8297",138,99,99,0,0,"PCTC",1
17,"17165",645,502,502,2,0,"PCTC",1
25,"25045",57,26,26,2,0,"PCTC",0
8,"8090",142,116,116,0,0,"PCTC",0
25,"25082",292,197,197,2,0,"PCTC",0
8,"8241",70,52,52,0,0,"PCTC",0
8,"8118",17634,13450,13402,80,48,"PCTC",8
43,"43106",784,605,598,3,7,"PCTC",0
43,"43062",269,229,226,5,3,"PCTC",0
8,"8113",52589,36864,36690,244,174,"PCTC",21
8,"8206",744,604,599,5,5,"PCTC",0
25,"25216",244,186,186,0,0,"PCTC",0
43,"43080",230,192,192,2,0,"PCTC",0
43,"43159",76,60,60,0,0,"PCTC",0
43,"43907",4386,3083,3067,24,16,"PCTC",1
8,"8139",172,148,147,2,1,"PCTC",0
25,"25139",477,348,346,3,2,"PCTC",0
8,"8237",1644,1263,1254,9,9,"PCTC",0
43,"43162",4436,3191,3163,24,28,"PCTC",0
8,"8250",7235,4917,4876,41,41,"PCTC",4
25,"25013",2099,1430,1414,13,16,"PCTC",1
43,"43040",325,268,267,1,1,"PCTC",0
43,"43110",247,178,178,2,0,"PCTC",0
43,"43905",15100,9689,9630,43,59,"PCTC",4
8,"8028",1125,744,743,7,1,"PCTC",0
8,"8258",815,636,632,5,4,"PCTC",0
17,"17121",225,166,163,2,3,"PCTC",0
43,"43030",483,356,351,2,5,"PCTC",0
25,"25037",361,270,269,4,1,"PCTC",0
43,"43091",125,90,90,1,0,"PCTC",0
25,"25138",558,427,424,2,3,"PCTC",1
17,"17213",5567,3654,3630,19,24,"PCTC",0
43,"43112",245,179,179,3,0,"PCTC",0
17,"17166",547,442,440,0,2,"PCTC",1
8,"8059",340,255,250,1,5,"PCTC",0
43,"43024",1545,1019,1014,14,5,"PCTC",0
17,"17144",211,162,159,3,3,"PCTC",0
8,"8253",132,103,102,0,1,"PCTC",0
17,"17107",267,207,205,2,2,"PCTC",0
43,"43079",364,290,289,2,1,"PCTC",1
17,"17030",654,460,459,1,1,"PCTC",0
8,"8281",4858,3783,3762,19,21,"PCTC",0
17,"17083",2971,2164,2154,13,10,"PCTC",1
8,"8089",34190,24548,24404,194,144,"PCTC",25
25,"25056",209,145,145,0,0,"PCTC",0
17,"17028",297,216,214,2,2,"PCTC",0
43,"43070",243,194,193,0,1,"PCTC",0
8,"8226",929,748,747,10,1,"PCTC",0
25,"25133",671,481,479,1,2,"PCTC",0
17,"17069",359,270,267,2,3,"PCTC",0
43,"43021",349,245,243,2,2,"PCTC",0
17,"17119",71,53,52,3,1,"PCTC",0
8,"8177",36,27,27,1,0,"PCTC",0
8,"8262",6945,4649,4599,38,50,"PCTC",4
25,"25102",647,484,482,5,2,"PCTC",0
8,"8043",3414,2429,2422,15,7,"PCTC",1
25,"25041",525,375,370,4,5,"PCTC",0
8,"8085",986,769,767,6,2,"PCTC",0
43,"43165",571,469,467,2,2,"PCTC",1
17,"17188",171,134,134,1,0,"PCTC",0
8,"8025",1573,1170,1160,9,10,"PCTC",1
43,"43177",276,229,227,2,2,"PCTC",0
8,"8296",1869,1412,1408,10,4,"PCTC",1
17,"17901",987,733,725,5,8,"PCTC",0
25,"25063",84,52,51,0,1,"PCTC",0
43,"43049",727,557,555,3,2,"PCTC",0
25,"25036",180,124,124,1,0,"PCTC",0
17,"17135",393,307,303,0,4,"PCTC",0
17,"17021",119,89,87,0,2,"PCTC",0
17,"17100",193,147,141,0,6,"PCTC",0
8,"8236",1564,1145,1133,4,12,"PCTC",0
8,"8024",357,282,282,2,0,"PCTC",0
17,"17159",622,459,459,1,0,"PCTC",1
8,"8165",1680,1177,1171,7,6,"PCTC",0
17,"17048",6284,4077,4048,34,29,"PCTC",2
43,"43131",4827,3134,3116,32,18,"PCTC",1
17,"17042",410,299,297,5,2,"PCTC",0
8,"8279",156327,112605,112030,952,575,"PCTC",70
43,"43069",183,148,147,2,1,"PCTC",0
8,"8153",573,457,452,3,5,"PCTC",0
8,"8187",153822,113081,112470,758,611,"PCTC",65
8,"8023",7029,5027,5000,39,27,"PCTC",0
17,"17080",144,113,113,1,0,"PCTC",0
17,"17014",66,51,49,0,2,"PCTC",0
25,"25061",80,51,51,0,0,"PCTC",0
25,"25096",885,597,591,2,6,"PCTC",0
17,"17063",179,153,149,0,4,"PCTC",0
8,"8221",12793,10123,10079,73,44,"PCTC",4
17,"17090",539,440,440,2,0,"PCTC",0
17,"17025",1182,943,938,5,5,"PCTC",0
8,"8256",693,542,542,3,0,"PCTC",0
43,"43076",454,336,335,1,1,"PCTC",0
43,"43155",22586,15295,15204,120,91,"PCTC",4
8,"8227",2420,1775,1769,11,6,"PCTC",2
25,"25252",553,380,379,2,1,"PCTC",0
8,"8030",5208,4045,4033,25,12,"PCTC",0
17,"17035",544,447,447,2,0,"PCTC",0
17,"17099",78,55,55,0,0,"PCTC",0
25,"25062",691,498,491,4,7,"PCTC",0
43,"43153",11197,7685,7649,53,36,"PCTC",5
25,"25137",8684,5802,5757,48,45,"PCTC",5
43,"43014",14386,9542,9464,74,78,"PCTC",6
17,"17067",704,551,549,6,2,"PCTC",1
17,"17164",3918,2856,2838,17,18,"PCTC",0
43,"43134",281,217,215,5,2,"PCTC",0
43,"43174",144,118,114,0,4,"PCTC",0
43,"43075",86,65,63,0,2,"PCTC",0
25,"25907",500,366,364,5,2,"PCTC",0
25,"25098",227,160,158,1,2,"PCTC",0
17,"17215",2286,1855,1844,13,11,"PCTC",0
43,"43109",2706,1751,1738,17,13,"PCTC",0
43,"43035",233,182,182,5,0,"PCTC",0
8,"8223",1897,1345,1341,10,4,"PCTC",0
25,"25040",10651,7041,6987,57,54,"PCTC",3
8,"8087",144,120,120,0,0,"PCTC",0
17,"17086",1769,1116,1109,6,7,"PCTC",1
17,"17187",625,496,492,3,4,"PCTC",0
25,"25074",179,155,151,2,4,"PCTC",0
8,"8122",1733,1179,1175,4,4,"PCTC",0
43,"43111",2129,1412,1401,8,11,"PCTC",0
25,"25177",356,252,250,1,2,"PCTC",1
8,"8194",25680,16465,16376,131,89,"PCTC",18
25,"25174",390,312,312,1,0,"PCTC",2
43,"43032",462,354,350,2,4,"PCTC",0
17,"17177",562,426,423,1,3,"PCTC",0
25,"25027",978,695,690,3,5,"PCTC",0
8,"8009",9531,7200,7171,47,29,"PCTC",2
25,"25035",364,257,256,0,1,"PCTC",0
25,"25038",1478,1057,1048,10,9,"PCTC",0
8,"8112",12926,9268,9230,61,38,"PCTC",6
17,"17150",1444,1177,1163,13,14,"PCTC",1
8,"8082",1164,796,780,5,16,"PCTC",0
43,"43127",775,607,606,3,1,"PCTC",0
8,"8108",5181,3880,3861,30,19,"PCTC",1
25,"25242",688,494,488,5,6,"PCTC",1
17,"17060",409,300,298,1,2,"PCTC",0
43,"43022",1436,1028,1024,13,4,"PCTC",0
25,"25192",727,527,524,4,3,"PCTC",1
8,"8902",3941,2974,2962,16,12,"PCTC",1
43,"43008",305,171,171,7,0,"PCTC",0
25,"25076",131,91,91,0,0,"PCTC",0
25,"25073",559,377,377,2,0,"PCTC",0
17,"17040",551,440,439,5,1,"PCTC",1
25,"25220",991,768,762,1,6,"PCTC",0
8,"8111",216,195,194,2,1,"PCTC",0
8,"8275",247,218,218,3,0,"PCTC",0
8,"8081",349,274,270,0,4,"PCTC",0
43,"43122",112,91,91,1,0,"PCTC",0
8,"8238",14946,11911,11873,85,38,"PCTC",3
8,"8190",255,184,182,1,2,"PCTC",0
25,"25906",205,133,131,2,2,"PCTC",0
8,"8231",21269,14655,14573,111,82,"PCTC",12
8,"8181",8133,5949,5924,31,25,"PCTC",1
17,"17201",137,103,103,0,0,"PCTC",0
17,"17195",338,274,272,1,2,"PCTC",0
8,"8072",10769,7632,7600,56,32,"PCTC",4
17,"17153",189,150,149,1,1,"PCTC",0
25,"25910",91,63,63,0,0,"PCTC",0
25,"25207",6443,4525,4492,31,33,"PCTC",0
25,"25169",170,117,117,5,0,"PCTC",0
8,"8268",975,729,723,6,6,"PCTC",0
8,"8184",55053,38519,38323,298,196,"PCTC",19
8,"8266",43422,32827,32696,241,131,"PCTC",29
17,"17062",5982,4025,4001,19,24,"PCTC",5
25,"25149",1377,1034,1028,9,6,"PCTC",0
8,"8195",75,62,62,0,0,"PCTC",0
25,"25228",3143,2261,2250,18,11,"PCTC",0
8,"8060",139,110,108,1,2,"PCTC",0
25,"25167",223,165,164,3,1,"PCTC",0
8,"8234",3443,2561,2550,15,11,"PCTC",3
8,"8164",936,750,747,6,3,"PCTC",0
17,"17007",1763,1367,1359,9,8,"PCTC",0
17,"17089",5749,3973,3949,17,24,"PCTC",0
8,"8154",697,541,539,3,2,"PCTC",0
43,"43048",768,564,554,7,10,"PCTC",1
8,"8095",66,49,49,0,0,"PCTC",0
17,"17054",342,250,250,2,0,"PCTC",0
8,"8247",982,799,798,4,1,"PCTC",0
43,"43016",3470,2547,2508,15,39,"PCTC",0
43,"43130",169,131,130,2,1,"PCTC",0
43,"43042",2215,1723,1710,18,13,"PCTC",0
25,"25025",1362,909,898,15,11,"PCTC",0
8,"8255",133,100,100,2,0,"PCTC",0
17,"17214",714,516,511,6,5,"PCTC",0
17,"17170",173,140,140,2,0,"PCTC",0
43,"43017",112,94,94,1,0,"PCTC",0
25,"25185",680,452,451,0,1,"PCTC",0
8,"8278",4925,3820,3804,22,16,"PCTC",3
17,"17111",984,728,728,7,0,"PCTC",0
25,"25247",142,89,89,2,0,"PCTC",0
8,"8099",753,529,529,4,0,"PCTC",0
43,"43175",534,363,359,5,4,"PCTC",0
17,"17038",377,303,301,0,2,"PCTC",1
25,"25120",92888,62740,62389,450,351,"PCTC",39
25,"25002",465,324,323,4,1,"PCTC",0
25,"25064",96,78,78,0,0,"PCTC",0
17,"17051",202,161,160,0,1,"PCTC",0
25,"25208",337,242,241,2,1,"PCTC",2
8,"8127",2254,1548,1544,10,4,"PCTC",0
25,"25181",172,137,137,1,0,"PCTC",0
17,"17183",253,197,197,2,0,"PCTC",0
8,"8117",2489,1954,1941,21,13,"PCTC",3
8,"8005",6425,4830,4816,28,14,"PCTC",3
8,"8263",21208,15014,14890,111,124,"PCTC",6
8,"8124",37157,27139,26994,179,145,"PCTC",18
8,"8248",5687,4187,4165,21,22,"PCTC",2
17,"17036",2639,1944,1934,21,10,"PCTC",1
43,"43007",631,479,474,1,5,"PCTC",0
8,"8067",5746,4299,4270,24,29,"PCTC",5
25,"25254",704,511,508,2,3,"PCTC",0
43,"43053",186,135,134,0,1,"PCTC",0
17,"17092",3462,2414,2389,14,25,"PCTC",2
25,"25905",366,281,276,4,5,"PCTC",0
17,"17071",1134,943,940,1,3,"PCTC",2
17,"17033",5647,3879,3852,25,27,"PCTC",3
43,"43077",453,306,304,1,2,"PCTC",0
43,"43083",146,110,109,0,1,"PCTC",0
17,"17148",1550,1121,1114,15,7,"PCTC",3
25,"25234",4139,2786,2772,13,14,"PCTC",1
17,"17202",3848,2632,2615,16,17,"PCTC",3
43,"43051",9194,6133,6048,44,85,"PCTC",2
25,"25053",1100,819,811,7,8,"PCTC",0
17,"17221",4138,2999,2988,23,11,"PCTC",0
17,"17023",27314,18677,18546,117,131,"PCTC",13
17,"17203",165,126,126,0,0,"PCTC",0
17,"17143",145,104,104,0,0,"PCTC",0
43,"43157",339,279,279,1,0,"PCTC",0
8,"8020",5243,4117,4100,29,17,"PCTC",1
8,"8088",12347,9316,9270,75,46,"PCTC",2
43,"43105",155,126,123,4,3,"PCTC",0
8,"8903",201,181,181,1,0,"PCTC",0
17,"17138",836,591,584,7,7,"PCTC",0
25,"25046",410,331,326,4,5,"PCTC",0
8,"8046",13541,10510,10455,73,55,"PCTC",8
17,"17210",572,414,411,2,3,"PCTC",0
25,"25224",122,94,94,0,0,"PCTC",1
8,"8166",964,700,697,7,3,"PCTC",0
25,"25055",163,114,114,0,0,"PCTC",0
8,"8246",1692,1345,1340,7,5,"PCTC",0
17,"17070",110,87,87,0,0,"PCTC",0
8,"8197",7986,5829,5805,37,24,"PCTC",4
8,"8157",8574,6514,6472,47,42,"PCTC",1
8,"8074",11190,7698,7651,51,47,"PCTC",2
8,"8109",207,176,174,0,2,"PCTC",0
17,"17126",316,269,269,1,0,"PCTC",0
8,"8901",240,200,195,2,5,"PCTC",0
8,"8055",542,426,424,3,2,"PCTC",0
43,"43018",384,297,297,2,0,"PCTC",0
8,"8110",13671,9362,9311,60,51,"PCTC",9
17,"17112",198,148,147,3,1,"PCTC",0
8,"8257",103,82,82,0,0,"PCTC",0
43,"43903",2332,1502,1487,18,15,"PCTC",0
8,"8049",1309,910,903,3,7,"PCTC",0
43,"43059",250,193,192,1,1,"PCTC",0
17,"17027",2857,2236,2229,9,7,"PCTC",0
17,"17115",276,208,208,4,0,"PCTC",0
8,"8065",1183,920,913,8,7,"PCTC",2
8,"8168",388,280,279,3,1,"PCTC",0
8,"8066",1466,1109,1104,7,5,"PCTC",0
17,"17103",5057,3196,3174,21,22,"PCTC",2
8,"8126",8906,6673,6646,41,27,"PCTC",3
8,"8035",13006,8957,8918,50,39,"PCTC",5
17,"17082",435,308,307,1,1,"PCTC",1
25,"25007",1378,1010,999,12,11,"PCTC",0
8,"8180",27198,19822,19704,160,118,"PCTC",17
43,"43113",387,305,303,1,2,"PCTC",0
25,"25112",269,205,200,2,5,"PCTC",0
8,"8183",4573,3406,3398,14,8,"PCTC",2
43,"43160",1324,967,956,6,11,"PCTC",0
17,"17197",128,97,97,0,0,"PCTC",0
43,"43128",910,665,658,6,7,"PCTC",1
17,"17097",200,170,167,2,3,"PCTC",0
43,"43163",26162,17276,17128,98,148,"PCTC",14
43,"43140",2433,1685,1674,11,11,"PCTC",3
43,"43158",74,52,50,0,2,"PCTC",0
25,"25051",1522,1066,1059,6,7,"PCTC",1
43,"43029",312,241,240,1,1,"PCTC",0
17,"17198",437,307,306,0,1,"PCTC",0
8,"8014",2013,1526,1521,4,5,"PCTC",1
8,"8097",1103,845,840,4,5,"PCTC",0
8,"8269",2729,2114,2105,9,9,"PCTC",0
25,"25016",2083,1404,1399,3,5,"PCTC",0
25,"25912",841,620,619,5,1,"PCTC",0
8,"8071",249,209,208,0,1,"PCTC",0
43,"43904",2864,1881,1851,20,30,"PCTC",2
8,"8018",2540,1862,1855,7,7,"PCTC",1
8,"8170",442,322,320,0,2,"PCTC",0
8,"8171",2046,1520,1510,13,10,"PCTC",0
25,"25081",281,195,193,3,2,"PCTC",0
25,"25165",271,210,208,0,2,"PCTC",0
25,"25099",1285,908,904,6,4,"PCTC",0
17,"17233",2347,1853,1840,11,13,"PCTC",0
43,"43071",896,652,647,3,5,"PCTC",0
43,"43172",334,248,243,4,5,"PCTC",0
25,"25004",582,437,432,3,5,"PCTC",1
17,"17149",370,302,300,1,2,"PCTC",0
17,"17041",217,150,146,1,4,"PCTC",0
17,"17147",7916,5672,5641,41,31,"PCTC",3
43,"43034",465,365,365,5,0,"PCTC",0
8,"8031",2339,1760,1750,15,10,"PCTC",0
25,"25909",138,99,98,2,1,"PCTC",0
25,"25085",141,109,108,2,1,"PCTC",0
43,"43139",2007,1432,1419,9,13,"PCTC",0
17,"17139",1407,1128,1119,8,9,"PCTC",0
17,"17232",146,111,111,0,0,"PCTC",0
17,"17008",3605,2595,2577,8,18,"PCTC",0
8,"8174",388,322,318,2,4,"PCTC",0
25,"25023",4560,3350,3334,24,16,"PCTC",2
43,"43052",927,680,674,7,6,"PCTC",0
25,"25168",496,399,399,6,0,"PCTC",0
8,"8119",6897,5096,5052,31,44,"PCTC",4
17,"17218",576,456,451,3,5,"PCTC",1
17,"17155",14957,9519,9410,71,109,"PCTC",6
25,"25042",204,149,149,5,0,"PCTC",0
25,"25202",108,72,72,2,0,"PCTC",0
8,"8064",1956,1439,1423,7,16,"PCTC",0
8,"8079",333,260,258,2,2,"PCTC",0
25,"25221",115,82,81,1,1,"PCTC",0
25,"25248",870,676,675,5,1,"PCTC",0
25,"25030",117,76,76,0,0,"PCTC",0
17,"17085",293,239,238,0,1,"PCTC",0
8,"8051",18570,14112,14054,86,58,"PCTC",2
43,"43041",216,156,156,2,0,"PCTC",0
25,"25215",339,249,249,5,0,"PCTC",0
17,"17132",1344,1019,1009,12,10,"PCTC",0
8,"8306",535,368,368,5,0,"PCTC",0
8,"8135",6770,5187,5158,42,29,"PCTC",3
25,"25239",582,330,330,3,0,"PCTC",0
43,"43081",629,500,499,2,1,"PCTC",0
17,"17169",2511,1901,1890,8,11,"PCTC",0
8,"8240",9469,7351,7327,39,24,"PCTC",4
8,"8128",579,428,423,4,5,"PCTC",0
25,"25240",1366,1030,1021,4,9,"PCTC",0
25,"25086",525,410,407,3,3,"PCTC",0
8,"8061",1628,1154,1151,15,3,"PCTC",0
8,"8083",1672,1433,1430,6,3,"PCTC",0
25,"25145",75,59,59,0,0,"PCTC",0
25,"25071",41,31,30,0,1,"PCTC",0
43,"43125",884,658,645,12,13,"PCTC",2
8,"8033",13262,9887,9833,64,54,"PCTC",5
43,"43166",1646,1183,1176,4,7,"PCTC",0
8,"8230",7648,5797,5774,40,23,"PCTC",1
8,"8242",223,159,159,0,0,"PCTC",0
17,"17065",321,264,263,3,1,"PCTC",0
8,"8050",139,118,115,4,3,"PCTC",0
25,"25197",140,109,109,0,0,"PCTC",0
43,"43043",3317,2457,2445,12,12,"PCTC",0
17,"17176",128,111,111,0,0,"PCTC",0
25,"25901",289,214,211,4,3,"PCTC",0
43,"43096",97,76,76,0,0,"PCTC",0
8,"8038",1541,1129,1120,6,9,"PCTC",1
17,"17091",391,296,290,3,6,"PCTC",0
17,"17074",536,403,401,1,2,"PCTC",0
8,"8102",28940,21108,21014,157,94,"PCTC",9
17,"17189",1481,1228,1223,5,5,"PCTC",0
8,"8008",175,136,136,2,0,"PCTC",0
17,"17050",664,554,550,10,4,"PCTC",0
8,"8003",7213,5425,5409,41,16,"PCTC",0
43,"43129",4607,3284,3261,21,23,"PCTC",3
17,"17212",145,111,109,0,2,"PCTC",0
25,"25010",194,138,136,0,2,"PCTC",0
25,"25119",2258,1701,1686,11,15,"PCTC",0
8,"8179",636,466,465,2,1,"PCTC",1
17,"17140",635,506,505,2,1,"PCTC",0
17,"17102",556,398,396,1,2,"PCTC",0
8,"8056",42897,30873,30757,259,116,"PCTC",17
8,"8069",3323,2555,2540,21,15,"PCTC",1
8,"8058",1808,1280,1262,6,18,"PCTC",0
17,"17098",308,232,230,4,2,"PCTC",0
43,"43178",1435,1071,1066,2,5,"PCTC",0
43,"43003",349,257,255,3,2,"PCTC",0
8,"8172",20543,15191,15140,85,51,"PCTC",3
8,"8120",7129,5649,5621,51,28,"PCTC",2
17,"17180",8508,5977,5953,38,24,"PCTC",1
8,"8210",4640,3226,3200,24,26,"PCTC",1
8,"8096",43926,32120,31960,217,160,"PCTC",30
8,"8189",119,96,96,1,0,"PCTC",0
25,"25146",223,158,155,3,3,"PCTC",0
17,"17171",177,138,137,0,1,"PCTC",0
43,"43020",2291,1712,1688,19,24,"PCTC",2
43,"43099",284,214,214,4,0,"PCTC",0
8,"8104",657,496,493,4,3,"PCTC",0
25,"25109",211,155,154,1,1,"PCTC",1
8,"8202",12943,9408,9358,58,50,"PCTC",6
17,"17129",143,108,108,2,0,"PCTC",1
25,"25231",483,387,385,0,2,"PCTC",0
25,"25011",5271,3529,3505,21,24,"PCTC",1
17,"17174",164,130,130,4,0,"PCTC",0
43,"43044",3962,2751,2719,33,32,"PCTC",2
25,"25148",224,158,158,0,0,"PCTC",0
8,"8086",14137,9971,9912,77,59,"PCTC",5
25,"25156",765,571,567,3,4,"PCTC",0
43,"43025",591,448,443,4,5,"PCTC",0
8,"8212",491,393,386,6,7,"PCTC",0
25,"25243",3729,2370,2349,33,21,"PCTC",3
43,"43038",22070,15127,15018,113,109,"PCTC",10
8,"8130",110,81,81,2,0,"PCTC",0
17,"17120",823,560,558,5,2,"PCTC",0
25,"25058",4345,3058,3045,13,13,"PCTC",0
25,"25034",2271,1616,1600,12,16,"PCTC",0
43,"43146",40,32,32,0,0,"PCTC",0
17,"17141",6019,3855,3833,43,22,"PCTC",2
17,"17094",1058,757,747,3,10,"PCTC",1
43,"43066",158,108,108,1,0,"PCTC",0
17,"17228",285,218,217,0,1,"PCTC",0
8,"8007",6795,5099,5081,29,18,"PCTC",1
25,"25143",82,63,62,0,1,"PCTC",0
17,"17002",578,477,474,2,3,"PCTC",1
8,"8215",2617,1954,1946,22,8,"PCTC",1
8,"8107",11965,8604,8554,67,50,"PCTC",7
25,"25255",390,301,301,0,0,"PCTC",0
17,"17222",104,87,87,1,0,"PCTC",0
43,"43169",445,388,388,3,0,"PCTC",0
25,"25094",138,96,93,2,3,"PCTC",0
25,"25253",147,118,117,0,1,"PCTC",0
8,"8276",241,179,179,3,0,"PCTC",0
8,"8294",2093,1546,1534,11,12,"PCTC",1
8,"8205",61957,49325,49196,441,129,"PCTC",9
17,"17026",549,421,415,3,6,"PCTC",1
8,"8036",163,122,122,0,0,"PCTC",0
17,"17194",73,56,56,0,0,"PCTC",0
8,"8015",156540,109145,108440,957,705,"PCTC",81
17,"17186",3834,2980,2954,17,26,"PCTC",2
43,"43148",91182,65076,64756,441,320,"PCTC",32
43,"43011",1086,862,860,5,2,"PCTC",0
8,"8076",16526,11988,11893,90,95,"PCTC",5
25,"25201",110,81,81,0,0,"PCTC",0
8,"8273",2390,1871,1855,14,16,"PCTC",1
25,"25193",768,567,563,4,4,"PCTC",0
8,"8019",1122912,824423,821037,5287,3386,"PCTC",349
17,"17055",142,124,124,0,0,"PCTC",0
25,"25154",117,86,85,0,1,"PCTC",0
8,"8132",356,265,265,1,0,"PCTC",0
17,"17185",2260,1657,1652,8,5,"PCTC",0
43,"43151",107,88,88,0,0,"PCTC",0
8,"8091",5428,4048,4024,20,24,"PCTC",3
17,"17110",1332,990,981,3,9,"PCTC",0
8,"8288",1696,1103,1096,9,7,"PCTC",3
25,"25123",189,135,133,0,2,"PCTC",0
25,"25204",1187,858,849,13,9,"PCTC",0
25,"25048",1641,1207,1194,13,13,"PCTC",2
8,"8167",6056,4520,4500,38,20,"PCTC",4
25,"25005",269,193,193,3,0,"PCTC",0
8,"8243",154,125,125,2,0,"PCTC",0
8,"8125",25583,18334,18225,122,109,"PCTC",5
8,"8017",2808,2033,2016,16,17,"PCTC",1
25,"25250",327,269,265,1,4,"PCTC",0
25,"25020",270,202,201,2,1,"PCTC",1
43,"43060",2672,2032,2015,7,17,"PCTC",2
8,"8142",136,117,117,3,0,"PCTC",0
43,"43037",18216,11749,11672,70,77,"PCTC",6
8,"8219",15755,12235,12206,72,29,"PCTC",4
43,"43168",83,55,55,1,0,"PCTC",0
8,"8271",66,48,47,2,1,"PCTC",0
8,"8140",4816,3541,3520,25,21,"PCTC",2
43,"43142",1069,783,774,3,9,"PCTC",1
17,"17162",153,106,105,1,1,"PCTC",1
25,"25079",276,202,202,0,0,"PCTC",0
25,"25176",307,241,238,3,3,"PCTC",0
8,"8203",2466,1678,1675,7,3,"PCTC",1
43,"43102",458,331,324,2,7,"PCTC",0
8,"8265",1597,1262,1260,4,2,"PCTC",0
25,"25233",289,219,218,6,1,"PCTC",0
8,"8103",652,476,474,1,2,"PCTC",0
43,"43090",1199,689,686,5,3,"PCTC",1
17,"17167",2585,2015,1998,11,17,"PCTC",0
25,"25088",96,73,73,0,0,"PCTC",0
8,"8260",18515,13563,13487,84,76,"PCTC",9
8,"8283",6165,4546,4524,33,22,"PCTC",1
25,"25230",1541,1105,1099,9,6,"PCTC",0
25,"25001",143,102,102,1,0,"PCTC",0
43,"43119",849,591,588,8,3,"PCTC",0
8,"8006",11774,8375,8329,53,46,"PCTC",3
5,"5072",92,74,72,1,2,"PCTE",0
41,"41076",2134,1246,1230,11,16,"PCTE",1
40,"40145",1098,824,820,4,4,"PCTE",0
26,"26078",86,63,63,0,0,"PCTE",0
19,"19133",78,64,64,2,0,"PCTE",0
45,"45901",779,542,534,5,8,"PCTE",0
16,"16266",356,269,265,4,4,"PCTE",0
47,"47182",1328,940,934,8,6,"PCTE",0
47,"47046",124,99,99,1,0,"PCTE",0
5,"5105",330,247,242,2,5,"PCTE",0
41,"41029",13520,9849,9663,134,186,"PCTE",3
26,"26163",126,104,104,1,0,"PCTE",0
37,"37321",150,118,115,0,3,"PCTE",0
18,"18126",1436,1024,1002,9,22,"PCTE",0
23,"23051",2736,2066,2021,16,45,"PCTE",0
22,"22222",516,379,377,6,2,"PCTE",1
47,"47025",114,85,85,3,0,"PCTE",0
47,"47058",199,126,125,3,1,"PCTE",0
9,"9172",131,88,88,1,0,"PCTE",0
9,"9070",33,28,27,0,1,"PCTE",0
50,"50141",104,80,78,0,2,"PCTE",0
49,"49251",159,116,109,2,7,"PCTE",1
45,"45202",3963,2806,2771,10,35,"PCTE",3
45,"45071",1779,1374,1342,7,32,"PCTE",0
19,"19013",111,89,89,0,0,"PCTE",1
22,"22209",161,121,121,3,0,"PCTE",1
22,"22206",179,138,137,0,1,"PCTE",1
18,"18049",588,418,415,4,3,"PCTE",0
19,"19218",43,31,31,0,0,"PCTE",0
19,"19212",678,501,491,1,10,"PCTE",0
9,"9100",55,33,33,0,0,"PCTE",0
21,"21021",12545,7816,7696,104,120,"PCTE",4
16,"16007",1153,857,847,3,10,"PCTE",0
29,"29084",27199,18102,17800,268,302,"PCTE",4
18,"18151",261,167,166,4,1,"PCTE",0
37,"37014",1140,747,737,7,10,"PCTE",1
19,"19115",29,23,23,0,0,"PCTE",0
19,"19309",20,15,14,0,1,"PCTE",0
18,"18020",489,318,310,2,8,"PCTE",0
50,"50151",607,450,449,12,1,"PCTE",0
5,"5069",73,59,59,0,0,"PCTE",0
50,"50026",418,292,288,4,4,"PCTE",0
34,"34156",51,42,42,0,0,"PCTE",0
24,"24028",367,275,273,5,2,"PCTE",0
5,"5101",266,206,205,1,1,"PCTE",0
22,"22203",77,62,62,2,0,"PCTE",0
24,"24129",114,79,78,2,1,"PCTE",0
22,"22075",116,71,69,1,2,"PCTE",0
22,"22903",618,484,482,5,2,"PCTE",1
28,"28160",8709,6507,6460,62,47,"PCTE",4
40,"40080",51,31,31,0,0,"PCTE",0
9,"9437",266,207,203,4,4,"PCTE",1
37,"37282",193,132,131,3,1,"PCTE",0
19,"19064",64,56,56,0,0,"PCTE",0
5,"5046",38,35,35,0,0,"PCTE",0
50,"50012",94,76,72,0,4,"PCTE",0
19,"19039",56,48,48,2,0,"PCTE",0
19,"19250",16,12,12,0,0,"PCTE",0
40,"40082",104,84,84,2,0,"PCTE",0
34,"34151",148,98,96,1,2,"PCTE",0
19,"19303",41,32,32,0,0,"PCTE",0
37,"37307",146,94,91,1,3,"PCTE",0
18,"18036",3986,2956,2917,22,39,"PCTE",0
39,"39075",136789,95707,95089,478,618,"PCTE",52
40,"40089",209,155,148,2,7,"PCTE",2
5,"5036",118,91,90,0,1,"PCTE",0
41,"41064",5602,3520,3417,56,103,"PCTE",0
34,"34092",257,189,189,1,0,"PCTE",0
19,"19002",55,45,45,0,0,"PCTE",0
28,"28180",5317,4011,3959,35,52,"PCTE",1
42,"42177",61,42,41,0,1,"PCTE",0
50,"50244",192,131,130,1,1,"PCTE",0
45,"45127",775,510,502,1,8,"PCTE",1
39,"39093",297,216,214,1,2,"PCTE",0
49,"49204",58,44,43,1,1,"PCTE",0
23,"23052",1094,920,896,6,24,"PCTE",0
37,"37028",131,96,93,2,3,"PCTE",0
40,"40051",34,25,25,0,0,"PCTE",0
24,"24081",121,72,72,0,0,"PCTE",0
33,"33013",430,294,292,1,2,"PCTE",0
45,"45100",178,141,138,0,3,"PCTE",0
16,"16060",715,519,513,3,6,"PCTE",0
40,"40055",31,26,26,0,0,"PCTE",0
37,"37245",331,221,220,4,1,"PCTE",0
39,"39005",1419,1039,1030,9,9,"PCTE",0
42,"42018",127,94,94,1,0,"PCTE",0
37,"37339",295,219,219,5,0,"PCTE",0
29,"29054",42538,28080,27814,225,266,"PCTE",15
9,"9386",55,43,43,0,0,"PCTE",0
41,"41082",3354,2545,2507,11,38,"PCTE",1
18,"18037",535,417,410,2,7,"PCTE",0
9,"9242",66,53,52,3,1,"PCTE",0
9,"9400",307,225,224,4,1,"PCTE",0
18,"18011",4403,3002,2947,24,55,"PCTE",1
49,"49015",198,156,155,0,1,"PCTE",0
40,"40122",524,398,392,2,6,"PCTE",0
9,"9017",89,61,60,3,1,"PCTE",0
28,"28156",1082,788,784,3,4,"PCTE",1
40,"40181",4182,3102,3038,35,64,"PCTE",0
49,"49208",352,223,214,1,9,"PCTE",1
37,"37247",171,129,128,0,1,"PCTE",0
37,"37035",162,115,115,1,0,"PCTE",0
16,"16047",214,154,148,3,6,"PCTE",0
5,"5082",491,379,369,2,10,"PCTE",1
49,"49139",149,112,112,0,0,"PCTE",0
37,"37087",911,675,665,5,10,"PCTE",0
19,"19127",88,60,60,1,0,"PCTE",0
42,"42085",179,107,106,2,1,"PCTE",0
37,"37332",65,49,49,0,0,"PCTE",0
9,"9174",768,536,522,6,14,"PCTE",0
19,"19007",433,316,310,1,6,"PCTE",0
19,"19171",5380,3964,3919,22,45,"PCTE",12
29,"29901",44757,29291,28960,307,331,"PCTE",11
24,"24124",338,196,195,2,1,"PCTE",0
33,"33046",480,334,329,0,5,"PCTE",0
29,"29017",6404,4575,4468,48,107,"PCTE",5
49,"49143",201,119,118,1,1,"PCTE",0
29,"29013",1613,1191,1154,9,37,"PCTE",0
42,"42097",14,9,9,1,0,"PCTE",0
50,"50124",394,269,266,0,3,"PCTE",0
28,"28127",66793,53258,53009,458,249,"PCTE",9
42,"42029",131,94,94,4,0,"PCTE",0
34,"34059",411,304,292,6,12,"PCTE",0
2,"2059",320,225,217,0,8,"PCTE",0
49,"49094",210,111,111,0,0,"PCTE",0
24,"24021",1595,1037,1025,7,12,"PCTE",0
50,"50061",190,157,155,2,2,"PCTE",0
50,"50176",220,142,142,3,0,"PCTE",0
47,"47151",26,22,22,0,0,"PCTE",0
39,"39038",1512,992,983,5,9,"PCTE",0
45,"45185",7573,5422,5320,31,102,"PCTE",0
45,"45111",56,47,47,1,0,"PCTE",0
9,"9117",71,58,58,0,0,"PCTE",0
37,"37288",281,220,218,4,2,"PCTE",0
34,"34045",72,62,62,0,0,"PCTE",0
45,"45051",1678,1238,1209,13,29,"PCTE",1
40,"40025",129,109,107,1,2,"PCTE",0
49,"49019",232,162,152,2,10,"PCTE",0
26,"26074",107,87,86,2,1,"PCTE",0
47,"47133",2776,2096,2073,28,23,"PCTE",0
19,"19058",7458,5705,5663,40,42,"PCTE",3
37,"37170",1361,909,884,9,25,"PCTE",0
9,"9476",60,46,46,0,0,"PCTE",0
9,"9143",28,17,17,0,0,"PCTE",0
22,"22235",88,69,68,1,1,"PCTE",0
34,"34098",790,562,558,3,4,"PCTE",2
22,"22167",465,358,356,8,2,"PCTE",0
50,"50279",74,49,49,0,0,"PCTE",0
2,"2084",298,197,191,2,6,"PCTE",0
34,"34087",125,99,99,2,0,"PCTE",0
26,"26092",104,82,81,3,1,"PCTE",0
9,"9215",359,217,216,2,1,"PCTE",0
50,"50162",135,100,99,3,1,"PCTE",0
49,"49004",110,74,71,3,3,"PCTE",0
45,"45182",996,760,754,5,6,"PCTE",1
9,"9392",49,28,28,0,0,"PCTE",0
16,"16043",88,60,60,3,0,"PCTE",0
26,"26113",29,28,28,0,0,"PCTE",0
50,"50015",81,57,56,0,1,"PCTE",0
47,"47042",51,39,39,0,0,"PCTE",0
9,"9131",485,390,388,7,2,"PCTE",0
24,"24194",267,178,177,1,1,"PCTE",1
40,"40015",23,19,19,0,0,"PCTE",0
23,"23011",2138,1536,1507,17,29,"PCTE",2
47,"47119",89,59,58,2,1,"PCTE",0
42,"42197",68,54,53,0,1,"PCTE",0
22,"22004",123,83,83,0,0,"PCTE",0
37,"37348",100,76,76,0,0,"PCTE",0
42,"42171",111,72,71,1,1,"PCTE",0
9,"9268",89,62,62,0,0,"PCTE",0
2,"2054",375,288,283,0,5,"PCTE",0
9,"9221",498,380,377,8,3,"PCTE",1
19,"19323",36,26,26,0,0,"PCTE",0
22,"22035",225,153,152,1,1,"PCTE",0
28,"28122",578,404,401,1,3,"PCTE",0
40,"40179",620,500,490,3,10,"PCTE",0
49,"49117",431,294,289,0,5,"PCTE",0
50,"50086",176,106,102,1,4,"PCTE",0
5,"5089",455,342,324,0,18,"PCTE",0
18,"18017",18201,11500,11358,94,142,"PCTE",4
49,"49067",329,200,198,4,2,"PCTE",0
47,"47028",30,17,17,0,0,"PCTE",0
34,"34091",118,82,82,1,0,"PCTE",0
42,"42075",78,50,50,1,0,"PCTE",0
50,"50017",1773,1283,1265,13,18,"PCTE",0
34,"34154",77,48,48,1,0,"PCTE",0
40,"40101",918,672,665,11,7,"PCTE",1
39,"39003",261,189,187,2,2,"PCTE",0
18,"18014",6938,4864,4742,64,122,"PCTE",2
9,"9368",29,19,19,1,0,"PCTE",0
9,"9295",52,36,35,1,1,"PCTE",0
9,"9112",102,73,73,0,0,"PCTE",0
45,"45066",7815,5540,5447,25,93,"PCTE",2
50,"50254",179,115,113,0,2,"PCTE",0
47,"47145",583,430,426,6,4,"PCTE",0
49,"49197",155,109,104,0,5,"PCTE",0
24,"24098",1149,753,741,8,12,"PCTE",3
22,"22178",105,89,89,1,0,"PCTE",0
26,"26069",230,166,166,0,0,"PCTE",0
37,"37346",251,208,207,1,1,"PCTE",0
19,"19203",29,25,25,0,0,"PCTE",0
49,"49125",1392,883,871,11,12,"PCTE",0
29,"29079",2326,1609,1582,12,27,"PCTE",0
19,"19267",20,15,14,0,1,"PCTE",0
45,"45160",1097,838,824,4,14,"PCTE",0
47,"47008",22,13,13,0,0,"PCTE",0
41,"41030",501,376,366,9,10,"PCTE",1
28,"28134",63936,48022,47631,421,391,"PCTE",27
16,"16091",63,43,42,1,1,"PCTE",0
9,"9270",157,112,109,2,3,"PCTE",0
26,"26166",144,125,124,0,1,"PCTE",0
24,"24026",1085,724,712,14,12,"PCTE",0
14,"14063",994,731,719,8,12,"PCTE",0
24,"24171",337,136,134,4,2,"PCTE",0
37,"37240",928,648,637,2,11,"PCTE",0
28,"28045",35523,26213,25966,212,247,"PCTE",18
28,"28183",1162,823,813,9,10,"PCTE",1
5,"5266",100,79,79,1,0,"PCTE",0
50,"50167",208,166,163,1,3,"PCTE",0
28,"28088",296,196,191,1,5,"PCTE",0
40,"40054",108,79,78,3,1,"PCTE",0
26,"26047",1852,1449,1434,6,15,"PCTE",2
47,"47215",48,43,43,0,0,"PCTE",0
26,"26086",15,15,15,0,0,"PCTE",0
39,"39004",1479,1050,1031,5,19,"PCTE",1
5,"5208",39,32,32,0,0,"PCTE",0
37,"37045",27,19,19,0,0,"PCTE",0
34,"34190",50,33,33,1,0,"PCTE",0
29,"29026",1021,703,698,15,5,"PCTE",2
21,"21073",1902,1073,1043,13,30,"PCTE",0
49,"49124",238,170,164,2,6,"PCTE",0
33,"33075",244,125,122,3,3,"PCTE",0
5,"5112",95,59,58,0,1,"PCTE",0
9,"9166",96,77,77,0,0,"PCTE",0
37,"37378",92,54,54,0,0,"PCTE",0
47,"47181",165,136,135,1,1,"PCTE",0
26,"26132",106,73,70,2,3,"PCTE",0
19,"19146",47,35,35,0,0,"PCTE",1
16,"16172",325,233,228,1,5,"PCTE",0
40,"40091",109,87,85,0,2,"PCTE",0
16,"16046",213,142,142,0,0,"PCTE",0
9,"9054",89,65,63,4,2,"PCTE",0
45,"45172",640,475,462,6,13,"PCTE",0
9,"9434",1279,966,956,11,10,"PCTE",3
42,"42159",39,34,33,0,1,"PCTE",0
47,"47142",121,85,85,0,0,"PCTE",0
42,"42213",25,17,16,1,1,"PCTE",0
41,"41001",1558,1129,1104,6,25,"PCTE",0
24,"24074",97,70,70,1,0,"PCTE",0
37,"37096",203,144,144,2,0,"PCTE",0
29,"29020",3278,2329,2260,22,69,"PCTE",2
9,"9177",1140,790,780,7,10,"PCTE",2
5,"5075",96,76,76,0,0,"PCTE",0
29,"29028",1215,803,779,9,24,"PCTE",1
37,"37237",296,212,204,1,8,"PCTE",0
19,"19181",50,34,34,0,0,"PCTE",0
40,"40124",234,169,164,0,5,"PCTE",0
42,"42088",62,45,44,0,1,"PCTE",0
9,"9103",200,168,166,1,2,"PCTE",0
34,"34185",69,36,35,0,1,"PCTE",0
23,"23035",1111,877,856,2,21,"PCTE",0
29,"29018",2009,1421,1362,17,59,"PCTE",2
47,"47113",134,110,110,0,0,"PCTE",0
47,"47155",3454,2445,2405,26,40,"PCTE",3
23,"23048",817,605,599,4,6,"PCTE",1
40,"40219",573,382,366,5,16,"PCTE",0
42,"42014",57,35,35,0,0,"PCTE",0
50,"50272",13226,9250,9153,97,97,"PCTE",4
16,"16089",381,292,289,8,3,"PCTE",0
9,"9009",158,127,124,5,3,"PCTE",0
5,"5171",67,49,47,0,2,"PCTE",0
47,"47218",981,728,723,4,5,"PCTE",1
21,"21025",3886,2489,2431,31,58,"PCTE",0
9,"9302",96,66,66,0,0,"PCTE",0
37,"37235",214,163,159,2,4,"PCTE",1
50,"50235",2421,1721,1702,18,19,"PCTE",1
50,"50007",51,34,34,1,0,"PCTE",0
42,"42032",138,96,96,0,0,"PCTE",1
26,"26083",337,255,250,3,5,"PCTE",1
28,"28038",5213,3801,3753,24,48,"PCTE",1
18,"18023",15717,10964,10751,132,213,"PCTE",8
5,"5085",31,27,27,0,0,"PCTE",0
49,"49010",350,260,256,8,4,"PCTE",0
47,"47184",537,411,402,1,9,"PCTE",0
19,"19017",56,47,47,0,0,"PCTE",0
39,"39090",773,557,553,2,4,"PCTE",0
16,"16219",81,58,58,0,0,"PCTE",0
2,"2025",7345,5388,5278,51,110,"PCTE",5
19,"19034",25,22,21,0,1,"PCTE",0
9,"9406",239,165,162,2,3,"PCTE",0
21,"21068",973,562,556,11,6,"PCTE",1
14,"14044",1613,1186,1164,10,22,"PCTE",4
9,"9073",964,713,706,3,7,"PCTE",0
47,"47062",155,128,128,0,0,"PCTE",0
18,"18053",1554,1001,985,9,16,"PCTE",2
50,"50295",48,41,41,0,0,"PCTE",0
19,"19331",2677,1892,1841,18,51,"PCTE",0
22,"22050",93,77,77,0,0,"PCTE",0
28,"28094",988,711,707,5,4,"PCTE",0
19,"19009",263,186,184,0,2,"PCTE",0
40,"40092",105,75,75,2,0,"PCTE",0
47,"47001",52,43,42,1,1,"PCTE",0
41,"41901",2692,2101,2051,47,50,"PCTE",0
37,"37009",197,145,144,1,1,"PCTE",0
19,"19074",67,57,57,1,0,"PCTE",0
33,"33029",315,145,142,1,3,"PCTE",0
19,"19220",2608,1673,1653,10,20,"PCTE",2
49,"49023",899,627,620,3,7,"PCTE",1
45,"45104",419,328,324,1,4,"PCTE",0
34,"34006",79,73,69,2,4,"PCTE",0
28,"28023",5159,4052,4019,27,33,"PCTE",1
50,"50090",134,96,96,0,0,"PCTE",0
19,"19240",49,36,36,0,0,"PCTE",0
5,"5149",101,72,71,2,1,"PCTE",0
50,"50160",2140,1421,1394,14,27,"PCTE",1
37,"37006",116,71,70,3,1,"PCTE",1
28,"28089",3856,2866,2829,21,37,"PCTE",3
37,"37176",128,99,98,1,1,"PCTE",0
42,"42166",55,38,37,0,1,"PCTE",0
33,"33077",1097,688,683,4,5,"PCTE",0
47,"47174",271,215,213,4,2,"PCTE",0
50,"50204",2396,1723,1712,17,11,"PCTE",0
34,"34048",62,51,51,1,0,"PCTE",0
18,"18057",5584,4042,3958,51,84,"PCTE",4
24,"24036",252,146,146,1,0,"PCTE",0
28,"28159",589,455,447,4,8,"PCTE",0
26,"26144",187,147,143,1,4,"PCTE",0
42,"42116",37,30,29,2,1,"PCTE",0
45,"45193",586,478,469,0,9,"PCTE",0
9,"9485",55,41,41,0,0,"PCTE",0
41,"41016",7820,5523,5407,57,116,"PCTE",1
9,"9458",490,388,385,6,3,"PCTE",3
34,"34221",168,129,127,2,2,"PCTE",0
40,"40162",380,273,265,1,8,"PCTE",0
18,"18134",6104,4049,3972,39,77,"PCTE",2
9,"9078",32,27,27,0,0,"PCTE",0
21,"21011",3500,2371,2314,23,57,"PCTE",0
40,"40076",6576,4700,4607,32,93,"PCTE",6
33,"33048",132,86,85,1,1,"PCTE",0
19,"19168",265,182,175,4,7,"PCTE",2
18,"18095",2054,1475,1433,14,42,"PCTE",5
21,"21022",187,121,116,0,5,"PCTE",0
28,"28066",7575,5771,5718,58,53,"PCTE",1
16,"16056",442,275,270,4,5,"PCTE",0
9,"9007",54,37,35,0,2,"PCTE",0
34,"34050",187,136,136,1,0,"PCTE",0
50,"50048",33,25,25,0,0,"PCTE",0
5,"5058",71,45,43,0,2,"PCTE",0
19,"19178",27,17,16,0,1,"PCTE",0
50,"50073",2122,1559,1540,14,19,"PCTE",1
16,"16010",134,92,88,0,4,"PCTE",0
22,"22225",2606,1638,1612,20,26,"PCTE",1
37,"37287",297,204,202,2,2,"PCTE",0
19,"19326",2463,1671,1650,13,21,"PCTE",2
47,"47123",461,360,358,2,2,"PCTE",0
24,"24039",1949,1420,1412,33,8,"PCTE",0
49,"49103",392,319,316,5,3,"PCTE",0
24,"24077",212,166,162,0,4,"PCTE",1
40,"40180",276,215,210,2,5,"PCTE",0
37,"37344",229,157,147,2,10,"PCTE",0
19,"19038",19,16,15,0,1,"PCTE",0
37,"37131",175,125,125,0,0,"PCTE",0
16,"16228",173,147,145,2,2,"PCTE",0
14,"14031",556,462,456,5,6,"PCTE",0
42,"42007",108,80,80,1,0,"PCTE",0
19,"19120",107,86,86,1,0,"PCTE",0
41,"41047",10449,7884,7770,119,114,"PCTE",4
47,"47185",82,62,61,1,1,"PCTE",0
45,"45135",4152,3118,3066,21,52,"PCTE",1
42,"42105",47,40,40,2,0,"PCTE",0
33,"33012",5085,3158,3142,27,16,"PCTE",0
37,"37226",152,113,113,2,0,"PCTE",0
41,"41075",10320,7159,6972,88,187,"PCTE",6
33,"33031",33775,20484,20184,276,300,"PCTE",45
9,"9085",481,349,342,2,7,"PCTE",2
5,"5222",140,118,118,0,0,"PCTE",0
19,"19124",378,230,229,2,1,"PCTE",0
23,"23040",1438,1175,1159,3,16,"PCTE",3
23,"23074",2984,2271,2236,20,35,"PCTE",3
24,"24225",979,678,668,5,10,"PCTE",0
26,"26018",10443,7664,7538,80,126,"PCTE",12
37,"37268",106,62,61,1,1,"PCTE",0
47,"47176",199,110,110,0,0,"PCTE",0
49,"49265",110,79,78,2,1,"PCTE",0
28,"28128",453,334,331,1,3,"PCTE",0
16,"16052",539,422,419,3,3,"PCTE",0
9,"9139",98,79,79,2,0,"PCTE",0
5,"5040",64,47,46,0,1,"PCTE",0
19,"19161",212,158,157,3,1,"PCTE",0
28,"28040",16741,10717,10604,79,113,"PCTE",5
49,"49133",287,206,203,1,3,"PCTE",0
33,"33059",4359,2651,2625,33,26,"PCTE",1
5,"5059",92,49,48,0,1,"PCTE",0
9,"9003",182,134,132,1,2,"PCTE",0
22,"22902",206,147,144,1,3,"PCTE",0
37,"37225",97,78,74,0,4,"PCTE",0
14,"14003",1245,925,907,5,18,"PCTE",0
37,"37334",71,30,30,0,0,"PCTE",0
40,"40088",272,192,192,0,0,"PCTE",0
50,"50126",2240,1528,1509,24,19,"PCTE",0
45,"45110",1685,1288,1274,5,14,"PCTE",0
26,"26024",204,157,156,1,1,"PCTE",1
40,"40004",436,330,319,2,11,"PCTE",0
49,"49232",85,64,64,0,0,"PCTE",0
50,"50052",81,61,61,0,0,"PCTE",0
34,"34081",60,45,44,0,1,"PCTE",0
2,"2017",760,498,493,1,5,"PCTE",0
47,"47103",252,195,192,1,3,"PCTE",0
45,"45201",3692,2198,2175,15,23,"PCTE",2
40,"40170",1302,962,948,6,14,"PCTE",1
49,"49221",233,122,120,2,2,"PCTE",0
37,"37197",88,53,53,1,0,"PCTE",0
33,"33043",656,408,401,2,7,"PCTE",0
50,"50287",253,189,188,11,1,"PCTE",0
50,"50004",475,360,356,2,4,"PCTE",1
9,"9091",686,479,467,4,12,"PCTE",0
47,"47073",116,80,79,2,1,"PCTE",0
34,"34178",119,94,91,0,3,"PCTE",0
26,"26179",39,27,27,0,0,"PCTE",0
5,"5094",133,105,105,0,0,"PCTE",0
33,"33047",1068,771,759,9,12,"PCTE",0
9,"9279",166,116,114,1,2,"PCTE",0
37,"37150",34,31,31,0,0,"PCTE",0
34,"34121",187,150,150,3,0,"PCTE",0
45,"45121",7345,4949,4899,24,50,"PCTE",1
34,"34217",1269,999,983,14,16,"PCTE",1
16,"16130",533,407,404,0,3,"PCTE",0
9,"9455",45,34,33,0,1,"PCTE",0
9,"9183",42,32,32,0,0,"PCTE",0
23,"23904",2570,1583,1562,10,21,"PCTE",2
50,"50066",2903,2095,2078,19,17,"PCTE",0
39,"39096",669,451,450,1,1,"PCTE",0
37,"37007",391,289,281,7,8,"PCTE",0
22,"22136",749,524,518,5,6,"PCTE",0
21,"21003",684,476,452,4,24,"PCTE",0
50,"50118",2101,1484,1477,17,7,"PCTE",1
49,"49228",53,36,36,0,0,"PCTE",0
19,"19139",26,19,19,2,0,"PCTE",0
33,"33062",385,194,187,4,7,"PCTE",0
29,"29067",431757,290824,287855,3289,2969,"PCTE",149
37,"37298",170,109,109,0,0,"PCTE",0
28,"28001",70,48,47,1,1,"PCTE",0
5,"5143",59,52,51,1,1,"PCTE",0
19,"19121",265,205,204,0,1,"PCTE",0
24,"24043",116,54,52,0,2,"PCTE",0
50,"50224",61,44,44,2,0,"PCTE",0
39,"39018",4284,3211,3177,22,34,"PCTE",12
28,"28120",1220,910,897,5,13,"PCTE",0
45,"45205",7438,4772,4701,27,71,"PCTE",12
22,"22044",234,166,164,1,2,"PCTE",0
37,"37139",189,150,148,1,2,"PCTE",0
18,"18046",1738,1042,1023,7,19,"PCTE",1
39,"39056",2262,1683,1671,14,12,"PCTE",3
14,"14057",6157,4773,4707,59,66,"PCTE",2
45,"45021",2639,1798,1755,22,43,"PCTE",1
33,"33019",2844,1702,1680,11,22,"PCTE",6
40,"40904",344,286,284,8,2,"PCTE",1
22,"22133",108,71,71,3,0,"PCTE",0
41,"41099",3961,2448,2413,14,35,"PCTE",1
47,"47005",506,358,348,3,10,"PCTE",0
50,"50110",340,248,238,1,10,"PCTE",0
22,"22165",449,305,300,3,5,"PCTE",0
18,"18063",1232,687,678,9,9,"PCTE",0
18,"18072",655,452,445,4,7,"PCTE",0
9,"9086",652,479,471,3,8,"PCTE",0
22,"22135",173,123,121,0,2,"PCTE",0
49,"49079",104,79,76,0,3,"PCTE",0
40,"40012",241,160,156,7,4,"PCTE",0
22,"22099",490,349,343,2,6,"PCTE",0
22,"22163",426,338,335,0,3,"PCTE",0
5,"5249",96,63,63,0,0,"PCTE",0
2,"2068",323,239,239,3,0,"PCTE",0
5,"5188",39,33,33,0,0,"PCTE",0
49,"49040",109,89,87,2,2,"PCTE",0
37,"37098",290,197,197,1,0,"PCTE",0
9,"9360",26,19,19,0,0,"PCTE",0
40,"40155",3897,2920,2880,56,40,"PCTE",2
39,"39077",237,151,148,1,3,"PCTE",0
50,"50082",82,57,57,0,0,"PCTE",0
28,"28133",6146,4245,4180,25,65,"PCTE",0
47,"47230",285,209,206,1,3,"PCTE",0
9,"9214",632,409,407,2,2,"PCTE",0
37,"37214",120,70,68,2,2,"PCTE",0
5,"5092",145,111,107,1,4,"PCTE",0
29,"29099",969,688,669,11,19,"PCTE",0
37,"37110",104,81,79,1,2,"PCTE",0
22,"22213",2918,2084,2062,20,22,"PCTE",2
24,"24162",1753,1259,1245,12,14,"PCTE",1
40,"40069",68,59,59,0,0,"PCTE",0
34,"34186",49,44,44,0,0,"PCTE",0
47,"47144",72,54,53,2,1,"PCTE",1
39,"39059",7518,5327,5287,23,40,"PCTE",5
2,"2024",3361,2444,2411,24,33,"PCTE",1
40,"40230",93,66,64,0,2,"PCTE",0
34,"34240",84,67,66,1,1,"PCTE",0
40,"40144",16,15,15,0,0,"PCTE",0
26,"26122",115,81,80,4,1,"PCTE",1
19,"19105",2550,1913,1889,10,24,"PCTE",0
24,"24163",4076,2979,2954,35,25,"PCTE",3
34,"34139",160,117,115,2,2,"PCTE",0
34,"34134",44,25,25,0,0,"PCTE",0
39,"39094",840,611,611,2,0,"PCTE",0
5,"5123",106,78,78,0,0,"PCTE",0
24,"24131",684,416,415,2,1,"PCTE",0
40,"40018",73,50,50,0,0,"PCTE",0
34,"34049",329,229,227,1,2,"PCTE",1
40,"40047",37,23,23,0,0,"PCTE",0
39,"39070",126,91,89,0,2,"PCTE",0
40,"40146",260,206,204,0,2,"PCTE",0
18,"18021",17929,12165,11949,139,216,"PCTE",8
42,"42034",41,25,25,0,0,"PCTE",0
22,"22246",63,43,43,0,0,"PCTE",0
49,"49174",127,86,85,1,1,"PCTE",0
47,"47200",70,60,60,0,0,"PCTE",0
24,"24076",1283,926,913,10,13,"PCTE",0
28,"28123",62178,49883,49515,397,368,"PCTE",20
47,"47216",111,94,91,0,3,"PCTE",0
41,"41091",539590,389351,384943,4676,4408,"PCTE",172
18,"18033",279,179,174,0,5,"PCTE",0
40,"40190",43,37,35,0,2,"PCTE",0
22,"22014",227,164,162,5,2,"PCTE",0
9,"9110",77,50,50,0,0,"PCTE",0
23,"23030",1207,998,977,7,21,"PCTE",0
18,"18174",435,324,320,3,4,"PCTE",0
49,"49185",156,120,116,0,4,"PCTE",0
42,"42125",71,55,55,0,0,"PCTE",0
22,"22008",144,113,112,2,1,"PCTE",0
21,"21027",49,32,32,0,0,"PCTE",0
26,"26012",37,28,28,1,0,"PCTE",0
33,"33024",224741,151660,150461,1597,1199,"PCTE",232
50,"50147",744,508,506,5,2,"PCTE",0
9,"9058",394,286,284,6,2,"PCTE",2
9,"9387",107,89,88,0,1,"PCTE",0
33,"33053",1078,602,599,10,3,"PCTE",6
47,"47178",170,128,124,2,4,"PCTE",0
16,"16116",76,59,58,1,1,"PCTE",0
50,"50044",224,159,159,2,0,"PCTE",0
28,"28042",1261,918,908,9,10,"PCTE",0
34,"34005",786,601,593,3,8,"PCTE",0
37,"37031",329,241,238,3,3,"PCTE",0
9,"9326",156,111,110,1,1,"PCTE",0
39,"39088",59,40,40,2,0,"PCTE",0
50,"50119",876,633,625,11,8,"PCTE",0
22,"22054",1614,1029,1009,19,20,"PCTE",3
37,"37328",159,112,110,1,2,"PCTE",0
9,"9408",40,29,29,0,0,"PCTE",0
5,"5077",154,113,110,0,3,"PCTE",0
5,"5247",231,132,131,1,1,"PCTE",0
21,"21029",1514,1036,1003,14,33,"PCTE",0
49,"49223",701,498,494,7,4,"PCTE",0
39,"39063",936,618,616,4,2,"PCTE",0
5,"5001",182,139,138,1,1,"PCTE",0
37,"37109",178,127,126,0,1,"PCTE",0
33,"33045",4359,2819,2787,32,32,"PCTE",4
47,"47226",148,115,115,1,0,"PCTE",0
47,"47017",190,146,146,0,0,"PCTE",0
18,"18029",1812,1104,1065,7,39,"PCTE",0
47,"47111",1001,738,732,5,6,"PCTE",1
50,"50016",44,31,31,0,0,"PCTE",0
16,"16115",49,32,32,0,0,"PCTE",0
19,"19269",86,61,61,0,0,"PCTE",0
19,"19123",37,30,28,0,2,"PCTE",0
26,"26044",51,38,36,0,2,"PCTE",0
47,"47082",805,641,630,3,11,"PCTE",1
47,"47191",111,81,81,0,0,"PCTE",2
42,"42149",386,273,270,2,3,"PCTE",0
49,"49123",519,384,383,4,1,"PCTE",0
33,"33009",878,545,542,4,3,"PCTE",0
16,"16187",55,38,38,3,0,"PCTE",0
33,"33065",1077,670,657,11,13,"PCTE",0
9,"9225",80,55,55,0,0,"PCTE",4
9,"9063",215,184,181,2,3,"PCTE",0
45,"45181",2330,1693,1661,10,32,"PCTE",1
50,"50072",183,131,129,0,2,"PCTE",0
24,"24024",636,407,403,6,4,"PCTE",1
9,"9337",113,80,77,2,3,"PCTE",0
16,"16095",82,70,70,1,0,"PCTE",0
49,"49048",113,88,88,0,0,"PCTE",0
28,"28110",2029,1498,1478,9,20,"PCTE",1
5,"5133",61,44,43,0,1,"PCTE",0
19,"19051",61,52,52,0,0,"PCTE",0
49,"49247",412,255,252,2,3,"PCTE",0
16,"16012",76,66,66,0,0,"PCTE",0
39,"39032",1420,1032,1027,7,5,"PCTE",0
19,"19238",43,30,28,0,2,"PCTE",0
23,"23059",5736,4245,4119,51,126,"PCTE",4
5,"5145",43,28,28,0,0,"PCTE",0
45,"45034",1290,968,948,7,20,"PCTE",0
22,"22187",288,220,220,2,0,"PCTE",0
37,"37047",215,89,89,0,0,"PCTE",0
49,"49192",123,93,90,2,3,"PCTE",0
16,"16106",2701,2029,2001,6,28,"PCTE",1
49,"49012",70,34,34,0,0,"PCTE",0
5,"5078",95,78,78,2,0,"PCTE",1
9,"9389",63,45,45,0,0,"PCTE",0
49,"49028",108,90,89,1,1,"PCTE",0
49,"49137",167,123,121,0,2,"PCTE",0
37,"37187",548,407,399,0,8,"PCTE",0
37,"37250",325,212,211,0,1,"PCTE",0
37,"37319",88,68,64,2,4,"PCTE",0
14,"14062",945,700,693,2,7,"PCTE",0
16,"16177",83,65,65,1,0,"PCTE",0
2,"2016",528,353,352,4,1,"PCTE",0
47,"47161",3970,3111,3089,24,22,"PCTE",5
26,"26020",449,319,313,1,6,"PCTE",0
34,"34210",98,82,82,1,0,"PCTE",0
49,"49017",247,176,176,1,0,"PCTE",0
45,"45171",1329,958,940,4,18,"PCTE",1
5,"5115",509,350,344,0,6,"PCTE",0
28,"28018",4121,3174,3151,22,23,"PCTE",2
24,"24137",1043,700,691,8,9,"PCTE",1
37,"37341",47,29,29,0,0,"PCTE",0
16,"16137",37,27,25,0,2,"PCTE",0
9,"9229",178,127,127,1,0,"PCTE",0
41,"41010",4586,3218,3157,42,61,"PCTE",1
16,"16224",72,60,58,0,2,"PCTE",0
50,"50276",118,91,91,0,0,"PCTE",0
37,"37248",150,116,116,1,0,"PCTE",0
5,"5083",137,92,91,0,1,"PCTE",0
19,"19080",67,47,47,0,0,"PCTE",0
37,"37296",297,215,210,0,5,"PCTE",0
16,"16234",23,17,17,0,0,"PCTE",0
19,"19150",116,89,89,0,0,"PCTE",0
22,"22177",96,69,68,0,1,"PCTE",0
28,"28019",1272,926,914,6,12,"PCTE",1
42,"42123",157,103,102,6,1,"PCTE",0
9,"9125",555,386,382,4,4,"PCTE",0
23,"23029",798,595,590,0,5,"PCTE",0
9,"9108",433,315,311,3,4,"PCTE",0
28,"28080",49866,39769,39583,346,186,"PCTE",9
18,"18038",1042,782,760,5,22,"PCTE",4
28,"28151",3274,2344,2310,16,34,"PCTE",0
49,"49193",428,261,253,3,8,"PCTE",0
41,"41018",9432,6463,6368,86,95,"PCTE",1
9,"9304",198,152,149,1,3,"PCTE",0
39,"39002",3408,2360,2323,7,37,"PCTE",0
5,"5178",340,261,255,3,6,"PCTE",0
22,"22195",238,190,186,0,4,"PCTE",0
18,"18103",714,500,498,3,2,"PCTE",0
33,"33037",33074,20693,20412,259,281,"PCTE",74
50,"50132",780,549,538,7,11,"PCTE",0
14,"14012",6046,4215,4120,56,95,"PCTE",2
26,"26178",72,56,56,1,0,"PCTE",0
5,"5118",64,41,41,1,0,"PCTE",0
5,"5182",721,457,436,3,21,"PCTE",0
50,"50278",175,133,131,2,2,"PCTE",0
37,"37156",4261,2928,2869,23,59,"PCTE",0
23,"23031",764,660,640,6,20,"PCTE",0
34,"34215",161,126,125,6,1,"PCTE",0
26,"26140",239,180,177,1,3,"PCTE",2
24,"24104",243,167,166,0,1,"PCTE",0
14,"14016",1273,936,922,5,14,"PCTE",0
40,"40127",36,25,23,0,2,"PCTE",0
16,"16015",349,242,239,6,3,"PCTE",0
45,"45079",355,250,250,0,0,"PCTE",0
9,"9129",91,74,74,0,0,"PCTE",0
41,"41041",9765,7172,6943,63,229,"PCTE",2
42,"42189",57,43,43,0,0,"PCTE",0
19,"19086",1371,1003,996,9,7,"PCTE",2
5,"5019",44865,32917,32586,282,331,"PCTE",44
45,"45169",179,114,111,1,3,"PCTE",0
9,"9113",453,321,315,8,6,"PCTE",0
22,"22082",288,217,214,0,3,"PCTE",0
5,"5120",33,26,26,0,0,"PCTE",0
9,"9060",126,104,104,2,0,"PCTE",1
40,"40030",419,317,314,3,3,"PCTE",0
34,"34055",254,185,184,3,1,"PCTE",1
45,"45080",3,3,3,0,0,"PCTE",0
49,"49206",776,515,504,7,11,"PCTE",0
26,"26128",94,71,71,1,0,"PCTE",0
9,"9102",33,22,22,0,0,"PCTE",0
37,"37151",142,109,109,1,0,"PCTE",1
23,"23045",2054,1423,1412,10,11,"PCTE",5
34,"34170",50,30,30,1,0,"PCTE",0
19,"19244",74,55,55,3,0,"PCTE",0
47,"47007",4051,2987,2954,27,33,"PCTE",4
28,"28179",1451,1043,1033,6,10,"PCTE",0
26,"26121",30,19,19,0,0,"PCTE",0
34,"34155",122,95,95,0,0,"PCTE",0
22,"22041",145,116,116,2,0,"PCTE",0
14,"14047",1644,1198,1183,14,15,"PCTE",0
24,"24207",276,215,215,2,0,"PCTE",0
50,"50046",162,125,125,6,0,"PCTE",0
19,"19088",91,67,66,0,1,"PCTE",0
42,"42041",31,23,23,0,0,"PCTE",0
49,"49036",503,319,316,5,3,"PCTE",0
5,"5185",96,63,61,1,2,"PCTE",0
5,"5122",118,91,89,1,2,"PCTE",0
50,"50257",159,128,125,2,3,"PCTE",0
37,"37160",597,380,370,3,10,"PCTE",1
16,"16237",98,82,82,1,0,"PCTE",0
26,"26029",34,26,26,1,0,"PCTE",0
16,"16067",123,91,90,1,1,"PCTE",0
21,"21041",113074,73295,72313,1063,982,"PCTE",35
45,"45108",465,343,341,0,2,"PCTE",0
40,"40086",656,513,496,7,17,"PCTE",0
50,"50116",169,124,123,0,1,"PCTE",0
22,"22063",161,128,126,0,2,"PCTE",0
37,"37373",692,451,442,4,9,"PCTE",0
9,"9226",54,45,45,2,0,"PCTE",0
33,"33066",42818,27780,27466,425,314,"PCTE",41
42,"42194",144,101,100,2,1,"PCTE",0
16,"16148",544,452,451,2,1,"PCTE",0
45,"45157",2288,1490,1472,5,18,"PCTE",1
28,"28026",6767,5058,5024,27,34,"PCTE",1
37,"37256",191,123,123,1,0,"PCTE",0
47,"47056",81,57,57,0,0,"PCTE",0
39,"39039",540,355,355,1,0,"PCTE",0
9,"9440",80,61,61,0,0,"PCTE",0
40,"40213",93,78,78,1,0,"PCTE",0
23,"23085",2171,1587,1575,7,12,"PCTE",1
42,"42019",519,345,341,3,4,"PCTE",1
2,"2034",1323,1024,1018,6,6,"PCTE",0
47,"47027",2799,2059,2025,12,34,"PCTE",2
40,"40191",198,143,138,0,5,"PCTE",0
45,"45024",1034,742,733,1,9,"PCTE",0
16,"16227",109,78,76,0,2,"PCTE",0
21,"21017",2302,1469,1452,18,17,"PCTE",0
41,"41071",5571,3608,3516,64,92,"PCTE",4
40,"40003",116,82,79,3,3,"PCTE",0
26,"26108",309,240,231,2,9,"PCTE",0
50,"50161",98,75,74,2,1,"PCTE",0
23,"23039",2170,1502,1460,10,42,"PCTE",0
9,"9083",26,21,21,0,0,"PCTE",0
28,"28903",35555,28875,28671,341,204,"PCTE",11
19,"19054",161,136,135,3,1,"PCTE",0
24,"24040",416,293,292,2,1,"PCTE",0
9,"9195",57,40,40,0,0,"PCTE",0
34,"34032",38,30,30,0,0,"PCTE",0
24,"24112",288,188,186,2,2,"PCTE",0
49,"49214",666,486,477,6,9,"PCTE",0
19,"19221",31,22,22,1,0,"PCTE",0
34,"34077",395,282,278,7,4,"PCTE",0
39,"39022",970,673,668,2,5,"PCTE",1
24,"24185",447,303,295,1,8,"PCTE",0
23,"23003",8639,6296,6226,41,70,"PCTE",10
18,"18138",2470,1597,1573,25,24,"PCTE",2
9,"9471",140,108,107,1,1,"PCTE",1
49,"49090",190,135,134,3,1,"PCTE",0
9,"9249",47,35,35,3,0,"PCTE",0
19,"19092",395,286,279,2,7,"PCTE",0
37,"37062",78,59,59,0,0,"PCTE",0
28,"28102",880,639,621,7,18,"PCTE",0
19,"19055",44,32,31,2,1,"PCTE",0
23,"23041",489,378,376,1,2,"PCTE",0
45,"45199",3188,2077,2055,20,22,"PCTE",1
40,"40048",35,27,27,0,0,"PCTE",0
47,"47146",275,215,214,1,1,"PCTE",0
24,"24062",126,79,79,0,0,"PCTE",0
9,"9377",626,468,460,6,8,"PCTE",0
26,"26089",111981,80365,79216,893,1149,"PCTE",131
45,"45069",1820,1370,1355,1,15,"PCTE",1
40,"40100",262,208,204,4,4,"PCTE",0
22,"22081",247,173,171,3,2,"PCTE",0
9,"9466",113,84,83,1,1,"PCTE",0
33,"33015",1396,849,842,7,7,"PCTE",3
16,"16135",115,76,76,0,0,"PCTE",1
21,"21071",206,148,144,4,4,"PCTE",0
24,"24183",748,464,460,9,4,"PCTE",3
47,"47187",71,49,49,0,0,"PCTE",0
40,"40200",38,28,28,0,0,"PCTE",0
18,"18909",514,403,403,0,0,"PCTE",0
5,"5029",100,73,73,1,0,"PCTE",0
49,"49142",244,163,160,0,3,"PCTE",0
14,"14053",5918,4054,3968,92,86,"PCTE",2
9,"9419",67,52,49,0,3,"PCTE",0
47,"47198",64,43,43,0,0,"PCTE",0
50,"50036",100,76,76,1,0,"PCTE",0
5,"5030",40,32,32,0,0,"PCTE",0
26,"26073",92,68,66,1,2,"PCTE",0
18,"18074",265,205,205,0,0,"PCTE",0
18,"18175",11793,8099,7943,62,156,"PCTE",6
2,"2050",85,66,66,1,0,"PCTE",0
16,"16245",396,304,298,1,6,"PCTE",1
41,"41051",2317,1715,1688,4,27,"PCTE",0
5,"5193",179,140,139,2,1,"PCTE",0
16,"16195",458,343,338,0,5,"PCTE",0
18,"18910",710,439,434,1,5,"PCTE",0
5,"5060",108,79,79,2,0,"PCTE",0
22,"22074",303,209,208,5,1,"PCTE",0
24,"24218",451,310,308,3,2,"PCTE",0
24,"24033",209,149,149,0,0,"PCTE",0
40,"40094",353,265,263,3,2,"PCTE",0
21,"21039",303,211,210,6,1,"PCTE",0
37,"37242",82,59,59,1,0,"PCTE",0
16,"16064",651,556,550,4,6,"PCTE",0
22,"22243",43,32,31,0,1,"PCTE",0
9,"9482",34,22,22,0,0,"PCTE",0
16,"16065",370,287,287,3,0,"PCTE",0
5,"5184",238,163,160,2,3,"PCTE",0
42,"42165",414,246,237,4,9,"PCTE",1
14,"14040",3749,2905,2845,53,60,"PCTE",2
19,"19166",154,110,108,0,2,"PCTE",0
33,"33034",9979,5937,5873,64,64,"PCTE",9
29,"29055",1892,1425,1394,3,31,"PCTE",0
22,"22217",370,274,269,4,5,"PCTE",0
40,"40229",26,22,22,0,0,"PCTE",0
28,"28148",89174,65500,64784,566,716,"PCTE",49
50,"50022",504,373,369,12,4,"PCTE",0
14,"14019",6380,4933,4831,71,102,"PCTE",1
22,"22200",239,165,164,2,1,"PCTE",0
28,"28024",168,137,136,2,1,"PCTE",0
50,"50249",283,202,200,0,2,"PCTE",0
9,"9410",3019,1924,1898,21,26,"PCTE",4
16,"16018",376,290,290,2,0,"PCTE",1
26,"26028",135,111,110,3,1,"PCTE",0
9,"9098",470,318,309,3,9,"PCTE",0
26,"26041",109,67,65,0,2,"PCTE",1
24,"24049",1417,983,975,14,8,"PCTE",0
26,"26040",64,47,47,1,0,"PCTE",0
28,"28143",77,58,58,0,0,"PCTE",0
47,"47045",732,558,549,3,9,"PCTE",0
49,"49113",162,131,131,2,0,"PCTE",0
19,"19132",86,65,63,0,2,"PCTE",0
45,"45095",663,496,492,2,4,"PCTE",0
18,"18146",930,645,629,10,16,"PCTE",0
34,"34120",63790,46117,45597,464,520,"PCTE",51
34,"34072",145,125,123,1,2,"PCTE",0
16,"16068",125,88,88,3,0,"PCTE",0
33,"33010",1722,1085,1069,15,16,"PCTE",0
26,"26158",242,184,181,1,3,"PCTE",0
47,"47172",135,114,113,0,1,"PCTE",0
18,"18913",771,530,514,2,16,"PCTE",0
16,"16084",48,34,30,1,4,"PCTE",0
22,"22002",99,81,81,0,0,"PCTE",0
47,"47205",355,248,244,2,4,"PCTE",0
45,"45085",1535,1061,1052,11,9,"PCTE",2
9,"9192",54,46,45,1,1,"PCTE",0
37,"37026",180,148,147,5,1,"PCTE",0
37,"37283",116,83,83,0,0,"PCTE",0
22,"22094",102,69,69,3,0,"PCTE",1
24,"24027",1214,841,828,6,13,"PCTE",1
18,"18170",317,212,209,0,3,"PCTE",0
34,"34132",106,73,72,0,1,"PCTE",0
23,"23054",375,280,272,1,8,"PCTE",0
40,"40132",45,26,25,0,1,"PCTE",0
37,"37280",70,47,46,0,1,"PCTE",0
9,"9298",72,52,52,1,0,"PCTE",0
49,"49115",167,121,121,2,0,"PCTE",0
33,"33049",5973,3569,3518,48,51,"PCTE",3
9,"9159",62,49,47,0,2,"PCTE",1
18,"18147",3655,2273,2241,16,32,"PCTE",2
16,"16086",872,699,690,7,9,"PCTE",0
28,"28113",36951,27912,27604,241,308,"PCTE",17
19,"19066",51,42,42,0,0,"PCTE",0
28,"28079",2384271,1765443,1753633,13854,11810,"PCTE",879
5,"5199",37,31,31,0,0,"PCTE",0
41,"41028",2108,1652,1632,22,20,"PCTE",1
28,"28146",1806,1232,1218,3,14,"PCTE",0
40,"40046",83,67,67,1,0,"PCTE",0
24,"24123",709,461,457,2,4,"PCTE",0
24,"24198",541,346,344,6,2,"PCTE",0
37,"37362",4783,3469,3420,44,49,"PCTE",6
50,"50268",41,32,32,1,0,"PCTE",0
22,"22103",664,489,489,4,0,"PCTE",0
26,"26123",128,110,110,0,0,"PCTE",1
34,"34189",53,33,33,0,0,"PCTE",0
22,"22039",813,635,634,4,1,"PCTE",0
45,"45136",5827,3908,3864,22,44,"PCTE",2
37,"37113",404,286,285,13,1,"PCTE",0
45,"45173",9756,6811,6720,49,91,"PCTE",5
37,"37143",384,273,273,2,0,"PCTE",2
41,"41102",14773,10377,10028,174,349,"PCTE",7
18,"18050",1649,1113,1095,5,18,"PCTE",0
50,"50092",290,218,214,0,4,"PCTE",0
28,"28009",14593,11026,10913,73,113,"PCTE",7
33,"33051",6787,4318,4268,48,50,"PCTE",4
37,"37077",251,206,204,1,2,"PCTE",0
19,"19262",125,98,98,0,0,"PCTE",0
39,"39058",806,556,554,2,2,"PCTE",0
24,"24196",1907,1322,1299,4,23,"PCTE",2
22,"22207",121,66,65,0,1,"PCTE",0
28,"28112",160,129,129,0,0,"PCTE",0
50,"50177",288,196,193,0,3,"PCTE",0
34,"34208",48,40,40,1,0,"PCTE",1
41,"41012",3375,2259,2214,26,45,"PCTE",1
41,"41101",6025,4299,4213,53,86,"PCTE",0
39,"39086",358,236,235,2,1,"PCTE",0
37,"37089",60,44,43,0,1,"PCTE",0
18,"18012",2114,1519,1492,9,27,"PCTE",0
29,"29049",2890,2069,2034,12,35,"PCTE",1
47,"47147",103,86,82,0,4,"PCTE",0
49,"49119",217,158,156,2,2,"PCTE",0
2,"2027",274,209,203,1,6,"PCTE",1
34,"34051",91,72,70,0,2,"PCTE",0
47,"47177",104,78,78,0,0,"PCTE",0
23,"23091",675,516,512,1,4,"PCTE",0
5,"5902",286,214,211,1,3,"PCTE",0
19,"19263",21,15,15,0,0,"PCTE",0
9,"9011",70,42,40,0,2,"PCTE",0
9,"9272",251,166,166,1,0,"PCTE",1
26,"26049",156,120,115,0,5,"PCTE",0
2,"2028",111,81,81,0,0,"PCTE",0
21,"21058",2567,1806,1766,32,40,"PCTE",2
33,"33025",8956,5493,5453,81,40,"PCTE",4
49,"49120",54,35,35,0,0,"PCTE",0
5,"5005",165,127,119,0,8,"PCTE",0
22,"22072",197,127,126,1,1,"PCTE",0
24,"24022",304,198,195,2,3,"PCTE",0
47,"47190",95,75,75,1,0,"PCTE",0
47,"47222",85,70,70,1,0,"PCTE",0
33,"33035",11214,7359,7303,102,56,"PCTE",11
49,"49168",89,68,68,0,0,"PCTE",0
9,"9388",31,26,25,0,1,"PCTE",0
26,"26141",98,70,70,0,0,"PCTE",0
9,"9439",1061,801,790,2,11,"PCTE",4
22,"22220",147,106,105,1,1,"PCTE",2
28,"28013",41661,29431,29168,241,263,"PCTE",17
34,"34099",53,44,42,0,2,"PCTE",0
40,"40083",73,52,52,1,0,"PCTE",0
49,"49086",111,89,89,1,0,"PCTE",0
49,"49184",172,110,107,2,3,"PCTE",1
19,"19237",39,34,34,0,0,"PCTE",0
49,"49259",79,59,59,0,0,"PCTE",0
34,"34096",48,39,38,0,1,"PCTE",0
42,"42058",103,74,72,1,2,"PCTE",0
14,"14072",983,692,680,6,12,"PCTE",1
21,"21007",6379,4268,4178,66,90,"PCTE",4
26,"26104",10,9,9,1,0,"PCTE",0
49,"49062",103,58,58,0,0,"PCTE",0
23,"23034",2480,1923,1882,15,41,"PCTE",0
23,"23069",5240,4153,4065,26,88,"PCTE",7
50,"50096",34,22,22,0,0,"PCTE",0
16,"16278",61,45,45,0,0,"PCTE",0
49,"49014",116,83,83,1,0,"PCTE",1
50,"50106",123,78,78,0,0,"PCTE",0
19,"19099",286,179,175,1,4,"PCTE",0
19,"19176",227,172,172,0,0,"PCTE",0
16,"16215",237,162,158,1,4,"PCTE",0
37,"37368",17,12,11,0,1,"PCTE",0
14,"14066",5748,4116,4035,59,81,"PCTE",2
2,"2032",259,183,178,2,5,"PCTE",1
37,"37082",733,468,456,7,12,"PCTE",0
5,"5079",66,53,52,0,1,"PCTE",0
37,"37305",219,177,175,2,2,"PCTE",1
41,"41035",1051,733,722,10,11,"PCTE",0
9,"9442",368,265,262,1,3,"PCTE",0
5,"5196",57,43,43,0,0,"PCTE",0
42,"42163",50,27,27,1,0,"PCTE",0
49,"49078",138,113,109,4,4,"PCTE",0
24,"24170",1806,1232,1220,9,12,"PCTE",1
40,"40154",22,18,18,1,0,"PCTE",0
29,"29100",2379,1582,1551,22,31,"PCTE",0
5,"5177",136,117,116,0,1,"PCTE",0
34,"34205",55,38,38,0,0,"PCTE",0
9,"9119",42,24,24,0,0,"PCTE",0
40,"40185",800,560,553,4,7,"PCTE",1
9,"9444",63,40,40,1,0,"PCTE",0
40,"40022",195,144,141,2,3,"PCTE",0
18,"18102",8233,5424,5266,46,158,"PCTE",7
21,"21060",12287,7761,7638,134,123,"PCTE",2
24,"24122",1292,818,810,7,8,"PCTE",0
19,"19302",52,42,42,1,0,"PCTE",0
37,"37357",248,193,192,1,1,"PCTE",0
19,"19047",55,47,47,1,0,"PCTE",0
40,"40056",31,21,20,0,1,"PCTE",0
16,"16058",94,71,71,1,0,"PCTE",0
26,"26134",81,67,67,3,0,"PCTE",0
16,"16218",184,134,133,1,1,"PCTE",0
49,"49053",919,676,661,8,15,"PCTE",0
47,"47089",133,111,111,2,0,"PCTE",0
16,"16098",521,418,415,2,3,"PCTE",0
50,"50074",6156,4100,4022,33,78,"PCTE",4
28,"28048",514,386,384,4,2,"PCTE",0
37,"37371",252,156,155,0,1,"PCTE",0
42,"42045",273,175,174,4,1,"PCTE",0
40,"40186",35,29,29,0,0,"PCTE",0
9,"9068",23,16,16,0,0,"PCTE",0
16,"16272",201,149,147,2,2,"PCTE",0
24,"24064",1501,1030,1012,2,18,"PCTE",1
37,"37152",400,268,261,4,7,"PCTE",0
19,"19045",122,97,96,0,1,"PCTE",0
9,"9123",42,36,36,0,0,"PCTE",0
45,"45147",592,449,443,2,6,"PCTE",0
37,"37310",166,116,115,3,1,"PCTE",0
49,"49093",280,226,223,5,3,"PCTE",0
24,"24174",457,294,289,3,5,"PCTE",0
24,"24139",2071,1371,1346,15,25,"PCTE",1
5,"5015",68,45,44,1,1,"PCTE",0
16,"16100",642,518,514,2,4,"PCTE",0
37,"37278",793,570,567,6,3,"PCTE",1
34,"34108",499,391,384,3,7,"PCTE",0
49,"49128",520,384,378,7,6,"PCTE",0
19,"19242",74,53,53,1,0,"PCTE",0
50,"50277",45,34,34,0,0,"PCTE",0
29,"29075",12886,8292,8191,63,101,"PCTE",1
16,"16175",5071,3807,3732,43,75,"PCTE",0
45,"45174",300,218,217,2,1,"PCTE",0
50,"50068",1943,1299,1287,10,12,"PCTE",0
19,"19188",36,31,31,0,0,"PCTE",0
41,"41904",1789,1125,1109,31,16,"PCTE",0
28,"28034",368,258,255,0,3,"PCTE",0
21,"21013",10626,6990,6807,99,183,"PCTE",0
29,"29052",213,129,128,0,1,"PCTE",0
9,"9450",23,18,18,1,0,"PCTE",0
24,"24176",302,232,226,0,6,"PCTE",0
22,"22239",85,67,65,0,2,"PCTE",0
28,"28106",78872,54111,53443,412,668,"PCTE",47
50,"50121",270,209,208,3,1,"PCTE",0
41,"41068",13963,9596,9407,96,189,"PCTE",6
47,"47031",191,141,140,0,1,"PCTE",1
45,"45078",1333,1084,1077,6,7,"PCTE",0
37,"37186",94,68,68,0,0,"PCTE",0
19,"19305",139,104,103,1,1,"PCTE",0
9,"9289",1353,873,861,4,12,"PCTE",2
47,"47188",98,73,70,0,3,"PCTE",0
50,"50053",643,476,466,3,10,"PCTE",0
16,"16102",1159,815,767,9,48,"PCTE",0
24,"24031",207,160,158,0,2,"PCTE",1
42,"42093",36,28,28,1,0,"PCTE",0
18,"18132",3101,2418,2382,23,36,"PCTE",1
9,"9236",34,25,25,1,0,"PCTE",0
5,"5152",644,498,496,3,2,"PCTE",0
42,"42051",15,9,9,0,0,"PCTE",0
16,"16142",119,90,90,0,0,"PCTE",0
49,"49131",231,149,145,1,4,"PCTE",0
37,"37281",39,28,27,0,1,"PCTE",0
14,"14073",2768,1934,1880,33,54,"PCTE",0
29,"29097",4160,2872,2800,56,72,"PCTE",4
49,"49087",476,246,244,0,2,"PCTE",0
47,"47149",46,33,32,1,1,"PCTE",1
9,"9075",104,82,82,0,0,"PCTE",0
5,"5109",445,334,329,4,5,"PCTE",0
37,"37376",2130,1446,1423,18,23,"PCTE",0
41,"41042",5872,4477,4424,42,53,"PCTE",2
45,"45117",718,552,548,0,4,"PCTE",0
40,"40192",134,106,105,1,1,"PCTE",0
16,"16231",45,38,38,0,0,"PCTE",2
50,"50054",55,37,37,2,0,"PCTE",0
5,"5264",54,32,31,4,1,"PCTE",0
50,"50050",87,62,62,1,0,"PCTE",0
45,"45180",2850,2044,2023,15,21,"PCTE",0
37,"37360",206,135,135,1,0,"PCTE",0
40,"40074",246,193,189,2,4,"PCTE",0
50,"50289",53,42,42,1,0,"PCTE",0
9,"9077",26,21,21,0,0,"PCTE",0
50,"50006",913,670,654,13,16,"PCTE",0
16,"16030",24,18,18,1,0,"PCTE",0
50,"50149",34,25,25,0,0,"PCTE",0
5,"5175",144,109,109,0,0,"PCTE",0
19,"19186",76,60,60,0,0,"PCTE",0
28,"28086",5446,3643,3600,19,43,"PCTE",0
37,"37347",463,349,345,9,4,"PCTE",0
18,"18056",3382,2397,2350,30,47,"PCTE",2
47,"47086",3818,2835,2784,36,51,"PCTE",1
28,"28096",20022,14440,14238,115,202,"PCTE",11
18,"18165",4265,2870,2820,22,50,"PCTE",2
22,"22083",447,360,355,6,5,"PCTE",0
40,"40001",708,544,536,3,8,"PCTE",0
49,"49025",157,121,118,0,3,"PCTE",0
16,"16188",74,57,57,1,0,"PCTE",0
28,"28025",405,294,291,5,3,"PCTE",0
40,"40194",39173,28641,28260,353,381,"PCTE",23
18,"18101",9449,6688,6568,77,120,"PCTE",6
50,"50282",55,38,38,1,0,"PCTE",0
21,"21001",621,431,418,0,13,"PCTE",0
24,"24148",1602,1152,1140,11,12,"PCTE",1
24,"24073",437,285,282,1,3,"PCTE",0
37,"37083",181,155,153,1,2,"PCTE",0
37,"37380",55,41,40,2,1,"PCTE",0
49,"49172",474,278,271,1,7,"PCTE",0
50,"50057",1331,933,922,10,11,"PCTE",0
40,"40002",32,22,21,0,1,"PCTE",0
24,"24182",410,273,270,7,3,"PCTE",0
9,"9463",246,174,174,4,0,"PCTE",0
37,"37130",173,135,134,2,1,"PCTE",0
5,"5124",87,67,67,2,0,"PCTE",0
24,"24038",3024,2121,2071,25,50,"PCTE",2
22,"22150",459,325,321,8,4,"PCTE",0
9,"9297",310,233,233,6,0,"PCTE",0
19,"19154",58,45,45,0,0,"PCTE",0
34,"34089",141,102,101,4,1,"PCTE",0
26,"26155",145,120,119,0,1,"PCTE",0
9,"9122",86,55,55,0,0,"PCTE",0
37,"37381",138,98,93,0,5,"PCTE",0
19,"19159",87,73,72,1,1,"PCTE",0
29,"29009",1435,971,957,17,14,"PCTE",1
28,"28027",1215,836,826,8,10,"PCTE",0
18,"18010",527,398,394,5,4,"PCTE",0
9,"9194",1970,1376,1359,15,17,"PCTE",4
47,"47068",29,21,21,0,0,"PCTE",0
21,"21074",2736,1826,1790,19,36,"PCTE",0
29,"29036",614,393,387,1,6,"PCTE",0
5,"5158",346,263,261,0,2,"PCTE",0
42,"42020",4170,2732,2686,35,46,"PCTE",1
41,"41092",7681,5408,5299,79,109,"PCTE",0
33,"33068",1031,518,510,5,8,"PCTE",1
14,"14050",2350,1774,1720,20,54,"PCTE",1
50,"50135",85,59,59,0,0,"PCTE",0
45,"45123",3196,2252,2218,11,34,"PCTE",1
16,"16111",168,114,111,2,3,"PCTE",0
18,"18071",5636,3909,3807,45,102,"PCTE",1
34,"34124",60,45,45,0,0,"PCTE",0
49,"49104",326,218,216,0,2,"PCTE",0
21,"21045",231,177,174,4,3,"PCTE",0
14,"14051",1323,975,951,7,24,"PCTE",0
49,"49138",205,141,140,2,1,"PCTE",0
45,"45124",2080,1628,1595,15,33,"PCTE",0
19,"19222",95,70,70,2,0,"PCTE",0
50,"50285",657,448,442,4,6,"PCTE",0
33,"33069",3379,2249,2231,41,18,"PCTE",2
29,"29010",1637,1263,1187,2,76,"PCTE",0
49,"49141",290,191,191,1,0,"PCTE",0
34,"34125",105,80,80,2,0,"PCTE",0
28,"28029",576,443,443,4,0,"PCTE",0
42,"42156",29,21,21,0,0,"PCTE",0
47,"47166",251,183,181,2,2,"PCTE",0
45,"45101",3671,2842,2808,13,34,"PCTE",4
49,"49083",47,37,37,1,0,"PCTE",0
9,"9318",56,33,33,0,0,"PCTE",1
50,"50032",243,167,164,3,3,"PCTE",0
16,"16213",34,27,26,0,1,"PCTE",0
37,"37085",5060,3732,3689,52,43,"PCTE",1
47,"47157",490,398,397,2,1,"PCTE",0
39,"39024",1802,1325,1314,7,11,"PCTE",2
14,"14024",1849,1417,1391,5,26,"PCTE",1
37,"37375",678,539,523,8,16,"PCTE",0
45,"45150",428,322,319,3,3,"PCTE",0
34,"34110",75,64,64,0,0,"PCTE",0
42,"42023",57,48,48,0,0,"PCTE",0
28,"28169",1577,1214,1209,7,5,"PCTE",0
33,"33071",546,385,383,7,2,"PCTE",0
42,"42200",74,49,46,0,3,"PCTE",0
37,"37230",220,169,168,1,1,"PCTE",0
45,"45126",234,146,144,2,2,"PCTE",0
2,"2083",209,181,181,0,0,"PCTE",0
50,"50138",45,37,37,3,0,"PCTE",0
19,"19254",43,34,34,0,0,"PCTE",0
37,"37355",159,121,120,1,1,"PCTE",0
9,"9090",49,41,39,2,2,"PCTE",1
21,"21078",2641,1718,1670,10,48,"PCTE",1
22,"22242",60,41,40,0,1,"PCTE",0
49,"49257",305,186,184,0,2,"PCTE",0
42,"42202",19,11,10,0,1,"PCTE",0
47,"47138",224,169,166,0,3,"PCTE",0
16,"16003",134,108,105,0,3,"PCTE",1
9,"9144",44,31,31,0,0,"PCTE",0
23,"23044",4697,3495,3400,31,95,"PCTE",6
28,"28043",6190,4031,3969,33,62,"PCTE",2
16,"16079",28,16,16,0,0,"PCTE",0
34,"34068",29,25,24,0,1,"PCTE",0
39,"39073",10260,7537,7482,42,55,"PCTE",2
2,"2085",306,232,226,2,6,"PCTE",0
45,"45190",462,361,353,3,8,"PCTE",0
41,"41052",3032,2162,2092,6,70,"PCTE",0
9,"9148",77,58,58,3,0,"PCTE",0
50,"50190",669,532,518,10,14,"PCTE",0
19,"19321",34,28,28,0,0,"PCTE",0
42,"42113",510,370,366,2,4,"PCTE",2
9,"9257",85,67,67,2,0,"PCTE",0
42,"42115",89,68,66,0,2,"PCTE",0
50,"50193",664,487,475,4,12,"PCTE",1
47,"47170",43,36,30,0,6,"PCTE",0
47,"47150",253,193,187,3,6,"PCTE",0
16,"16169",49,28,28,0,0,"PCTE",0
5,"5034",15,14,13,0,1,"PCTE",0
42,"42016",20,13,13,0,0,"PCTE",0
24,"24219",489,334,329,7,5,"PCTE",0
50,"50140",153,96,95,1,1,"PCTE",0
24,"24180",1086,767,759,9,8,"PCTE",0
37,"37316",711,546,541,7,5,"PCTE",0
2,"2064",371,288,283,2,5,"PCTE",0
50,"50088",274,195,191,2,4,"PCTE",0
47,"47004",1135,878,872,5,6,"PCTE",0
22,"22020",115,83,80,3,3,"PCTE",0
42,"42028",75,57,56,0,1,"PCTE",0
34,"34181",422,289,285,0,4,"PCTE",2
37,"37294",11750,8395,8280,88,115,"PCTE",7
24,"24084",153,105,102,2,3,"PCTE",0
49,"49148",259,119,115,1,4,"PCTE",0
41,"41098",5161,3792,3732,33,60,"PCTE",1
16,"16198",1281,938,928,6,10,"PCTE",1
41,"41054",719,562,546,3,16,"PCTE",0
19,"19257",3279,2233,2206,21,27,"PCTE",2
24,"24086",258,197,196,1,1,"PCTE",1
40,"40010",108,83,82,0,1,"PCTE",0
37,"37005",65,44,44,1,0,"PCTE",0
24,"24050",105,77,77,2,0,"PCTE",0
24,"24181",1404,944,925,7,19,"PCTE",0
2,"2055",1055,672,668,2,4,"PCTE",0
50,"50216",236,169,167,0,2,"PCTE",0
50,"50065",56,37,37,0,0,"PCTE",0
18,"18047",6103,3992,3922,61,70,"PCTE",3
19,"19258",84,63,62,0,1,"PCTE",0
9,"9901",334,228,226,4,2,"PCTE",1
41,"41100",954,670,635,7,35,"PCTE",2
49,"49227",317,245,244,4,1,"PCTE",1
23,"23049",1740,1215,1183,12,32,"PCTE",6
26,"26031",95,83,83,0,0,"PCTE",0
42,"42100",30,24,24,1,0,"PCTE",0
45,"45093",147,115,114,0,1,"PCTE",0
50,"50125",340,230,229,2,1,"PCTE",0
50,"50168",29,20,20,0,0,"PCTE",0
39,"39021",464,370,364,1,6,"PCTE",0
16,"16251",1805,1318,1302,9,16,"PCTE",0
5,"5134",47,40,40,0,0,"PCTE",0
24,"24197",717,500,499,2,1,"PCTE",2
5,"5135",399,294,292,2,2,"PCTE",0
49,"49263",44,32,32,1,0,"PCTE",0
42,"42031",25,17,17,1,0,"PCTE",0
34,"34047",1711,1275,1248,18,27,"PCTE",3
23,"23086",11427,7984,7735,81,249,"PCTE",13
19,"19169",30,27,27,0,0,"PCTE",0
22,"22064",155,100,100,2,0,"PCTE",0
5,"5070",30,29,29,0,0,"PCTE",0
22,"22176",171,140,138,2,2,"PCTE",0
9,"9903",3112,2087,2058,24,29,"PCTE",2
40,"40207",802,593,590,11,3,"PCTE",1
28,"28176",13980,10765,10701,72,64,"PCTE",2
22,"22214",117,92,89,0,3,"PCTE",0
37,"37331",186,115,114,2,1,"PCTE",0
33,"33050",548,316,314,1,2,"PCTE",0
22,"22137",1009,671,665,1,6,"PCTE",0
9,"9160",83,63,63,1,0,"PCTE",0
50,"50293",392,257,255,2,2,"PCTE",0
2,"2058",300,186,177,1,9,"PCTE",0
28,"28008",2008,1333,1323,7,10,"PCTE",0
37,"37038",756,531,517,4,14,"PCTE",1
5,"5039",47,43,43,0,0,"PCTE",0
42,"42033",50,48,48,2,0,"PCTE",0
19,"19231",10,6,6,0,0,"PCTE",0
47,"47080",33,25,24,0,1,"PCTE",0
41,"41057",258,174,170,3,4,"PCTE",0
16,"16254",199,159,159,0,0,"PCTE",1
14,"14061",687,536,523,1,13,"PCTE",1
34,"34140",93,57,57,1,0,"PCTE",0
34,"34001",39,27,27,1,0,"PCTE",0
37,"37300",540,355,352,7,3,"PCTE",0
5,"5201",497,404,401,0,3,"PCTE",1
24,"24125",416,233,231,3,2,"PCTE",0
40,"40143",82,68,67,2,1,"PCTE",2
37,"37229",138,103,101,0,2,"PCTE",0
16,"16194",219,169,161,0,8,"PCTE",0
49,"49031",148,107,105,2,2,"PCTE",0
45,"45053",7820,5814,5712,56,102,"PCTE",0
50,"50262",1161,849,832,11,17,"PCTE",1
19,"19126",1701,1223,1207,6,16,"PCTE",0
45,"45200",4471,3351,3269,25,82,"PCTE",2
37,"37289",210,147,144,0,3,"PCTE",1
22,"22181",86,55,54,2,1,"PCTE",0
47,"47020",270,212,207,5,5,"PCTE",0
45,"45028",3613,2675,2647,22,28,"PCTE",0
24,"24165",317,202,199,1,3,"PCTE",0
37,"37364",760,502,500,0,2,"PCTE",1
39,"39006",1729,1207,1192,1,15,"PCTE",0
18,"18085",690,440,432,1,8,"PCTE",0
19,"19233",79,65,65,2,0,"PCTE",0
19,"19330",69,62,62,0,0,"PCTE",0
28,"28149",6298,4751,4699,35,52,"PCTE",6
14,"14034",302,222,215,1,7,"PCTE",0
34,"34143",161,115,112,2,3,"PCTE",0
40,"40115",142,100,100,0,0,"PCTE",0
19,"19297",32,28,28,0,0,"PCTE",0
24,"24057",1295,909,891,7,18,"PCTE",2
19,"19142",263,179,179,1,0,"PCTE",0
22,"22142",94,72,70,0,2,"PCTE",0
21,"21028",370,265,259,2,6,"PCTE",0
47,"47083",81,63,61,0,2,"PCTE",0
37,"37272",132,97,95,0,2,"PCTE",0
23,"23019",1466,1117,1090,5,27,"PCTE",1
26,"26088",39,35,34,0,1,"PCTE",1
18,"18024",837,651,639,11,12,"PCTE",0
50,"50247",852,600,594,8,6,"PCTE",0
22,"22184",167,132,130,4,2,"PCTE",0
18,"18184",2193,1542,1511,16,31,"PCTE",0
5,"5141",95,79,78,1,1,"PCTE",0
47,"47116",396,304,302,2,2,"PCTE",1
37,"37042",36,27,27,1,0,"PCTE",0
45,"45141",848,626,615,0,11,"PCTE",0
29,"29051",42179,27231,26724,282,507,"PCTE",11
18,"18152",928,663,660,3,3,"PCTE",0
24,"24059",804,466,463,5,3,"PCTE",2
49,"49157",188,136,133,2,3,"PCTE",2
16,"16081",50,37,36,0,1,"PCTE",0
37,"37003",104,75,75,2,0,"PCTE",0
42,"42083",26,20,20,0,0,"PCTE",0
5,"5195",199,125,125,1,0,"PCTE",0
45,"45130",294,222,222,1,0,"PCTE",0
50,"50157",289,199,196,1,3,"PCTE",0
34,"34116",54,35,35,0,0,"PCTE",0
29,"29089",3138,2262,2186,13,76,"PCTE",4
26,"26064",2335,1617,1584,28,33,"PCTE",2
22,"22032",102,69,68,1,1,"PCTE",0
49,"49047",98,74,72,1,2,"PCTE",0
18,"18088",1526,1000,993,10,7,"PCTE",0
26,"26117",2105,1537,1500,17,37,"PCTE",1
49,"49158",206,159,155,0,4,"PCTE",0
39,"39037",2033,1431,1420,3,11,"PCTE",1
40,"40214",198,160,154,0,6,"PCTE",0
45,"45033",297,205,201,1,4,"PCTE",0
50,"50123",430,304,297,3,7,"PCTE",0
18,"18089",14504,9854,9746,100,108,"PCTE",4
49,"49271",176,128,127,3,1,"PCTE",0
49,"49194",331,198,197,0,1,"PCTE",0
26,"26017",364,274,269,2,5,"PCTE",0
47,"47055",188,147,147,2,0,"PCTE",0
37,"37180",68,45,44,1,1,"PCTE",0
29,"29071",980,580,564,11,16,"PCTE",0
16,"16249",1938,1422,1406,6,16,"PCTE",0
19,"19177",60,45,45,0,0,"PCTE",0
49,"49050",498,305,305,2,0,"PCTE",1
34,"34103",96,79,76,0,3,"PCTE",0
9,"9065",136,112,111,0,1,"PCTE",0
37,"37369",126,83,81,0,2,"PCTE",0
22,"22045",65,52,52,0,0,"PCTE",0
5,"5144",65,47,46,1,1,"PCTE",0
49,"49272",73,49,46,2,3,"PCTE",0
16,"16019",187,141,141,1,0,"PCTE",0
24,"24210",524,353,353,1,0,"PCTE",0
34,"34012",342,237,232,3,5,"PCTE",0
28,"28901",890,624,618,5,6,"PCTE",0
50,"50040",82,66,66,1,0,"PCTE",0
14,"14068",517,388,378,3,10,"PCTE",0
5,"5037",210,135,135,0,0,"PCTE",0
18,"18059",4265,2960,2886,23,74,"PCTE",3
50,"50099",3036,2137,2113,17,24,"PCTE",2
39,"39067",753,476,474,1,2,"PCTE",1
37,"37049",125,76,76,0,0,"PCTE",0
40,"40218",80,56,55,0,1,"PCTE",0
23,"23060",19210,13677,13495,145,182,"PCTE",11
28,"28047",42984,30772,30486,270,286,"PCTE",12
37,"37121",536,413,403,4,10,"PCTE",0
40,"40024",823,582,575,8,7,"PCTE",0
9,"9228",155,129,129,0,0,"PCTE",1
34,"34106",110,92,92,3,0,"PCTE",0
49,"49275",51064,34471,34017,475,454,"PCTE",53
23,"23061",7711,5357,5231,44,126,"PCTE",1
24,"24100",737,506,502,9,4,"PCTE",0
37,"37277",74,55,55,0,0,"PCTE",0
9,"9230",33,26,26,0,0,"PCTE",0
14,"14013",16619,11968,11719,153,249,"PCTE",6
37,"37122",203,162,161,3,1,"PCTE",0
50,"50227",107,62,62,1,0,"PCTE",0
2,"2002",427,340,337,2,3,"PCTE",0
26,"26021",2742,1967,1932,14,35,"PCTE",2
14,"14041",3113,2234,2160,43,74,"PCTE",7
45,"45148",263,184,184,0,0,"PCTE",0
9,"9178",39,24,24,0,0,"PCTE",0
41,"41067",7273,5114,5036,59,78,"PCTE",2
24,"24213",158,127,126,1,1,"PCTE",1
41,"41066",1307,927,898,7,29,"PCTE",1
28,"28049",57814,44977,44559,385,418,"PCTE",33
18,"18161",245,199,196,0,3,"PCTE",0
49,"49129",810,541,527,4,14,"PCTE",2
42,"42140",15,11,11,1,0,"PCTE",0
2,"2003",134196,96374,95521,913,853,"PCTE",75
16,"16061",939,746,727,16,19,"PCTE",0
24,"24175",1821,1316,1305,15,11,"PCTE",1
16,"16255",132,99,99,0,0,"PCTE",0
50,"50042",19,17,17,1,0,"PCTE",0
37,"37102",375,260,260,4,0,"PCTE",0
21,"21016",985,703,680,5,23,"PCTE",0
42,"42157",10,9,9,0,0,"PCTE",0
37,"37374",1138,889,872,2,17,"PCTE",1
9,"9347",140,111,107,1,4,"PCTE",0
40,"40158",15,11,11,0,0,"PCTE",0
39,"39099",3193,2363,2346,10,17,"PCTE",0
49,"49057",107,74,71,0,3,"PCTE",0
24,"24056",2726,1803,1772,21,31,"PCTE",1
49,"49166",1193,835,821,7,14,"PCTE",4
41,"41040",11183,8351,8253,71,98,"PCTE",2
19,"19152",540,377,374,2,3,"PCTE",0
42,"42011",16,11,11,0,0,"PCTE",0
50,"50155",95,65,65,0,0,"PCTE",0
42,"42142",42,36,36,1,0,"PCTE",0
42,"42092",61,40,39,0,1,"PCTE",0
45,"45004",546,400,398,2,2,"PCTE",1
29,"29059",2662,1950,1895,16,55,"PCTE",1
34,"34160",133,107,106,0,1,"PCTE",0
18,"18901",489,323,322,5,1,"PCTE",0
23,"23902",2219,1813,1770,6,43,"PCTE",1
16,"16063",112,81,81,1,0,"PCTE",0
28,"28052",3961,2700,2659,14,41,"PCTE",2
40,"40060",67,40,40,1,0,"PCTE",0
40,"40222",161,134,131,1,3,"PCTE",0
9,"9026",377,288,288,1,0,"PCTE",0
14,"14017",10953,7929,7791,84,138,"PCTE",9
18,"18163",311,206,204,0,2,"PCTE",0
39,"39100",849,567,565,5,2,"PCTE",1
49,"49022",282,230,229,2,1,"PCTE",0
22,"22197",436,327,325,3,2,"PCTE",0
5,"5086",76,58,58,1,0,"PCTE",0
33,"33063",375,269,267,5,2,"PCTE",0
37,"37091",161,104,104,0,0,"PCTE",0
22,"22906",177,123,122,6,1,"PCTE",0
18,"18003",14454,10162,9935,105,227,"PCTE",14
47,"47128",53,45,43,0,2,"PCTE",0
22,"22158",11994,8115,8049,79,66,"PCTE",7
16,"16276",20,17,17,1,0,"PCTE",0
18,"18099",1582,1184,1156,13,28,"PCTE",0
26,"26181",15,14,14,0,0,"PCTE",0
24,"24179",287,207,207,2,0,"PCTE",0
28,"28118",61,52,50,0,2,"PCTE",0
42,"42039",216,144,141,1,3,"PCTE",0
19,"19256",46,36,36,0,0,"PCTE",0
19,"19226",37,22,22,0,0,"PCTE",0
19,"19111",160,128,125,0,3,"PCTE",0
9,"9115",90,65,63,3,2,"PCTE",0
19,"19027",129,97,95,1,2,"PCTE",0
45,"45155",311,240,240,0,0,"PCTE",0
40,"40075",152,116,116,0,0,"PCTE",0
42,"42176",27,21,21,0,0,"PCTE",0
22,"22119",1267,880,871,4,9,"PCTE",0
9,"9456",130,86,86,1,0,"PCTE",0
28,"28044",6266,4693,4642,36,51,"PCTE",0
24,"24146",254,202,201,1,1,"PCTE",1
22,"22160",207,149,149,1,0,"PCTE",0
42,"42192",36,22,22,2,0,"PCTE",0
19,"19246",42,27,27,1,0,"PCTE",0
37,"37057",208,151,149,0,2,"PCTE",0
34,"34071",158,128,128,2,0,"PCTE",0
49,"49134",158,100,99,1,1,"PCTE",0
18,"18006",4062,2765,2711,25,54,"PCTE",6
2,"2009",19495,13877,13663,134,214,"PCTE",11
26,"26183",66,48,48,0,0,"PCTE",0
22,"22232",88,61,61,2,0,"PCTE",0
19,"19156",917,686,679,2,7,"PCTE",2
50,"50133",98,76,76,0,0,"PCTE",0
37,"37223",106,75,74,0,1,"PCTE",0
2,"2010",1784,1374,1349,12,25,"PCTE",3
45,"45083",568,433,429,2,4,"PCTE",1
16,"16238",461,380,378,1,2,"PCTE",0
37,"37318",196,132,132,0,0,"PCTE",0
9,"9034",291,227,224,1,3,"PCTE",0
5,"5156",242,145,145,1,0,"PCTE",0
19,"19280",3669,2622,2597,24,25,"PCTE",2
19,"19052",21,16,16,0,0,"PCTE",0
47,"47131",167,122,120,2,2,"PCTE",0
5,"5253",75,54,54,0,0,"PCTE",0
28,"28056",946,664,660,2,4,"PCTE",0
24,"24222",14499,10219,10076,99,143,"PCTE",9
40,"40033",70,55,52,1,3,"PCTE",0
37,"37350",403,281,274,1,7,"PCTE",1
49,"49126",260,153,150,1,3,"PCTE",1
50,"50284",129,98,98,0,0,"PCTE",0
40,"40196",30,24,24,0,0,"PCTE",0
50,"50058",63,45,43,0,2,"PCTE",0
45,"45196",1382,1029,1005,7,24,"PCTE",0
23,"23038",3786,2934,2900,21,34,"PCTE",0
50,"50033",61,44,44,1,0,"PCTE",0
50,"50185",140,93,92,1,1,"PCTE",0
23,"23072",1879,1389,1363,3,26,"PCTE",1
40,"40034",74,59,58,0,1,"PCTE",0
2,"2045",3609,2797,2752,38,45,"PCTE",3
9,"9414",180,137,135,1,2,"PCTE",0
50,"50259",82,55,55,2,0,"PCTE",0
19,"19249",29,26,26,0,0,"PCTE",0
19,"19190",2284,1632,1613,16,19,"PCTE",0
21,"21014",4066,3089,3029,30,60,"PCTE",2
47,"47038",100,61,61,0,0,"PCTE",0
45,"45050",505,338,332,2,6,"PCTE",0
5,"5189",397,293,291,3,2,"PCTE",0
16,"16902",124,86,86,1,0,"PCTE",0
49,"49066",437,276,272,2,4,"PCTE",1
28,"28028",1836,1374,1363,3,11,"PCTE",0
40,"40165",73,53,52,0,1,"PCTE",0
28,"28101",226,174,172,1,2,"PCTE",0
9,"9362",198,156,156,4,0,"PCTE",0
14,"14023",1999,1629,1593,11,36,"PCTE",0
45,"45013",1679,1266,1248,5,18,"PCTE",0
16,"16151",61,51,51,1,0,"PCTE",0
47,"47165",6823,4999,4906,48,93,"PCTE",4
19,"19283",29,26,26,0,0,"PCTE",0
50,"50136",532,366,361,3,5,"PCTE",0
41,"41048",2195,1445,1400,13,45,"PCTE",1
9,"9308",58,34,34,1,0,"PCTE",0
22,"22127",521,353,352,5,1,"PCTE",0
33,"33070",3267,2211,2185,27,26,"PCTE",0
37,"37088",199,135,133,0,2,"PCTE",0
14,"14005",6298,3905,3828,71,77,"PCTE",3
5,"5106",27,14,14,0,0,"PCTE",0
9,"9163",573,436,432,7,4,"PCTE",0
37,"37124",195,137,137,2,0,"PCTE",0
22,"22059",1135,765,752,2,13,"PCTE",0
18,"18140",42474,26967,26648,225,319,"PCTE",19
47,"47010",14718,11521,11392,137,129,"PCTE",6
24,"24079",861,601,595,9,6,"PCTE",1
2,"2082",98,80,80,0,0,"PCTE",0
28,"28021",571,365,364,1,1,"PCTE",2
22,"22168",22,20,19,0,1,"PCTE",0
50,"50011",117,90,89,3,1,"PCTE",0
22,"22027",311,210,209,1,1,"PCTE",0
19,"19096",105,72,70,0,2,"PCTE",0
24,"24080",207,155,154,1,1,"PCTE",0
50,"50035",74,57,57,0,0,"PCTE",0
49,"49069",337,210,201,0,9,"PCTE",0
18,"18013",4154,2892,2812,28,80,"PCTE",2
9,"9041",25,21,21,2,0,"PCTE",0
18,"18107",920,643,626,1,17,"PCTE",0
49,"49033",655,440,434,4,6,"PCTE",0
50,"50213",92,70,70,2,0,"PCTE",0
24,"24189",5872,3915,3873,42,42,"PCTE",2
37,"37167",174,147,144,2,3,"PCTE",0
50,"50113",587,471,461,2,10,"PCTE",0
9,"9255",83,58,58,0,0,"PCTE",0
26,"26037",125,98,98,3,0,"PCTE",0
50,"50165",1768,1255,1222,20,33,"PCTE",1
45,"45055",1004,768,755,4,13,"PCTE",1
18,"18108",822,604,599,2,5,"PCTE",1
14,"14026",2000,1294,1253,20,41,"PCTE",1
21,"21049",3262,2028,1977,15,51,"PCTE",1
19,"19098",20,17,17,0,0,"PCTE",0
39,"39026",1702,1160,1151,11,9,"PCTE",0
50,"50013",199,158,158,0,0,"PCTE",0
40,"40008",42,36,36,1,0,"PCTE",0
23,"23080",1720,1313,1294,6,19,"PCTE",2
18,"18077",471,350,343,1,7,"PCTE",0
37,"37002",125,64,63,0,1,"PCTE",0
18,"18176",242,164,161,2,3,"PCTE",0
50,"50288",3440,2513,2486,26,27,"PCTE",0
5,"5033",169,135,134,0,1,"PCTE",0
40,"40172",47,33,32,0,1,"PCTE",0
26,"26003",379,311,306,1,5,"PCTE",0
5,"5228",168,99,98,0,1,"PCTE",0
28,"28064",125,98,95,3,3,"PCTE",0
49,"49235",415,300,290,4,10,"PCTE",1
23,"23020",1510,1263,1253,16,10,"PCTE",3
41,"41024",22819,14767,14455,169,312,"PCTE",14
47,"47203",54,40,40,0,0,"PCTE",0
22,"22230",291,209,207,4,2,"PCTE",2
41,"41053",21693,15843,15379,171,464,"PCTE",5
16,"16131",123,84,84,0,0,"PCTE",0
47,"47034",75,58,58,2,0,"PCTE",0
45,"45020",1240,905,900,5,5,"PCTE",0
19,"19061",56,42,41,0,1,"PCTE",0
42,"42191",183,116,114,5,2,"PCTE",0
2,"2086",2389,1567,1554,10,13,"PCTE",0
49,"49077",157,80,80,0,0,"PCTE",0
22,"22131",84,62,58,5,4,"PCTE",0
9,"9047",52,42,41,1,1,"PCTE",0
21,"21051",222,171,168,3,3,"PCTE",0
26,"26005",2483,1589,1570,13,19,"PCTE",2
9,"9208",176,121,120,4,1,"PCTE",0
19,"19196",89,70,67,1,3,"PCTE",0
2,"2020",425,336,332,4,4,"PCTE",0
40,"40903",75,61,59,0,2,"PCTE",0
23,"23010",14264,9801,9635,120,166,"PCTE",3
45,"45059",1702,1315,1303,1,12,"PCTE",0
16,"16044",43,29,28,0,1,"PCTE",0
37,"37004",25,18,18,0,0,"PCTE",0
19,"19228",27,17,17,1,0,"PCTE",0
40,"40109",69,51,50,3,1,"PCTE",0
19,"19103",247,205,202,1,3,"PCTE",0
24,"24120",305,182,181,1,1,"PCTE",0
37,"37171",396,272,270,2,2,"PCTE",0
50,"50089",8616,6420,6364,50,56,"PCTE",2
5,"5167",223,177,172,0,5,"PCTE",0
5,"5230",65,57,56,1,1,"PCTE",0
45,"45022",395,292,292,2,0,"PCTE",0
41,"41055",14791,10197,10000,125,197,"PCTE",5
9,"9213",264,182,182,1,0,"PCTE",0
2,"2023",504,419,412,0,7,"PCTE",0
49,"49262",367,263,261,1,2,"PCTE",0
22,"22036",84,71,71,1,0,"PCTE",0
37,"37072",144,121,118,5,3,"PCTE",0
19,"19198",17,14,14,0,0,"PCTE",0
28,"28067",4416,3359,3311,18,48,"PCTE",0
9,"9051",164,125,125,0,0,"PCTE",0
14,"14030",7761,5711,5588,84,123,"PCTE",2
50,"50117",123,93,93,4,0,"PCTE",0
37,"37266",68,44,44,0,0,"PCTE",0
26,"26161",8,8,8,0,0,"PCTE",0
37,"37361",84,55,54,1,1,"PCTE",0
9,"9378",31,20,19,0,1,"PCTE",1
42,"42209",134,86,84,4,2,"PCTE",0
26,"26080",451,347,344,0,3,"PCTE",0
50,"50041",16,10,10,0,0,"PCTE",0
49,"49186",230,172,170,0,2,"PCTE",2
47,"47048",175,124,122,0,2,"PCTE",1
19,"19291",1143,803,794,2,9,"PCTE",1
50,"50170",357,245,242,6,3,"PCTE",0
45,"45062",1075,816,808,11,8,"PCTE",1
49,"49187",1197,839,819,12,20,"PCTE",0
19,"19230",558,409,406,1,3,"PCTE",1
40,"40177",139,106,105,0,1,"PCTE",0
49,"49081",1321,972,953,6,19,"PCTE",0
23,"23015",1316,979,973,18,6,"PCTE",3
16,"16162",39,31,31,0,0,"PCTE",0
19,"19135",90,71,69,1,2,"PCTE",0
18,"18115",2635,1766,1738,13,28,"PCTE",0
26,"26009",394,282,278,1,4,"PCTE",1
24,"24199",398,263,256,4,7,"PCTE",0
16,"16125",1607,1166,1150,11,16,"PCTE",1
5,"5073",282,210,207,1,3,"PCTE",0
9,"9382",27,22,22,0,0,"PCTE",0
5,"5267",103,67,67,1,0,"PCTE",0
5,"5170",47,34,34,1,0,"PCTE",0
16,"16048",404,300,298,2,2,"PCTE",0
28,"28070",105,80,80,3,0,"PCTE",0
42,"42076",200,149,143,2,6,"PCTE",0
29,"29095",3285,2313,2224,39,89,"PCTE",2
45,"45113",1770,1189,1171,5,18,"PCTE",1
37,"37205",212,157,155,1,2,"PCTE",0
9,"9164",147,112,111,0,1,"PCTE",1
29,"29012",9718,6664,6553,85,111,"PCTE",2
18,"18194",2038,1373,1348,12,25,"PCTE",0
47,"47030",935,680,669,5,11,"PCTE",0
21,"21036",204,128,121,1,7,"PCTE",0
9,"9365",26,17,17,0,0,"PCTE",0
42,"42079",21,17,17,1,0,"PCTE",0
18,"18117",497,360,354,1,6,"PCTE",0
47,"47050",3908,2713,2673,39,40,"PCTE",0
16,"16049",137,98,98,2,0,"PCTE",0
49,"49267",96,67,63,2,4,"PCTE",0
49,"49084",266,197,195,11,2,"PCTE",2
50,"50221",29,18,18,0,0,"PCTE",0
23,"23017",1498,1153,1129,11,24,"PCTE",0
34,"34141",176,149,146,0,3,"PCTE",0
34,"34196",87,67,67,3,0,"PCTE",0
37,"37302",262,161,161,2,0,"PCTE",0
24,"24092",731,506,504,1,2,"PCTE",0
16,"16165",56,45,45,0,0,"PCTE",0
47,"47148",419,332,324,3,8,"PCTE",0
2,"2061",605,464,458,3,6,"PCTE",0
47,"47115",276,212,211,1,1,"PCTE",0
42,"42217",33,25,25,0,0,"PCTE",0
45,"45176",3859,2694,2662,24,32,"PCTE",1
45,"45067",2267,1722,1675,14,47,"PCTE",1
9,"9167",53,36,36,0,0,"PCTE",0
49,"49191",265,192,188,2,4,"PCTE",0
23,"23092",27717,19749,19490,217,259,"PCTE",17
37,"37335",384,282,279,1,3,"PCTE",1
49,"49046",246,174,169,0,5,"PCTE",0
34,"34146",53,43,43,0,0,"PCTE",0
37,"37208",71,49,49,0,0,"PCTE",0
18,"18120",266,204,204,4,0,"PCTE",0
42,"42218",68,44,43,0,1,"PCTE",1
34,"34053",194,156,154,3,2,"PCTE",0
49,"49121",372,239,233,1,6,"PCTE",0
37,"37178",98,70,70,0,0,"PCTE",0
28,"28073",12707,9198,9080,94,118,"PCTE",8
19,"19204",150,105,104,3,1,"PCTE",0
14,"14036",3677,2619,2555,39,64,"PCTE",0
33,"33026",8201,5014,4974,74,40,"PCTE",7
5,"5174",62,51,51,1,0,"PCTE",0
50,"50166",235,186,186,0,0,"PCTE",0
9,"9202",22,16,16,2,0,"PCTE",0
22,"22186",189,148,145,3,3,"PCTE",0
9,"9062",40,34,33,0,1,"PCTE",0
23,"23094",3739,2920,2876,29,44,"PCTE",5
16,"16146",85,49,49,0,0,"PCTE",0
19,"19050",15,13,13,0,0,"PCTE",0
9,"9315",384,245,242,3,3,"PCTE",0
26,"26129",939,657,644,2,13,"PCTE",0
9,"9224",147,113,112,0,1,"PCTE",1
5,"5905",214,148,142,1,6,"PCTE",0
47,"47054",599,465,460,1,5,"PCTE",0
23,"23021",512,406,399,2,7,"PCTE",0
34,"34202",28,23,23,2,0,"PCTE",0
28,"28075",6020,4521,4469,37,52,"PCTE",3
26,"26130",205,153,150,1,3,"PCTE",1
21,"21061",5083,3325,3255,36,70,"PCTE",0
40,"40053",79,56,56,1,0,"PCTE",0
45,"45070",1412,1158,1136,7,22,"PCTE",1
37,"37148",399,295,291,0,4,"PCTE",0
28,"28015",20885,16237,16104,134,133,"PCTE",2
24,"24060",561,297,296,2,1,"PCTE",0
5,"5010",142,102,100,2,2,"PCTE",0
29,"29070",43686,27672,27323,290,349,"PCTE",17
19,"19334",43,35,35,0,0,"PCTE",0
18,"18157",1148,843,827,7,16,"PCTE",2
18,"18027",2598,1730,1706,12,24,"PCTE",2
37,"37046",10648,7396,7241,62,155,"PCTE",1
19,"19006",755,506,494,4,12,"PCTE",0
42,"42004",2290,1595,1565,30,30,"PCTE",1
40,"40121",249,188,178,1,10,"PCTE",0
24,"24134",3287,2278,2226,18,52,"PCTE",0
26,"26131",34,33,33,0,0,"PCTE",0
18,"18028",898,723,718,3,5,"PCTE",0
19,"19301",37,26,26,0,0,"PCTE",0
40,"40087",85,70,70,0,0,"PCTE",1
34,"34904",300,188,186,0,2,"PCTE",0
47,"47121",517,410,398,2,12,"PCTE",0
45,"45109",2791,2123,2072,20,51,"PCTE",2
19,"19078",47,37,36,0,1,"PCTE",0
22,"22188",75,50,50,1,0,"PCTE",0
34,"34060",133,109,107,0,2,"PCTE",0
41,"41009",1148,750,732,5,18,"PCTE",0
50,"50275",111,50,50,0,0,"PCTE",0
9,"9445",41,28,27,1,1,"PCTE",0
37,"37246",5146,3791,3737,42,54,"PCTE",5
49,"49162",170,117,116,1,1,"PCTE",0
47,"47088",101,79,79,0,0,"PCTE",0
19,"19044",275,186,182,0,4,"PCTE",0
9,"9066",54,37,37,0,0,"PCTE",1
26,"26173",8,8,8,1,0,"PCTE",0
9,"9343",92,66,65,0,1,"PCTE",0
49,"49092",115,72,72,0,0,"PCTE",0
9,"9021",50,30,30,3,0,"PCTE",0
49,"49200",936,679,670,9,9,"PCTE",1
49,"49163",203,139,138,3,1,"PCTE",1
16,"16023",513,367,367,3,0,"PCTE",0
34,"34061",91,70,69,1,1,"PCTE",0
5,"5179",199,176,172,1,4,"PCTE",0
47,"47154",146,115,111,6,4,"PCTE",0
9,"9398",73,52,52,0,0,"PCTE",1
42,"42139",21,16,16,2,0,"PCTE",0
29,"29074",771,561,555,1,6,"PCTE",0
9,"9124",1405,946,928,6,18,"PCTE",1
37,"37372",133,99,98,0,1,"PCTE",0
40,"40156",272,194,190,4,4,"PCTE",0
21,"21065",259,178,175,0,3,"PCTE",0
23,"23028",6103,4369,4286,26,83,"PCTE",2
45,"45002",2619,1676,1663,14,13,"PCTE",0
19,"19151",1077,703,693,8,10,"PCTE",3
23,"23101",351,238,238,3,0,"PCTE",1
47,"47029",50,37,35,1,2,"PCTE",0
24,"24029",686,430,428,6,2,"PCTE",0
47,"47186",244314,182449,180833,1818,1616,"PCTE",185
14,"14042",18695,13788,13514,206,274,"PCTE",18
18,"18096",340,227,226,0,1,"PCTE",0
42,"42078",1000,653,640,5,13,"PCTE",1
19,"19106",77,57,57,0,0,"PCTE",0
37,"37239",203,175,174,2,1,"PCTE",2
29,"29002",1143,777,766,6,11,"PCTE",2
14,"14033",1239,875,856,8,19,"PCTE",2
33,"33042",4237,2862,2816,49,46,"PCTE",4
28,"28136",693,538,533,2,5,"PCTE",0
40,"40136",102,79,77,3,2,"PCTE",0
28,"28011",417,295,292,6,3,"PCTE",0
9,"9348",131,103,101,0,2,"PCTE",0
49,"49203",280,218,212,1,6,"PCTE",0
21,"21037",462,320,313,1,7,"PCTE",0
37,"37312",244,191,189,1,2,"PCTE",0
14,"14015",2045,1465,1418,16,47,"PCTE",1
24,"24142",24715,16839,16616,159,223,"PCTE",26
24,"24030",4158,2746,2696,18,50,"PCTE",3
9,"9449",91,78,76,1,2,"PCTE",0
9,"9405",122,94,91,0,3,"PCTE",1
49,"49243",107,74,74,0,0,"PCTE",0
34,"34067",129,80,78,1,2,"PCTE",0
40,"40059",109,92,91,2,1,"PCTE",0
19,"19214",74,51,51,0,0,"PCTE",0
37,"37313",535,395,394,1,1,"PCTE",2
19,"19118",11,10,9,0,1,"PCTE",0
9,"9181",276,194,191,7,3,"PCTE",1
21,"21038",1082,688,676,4,12,"PCTE",0
47,"47158",859,618,608,4,10,"PCTE",0
23,"23032",529,427,419,5,8,"PCTE",0
34,"34216",61,41,41,0,0,"PCTE",1
47,"47221",97,85,84,1,1,"PCTE",0
37,"37021",66,45,44,0,1,"PCTE",0
34,"34161",22,12,12,0,0,"PCTE",0
22,"22117",2384,1606,1596,18,10,"PCTE",2
29,"29060",665,454,450,1,4,"PCTE",0
18,"18098",5959,3816,3749,33,67,"PCTE",2
49,"49059",84,61,58,0,3,"PCTE",0
42,"42095",1909,1345,1326,32,19,"PCTE",2
26,"26026",1268,986,970,4,16,"PCTE",1
50,"50028",78,53,53,0,0,"PCTE",0
9,"9238",931,473,461,1,12,"PCTE",0
50,"50105",277,203,198,4,5,"PCTE",0
16,"16185",36,31,31,0,0,"PCTE",0
24,"24144",621,419,412,4,7,"PCTE",0
50,"50182",3657,2499,2485,23,14,"PCTE",1
29,"29005",4507,3012,2965,29,47,"PCTE",2
16,"16053",388,306,303,3,3,"PCTE",0
37,"37147",184,126,124,1,2,"PCTE",0
29,"29014",218,122,121,3,1,"PCTE",0
37,"37106",248,161,160,4,1,"PCTE",0
9,"9032",103,62,62,3,0,"PCTE",0
9,"9151",446,352,346,3,6,"PCTE",0
9,"9095",103,54,53,3,1,"PCTE",0
26,"26169",66,51,50,0,1,"PCTE",0
50,"50183",316,227,223,1,4,"PCTE",0
28,"28054",11943,8800,8731,72,69,"PCTE",5
9,"9353",74,56,54,1,2,"PCTE",0
34,"34220",152,133,132,1,1,"PCTE",0
21,"21010",15011,8812,8694,174,118,"PCTE",4
16,"16066",2280,1765,1734,18,31,"PCTE",2
19,"19308",57,49,49,0,0,"PCTE",0
26,"26065",63,46,43,0,3,"PCTE",0
45,"45008",144,112,110,1,2,"PCTE",0
45,"45046",2369,1679,1651,11,28,"PCTE",0
29,"29062",658,557,551,2,6,"PCTE",0
45,"45119",3499,2217,2190,3,27,"PCTE",2
34,"34028",132,95,92,2,3,"PCTE",0
22,"22053",783,494,492,6,2,"PCTE",0
37,"37129",248,181,181,1,0,"PCTE",0
37,"37058",56,38,38,1,0,"PCTE",0
33,"33038",2218,1501,1477,17,24,"PCTE",4
40,"40063",6913,4948,4838,57,110,"PCTE",4
26,"26066",263,201,194,5,7,"PCTE",0
47,"47192",89,78,76,3,2,"PCTE",0
37,"37097",42,29,29,0,0,"PCTE",0
50,"50056",399,296,296,3,0,"PCTE",0
22,"22201",264,188,186,3,2,"PCTE",0
18,"18068",1638,1197,1167,12,30,"PCTE",0
16,"16189",264,196,194,4,2,"PCTE",0
47,"47066",1482,1096,1086,14,10,"PCTE",0
50,"50258",53,25,25,1,0,"PCTE",0
47,"47067",153,112,112,3,0,"PCTE",0
49,"49210",447,350,348,3,2,"PCTE",1
26,"26107",86,65,64,1,1,"PCTE",0
37,"37060",283,205,202,1,3,"PCTE",0
49,"49250",1191,844,824,8,20,"PCTE",0
26,"26068",78,61,61,0,0,"PCTE",0
24,"24150",226,163,162,0,1,"PCTE",0
28,"28100",4482,3146,3113,21,33,"PCTE",3
45,"45122",5605,4321,4288,33,33,"PCTE",2
22,"22023",385,293,283,2,10,"PCTE",0
42,"42153",12,10,10,0,0,"PCTE",0
28,"28058",141836,104142,103011,896,1131,"PCTE",68
18,"18039",3343,2293,2252,22,41,"PCTE",1
49,"49173",335,165,163,4,2,"PCTE",0
28,"28165",1917,1339,1321,2,18,"PCTE",0
9,"9247",21,18,18,0,0,"PCTE",0
26,"26032",43,36,35,0,1,"PCTE",0
33,"33040",4556,2837,2784,58,53,"PCTE",4
37,"37351",268,229,226,0,3,"PCTE",0
50,"50109",95,65,62,2,3,"PCTE",0
5,"5093",362,251,249,0,2,"PCTE",2
9,"9137",187,129,127,0,2,"PCTE",0
45,"45086",483,339,332,0,7,"PCTE",2
28,"28166",357,281,276,1,5,"PCTE",1
18,"18040",237,146,145,0,1,"PCTE",0
2,"2080",498,358,352,0,6,"PCTE",0
49,"49175",204,136,135,3,1,"PCTE",0
49,"49216",147,115,109,0,6,"PCTE",0
9,"9416",52,30,30,0,0,"PCTE",1
24,"24006",488,356,347,4,9,"PCTE",0
33,"33041",7101,4564,4513,58,51,"PCTE",6
9,"9138",84,67,66,1,1,"PCTE",0
40,"40166",251,201,201,0,0,"PCTE",0
49,"49219",7196,4613,4528,64,85,"PCTE",5
37,"37029",186,125,124,1,1,"PCTE",0
40,"40005",25,23,23,1,0,"PCTE",0
19,"19317",124,83,82,0,1,"PCTE",0
26,"26150",97,77,77,1,0,"PCTE",0
49,"49107",115,70,70,0,0,"PCTE",0
47,"47156",150,117,117,0,0,"PCTE",0
40,"40058",306,244,240,1,4,"PCTE",0
18,"18127",17005,11790,11583,150,207,"PCTE",12
19,"19107",306,245,244,0,1,"PCTE",0
16,"16140",18,14,14,1,0,"PCTE",0
40,"40221",50,38,35,0,3,"PCTE",0
16,"16062",25,20,20,0,0,"PCTE",0
22,"22193",272,199,194,4,5,"PCTE",0
45,"45077",546,413,409,0,4,"PCTE",0
19,"19022",592,423,420,6,3,"PCTE",1
34,"34228",77,59,59,1,0,"PCTE",0
9,"9088",63,31,30,0,1,"PCTE",1
19,"19192",1762,1251,1240,5,11,"PCTE",0
34,"34080",5231,3207,3161,35,46,"PCTE",3
5,"5161",545,395,395,0,0,"PCTE",2
5,"5128",339,258,253,5,5,"PCTE",0
18,"18043",129,74,71,0,3,"PCTE",0
37,"37260",137,110,109,0,1,"PCTE",0
34,"34229",58,47,47,1,0,"PCTE",0
26,"26036",16989,11463,11260,101,203,"PCTE",22
47,"47167",245,198,198,1,0,"PCTE",0
5,"5096",76,62,62,0,0,"PCTE",0
42,"42110",54,43,43,0,0,"PCTE",0
19,"19163",60,49,49,0,0,"PCTE",0
23,"23077",604,482,477,2,5,"PCTE",0
28,"28032",5090,3716,3675,22,41,"PCTE",2
9,"9311",59,45,45,0,0,"PCTE",0
19,"19023",119,87,85,0,2,"PCTE",0
9,"9421",240,180,180,3,0,"PCTE",0
9,"9253",101,77,76,0,1,"PCTE",0
33,"33016",18848,12845,12737,173,108,"PCTE",16
18,"18044",161,91,91,0,0,"PCTE",1
14,"14054",13775,10464,10165,105,299,"PCTE",6
28,"28138",60,43,42,0,1,"PCTE",0
22,"22172",520,373,369,5,4,"PCTE",0
45,"45018",550,385,380,1,5,"PCTE",0
47,"47104",2816,2153,2099,20,54,"PCTE",1
34,"34231",211,157,153,3,4,"PCTE",0
26,"26154",10,10,9,1,1,"PCTE",0
9,"9423",27,24,24,1,0,"PCTE",0
2,"2052",466,371,370,6,1,"PCTE",0
50,"50114",132,108,108,0,0,"PCTE",0
26,"26039",40,31,31,0,0,"PCTE",0
21,"21902",1136,744,739,2,5,"PCTE",1
26,"26002",821,611,597,1,14,"PCTE",1
34,"34232",725,505,492,13,13,"PCTE",2
24,"24157",2542,1846,1809,16,37,"PCTE",0
22,"22011",98,80,79,0,1,"PCTE",0
47,"47085",16330,11556,11419,121,137,"PCTE",11
50,"50037",125,85,80,0,5,"PCTE",0
9,"9390",554,455,450,6,5,"PCTE",2
40,"40183",117,105,99,1,6,"PCTE",0
22,"22908",190,135,134,0,1,"PCTE",0
22,"22208",192,150,147,1,3,"PCTE",0
50,"50115",3279,2170,2131,27,39,"PCTE",1
22,"22244",42,33,32,1,1,"PCTE",0
16,"16248",862,710,700,6,10,"PCTE",0
34,"34041",82,64,64,3,0,"PCTE",0
19,"19031",8,8,8,0,0,"PCTE",0
26,"26004",69,47,46,0,1,"PCTE",0
37,"37358",159,124,124,0,0,"PCTE",0
34,"34086",102,81,81,2,0,"PCTE",0
47,"47171",375,295,290,9,5,"PCTE",0
28,"28004",6618,4502,4457,28,45,"PCTE",4
24,"24158",296,197,192,0,5,"PCTE",0
28,"28035",1404,981,966,4,15,"PCTE",0
47,"47076",17787,13484,13306,179,178,"PCTE",7
18,"18145",10909,7925,7780,67,145,"PCTE",5
28,"28005",136518,101397,100485,871,912,"PCTE",47
5,"5035",92,68,68,0,0,"PCTE",0
37,"37070",523,371,365,4,6,"PCTE",2
9,"9154",123,90,90,7,0,"PCTE",0
5,"5166",155,108,104,1,4,"PCTE",0
50,"50192",227,182,181,0,1,"PCTE",0
49,"49226",240,200,198,2,2,"PCTE",0
50,"50064",439,348,346,1,2,"PCTE",0
9,"9101",72,52,52,0,0,"PCTE",0
37,"37265",198,167,163,1,4,"PCTE",0
9,"9261",446,279,271,2,8,"PCTE",2
37,"37359",165,105,103,0,2,"PCTE",0
19,"19032",145,94,93,2,1,"PCTE",0
40,"40013",57,47,47,0,0,"PCTE",0
19,"19259",28,22,22,0,0,"PCTE",0
40,"40045",119,93,93,1,0,"PCTE",0
33,"33020",12981,8550,8453,120,97,"PCTE",12
50,"50291",95,76,76,0,0,"PCTE",0
28,"28006",80903,60936,60508,482,428,"PCTE",29
14,"14058",7866,5451,5334,69,117,"PCTE",3
5,"5198",70,53,51,0,2,"PCTE",0
19,"19229",58,53,53,0,0,"PCTE",0
28,"28175",940,740,730,2,10,"PCTE",0
14,"14059",679,527,521,11,6,"PCTE",1
34,"34136",143,89,89,1,0,"PCTE",0
18,"18179",493,315,309,8,6,"PCTE",0
21,"21023",2033,1215,1193,10,22,"PCTE",1
50,"50217",426,333,333,1,0,"PCTE",0
9,"9052",28,21,20,0,1,"PCTE",0
19,"19065",109,86,85,1,1,"PCTE",0
24,"24088",996,750,745,9,5,"PCTE",3
28,"28007",127491,96937,96102,810,835,"PCTE",47
5,"5104",33,21,19,0,2,"PCTE",0
45,"45098",2090,1488,1469,7,19,"PCTE",0
9,"9430",25,21,21,0,0,"PCTE",0
49,"49116",356,239,234,4,5,"PCTE",0
40,"40078",150,123,123,6,0,"PCTE",0
37,"37008",4213,3092,3046,21,46,"PCTE",3
19,"19170",189,115,115,1,0,"PCTE",0
47,"47175",6755,4950,4870,49,80,"PCTE",1
18,"18148",787,618,605,5,13,"PCTE",1
34,"34238",294,238,236,1,2,"PCTE",0
24,"24017",532,375,374,1,1,"PCTE",0
2,"2057",1947,1358,1333,15,25,"PCTE",1
45,"45099",3700,2524,2501,9,23,"PCTE",3
47,"47208",53,35,35,1,0,"PCTE",0
50,"50245",74,51,51,0,0,"PCTE",0
34,"34093",83,61,60,0,1,"PCTE",0
40,"40178",85,61,60,0,1,"PCTE",0
28,"28114",141,97,97,0,0,"PCTE",0
9,"9105",95,65,64,1,1,"PCTE",0
18,"18149",5408,3926,3859,42,67,"PCTE",0
22,"22215",127,81,81,0,0,"PCTE",0
9,"9432",170,125,123,0,2,"PCTE",0
37,"37269",424,280,277,2,3,"PCTE",0
37,"37363",104,81,80,0,1,"PCTE",0
34,"34079",1729,1296,1275,19,21,"PCTE",0
22,"22105",102,65,65,0,0,"PCTE",0
47,"47081",39,32,32,0,0,"PCTE",0
47,"47070",29,24,24,0,0,"PCTE",0
37,"37063",58,47,47,0,0,"PCTE",0
22,"22128",188,145,143,3,2,"PCTE",0
40,"40049",37,27,27,0,0,"PCTE",0
40,"40148",231,165,163,4,2,"PCTE",0
9,"9328",70,37,37,3,0,"PCTE",0
9,"9010",33,25,25,2,0,"PCTE",0
40,"40017",83,71,68,2,3,"PCTE",0
41,"41087",10557,7217,7029,67,188,"PCTE",3
23,"23090",1204,953,938,6,15,"PCTE",0
34,"34003",147,104,103,0,1,"PCTE",0
41,"41031",1204,780,769,5,11,"PCTE",0
18,"18051",1092,735,718,8,17,"PCTE",0
49,"49154",111,63,59,0,4,"PCTE",0
24,"24020",436,230,228,0,2,"PCTE",0
34,"34192",76,59,59,0,0,"PCTE",0
28,"28041",4805,3666,3634,38,32,"PCTE",3
49,"49011",214,147,146,5,1,"PCTE",1
45,"45139",144,111,111,0,0,"PCTE",0
22,"22182",227,132,131,3,1,"PCTE",0
40,"40118",46,32,32,1,0,"PCTE",0
37,"37079",77,59,59,1,0,"PCTE",0
5,"5205",81,59,58,2,1,"PCTE",0
24,"24166",1346,929,916,14,13,"PCTE",0
9,"9438",562,447,437,6,10,"PCTE",2
16,"16212",233,186,184,0,2,"PCTE",0
39,"39091",1881,1297,1291,8,6,"PCTE",1
23,"23055",46314,30950,30506,279,444,"PCTE",46
37,"37116",70,50,50,0,0,"PCTE",0
9,"9332",137,93,91,2,2,"PCTE",0
47,"47179",368,256,254,2,2,"PCTE",0
24,"24058",189,115,114,1,1,"PCTE",0
41,"41903",6776,4616,4494,72,122,"PCTE",3
50,"50094",1500,1041,1022,12,19,"PCTE",2
47,"47052",6781,5213,5156,50,57,"PCTE",11
22,"22107",102,53,53,0,0,"PCTE",0
37,"37366",40,34,33,2,1,"PCTE",0
5,"5007",109,73,72,0,1,"PCTE",0
28,"28085",4194,3126,3091,24,35,"PCTE",0
49,"49234",394,282,277,0,5,"PCTE",2
26,"26051",213,165,165,1,0,"PCTE",0
45,"45203",2777,1986,1961,18,25,"PCTE",1
39,"39083",1063,619,611,2,8,"PCTE",2
28,"28074",141137,106626,105602,885,1024,"PCTE",78
29,"29006",679,461,452,4,9,"PCTE",0
24,"24071",947,618,611,6,7,"PCTE",0
24,"24083",997,659,647,9,12,"PCTE",0
5,"5044",244,170,170,1,0,"PCTE",0
47,"47180",57,41,41,1,0,"PCTE",0
9,"9441",94,76,76,0,0,"PCTE",0
33,"33055",1485,992,966,14,26,"PCTE",2
18,"18153",8834,6174,6063,54,111,"PCTE",4
22,"22221",92,56,55,0,1,"PCTE",0
37,"37081",879,680,674,2,6,"PCTE",0
22,"22012",102,75,75,2,0,"PCTE",0
34,"34101",48,36,36,1,0,"PCTE",0
33,"33056",4850,3068,3044,25,24,"PCTE",2
42,"42003",65,49,47,0,2,"PCTE",0
5,"5239",215,163,163,3,0,"PCTE",0
5,"5045",81,58,58,0,0,"PCTE",0
40,"40020",149,112,111,1,1,"PCTE",0
29,"29025",41540,27170,26897,271,273,"PCTE",10
22,"22110",700,476,473,3,3,"PCTE",1
21,"21062",1403,849,838,10,11,"PCTE",0
24,"24209",2597,1651,1636,12,15,"PCTE",2
50,"50274",64,46,43,1,3,"PCTE",0
37,"37275",98,67,67,0,0,"PCTE",0
5,"5113",62,42,42,0,0,"PCTE",0
26,"26054",291,225,223,3,2,"PCTE",1
41,"41007",12488,7657,7421,126,236,"PCTE",5
23,"23025",2725,1894,1870,11,24,"PCTE",2
16,"16096",278,219,217,1,2,"PCTE",0
49,"49237",142,78,78,0,0,"PCTE",0
5,"5012",117,88,88,1,0,"PCTE",0
19,"19042",22,18,17,0,1,"PCTE",0
37,"37015",198,127,125,2,2,"PCTE",0
9,"9018",24624,17232,16983,192,249,"PCTE",29
41,"41036",3903,2708,2645,35,63,"PCTE",0
21,"21032",1827,1337,1314,13,23,"PCTE",0
5,"5114",1257,989,968,5,21,"PCTE",0
28,"28016",79,55,55,0,0,"PCTE",0
9,"9280",26,18,18,0,0,"PCTE",0
28,"28017",1280,975,963,10,12,"PCTE",2
47,"47057",272,200,199,0,1,"PCTE",0
9,"9395",121,74,74,1,0,"PCTE",0
24,"24063",362,247,245,2,2,"PCTE",1
22,"22077",362,280,272,5,8,"PCTE",0
47,"47026",50,37,37,1,0,"PCTE",0
9,"9020",233,170,166,3,4,"PCTE",0
9,"9281",136,97,97,2,0,"PCTE",0
24,"24211",259,199,198,3,1,"PCTE",0
41,"41065",22527,14684,14463,205,221,"PCTE",4
34,"34104",231,164,162,2,2,"PCTE",0
49,"49054",847,576,569,8,7,"PCTE",0
19,"19901",35,27,27,0,0,"PCTE",0
39,"39040",4271,3103,3080,18,23,"PCTE",2
9,"9176",58,46,45,2,1,"PCTE",0
26,"26096",257,198,193,2,5,"PCTE",0
5,"5014",5263,3699,3648,35,51,"PCTE",2
23,"23062",1410,1094,1076,0,18,"PCTE",0
26,"26175",47,40,38,1,2,"PCTE",0
50,"50075",70,55,55,1,0,"PCTE",0
29,"29902",2593,1561,1533,15,28,"PCTE",1
29,"29903",485,326,324,2,2,"PCTE",0
5,"5243",80,57,56,1,1,"PCTE",0
42,"42008",54,41,41,0,0,"PCTE",0
22,"22016",558,384,382,5,2,"PCTE",0
49,"49240",185,125,123,3,2,"PCTE",0
49,"49055",91,72,72,3,0,"PCTE",0
45,"45001",1846,1213,1181,10,32,"PCTE",0
23,"23063",3784,2699,2664,22,35,"PCTE",1
40,"40057",1397,1081,1067,15,14,"PCTE",1
28,"28091",5491,3709,3650,20,59,"PCTE",2
14,"14070",1280,911,902,4,9,"PCTE",0
22,"22226",761,537,530,13,7,"PCTE",0
34,"34213",53,46,46,0,0,"PCTE",0
29,"29057",330,222,218,2,4,"PCTE",0
33,"33032",11056,7052,6905,109,147,"PCTE",9
37,"37074",136,93,90,1,3,"PCTE",0
34,"34158",283,170,167,0,3,"PCTE",0
29,"29058",1542,994,979,5,15,"PCTE",0
34,"34094",61,45,45,2,0,"PCTE",0
9,"9024",150,100,99,1,1,"PCTE",0
5,"5107",54,36,35,2,1,"PCTE",0
34,"34159",375,221,214,4,7,"PCTE",0
22,"22227",200,140,140,2,0,"PCTE",0
26,"26177",306,233,229,2,4,"PCTE",0
26,"26060",78,51,50,2,1,"PCTE",0
39,"39015",828,559,556,3,3,"PCTE",0
50,"50129",212,129,127,0,2,"PCTE",1
5,"5017",84,70,67,2,3,"PCTE",1
49,"49242",439,342,336,2,6,"PCTE",3
37,"37125",231,154,148,1,6,"PCTE",0
26,"26139",58,43,43,2,0,"PCTE",0
18,"18162",919,664,652,3,12,"PCTE",0
28,"28093",2177,1681,1658,11,23,"PCTE",0
2,"2006",573,425,424,1,1,"PCTE",0
23,"23065",1530,1068,1054,7,14,"PCTE",1
19,"19011",237,165,162,3,3,"PCTE",0
19,"19274",953,693,676,9,17,"PCTE",1
5,"5183",123,103,100,0,3,"PCTE",0
50,"50130",354,225,222,1,3,"PCTE",0
49,"49132",310,220,215,2,5,"PCTE",0
18,"18065",588,464,451,2,13,"PCTE",3
16,"16103",235,183,181,2,2,"PCTE",0
23,"23066",4274,3517,3460,16,57,"PCTE",3
50,"50078",227,168,166,0,2,"PCTE",0
19,"19048",19,14,13,1,1,"PCTE",0
37,"37126",30,25,25,0,0,"PCTE",0
9,"9294",99,81,78,0,3,"PCTE",1
21,"21069",1681,1073,1056,9,17,"PCTE",0
40,"40160",93,65,62,0,3,"PCTE",0
26,"26180",221,164,162,4,2,"PCTE",0
50,"50280",290,220,216,1,4,"PCTE",0
29,"29004",283,222,218,3,4,"PCTE",0
34,"34113",40,38,38,0,0,"PCTE",0
19,"19049",8,8,7,0,1,"PCTE",0
45,"45006",1334,866,858,1,8,"PCTE",0
42,"42148",9,9,9,0,0,"PCTE",0
16,"16104",53,42,42,0,0,"PCTE",0
24,"24069",37,26,25,0,1,"PCTE",0
34,"34114",200,134,134,0,0,"PCTE",0
45,"45105",376,277,268,5,9,"PCTE",0
41,"41089",6621,4650,4549,64,101,"PCTE",6
28,"28003",167,133,131,4,2,"PCTE",0
21,"21020",349,230,228,2,2,"PCTE",0
39,"39027",3045,2231,2199,23,32,"PCTE",1
39,"39036",965,707,703,4,4,"PCTE",0
42,"42096",244,132,129,2,3,"PCTE",0
9,"9132",170,121,120,0,1,"PCTE",0
40,"40095",453,341,329,2,12,"PCTE",0
49,"49100",281,164,157,2,7,"PCTE",1
18,"18067",682,442,437,2,5,"PCTE",0
28,"28162",2784,2143,2131,20,12,"PCTE",1
37,"37092",1933,1342,1327,13,15,"PCTE",0
40,"40130",127,95,87,1,8,"PCTE",0
16,"16107",94,56,56,0,0,"PCTE",1
45,"45082",1145,904,893,7,11,"PCTE",0
9,"9411",153,105,104,0,1,"PCTE",1
22,"22021",1884,1331,1319,26,12,"PCTE",0
5,"5251",56,35,34,0,1,"PCTE",0
34,"34027",1049,677,665,15,12,"PCTE",0
28,"28055",944,636,627,4,9,"PCTE",0
40,"40097",130,103,102,5,1,"PCTE",0
49,"49135",576,368,366,3,2,"PCTE",0
42,"42017",131,99,96,1,3,"PCTE",0
21,"21042",15610,8112,8011,164,101,"PCTE",10
16,"16108",44,35,34,1,1,"PCTE",0
47,"47225",73,61,59,1,2,"PCTE",0
16,"16032",284,220,220,1,0,"PCTE",0
34,"34168",45,39,39,1,0,"PCTE",0
47,"47193",1625,1251,1236,10,15,"PCTE",0
42,"42193",14,7,7,0,0,"PCTE",0
50,"50134",120,85,82,4,3,"PCTE",0
14,"14901",932,753,750,6,3,"PCTE",0
49,"49136",313,218,217,5,1,"PCTE",0
21,"21012",285,224,221,0,3,"PCTE",0
33,"33067",751,543,538,7,5,"PCTE",1
9,"9082",36,32,32,0,0,"PCTE",0
26,"26146",84,56,55,0,1,"PCTE",0
34,"34223",203,147,143,1,4,"PCTE",0
19,"19053",1906,1323,1304,12,19,"PCTE",1
29,"29065",191,145,143,3,2,"PCTE",0
26,"26147",34,26,25,0,1,"PCTE",0
29,"29083",2063,1471,1444,14,27,"PCTE",1
22,"22086",194,137,137,1,0,"PCTE",0
9,"9464",33,24,24,0,0,"PCTE",0
9,"9246",599,381,372,2,9,"PCTE",1
28,"28132",12197,8622,8537,75,85,"PCTE",6
47,"47163",277,208,205,3,3,"PCTE",0
50,"50108",50,37,37,0,0,"PCTE",0
16,"16071",20,16,16,0,0,"PCTE",0
2,"2013",125,90,88,0,2,"PCTE",0
37,"37193",362,253,252,4,1,"PCTE",0
34,"34123",1634,1274,1258,4,16,"PCTE",0
49,"49029",609,435,419,6,16,"PCTE",0
2,"2079",2807,2000,1978,17,22,"PCTE",2
45,"45159",83,71,69,0,2,"PCTE",0
5,"5125",56,47,46,0,1,"PCTE",0
5,"5025",78,65,65,0,0,"PCTE",0
18,"18171",2098,1521,1460,11,61,"PCTE",0
24,"24152",433,269,267,4,2,"PCTE",0
45,"45087",8180,5737,5628,41,109,"PCTE",2
50,"50009",97,61,61,1,0,"PCTE",0
9,"9307",102,76,74,1,2,"PCTE",0
50,"50210",37,26,26,0,0,"PCTE",0
9,"9467",59,46,46,2,0,"PCTE",0
9,"9038",109,87,86,1,1,"PCTE",0
47,"47196",29,21,21,0,0,"PCTE",0
37,"37100",74,59,58,1,1,"PCTE",0
39,"39023",6563,4788,4753,14,35,"PCTE",3
50,"50010",67,52,52,1,0,"PCTE",1
47,"47101",1634,1278,1262,7,16,"PCTE",0
16,"16243",376,316,309,4,7,"PCTE",0
50,"50211",236,174,173,0,1,"PCTE",0
49,"49252",312,240,236,7,4,"PCTE",0
28,"28104",15528,12342,12234,103,108,"PCTE",7
18,"18032",247,164,163,1,1,"PCTE",0
18,"18042",417,332,330,4,2,"PCTE",1
50,"50111",181,130,130,1,0,"PCTE",0
37,"37343",66,44,43,1,1,"PCTE",0
26,"26035",16,12,11,0,1,"PCTE",0
5,"5245",353,262,256,0,6,"PCTE",1
50,"50298",5439,4053,4007,41,46,"PCTE",8
16,"16002",192,160,158,2,2,"PCTE",0
18,"18173",8999,5958,5871,50,87,"PCTE",2
24,"24227",1527,1036,1032,13,4,"PCTE",1
19,"19162",67,41,41,0,0,"PCTE",0
37,"37101",138,101,100,1,1,"PCTE",0
29,"29086",770,479,476,5,3,"PCTE",0
37,"37134",209,143,141,3,2,"PCTE",0
40,"40006",22,19,19,0,0,"PCTE",0
50,"50137",958,740,731,8,9,"PCTE",0
9,"9310",15,14,11,0,3,"PCTE",0
49,"49032",282,196,196,0,0,"PCTE",0
40,"40007",68,55,55,1,0,"PCTE",0
34,"34127",80,62,62,0,0,"PCTE",0
42,"42158",97,73,73,1,0,"PCTE",0
45,"45091",376,270,269,3,1,"PCTE",0
49,"49256",236,183,179,0,4,"PCTE",0
5,"5192",92,75,72,1,3,"PCTE",0
42,"42063",45,31,30,1,1,"PCTE",0
5,"5226",63,43,42,0,1,"PCTE",0
28,"28107",442,316,310,5,6,"PCTE",0
37,"37291",269,186,185,1,1,"PCTE",0
41,"41023",7999,5500,5435,60,65,"PCTE",4
5,"5129",111,70,69,0,1,"PCTE",0
34,"34130",195,154,153,5,1,"PCTE",0
49,"49145",208,113,113,1,0,"PCTE",0
5,"5099",451,350,344,3,6,"PCTE",0
16,"16908",166,133,132,2,1,"PCTE",0
18,"18076",789,534,532,2,2,"PCTE",0
50,"50062",1885,1332,1308,15,24,"PCTE",3
40,"40106",179,140,139,2,1,"PCTE",0
37,"37198",202,147,144,2,3,"PCTE",0
16,"16246",451,327,322,1,5,"PCTE",0
28,"28140",3156,2359,2331,16,28,"PCTE",3
24,"24082",847,615,608,16,7,"PCTE",2
9,"9372",204,175,169,2,6,"PCTE",0
37,"37168",397,271,266,3,5,"PCTE",2
28,"28033",4177,2972,2936,20,36,"PCTE",0
29,"29015",32093,22044,21716,253,328,"PCTE",16
28,"28108",3736,2681,2652,21,29,"PCTE",3
24,"24023",264,188,185,1,3,"PCTE",0
16,"16094",121,86,84,0,2,"PCTE",0
26,"26052",146,106,105,0,1,"PCTE",0
2,"2075",1700,1357,1347,6,10,"PCTE",0
22,"22062",154,107,107,1,0,"PCTE",0
5,"5131",96,64,64,1,0,"PCTE",0
16,"16118",1351,1022,1009,13,13,"PCTE",0
24,"24047",708,462,459,1,3,"PCTE",0
33,"33018",2804,1830,1806,30,24,"PCTE",2
37,"37264",56,39,39,0,0,"PCTE",0
50,"50215",20,14,14,0,0,"PCTE",0
18,"18078",714,546,538,5,8,"PCTE",1
19,"19167",129,104,103,1,1,"PCTE",0
23,"23082",1850,1292,1279,13,13,"PCTE",0
9,"9316",104,80,80,0,0,"PCTE",0
45,"45131",259,219,216,1,3,"PCTE",0
34,"34133",101,75,73,0,2,"PCTE",0
37,"37234",314,194,192,3,2,"PCTE",0
22,"22245",303,222,213,3,9,"PCTE",0
2,"2901",2196,1441,1419,10,22,"PCTE",0
49,"49260",693,480,473,3,7,"PCTE",0
42,"42207",48,42,41,0,1,"PCTE",0
29,"29016",253,196,194,0,2,"PCTE",0
24,"24159",1716,1238,1216,6,22,"PCTE",3
41,"41026",4302,3355,3288,26,67,"PCTE",0
40,"40205",228,159,157,1,2,"PCTE",0
37,"37201",238,170,168,0,2,"PCTE",0
28,"28173",523,384,381,1,3,"PCTE",0
28,"28036",2699,1977,1957,20,20,"PCTE",1
47,"47109",161,120,120,1,0,"PCTE",0
16,"16250",67,52,52,1,0,"PCTE",0
49,"49038",88,63,58,1,5,"PCTE",0
47,"47110",445,335,327,1,8,"PCTE",0
45,"45096",987,748,725,9,23,"PCTE",2
33,"33076",12115,7519,7456,76,63,"PCTE",9
45,"45133",2798,1957,1922,11,35,"PCTE",3
40,"40206",162,126,123,0,3,"PCTE",0
41,"41083",1145,821,814,6,7,"PCTE",1
37,"37141",149,101,100,0,1,"PCTE",0
50,"50142",23,16,16,1,0,"PCTE",1
34,"34184",49,37,35,0,2,"PCTE",0
14,"14002",10895,7599,7479,109,120,"PCTE",12
45,"45023",2300,1700,1685,19,15,"PCTE",1
40,"40110",316,237,234,4,3,"PCTE",0
9,"9265",38,31,31,1,0,"PCTE",0
24,"24161",294,208,204,3,4,"PCTE",0
40,"40906",2149,1701,1662,18,39,"PCTE",2
26,"26008",1821,1310,1290,15,20,"PCTE",1
9,"9321",1576,1151,1135,10,16,"PCTE",1
19,"19290",851,551,550,4,1,"PCTE",1
18,"18018",542,384,377,2,7,"PCTE",0
21,"21054",8175,6014,5887,41,127,"PCTE",2
50,"50243",307,227,224,2,3,"PCTE",0
41,"41084",2799,2029,1937,9,92,"PCTE",0
47,"47207",256,198,195,3,3,"PCTE",0
29,"29047",1082,860,846,0,14,"PCTE",1
49,"49006",139,98,95,3,3,"PCTE",0
9,"9380",71,42,41,0,1,"PCTE",0
16,"16204",237,179,177,1,2,"PCTE",0
39,"39031",1237,870,865,1,5,"PCTE",0
18,"18083",232,181,179,1,2,"PCTE",0
50,"50067",13928,9831,9699,92,132,"PCTE",5
37,"37267",177,130,129,0,1,"PCTE",1
22,"22248",103,73,73,0,0,"PCTE",0
40,"40112",2813,2126,2087,26,39,"PCTE",1
29,"29019",853,604,588,2,16,"PCTE",0
16,"16205",106,73,73,1,0,"PCTE",0
29,"29094",59795,39350,38854,454,496,"PCTE",19
26,"26082",101,79,79,0,0,"PCTE",1
9,"9381",28,19,19,0,0,"PCTE",0
49,"49152",474,289,282,2,7,"PCTE",0
18,"18084",4533,3233,3178,35,55,"PCTE",1
26,"26046",1552,1056,1027,11,29,"PCTE",0
45,"45137",1541,1007,998,8,9,"PCTE",1
49,"49041",409,287,282,1,5,"PCTE",0
9,"9906",1185,883,877,16,6,"PCTE",5
16,"16126",720,552,545,3,7,"PCTE",1
5,"5234",45,38,38,0,0,"PCTE",0
19,"19294",26,18,18,0,0,"PCTE",0
19,"19172",51,38,38,0,0,"PCTE",0
28,"28030",1832,1319,1297,13,22,"PCTE",2
50,"50269",287,172,167,2,5,"PCTE",0
26,"26125",2665,1885,1853,21,32,"PCTE",0
16,"16013",26,24,24,0,0,"PCTE",0
39,"39061",3470,2605,2591,14,14,"PCTE",2
21,"21057",995,600,590,8,10,"PCTE",2
49,"49189",186,104,104,1,0,"PCTE",0
16,"16128",50,38,38,0,0,"PCTE",0
42,"42172",28,26,26,0,0,"PCTE",0
34,"34243",323,243,239,1,4,"PCTE",0
47,"47210",399,278,275,3,3,"PCTE",0
37,"37010",925,645,638,5,7,"PCTE",1
45,"45102",3613,2495,2464,27,31,"PCTE",2
24,"24202",7504,4607,4538,51,69,"PCTE",8
37,"37114",74,58,55,1,3,"PCTE",0
19,"19296",29,24,24,0,0,"PCTE",0
5,"5236",105,69,69,1,0,"PCTE",0
47,"47051",324,261,258,6,3,"PCTE",0
26,"26126",29,27,27,0,0,"PCTE",0
39,"39062",1864,1395,1376,3,19,"PCTE",1
22,"22251",327,259,256,0,3,"PCTE",0
19,"19174",90,65,64,0,1,"PCTE",0
37,"37303",179,118,117,1,1,"PCTE",0
29,"29022",177,137,136,1,1,"PCTE",0
47,"47022",59,52,48,1,4,"PCTE",0
39,"39035",9142,6574,6517,24,57,"PCTE",2
50,"50222",1574,1024,1008,12,16,"PCTE",2
47,"47211",48,37,37,1,0,"PCTE",0
5,"5904",108,70,69,5,1,"PCTE",0
42,"42174",174,121,118,4,3,"PCTE",1
22,"22042",116,91,89,1,2,"PCTE",0
45,"45030",471,346,334,4,12,"PCTE",0
50,"50070",50,30,29,0,1,"PCTE",0
19,"19332",85,59,57,4,2,"PCTE",0
2,"2063",1358,987,973,3,14,"PCTE",0
50,"50296",385,240,235,3,5,"PCTE",0
29,"29023",2330,1441,1429,11,12,"PCTE",0
5,"5043",73,58,58,0,0,"PCTE",0
5,"5238",728,529,525,1,4,"PCTE",1
49,"49269",218,126,124,1,2,"PCTE",0
47,"47023",3057,2369,2359,20,10,"PCTE",2
16,"16247",63,51,50,1,1,"PCTE",0
40,"40107",90,67,67,0,0,"PCTE",0
40,"40129",159,119,117,2,2,"PCTE",0
47,"47075",4772,3557,3512,34,45,"PCTE",2
19,"19004",59,44,44,0,0,"PCTE",0
28,"28014",34522,25016,24748,229,268,"PCTE",13
37,"37209",415,276,275,2,1,"PCTE",0
28,"28119",2294,1760,1738,12,22,"PCTE",1
45,"45032",445,290,286,2,4,"PCTE",1
29,"29024",371,216,204,3,12,"PCTE",0
37,"37118",117,86,86,3,0,"PCTE",0
50,"50223",906,702,693,9,9,"PCTE",1
9,"9170",207,151,150,1,1,"PCTE",1
16,"16265",22,18,18,0,0,"PCTE",0
9,"9335",86,66,66,3,0,"PCTE",0
18,"18187",510,350,350,2,0,"PCTE",0
42,"42084",20,15,15,0,0,"PCTE",0
49,"49088",80,51,51,0,0,"PCTE",0
49,"49159",269,182,182,2,0,"PCTE",0
9,"9276",390,256,244,4,12,"PCTE",0
9,"9016",85,54,54,0,0,"PCTE",1
24,"24061",1753,1234,1223,10,11,"PCTE",3
34,"34102",197,158,156,1,2,"PCTE",0
14,"14039",2577,1858,1801,29,57,"PCTE",0
21,"21031",1166,773,736,11,37,"PCTE",1
5,"5240",3346,2259,2232,11,27,"PCTE",3
50,"50150",624,387,384,2,3,"PCTE",0
39,"39010",610,457,453,1,4,"PCTE",1
9,"9277",103,84,82,1,2,"PCTE",0
18,"18188",1646,1224,1202,10,22,"PCTE",1
28,"28046",4824,3726,3707,33,19,"PCTE",1
14,"14011",580,444,443,3,1,"PCTE",1
37,"37016",563,419,411,4,8,"PCTE",1
33,"33057",1525,1005,988,17,17,"PCTE",1
14,"14067",3842,2863,2800,42,63,"PCTE",2
42,"42178",99,71,71,0,0,"PCTE",0
24,"24172",389,208,202,1,6,"PCTE",0
5,"5047",4105,3004,2936,23,68,"PCTE",1
37,"37120",98,78,76,0,2,"PCTE",0
47,"47183",135,100,100,1,0,"PCTE",0
19,"19147",42,32,32,0,0,"PCTE",0
29,"29072",3291,2360,2307,19,53,"PCTE",1
5,"5081",37,21,21,3,0,"PCTE",0
22,"22112",9525,6317,6245,91,72,"PCTE",6
2,"2067",1137,808,794,2,14,"PCTE",1
19,"19335",51,39,38,0,1,"PCTE",0
47,"47122",2007,1520,1492,8,28,"PCTE",0
41,"41037",3201,2306,2260,22,46,"PCTE",0
45,"45074",397,300,293,2,7,"PCTE",0
22,"22078",431,285,285,4,0,"PCTE",0
50,"50025",4541,3110,3083,39,27,"PCTE",2
21,"21034",1155,768,748,5,20,"PCTE",0
19,"19008",36,30,30,0,0,"PCTE",0
19,"19148",42,29,28,1,1,"PCTE",0
29,"29073",1657,1082,1069,15,13,"PCTE",1
49,"49164",141,95,92,1,3,"PCTE",0
16,"16022",76,63,63,0,0,"PCTE",0
37,"37018",106,75,75,0,0,"PCTE",0
29,"29056",1047,708,696,5,12,"PCTE",0
9,"9446",10,7,7,0,0,"PCTE",0
22,"22015",299,218,215,1,3,"PCTE",0
37,"37086",107,86,85,2,1,"PCTE",0
29,"29029",383,256,254,4,2,"PCTE",0
2,"2036",93,66,66,0,0,"PCTE",0
39,"39041",1753,1285,1269,7,16,"PCTE",1
33,"33060",13991,8629,8481,109,148,"PCTE",17
42,"42046",46,32,32,0,0,"PCTE",0
42,"42048",60,52,52,0,0,"PCTE",0
50,"50128",26,23,23,0,0,"PCTE",0
37,"37216",294,234,227,5,7,"PCTE",0
50,"50153",914,683,675,9,8,"PCTE",1
21,"21035",9766,6114,5998,92,116,"PCTE",1
39,"39097",666,342,335,2,7,"PCTE",0
22,"22114",124,75,72,1,3,"PCTE",0
34,"34063",84,74,74,1,0,"PCTE",0
29,"29030",770,618,611,4,7,"PCTE",1
37,"37279",713,488,480,4,8,"PCTE",0
21,"21005",15754,9502,9340,84,162,"PCTE",5
5,"5117",191,155,153,1,2,"PCTE",0
39,"39042",5910,4354,4315,14,39,"PCTE",2
19,"19182",37,32,32,0,0,"PCTE",0
50,"50180",107,85,85,1,0,"PCTE",0
37,"37217",59,43,43,3,0,"PCTE",0
22,"22156",289,216,213,1,3,"PCTE",0
5,"5151",83,60,60,0,0,"PCTE",0
42,"42049",108,71,71,1,0,"PCTE",0
34,"34066",54,47,47,1,0,"PCTE",1
19,"19082",100,72,71,1,1,"PCTE",0
2,"2005",554,426,419,8,7,"PCTE",0
39,"39071",410,251,250,1,1,"PCTE",0
19,"19243",34,32,31,1,1,"PCTE",0
49,"49167",180,131,131,2,0,"PCTE",0
42,"42187",58,44,39,1,5,"PCTE",0
19,"19183",70,59,58,0,1,"PCTE",0
5,"5053",76,48,48,0,0,"PCTE",0
9,"9025",110,61,58,0,3,"PCTE",0
26,"26101",31,18,17,0,1,"PCTE",0
40,"40093",74,62,62,1,0,"PCTE",0
42,"42188",46,35,35,1,0,"PCTE",0
29,"29031",1555,1015,986,6,29,"PCTE",0
23,"23903",3498,2633,2601,28,32,"PCTE",3
41,"41069",29669,20316,19848,381,468,"PCTE",24
37,"37345",150,117,113,0,4,"PCTE",0
18,"18034",484,345,342,3,3,"PCTE",0
9,"9451",237,196,189,1,7,"PCTE",0
45,"45042",172,122,121,0,1,"PCTE",0
39,"39101",231,134,132,2,2,"PCTE",0
42,"42145",129,105,104,1,1,"PCTE",0
50,"50156",212,156,151,2,5,"PCTE",0
9,"9351",61,46,45,1,1,"PCTE",0
5,"5054",1192,871,856,6,15,"PCTE",0
9,"9027",47,38,34,1,4,"PCTE",1
50,"50231",253,199,195,4,4,"PCTE",0
16,"16143",15,10,10,1,0,"PCTE",0
33,"33007",1382,804,795,4,9,"PCTE",1
16,"16145",413,333,326,6,7,"PCTE",0
14,"14018",3617,2632,2568,31,64,"PCTE",1
37,"37377",215,174,173,0,1,"PCTE",0
19,"19119",76,65,65,0,0,"PCTE",0
19,"19040",53,43,42,1,1,"PCTE",0
39,"39064",1352,1007,990,3,17,"PCTE",2
41,"41097",3131,2197,2140,13,57,"PCTE",1
19,"19208",39,32,32,0,0,"PCTE",0
50,"50232",160,93,92,1,1,"PCTE",1
45,"45007",656,502,497,0,5,"PCTE",0
50,"50079",226,162,160,1,2,"PCTE",0
49,"49061",143,98,97,1,1,"PCTE",0
19,"19155",64,49,49,0,0,"PCTE",0
50,"50005",228,185,184,2,1,"PCTE",0
40,"40062",56,43,42,0,1,"PCTE",0
9,"9241",244,171,169,6,2,"PCTE",2
39,"39074",7050,5074,5029,26,45,"PCTE",2
37,"37222",78,55,55,2,0,"PCTE",0
39,"39102",2229,1524,1514,10,10,"PCTE",1
28,"28097",126,87,87,2,0,"PCTE",0
37,"37284",317,229,222,2,7,"PCTE",0
50,"50159",640,493,486,3,7,"PCTE",0
47,"47129",855,660,648,7,12,"PCTE",2
47,"47223",148,105,102,4,3,"PCTE",0
42,"42055",158,113,113,1,0,"PCTE",0
9,"9301",658,497,488,5,9,"PCTE",1
28,"28130",28569,22050,21799,187,251,"PCTE",18
50,"50233",96,78,78,0,0,"PCTE",0
39,"39047",1998,1408,1392,8,16,"PCTE",0
47,"47065",820,608,602,2,6,"PCTE",0
49,"49101",144,88,82,1,6,"PCTE",0
29,"29063",305,244,242,2,2,"PCTE",0
49,"49026",199,134,134,0,0,"PCTE",0
26,"26030",18,18,17,1,1,"PCTE",0
45,"45047",2694,1733,1706,24,27,"PCTE",0
9,"9412",750,484,482,4,2,"PCTE",3
28,"28164",3230,2371,2345,28,26,"PCTE",0
19,"19310",7,7,7,0,0,"PCTE",0
18,"18007",730,490,478,3,12,"PCTE",0
19,"19090",90,69,68,1,1,"PCTE",0
47,"47036",204,159,156,1,3,"PCTE",0
40,"40228",493,362,361,3,1,"PCTE",0
50,"50234",242,159,154,4,5,"PCTE",0
40,"40065",467,338,329,1,9,"PCTE",0
34,"34074",690,502,490,13,12,"PCTE",0
47,"47194",295,228,227,1,1,"PCTE",1
22,"22125",39530,27358,27075,344,283,"PCTE",23
33,"33039",1646,1118,1110,8,8,"PCTE",0
18,"18168",783,566,561,11,5,"PCTE",0
14,"14021",260521,185270,183300,2192,1970,"PCTE",152
37,"37286",204,140,137,2,3,"PCTE",0
42,"42195",86,51,51,2,0,"PCTE",0
9,"9035",284,191,190,2,1,"PCTE",0
16,"16149",147,105,105,2,0,"PCTE",0
45,"45158",2545,1805,1786,9,19,"PCTE",0
19,"19311",85,60,59,0,1,"PCTE",0
34,"34171",928,572,562,2,10,"PCTE",1
21,"21044",18061,11170,11003,123,167,"PCTE",4
18,"18906",903,641,639,2,2,"PCTE",0
34,"34033",18,14,14,0,0,"PCTE",0
41,"41019",4931,3323,3251,39,72,"PCTE",2
39,"39078",1410,1004,997,5,7,"PCTE",0
45,"45197",1888,1446,1426,5,20,"PCTE",0
50,"50186",37,26,26,1,0,"PCTE",0
40,"40198",24,20,19,0,1,"PCTE",0
26,"26070",152,125,122,1,3,"PCTE",0
37,"37061",195,136,136,1,0,"PCTE",0
47,"47228",432,324,320,2,4,"PCTE",0
40,"40134",692,522,509,10,13,"PCTE",0
40,"40231",100,79,76,0,3,"PCTE",0
40,"40070",143,94,92,1,2,"PCTE",0
34,"34225",5016,3708,3650,41,58,"PCTE",5
24,"24113",346,240,240,2,0,"PCTE",0
50,"50261",201,154,151,0,3,"PCTE",0
24,"24078",324,228,225,0,3,"PCTE",0
2,"2015",1432,1163,1148,8,15,"PCTE",0
5,"5127",600,472,469,7,3,"PCTE",0
21,"21076",2153,1459,1426,31,33,"PCTE",0
50,"50034",767,516,511,10,5,"PCTE",1
24,"24153",228,171,171,3,0,"PCTE",1
39,"39079",8850,6247,6175,28,72,"PCTE",6
2,"2049",778,506,496,1,10,"PCTE",1
41,"41021",21410,14369,14139,195,230,"PCTE",13
50,"50188",26,23,23,0,0,"PCTE",0
47,"47102",257,212,210,2,2,"PCTE",0
24,"24114",2866,1753,1742,15,11,"PCTE",3
2,"2048",1173,912,901,9,11,"PCTE",0
5,"5258",107,80,80,1,0,"PCTE",0
50,"50237",100,75,75,2,0,"PCTE",0
19,"19223",99,66,65,1,1,"PCTE",0
19,"19284",10,10,10,0,0,"PCTE",0
24,"24007",735,500,496,8,4,"PCTE",0
47,"47137",29,25,25,0,0,"PCTE",0
23,"23076",774,606,595,6,11,"PCTE",0
24,"24115",53159,35203,34784,410,419,"PCTE",123
23,"23005",29876,20565,20268,254,297,"PCTE",16
5,"5259",99,80,79,2,1,"PCTE",0
45,"45163",8326,5835,5693,48,142,"PCTE",5
26,"26112",218,152,148,1,4,"PCTE",0
16,"16039",365,241,238,3,3,"PCTE",0
42,"42201",23,21,21,0,0,"PCTE",1
19,"19224",106,83,83,1,0,"PCTE",0
23,"23043",517,360,360,1,0,"PCTE",0
41,"41078",2445,1722,1689,12,33,"PCTE",2
18,"18141",382,240,237,0,3,"PCTE",1
40,"40039",180,133,133,0,0,"PCTE",0
9,"9043",172,112,111,1,1,"PCTE",0
37,"37135",1146,849,837,5,12,"PCTE",0
49,"49178",748,520,505,7,15,"PCTE",0
37,"37292",91,65,65,0,0,"PCTE",0
26,"26001",199,145,141,3,4,"PCTE",0
37,"37231",236,185,183,5,2,"PCTE",0
9,"9044",55,46,44,1,2,"PCTE",0
47,"47199",71,57,57,2,0,"PCTE",1
29,"29042",14586,9793,9649,95,144,"PCTE",3
16,"16117",1018,723,715,9,8,"PCTE",2
34,"34083",1647,1089,1080,2,9,"PCTE",0
47,"47074",141,110,109,0,1,"PCTE",0
18,"18045",1065,720,690,11,30,"PCTE",0
42,"42204",53,37,35,1,2,"PCTE",0
9,"9256",330,221,219,0,2,"PCTE",1
47,"47105",169,138,137,2,1,"PCTE",0
22,"22061",6567,4446,4410,48,36,"PCTE",5
23,"23008",1422,1042,1020,9,22,"PCTE",5
19,"19195",36,26,25,2,1,"PCTE",0
5,"5065",452,339,337,2,2,"PCTE",0
34,"34056",1926,1335,1311,10,24,"PCTE",1
19,"19278",24,20,20,0,0,"PCTE",0
50,"50063",64,49,49,0,0,"PCTE",0
16,"16082",272,194,192,1,2,"PCTE",0
47,"47140",106,83,83,0,0,"PCTE",0
42,"42205",77,59,57,3,2,"PCTE",1
45,"45204",630,453,449,1,4,"PCTE",0
37,"37199",128,92,92,2,0,"PCTE",0
41,"41025",2031,1409,1349,11,60,"PCTE",2
18,"18111",2863,2038,2001,29,37,"PCTE",1
28,"28141",6284,4617,4570,42,47,"PCTE",1
16,"16910",75,44,44,1,0,"PCTE",1
26,"26118",71,54,53,1,1,"PCTE",1
16,"16042",1091,832,823,4,9,"PCTE",0
42,"42069",1483,896,878,2,18,"PCTE",0
18,"18912",1352,926,912,7,14,"PCTE",0
40,"40108",109,85,85,2,0,"PCTE",0
39,"39028",3892,2905,2878,20,27,"PCTE",2
34,"34042",294,224,221,1,3,"PCTE",0
9,"9374",93,75,72,2,3,"PCTE",0
49,"49225",122,68,68,0,0,"PCTE",0
19,"19289",23,16,16,0,0,"PCTE",0
9,"9317",20,18,18,0,0,"PCTE",0
47,"47015",177,129,129,0,0,"PCTE",0
14,"14029",4001,2855,2821,30,34,"PCTE",3
47,"47141",112,90,89,0,1,"PCTE",0
9,"9048",1373,937,911,10,26,"PCTE",9
9,"9427",1363,854,842,7,12,"PCTE",2
40,"40044",134,101,101,3,0,"PCTE",1
5,"5067",73,56,54,0,2,"PCTE",1
9,"9050",57,38,38,1,0,"PCTE",0
16,"16202",733,533,526,4,7,"PCTE",0
42,"42030",91,69,69,2,0,"PCTE",0
22,"22175",184,129,128,0,1,"PCTE",0
34,"34046",43,29,29,0,0,"PCTE",0
24,"24015",2193,1532,1500,12,32,"PCTE",3
9,"9429",53,34,34,1,0,"PCTE",0
2,"2056",1640,1204,1179,11,25,"PCTE",0
26,"26119",178,132,132,0,0,"PCTE",0
40,"40176",372,288,287,2,1,"PCTE",0
26,"26120",1441,1027,1011,11,16,"PCTE",2
45,"45170",194,146,140,0,6,"PCTE",0
47,"47143",104,67,67,0,0,"PCTE",0
22,"22247",28,18,18,0,0,"PCTE",1
49,"49150",123,95,92,3,3,"PCTE",0
37,"37172",846,530,524,6,6,"PCTE",3
50,"50218",112,88,88,1,0,"PCTE",0
18,"18914",1660,1255,1227,11,28,"PCTE",0
18,"18114",585,425,424,7,1,"PCTE",1
49,"49039",324,249,239,3,10,"PCTE",0
50,"50267",565,380,375,4,5,"PCTE",0
26,"26045",11,10,10,1,0,"PCTE",0
9,"9266",97,71,68,1,3,"PCTE",0
18,"18915",726,474,467,4,7,"PCTE",2
47,"47079",55,44,43,1,1,"PCTE",0
16,"16124",1807,1367,1347,14,20,"PCTE",1
16,"16087",238,184,184,6,0,"PCTE",1
5,"5136",83,55,55,0,0,"PCTE",0
24,"24053",398,250,248,1,2,"PCTE",0
16,"16161",51,44,44,1,0,"PCTE",0
50,"50091",39,32,32,0,0,"PCTE",0
9,"9905",373,239,238,2,1,"PCTE",1
21,"21055",7326,5395,5309,43,86,"PCTE",0
5,"5169",218,171,171,1,0,"PCTE",0
39,"39060",6704,4959,4887,23,72,"PCTE",5
23,"23088",6017,4529,4427,61,102,"PCTE",84
9,"9056",4833,3191,3156,37,35,"PCTE",7
18,"18116",2856,2027,1979,13,48,"PCTE",1
42,"42121",54,39,39,0,0,"PCTE",0
45,"45064",3987,2918,2880,33,38,"PCTE",0
37,"37039",279,202,197,2,5,"PCTE",0
19,"19261",33,23,23,0,0,"PCTE",0
49,"49188",111,75,73,0,2,"PCTE",0
22,"22067",70,52,52,0,0,"PCTE",0
19,"19200",66,53,52,0,1,"PCTE",0
41,"41002",1421,938,911,7,27,"PCTE",0
49,"49153",150,110,107,2,3,"PCTE",0
9,"9433",52,40,40,0,0,"PCTE",0
37,"37333",203,125,124,2,1,"PCTE",0
50,"50146",189,149,149,3,0,"PCTE",0
9,"9327",26,20,20,0,0,"PCTE",0
9,"9908",423,254,253,4,1,"PCTE",0
41,"41003",2373,1747,1708,18,39,"PCTE",1
22,"22040",149,119,119,3,0,"PCTE",0
9,"9907",1526,1140,1119,18,21,"PCTE",0
5,"5139",71,59,58,1,1,"PCTE",0
28,"28071",63,46,45,0,1,"PCTE",0
45,"45065",264,211,206,1,5,"PCTE",0
41,"41059",35358,26408,26052,346,356,"PCTE",18
28,"28010",10649,8167,8098,76,69,"PCTE",2
5,"5204",578,445,442,3,3,"PCTE",0
19,"19173",47,40,40,0,0,"PCTE",0
37,"37078",781,626,603,9,23,"PCTE",1
9,"9219",27097,17874,17629,192,245,"PCTE",23
49,"49155",81,60,59,0,1,"PCTE",0
50,"50246",37,24,24,0,0,"PCTE",0
16,"16014",558,419,417,6,2,"PCTE",0
28,"28083",9836,7278,7206,64,72,"PCTE",5
37,"37207",336,244,240,4,4,"PCTE",0
34,"34052",164,127,125,1,2,"PCTE",1
5,"5172",111,83,83,1,0,"PCTE",0
14,"14035",5774,4076,4017,35,59,"PCTE",1
16,"16051",128,96,96,3,0,"PCTE",0
9,"9059",136870,99937,98641,1416,1296,"PCTE",212
42,"42081",126,88,88,0,0,"PCTE",0
50,"50173",156,114,114,0,0,"PCTE",0
19,"19109",33,26,26,2,0,"PCTE",0
16,"16129",88,72,72,0,0,"PCTE",0
19,"19073",16,15,15,1,0,"PCTE",0
26,"26127",182,149,149,1,0,"PCTE",0
45,"45177",1998,1557,1525,10,32,"PCTE",0
45,"45068",179,129,127,0,2,"PCTE",0
21,"21059",221,169,163,1,6,"PCTE",0
28,"28150",3191,2423,2401,13,22,"PCTE",0
50,"50045",1217,891,878,10,13,"PCTE",0
47,"47084",1077,794,784,11,10,"PCTE",0
39,"39092",863,534,533,3,1,"PCTE",2
19,"19298",53,43,41,0,2,"PCTE",0
26,"26015",185,140,138,2,2,"PCTE",0
45,"45179",493,362,357,5,5,"PCTE",0
50,"50095",12149,8322,8239,91,83,"PCTE",14
16,"16156",84,64,64,0,0,"PCTE",0
47,"47013",91,77,77,1,0,"PCTE",0
37,"37337",137,104,103,0,1,"PCTE",0
40,"40084",52,41,41,2,0,"PCTE",1
37,"37273",85,58,58,2,0,"PCTE",0
37,"37367",179,147,143,2,4,"PCTE",0
42,"42219",40,34,34,1,0,"PCTE",1
16,"16170",646,451,449,5,2,"PCTE",0
5,"5008",202,158,155,0,3,"PCTE",0
50,"50175",907,638,632,11,6,"PCTE",2
18,"18121",119,79,79,1,0,"PCTE",0
19,"19005",91,63,62,0,1,"PCTE",0
34,"34204",50,35,35,0,0,"PCTE",0
26,"26016",28,20,18,0,2,"PCTE",0
33,"33028",1143,519,518,7,1,"PCTE",0
41,"41034",23576,15461,15214,264,247,"PCTE",6
23,"23095",8571,6159,6101,37,58,"PCTE",1
33,"33027",752,412,405,11,7,"PCTE",1
47,"47214",1349,1036,1019,5,17,"PCTE",1
24,"24096",105,56,54,1,2,"PCTE",0
34,"34902",123,91,91,0,0,"PCTE",1
34,"34903",179,129,129,1,0,"PCTE",0
40,"40215",79,66,66,2,0,"PCTE",0
37,"37244",129,97,97,1,0,"PCTE",2
28,"28153",816,547,544,3,3,"PCTE",0
28,"28076",432,330,327,4,3,"PCTE",0
9,"9064",305,225,219,6,6,"PCTE",0
34,"34058",182,152,152,0,0,"PCTE",0
45,"45072",653,469,462,1,7,"PCTE",0
40,"40152",732,575,565,10,10,"PCTE",0
50,"50250",54,44,44,2,0,"PCTE",0
22,"22013",271,200,197,3,3,"PCTE",0
16,"16134",4368,3143,3102,22,41,"PCTE",1
16,"16269",378,287,285,2,2,"PCTE",0
5,"5241",3062,2011,1977,21,34,"PCTE",1
21,"21002",16070,11301,11137,132,164,"PCTE",3
9,"9227",112,89,89,1,0,"PCTE",0
45,"45073",288,214,210,2,4,"PCTE",0
24,"24136",495,347,344,1,3,"PCTE",0
28,"28154",5570,3999,3961,29,38,"PCTE",4
21,"21033",569,410,405,3,5,"PCTE",0
28,"28155",487,374,369,0,5,"PCTE",0
9,"9120",41,34,33,3,1,"PCTE",0
23,"23098",847,704,700,0,4,"PCTE",0
9,"9340",74,49,49,1,0,"PCTE",0
34,"34015",37,24,24,0,0,"PCTE",0
33,"33058",1668,1050,1035,13,15,"PCTE",4
37,"37309",36,21,21,0,0,"PCTE",0
18,"18061",999,781,770,5,11,"PCTE",1
50,"50201",449,345,344,4,1,"PCTE",1
18,"18124",355,232,231,1,1,"PCTE",0
45,"45184",204,123,122,0,1,"PCTE",0
22,"22151",85,60,60,0,0,"PCTE",0
19,"19179",74,64,64,3,0,"PCTE",0
45,"45037",1520,1072,1055,5,17,"PCTE",0
37,"37050",66,52,52,1,0,"PCTE",0
16,"16174",166,130,129,2,1,"PCTE",0
2,"2035",1946,1494,1473,5,21,"PCTE",0
39,"39012",6772,4807,4755,31,52,"PCTE",3
26,"26095",93,71,68,0,3,"PCTE",0
18,"18192",1462,1125,1103,3,22,"PCTE",1
14,"14069",7340,5100,5000,69,100,"PCTE",1
49,"49018",277,197,190,2,7,"PCTE",1
9,"9447",43,37,36,0,1,"PCTE",0
45,"45075",120,77,74,0,3,"PCTE",0
5,"5049",403,261,253,1,8,"PCTE",2
45,"45112",1844,1121,1086,8,35,"PCTE",0
37,"37154",129,97,94,1,3,"PCTE",0
34,"34019",111,87,86,1,1,"PCTE",0
26,"26136",90,65,64,2,1,"PCTE",0
41,"41011",15462,11019,10696,183,323,"PCTE",6
47,"47059",94,64,64,0,0,"PCTE",0
21,"21066",490,394,389,4,5,"PCTE",1
24,"24214",626,438,433,8,5,"PCTE",0
5,"5180",76,55,53,0,2,"PCTE",0
28,"28157",690,471,467,1,4,"PCTE",0
9,"9403",103,79,78,1,1,"PCTE",0
9,"9179",39,30,30,1,0,"PCTE",0
26,"26023",433,316,314,3,2,"PCTE",0
9,"9232",139,100,97,1,3,"PCTE",0
47,"47219",39,31,28,1,3,"PCTE",0
37,"37052",287,192,191,2,1,"PCTE",0
45,"45187",3967,3133,3074,16,59,"PCTE",1
2,"2038",262,197,193,0,4,"PCTE",0
47,"47092",101,81,79,0,2,"PCTE",0
45,"45188",2770,1925,1886,12,39,"PCTE",0
24,"24067",602,327,324,6,3,"PCTE",3
24,"24215",149,116,115,0,1,"PCTE",0
16,"16025",24,20,20,0,0,"PCTE",0
16,"16141",131,98,96,1,2,"PCTE",0
45,"45040",1247,727,715,3,12,"PCTE",1
18,"18002",529,387,384,1,3,"PCTE",0
19,"19306",24,18,18,0,0,"PCTE",0
9,"9235",144,107,105,0,2,"PCTE",0
45,"45041",3967,2723,2689,18,34,"PCTE",1
19,"19215",135,109,109,0,0,"PCTE",0
21,"21008",2604,1663,1626,10,37,"PCTE",2
28,"28022",37338,30620,30455,229,165,"PCTE",12
49,"49097",67,44,44,0,0,"PCTE",0
45,"45189",633,462,459,7,3,"PCTE",2
50,"50230",1140,771,767,11,4,"PCTE",0
47,"47032",147,102,102,0,0,"PCTE",0
40,"40029",25,21,19,0,2,"PCTE",0
40,"40061",63,47,44,0,3,"PCTE",0
14,"14045",2997,2329,2287,30,42,"PCTE",2
28,"28053",6956,5475,5414,44,61,"PCTE",2
39,"39072",325,184,182,0,2,"PCTE",0
37,"37251",108,75,75,0,0,"PCTE",0
2,"2040",548,476,474,1,2,"PCTE",0
21,"21009",834,527,508,4,19,"PCTE",0
47,"47189",151,128,122,1,6,"PCTE",0
22,"22229",107,70,70,2,0,"PCTE",0
50,"50029",594,432,431,3,1,"PCTE",1
47,"47063",86,68,68,0,0,"PCTE",0
37,"37056",39,28,28,0,0,"PCTE",0
49,"49244",46,23,23,0,0,"PCTE",0
22,"22907",1463,1016,1006,21,10,"PCTE",0
19,"19143",1781,1278,1266,18,12,"PCTE",1
42,"42129",678,485,480,6,5,"PCTE",2
47,"47033",205,151,150,2,1,"PCTE",0
26,"26143",260,197,192,1,5,"PCTE",0
16,"16186",403,309,305,3,4,"PCTE",1
2,"2042",810,581,577,1,4,"PCTE",0
33,"33008",1679,1140,1133,10,7,"PCTE",3
19,"19016",57,40,40,0,0,"PCTE",0
9,"9030",116,81,81,1,0,"PCTE",0
50,"50207",87,58,58,1,0,"PCTE",0
33,"33036",11281,7240,7153,96,87,"PCTE",4
41,"41015",5426,3778,3639,41,139,"PCTE",1
23,"23047",1558,1203,1186,8,17,"PCTE",2
40,"40225",1085,822,809,5,13,"PCTE",1
37,"37159",74,59,59,0,0,"PCTE",0
22,"22084",571,400,391,5,9,"PCTE",0
42,"42054",18,12,12,0,0,"PCTE",0
5,"5262",318,238,235,1,3,"PCTE",1
18,"18100",7997,5523,5367,66,156,"PCTE",4
37,"37128",235,169,168,0,1,"PCTE",0
9,"9133",38,33,33,0,0,"PCTE",0
9,"9134",217,142,138,1,4,"PCTE",0
24,"24037",330,189,189,1,0,"PCTE",1
2,"2076",313,233,230,2,3,"PCTE",0
5,"5219",33,23,23,0,0,"PCTE",0
49,"49171",603,433,427,4,6,"PCTE",0
26,"26106",79,67,67,0,0,"PCTE",0
39,"39019",2232,1628,1603,10,25,"PCTE",2
2,"2044",1040,665,656,5,9,"PCTE",0
41,"41045",5873,3901,3802,53,99,"PCTE",4
22,"22233",81,53,53,0,0,"PCTE",0
49,"49248",171,128,128,1,0,"PCTE",0
37,"37059",117,95,95,3,0,"PCTE",0
19,"19122",81,62,60,2,2,"PCTE",1
34,"34222",107,71,68,1,3,"PCTE",0
18,"18136",1778,1320,1284,14,36,"PCTE",1
37,"37161",123,86,86,0,0,"PCTE",0
29,"29008",15249,10396,10234,108,162,"PCTE",5
22,"22202",147,128,128,3,0,"PCTE",0
40,"40068",22,21,21,0,0,"PCTE",0
37,"37162",212,139,137,3,2,"PCTE",0
22,"22234",743,498,491,5,7,"PCTE",0
16,"16239",118,88,87,0,1,"PCTE",0
37,"37192",361,200,198,3,2,"PCTE",1
47,"47006",182,149,145,1,4,"PCTE",0
45,"45011",279,235,233,4,2,"PCTE",0
41,"41074",2994,2154,2105,19,49,"PCTE",2
42,"42103",543,383,374,2,9,"PCTE",0
9,"9358",247,165,161,3,4,"PCTE",0
19,"19019",14,11,11,1,0,"PCTE",0
18,"18137",968,733,731,3,2,"PCTE",0
34,"34076",532,443,438,1,5,"PCTE",0
34,"34224",39,25,25,0,0,"PCTE",0
26,"26148",154,125,122,3,3,"PCTE",0
19,"19160",883,535,530,11,5,"PCTE",0
24,"24184",177,106,105,0,1,"PCTE",0
45,"45012",623,482,472,0,10,"PCTE",0
16,"16110",90,70,70,1,0,"PCTE",0
37,"37163",34,24,24,0,0,"PCTE",0
19,"19314",44,33,33,0,0,"PCTE",0
47,"47195",426,314,310,2,4,"PCTE",0
37,"37320",85,65,64,1,1,"PCTE",0
26,"26033",162,133,132,3,1,"PCTE",2
37,"37164",232,176,175,3,1,"PCTE",0
5,"5256",110,88,86,1,2,"PCTE",0
5,"5026",183,149,147,1,2,"PCTE",0
45,"45198",1808,1442,1428,6,14,"PCTE",0
16,"16242",300,245,243,2,2,"PCTE",0
50,"50236",95,77,75,0,2,"PCTE",0
50,"50187",55,42,42,0,0,"PCTE",0
22,"22204",1117,728,723,14,5,"PCTE",0
40,"40103",139,113,113,0,0,"PCTE",0
22,"22236",232,190,188,2,2,"PCTE",0
41,"41093",19064,14867,14700,151,167,"PCTE",5
37,"37165",31,22,22,0,0,"PCTE",0
42,"42107",70,48,47,1,1,"PCTE",0
24,"24042",60,47,47,2,0,"PCTE",0
34,"34175",87,67,66,1,1,"PCTE",0
14,"14052",9039,5579,5478,79,101,"PCTE",2
9,"9473",85,68,64,0,4,"PCTE",1
29,"29011",2893,1763,1736,12,27,"PCTE",0
42,"42108",10,7,7,0,0,"PCTE",0
50,"50060",171,126,125,1,1,"PCTE",2
39,"39080",3477,2404,2388,4,16,"PCTE",1
28,"28168",1347,933,918,6,15,"PCTE",1
19,"19318",26,18,18,0,0,"PCTE",0
14,"14025",2834,2352,2299,9,53,"PCTE",2
45,"45090",370,262,261,2,1,"PCTE",0
22,"22205",448,294,292,0,2,"PCTE",0
49,"49108",446,312,309,2,3,"PCTE",0
37,"37354",5479,3969,3905,37,64,"PCTE",11
26,"26152",27,20,20,1,0,"PCTE",0
41,"41022",4255,2735,2667,32,68,"PCTE",1
40,"40201",42,37,37,0,0,"PCTE",0
21,"21048",318,234,229,3,5,"PCTE",0
24,"24228",619,370,364,2,6,"PCTE",1
34,"34037",301,206,204,1,2,"PCTE",0
42,"42111",274,183,181,0,2,"PCTE",0
5,"5097",464,309,305,0,4,"PCTE",1
9,"9478",45,34,34,1,0,"PCTE",1
49,"49109",561,419,415,6,4,"PCTE",0
34,"34230",16,11,11,0,0,"PCTE",0
24,"24155",441,340,334,2,6,"PCTE",1
28,"28002",3250,2261,2243,14,18,"PCTE",0
37,"37136",625,388,387,7,1,"PCTE",0
19,"19286",772,585,575,3,10,"PCTE",1
33,"33073",8096,4377,4320,59,57,"PCTE",0
33,"33072",1443,816,814,8,2,"PCTE",2
42,"42160",246,177,175,3,2,"PCTE",1
49,"49034",408,282,281,2,1,"PCTE",0
40,"40073",387,327,323,1,4,"PCTE",0
18,"18144",816,592,582,3,10,"PCTE",0
42,"42026",28,25,25,0,0,"PCTE",0
50,"50087",28,19,19,0,0,"PCTE",0
9,"9480",105,84,84,0,0,"PCTE",0
24,"24046",893,595,583,6,12,"PCTE",1
14,"14055",18411,13054,12798,192,256,"PCTE",1
23,"23081",1494,1084,1061,9,23,"PCTE",1
42,"42027",72,48,47,1,1,"PCTE",0
21,"21019",592,397,389,6,8,"PCTE",0
28,"28171",4410,2921,2889,8,32,"PCTE",0
40,"40203",987,753,740,13,13,"PCTE",2
50,"50264",151,111,110,0,1,"PCTE",0
16,"16197",67,44,43,0,1,"PCTE",0
18,"18911",7933,5464,5348,53,116,"PCTE",2
26,"26076",115,83,83,0,0,"PCTE",0
29,"29044",749,477,473,1,4,"PCTE",0
50,"50038",1404,1024,1007,15,17,"PCTE",2
49,"49003",860,534,530,5,4,"PCTE",0
39,"39084",868,608,605,3,3,"PCTE",0
19,"19333",96,68,67,0,1,"PCTE",0
34,"34234",66,48,45,0,3,"PCTE",0
29,"29090",1649,1138,1124,10,14,"PCTE",0
42,"42162",2298,1493,1462,18,31,"PCTE",4
34,"34010",550,407,399,7,8,"PCTE",0
37,"37107",10444,6997,6884,76,113,"PCTE",11
9,"9152",244,161,161,0,0,"PCTE",0
5,"5229",75,61,61,1,0,"PCTE",0
42,"42206",8,5,5,2,0,"PCTE",0
9,"9259",230,178,176,2,2,"PCTE",1
16,"16083",44,24,24,0,0,"PCTE",0
24,"24902",331,239,239,0,0,"PCTE",0
19,"19197",28,22,22,1,0,"PCTE",0
9,"9209",4404,2997,2950,31,47,"PCTE",2
49,"49183",90,67,65,2,2,"PCTE",0
19,"19324",164,122,120,4,2,"PCTE",1
5,"5102",1681,1252,1228,8,24,"PCTE",0
47,"47077",234,172,170,1,2,"PCTE",0
24,"24087",582,431,427,3,4,"PCTE",0
42,"42118",21,11,11,0,0,"PCTE",0
49,"49005",125,80,80,1,0,"PCTE",0
19,"19033",47,38,37,1,1,"PCTE",0
9,"9155",25,23,23,0,0,"PCTE",0
16,"16122",244,184,182,1,2,"PCTE",0
40,"40077",966,718,704,10,14,"PCTE",0
29,"29091",9490,6428,6304,61,124,"PCTE",2
47,"47173",879,627,622,9,5,"PCTE",0
5,"5197",100,82,79,1,3,"PCTE",0
5,"5103",63,44,44,1,0,"PCTE",0
18,"18048",2494,1708,1657,18,51,"PCTE",3
16,"16203",10221,6960,6883,42,77,"PCTE",4
28,"28037",1570,1135,1123,4,12,"PCTE",0
50,"50169",333,231,230,0,1,"PCTE",0
34,"34135",398,267,264,4,3,"PCTE",0
40,"40905",130,95,95,0,0,"PCTE",0
28,"28145",2671,1927,1895,21,32,"PCTE",2
28,"28068",11740,8615,8543,72,72,"PCTE",11
47,"47047",199,136,135,4,1,"PCTE",1
5,"5168",3503,2536,2511,29,25,"PCTE",3
37,"37073",613,448,440,4,8,"PCTE",1
23,"23050",90664,65260,64519,581,741,"PCTE",59
37,"37236",123,85,82,1,3,"PCTE",0
40,"40014",56,39,38,0,1,"PCTE",0
24,"24052",139,94,93,0,1,"PCTE",0
16,"16253",308,230,228,2,2,"PCTE",0
9,"9431",116,85,84,2,1,"PCTE",0
49,"49007",361,241,233,7,8,"PCTE",0
9,"9104",49,35,34,0,1,"PCTE",0
28,"28039",134,93,93,1,0,"PCTE",0
37,"37112",158,110,109,2,1,"PCTE",0
49,"49229",109,80,77,1,3,"PCTE",0
19,"19036",242,202,200,1,2,"PCTE",0
28,"28177",10851,8550,8485,89,65,"PCTE",4
5,"5200",41,26,26,0,0,"PCTE",0
16,"16011",20,14,14,0,0,"PCTE",0
18,"18181",194,134,133,0,1,"PCTE",0
45,"45026",219,166,164,1,2,"PCTE",0
47,"47049",91,58,58,0,0,"PCTE",0
16,"16088",100,86,86,0,0,"PCTE",1
40,"40079",229,160,159,2,1,"PCTE",0
23,"23016",386,313,305,4,8,"PCTE",0
28,"28147",991,702,698,4,4,"PCTE",0
9,"9216",370,245,241,3,4,"PCTE",1
22,"22139",80,57,57,1,0,"PCTE",0
39,"39089",131,82,82,0,0,"PCTE",0
24,"24164",351,175,174,0,1,"PCTE",1
50,"50120",55,42,42,1,0,"PCTE",1
49,"49009",382,251,251,0,0,"PCTE",0
37,"37175",412,298,293,4,5,"PCTE",0
22,"22069",423,296,294,4,2,"PCTE",0
18,"18022",13875,8948,8764,98,184,"PCTE",8
5,"5901",247,154,152,3,2,"PCTE",0
39,"39033",536,375,372,1,3,"PCTE",0
33,"33052",681,418,416,3,2,"PCTE",0
45,"45175",603,476,473,1,3,"PCTE",0
37,"37206",87,65,54,0,11,"PCTE",0
18,"18150",6964,4717,4622,51,95,"PCTE",1
5,"5002",1905,1361,1329,11,32,"PCTE",6
50,"50294",65,45,45,0,0,"PCTE",0
37,"37270",184,139,136,2,3,"PCTE",0
9,"9109",1072,575,558,0,17,"PCTE",3
9,"9329",113,76,75,5,1,"PCTE",0
14,"14006",1319,1088,1057,8,31,"PCTE",0
28,"28072",6176,4716,4673,44,43,"PCTE",1
16,"16050",218,172,169,2,3,"PCTE",0
39,"39034",255,133,128,2,5,"PCTE",0
24,"24203",88,62,62,1,0,"PCTE",0
28,"28117",99,87,86,0,1,"PCTE",0
37,"37365",162,125,121,0,4,"PCTE",1
5,"5108",39,21,21,0,0,"PCTE",0
50,"50197",95,69,68,2,1,"PCTE",1
26,"26167",50,34,33,1,1,"PCTE",0
16,"16092",149,108,108,1,0,"PCTE",0
9,"9273",48,40,39,0,1,"PCTE",0
26,"26014",443,278,273,3,5,"PCTE",0
24,"24167",703,436,430,3,6,"PCTE",0
18,"18054",820,573,569,2,4,"PCTE",0
22,"22218",39,34,34,0,0,"PCTE",0
19,"19264",33,25,25,0,0,"PCTE",0
50,"50271",246,179,173,4,6,"PCTE",0
26,"26168",5584,3757,3696,35,61,"PCTE",4
24,"24094",1320,866,852,11,14,"PCTE",1
41,"41061",2141,1661,1621,7,40,"PCTE",0
39,"39008",13900,9814,9734,63,80,"PCTE",8
18,"18087",182877,131811,130184,1106,1627,"PCTE",78
42,"42128",45,40,39,2,1,"PCTE",0
24,"24168",430,325,322,6,3,"PCTE",0
9,"9061",147,119,119,0,0,"PCTE",0
19,"19110",51,39,39,0,0,"PCTE",0
14,"14065",1820,1374,1352,13,22,"PCTE",0
2,"2030",2949,2158,2122,16,36,"PCTE",2
21,"21030",1887,1493,1458,12,35,"PCTE",0
14,"14009",2653,1658,1631,24,27,"PCTE",0
49,"49013",219,160,159,0,1,"PCTE",0
34,"34100",132,96,95,1,1,"PCTE",0
37,"37243",89,66,66,0,0,"PCTE",0
23,"23057",727,582,572,7,10,"PCTE",0
19,"19041",163,118,117,1,1,"PCTE",0
42,"42130",51,42,40,1,2,"PCTE",0
37,"37253",135,109,109,1,0,"PCTE",0
50,"50273",33,24,24,1,0,"PCTE",0
24,"24169",2777,1908,1880,10,28,"PCTE",1
37,"37211",208,148,148,0,0,"PCTE",0
29,"29053",1717,1133,1116,12,17,"PCTE",1
37,"37034",77,63,62,0,1,"PCTE",0
26,"26091",147,115,114,0,1,"PCTE",0
45,"45143",1192,877,865,9,12,"PCTE",1
16,"16132",33,25,25,1,0,"PCTE",0
23,"23024",12215,8702,8447,69,255,"PCTE",11
45,"45107",3463,2621,2585,23,36,"PCTE",1
16,"16171",1728,1334,1313,10,21,"PCTE",0
5,"5209",74,58,58,1,0,"PCTE",0
49,"49236",71,54,54,0,0,"PCTE",0
2,"2065",441,368,361,0,7,"PCTE",0
37,"37181",265,158,158,0,0,"PCTE",0
42,"42131",50,39,39,2,0,"PCTE",0
47,"47087",362,272,268,1,4,"PCTE",0
2,"2066",222,165,163,1,2,"PCTE",0
37,"37306",238,140,136,3,4,"PCTE",0
49,"49016",230,155,155,0,0,"PCTE",0
26,"26093",48,34,33,0,1,"PCTE",0
33,"33001",1475,758,753,15,5,"PCTE",2
28,"28121",209,156,152,1,4,"PCTE",0
37,"37370",316,238,237,2,1,"PCTE",0
19,"19043",99,80,79,0,1,"PCTE",0
16,"16217",91,72,72,0,0,"PCTE",0
39,"39095",2266,1637,1619,8,18,"PCTE",0
47,"47153",101,69,69,1,0,"PCTE",0
22,"22223",77,60,59,2,1,"PCTE",1
37,"37340",141,97,97,1,0,"PCTE",0
26,"26019",346,260,251,2,9,"PCTE",1
42,"42087",51,45,42,1,3,"PCTE",0
26,"26056",404,312,301,2,11,"PCTE",0
29,"29027",2325,1543,1516,13,27,"PCTE",0
18,"18189",785,598,592,9,6,"PCTE",1
34,"34017",889,676,665,7,11,"PCTE",0
19,"19281",19,18,18,0,0,"PCTE",2
28,"28057",1556,1155,1141,7,14,"PCTE",0
40,"40123",141,98,94,4,4,"PCTE",0
39,"39068",642,442,438,1,4,"PCTE",1
24,"24099",153,111,110,1,1,"PCTE",0
16,"16271",612,482,481,3,1,"PCTE",2
37,"37215",133,93,90,1,3,"PCTE",0
47,"47090",2447,1823,1784,15,39,"PCTE",1
42,"42135",69,40,40,1,0,"PCTE",0
34,"34018",199,151,149,4,2,"PCTE",0
22,"22113",478,335,333,6,2,"PCTE",1
21,"21004",1586,994,964,23,30,"PCTE",0
37,"37017",226,169,168,4,1,"PCTE",0
50,"50001",89,68,68,0,0,"PCTE",0
9,"9345",111,87,86,2,1,"PCTE",0
37,"37184",289,178,177,1,1,"PCTE",0
42,"42089",57,44,43,0,1,"PCTE",0
5,"5148",22,19,19,0,0,"PCTE",0
9,"9022",58,46,46,1,0,"PCTE",0
24,"24065",2164,1524,1492,12,32,"PCTE",1
34,"34107",73,47,46,1,1,"PCTE",0
18,"18062",11226,7969,7777,88,192,"PCTE",2
45,"45149",517,400,393,2,7,"PCTE",0
49,"49241",235,178,177,1,1,"PCTE",0
34,"34062",148,94,93,0,1,"PCTE",0
33,"33004",65304,43473,43153,563,320,"PCTE",66
50,"50051",802,551,550,2,1,"PCTE",0
22,"22079",118,85,84,1,1,"PCTE",0
49,"49020",253,189,187,0,2,"PCTE",0
21,"21067",406,274,271,3,3,"PCTE",0
22,"22904",751,516,511,3,5,"PCTE",1
40,"40189",471,344,329,1,15,"PCTE",0
34,"34214",176,121,120,1,1,"PCTE",1
22,"22049",73,62,62,0,0,"PCTE",0
22,"22115",348,263,261,3,2,"PCTE",0
22,"22017",826,613,608,2,5,"PCTE",0
14,"14071",874,551,540,5,11,"PCTE",0
24,"24102",587,403,399,7,4,"PCTE",0
2,"2071",1027,800,795,7,5,"PCTE",0
28,"28020",193,96,93,0,3,"PCTE",0
9,"9180",132,94,91,1,3,"PCTE",0
33,"33033",9381,5848,5770,88,78,"PCTE",23
18,"18128",332,263,260,1,3,"PCTE",0
47,"47220",151,106,105,1,1,"PCTE",0
16,"16244",698,598,585,7,13,"PCTE",1
40,"40028",103,88,87,2,1,"PCTE",0
5,"5246",48,35,35,0,0,"PCTE",0
22,"22905",287,217,217,1,0,"PCTE",0
16,"16275",12,12,12,1,0,"PCTE",0
5,"5018",23,17,17,2,0,"PCTE",0
16,"16026",91,69,68,0,1,"PCTE",1
24,"24216",666,453,445,4,8,"PCTE",0
19,"19153",22,20,20,2,0,"PCTE",0
49,"49021",14204,9429,9295,87,134,"PCTE",7
26,"26025",84,69,65,2,4,"PCTE",0
24,"24143",497,344,343,3,1,"PCTE",0
45,"45005",225,170,167,3,3,"PCTE",0
50,"50205",72,51,49,0,2,"PCTE",0
47,"47127",138,89,88,2,1,"PCTE",1
41,"41013",4836,3174,3124,41,50,"PCTE",4
26,"26062",85,62,62,1,0,"PCTE",0
9,"9130",64,39,39,2,0,"PCTE",0
47,"47094",120,100,100,0,0,"PCTE",0
29,"29032",6655,4900,4775,36,125,"PCTE",3
2,"2073",4825,3433,3394,35,39,"PCTE",3
19,"19087",17,16,16,0,0,"PCTE",0
26,"26063",118,88,88,2,0,"PCTE",1
37,"37188",158,107,105,3,2,"PCTE",0
39,"39017",550,378,372,1,6,"PCTE",0
22,"22019",176,128,126,1,2,"PCTE",0
9,"9029",151,111,108,2,3,"PCTE",1
9,"9076",24,19,19,1,0,"PCTE",1
22,"22052",874,660,652,7,8,"PCTE",0
9,"9189",123,83,78,0,5,"PCTE",0
28,"28129",8589,6397,6338,46,59,"PCTE",1
40,"40031",546,410,406,3,4,"PCTE",1
45,"45192",2380,1890,1854,8,36,"PCTE",2
47,"47095",41,29,28,0,1,"PCTE",0
40,"40193",219,156,155,3,1,"PCTE",0
37,"37127",205,139,139,1,0,"PCTE",0
5,"5055",532,417,413,3,4,"PCTE",1
24,"24034",3466,2382,2359,25,23,"PCTE",5
49,"49207",215,144,143,1,1,"PCTE",0
47,"47160",395,296,294,3,2,"PCTE",0
9,"9483",189,156,155,2,1,"PCTE",0
41,"41081",30061,21488,21059,331,429,"PCTE",13
33,"33074",3366,2042,2011,35,31,"PCTE",4
50,"50055",3635,2298,2244,36,54,"PCTE",3
47,"47096",127,94,93,1,1,"PCTE",0
19,"19145",40,32,32,0,0,"PCTE",0
16,"16119",175,117,115,0,2,"PCTE",0
16,"16006",113,100,100,1,0,"PCTE",0
34,"34167",110,84,83,0,1,"PCTE",0
19,"19279",54,42,42,0,0,"PCTE",0
24,"24108",348,247,246,4,1,"PCTE",0
29,"29007",28907,20371,20129,254,242,"PCTE",17
9,"9190",86,58,54,2,4,"PCTE",0
14,"14020",336,227,225,0,2,"PCTE",1
9,"9243",73,50,49,1,1,"PCTE",1
22,"22909",307,219,217,0,2,"PCTE",0
45,"45048",360,276,271,2,5,"PCTE",0
45,"45120",113,86,86,0,0,"PCTE",0
37,"37025",245,198,196,5,2,"PCTE",0
37,"37317",287,211,209,1,2,"PCTE",1
34,"34073",180,123,120,3,3,"PCTE",0
9,"9135",41,28,28,0,0,"PCTE",0
2,"2077",52,41,41,0,0,"PCTE",0
42,"42152",67,47,44,1,3,"PCTE",0
18,"18069",484,356,356,5,0,"PCTE",3
41,"41046",3005,2241,2198,11,43,"PCTE",0
37,"37349",100,61,58,0,3,"PCTE",0
45,"45194",64,45,44,1,1,"PCTE",0
2,"2078",891,650,642,4,8,"PCTE",0
47,"47037",161,128,125,1,3,"PCTE",0
29,"29064",423,291,285,2,6,"PCTE",0
33,"33011",10563,5646,5578,92,68,"PCTE",5
22,"22055",305,242,235,2,7,"PCTE",0
18,"18905",15688,10406,10200,122,206,"PCTE",4
42,"42057",145,70,70,0,0,"PCTE",0
21,"21043",1853,1354,1325,23,29,"PCTE",1
18,"18082",810,503,500,3,3,"PCTE",0
26,"26007",482,360,348,0,12,"PCTE",4
45,"45061",2490,1690,1669,9,21,"PCTE",1
24,"24004",495,387,384,10,3,"PCTE",1
37,"37099",63,46,46,1,0,"PCTE",0
37,"37132",317,211,207,0,4,"PCTE",0
16,"16034",155,116,113,0,3,"PCTE",0
47,"47164",349,283,281,1,2,"PCTE",0
18,"18070",287,216,216,3,0,"PCTE",0
5,"5126",60,47,45,0,2,"PCTE",0
50,"50059",757,556,551,5,5,"PCTE",0
40,"40035",135,110,110,2,0,"PCTE",0
5,"5221",322,231,231,0,0,"PCTE",0
5,"5159",224,133,132,3,1,"PCTE",0
26,"26109",73,68,68,0,0,"PCTE",0
9,"9248",80,62,61,1,1,"PCTE",1
39,"39050",260,164,164,1,0,"PCTE",0
47,"47100",118,93,87,2,6,"PCTE",0
42,"42106",13,11,11,0,0,"PCTE",0
29,"29066",357,248,246,1,2,"PCTE",0
42,"42021",65,46,45,2,1,"PCTE",0
49,"49030",79,56,56,0,0,"PCTE",0
16,"16192",42,28,28,0,0,"PCTE",0
9,"9417",42,31,31,1,0,"PCTE",0
19,"19251",39,30,30,0,0,"PCTE",0
37,"37258",134,92,92,1,0,"PCTE",0
29,"29085",138,98,93,1,5,"PCTE",0
9,"9250",264,195,193,3,2,"PCTE",0
5,"5095",236,181,177,1,4,"PCTE",0
5,"5191",121,99,99,0,0,"PCTE",1
2,"2081",18287,12910,12675,130,235,"PCTE",12
5,"5160",289,220,213,0,7,"PCTE",0
42,"42198",19,9,9,1,0,"PCTE",0
19,"19057",69,51,51,0,0,"PCTE",0
28,"28060",1585,1160,1146,5,14,"PCTE",0
47,"47040",56,42,41,0,1,"PCTE",0
16,"16905",1302,951,934,10,17,"PCTE",0
29,"29040",1933,1260,1235,11,25,"PCTE",0
16,"16113",3065,2142,2108,13,34,"PCTE",1
9,"9141",617,463,456,5,7,"PCTE",0
28,"28031",2129,1501,1486,8,15,"PCTE",1
24,"24188",3795,2877,2825,40,52,"PCTE",4
40,"40104",283,203,200,0,3,"PCTE",0
16,"16209",110,95,94,2,1,"PCTE",1
40,"40105",43,35,35,0,0,"PCTE",0
45,"45016",4486,3288,3251,19,37,"PCTE",3
42,"42062",20,10,10,0,0,"PCTE",0
19,"19285",20,16,16,0,0,"PCTE",0
23,"23006",4582,3536,3461,43,75,"PCTE",4
50,"50238",84,65,65,0,0,"PCTE",0
22,"22060",1167,817,808,14,9,"PCTE",0
41,"41079",9285,6591,6446,101,145,"PCTE",4
34,"34177",178,149,149,1,0,"PCTE",0
40,"40138",2102,1585,1565,13,20,"PCTE",2
24,"24008",8931,6291,6214,79,77,"PCTE",2
45,"45017",264,199,196,4,3,"PCTE",0
47,"47011",554,466,462,7,4,"PCTE",0
34,"34129",168,118,118,1,0,"PCTE",0
19,"19024",8561,6015,5942,44,73,"PCTE",3
24,"24190",146,103,103,2,0,"PCTE",0
16,"16155",490,389,388,7,1,"PCTE",0
40,"40171",40,32,32,1,0,"PCTE",0
9,"9422",19,13,13,0,0,"PCTE",0
37,"37262",69,51,51,0,0,"PCTE",0
47,"47012",100,72,71,0,1,"PCTE",0
5,"5261",32,25,25,0,0,"PCTE",0
40,"40040",2489,1766,1744,26,22,"PCTE",2
9,"9093",162,131,131,1,0,"PCTE",0
9,"9045",269,159,158,0,1,"PCTE",0
49,"49258",111,93,93,2,0,"PCTE",0
42,"42161",136,99,99,0,0,"PCTE",0
16,"16041",334,244,243,2,1,"PCTE",1
18,"18015",424,331,330,4,1,"PCTE",0
47,"47139",997,728,719,4,9,"PCTE",0
29,"29088",2689,1817,1747,15,70,"PCTE",0
24,"24011",182,104,102,3,2,"PCTE",0
19,"19060",157,123,122,0,1,"PCTE",0
28,"28109",1651,1131,1116,8,15,"PCTE",0
49,"49002",58,43,40,0,3,"PCTE",0
19,"19130",61556,45926,45388,408,538,"PCTE",28
49,"49111",119,84,84,3,0,"PCTE",0
24,"24119",695,464,458,7,6,"PCTE",2
50,"50240",943,693,683,12,10,"PCTE",0
29,"29098",1228,902,876,11,26,"PCTE",0
49,"49270",139,93,92,0,1,"PCTE",0
19,"19266",229,184,182,1,2,"PCTE",0
47,"47106",44,30,30,0,0,"PCTE",0
40,"40141",822,584,568,9,16,"PCTE",2
5,"5155",46,33,31,1,2,"PCTE",0
14,"14038",32742,23345,22974,242,371,"PCTE",14
39,"39065",222,166,163,0,3,"PCTE",0
45,"45058",344,245,236,1,9,"PCTE",0
19,"19102",88,75,73,0,2,"PCTE",0
2,"2021",1013,806,798,6,8,"PCTE",0
50,"50290",360,260,255,5,5,"PCTE",0
45,"45132",2387,1765,1754,13,11,"PCTE",0
21,"21052",4403,2688,2631,26,57,"PCTE",2
34,"34182",746,558,553,9,5,"PCTE",0
19,"19288",21,20,20,2,0,"PCTE",0
22,"22174",462,352,350,0,2,"PCTE",0
28,"28111",629,479,475,2,4,"PCTE",0
49,"49149",368,270,266,1,4,"PCTE",0
23,"23084",902,627,621,4,6,"PCTE",1
47,"47204",235,159,157,3,2,"PCTE",0
16,"16008",80,63,63,1,0,"PCTE",0
49,"49037",174,139,136,1,3,"PCTE",2
39,"39029",629,476,469,1,7,"PCTE",0
47,"47016",65,55,55,0,0,"PCTE",0
24,"24121",599,422,418,3,4,"PCTE",0
9,"9211",1369,938,921,14,17,"PCTE",0
28,"28144",6525,5032,4987,39,45,"PCTE",5
28,"28174",1858,1284,1273,1,11,"PCTE",0
49,"49114",40,31,27,0,4,"PCTE",0
29,"29045",1679,1162,1144,5,18,"PCTE",1
9,"9902",439,334,326,10,8,"PCTE",1
45,"45134",1622,1187,1177,8,10,"PCTE",0
16,"16009",54,44,44,2,0,"PCTE",0
42,"42211",84,67,67,0,0,"PCTE",0
16,"16085",131,106,106,0,0,"PCTE",0
33,"33021",4304,2643,2610,32,33,"PCTE",3
37,"37276",125,92,92,0,0,"PCTE",0
37,"37037",108,72,72,0,0,"PCTE",0
24,"24109",857,534,528,8,6,"PCTE",0
19,"19114",30,22,21,1,1,"PCTE",0
23,"23012",4004,2726,2689,21,37,"PCTE",0
23,"23014",2535,1890,1861,28,29,"PCTE",4
16,"16160",58,41,41,1,0,"PCTE",0
22,"22102",180,137,136,3,1,"PCTE",0
9,"9904",464,344,339,3,5,"PCTE",0
50,"50292",130,108,107,0,1,"PCTE",0
42,"42120",131,87,86,1,1,"PCTE",0
5,"5038",114,83,82,0,1,"PCTE",0
18,"18180",636,410,401,2,9,"PCTE",0
26,"26081",15,14,14,1,0,"PCTE",0
49,"49151",591,389,388,3,1,"PCTE",0
37,"37299",230,148,147,0,1,"PCTE",0
42,"42168",108,73,73,0,0,"PCTE",0
23,"23087",11169,8193,8045,79,148,"PCTE",30
42,"42167",235,163,161,4,2,"PCTE",1
19,"19067",68,46,44,0,2,"PCTE",0
19,"19293",1945,1402,1388,19,14,"PCTE",0
18,"18916",1815,1093,1086,6,7,"PCTE",0
50,"50018",883,622,616,5,6,"PCTE",0
9,"9055",47,33,32,0,1,"PCTE",0
24,"24018",172,129,128,0,1,"PCTE",0
26,"26164",50,36,35,0,1,"PCTE",1
22,"22006",268,167,164,4,3,"PCTE",0
19,"19136",11,10,10,0,0,"PCTE",0
28,"28125",3208,2275,2252,5,23,"PCTE",1
47,"47019",92,68,68,1,0,"PCTE",0
24,"24201",1029,683,676,9,7,"PCTE",1
19,"19213",67,53,52,1,1,"PCTE",0
19,"19070",65,45,45,0,0,"PCTE",0
49,"49118",193,151,151,2,0,"PCTE",0
19,"19037",131,109,108,0,1,"PCTE",0
50,"50270",38,26,25,0,1,"PCTE",0
28,"28082",6110,4622,4581,41,41,"PCTE",4
24,"24019",338,259,256,4,3,"PCTE",0
49,"49266",66,46,45,1,1,"PCTE",0
40,"40081",117,80,76,1,4,"PCTE",0
2,"2060",1268,953,939,7,14,"PCTE",1
23,"23053",9451,6038,5975,60,63,"PCTE",11
22,"22007",751,527,520,1,7,"PCTE",0
28,"28126",50,36,36,0,0,"PCTE",0
49,"49231",288,208,203,0,5,"PCTE",0
33,"33005",1357,832,825,11,7,"PCTE",1
40,"40211",66,54,54,1,0,"PCTE",0
34,"34022",1022,813,798,7,15,"PCTE",0
28,"28116",748,576,569,2,7,"PCTE",0
22,"22106",20,13,13,2,0,"PCTE",0
23,"23018",2243,1606,1584,17,22,"PCTE",1
49,"49190",50,42,42,3,0,"PCTE",0
22,"22141",115,94,93,0,1,"PCTE",0
42,"42037",28,13,13,2,0,"PCTE",0
45,"45140",1075,788,772,10,16,"PCTE",1
45,"45029",186,154,154,2,0,"PCTE",0
49,"49044",78,56,53,0,3,"PCTE",0
47,"47021",73,57,55,0,2,"PCTE",0
42,"42038",33,22,22,1,0,"PCTE",0
14,"14007",15016,10248,10043,99,205,"PCTE",10
49,"49156",218,149,144,0,5,"PCTE",0
24,"24093",342,214,212,2,2,"PCTE",0
41,"41060",15058,10551,10302,122,249,"PCTE",2
2,"2029",3333,2363,2320,13,43,"PCTE",3
37,"37241",167,121,119,3,2,"PCTE",1
24,"24130",415,291,289,2,2,"PCTE",0
33,"33054",1601,1025,1010,17,15,"PCTE",0
29,"29068",7833,4897,4806,50,91,"PCTE",2
50,"50148",304,213,211,2,2,"PCTE",1
37,"37044",431,309,308,3,1,"PCTE",0
9,"9168",270,211,210,5,1,"PCTE",1
16,"16264",385,311,305,1,6,"PCTE",0
40,"40182",169,112,112,1,0,"PCTE",0
23,"23056",3052,2279,2207,26,72,"PCTE",7
41,"41005",9285,6637,6497,83,140,"PCTE",1
47,"47053",123,101,97,3,4,"PCTE",0
19,"19235",98,77,76,1,1,"PCTE",0
22,"22144",255,192,190,2,2,"PCTE",0
19,"19265",134,97,97,5,0,"PCTE",0
9,"9334",51,36,34,1,2,"PCTE",0
47,"47212",356,289,287,4,2,"PCTE",0
22,"22253",56,40,40,1,0,"PCTE",0
40,"40120",195,169,163,0,6,"PCTE",1
5,"5217",54,42,41,0,1,"PCTE",0
5,"5088",29,22,22,0,0,"PCTE",0
37,"37169",177,122,122,0,0,"PCTE",0
47,"47024",223,170,168,1,2,"PCTE",0
24,"24132",610,330,329,5,1,"PCTE",0
26,"26157",283,222,217,0,5,"PCTE",0
50,"50191",446,327,326,1,1,"PCTE",0
18,"18177",375,235,231,5,4,"PCTE",0
34,"34233",128,104,104,0,0,"PCTE",0
5,"5056",91,71,70,0,1,"PCTE",0
50,"50047",38,24,24,0,0,"PCTE",0
23,"23058",8832,6528,6407,57,121,"PCTE",5
26,"26171",155,109,107,2,2,"PCTE",0
16,"16055",669,429,426,0,3,"PCTE",1
37,"37119",99,78,78,1,0,"PCTE",0
9,"9338",225,174,172,3,2,"PCTE",0
34,"34011",379,290,284,2,6,"PCTE",0
22,"22254",1084,744,735,10,9,"PCTE",1
40,"40021",18,15,15,0,0,"PCTE",0
34,"34152",124,99,94,0,5,"PCTE",0
18,"18154",982,668,668,4,0,"PCTE",0
37,"37212",104,76,76,0,0,"PCTE",0
42,"42043",3816,2602,2540,23,62,"PCTE",4
23,"23096",2543,2029,1986,16,43,"PCTE",0
41,"41063",2735,1855,1797,30,58,"PCTE",0
24,"24003",603,374,372,0,2,"PCTE",0
28,"28078",40,38,38,0,0,"PCTE",0
41,"41008",1044,788,766,3,22,"PCTE",0
45,"45035",286,206,204,2,2,"PCTE",0
37,"37182",75,47,47,1,0,"PCTE",0
16,"16270",154,123,122,1,1,"PCTE",0
39,"39011",1587,1178,1178,6,0,"PCTE",0
42,"42134",2651,1875,1836,21,39,"PCTE",2
18,"18158",7978,4861,4771,43,90,"PCTE",7
18,"18094",2299,1712,1652,20,60,"PCTE",0
33,"33002",9403,5920,5839,69,81,"PCTE",6
22,"22046",713,555,549,9,6,"PCTE",0
19,"19189",114,87,84,0,3,"PCTE",0
26,"26094",67,51,51,0,0,"PCTE",0
39,"39030",1874,1199,1187,6,12,"PCTE",0
42,"42073",73,56,55,0,1,"PCTE",1
42,"42182",49,39,39,1,0,"PCTE",0
33,"33030",876,632,630,8,2,"PCTE",1
9,"9396",149,121,121,4,0,"PCTE",3
28,"28090",9252,7216,7153,58,63,"PCTE",4
24,"24212",983,693,684,10,9,"PCTE",0
22,"22047",248,202,201,1,1,"PCTE",1
18,"18030",566,382,380,2,2,"PCTE",0
50,"50252",5019,3486,3456,53,30,"PCTE",3
19,"19079",7,6,6,0,0,"PCTE",0
41,"41038",102752,71545,70538,980,1007,"PCTE",41
19,"19241",35,26,25,2,1,"PCTE",0
5,"5116",96,68,68,0,0,"PCTE",0
5,"5212",197,117,117,0,0,"PCTE",0
16,"16099",179,108,105,0,3,"PCTE",0
50,"50203",1065,817,804,5,13,"PCTE",0
40,"40188",83,63,60,0,3,"PCTE",0
37,"37311",201,157,156,1,1,"PCTE",0
16,"16139",317,226,222,1,4,"PCTE",0
28,"28124",73,51,50,0,1,"PCTE",0
49,"49202",173,103,101,0,2,"PCTE",0
47,"47124",383,302,300,3,2,"PCTE",0
45,"45076",574,361,357,1,4,"PCTE",0
50,"50179",255,197,197,0,0,"PCTE",0
49,"49165",55,52,52,1,0,"PCTE",0
37,"37259",39,28,28,1,0,"PCTE",0
5,"5051",157,117,115,1,2,"PCTE",1
37,"37185",539,372,363,2,9,"PCTE",0
45,"45015",656,449,438,2,11,"PCTE",0
37,"37019",138,111,109,0,2,"PCTE",0
40,"40220",64,46,45,0,1,"PCTE",0
19,"19116",12,10,10,0,0,"PCTE",0
19,"19271",41,22,21,1,1,"PCTE",0
40,"40126",67,44,42,0,2,"PCTE",0
47,"47060",224,171,168,1,3,"PCTE",0
50,"50102",815,594,584,7,10,"PCTE",0
16,"16274",97,76,75,1,1,"PCTE",0
47,"47061",237,185,184,0,1,"PCTE",0
49,"49056",285,191,190,3,1,"PCTE",0
22,"22080",263,188,184,3,4,"PCTE",0
9,"9251",362,258,256,3,2,"PCTE",1
21,"21047",1878,1144,1112,12,32,"PCTE",1
50,"50901",133,96,96,0,0,"PCTE",0
39,"39043",1517,1167,1154,3,13,"PCTE",0
37,"37065",276,167,167,2,0,"PCTE",0
9,"9292",72,55,55,3,0,"PCTE",1
47,"47126",42,35,35,1,0,"PCTE",0
42,"42144",419,302,298,6,4,"PCTE",1
47,"47093",795,585,573,7,12,"PCTE",2
19,"19184",59,47,47,0,0,"PCTE",0
33,"33006",1476,862,857,9,5,"PCTE",0
22,"22116",1342,915,905,11,10,"PCTE",0
34,"34023",5103,3585,3543,45,42,"PCTE",6
37,"37157",76,64,63,1,1,"PCTE",0
9,"9182",74,54,54,0,0,"PCTE",0
47,"47159",825,672,661,0,11,"PCTE",0
45,"45116",666,492,489,4,3,"PCTE",0
39,"39044",3921,2805,2783,18,22,"PCTE",4
40,"40223",235,177,174,1,3,"PCTE",0
45,"45153",1568,1168,1162,8,6,"PCTE",2
26,"26102",6076,4276,4205,52,71,"PCTE",4
47,"47002",18,18,18,0,0,"PCTE",0
37,"37315",89,65,64,0,1,"PCTE",0
24,"24105",1512,1054,1047,10,7,"PCTE",1
16,"16277",105,74,74,0,0,"PCTE",0
26,"26103",814,617,603,10,14,"PCTE",0
21,"21070",6294,4232,4124,64,108,"PCTE",0
23,"23033",1325,1008,989,11,19,"PCTE",1
24,"24106",218,139,139,1,0,"PCTE",0
18,"18903",852,544,537,9,7,"PCTE",0
21,"21040",3193,2219,2123,32,96,"PCTE",2
47,"47064",37,30,29,1,1,"PCTE",0
5,"5154",31,23,23,0,0,"PCTE",0
2,"2008",1103,737,722,8,15,"PCTE",0
45,"45154",1491,1033,1024,11,9,"PCTE",2
29,"29080",6940,4676,4617,36,59,"PCTE",2
22,"22199",6884,4438,4384,71,54,"PCTE",3
28,"28095",1719,1236,1226,5,10,"PCTE",0
50,"50030",197,124,124,1,0,"PCTE",0
37,"37263",339,215,210,0,5,"PCTE",0
45,"45167",1370,1078,1065,1,13,"PCTE",0
41,"41090",3489,2560,2467,27,93,"PCTE",0
28,"28172",9915,7715,7652,60,63,"PCTE",1
9,"9354",34,31,31,2,0,"PCTE",0
26,"26053",191,144,140,2,4,"PCTE",1
40,"40151",43,31,31,0,0,"PCTE",0
39,"39009",3325,2306,2293,7,13,"PCTE",1
40,"40173",140,120,118,2,2,"PCTE",0
40,"40204",145,102,101,0,1,"PCTE",0
47,"47130",94,64,63,0,1,"PCTE",0
22,"22122",69,52,50,2,2,"PCTE",0
29,"29035",1478,1054,1040,3,14,"PCTE",0
45,"45009",455,277,274,2,3,"PCTE",1
50,"50031",134,78,75,0,3,"PCTE",0
47,"47097",305,239,237,0,2,"PCTE",0
42,"42098",8,7,7,0,0,"PCTE",1
19,"19247",140,103,102,1,1,"PCTE",0
5,"5057",2418,1785,1748,9,37,"PCTE",1
26,"26145",239,194,187,3,7,"PCTE",0
47,"47162",70,57,57,2,0,"PCTE",0
37,"37285",360,271,270,0,1,"PCTE",0
40,"40163",42,35,35,1,0,"PCTE",1
41,"41073",1684,1100,1074,7,26,"PCTE",0
50,"50081",487,355,349,5,6,"PCTE",0
42,"42071",159,92,92,2,0,"PCTE",1
16,"16070",29,27,27,0,0,"PCTE",0
23,"23037",518,403,398,10,5,"PCTE",0
49,"49027",125,82,81,0,1,"PCTE",0
50,"50283",69,46,46,0,0,"PCTE",0
40,"40164",186,131,130,0,1,"PCTE",0
16,"16190",4930,3747,3688,26,59,"PCTE",1
22,"22022",542,405,403,2,2,"PCTE",1
19,"19018",142,112,112,1,0,"PCTE",0
19,"19157",53,37,37,0,0,"PCTE",0
50,"50209",2785,1893,1865,24,28,"PCTE",1
49,"49064",478,297,296,6,1,"PCTE",0
19,"19325",154,86,86,1,0,"PCTE",0
34,"34031",26,26,26,1,0,"PCTE",0
37,"37297",394,298,297,0,1,"PCTE",0
5,"5265",83,59,58,1,1,"PCTE",0
42,"42181",384,281,278,3,3,"PCTE",1
22,"22189",175,142,142,1,0,"PCTE",0
23,"23002",17427,12837,12542,126,295,"PCTE",21
9,"9306",94,69,69,1,0,"PCTE",0
47,"47099",154,123,118,0,5,"PCTE",0
16,"16240",98,71,69,0,2,"PCTE",0
14,"14022",3881,2888,2853,15,35,"PCTE",5
42,"42154",103,76,76,1,0,"PCTE",0
9,"9415",275,178,178,3,0,"PCTE",0
24,"24151",433,307,304,1,3,"PCTE",0
16,"16035",224,177,174,2,3,"PCTE",0
18,"18105",3827,2436,2392,22,44,"PCTE",1
29,"29038",18908,12122,11931,197,191,"PCTE",10
9,"9361",103,64,64,1,0,"PCTE",0
19,"19020",46,31,31,0,0,"PCTE",0
26,"26149",42,34,34,0,0,"PCTE",0
50,"50260",35,31,31,0,0,"PCTE",0
37,"37352",209,157,155,3,2,"PCTE",0
47,"47134",150,120,116,2,4,"PCTE",0
19,"19095",11,7,6,0,1,"PCTE",0
23,"23075",3222,2513,2475,19,38,"PCTE",2
16,"16112",1466,972,957,12,15,"PCTE",0
22,"22087",60,46,46,0,0,"PCTE",0
34,"34227",70,56,52,1,4,"PCTE",0
37,"37051",79,58,58,0,0,"PCTE",0
26,"26071",8644,5668,5591,53,77,"PCTE",12
28,"28167",8640,6564,6504,51,60,"PCTE",2
40,"40157",39,30,30,0,0,"PCTE",0
9,"9363",906,660,655,5,5,"PCTE",2
37,"37353",122,82,80,0,2,"PCTE",0
41,"41094",6496,4733,4628,47,105,"PCTE",3
40,"40037",30,17,17,0,0,"PCTE",0
41,"41049",9515,6961,6843,115,118,"PCTE",4
50,"50286",75,54,53,0,1,"PCTE",0
24,"24154",952,625,618,5,7,"PCTE",0
28,"28061",22757,17091,16965,115,126,"PCTE",10
34,"34176",127,95,90,3,5,"PCTE",0
5,"5062",163,121,119,3,2,"PCTE",0
50,"50164",381,245,243,3,2,"PCTE",0
41,"41077",8631,5788,5598,51,190,"PCTE",1
33,"33023",3249,2127,2097,30,30,"PCTE",2
16,"16176",29,20,20,0,0,"PCTE",0
23,"23042",292,219,219,0,0,"PCTE",0
19,"19193",22,21,21,1,0,"PCTE",0
26,"26100",54,43,43,0,0,"PCTE",0
45,"45151",544,413,409,0,4,"PCTE",0
34,"34004",5517,3819,3769,36,50,"PCTE",9
47,"47041",147,105,103,3,2,"PCTE",0
16,"16154",4739,3416,3379,33,37,"PCTE",1
24,"24116",387,227,226,3,1,"PCTE",0
24,"24044",150,91,89,2,2,"PCTE",0
19,"19319",4609,3303,3273,22,30,"PCTE",1
49,"49071",716,432,429,6,3,"PCTE",0
29,"29087",363,249,243,4,6,"PCTE",1
37,"37103",409,295,294,2,1,"PCTE",0
24,"24009",274,136,135,1,1,"PCTE",0
22,"22170",672,460,456,5,4,"PCTE",0
2,"2018",789,611,606,3,5,"PCTE",0
21,"21018",1719,1048,1029,12,19,"PCTE",1
19,"19255",74,37,37,0,0,"PCTE",0
40,"40202",56,33,33,0,0,"PCTE",0
19,"19059",73,47,47,0,0,"PCTE",0
26,"26153",10,10,10,1,0,"PCTE",0
39,"39082",1611,1108,1102,8,6,"PCTE",1
19,"19322",26,20,19,1,1,"PCTE",0
28,"28063",252,188,187,1,1,"PCTE",0
26,"26114",72,61,61,0,0,"PCTE",0
47,"47232",96,67,65,0,2,"PCTE",0
49,"49075",130,100,97,1,3,"PCTE",0
5,"5194",132,105,104,1,1,"PCTE",0
22,"22130",10146,6505,6436,57,69,"PCTE",1
26,"26075",315,234,229,1,5,"PCTE",0
37,"37293",102,68,68,1,0,"PCTE",0
24,"24191",106,70,69,2,1,"PCTE",0
50,"50903",2268,1685,1670,16,15,"PCTE",2
37,"37033",94,67,67,0,0,"PCTE",0
40,"40009",41,35,34,0,1,"PCTE",0
9,"9424",31,24,23,0,1,"PCTE",0
39,"39055",1065,747,736,4,11,"PCTE",0
2,"2053",2888,2086,2042,14,44,"PCTE",0
19,"19299",100,72,71,1,1,"PCTE",0
28,"28152",16986,13444,13366,111,78,"PCTE",11
49,"49112",118,72,72,2,0,"PCTE",0
26,"26170",423,303,301,2,2,"PCTE",0
47,"47044",323,273,270,4,3,"PCTE",0
39,"39046",1342,910,902,3,8,"PCTE",0
41,"41044",7753,5636,5547,55,89,"PCTE",5
47,"47014",48,39,39,1,0,"PCTE",0
9,"9391",347,247,246,2,1,"PCTE",0
23,"23046",2334,1880,1855,9,25,"PCTE",0
5,"5132",857,548,539,7,9,"PCTE",0
37,"37200",190,132,131,0,1,"PCTE",0
50,"50241",582,414,406,2,8,"PCTE",0
24,"24014",7152,4494,4448,47,46,"PCTE",5
24,"24025",283,190,185,3,5,"PCTE",0
24,"24012",278,182,180,0,2,"PCTE",0
16,"16158",513,371,366,5,5,"PCTE",0
39,"39066",866,616,606,6,10,"PCTE",0
50,"50266",120,77,76,3,1,"PCTE",0
40,"40174",319,229,227,3,2,"PCTE",0
42,"42117",129,98,95,1,3,"PCTE",0
16,"16199",27,18,18,0,0,"PCTE",0
26,"26042",795,578,572,8,6,"PCTE",1
9,"9375",42,35,35,0,0,"PCTE",0
26,"26006",1833,1358,1335,7,23,"PCTE",1
5,"5023",174,148,145,2,3,"PCTE",0
24,"24051",389,275,269,1,6,"PCTE",0
34,"34237",579,408,400,1,8,"PCTE",0
34,"34088",265,195,191,1,4,"PCTE",0
37,"37036",55,36,34,0,2,"PCTE",0
24,"24160",633,404,403,2,1,"PCTE",1
42,"42119",141,78,78,1,0,"PCTE",0
19,"19134",23,14,14,0,0,"PCTE",0
37,"37330",314,227,223,2,4,"PCTE",1
49,"49080",622,440,437,4,3,"PCTE",2
9,"9001",32,25,25,0,0,"PCTE",0
29,"29092",576,375,366,7,9,"PCTE",0
19,"19268",50,37,35,0,2,"PCTE",0
16,"16123",66,42,41,0,1,"PCTE",0
50,"50225",1532,983,971,12,12,"PCTE",0
49,"49273",165,90,90,0,0,"PCTE",0
22,"22089",274,195,193,2,2,"PCTE",0
37,"37173",1412,951,937,15,14,"PCTE",1
39,"39087",41241,29341,29084,152,257,"PCTE",51
26,"26135",152,115,114,0,1,"PCTE",0
50,"50178",269,165,163,6,2,"PCTE",0
41,"41056",3687,2836,2779,37,57,"PCTE",1
26,"26162",108,90,89,1,1,"PCTE",0
19,"19199",19,15,15,0,0,"PCTE",0
37,"37203",151,114,113,1,1,"PCTE",0
5,"5232",104,86,83,1,3,"PCTE",0
5,"5233",223,174,173,0,1,"PCTE",0
45,"45063",375,268,264,0,4,"PCTE",0
37,"37142",554,396,394,5,2,"PCTE",0
37,"37238",105,83,80,0,3,"PCTE",0
26,"26010",85,66,63,1,3,"PCTE",0
14,"14060",3715,2714,2641,41,73,"PCTE",2
49,"49008",423,263,259,1,4,"PCTE",0
41,"41085",4182,3258,3181,43,77,"PCTE",1
29,"29048",1364,1053,1039,8,14,"PCTE",1
45,"45186",2943,2142,2121,12,21,"PCTE",0
9,"9448",203,159,157,0,2,"PCTE",1
49,"49230",84,69,69,0,0,"PCTE",0
16,"16001",62,45,45,0,0,"PCTE",0
2,"2070",373,306,301,6,5,"PCTE",0
16,"16225",55,30,30,0,0,"PCTE",0
37,"37195",39,31,31,0,0,"PCTE",0
5,"5213",94,72,70,0,2,"PCTE",0
19,"19329",58,46,46,0,0,"PCTE",0
41,"41058",17956,12890,12553,200,337,"PCTE",4
40,"40016",55,44,43,1,1,"PCTE",0
49,"49043",256,191,189,1,2,"PCTE",1
22,"22250",346,241,241,0,0,"PCTE",0
45,"45138",1058,813,802,5,11,"PCTE",0
50,"50220",45,38,38,0,0,"PCTE",0
24,"24127",263,183,181,1,2,"PCTE",0
16,"16258",172,124,119,0,5,"PCTE",0
26,"26084",7264,5130,5059,61,71,"PCTE",13
9,"9384",292,199,193,3,6,"PCTE",2
2,"2074",5890,4054,4010,39,44,"PCTE",3
37,"37138",222,163,159,3,4,"PCTE",1
9,"9418",73,54,51,0,3,"PCTE",0
42,"42024",84,64,62,1,2,"PCTE",0
40,"40072",224,175,171,1,4,"PCTE",0
41,"41050",5173,3954,3878,36,76,"PCTE",0
5,"5052",85,70,69,0,1,"PCTE",0
28,"28051",1644,1231,1220,9,11,"PCTE",1
42,"42036",40,33,32,1,1,"PCTE",0
37,"37011",100,78,78,3,0,"PCTE",0
42,"42216",26,20,20,0,0,"PCTE",0
37,"37041",71,53,53,0,0,"PCTE",0
29,"29050",392,229,227,3,2,"PCTE",0
26,"26013",330,243,242,2,1,"PCTE",2
16,"16166",240,173,171,0,2,"PCTE",0
34,"34199",1150,767,754,14,13,"PCTE",3
22,"22009",581,387,386,7,1,"PCTE",0
9,"9220",69,52,52,3,0,"PCTE",0
5,"5903",137,84,83,0,1,"PCTE",0
41,"41088",515,368,358,2,10,"PCTE",0
19,"19003",36,30,30,0,0,"PCTE",0
41,"41032",3842,2800,2704,24,96,"PCTE",0
49,"49268",364,266,263,3,3,"PCTE",0
16,"16263",967,724,721,3,3,"PCTE",0
26,"26050",125,92,91,1,1,"PCTE",0
37,"37012",144,111,111,0,0,"PCTE",0
5,"5206",26,17,17,0,0,"PCTE",0
16,"16093",54,45,45,0,0,"PCTE",0
50,"50021",25,21,21,0,0,"PCTE",0
9,"9223",42,36,36,0,0,"PCTE",0
40,"40150",60,42,42,0,0,"PCTE",0
42,"42082",8,8,8,0,0,"PCTE",0
49,"49122",761,517,505,7,12,"PCTE",0
5,"5110",696,469,464,2,5,"PCTE",2
34,"34009",30,26,26,0,0,"PCTE",0
34,"34149",23,20,20,0,0,"PCTE",0
9,"9114",77,60,59,0,1,"PCTE",1
42,"42001",250,172,172,3,0,"PCTE",0
40,"40119",166,133,132,2,1,"PCTE",0
34,"34147",164,120,120,1,0,"PCTE",0
34,"34206",810,608,602,5,6,"PCTE",1
26,"26048",21,21,21,0,0,"PCTE",0
9,"9275",167,114,114,1,0,"PCTE",0
42,"42068",77,58,57,0,1,"PCTE",0
34,"34057",464,308,302,4,6,"PCTE",1
9,"9425",472,311,309,3,2,"PCTE",0
49,"49147",250,164,162,1,2,"PCTE",0
50,"50080",34,27,27,0,0,"PCTE",0
9,"9258",165,128,127,0,1,"PCTE",0
50,"50265",74,54,54,1,0,"PCTE",0
37,"37024",89,60,60,0,0,"PCTE",0
19,"19075",58,38,37,3,1,"PCTE",0
18,"18005",363,232,230,3,2,"PCTE",1
29,"29081",250,185,182,2,3,"PCTE",0
24,"24221",738,492,485,9,7,"PCTE",1
19,"19300",782,591,588,5,3,"PCTE",0
47,"47152",67,59,59,0,0,"PCTE",0
16,"16031",35,26,26,0,0,"PCTE",0
37,"37149",60,50,50,0,0,"PCTE",0
19,"19112",53,35,34,0,1,"PCTE",0
50,"50098",162,119,118,1,1,"PCTE",0
9,"9173",123,96,93,2,3,"PCTE",0
22,"22149",301,211,210,1,1,"PCTE",0
45,"45144",736,562,557,1,5,"PCTE",1
37,"37255",43,33,31,1,2,"PCTE",0
9,"9428",102,73,73,1,0,"PCTE",0
14,"14049",16185,11561,11323,145,238,"PCTE",5
26,"26055",39,30,30,0,0,"PCTE",0
22,"22076",285,207,203,4,4,"PCTE",0
5,"5080",42,30,30,0,0,"PCTE",0
49,"49091",246,168,167,1,1,"PCTE",1
45,"45183",2378,1555,1525,16,30,"PCTE",0
9,"9175",120,78,76,1,2,"PCTE",0
42,"42044",53,37,35,1,2,"PCTE",0
2,"2001",687,513,505,1,8,"PCTE",0
16,"16173",175,128,127,0,1,"PCTE",1
28,"28902",521,394,389,3,5,"PCTE",0
37,"37224",189,156,153,2,3,"PCTE",0
49,"49052",183,120,117,2,3,"PCTE",0
22,"22066",755,529,520,8,9,"PCTE",0
9,"9072",331,261,260,4,1,"PCTE",1
50,"50014",119,81,81,0,0,"PCTE",0
19,"19252",56,44,44,0,0,"PCTE",0
37,"37322",2462,1580,1537,14,43,"PCTE",3
5,"5048",107,89,88,2,1,"PCTE",0
50,"50152",1351,942,932,14,10,"PCTE",0
50,"50008",5187,3334,3288,37,46,"PCTE",1
16,"16150",98,66,66,2,0,"PCTE",0
42,"42183",102,74,74,1,0,"PCTE",0
33,"33003",603,322,317,7,5,"PCTE",0
18,"18159",989,765,762,2,3,"PCTE",1
22,"22024",220,159,158,1,1,"PCTE",4
5,"5211",425,336,330,2,6,"PCTE",0
26,"26174",134,100,99,3,1,"PCTE",0
34,"34157",2353,1697,1669,18,28,"PCTE",1
49,"49127",2402,1640,1604,18,36,"PCTE",0
23,"23099",4824,3523,3435,35,88,"PCTE",3
50,"50202",124,76,74,0,2,"PCTE",0
34,"34211",171,154,153,2,1,"PCTE",0
50,"50101",833,557,550,5,7,"PCTE",0
37,"37342",250,190,189,3,1,"PCTE",0
29,"29001",4207,3002,2959,40,43,"PCTE",1
22,"22088",143,98,97,1,1,"PCTE",0
29,"29904",418,328,322,1,6,"PCTE",0
16,"16073",190,153,153,1,0,"PCTE",0
45,"45089",1432,1076,1064,10,12,"PCTE",0
22,"22155",66,52,52,0,0,"PCTE",0
42,"42061",270,188,186,5,2,"PCTE",0
37,"37155",68,48,48,0,0,"PCTE",0
42,"42090",83,65,64,1,1,"PCTE",0
23,"23901",1125,905,895,3,10,"PCTE",0
19,"19010",9,9,9,0,0,"PCTE",0
42,"42141",101,59,59,0,0,"PCTE",0
9,"9071",39,29,29,1,0,"PCTE",0
45,"45003",554,398,393,2,5,"PCTE",0
18,"18064",366,289,286,0,3,"PCTE",0
19,"19117",1632,1187,1167,12,20,"PCTE",1
45,"45114",549,400,394,1,6,"PCTE",0
29,"29061",1043,803,773,9,30,"PCTE",0
40,"40216",785,633,621,9,12,"PCTE",1
22,"22109",261,184,183,1,1,"PCTE",1
37,"37069",981,669,657,3,12,"PCTE",1
34,"34126",248,177,176,3,1,"PCTE",0
41,"41095",40187,27090,26680,512,410,"PCTE",8
37,"37290",130,106,106,0,0,"PCTE",0
16,"16153",924,751,741,4,10,"PCTE",0
19,"19272",66,55,55,2,0,"PCTE",0
18,"18097",947,633,631,0,2,"PCTE",1
49,"49058",301,222,221,1,1,"PCTE",0
5,"5119",24,17,17,1,0,"PCTE",0
37,"37090",68,47,47,0,0,"PCTE",0
5,"5215",156,120,113,0,7,"PCTE",0
2,"2072",1528,981,958,7,23,"PCTE",0
42,"42094",596,448,436,9,12,"PCTE",1
49,"49098",200,139,138,3,1,"PCTE",0
9,"9454",41,34,33,1,1,"PCTE",0
37,"37055",117,97,93,0,4,"PCTE",0
9,"9074",844,610,609,12,1,"PCTE",0
42,"42052",16,14,14,0,0,"PCTE",0
49,"49205",359,252,251,7,1,"PCTE",0
29,"29077",207,135,134,1,1,"PCTE",0
37,"37314",81,65,65,0,0,"PCTE",0
50,"50189",678,494,487,6,7,"PCTE",0
50,"50206",457,349,345,5,4,"PCTE",0
24,"24178",60,54,54,1,0,"PCTE",0
49,"49245",251,174,171,1,3,"PCTE",0
19,"19015",82,74,73,1,1,"PCTE",0
23,"23067",2405,1765,1724,14,41,"PCTE",8
19,"19307",25,23,23,0,0,"PCTE",0
19,"19245",1138,798,778,6,20,"PCTE",1
23,"23905",1828,1320,1302,12,18,"PCTE",2
9,"9409",117,80,80,0,0,"PCTE",0
9,"9184",6,6,6,0,0,"PCTE",0
24,"24070",3886,2677,2625,18,52,"PCTE",2
34,"34070",131,98,96,0,2,"PCTE",0
19,"19217",43,36,36,0,0,"PCTE",0
49,"49099",96,67,67,0,0,"PCTE",0
37,"37023",1624,1233,1211,15,22,"PCTE",0
18,"18093",2751,1693,1674,18,19,"PCTE",1
40,"40071",39,32,26,0,6,"PCTE",0
33,"33061",344,174,174,1,0,"PCTE",1
2,"2026",834,644,633,4,11,"PCTE",0
28,"28182",203,167,163,1,4,"PCTE",0
19,"19227",68,42,41,1,1,"PCTE",0
50,"50199",318,206,201,1,5,"PCTE",1
37,"37179",197,167,165,0,2,"PCTE",1
45,"45094",365,274,271,3,3,"PCTE",0
45,"45045",1338,926,915,9,11,"PCTE",0
22,"22001",212,147,146,0,1,"PCTE",0
29,"29043",2463,1508,1460,20,48,"PCTE",0
22,"22162",125,94,94,0,0,"PCTE",0
2,"2046",1125,892,870,12,22,"PCTE",0
16,"16157",183,150,148,0,2,"PCTE",6
5,"5263",162,117,115,1,2,"PCTE",0
37,"37191",102,57,57,1,0,"PCTE",0
49,"49063",303,228,227,3,1,"PCTE",0
9,"9443",151,113,112,0,1,"PCTE",1
34,"34029",665,524,518,1,6,"PCTE",0
42,"42056",28,25,24,0,1,"PCTE",0
40,"40131",51,45,45,0,0,"PCTE",0
9,"9460",162,141,140,0,1,"PCTE",0
2,"2043",1165,872,858,6,14,"PCTE",0
37,"37379",169,133,132,0,1,"PCTE",0
39,"39076",3512,2517,2491,13,26,"PCTE",2
39,"39020",23993,15944,15792,89,152,"PCTE",19
9,"9262",160,122,120,2,2,"PCTE",0
47,"47098",567,452,446,4,6,"PCTE",1
16,"16109",41,30,30,0,0,"PCTE",0
9,"9356",43,31,30,0,1,"PCTE",0
28,"28099",1950,1409,1404,16,5,"PCTE",1
39,"39048",1772,1311,1295,8,16,"PCTE",1
9,"9136",169,129,125,2,4,"PCTE",1
34,"34169",371,263,259,5,4,"PCTE",1
29,"29082",34683,24751,24495,263,256,"PCTE",7
24,"24223",2533,1727,1705,40,22,"PCTE",4
2,"2012",1835,1462,1420,9,42,"PCTE",2
29,"29046",2494,1727,1693,13,34,"PCTE",2
24,"24016",488,244,243,0,1,"PCTE",0
47,"47071",396,321,316,5,5,"PCTE",1
34,"34084",158,125,125,1,0,"PCTE",0
16,"16017",336,276,270,1,6,"PCTE",0
50,"50281",68,52,50,0,2,"PCTE",0
21,"21056",2914,2148,2046,29,102,"PCTE",0
19,"19091",23,17,17,0,0,"PCTE",0
5,"5254",184,149,147,1,2,"PCTE",0
21,"21064",6674,4503,4426,68,77,"PCTE",0
5,"5147",144,101,99,0,2,"PCTE",1
23,"23073",4363,3214,3176,24,38,"PCTE",6
9,"9036",31,24,24,4,0,"PCTE",0
37,"37194",229,161,160,0,1,"PCTE",1
9,"9323",57,37,36,0,1,"PCTE",0
40,"40234",375,278,269,3,9,"PCTE",0
9,"9084",165,116,111,1,5,"PCTE",2
19,"19282",138,107,106,0,1,"PCTE",0
42,"42059",20,14,14,0,0,"PCTE",0
22,"22057",364,253,248,4,5,"PCTE",0
42,"42155",146,83,80,2,3,"PCTE",0
9,"9037",105,94,93,0,1,"PCTE",0
9,"9162",130,102,100,1,2,"PCTE",0
45,"45088",2366,1526,1501,8,25,"PCTE",0
5,"5190",53,44,43,0,1,"PCTE",0
37,"37174",975,716,705,2,11,"PCTE",1
19,"19304",224,169,166,3,3,"PCTE",0
50,"50297",503800,365284,362768,3385,2516,"PCTE",305
19,"19125",45,23,23,0,0,"PCTE",1
40,"40125",76,48,46,0,2,"PCTE",0
37,"37123",159,124,123,2,1,"PCTE",0
42,"42022",206,147,146,6,1,"PCTE",0
41,"41039",31538,22078,21717,278,361,"PCTE",29
45,"45125",2256,1711,1689,16,22,"PCTE",0
9,"9309",293,198,193,5,5,"PCTE",0
47,"47197",875,659,656,9,3,"PCTE",0
9,"9140",117,78,77,1,1,"PCTE",0
50,"50084",67,47,47,1,0,"PCTE",0
37,"37030",82,60,60,0,0,"PCTE",0
50,"50085",182,121,121,0,0,"PCTE",1
16,"16074",30,25,25,0,0,"PCTE",0
49,"49177",255,145,144,1,1,"PCTE",0
41,"41080",1231,832,815,14,17,"PCTE",1
45,"45145",2631,1746,1707,12,39,"PCTE",1
41,"41086",16199,10227,10105,137,122,"PCTE",11
26,"26072",287,239,235,3,4,"PCTE",0
18,"18185",545,434,424,5,10,"PCTE",0
16,"16078",41384,28809,28500,322,309,"PCTE",15
21,"21077",1739,1266,1235,13,31,"PCTE",0
19,"19001",43,32,32,0,0,"PCTE",0
5,"5162",76,47,45,1,2,"PCTE",0
37,"37166",196,134,133,1,1,"PCTE",0
9,"9128",76,56,56,0,0,"PCTE",0
9,"9199",91,68,68,0,0,"PCTE",0
45,"45164",166,143,142,1,1,"PCTE",0
23,"23027",711,547,539,5,8,"PCTE",1
45,"45054",3798,2612,2587,10,25,"PCTE",1
5,"5063",31,26,26,0,0,"PCTE",0
39,"39007",386,265,264,0,1,"PCTE",0
37,"37271",349,262,258,2,4,"PCTE",0
26,"26038",76,52,52,0,0,"PCTE",0
50,"50263",171,110,108,1,2,"PCTE",0
47,"47168",30,26,26,1,0,"PCTE",0
9,"9201",27,17,17,0,0,"PCTE",0
24,"24117",410,302,301,1,1,"PCTE",0
37,"37356",84,58,58,0,0,"PCTE",0
41,"41004",57692,38578,37814,696,764,"PCTE",26
16,"16196",589,490,476,3,14,"PCTE",0
24,"24230",403,268,265,3,3,"PCTE",0
47,"47169",62,52,52,0,0,"PCTE",0
24,"24156",220,135,133,0,2,"PCTE",1
45,"45165",62598,43750,43259,329,491,"PCTE",26
19,"19225",851,618,611,2,7,"PCTE",0
5,"5130",94,77,77,1,0,"PCTE",0
2,"2019",2352,1806,1766,9,40,"PCTE",1
16,"16909",655,493,488,4,5,"PCTE",1
49,"49076",330,230,226,9,4,"PCTE",1
14,"14028",302,241,240,3,1,"PCTE",0
50,"50139",318,237,237,1,0,"PCTE",0
24,"24193",363,264,264,1,0,"PCTE",1
14,"14027",7890,5841,5726,78,115,"PCTE",4
21,"21063",2611,1948,1891,23,57,"PCTE",2
26,"26124",768,603,590,4,13,"PCTE",0
22,"22143",190,118,115,1,3,"PCTE",0
49,"49246",214,183,180,3,3,"PCTE",0
5,"5084",66,44,44,0,0,"PCTE",0
40,"40140",76,54,54,0,0,"PCTE",0
18,"18025",277,198,197,0,1,"PCTE",0
5,"5165",361,266,261,4,5,"PCTE",0
26,"26077",16,16,16,0,0,"PCTE",0
22,"22095",66,52,51,1,1,"PCTE",0
49,"49224",166,102,100,0,2,"PCTE",0
24,"24901",853,517,513,4,4,"PCTE",0
40,"40111",50,39,39,0,0,"PCTE",0
19,"19202",16,13,13,1,0,"PCTE",0
47,"47112",2561,1960,1933,13,27,"PCTE",1
49,"49170",99,68,68,1,0,"PCTE",0
24,"24107",206,147,147,1,0,"PCTE",0
50,"50208",1761,1267,1250,16,17,"PCTE",1
16,"16216",272,207,204,0,3,"PCTE",0
5,"5022",1580,1202,1193,6,9,"PCTE",3
50,"50200",479,389,383,5,6,"PCTE",0
45,"45168",62836,46917,46353,424,564,"PCTE",30
40,"40142",52,39,37,0,2,"PCTE",0
14,"14001",3423,2563,2515,11,48,"PCTE",3
5,"5176",221,163,159,0,4,"PCTE",0
18,"18178",664,474,467,1,7,"PCTE",0
16,"16121",227,160,152,0,8,"PCTE",0
45,"45084",2103,1533,1508,7,25,"PCTE",0
18,"18135",4385,2882,2798,24,84,"PCTE",4
37,"37108",98,75,75,3,0,"PCTE",0
49,"49261",1504,1044,1026,7,18,"PCTE",3
26,"26079",633,503,499,2,4,"PCTE",0
22,"22212",69,52,52,1,0,"PCTE",0
42,"42208",20,12,12,1,0,"PCTE",0
37,"37071",76,64,62,1,2,"PCTE",0
34,"34236",147,104,104,0,0,"PCTE",0
22,"22003",135,107,107,0,0,"PCTE",0
26,"26043",346,243,235,2,8,"PCTE",1
19,"19104",19,15,14,0,1,"PCTE",0
45,"45036",638,455,449,1,6,"PCTE",0
41,"41902",4599,2906,2868,50,38,"PCTE",5
19,"19175",29,18,17,1,1,"PCTE",0
9,"9019",146,105,103,4,2,"PCTE",0
49,"49096",155,113,112,2,1,"PCTE",0
5,"5100",260,193,192,3,1,"PCTE",1
5,"5214",28,18,18,0,0,"PCTE",0
50,"50043",241,155,154,1,1,"PCTE",0
9,"9198",100,75,74,2,1,"PCTE",0
49,"49065",1048,747,725,6,22,"PCTE",1
24,"24110",1158,784,773,1,11,"PCTE",0
24,"24173",896,590,583,2,7,"PCTE",2
47,"47206",79,66,66,0,0,"PCTE",0
22,"22018",303,216,215,3,1,"PCTE",1
9,"9067",399,232,230,3,2,"PCTE",0
42,"42050",27,17,17,0,0,"PCTE",0
37,"37183",377,267,267,5,0,"PCTE",0
2,"2069",11401,8055,7975,30,80,"PCTE",4
33,"33078",127,81,81,0,0,"PCTE",0
21,"21024",464,328,312,1,16,"PCTE",1
45,"45025",1218,849,844,9,5,"PCTE",0
34,"34241",17,17,16,3,1,"PCTE",0
42,"42184",55,36,33,0,3,"PCTE",0
50,"50219",4283,3034,2990,30,44,"PCTE",3
50,"50195",53,42,38,0,4,"PCTE",0
24,"24101",370,219,213,4,6,"PCTE",1
21,"21015",645,361,356,8,5,"PCTE",1
39,"39069",1934,1475,1458,2,17,"PCTE",2
49,"49105",135,94,94,2,0,"PCTE",0
47,"47009",98,84,84,0,0,"PCTE",0
18,"18907",1762,1358,1351,4,7,"PCTE",0
47,"47229",221,150,149,0,1,"PCTE",0
40,"40026",112,101,99,0,2,"PCTE",0
50,"50154",114,92,92,1,0,"PCTE",0
19,"19138",215,158,154,4,4,"PCTE",0
47,"47209",32,23,23,0,0,"PCTE",0
24,"24055",674,484,482,8,2,"PCTE",1
42,"42124",56,27,27,0,0,"PCTE",0
42,"42215",723,468,452,10,16,"PCTE",0
37,"37040",376,291,288,0,3,"PCTE",0
24,"24095",317,228,228,3,0,"PCTE",2
49,"49238",273,205,200,4,5,"PCTE",0
39,"39014",882,538,536,0,2,"PCTE",0
47,"47003",206,167,166,5,1,"PCTE",0
9,"9269",29,24,23,0,1,"PCTE",0
24,"24118",101,72,72,0,0,"PCTE",0
41,"41062",2151,1619,1589,12,30,"PCTE",0
14,"14056",23477,15826,15470,177,356,"PCTE",6
37,"37274",118296,84144,83280,880,864,"PCTE",88
50,"50171",99,69,69,2,0,"PCTE",0
40,"40168",27,20,20,0,0,"PCTE",0
5,"5225",355,276,273,6,3,"PCTE",0
49,"49181",333,197,195,2,2,"PCTE",0
22,"22157",181,122,121,2,1,"PCTE",0
50,"50143",541,373,367,2,6,"PCTE",1
16,"16259",28,22,22,0,0,"PCTE",0
9,"9012",93,70,68,0,2,"PCTE",0
29,"29003",916,677,666,4,11,"PCTE",2
24,"24068",430,289,281,0,8,"PCTE",0
34,"34246",68,52,52,0,0,"PCTE",0
26,"26087",180,123,123,3,0,"PCTE",0
37,"37177",259,198,197,3,1,"PCTE",0
37,"37080",221,164,163,1,1,"PCTE",0
28,"28012",929,707,698,7,9,"PCTE",0
14,"14064",296,211,208,6,3,"PCTE",0
2,"2007",1017,757,746,5,11,"PCTE",1
16,"16040",91,76,76,2,0,"PCTE",0
24,"24229",376,275,269,2,6,"PCTE",0
16,"16167",288,225,217,0,8,"PCTE",0
50,"50020",795,548,545,4,3,"PCTE",0
2,"2062",382,261,256,2,5,"PCTE",0
23,"23093",3119,2264,2216,24,48,"PCTE",3
16,"16016",217,157,157,1,0,"PCTE",0
42,"42175",22,16,16,0,0,"PCTE",0
9,"9274",1035,774,762,8,12,"PCTE",1
34,"34901",1053,762,759,10,3,"PCTE",0
37,"37336",56,45,43,2,2,"PCTE",1
50,"50122",68,43,42,1,1,"PCTE",0
50,"50198",47,32,32,0,0,"PCTE",0
9,"9014",182,101,101,0,0,"PCTE",0
16,"16033",1633,1199,1174,8,25,"PCTE",0
49,"49095",282,202,201,6,1,"PCTE",1
45,"45118",2124,1403,1380,8,23,"PCTE",0
39,"39052",19005,13859,13748,83,111,"PCTE",5
34,"34039",58,48,47,0,1,"PCTE",1
34,"34036",230,159,158,0,1,"PCTE",0
26,"26151",412,317,317,4,0,"PCTE",0
19,"19201",60,44,44,0,0,"PCTE",0
50,"50019",63,46,46,0,0,"PCTE",0
47,"47118",147,97,97,2,0,"PCTE",0
14,"14037",3161,2233,2158,22,75,"PCTE",2
5,"5066",435,344,341,2,3,"PCTE",0
50,"50251",8209,5732,5658,66,74,"PCTE",6
24,"24224",564,381,375,5,6,"PCTE",0
42,"42012",29,22,22,0,0,"PCTE",0
37,"37257",51,36,36,1,0,"PCTE",0
22,"22126",89,64,64,0,0,"PCTE",0
24,"24089",101036,71905,71305,744,600,"PCTE",81
29,"29034",461,333,332,2,1,"PCTE",0
47,"47224",93,75,75,1,0,"PCTE",0
18,"18122",15994,11009,10773,109,236,"PCTE",5
28,"28163",429,332,326,0,6,"PCTE",0
22,"22111",143,96,95,2,1,"PCTE",0
16,"16133",4399,3317,3256,34,61,"PCTE",4
40,"40184",245,196,194,0,2,"PCTE",0
47,"47035",901,659,653,4,6,"PCTE",0
9,"9191",33,23,23,1,0,"PCTE",0
26,"26105",2188,1564,1536,24,28,"PCTE",1
18,"18079",3466,2391,2333,22,58,"PCTE",1
16,"16280",163,122,119,2,3,"PCTE",0
22,"22085",94,78,76,0,2,"PCTE",0
19,"19239",93,70,70,1,0,"PCTE",0
42,"42132",140,102,101,2,1,"PCTE",0
5,"5210",81,56,56,0,0,"PCTE",0
2,"2033",1864,1352,1315,12,37,"PCTE",1
19,"19210",18,16,16,0,0,"PCTE",0
22,"22901",714,433,423,6,10,"PCTE",0
28,"28158",694,501,495,2,6,"PCTE",0
18,"18066",2095,1401,1378,12,23,"PCTE",1
19,"19113",454,327,322,4,5,"PCTE",0
49,"49035",220,180,180,4,0,"PCTE",0
37,"37196",70,50,50,0,0,"PCTE",0
37,"37013",104,72,70,2,2,"PCTE",0
40,"40902",113,78,76,1,2,"PCTE",0
18,"18016",297,200,198,3,2,"PCTE",0
41,"41006",2733,1776,1742,17,34,"PCTE",1
22,"22173",219,147,141,3,6,"PCTE",1
21,"21050",12567,8522,8392,89,130,"PCTE",3
37,"37382",162,127,124,0,3,"PCTE",1
50,"50024",543,400,397,3,3,"PCTE",0
45,"45057",224,177,173,0,4,"PCTE",0
49,"49239",599,393,384,6,9,"PCTE",0
5,"5041",984,743,732,5,11,"PCTE",2
37,"37218",51,25,23,0,2,"PCTE",0
24,"24103",274,134,134,0,0,"PCTE",0
26,"26057",50,45,45,2,0,"PCTE",0
16,"16903",992,750,732,8,18,"PCTE",0
9,"9283",39,25,24,1,1,"PCTE",0
24,"24005",342,218,217,0,1,"PCTE",0
29,"29093",2150,1543,1520,8,23,"PCTE",0
42,"42212",57,45,45,2,0,"PCTE",0
9,"9287",191,144,143,2,1,"PCTE",0
45,"45014",4039,2606,2552,35,54,"PCTE",5
49,"49201",283,232,228,3,4,"PCTE",0
5,"5257",132,98,95,4,3,"PCTE",1
41,"41020",13012,8148,7999,135,149,"PCTE",2
26,"26176",56,43,43,0,0,"PCTE",0
26,"26022",177,130,128,0,2,"PCTE",0
2,"2047",110,83,81,0,2,"PCTE",0
50,"50228",249,207,207,3,0,"PCTE",0
16,"16152",32,26,26,3,0,"PCTE",0
18,"18106",413,270,261,3,9,"PCTE",0
16,"16024",121,85,84,0,1,"PCTE",0
34,"34109",60,34,34,0,0,"PCTE",0
47,"47125",49,42,42,0,0,"PCTE",0
24,"24066",439,274,273,3,1,"PCTE",1
16,"16236",857,615,608,1,7,"PCTE",0
45,"45097",1037,834,819,7,15,"PCTE",0
26,"26111",250,191,187,3,4,"PCTE",0
50,"50196",101,73,73,0,0,"PCTE",0
45,"45019",7560,5216,5135,50,81,"PCTE",5
5,"5016",6355,4677,4584,28,93,"PCTE",2
5,"5235",141,97,97,2,0,"PCTE",0
50,"50093",87,66,64,1,2,"PCTE",0
37,"37304",156,97,96,1,1,"PCTE",0
9,"9373",399,254,251,5,3,"PCTE",0
45,"45142",7792,5717,5624,62,93,"PCTE",4
37,"37233",53,39,39,1,0,"PCTE",0
22,"22252",118,95,91,1,4,"PCTE",0
42,"42065",23,18,18,1,0,"PCTE",0
19,"19270",14,13,13,0,0,"PCTE",0
5,"5242",679,571,562,9,9,"PCTE",0
50,"50194",80,51,51,0,0,"PCTE",0
22,"22037",112,87,87,2,0,"PCTE",0
5,"5140",99,83,81,0,2,"PCTE",0
29,"29096",2757,1847,1790,19,57,"PCTE",2
24,"24032",99,70,66,1,4,"PCTE",0
2,"2039",945,745,734,8,11,"PCTE",0
16,"16027",691,500,495,1,5,"PCTE",0
5,"5153",86,58,56,3,2,"PCTE",0
9,"9407",25,19,17,0,2,"PCTE",0
24,"24217",135,93,93,0,0,"PCTE",2
22,"22129",162,110,110,0,0,"PCTE",1
19,"19277",15,10,10,0,0,"PCTE",0
18,"18143",945,661,651,2,10,"PCTE",3
37,"37022",242,191,190,0,1,"PCTE",0
37,"37219",169,88,85,1,3,"PCTE",0
42,"42190",94,61,61,1,0,"PCTE",0
5,"5216",209,149,149,0,0,"PCTE",0
18,"18004",669,467,466,6,1,"PCTE",0
34,"34024",25,14,14,0,0,"PCTE",0
34,"34218",437,313,309,3,4,"PCTE",0
28,"28161",52164,38607,38193,306,414,"PCTE",36
42,"42015",30,20,20,0,0,"PCTE",0
2,"2041",316,238,236,0,2,"PCTE",0
39,"39045",352,238,234,0,4,"PCTE",0
26,"26067",22,18,18,3,0,"PCTE",0
47,"47135",82,65,65,3,0,"PCTE",0
19,"19287",134,100,98,2,2,"PCTE",0
40,"40224",18,15,15,0,0,"PCTE",0
37,"37301",84,64,64,1,0,"PCTE",0
22,"22043",93,53,53,0,0,"PCTE",0
18,"18109",597,430,422,5,8,"PCTE",0
5,"5021",1861,1323,1304,22,19,"PCTE",2
50,"50172",174,125,123,2,2,"PCTE",0
9,"9206",52,43,43,0,0,"PCTE",0
45,"45106",7418,5380,5306,34,74,"PCTE",4
2,"2031",535,406,401,4,5,"PCTE",0
40,"40043",1773,1376,1345,21,31,"PCTE",1
40,"40128",123,88,87,1,1,"PCTE",0
41,"41070",6451,4715,4632,70,83,"PCTE",1
37,"37020",431,320,314,3,6,"PCTE",0
50,"50003",117,89,89,1,0,"PCTE",0
28,"28137",1770,1300,1289,6,11,"PCTE",0
9,"9366",76,55,55,2,0,"PCTE",0
16,"16191",850,664,653,11,11,"PCTE",0
34,"34137",24,19,19,2,0,"PCTE",0
5,"5218",104,81,79,0,2,"PCTE",0
18,"18904",741,500,498,1,2,"PCTE",0
24,"24002",224,165,162,1,3,"PCTE",0
19,"19219",9,8,7,0,1,"PCTE",0
9,"9079",47,38,38,0,0,"PCTE",0
22,"22096",332,248,241,10,7,"PCTE",0
19,"19076",29,23,23,0,0,"PCTE",0
24,"24133",357,256,256,1,0,"PCTE",0
42,"42042",53,42,41,1,1,"PCTE",0
41,"41017",15907,11486,11302,158,184,"PCTE",10
14,"14048",1199,883,866,4,17,"PCTE",1
39,"39057",2366,1636,1607,10,29,"PCTE",0
37,"37329",38,29,28,1,1,"PCTE",0
24,"24149",149,123,123,0,0,"PCTE",0
2,"2011",556,429,427,1,2,"PCTE",0
5,"5024",193,127,125,2,2,"PCTE",0
16,"16901",624,443,438,5,5,"PCTE",0
14,"14902",1113,877,851,15,26,"PCTE",2
45,"45049",419,303,295,1,8,"PCTE",0
49,"49255",387,304,298,3,6,"PCTE",0
40,"40041",966,729,716,8,13,"PCTE",0
42,"42086",33,19,19,1,0,"PCTE",0
47,"47132",39,32,32,1,0,"PCTE",0
5,"5142",88,76,75,0,1,"PCTE",0
34,"34242",91,65,62,2,3,"PCTE",0
49,"49068",422,263,261,4,2,"PCTE",1
39,"39098",1381,1088,1080,5,8,"PCTE",0
50,"50071",126,84,84,0,0,"PCTE",0
5,"5138",283,218,217,1,1,"PCTE",0
5,"5087",147,108,107,3,1,"PCTE",0
34,"34180",68,54,54,1,0,"PCTE",0
9,"9169",97,72,70,1,2,"PCTE",1
26,"26115",23,22,21,3,1,"PCTE",0
9,"9197",144,105,103,2,2,"PCTE",0
29,"29037",215,156,153,1,3,"PCTE",0
47,"47217",1984,1460,1437,11,23,"PCTE",1
19,"19260",38,27,27,1,0,"PCTE",0
24,"24177",467,265,263,2,2,"PCTE",0
29,"29076",2354,1498,1444,21,54,"PCTE",3
45,"45115",2602,2013,1969,12,44,"PCTE",2
49,"49264",529,334,329,2,5,"PCTE",0
47,"47069",115,87,87,0,0,"PCTE",0
26,"26058",149,114,114,2,0,"PCTE",1
26,"26034",606,457,440,5,17,"PCTE",3
24,"24090",323,200,200,2,0,"PCTE",1
28,"28059",4516,3343,3299,30,44,"PCTE",2
42,"42009",77,58,58,0,0,"PCTE",1
45,"45038",3528,2556,2521,26,35,"PCTE",4
50,"50083",81,64,64,2,0,"PCTE",0
34,"34034",112,82,82,1,0,"PCTE",0
40,"40901",413,320,315,7,5,"PCTE",0
5,"5061",257,193,189,1,4,"PCTE",0
26,"26098",92,63,63,1,0,"PCTE",0
37,"37249",37,28,28,0,0,"PCTE",1
50,"50163",3846,2863,2840,25,23,"PCTE",2
39,"39051",73,64,64,1,0,"PCTE",0
40,"40036",496,395,380,8,15,"PCTE",0
24,"24187",834,559,549,11,10,"PCTE",1
5,"5207",645,485,478,4,7,"PCTE",0
5,"5231",150,123,122,2,1,"PCTE",0
26,"26165",336,248,242,3,6,"PCTE",1
19,"19081",27,21,21,0,0,"PCTE",0
28,"28092",153631,112460,111341,913,1119,"PCTE",80
29,"29069",87188,54019,53240,633,779,"PCTE",20
40,"40161",32,24,23,1,1,"PCTE",0
5,"5121",263,194,189,1,5,"PCTE",0
9,"9218",350,254,252,5,2,"PCTE",0
16,"16029",104,76,74,0,2,"PCTE",0
29,"29021",155,111,109,1,2,"PCTE",0
45,"45166",1575,1231,1210,5,21,"PCTE",1
45,"45031",2861,1894,1858,13,36,"PCTE",3
26,"26099",1220,956,931,7,25,"PCTE",1
45,"45081",19268,13690,13516,104,174,"PCTE",14
37,"37027",239,182,179,2,3,"PCTE",0
50,"50100",304,215,212,1,3,"PCTE",1
39,"39049",304,198,195,2,3,"PCTE",0
19,"19211",350,272,269,0,3,"PCTE",0
37,"37115",108,67,65,0,2,"PCTE",0
37,"37323",474,335,325,5,10,"PCTE",0
40,"40212",26,19,19,1,0,"PCTE",0
18,"18183",623,380,376,0,4,"PCTE",0
23,"23079",3624,2661,2630,19,31,"PCTE",0
19,"19165",45,39,39,0,0,"PCTE",0
9,"9312",89,68,68,1,0,"PCTE",0
37,"37104",24,16,16,0,0,"PCTE",0
37,"37146",106,82,76,0,6,"PCTE",0
5,"5163",1702,1258,1233,5,25,"PCTE",1
37,"37068",337,240,236,1,4,"PCTE",0
45,"45092",223,193,190,1,3,"PCTE",0
9,"9094",53,42,42,0,0,"PCTE",0
5,"5186",1564,1140,1125,5,15,"PCTE",0
50,"50902",77,65,62,0,3,"PCTE",0
40,"40139",255,194,192,2,2,"PCTE",1
9,"9314",90,75,75,2,0,"PCTE",0
5,"5164",18,12,12,0,0,"PCTE",0
49,"49146",265,183,181,4,2,"PCTE",1
16,"16005",234,163,160,1,3,"PCTE",0
22,"22029",118,85,83,1,2,"PCTE",0
37,"37202",1004,773,763,12,10,"PCTE",2
22,"22249",125,93,92,1,1,"PCTE",1
14,"14008",2758,1880,1836,21,44,"PCTE",0
9,"9239",47,31,31,0,0,"PCTE",0
45,"45129",98,77,77,1,0,"PCTE",0
19,"19046",22204,16001,15752,156,249,"PCTE",18
50,"50027",223,166,161,2,5,"PCTE",0
5,"5074",668,540,537,5,3,"PCTE",0
9,"9046",23,17,17,0,0,"PCTE",0
9,"9217",342,240,237,1,3,"PCTE",0
14,"14046",4442,3283,3190,34,93,"PCTE",1
42,"42053",21,17,17,0,0,"PCTE",0
26,"26142",789,572,564,6,8,"PCTE",2
34,"34131",56,46,46,0,0,"PCTE",0
47,"47039",162,119,117,0,2,"PCTE",0
41,"41014",2476,1852,1799,10,53,"PCTE",1
37,"37221",391,259,257,2,2,"PCTE",0
50,"50184",87,70,70,0,0,"PCTE",0
45,"45156",3334,2561,2502,23,59,"PCTE",1
37,"37067",3278,2568,2529,30,39,"PCTE",4
22,"22228",532,371,364,4,7,"PCTE",0
5,"5042",141,111,111,0,0,"PCTE",0
28,"28069",58,44,42,1,2,"PCTE",0
24,"24001",165,93,93,0,0,"PCTE",0
14,"14075",552,413,391,5,22,"PCTE",1
28,"28065",131232,100864,99883,846,981,"PCTE",75
28,"28087",3301,2539,2519,20,20,"PCTE",1
14,"14010",3992,2786,2723,14,63,"PCTE",1
50,"50107",988,758,755,8,3,"PCTE",0
28,"28131",13510,9647,9544,89,103,"PCTE",8
34,"34122",83,56,56,0,0,"PCTE",0
23,"23097",6346,4243,4194,31,49,"PCTE",1
34,"34025",52,34,34,1,0,"PCTE",1
21,"21053",3306,2161,2106,11,55,"PCTE",3
9,"9413",405,267,263,0,4,"PCTE",0
45,"45060",152,109,109,1,0,"PCTE",0
37,"37140",630,395,393,0,2,"PCTE",1
50,"50242",99,74,74,0,0,"PCTE",0
2,"2022",341,243,243,2,0,"PCTE",0
16,"16020",9,5,5,1,0,"PCTE",0
19,"19232",56,40,40,0,0,"PCTE",0
49,"49169",38,33,32,0,1,"PCTE",0
42,"42006",154,105,103,0,2,"PCTE",0
45,"45161",15469,10281,10167,68,114,"PCTE",8
24,"24041",513,312,305,4,7,"PCTE",1
40,"40199",101,76,72,2,4,"PCTE",0
49,"49024",626,432,426,3,6,"PCTE",0
37,"37327",179,148,147,2,1,"PCTE",0
23,"23064",1669,1311,1296,9,15,"PCTE",0
37,"37117",1572,1103,1092,12,11,"PCTE",0
49,"49042",229,166,164,2,2,"PCTE",0
18,"18902",752,589,568,3,21,"PCTE",0
45,"45027",315,249,246,2,3,"PCTE",0
9,"9288",87,64,64,0,0,"PCTE",0
9,"9231",57,35,35,2,0,"PCTE",0
34,"34174",172,142,136,0,6,"PCTE",2
50,"50253",379,294,290,1,4,"PCTE",0
45,"45162",630,448,438,1,10,"PCTE",0
9,"9039",54,38,37,0,1,"PCTE",0
39,"39054",4541,3271,3252,30,19,"PCTE",2
42,"42013",34,22,22,2,0,"PCTE",1
37,"37145",236,173,170,3,3,"PCTE",0
34,"34112",39,31,31,0,0,"PCTE",0
47,"47227",53,36,35,0,1,"PCTE",0
42,"42196",7,7,7,1,0,"PCTE",0
9,"9006",57,30,29,0,1,"PCTE",0
49,"49082",341,273,270,12,3,"PCTE",0
28,"28181",20801,16353,16243,97,110,"PCTE",5
14,"14032",388,302,293,0,9,"PCTE",1
37,"37252",99,65,65,1,0,"PCTE",0
49,"49110",344,196,195,2,1,"PCTE",0
42,"42025",1125,741,732,12,9,"PCTE",0
40,"40113",404,308,304,2,4,"PCTE",0
18,"18182",1926,1222,1204,8,18,"PCTE",1
9,"9196",133,95,95,2,0,"PCTE",0
22,"22025",1022,705,694,14,11,"PCTE",0
42,"42060",28,16,14,0,2,"PCTE",0
26,"26138",4504,2982,2930,32,52,"PCTE",1
21,"21026",262,172,168,2,4,"PCTE",0
22,"22068",64,41,41,1,0,"PCTE",0
19,"19216",127,88,88,0,0,"PCTE",2
16,"16097",139,117,116,0,1,"PCTE",0
22,"22051",90,72,72,2,0,"PCTE",0
50,"50214",18,18,14,1,4,"PCTE",0
34,"34201",171,131,130,1,1,"PCTE",0
39,"39081",440,330,327,1,3,"PCTE",0
33,"33022",802,460,452,4,8,"PCTE",17
16,"16038",27,20,20,0,0,"PCTE",0
47,"47117",287,199,197,6,2,"PCTE",6
47,"47114",3900,2549,2514,18,35,"PCTE",0
37,"37189",114,75,74,1,1,"PCTE",0
9,"9127",52,36,35,0,1,"PCTE",0
41,"41043",669,447,436,11,11,"PCTE",0
24,"24205",990,678,667,6,11,"PCTE",1
49,"49233",85,51,51,0,0,"PCTE",0
34,"34020",49,37,37,1,0,"PCTE",0
37,"37133",101,73,69,1,4,"PCTE",0
50,"50023",199,145,143,2,2,"PCTE",0
40,"40019",29,23,23,1,0,"PCTE",0
34,"34163",46,37,37,0,0,"PCTE",0
33,"33044",177059,121380,120421,1543,959,"PCTE",119
39,"39053",212,133,133,4,0,"PCTE",0
16,"16906",70,44,44,1,0,"PCTE",0
37,"37054",233,190,186,2,4,"PCTE",0
5,"5173",60,54,54,0,0,"PCTE",0
5,"5237",153,125,123,0,2,"PCTE",0
50,"50174",80,58,57,0,1,"PCTE",0
9,"9303",73,58,58,0,0,"PCTE",0
9,"9033",80,64,63,1,1,"PCTE",0
5,"5252",56,46,45,0,1,"PCTE",0
5,"5157",227,146,146,3,0,"PCTE",0
24,"24097",200,138,137,1,1,"PCTE",0
47,"47018",36,31,31,0,0,"PCTE",0
9,"9149",36,29,29,0,0,"PCTE",0
45,"45152",545,402,393,1,9,"PCTE",0
50,"50239",63,46,45,1,1,"PCTE",0
9,"9013",42,32,32,0,0,"PCTE",0
5,"5064",101,77,77,0,0,"PCTE",0
40,"40052",72,55,55,0,0,"PCTE",0
37,"37144",327,233,233,2,0,"PCTE",0
26,"26110",149,116,114,0,2,"PCTE",0
42,"42185",24,20,20,0,0,"PCTE",0
34,"34165",57,45,44,1,1,"PCTE",0
21,"21075",338,243,235,3,8,"PCTE",0
49,"49199",236,159,157,3,2,"PCTE",1
39,"39001",2063,1474,1467,5,7,"PCTE",0
42,"42127",37,26,26,1,0,"PCTE",0
23,"23009",12849,9722,9572,99,150,"PCTE",2
16,"16163",64,51,51,0,0,"PCTE",0
14,"14074",2225,1775,1743,17,32,"PCTE",1
28,"28178",1149,869,853,4,16,"PCTE",0
24,"24206",1594,1104,1093,11,11,"PCTE",1
42,"42151",38,27,27,0,0,"PCTE",0
49,"49160",42,27,27,0,0,"PCTE",0
40,"40135",277,212,210,3,2,"PCTE",0
19,"19327",385,313,308,2,5,"PCTE",0
18,"18123",284,202,200,5,2,"PCTE",0
14,"14004",1963,1465,1437,15,28,"PCTE",0
16,"16072",132,84,84,1,0,"PCTE",0
22,"22164",42,28,28,0,0,"PCTE",0
16,"16004",228,175,174,0,1,"PCTE",0
5,"5187",1714,1247,1221,9,26,"PCTE",3
9,"9350",421,316,311,5,5,"PCTE",0
37,"37204",253,176,173,2,3,"PCTE",0
50,"50144",31,24,24,0,0,"PCTE",0
23,"23026",3431,2430,2375,25,55,"PCTE",1
45,"45146",101,79,79,0,0,"PCTE",0
2,"2014",354,254,252,3,2,"PCTE",0
50,"50256",70,43,43,0,0,"PCTE",0
50,"50255",199,152,147,3,5,"PCTE",1
49,"49220",146,102,98,3,4,"PCTE",0
16,"16206",184,126,125,4,1,"PCTE",0
40,"40149",479,345,338,3,7,"PCTE",1
16,"16101",137,111,109,1,2,"PCTE",0
45,"45039",201,157,157,0,0,"PCTE",0
47,"47078",157,114,107,0,7,"PCTE",0
19,"19248",73,54,54,0,0,"PCTE",0
16,"16057",62,45,45,0,0,"PCTE",0
50,"50076",70,56,56,0,0,"PCTE",0
29,"29033",1084,733,722,5,11,"PCTE",0
14,"14043",7406,5323,5211,63,112,"PCTE",1
50,"50104",320,251,251,1,0,"PCTE",0
5,"5220",364,277,274,0,3,"PCTE",0
16,"16181",54,40,40,0,0,"PCTE",0
23,"23007",3015,2252,2229,14,23,"PCTE",3
24,"24091",575,368,362,5,6,"PCTE",2
42,"42173",29860,19581,19206,337,375,"PCTE",48
42,"42080",153,108,108,1,0,"PCTE",0
47,"47213",104,78,78,0,0,"PCTE",0
2,"2004",597,459,455,3,4,"PCTE",0
37,"37232",377,303,303,2,0,"PCTE",1
50,"50069",66,33,33,1,0,"PCTE",0
9,"9325",177,103,101,2,2,"PCTE",1
16,"16904",453,348,345,11,3,"PCTE",2
45,"45191",524,437,432,2,5,"PCTE",0
23,"23070",3813,2384,2354,11,30,"PCTE",0
16,"16193",55,50,49,0,1,"PCTE",0
5,"5227",341,230,228,1,2,"PCTE",0
19,"19108",95,78,78,0,0,"PCTE",0
26,"26011",7251,4807,4711,47,96,"PCTE",6
18,"18164",1790,1135,1108,11,27,"PCTE",1
34,"34179",25,18,16,0,2,"PCTE",0
49,"49130",155,116,112,1,4,"PCTE",0
18,"18086",338,253,247,1,6,"PCTE",0
26,"26059",1109,801,791,6,10,"PCTE",1
21,"21046",1729,1212,1187,14,25,"PCTE",0
50,"50181",999,748,732,3,16,"PCTE",0
23,"23004",407,321,315,2,6,"PCTE",0
49,"49102",182,130,130,2,0,"PCTE",0
37,"37254",174,140,135,0,5,"PCTE",0
19,"19209",40,30,29,0,1,"PCTE",0
41,"41033",4958,3299,3250,38,49,"PCTE",3
41,"41072",4031,2969,2933,15,36,"PCTE",1
40,"40032",368,247,244,5,3,"PCTE",0
33,"33064",240,151,151,0,0,"PCTE",0
33,"33017",2969,1787,1768,38,19,"PCTE",3
19,"19021",978,678,662,3,16,"PCTE",0
9,"9057",147,110,108,0,2,"PCTE",1
19,"19185",26,15,15,1,0,"PCTE",0
5,"5260",95,73,73,0,0,"PCTE",0
19,"19071",8277,5838,5763,53,75,"PCTE",4
24,"24226",194,118,118,1,0,"PCTE",0
5,"5224",102,85,84,2,1,"PCTE",0
24,"24010",8251,5357,5275,40,82,"PCTE",3
37,"37338",77,58,58,0,0,"PCTE",0
37,"37158",230,149,149,1,0,"PCTE",0
18,"18035",1179,882,870,7,12,"PCTE",0
49,"49085",904,583,579,5,4,"PCTE",0
40,"40210",97,69,69,1,0,"PCTE",0
18,"18133",2101,1496,1477,6,19,"PCTE",0
26,"26061",1542,1104,1079,12,25,"PCTE",2
50,"50131",212,152,147,4,5,"PCTE",1
2,"2037",22963,14737,14588,68,149,"PCTE",13
9,"9244",45,31,31,2,0,"PCTE",0
19,"19191",13,12,12,0,0,"PCTE",0
18,"18119",1708,1264,1240,7,24,"PCTE",1
9,"9200",48,29,29,0,0,"PCTE",0
49,"49209",451,274,269,7,5,"PCTE",1
19,"19089",23,17,17,0,0,"PCTE",0
24,"24054",410,275,271,0,4,"PCTE",0
9,"9339",128,106,105,0,1,"PCTE",0
34,"34082",78,59,58,0,1,"PCTE",0
37,"37001",165,120,120,0,0,"PCTE",0
2,"2051",1654,1115,1101,13,14,"PCTE",0
37,"37137",98,60,59,2,1,"PCTE",0
26,"26160",731,539,533,4,6,"PCTE",0
18,"18193",14934,10301,10127,116,174,"PCTE",11
29,"29039",2759,1900,1860,23,40,"PCTE",2
42,"42010",21,15,14,0,1,"PCTE",0
37,"37325",88,63,63,0,0,"PCTE",0
28,"28062",306,232,227,0,5,"PCTE",0
50,"50039",462,339,333,1,6,"PCTE",1
23,"23001",912,723,712,2,11,"PCTE",0
49,"49222",369,250,247,2,3,"PCTE",0
5,"5027",258,209,203,5,6,"PCTE",0
50,"50002",125,91,86,0,5,"PCTE",0
50,"50077",201,140,140,1,0,"PCTE",0
33,"33014",8735,5744,5689,67,55,"PCTE",17
21,"21079",678,428,417,2,11,"PCTE",3
41,"41096",6178,4739,4655,60,84,"PCTE",3
47,"47043",306,241,240,4,1,"PCTE",0
41,"41027",4007,2628,2546,33,82,"PCTE",1
26,"26172",25,16,15,0,1,"PCTE",0
9,"9267",117,95,93,1,2,"PCTE",0
34,"34245",307,212,212,0,0,"PCTE",0
37,"37213",83,64,64,0,0,"PCTE",1
21,"21006",3321,2197,2125,19,72,"PCTE",0
29,"29041",3697,2406,2361,47,45,"PCTE",2
19,"19097",14,14,13,0,1,"PCTE",0
19,"19129",25,21,21,0,0,"PCTE",0
37,"37261",213,153,149,0,4,"PCTE",0
16,"16036",120,94,93,0,1,"PCTE",0
34,"34035",97,76,75,3,1,"PCTE",0
18,"18908",776,553,528,3,25,"PCTE",0
16,"16159",198,135,135,2,0,"PCTE",0
42,"42070",31,23,23,1,0,"PCTE",0
9,"9346",90,61,60,1,1,"PCTE",0
22,"22058",193,141,141,0,0,"PCTE",0
39,"39025",8637,6256,6179,33,77,"PCTE",9
9,"9330",1481,1050,1037,17,13,"PCTE",0
24,"24145",612,338,337,1,1,"PCTE",0
42,"42035",730,464,460,3,4,"PCTE",2
45,"45043",776,608,598,3,10,"PCTE",0
50,"50229",65,46,46,1,0,"PCTE",0
5,"5244",39,29,29,0,0,"PCTE",0
9,"9023",1190,891,879,17,12,"PCTE",3
42,"42064",83,65,65,1,0,"PCTE",0
28,"28135",998,712,703,2,9,"PCTE",1
49,"49179",337,210,209,3,1,"PCTE",0
19,"19187",42,32,32,0,0,"PCTE",0
37,"37324",333,247,242,3,5,"PCTE",0
16,"16273",300,214,211,3,3,"PCTE",0
5,"5181",46,34,34,0,0,"PCTE",0
50,"50248",501,344,328,3,16,"PCTE",0
5,"5076",468,376,367,1,9,"PCTE",0
28,"28115",62612,50619,50431,399,188,"PCTE",5
9,"9394",668,432,429,6,3,"PCTE",1
45,"45052",3132,2433,2416,29,17,"PCTE",2
22,"22190",123,77,77,1,0,"PCTE",0
19,"19194",91,69,69,0,0,"PCTE",0
47,"47091",76,60,59,2,1,"PCTE",0
45,"45128",2569,1676,1652,6,24,"PCTE",0
39,"39013",517,359,356,1,3,"PCTE",0
9,"9369",419,288,284,3,4,"PCTE",0
21,"21072",10233,7374,7183,116,191,"PCTE",3
37,"37190",189,141,139,1,2,"PCTE",0
34,"34069",2184,1555,1517,17,38,"PCTE",0
40,"40195",776,573,565,4,8,"PCTE",0
50,"50212",32,26,26,0,0,"PCTE",0
9,"9352",102,74,74,0,0,"PCTE",0
49,"49249",61,45,45,1,0,"PCTE",0
14,"14014",2496,1962,1907,20,55,"PCTE",2
16,"16211",335,228,227,1,1,"PCTE",0
45,"45056",2341,1315,1295,11,20,"PCTE",1
26,"26027",139,99,97,0,2,"PCTE",1
22,"22048",12635,8889,8807,98,82,"PCTE",5
45,"45010",383,258,257,3,1,"PCTE",0
9,"9472",52,40,38,0,2,"PCTE",0
37,"37032",553,388,388,2,0,"PCTE",0
22,"22090",86,61,61,1,0,"PCTE",0
24,"24141",96,74,74,0,0,"PCTE",0
49,"49180",135,82,81,5,1,"PCTE",0
16,"16147",54,34,33,0,1,"PCTE",0
22,"22124",183,119,119,0,0,"PCTE",0
47,"47231",4439,3359,3323,36,36,"PCTE",4
5,"5013",834,658,653,2,5,"PCTE",0
37,"37228",324,262,262,1,0,"PCTE",0
40,"40208",724,546,543,5,3,"PCTE",0
28,"28050",4406,3202,3167,29,35,"PCTE",3
22,"22028",358,237,233,1,4,"PCTE",1
5,"5090",73,63,62,0,1,"PCTE",0
34,"34038",259,183,178,0,5,"PCTE",0
49,"49176",605,360,353,0,7,"PCTE",0
28,"28084",16243,11562,11408,90,154,"PCTE",6
9,"9355",85,67,67,1,0,"PCTE",0
40,"40099",54,44,42,0,2,"PCTE",0
45,"45195",2064,1519,1481,9,38,"PCTE",2
45,"45103",363,286,283,0,3,"PCTE",0
18,"18001",222,147,146,0,1,"PCTE",0
40,"40159",130,94,93,2,1,"PCTE",0
28,"28170",2495,1714,1695,13,19,"PCTE",0
39,"39085",7017,5029,4992,23,37,"PCTE",3
40,"40233",399,279,273,0,6,"PCTE",0
16,"16045",180,128,127,0,1,"PCTE",1
23,"23071",1704,1278,1258,10,20,"PCTE",1
19,"19234",44,30,30,0,0,"PCTE",0
16,"16279",173,109,108,0,1,"PCTE",0
39,"39016",23850,17235,17106,70,129,"PCTE",11
18,"18112",104,68,66,2,2,"PCTE",0
18,"18167",1839,1243,1224,9,19,"PCTE",1
42,"42164",1580,1043,1029,8,14,"PCTE",0
31,"31062",1070,778,770,10,8,"PCTE/ELAK",1
31,"31224",884,637,630,7,7,"PCTE/ELAK",0
31,"31183",718,536,534,5,2,"PCTE/ELAK",1
31,"31189",1125,702,698,6,4,"PCTE/ELAK",2
31,"31263",231,137,137,1,0,"PCTE/ELAK",0
31,"31087",179,124,124,3,0,"PCTE/ELAK",0
31,"31207",280,194,191,3,3,"PCTE/ELAK",1
31,"31211",17,15,14,3,1,"PCTE/ELAK",0
31,"31171",670,466,462,1,4,"PCTE/ELAK",1
31,"31199",138,86,84,0,2,"PCTE/ELAK",0
31,"31058",199,134,133,2,1,"PCTE/ELAK",2
31,"31067",1887,1265,1249,6,16,"PCTE/ELAK",1
31,"31163",2011,1422,1404,6,18,"PCTE/ELAK",0
31,"31116",57,27,27,3,0,"PCTE/ELAK",0
31,"31226",572,347,343,4,4,"PCTE/ELAK",0
31,"31099",51,38,38,0,0,"PCTE/ELAK",0
31,"31003",121,71,71,0,0,"PCTE/ELAK",0
31,"31037",91,70,70,0,0,"PCTE/ELAK",0
31,"31167",833,581,573,2,8,"PCTE/ELAK",1
31,"31076",2543,1965,1956,19,9,"PCTE/ELAK",3
31,"31185",461,291,290,1,1,"PCTE/ELAK",0
31,"31173",845,642,636,4,6,"PCTE/ELAK",0
31,"31904",1559,989,972,11,17,"PCTE/ELAK",1
31,"31005",279,183,183,4,0,"PCTE/ELAK",0
31,"31249",1798,1235,1227,13,8,"PCTE/ELAK",2
31,"31040",186,131,129,1,2,"PCTE/ELAK",0
31,"31050",6016,3675,3612,41,63,"PCTE/ELAK",3
31,"31025",762,497,490,1,7,"PCTE/ELAK",1
31,"31136",461,294,293,3,1,"PCTE/ELAK",1
31,"31114",388,272,271,3,1,"PCTE/ELAK",0
31,"31187",99,53,52,0,1,"PCTE/ELAK",0
31,"31141",106,66,61,1,5,"PCTE/ELAK",0
31,"31128",349,217,215,4,2,"PCTE/ELAK",0
31,"31063",84,59,59,0,0,"PCTE/ELAK",0
31,"31018",426,287,283,2,4,"PCTE/ELAK",0
31,"31043",29,23,23,0,0,"PCTE/ELAK",0
31,"31113",130,77,76,0,1,"PCTE/ELAK",1
31,"31222",57,35,34,3,1,"PCTE/ELAK",0
31,"31168",238,176,174,1,2,"PCTE/ELAK",0
31,"31227",8118,5691,5636,65,55,"PCTE/ELAK",12
31,"31197",67,51,51,2,0,"PCTE/ELAK",0
31,"31191",3024,2156,2133,23,23,"PCTE/ELAK",5
31,"31134",172,106,106,1,0,"PCTE/ELAK",0
31,"31235",156,112,108,1,4,"PCTE/ELAK",3
31,"31220",742,551,539,6,12,"PCTE/ELAK",3
31,"31162",48,28,27,1,1,"PCTE/ELAK",0
31,"31155",246,165,161,3,4,"PCTE/ELAK",1
31,"31902",4661,3228,3201,39,27,"PCTE/ELAK",3
31,"31137",198,83,83,1,0,"PCTE/ELAK",0
31,"31123",615,350,347,4,3,"PCTE/ELAK",0
31,"31094",105,70,70,1,0,"PCTE/ELAK",0
31,"31098",1984,1443,1428,11,15,"PCTE/ELAK",2
31,"31001",79,56,56,0,0,"PCTE/ELAK",0
31,"31131",913,672,664,8,8,"PCTE/ELAK",0
31,"31091",322,201,201,3,0,"PCTE/ELAK",0
31,"31016",7790,5541,5502,56,39,"PCTE/ELAK",8
31,"31175",66,46,46,0,0,"PCTE/ELAK",0
31,"31179",486,315,312,3,3,"PCTE/ELAK",0
31,"31103",40,28,27,0,1,"PCTE/ELAK",0
31,"31188",319,197,191,3,6,"PCTE/ELAK",0
31,"31253",121,100,100,0,0,"PCTE/ELAK",0
31,"31010",5719,3799,3770,22,29,"PCTE/ELAK",5
31,"31051",241,169,167,3,2,"PCTE/ELAK",0
31,"31196",31,23,23,0,0,"PCTE/ELAK",1
31,"31905",2992,1994,1984,9,10,"PCTE/ELAK",2
31,"31208",2568,1855,1835,24,20,"PCTE/ELAK",1
31,"31027",811,527,521,1,6,"PCTE/ELAK",0
31,"31124",207,134,134,2,0,"PCTE/ELAK",0
31,"31223",953,667,654,4,13,"PCTE/ELAK",0
31,"31262",234,190,188,0,2,"PCTE/ELAK",0
31,"31064",1398,1035,1031,5,4,"PCTE/ELAK",2
31,"31036",879,601,589,5,12,"PCTE/ELAK",1
31,"31101",1428,986,981,6,5,"PCTE/ELAK",1
31,"31039",92,70,69,1,1,"PCTE/ELAK",0
31,"31152",1255,826,817,8,9,"PCTE/ELAK",1
31,"31006",1877,1328,1310,14,18,"PCTE/ELAK",3
31,"31132",147,100,100,2,0,"PCTE/ELAK",0
31,"31238",119,96,95,4,1,"PCTE/ELAK",0
31,"31068",2816,2028,1989,20,39,"PCTE/ELAK",2
31,"31150",200,120,119,1,1,"PCTE/ELAK",0
31,"31146",30,22,22,1,0,"PCTE/ELAK",0
31,"31206",2077,1433,1417,15,16,"PCTE/ELAK",1
31,"31190",44,30,30,1,0,"PCTE/ELAK",0
31,"31908",1076,763,762,5,1,"PCTE/ELAK",0
31,"31236",1319,815,808,8,7,"PCTE/ELAK",1
31,"31017",375,250,250,10,0,"PCTE/ELAK",0
31,"31204",36,25,25,0,0,"PCTE/ELAK",0
31,"31110",83,61,61,1,0,"PCTE/ELAK",0
31,"31029",913,606,601,14,5,"PCTE/ELAK",1
31,"31192",160,125,123,0,2,"PCTE/ELAK",0
31,"31201",151450,105649,104976,1004,673,"PCTE/ELAK",105
31,"31135",111,73,72,3,1,"PCTE/ELAK",0
31,"31054",453,279,276,2,3,"PCTE/ELAK",0
31,"31159",1097,813,812,2,1,"PCTE/ELAK",1
31,"31071",13,11,11,0,0,"PCTE/ELAK",0
31,"31225",35,29,28,0,1,"PCTE/ELAK",0
31,"31014",268,168,168,2,0,"PCTE/ELAK",0
31,"31031",212,134,132,2,2,"PCTE/ELAK",0
31,"31002",431,294,290,3,4,"PCTE/ELAK",1
31,"31156",238,175,174,2,1,"PCTE/ELAK",0
31,"31250",2761,1776,1759,13,17,"PCTE/ELAK",4
31,"31258",7879,5668,5631,50,37,"PCTE/ELAK",2
31,"31038",1343,975,963,16,12,"PCTE/ELAK",0
31,"31234",146,101,101,0,0,"PCTE/ELAK",0
31,"31144",760,442,441,4,1,"PCTE/ELAK",0
31,"31092",683,413,413,6,0,"PCTE/ELAK",0
31,"31019",1831,1231,1224,17,7,"PCTE/ELAK",0
31,"31177",245,161,159,1,2,"PCTE/ELAK",1
31,"31125",271,173,171,3,2,"PCTE/ELAK",0
31,"31907",11272,8478,8421,97,57,"PCTE/ELAK",10
31,"31161",350,261,256,1,5,"PCTE/ELAK",0
31,"31239",282,196,193,6,3,"PCTE/ELAK",0
31,"31048",166,121,119,1,2,"PCTE/ELAK",1
31,"31231",104,65,65,1,0,"PCTE/ELAK",0
31,"31260",1265,817,815,7,2,"PCTE/ELAK",0
31,"31028",215,121,121,2,0,"PCTE/ELAK",0
31,"31180",202,144,143,1,1,"PCTE/ELAK",0
31,"31004",31,22,22,1,0,"PCTE/ELAK",1
31,"31126",352,223,223,3,0,"PCTE/ELAK",0
31,"31045",510,347,345,8,2,"PCTE/ELAK",0
31,"31198",36,30,30,0,0,"PCTE/ELAK",0
31,"31138",948,629,627,8,2,"PCTE/ELAK",1
31,"31145",160,121,120,2,1,"PCTE/ELAK",0
31,"31057",1741,1237,1219,6,18,"PCTE/ELAK",2
31,"31069",823,596,595,1,1,"PCTE/ELAK",0
31,"31118",156,104,104,3,0,"PCTE/ELAK",0
31,"31090",139,67,67,0,0,"PCTE/ELAK",0
31,"31130",321,203,203,0,0,"PCTE/ELAK",0
31,"31049",679,461,453,2,8,"PCTE/ELAK",1
31,"31245",76,51,48,2,3,"PCTE/ELAK",2
31,"31111",91,52,52,0,0,"PCTE/ELAK",0
31,"31034",31,24,24,0,0,"PCTE/ELAK",0
31,"31216",3867,2592,2566,37,26,"PCTE/ELAK",2
31,"31086",13781,10133,10054,114,79,"PCTE/ELAK",7
31,"31127",131,90,86,0,4,"PCTE/ELAK",0
31,"31007",122,88,82,1,6,"PCTE/ELAK",0
31,"31055",267,192,191,0,1,"PCTE/ELAK",0
31,"31901",15487,11077,10991,117,86,"PCTE/ELAK",13
31,"31230",90,66,66,0,0,"PCTE/ELAK",0
31,"31172",370,257,250,6,7,"PCTE/ELAK",1
31,"31148",92,62,59,2,3,"PCTE/ELAK",1
31,"31047",238,163,163,2,0,"PCTE/ELAK",0
31,"31254",1916,1336,1322,9,14,"PCTE/ELAK",0
31,"31041",1671,1118,1105,15,13,"PCTE/ELAK",1
31,"31077",5416,3840,3794,38,46,"PCTE/ELAK",5
31,"31112",91,56,56,0,0,"PCTE/ELAK",0
31,"31906",2707,1800,1781,22,19,"PCTE/ELAK",4
31,"31160",104,83,82,1,1,"PCTE/ELAK",0
31,"31008",61,42,42,0,0,"PCTE/ELAK",5
31,"31088",5656,3929,3893,56,36,"PCTE/ELAK",4
31,"31243",300,216,213,6,3,"PCTE/ELAK",1
31,"31181",133,87,84,1,3,"PCTE/ELAK",0
31,"31084",1946,1367,1362,9,5,"PCTE/ELAK",0
31,"31153",2174,1417,1415,12,2,"PCTE/ELAK",2
31,"31157",3447,2182,2160,29,22,"PCTE/ELAK",3
31,"31149",2285,1531,1520,10,11,"PCTE/ELAK",0
31,"31078",2418,1752,1729,16,23,"PCTE/ELAK",2
31,"31151",53,37,37,0,0,"PCTE/ELAK",0
31,"31013",615,371,365,1,6,"PCTE/ELAK",1
31,"31170",44,31,30,2,1,"PCTE/ELAK",0
31,"31215",4670,3270,3219,33,51,"PCTE/ELAK",1
31,"31046",53,38,38,0,0,"PCTE/ELAK",0
31,"31240",514,352,352,3,0,"PCTE/ELAK",0
31,"31024",100,52,52,0,0,"PCTE/ELAK",0
31,"31252",80,52,52,1,0,"PCTE/ELAK",0
31,"31178",476,323,320,7,3,"PCTE/ELAK",0
31,"31142",1389,909,900,9,9,"PCTE/ELAK",2
31,"31106",721,547,545,1,2,"PCTE/ELAK",0
31,"31229",39,32,32,0,0,"PCTE/ELAK",0
31,"31052",101,78,75,0,3,"PCTE/ELAK",1
31,"31210",186,131,130,2,1,"PCTE/ELAK",0
31,"31221",1228,823,815,6,8,"PCTE/ELAK",0
31,"31147",110,79,78,1,1,"PCTE/ELAK",0
31,"31212",128,91,91,1,0,"PCTE/ELAK",0
31,"31108",1819,1348,1325,13,23,"PCTE/ELAK",3
31,"31100",256,166,165,0,1,"PCTE/ELAK",0
31,"31237",182,138,135,2,3,"PCTE/ELAK",0
31,"31075",113,69,69,2,0,"PCTE/ELAK",0
31,"31115",159,93,93,2,0,"PCTE/ELAK",0
31,"31251",3144,2197,2164,18,33,"PCTE/ELAK",2
31,"31213",99,50,50,0,0,"PCTE/ELAK",0
31,"31026",130,108,107,0,1,"PCTE/ELAK",0
31,"31139",152,100,100,1,0,"PCTE/ELAK",0
31,"31011",715,483,481,5,2,"PCTE/ELAK",0
31,"31089",236,168,167,1,1,"PCTE/ELAK",1
31,"31022",477,303,301,2,2,"PCTE/ELAK",0
31,"31072",5324,3733,3684,33,49,"PCTE/ELAK",3
31,"31061",48,45,45,2,0,"PCTE/ELAK",0
31,"31256",95,55,55,1,0,"PCTE/ELAK",0
31,"31140",112,73,73,1,0,"PCTE/ELAK",0
31,"31259",475,313,311,5,2,"PCTE/ELAK",0
31,"31023",7778,5977,5948,106,29,"PCTE/ELAK",3
31,"31193",1440,1062,1055,11,7,"PCTE/ELAK",2
31,"31205",419,290,289,4,1,"PCTE/ELAK",3
31,"31903",6950,4430,4394,39,36,"PCTE/ELAK",4
31,"31184",65,41,40,0,1,"PCTE/ELAK",0
31,"31246",130,89,87,2,2,"PCTE/ELAK",0
31,"31265",76,43,40,0,3,"PCTE/ELAK",0
31,"31261",240,161,158,2,3,"PCTE/ELAK",0
31,"31065",1843,1311,1300,12,11,"PCTE/ELAK",2
31,"31033",45,25,25,2,0,"PCTE/ELAK",0
31,"31095",71,59,59,0,0,"PCTE/ELAK",0
31,"31060",14323,9547,9434,79,113,"PCTE/ELAK",22
31,"31105",1471,1144,1124,10,20,"PCTE/ELAK",1
31,"31079",65,46,46,2,0,"PCTE/ELAK",0
31,"31059",182,121,121,1,0,"PCTE/ELAK",0
31,"31143",91,44,41,1,3,"PCTE/ELAK",0
31,"31083",49,39,39,1,0,"PCTE/ELAK",0
31,"31030",135,94,94,0,0,"PCTE/ELAK",1
31,"31104",1751,1147,1125,8,22,"PCTE/ELAK",3
31,"31174",100,55,55,0,0,"PCTE/ELAK",0
31,"31082",627,385,385,5,0,"PCTE/ELAK",0
31,"31042",2707,1926,1900,11,26,"PCTE/ELAK",2
31,"31015",1989,1399,1386,17,13,"PCTE/ELAK",2
31,"31053",509,354,350,4,4,"PCTE/ELAK",0
31,"31217",327,204,196,1,8,"PCTE/ELAK",0
31,"31209",149,111,110,0,1,"PCTE/ELAK",0
31,"31080",486,362,361,4,1,"PCTE/ELAK",0
31,"31096",99,79,79,3,0,"PCTE/ELAK",0
31,"31255",103,79,79,0,0,"PCTE/ELAK",0
31,"31035",50,30,29,0,1,"PCTE/ELAK",0
31,"31186",283,183,182,1,1,"PCTE/ELAK",1
31,"31244",157,69,69,0,0,"PCTE/ELAK",1
31,"31044",291,227,227,1,0,"PCTE/ELAK",0
31,"31248",272,142,138,3,4,"PCTE/ELAK",0
31,"31202",4360,2806,2767,30,39,"PCTE/ELAK",3
31,"31109",1657,1165,1160,12,5,"PCTE/ELAK",1
31,"31233",91,62,60,2,2,"PCTE/ELAK",0
31,"31203",30,19,19,2,0,"PCTE/ELAK",0
31,"31066",819,577,559,4,18,"PCTE/ELAK",0
31,"31257",915,654,642,9,12,"PCTE/ELAK",0
31,"31032",1670,1158,1147,18,11,"PCTE/ELAK",0
31,"31164",542,410,408,5,2,"PCTE/ELAK",1
31,"31133",34,27,27,1,0,"PCTE/ELAK",0
31,"31122",4981,3539,3504,38,35,"PCTE/ELAK",2
31,"31070",2633,1714,1682,16,32,"PCTE/ELAK",2
31,"31176",2919,1974,1933,27,41,"PCTE/ELAK",3
31,"31241",126,86,85,2,1,"PCTE/ELAK",0
31,"31020",435,224,222,1,2,"PCTE/ELAK",0
31,"31120",376,211,209,7,2,"PCTE/ELAK",0
31,"31158",248,156,151,0,5,"PCTE/ELAK",0
31,"31242",258,168,167,2,1,"PCTE/ELAK",0
31,"31121",62,42,42,0,0,"PCTE/ELAK",1
31,"31228",496,356,354,1,2,"PCTE/ELAK",0
31,"31169",2203,1429,1415,15,14,"PCTE/ELAK",1
31,"31119",35,24,24,1,0,"PCTE/ELAK",0
31,"31200",745,489,483,1,6,"PCTE/ELAK",1
31,"31219",80,59,58,2,1,"PCTE/ELAK",0
31,"31247",141,99,96,1,3,"PCTE/ELAK",0
31,"31195",169,108,108,0,0,"PCTE/ELAK",0
31,"31056",186,128,124,2,4,"PCTE/ELAK",0
31,"31194",328,224,222,3,2,"PCTE/ELAK",0
31,"31182",29,25,25,0,0,"PCTE/ELAK",0
31,"31166",242,172,172,2,0,"PCTE/ELAK",0
31,"31012",763,550,542,7,8,"PCTE/ELAK",1
31,"31154",217,107,104,0,3,"PCTE/ELAK",0
31,"31021",59,42,42,1,0,"PCTE/ELAK",0
31,"31214",87,55,54,0,1,"PCTE/ELAK",0
31,"31232",25687,17548,17304,243,244,"PCTE/ELAK",24
31,"31073",298,207,206,1,1,"PCTE/ELAK",0
31,"31107",1671,1204,1182,12,22,"PCTE/ELAK",1
31,"31081",338,229,227,1,2,"PCTE/ELAK",0
31,"31085",500,365,362,2,3,"PCTE/ELAK",0
31,"31093",275,201,198,3,3,"PCTE/ELAK",0
31,"31129",388,239,238,3,1,"PCTE/ELAK",0
31,"31097",10559,6977,6919,71,58,"PCTE/ELAK",9
31,"31074",394,293,292,5,1,"PCTE/ELAK",0
31,"31102",135,60,60,1,0,"PCTE/ELAK",0
31,"31009",674,455,451,2,4,"PCTE/ELAK",0
31,"31117",583,373,372,3,1,"PCTE/ELAK",1
31,"31165",2772,1946,1930,16,16,"PCTE/ELAK",2
31,"31264",179,91,90,2,1,"PCTE/ELAK",0
48,"48049",543,415,414,1,1,"PCTE/ELAK",0
48,"48020",272771,184893,183922,1227,971,"PCTE/ELAK",130
48,"48074",3275,2308,2295,11,13,"PCTE/ELAK",0
48,"48052",1562,1220,1210,5,10,"PCTE/ELAK",0
48,"48001",5899,4094,4074,19,20,"PCTE/ELAK",4
48,"48048",527,381,380,3,1,"PCTE/ELAK",1
48,"48066",344,246,246,2,0,"PCTE/ELAK",0
1,"1061",155,116,116,1,0,"PCTE/ELAK",0
48,"48021",1325,891,888,3,3,"PCTE/ELAK",2
48,"48068",1534,1154,1149,1,5,"PCTE/ELAK",0
1,"1053",596,364,362,1,2,"PCTE/ELAK",0
48,"48086",2024,1371,1358,5,13,"PCTE/ELAK",0
1,"1051",3569,2259,2244,3,15,"PCTE/ELAK",1
48,"48039",254,221,220,2,1,"PCTE/ELAK",0
48,"48065",3285,2341,2326,8,15,"PCTE/ELAK",3
48,"48083",6934,4800,4765,21,35,"PCTE/ELAK",8
48,"48015",33077,22441,22295,145,146,"PCTE/ELAK",24
1,"1018",1399,953,947,1,6,"PCTE/ELAK",0
48,"48046",12626,9300,9250,31,50,"PCTE/ELAK",3
48,"48058",947,682,679,2,3,"PCTE/ELAK",1
48,"48019",3429,2424,2411,14,13,"PCTE/ELAK",2
48,"48095",2324,1568,1555,13,13,"PCTE/ELAK",0
1,"1063",1852,1316,1303,6,13,"PCTE/ELAK",2
1,"1060",204,159,151,0,8,"PCTE/ELAK",1
1,"1021",471,321,319,3,2,"PCTE/ELAK",0
48,"48096",6516,4862,4816,33,46,"PCTE/ELAK",2
48,"48907",343,274,273,0,1,"PCTE/ELAK",0
48,"48076",288,211,211,1,0,"PCTE/ELAK",0
48,"48027",22745,16240,16158,74,82,"PCTE/ELAK",8
1,"1008",808,546,536,6,10,"PCTE/ELAK",1
48,"48055",2603,1833,1820,14,13,"PCTE/ELAK",1
1,"1011",213,162,160,3,2,"PCTE/ELAK",0
48,"48014",1229,845,843,8,2,"PCTE/ELAK",1
48,"48075",2066,1524,1508,9,16,"PCTE/ELAK",0
48,"48038",1151,829,829,1,0,"PCTE/ELAK",0
48,"48906",736,550,548,2,2,"PCTE/ELAK",0
48,"48093",891,669,666,5,3,"PCTE/ELAK",1
48,"48090",6004,4305,4254,28,51,"PCTE/ELAK",6
48,"48018",854,563,560,5,3,"PCTE/ELAK",2
1,"1901",2473,1633,1612,9,21,"PCTE/ELAK",3
48,"48042",1359,1055,1045,7,10,"PCTE/ELAK",1
1,"1052",272,189,186,2,3,"PCTE/ELAK",1
48,"48901",5160,3705,3684,16,21,"PCTE/ELAK",1
1,"1019",148,112,112,0,0,"PCTE/ELAK",0
1,"1036",14698,10207,10131,51,76,"PCTE/ELAK",10
1,"1006",174,124,122,1,2,"PCTE/ELAK",0
48,"48029",8681,6057,6027,41,30,"PCTE/ELAK",3
1,"1034",152,107,107,1,0,"PCTE/ELAK",0
48,"48085",10716,7707,7679,51,28,"PCTE/ELAK",8
48,"48010",476,343,343,1,0,"PCTE/ELAK",0
48,"48915",339,245,243,0,2,"PCTE/ELAK",0
1,"1027",444,273,271,0,2,"PCTE/ELAK",0
48,"48077",3366,2483,2467,9,16,"PCTE/ELAK",6
1,"1037",589,378,374,1,4,"PCTE/ELAK",1
48,"48908",250,212,210,1,2,"PCTE/ELAK",0
48,"48914",332,276,275,0,1,"PCTE/ELAK",0
48,"48089",3540,2561,2555,7,6,"PCTE/ELAK",0
48,"48071",6013,4240,4205,23,35,"PCTE/ELAK",2
1,"1020",323,228,224,1,4,"PCTE/ELAK",0
48,"48057",5730,4126,4115,14,11,"PCTE/ELAK",0
1,"1046",639,433,432,2,1,"PCTE/ELAK",0
1,"1062",318,221,219,2,2,"PCTE/ELAK",0
48,"48094",3121,2201,2188,7,13,"PCTE/ELAK",1
1,"1033",654,476,476,0,0,"PCTE/ELAK",3
1,"1032",498,363,353,1,10,"PCTE/ELAK",1
48,"48062",295,236,236,0,0,"PCTE/ELAK",0
48,"48012",2057,1610,1600,1,10,"PCTE/ELAK",2
1,"1013",710,469,465,2,4,"PCTE/ELAK",0
48,"48030",591,449,447,2,2,"PCTE/ELAK",1
1,"1042",911,680,671,8,9,"PCTE/ELAK",0
48,"48911",381,303,302,1,1,"PCTE/ELAK",0
1,"1030",141,102,102,0,0,"PCTE/ELAK",0
1,"1031",1136,844,830,1,14,"PCTE/ELAK",1
48,"48040",1303,933,926,7,7,"PCTE/ELAK",0
1,"1003",1166,843,837,6,6,"PCTE/ELAK",0
48,"48047",147,105,105,2,0,"PCTE/ELAK",0
48,"48056",980,731,728,3,3,"PCTE/ELAK",0
48,"48013",79353,53591,53205,331,386,"PCTE/ELAK",59
48,"48005",116,80,79,0,1,"PCTE/ELAK",0
48,"48002",7791,5510,5471,42,39,"PCTE/ELAK",7
1,"1056",202,107,107,0,0,"PCTE/ELAK",0
48,"48070",527,357,355,0,2,"PCTE/ELAK",0
48,"48011",9640,6753,6722,41,31,"PCTE/ELAK",1
48,"48033",217,162,162,1,0,"PCTE/ELAK",0
1,"1059",189597,128849,127910,688,939,"PCTE/ELAK",159
1,"1049",130,94,94,1,0,"PCTE/ELAK",0
1,"1004",1357,952,945,5,7,"PCTE/ELAK",2
48,"48063",354,256,252,1,4,"PCTE/ELAK",0
1,"1014",366,271,266,2,5,"PCTE/ELAK",0
48,"48003",14518,10375,10310,49,65,"PCTE/ELAK",6
48,"48006",307,242,240,3,2,"PCTE/ELAK",1
48,"48017",13121,8929,8886,45,43,"PCTE/ELAK",6
48,"48022",2305,1434,1425,11,9,"PCTE/ELAK",1
48,"48009",774,585,578,0,7,"PCTE/ELAK",0
48,"48912",2321,1684,1670,8,14,"PCTE/ELAK",1
1,"1043",2340,1487,1468,11,19,"PCTE/ELAK",0
1,"1047",982,653,642,6,11,"PCTE/ELAK",2
48,"48028",682,551,548,3,3,"PCTE/ELAK",0
48,"48904",3547,2563,2541,18,22,"PCTE/ELAK",3
48,"48054",25063,17705,17597,122,108,"PCTE/ELAK",10
48,"48903",1800,1358,1353,4,5,"PCTE/ELAK",0
48,"48072",965,730,724,3,6,"PCTE/ELAK",0
1,"1044",232,151,148,2,3,"PCTE/ELAK",0
48,"48043",4591,3337,3325,20,12,"PCTE/ELAK",1
48,"48037",696,497,485,0,12,"PCTE/ELAK",0
48,"48067",1133,810,805,0,5,"PCTE/ELAK",0
48,"48008",609,415,407,4,8,"PCTE/ELAK",1
48,"48024",1000,761,752,1,9,"PCTE/ELAK",0
48,"48061",789,602,601,2,1,"PCTE/ELAK",1
48,"48079",397,289,287,1,2,"PCTE/ELAK",0
48,"48007",389,243,243,0,0,"PCTE/ELAK",0
1,"1002",8014,5838,5786,24,52,"PCTE/ELAK",7
1,"1041",150,103,102,1,1,"PCTE/ELAK",1
48,"48031",303,221,221,0,0,"PCTE/ELAK",0
48,"48909",201,158,157,0,1,"PCTE/ELAK",0
48,"48051",220,151,150,0,1,"PCTE/ELAK",0
48,"48087",437,335,332,0,3,"PCTE/ELAK",0
1,"1057",235,196,194,0,2,"PCTE/ELAK",0
48,"48073",6827,4614,4591,38,23,"PCTE/ELAK",0
48,"48080",9916,6849,6793,44,56,"PCTE/ELAK",7
48,"48084",21780,14368,14271,79,97,"PCTE/ELAK",11
48,"48044",61957,45253,45063,299,190,"PCTE/ELAK",27
48,"48078",37858,25959,25819,157,140,"PCTE/ELAK",24
1,"1016",428,194,192,4,2,"PCTE/ELAK",0
48,"48913",1236,899,890,8,9,"PCTE/ELAK",0
1,"1902",723,485,478,8,7,"PCTE/ELAK",0
48,"48069",13131,9211,9162,55,49,"PCTE/ELAK",6
48,"48025",874,667,662,2,5,"PCTE/ELAK",0
1,"1022",755,532,523,4,9,"PCTE/ELAK",0
48,"48036",24015,16501,16425,83,76,"PCTE/ELAK",16
48,"48902",18987,12762,12670,88,92,"PCTE/ELAK",10
48,"48026",1132,834,832,2,2,"PCTE/ELAK",1
48,"48091",1078,758,757,5,1,"PCTE/ELAK",0
48,"48053",926,704,702,6,2,"PCTE/ELAK",0
1,"1039",188,150,147,2,3,"PCTE/ELAK",0
48,"48050",188,141,141,0,0,"PCTE/ELAK",0
48,"48035",406,314,314,0,0,"PCTE/ELAK",0
48,"48045",5207,3851,3817,9,34,"PCTE/ELAK",3
48,"48082",37358,25328,25167,125,161,"PCTE/ELAK",25
48,"48016",5471,3964,3935,31,29,"PCTE/ELAK",1
48,"48081",1903,1455,1447,7,8,"PCTE/ELAK",0
48,"48092",872,614,608,3,6,"PCTE/ELAK",1
48,"48905",2496,1778,1766,12,12,"PCTE/ELAK",0
1,"1017",817,537,532,3,5,"PCTE/ELAK",0
48,"48064",608,461,461,0,0,"PCTE/ELAK",0
48,"48023",579,451,448,0,3,"PCTE/ELAK",0
1,"1001",2020,1385,1372,5,13,"PCTE/ELAK",11
1,"1055",839,557,552,11,5,"PCTE/ELAK",0
48,"48032",5762,4287,4262,14,25,"PCTE/ELAK",7
48,"48004",326,245,245,1,0,"PCTE/ELAK",0
1,"1054",998,701,700,4,1,"PCTE/ELAK",0
48,"48059",402,299,297,0,2,"PCTE/ELAK",0
1,"1058",1414,893,884,1,9,"PCTE/ELAK",1
48,"48088",134,95,95,0,0,"PCTE/ELAK",1
1,"1010",2315,1705,1688,6,17,"PCTE/ELAK",3
48,"48910",2811,1952,1942,11,10,"PCTE/ELAK",1
48,"48041",687,548,547,4,1,"PCTE/ELAK",0
48,"48034",12623,8789,8711,76,78,"PCTE/ELAK",18
48,"48097",1314,886,882,6,4,"PCTE/ELAK",1
1,"1023",262,193,190,1,3,"PCTE/ELAK",0
1,"1009",1258,839,833,2,6,"PCTE/ELAK",0
1,"1028",1091,735,728,5,7,"PCTE/ELAK",0
48,"48060",3625,2429,2418,12,11,"PCTE/ELAK",0
32,"32075",4362,3117,3077,30,40,"PCTG",1
36,"36030",3921,2516,2484,31,32,"PCTG",0
27,"27034",1010,565,558,3,7,"PCTG",0
32,"32046",1089,679,670,4,9,"PCTG",0
32,"32010",364,271,267,2,4,"PCTG",0
32,"32059",1686,1099,1082,20,17,"PCTG",1
15,"15059",10229,6900,6734,85,166,"PCTG",3
32,"32047",1761,1192,1175,10,17,"PCTG",1
27,"27013",3690,2811,2766,30,45,"PCTG",0
27,"27030",3117,1945,1898,19,47,"PCTG",0
15,"15046",6157,3965,3865,23,100,"PCTG",7
15,"15901",3334,1948,1928,27,20,"PCTG",2
27,"27014",3144,2009,1985,24,24,"PCTG",0
15,"15088",3396,2047,2022,22,25,"PCTG",3
15,"15043",4944,3184,3117,27,67,"PCTG",1
32,"32083",805,498,494,3,4,"PCTG",1
32,"32002",2028,1349,1340,4,9,"PCTG",1
27,"27003",1743,1161,1134,18,27,"PCTG",0
15,"15074",3902,2629,2589,23,40,"PCTG",1
36,"36017",17364,11771,11598,123,173,"PCTG",17
36,"36009",4401,2712,2649,33,63,"PCTG",2
32,"32031",997,684,680,5,4,"PCTG",0
32,"32037",679,454,446,6,8,"PCTG",0
32,"32022",1238,840,835,10,5,"PCTG",0
36,"36902",5028,3453,3396,19,57,"PCTG",2
36,"36057",238417,165843,164264,1641,1579,"PCTG",171
32,"32087",1669,1158,1136,14,22,"PCTG",1
36,"36008",21845,14553,14373,138,180,"PCTG",26
36,"36032",3527,2407,2369,24,38,"PCTG",0
15,"15001",4697,3069,3022,45,47,"PCTG",5
15,"15076",2490,1539,1517,25,22,"PCTG",0
32,"32090",734,448,441,2,7,"PCTG",2
27,"27006",2441,1479,1460,11,19,"PCTG",1
36,"36010",2825,1983,1947,19,36,"PCTG",0
15,"15090",1115,711,701,19,10,"PCTG",2
27,"27902",7122,4472,4385,43,87,"PCTG",4
15,"15053",7469,4622,4579,44,43,"PCTG",3
36,"36019",1462,916,908,8,8,"PCTG",0
36,"36005",8105,5258,5152,54,106,"PCTG",9
32,"32053",1362,1001,989,10,12,"PCTG",1
36,"36042",18125,11975,11775,126,200,"PCTG",25
32,"32026",2655,1762,1731,17,31,"PCTG",0
36,"36007",1610,1047,1016,5,31,"PCTG",0
32,"32067",1189,696,692,4,4,"PCTG",2
15,"15056",5615,3697,3646,31,51,"PCTG",3
36,"36026",19890,13041,12891,169,150,"PCTG",9
15,"15005",25347,15441,15211,226,230,"PCTG",12
36,"36050",7645,5137,5049,48,88,"PCTG",2
15,"15021",5254,3473,3422,58,51,"PCTG",0
32,"32023",1130,787,782,2,5,"PCTG",0
36,"36043",4696,3038,3003,21,35,"PCTG",3
32,"32063",1795,1135,1119,16,16,"PCTG",3
15,"15064",2103,1458,1447,20,11,"PCTG",3
32,"32025",1014,731,718,5,13,"PCTG",0
36,"36027",4401,2940,2781,20,159,"PCTG",2
15,"15087",5710,3436,3392,31,44,"PCTG",2
32,"32092",491,280,275,0,5,"PCTG",1
32,"32035",1352,782,768,6,14,"PCTG",0
27,"27024",1447,1048,1032,6,16,"PCTG",1
36,"36029",16126,10936,10771,96,165,"PCTG",9
27,"27029",1425,925,910,11,15,"PCTG",1
15,"15017",19866,13497,13344,195,153,"PCTG",9
32,"32050",2254,1630,1612,15,18,"PCTG",1
36,"36053",5783,3955,3899,39,56,"PCTG",0
36,"36016",1069,639,633,5,6,"PCTG",0
32,"32007",1413,873,862,2,11,"PCTG",0
36,"36028",4049,2783,2739,22,44,"PCTG",4
36,"36052",7266,4772,4685,43,87,"PCTG",4
27,"27026",2299,1385,1368,9,17,"PCTG",1
32,"32085",10584,6687,6611,58,76,"PCTG",7
32,"32082",1164,736,728,11,8,"PCTG",0
15,"15035",11189,7256,7165,104,91,"PCTG",8
27,"27019",8188,5478,5395,88,83,"PCTG",3
32,"32070",495,247,238,4,9,"PCTG",0
27,"27007",2723,1822,1776,23,46,"PCTG",0
27,"27021",1632,962,935,23,27,"PCTG",0
27,"27031",15107,9759,9593,87,166,"PCTG",9
27,"27016",6958,4697,4616,50,81,"PCTG",1
15,"15070",8778,5802,5656,131,146,"PCTG",7
27,"27033",591,334,328,0,6,"PCTG",1
27,"27062",583,403,400,2,3,"PCTG",0
32,"32034",1062,763,753,6,10,"PCTG",2
32,"32066",547,396,396,0,0,"PCTG",0
27,"27037",1001,714,707,11,7,"PCTG",1
32,"32018",1181,883,871,5,12,"PCTG",0
36,"36033",12305,8759,8597,67,162,"PCTG",9
15,"15067",7933,5329,5282,43,47,"PCTG",8
36,"36039",15609,10562,10341,102,221,"PCTG",6
36,"36060",30431,19909,19673,206,236,"PCTG",6
27,"27048",1992,1317,1285,21,32,"PCTG",0
32,"32062",784,557,550,1,7,"PCTG",1
36,"36004",10109,6611,6502,79,109,"PCTG",7
32,"32091",1695,1163,1156,2,7,"PCTG",0
36,"36037",2538,1650,1625,12,25,"PCTG",0
15,"15018",1087,680,670,13,10,"PCTG",0
27,"27047",1517,955,940,12,15,"PCTG",2
32,"32074",977,642,631,2,11,"PCTG",0
27,"27002",1535,990,968,13,22,"PCTG",1
15,"15073",21725,13008,12820,126,188,"PCTG",15
36,"36013",2216,1298,1290,18,8,"PCTG",0
32,"32038",387,253,251,4,2,"PCTG",1
15,"15025",986,529,517,6,12,"PCTG",0
15,"15050",1732,931,917,15,14,"PCTG",0
32,"32011",916,512,507,3,5,"PCTG",0
32,"32032",7900,5186,5091,48,95,"PCTG",4
32,"32081",2057,1466,1445,17,21,"PCTG",0
15,"15045",3610,2057,2044,15,13,"PCTG",1
15,"15034",2712,1605,1585,15,20,"PCTG",2
15,"15077",8103,4893,4818,61,75,"PCTG",2
32,"32069",4223,3064,3023,31,41,"PCTG",3
32,"32030",945,642,641,8,1,"PCTG",0
27,"27045",926,588,583,6,5,"PCTG",0
32,"32033",667,439,436,4,3,"PCTG",0
15,"15086",2760,1829,1810,26,19,"PCTG",2
36,"36046",4073,2887,2818,31,69,"PCTG",2
15,"15004",4924,3333,3292,38,41,"PCTG",1
27,"27017",952,568,562,3,6,"PCTG",0
15,"15007",3164,2081,2060,24,21,"PCTG",0
15,"15032",3430,2243,2197,12,46,"PCTG",1
32,"32029",441,286,283,2,3,"PCTG",0
36,"36049",6990,4877,4787,40,90,"PCTG",2
32,"32014",1028,719,708,6,11,"PCTG",0
15,"15060",5871,4044,3978,58,66,"PCTG",4
36,"36003",10023,6877,6789,66,88,"PCTG",4
27,"27005",2560,1691,1662,19,29,"PCTG",1
27,"27055",1191,773,764,7,9,"PCTG",0
27,"27052",860,564,558,7,6,"PCTG",0
32,"32001",5100,3377,3333,32,44,"PCTG",3
36,"36045",24459,16966,16735,124,231,"PCTG",21
32,"32006",1418,986,970,14,16,"PCTG",0
27,"27038",923,624,619,8,5,"PCTG",0
15,"15015",2877,1845,1821,26,24,"PCTG",1
15,"15029",5354,3082,3050,46,32,"PCTG",3
36,"36001",2397,1674,1651,6,23,"PCTG",3
32,"32049",683,375,372,3,3,"PCTG",1
27,"27057",11047,7078,6941,64,137,"PCTG",5
32,"32048",846,460,458,1,2,"PCTG",0
15,"15010",1805,1047,1031,19,16,"PCTG",0
36,"36035",14615,10011,9880,103,131,"PCTG",3
15,"15044",1194,806,788,7,18,"PCTG",1
27,"27020",3365,2544,2500,42,44,"PCTG",1
27,"27051",7986,5324,5241,58,83,"PCTG",5
15,"15085",3176,2073,2047,29,26,"PCTG",1
36,"36038",66807,46235,45781,493,454,"PCTG",22
15,"15083",1029,627,614,5,13,"PCTG",0
15,"15041",9569,6362,6269,104,93,"PCTG",6
32,"32080",284,209,209,1,0,"PCTG",0
32,"32057",505,334,328,3,6,"PCTG",0
15,"15066",3995,2746,2695,29,51,"PCTG",0
32,"32003",863,632,619,3,13,"PCTG",0
27,"27901",2249,1373,1360,22,13,"PCTG",1
15,"15011",15501,9988,9846,78,142,"PCTG",13
36,"36006",11502,8057,7927,53,130,"PCTG",5
15,"15072",9434,6304,6228,48,76,"PCTG",8
36,"36059",4641,2844,2796,29,48,"PCTG",1
15,"15058",28761,20250,20098,261,152,"PCTG",7
27,"27041",2216,1463,1445,19,18,"PCTG",0
32,"32017",1193,735,724,3,11,"PCTG",0
27,"27010",4378,2719,2670,49,49,"PCTG",6
32,"32021",872,555,550,6,5,"PCTG",1
32,"32079",1280,880,869,13,11,"PCTG",1
32,"32042",1487,1010,1001,12,9,"PCTG",0
36,"36047",2248,1379,1363,11,16,"PCTG",1
15,"15009",10605,7245,7133,101,112,"PCTG",4
32,"32089",1206,740,726,8,14,"PCTG",0
32,"32072",3664,2387,2355,24,32,"PCTG",2
15,"15084",3039,2002,1981,12,21,"PCTG",1
15,"15042",2928,1879,1853,11,26,"PCTG",0
27,"27061",1018,704,683,12,21,"PCTG",0
15,"15006",5159,3008,2960,44,48,"PCTG",1
15,"15080",1637,1009,992,11,17,"PCTG",2
32,"32054",86117,56997,56376,581,621,"PCTG",49
32,"32039",1154,801,790,11,11,"PCTG",2
15,"15023",6277,4021,3968,34,53,"PCTG",1
15,"15019",25981,15866,15672,207,194,"PCTG",13
36,"36901",4154,3094,3029,21,65,"PCTG",5
32,"32020",2428,1728,1714,10,14,"PCTG",0
32,"32013",1985,1242,1230,16,12,"PCTG",3
32,"32078",1099,715,707,4,8,"PCTG",0
36,"36051",14358,9408,9255,86,153,"PCTG",7
15,"15075",12871,8751,8637,129,114,"PCTG",3
32,"32012",708,448,440,2,8,"PCTG",2
27,"27064",1505,972,951,9,21,"PCTG",1
36,"36024",16335,11431,11256,99,175,"PCTG",5
27,"27012",1264,658,650,6,8,"PCTG",1
27,"27053",497,342,334,2,8,"PCTG",0
15,"15020",3568,2226,2217,19,9,"PCTG",0
32,"32086",2531,1348,1332,11,16,"PCTG",0
15,"15071",7780,4937,4848,34,89,"PCTG",7
32,"32055",1216,781,764,10,17,"PCTG",1
32,"32077",1104,703,700,9,3,"PCTG",0
15,"15091",1097,705,686,17,19,"PCTG",0
15,"15069",6604,4587,4520,55,67,"PCTG",2
32,"32016",714,494,493,12,1,"PCTG",0
15,"15048",5087,3426,3383,40,43,"PCTG",1
15,"15033",2421,1673,1655,6,18,"PCTG",0
15,"15038",2126,1312,1296,12,16,"PCTG",1
15,"15093",4012,2413,2386,24,27,"PCTG",0
32,"32058",5247,3547,3489,30,58,"PCTG",2
27,"27042",1639,1120,1107,8,13,"PCTG",0
15,"15039",1224,802,785,9,17,"PCTG",0
32,"32061",1078,777,770,5,7,"PCTG",2
27,"27015",3995,2518,2460,25,58,"PCTG",2
27,"27046",1444,945,921,7,24,"PCTG",0
27,"27009",2005,1324,1303,11,21,"PCTG",1
36,"36020",2172,1435,1418,19,17,"PCTG",0
36,"36056",4932,3368,3310,24,58,"PCTG",7
36,"36021",12180,8188,8058,115,130,"PCTG",7
27,"27060",2434,1458,1434,17,24,"PCTG",1
36,"36041",13691,9022,8916,85,106,"PCTG",4
32,"32060",753,520,515,5,5,"PCTG",0
32,"32005",810,576,568,9,8,"PCTG",1
32,"32024",4817,3064,3014,34,50,"PCTG",6
36,"36048",5248,3429,3378,25,51,"PCTG",4
15,"15052",4070,2512,2488,18,24,"PCTG",0
15,"15013",6324,4132,4083,35,49,"PCTG",7
27,"27028",78725,52642,51965,642,677,"PCTG",45
27,"27027",1791,1198,1167,17,31,"PCTG",2
15,"15028",1392,944,936,4,8,"PCTG",1
27,"27035",183,110,110,3,0,"PCTG",0
15,"15079",1437,887,868,8,19,"PCTG",2
36,"36031",563,426,420,7,6,"PCTG",0
32,"32073",1273,863,857,6,6,"PCTG",0
32,"32041",752,462,458,4,4,"PCTG",0
15,"15003",1675,1029,1020,9,9,"PCTG",1
36,"36015",4079,2653,2606,29,47,"PCTG",3
15,"15024",4314,2859,2790,44,69,"PCTG",2
15,"15081",976,713,695,4,18,"PCTG",2
32,"32008",8647,5570,5495,56,75,"PCTG",10
15,"15049",1068,752,747,7,5,"PCTG",0
32,"32019",11469,7336,7225,98,111,"PCTG",7
36,"36054",11107,7027,6894,57,133,"PCTG",5
32,"32065",633,422,419,8,3,"PCTG",1
32,"32044",794,547,540,2,7,"PCTG",0
36,"36002",3049,1994,1968,22,26,"PCTG",2
15,"15054",31805,19579,19321,335,258,"PCTG",15
27,"27066",12588,8116,7954,109,162,"PCTG",7
27,"27044",2703,1495,1463,15,32,"PCTG",2
36,"36018",3033,1951,1926,9,25,"PCTG",2
15,"15057",12077,8109,8018,83,91,"PCTG",6
27,"27043",1222,746,737,12,9,"PCTG",1
15,"15055",4446,2829,2762,50,67,"PCTG",2
32,"32056",1490,1009,1003,10,6,"PCTG",0
15,"15040",2647,1779,1762,15,17,"PCTG",2
15,"15082",15446,10821,10687,130,134,"PCTG",12
32,"32076",1935,1320,1306,15,14,"PCTG",0
36,"36034",3299,2155,2132,15,23,"PCTG",5
27,"27056",1218,787,778,6,9,"PCTG",0
36,"36025",2127,1235,1221,5,14,"PCTG",1
32,"32009",10558,6621,6549,50,72,"PCTG",9
15,"15089",4299,2924,2887,41,37,"PCTG",3
32,"32045",2346,1604,1579,20,25,"PCTG",0
27,"27054",1135,807,782,5,25,"PCTG",0
36,"36022",9046,5834,5720,37,114,"PCTG",9
32,"32028",1537,1012,1004,5,8,"PCTG",0
27,"27022",4654,2760,2696,20,64,"PCTG",1
32,"32064",453,304,302,0,2,"PCTG",0
36,"36036",2546,1763,1742,14,21,"PCTG",2
36,"36055",13585,9177,8986,115,191,"PCTG",8
32,"32027",989,670,660,5,10,"PCTG",0
27,"27040",3008,2071,2046,21,25,"PCTG",1
32,"32036",1242,856,838,14,18,"PCTG",1
15,"15022",5580,3508,3472,47,36,"PCTG",2
27,"27065",12055,7566,7379,119,187,"PCTG",7
32,"32084",878,532,527,8,5,"PCTG",1
27,"27008",1326,865,853,5,12,"PCTG",1
27,"27063",1699,1131,1109,7,22,"PCTG",1
15,"15031",23868,16113,15954,207,159,"PCTG",13
15,"15014",3836,2191,2158,27,33,"PCTG",2
27,"27032",3197,1979,1956,30,23,"PCTG",1
27,"27001",2187,1111,1102,17,9,"PCTG",0
27,"27039",4467,3179,3121,47,58,"PCTG",3
15,"15008",5646,3859,3836,52,23,"PCTG",1
15,"15068",4824,2976,2937,54,39,"PCTG",3
15,"15037",4026,2375,2349,10,26,"PCTG",3
32,"32043",2497,1607,1582,14,25,"PCTG",0
27,"27049",1324,847,829,8,18,"PCTG",1
27,"27023",2453,1674,1644,25,30,"PCTG",0
36,"36058",4957,3043,2994,55,49,"PCTG",0
27,"27058",3283,2275,2241,12,34,"PCTG",2
15,"15047",2256,1429,1405,25,24,"PCTG",1
32,"32040",1400,1001,990,10,11,"PCTG",1
15,"15030",199701,137611,136590,1540,1021,"PCTG",86
32,"32052",1817,1278,1268,12,10,"PCTG",0
32,"32088",1636,955,944,17,11,"PCTG",1
27,"27018",3211,1830,1800,17,30,"PCTG",0
27,"27011",2341,1387,1362,7,25,"PCTG",1
27,"27025",2731,2047,2006,18,41,"PCTG",0
27,"27059",2035,1356,1322,7,34,"PCTG",0
27,"27050",2821,1980,1954,11,26,"PCTG",0
15,"15002",24040,16302,16117,183,185,"PCTG",7
15,"15016",4558,2747,2705,16,42,"PCTG",1
36,"36044",2527,1535,1499,12,36,"PCTG",1
15,"15062",5597,3406,3360,16,46,"PCTG",4
32,"32068",1401,882,878,4,4,"PCTG",3
32,"32004",1608,835,824,5,11,"PCTG",0
32,"32015",817,454,452,2,2,"PCTG",1
15,"15051",4545,2978,2945,47,33,"PCTG",3
36,"36061",8613,5822,5718,56,104,"PCTG",5
32,"32071",1351,821,814,6,7,"PCTG",2
36,"36014",1867,1265,1243,16,22,"PCTG",2
27,"27004",1143,640,625,2,15,"PCTG",0
15,"15065",7134,4869,4785,53,84,"PCTG",3
15,"15027",1563,1159,1140,23,19,"PCTG",1
15,"15078",78810,55693,55183,569,510,"PCTG",34
15,"15061",5149,3221,3168,44,53,"PCTG",2
15,"15092",6220,3810,3756,30,54,"PCTG",1
15,"15036",56053,36487,36175,501,312,"PCTG",50
36,"36023",8258,5504,5384,44,120,"PCTG",6
15,"15012",3603,2484,2422,20,62,"PCTG",1
15,"15902",4507,2885,2837,34,48,"PCTG",2
36,"36040",2505,1597,1563,15,34,"PCTG",1
32,"32051",1369,1062,1058,13,4,"PCTG",0
19,"19241",35,26,25,2,1,"PDSJE",1
19,"19288",21,20,20,2,0,"PDSJE",0
40,"40179",620,500,490,3,10,"PDSJE",0
19,"19112",53,35,34,0,1,"PDSJE",0
40,"40127",36,25,23,0,2,"PDSJE",0
40,"40138",2102,1585,1565,13,20,"PDSJE",4
19,"19156",917,686,679,2,7,"PDSJE",0
2,"2901",2196,1441,1419,10,22,"PDSJE",1
19,"19168",265,182,175,4,7,"PDSJE",0
40,"40177",139,106,105,0,1,"PDSJE",0
19,"19209",40,30,29,0,1,"PDSJE",1
40,"40189",471,344,329,1,15,"PDSJE",0
35,"35025",1752,1113,1095,5,18,"PDSJE",1
19,"19195",36,26,25,2,1,"PDSJE",0
40,"40219",573,382,366,5,16,"PDSJE",0
40,"40186",35,29,29,0,0,"PDSJE",0
19,"19258",84,63,62,0,1,"PDSJE",0
40,"40015",23,19,19,0,0,"PDSJE",0
40,"40025",129,109,107,1,2,"PDSJE",0
40,"40174",319,229,227,3,2,"PDSJE",0
40,"40204",145,102,101,0,1,"PDSJE",0
35,"35002",24229,15311,15133,101,178,"PDSJE",17
2,"2017",760,498,493,1,5,"PDSJE",0
40,"40149",479,345,338,3,7,"PDSJE",1
19,"19153",22,20,20,2,0,"PDSJE",1
19,"19023",119,87,85,0,2,"PDSJE",0
40,"40199",101,76,72,2,4,"PDSJE",0
19,"19261",33,23,23,0,0,"PDSJE",0
40,"40216",785,633,621,9,12,"PDSJE",0
19,"19232",56,40,40,0,0,"PDSJE",0
19,"19136",11,10,10,0,0,"PDSJE",0
19,"19107",306,245,244,0,1,"PDSJE",0
19,"19132",86,65,63,0,2,"PDSJE",0
2,"2069",11401,8055,7975,30,80,"PDSJE",3
19,"19274",953,693,676,9,17,"PDSJE",1
40,"40010",108,83,82,0,1,"PDSJE",0
40,"40140",76,54,54,0,0,"PDSJE",0
19,"19066",51,42,42,0,0,"PDSJE",0
19,"19178",27,17,16,0,1,"PDSJE",0
19,"19114",30,22,21,1,1,"PDSJE",0
40,"40198",24,20,19,0,1,"PDSJE",0
19,"19009",263,186,184,0,2,"PDSJE",0
40,"40089",209,155,148,2,7,"PDSJE",0
40,"40055",31,26,26,0,0,"PDSJE",0
40,"40054",108,79,78,3,1,"PDSJE",0
40,"40157",39,30,30,0,0,"PDSJE",0
40,"40108",109,85,85,2,0,"PDSJE",0
40,"40069",68,59,59,0,0,"PDSJE",0
40,"40043",1773,1376,1345,21,31,"PDSJE",1
19,"19135",90,71,69,1,2,"PDSJE",0
19,"19045",122,97,96,0,1,"PDSJE",0
2,"2064",371,288,283,2,5,"PDSJE",0
19,"19231",10,6,6,0,0,"PDSJE",0
19,"19078",47,37,36,0,1,"PDSJE",0
19,"19177",60,45,45,0,0,"PDSJE",0
40,"40222",161,134,131,1,3,"PDSJE",0
19,"19303",41,32,32,0,0,"PDSJE",0
2,"2055",1055,672,668,2,4,"PDSJE",0
19,"19055",44,32,31,2,1,"PDSJE",0
19,"19006",755,506,494,4,12,"PDSJE",1
19,"19251",39,30,30,0,0,"PDSJE",0
35,"35018",13153,7742,7674,80,68,"PDSJE",7
2,"2002",427,340,337,2,3,"PDSJE",0
19,"19021",978,678,662,3,16,"PDSJE",0
2,"2003",134196,96374,95521,913,853,"PDSJE",114
35,"35012",10862,5617,5568,40,49,"PDSJE",12
40,"40159",130,94,93,2,1,"PDSJE",0
19,"19224",106,83,83,1,0,"PDSJE",0
19,"19125",45,23,23,0,0,"PDSJE",0
40,"40082",104,84,84,2,0,"PDSJE",0
40,"40057",1397,1081,1067,15,14,"PDSJE",4
2,"2025",7345,5388,5278,51,110,"PDSJE",4
40,"40004",436,330,319,2,11,"PDSJE",0
40,"40205",228,159,157,1,2,"PDSJE",0
19,"19270",14,13,13,0,0,"PDSJE",0
19,"19301",37,26,26,0,0,"PDSJE",0
19,"19099",286,179,175,1,4,"PDSJE",0
19,"19221",31,22,22,1,0,"PDSJE",0
19,"19076",29,23,23,0,0,"PDSJE",0
40,"40087",85,70,70,0,0,"PDSJE",0
2,"2047",110,83,81,0,2,"PDSJE",0
2,"2005",554,426,419,8,7,"PDSJE",0
19,"19008",36,30,30,0,0,"PDSJE",0
19,"19061",56,42,41,0,1,"PDSJE",0
19,"19103",247,205,202,1,3,"PDSJE",0
40,"40145",1098,824,820,4,4,"PDSJE",0
19,"19067",68,46,44,0,2,"PDSJE",0
2,"2033",1864,1352,1315,12,37,"PDSJE",2
35,"35022",51765,29309,29034,184,275,"PDSJE",42
19,"19201",60,44,44,0,0,"PDSJE",0
19,"19304",224,169,166,3,3,"PDSJE",0
19,"19230",558,409,406,1,3,"PDSJE",1
40,"40151",43,31,31,0,0,"PDSJE",0
19,"19227",68,42,41,1,1,"PDSJE",0
35,"35010",3853,2224,2194,18,30,"PDSJE",1
19,"19268",50,37,35,0,2,"PDSJE",0
40,"40234",375,278,269,3,9,"PDSJE",1
40,"40005",25,23,23,1,0,"PDSJE",0
35,"35015",10752,5289,5222,39,67,"PDSJE",7
40,"40044",134,101,101,3,0,"PDSJE",0
2,"2032",259,183,178,2,5,"PDSJE",0
19,"19171",5380,3964,3919,22,45,"PDSJE",4
19,"19285",20,16,16,0,0,"PDSJE",0
19,"19257",3279,2233,2206,21,27,"PDSJE",5
40,"40112",2813,2126,2087,26,39,"PDSJE",2
19,"19190",2284,1632,1613,16,19,"PDSJE",0
40,"40225",1085,822,809,5,13,"PDSJE",0
19,"19176",227,172,172,0,0,"PDSJE",0
19,"19167",129,104,103,1,1,"PDSJE",0
2,"2011",556,429,427,1,2,"PDSJE",0
19,"19048",19,14,13,1,1,"PDSJE",0
19,"19092",395,286,279,2,7,"PDSJE",0
40,"40146",260,206,204,0,2,"PDSJE",0
40,"40156",272,194,190,4,4,"PDSJE",0
2,"2058",300,186,177,1,9,"PDSJE",0
19,"19115",29,23,23,0,0,"PDSJE",0
19,"19300",782,591,588,5,3,"PDSJE",1
19,"19324",164,122,120,4,2,"PDSJE",0
19,"19263",21,15,15,0,0,"PDSJE",0
19,"19080",67,47,47,0,0,"PDSJE",0
19,"19335",51,39,38,0,1,"PDSJE",0
2,"2066",222,165,163,1,2,"PDSJE",0
2,"2035",1946,1494,1473,5,21,"PDSJE",0
40,"40056",31,21,20,0,1,"PDSJE",0
2,"2021",1013,806,798,6,8,"PDSJE",2
2,"2065",441,368,361,0,7,"PDSJE",1
19,"19228",27,17,17,1,0,"PDSJE",0
40,"40061",63,47,44,0,3,"PDSJE",0
40,"40078",150,123,123,6,0,"PDSJE",0
19,"19193",22,21,21,1,0,"PDSJE",0
40,"40212",26,19,19,1,0,"PDSJE",0
35,"35008",6214,4193,4143,33,50,"PDSJE",0
40,"40904",344,286,284,8,2,"PDSJE",1
2,"2046",1125,892,870,12,22,"PDSJE",0
19,"19199",19,15,15,0,0,"PDSJE",0
19,"19040",53,43,42,1,1,"PDSJE",0
19,"19161",212,158,157,3,1,"PDSJE",0
40,"40093",74,62,62,1,0,"PDSJE",0
2,"2054",375,288,283,0,5,"PDSJE",0
40,"40142",52,39,37,0,2,"PDSJE",0
19,"19133",78,64,64,2,0,"PDSJE",0
19,"19334",43,35,35,0,0,"PDSJE",1
40,"40135",277,212,210,3,2,"PDSJE",0
40,"40130",127,95,87,1,8,"PDSJE",0
40,"40035",135,110,110,2,0,"PDSJE",0
19,"19267",20,15,14,0,1,"PDSJE",0
19,"19327",385,313,308,2,5,"PDSJE",0
19,"19089",23,17,17,0,0,"PDSJE",0
19,"19302",52,42,42,1,0,"PDSJE",1
2,"2031",535,406,401,4,5,"PDSJE",0
35,"35016",300581,181532,179831,1458,1701,"PDSJE",352
2,"2028",111,81,81,0,0,"PDSJE",0
2,"2036",93,66,66,0,0,"PDSJE",0
19,"19020",46,31,31,0,0,"PDSJE",0
19,"19031",8,8,8,0,0,"PDSJE",0
19,"19079",7,6,6,0,0,"PDSJE",0
19,"19064",64,56,56,0,0,"PDSJE",0
40,"40109",69,51,50,3,1,"PDSJE",0
40,"40036",496,395,380,8,15,"PDSJE",0
40,"40007",68,55,55,1,0,"PDSJE",0
40,"40017",83,71,68,2,3,"PDSJE",0
19,"19036",242,202,200,1,2,"PDSJE",0
19,"19310",7,7,7,0,0,"PDSJE",0
40,"40075",152,116,116,0,0,"PDSJE",0
19,"19299",100,72,71,1,1,"PDSJE",0
19,"19282",138,107,106,0,1,"PDSJE",0
19,"19041",163,118,117,1,1,"PDSJE",0
40,"40154",22,18,18,1,0,"PDSJE",0
19,"19150",116,89,89,0,0,"PDSJE",0
40,"40079",229,160,159,2,1,"PDSJE",0
19,"19181",50,34,34,0,0,"PDSJE",0
19,"19297",32,28,28,0,0,"PDSJE",0
19,"19106",77,57,57,0,0,"PDSJE",0
40,"40160",93,65,62,0,3,"PDSJE",0
40,"40191",198,143,138,0,5,"PDSJE",0
40,"40173",140,120,118,2,2,"PDSJE",0
19,"19052",21,16,16,0,0,"PDSJE",0
2,"2026",834,644,633,4,11,"PDSJE",0
40,"40141",822,584,568,9,16,"PDSJE",0
35,"35005",1009,680,668,2,12,"PDSJE",2
40,"40178",85,61,60,0,1,"PDSJE",0
40,"40120",195,169,163,0,6,"PDSJE",1
2,"2006",573,425,424,1,1,"PDSJE",0
40,"40134",692,522,509,10,13,"PDSJE",1
19,"19160",883,535,530,11,5,"PDSJE",0
19,"19240",49,36,36,0,0,"PDSJE",0
40,"40215",79,66,66,2,0,"PDSJE",0
40,"40152",732,575,565,10,10,"PDSJE",0
40,"40076",6576,4700,4607,32,93,"PDSJE",7
19,"19211",350,272,269,0,3,"PDSJE",2
19,"19111",160,128,125,0,3,"PDSJE",0
19,"19102",88,75,73,0,2,"PDSJE",0
40,"40053",79,56,56,1,0,"PDSJE",0
19,"19196",89,70,67,1,3,"PDSJE",0
2,"2014",354,254,252,3,2,"PDSJE",0
40,"40045",119,93,93,1,0,"PDSJE",0
2,"2050",85,66,66,1,0,"PDSJE",0
40,"40072",224,175,171,1,4,"PDSJE",0
19,"19286",772,585,575,3,10,"PDSJE",0
19,"19197",28,22,22,1,0,"PDSJE",0
40,"40903",75,61,59,0,2,"PDSJE",0
19,"19266",229,184,182,1,2,"PDSJE",0
19,"19039",56,48,48,2,0,"PDSJE",0
40,"40083",73,52,52,1,0,"PDSJE",0
40,"40131",51,45,45,0,0,"PDSJE",0
40,"40002",32,22,21,0,1,"PDSJE",0
2,"2080",498,358,352,0,6,"PDSJE",0
40,"40121",249,188,178,1,10,"PDSJE",0
19,"19105",2550,1913,1889,10,24,"PDSJE",7
19,"19086",1371,1003,996,9,7,"PDSJE",0
40,"40063",6913,4948,4838,57,110,"PDSJE",5
35,"35030",10046,5584,5505,44,79,"PDSJE",8
40,"40104",283,203,200,0,3,"PDSJE",0
35,"35023",11742,7787,7651,95,136,"PDSJE",12
19,"19216",127,88,88,0,0,"PDSJE",0
40,"40088",272,192,192,0,0,"PDSJE",1
40,"40020",149,112,111,1,1,"PDSJE",0
40,"40126",67,44,42,0,2,"PDSJE",0
40,"40136",102,79,77,3,2,"PDSJE",0
19,"19187",42,32,32,0,0,"PDSJE",0
19,"19244",74,55,55,3,0,"PDSJE",0
19,"19237",39,34,34,0,0,"PDSJE",0
19,"19090",90,69,68,1,1,"PDSJE",1
40,"40162",380,273,265,1,8,"PDSJE",0
2,"2043",1165,872,858,6,14,"PDSJE",0
40,"40012",241,160,156,7,4,"PDSJE",0
19,"19124",378,230,229,2,1,"PDSJE",0
19,"19269",86,61,61,0,0,"PDSJE",0
19,"19051",61,52,52,0,0,"PDSJE",0
40,"40086",656,513,496,7,17,"PDSJE",0
19,"19332",85,59,57,4,2,"PDSJE",0
19,"19157",53,37,37,0,0,"PDSJE",0
19,"19060",157,123,122,0,1,"PDSJE",0
19,"19329",58,46,46,0,0,"PDSJE",1
19,"19017",56,47,47,0,0,"PDSJE",0
19,"19203",29,25,25,0,0,"PDSJE",0
19,"19146",47,35,35,0,0,"PDSJE",0
40,"40021",18,15,15,0,0,"PDSJE",0
19,"19293",1945,1402,1388,19,14,"PDSJE",1
19,"19200",66,53,52,0,1,"PDSJE",0
35,"35033",6393,4147,4072,38,75,"PDSJE",6
19,"19189",114,87,84,0,3,"PDSJE",0
19,"19208",39,32,32,0,0,"PDSJE",1
2,"2019",2352,1806,1766,9,40,"PDSJE",0
35,"35029",4415,2498,2472,29,26,"PDSJE",2
40,"40166",251,201,201,0,0,"PDSJE",0
19,"19042",22,18,17,0,1,"PDSJE",0
19,"19212",678,501,491,1,10,"PDSJE",0
2,"2041",316,238,236,0,2,"PDSJE",0
40,"40030",419,317,314,3,3,"PDSJE",0
19,"19331",2677,1892,1841,18,51,"PDSJE",2
40,"40047",37,23,23,0,0,"PDSJE",0
40,"40184",245,196,194,0,2,"PDSJE",0
19,"19075",58,38,37,3,1,"PDSJE",0
40,"40033",70,55,52,1,3,"PDSJE",0
35,"35028",10156,5483,5425,56,58,"PDSJE",3
19,"19234",44,30,30,0,0,"PDSJE",0
19,"19247",140,103,102,1,1,"PDSJE",0
19,"19119",76,65,65,0,0,"PDSJE",0
40,"40071",39,32,26,0,6,"PDSJE",0
40,"40128",123,88,87,1,1,"PDSJE",0
40,"40070",143,94,92,1,2,"PDSJE",0
40,"40048",35,27,27,0,0,"PDSJE",0
19,"19046",22204,16001,15752,156,249,"PDSJE",36
40,"40013",57,47,47,0,0,"PDSJE",0
40,"40118",46,32,32,1,0,"PDSJE",0
40,"40018",73,50,50,0,0,"PDSJE",0
19,"19005",91,63,62,0,1,"PDSJE",0
40,"40084",52,41,41,2,0,"PDSJE",0
19,"19027",129,97,95,1,2,"PDSJE",0
19,"19145",40,32,32,0,0,"PDSJE",0
19,"19015",82,74,73,1,1,"PDSJE",0
2,"2077",52,41,41,0,0,"PDSJE",0
40,"40182",169,112,112,1,0,"PDSJE",0
40,"40101",918,672,665,11,7,"PDSJE",2
40,"40230",93,66,64,0,2,"PDSJE",0
40,"40124",234,169,164,0,5,"PDSJE",0
19,"19250",16,12,12,0,0,"PDSJE",0
40,"40060",67,40,40,1,0,"PDSJE",0
2,"2013",125,90,88,0,2,"PDSJE",0
40,"40051",34,25,25,0,0,"PDSJE",0
40,"40208",724,546,543,5,3,"PDSJE",0
35,"35007",517,347,345,2,2,"PDSJE",1
40,"40099",54,44,42,0,2,"PDSJE",0
2,"2082",98,80,80,0,0,"PDSJE",0
35,"35011",24859,15025,14833,149,192,"PDSJE",19
40,"40224",18,15,15,0,0,"PDSJE",0
2,"2081",18287,12910,12675,130,235,"PDSJE",7
19,"19307",25,23,23,0,0,"PDSJE",0
40,"40119",166,133,132,2,1,"PDSJE",0
40,"40028",103,88,87,2,1,"PDSJE",0
19,"19215",135,109,109,0,0,"PDSJE",0
35,"35020",5941,3740,3702,27,38,"PDSJE",2
40,"40214",198,160,154,0,6,"PDSJE",0
2,"2020",425,336,332,4,4,"PDSJE",0
19,"19287",134,100,98,2,2,"PDSJE",0
40,"40203",987,753,740,13,13,"PDSJE",2
40,"40052",72,55,55,0,0,"PDSJE",0
2,"2073",4825,3433,3394,35,39,"PDSJE",0
40,"40202",56,33,33,0,0,"PDSJE",0
2,"2044",1040,665,656,5,9,"PDSJE",0
19,"19235",98,77,76,1,1,"PDSJE",0
40,"40039",180,133,133,0,0,"PDSJE",0
19,"19074",67,57,57,1,0,"PDSJE",0
19,"19175",29,18,17,1,1,"PDSJE",0
2,"2023",504,419,412,0,7,"PDSJE",0
19,"19289",23,16,16,0,0,"PDSJE",0
19,"19238",43,30,28,0,2,"PDSJE",0
19,"19255",74,37,37,0,0,"PDSJE",0
2,"2040",548,476,474,1,2,"PDSJE",0
19,"19308",57,49,49,0,0,"PDSJE",0
19,"19186",76,60,60,0,0,"PDSJE",1
40,"40181",4182,3102,3038,35,64,"PDSJE",5
19,"19319",4609,3303,3273,22,30,"PDSJE",4
19,"19233",79,65,65,2,0,"PDSJE",1
40,"40103",139,113,113,0,0,"PDSJE",0
19,"19071",8277,5838,5763,53,75,"PDSJE",10
40,"40211",66,54,54,1,0,"PDSJE",0
40,"40188",83,63,60,0,3,"PDSJE",0
19,"19279",54,42,42,0,0,"PDSJE",0
19,"19191",13,12,12,0,0,"PDSJE",0
40,"40155",3897,2920,2880,56,40,"PDSJE",5
19,"19333",96,68,67,0,1,"PDSJE",0
35,"35021",15072,9791,9696,80,95,"PDSJE",11
19,"19118",11,10,9,0,1,"PDSJE",0
19,"19182",37,32,32,0,0,"PDSJE",0
19,"19192",1762,1251,1240,5,11,"PDSJE",2
19,"19317",124,83,82,0,1,"PDSJE",0
40,"40228",493,362,361,3,1,"PDSJE",0
19,"19188",36,31,31,0,0,"PDSJE",0
19,"19087",17,16,16,0,0,"PDSJE",0
35,"35027",10502,6831,6750,67,81,"PDSJE",17
40,"40029",25,21,19,0,2,"PDSJE",0
19,"19174",90,65,64,0,1,"PDSJE",0
40,"40074",246,193,189,2,4,"PDSJE",0
40,"40195",776,573,565,4,8,"PDSJE",3
2,"2059",320,225,217,0,8,"PDSJE",0
19,"19162",67,41,41,0,0,"PDSJE",0
19,"19163",60,49,49,0,0,"PDSJE",0
2,"2062",382,261,256,2,5,"PDSJE",0
19,"19003",36,30,30,0,0,"PDSJE",0
19,"19002",55,45,45,0,0,"PDSJE",0
19,"19314",44,33,33,0,0,"PDSJE",0
2,"2010",1784,1374,1349,12,25,"PDSJE",1
19,"19185",26,15,15,1,0,"PDSJE",0
19,"19290",851,551,550,4,1,"PDSJE",2
19,"19219",9,8,7,0,1,"PDSJE",0
19,"19264",33,25,25,0,0,"PDSJE",0
40,"40024",823,582,575,8,7,"PDSJE",2
40,"40032",368,247,244,5,3,"PDSJE",0
19,"19309",20,15,14,0,1,"PDSJE",0
2,"2042",810,581,577,1,4,"PDSJE",1
2,"2068",323,239,239,3,0,"PDSJE",0
40,"40201",42,37,37,0,0,"PDSJE",0
40,"40168",27,20,20,0,0,"PDSJE",0
40,"40223",235,177,174,1,3,"PDSJE",1
19,"19148",42,29,28,1,1,"PDSJE",0
19,"19091",23,17,17,0,0,"PDSJE",0
2,"2027",274,209,203,1,6,"PDSJE",0
19,"19070",65,45,45,0,0,"PDSJE",0
2,"2053",2888,2086,2042,14,44,"PDSJE",1
40,"40113",404,308,304,2,4,"PDSJE",1
19,"19213",67,53,52,1,1,"PDSJE",0
40,"40213",93,78,78,1,0,"PDSJE",0
19,"19034",25,22,21,0,1,"PDSJE",0
19,"19278",24,20,20,0,0,"PDSJE",0
2,"2086",2389,1567,1554,10,13,"PDSJE",2
19,"19049",8,8,7,0,1,"PDSJE",0
19,"19326",2463,1671,1650,13,21,"PDSJE",2
19,"19298",53,43,41,0,2,"PDSJE",0
40,"40125",76,48,46,0,2,"PDSJE",0
19,"19013",111,89,89,0,0,"PDSJE",0
2,"2070",373,306,301,6,5,"PDSJE",0
2,"2072",1528,981,958,7,23,"PDSJE",0
40,"40097",130,103,102,5,1,"PDSJE",0
19,"19110",51,39,39,0,0,"PDSJE",0
19,"19109",33,26,26,2,0,"PDSJE",0
19,"19116",12,10,10,0,0,"PDSJE",0
40,"40046",83,67,67,1,0,"PDSJE",0
19,"19019",14,11,11,1,0,"PDSJE",0
19,"19291",1143,803,794,2,9,"PDSJE",5
19,"19097",14,14,13,0,1,"PDSJE",0
2,"2016",528,353,352,4,1,"PDSJE",0
2,"2039",945,745,734,8,11,"PDSJE",0
19,"19280",3669,2622,2597,24,25,"PDSJE",4
19,"19294",26,18,18,0,0,"PDSJE",0
19,"19122",81,62,60,2,2,"PDSJE",0
40,"40906",2149,1701,1662,18,39,"PDSJE",5
19,"19256",46,36,36,0,0,"PDSJE",0
40,"40207",802,593,590,11,3,"PDSJE",2
2,"2076",313,233,230,2,3,"PDSJE",0
40,"40058",306,244,240,1,4,"PDSJE",0
40,"40231",100,79,76,0,3,"PDSJE",0
40,"40006",22,19,19,0,0,"PDSJE",0
40,"40105",43,35,35,0,0,"PDSJE",0
19,"19245",1138,798,778,6,20,"PDSJE",1
19,"19121",265,205,204,0,1,"PDSJE",0
40,"40170",1302,962,948,6,14,"PDSJE",0
19,"19222",95,70,70,2,0,"PDSJE",0
19,"19120",107,86,86,1,0,"PDSJE",0
2,"2037",22963,14737,14588,68,149,"PDSJE",26
40,"40143",82,68,67,2,1,"PDSJE",0
19,"19166",154,110,108,0,2,"PDSJE",0
19,"19259",28,22,22,0,0,"PDSJE",0
40,"40123",141,98,94,4,4,"PDSJE",0
40,"40144",16,15,15,0,0,"PDSJE",0
40,"40905",130,95,95,0,0,"PDSJE",0
19,"19252",56,44,44,0,0,"PDSJE",0
19,"19202",16,13,13,1,0,"PDSJE",0
35,"35032",3331,2293,2252,23,41,"PDSJE",2
40,"40094",353,265,263,3,2,"PDSJE",0
40,"40132",45,26,25,0,1,"PDSJE",0
19,"19265",134,97,97,5,0,"PDSJE",0
40,"40019",29,23,23,1,0,"PDSJE",0
19,"19323",36,26,26,0,0,"PDSJE",0
2,"2022",341,243,243,2,0,"PDSJE",0
35,"35026",83172,48751,48109,449,642,"PDSJE",78
19,"19143",1781,1278,1266,18,12,"PDSJE",4
35,"35014",11962,5994,5888,60,106,"PDSJE",4
19,"19016",57,40,40,0,0,"PDSJE",0
19,"19325",154,86,86,1,0,"PDSJE",0
19,"19044",275,186,182,0,4,"PDSJE",0
19,"19142",263,179,179,1,0,"PDSJE",0
19,"19054",161,136,135,3,1,"PDSJE",0
40,"40192",134,106,105,1,1,"PDSJE",0
19,"19022",592,423,420,6,3,"PDSJE",2
35,"35019",32830,18390,18243,87,147,"PDSJE",18
40,"40077",966,718,704,10,14,"PDSJE",4
40,"40016",55,44,43,1,1,"PDSJE",0
19,"19004",59,44,44,0,0,"PDSJE",0
2,"2052",466,371,370,6,1,"PDSJE",0
19,"19901",35,27,27,0,0,"PDSJE",0
2,"2024",3361,2444,2411,24,33,"PDSJE",1
35,"35034",8392,3946,3908,27,38,"PDSJE",3
19,"19223",99,66,65,1,1,"PDSJE",0
19,"19330",69,62,62,0,0,"PDSJE",0
40,"40150",60,42,42,0,0,"PDSJE",0
40,"40115",142,100,100,0,0,"PDSJE",0
19,"19165",45,39,39,0,0,"PDSJE",0
19,"19226",37,22,22,0,0,"PDSJE",0
40,"40129",159,119,117,2,2,"PDSJE",0
19,"19130",61556,45926,45388,408,538,"PDSJE",82
2,"2074",5890,4054,4010,39,44,"PDSJE",4
40,"40193",219,156,155,3,1,"PDSJE",3
40,"40221",50,38,35,0,3,"PDSJE",0
19,"19272",66,55,55,2,0,"PDSJE",0
35,"35017",27498,15513,15240,121,273,"PDSJE",13
19,"19043",99,80,79,0,1,"PDSJE",0
2,"2067",1137,808,794,2,14,"PDSJE",4
40,"40158",15,11,11,0,0,"PDSJE",0
19,"19184",59,47,47,0,0,"PDSJE",0
2,"2083",209,181,181,0,0,"PDSJE",0
40,"40001",708,544,536,3,8,"PDSJE",1
19,"19284",10,10,10,0,0,"PDSJE",0
19,"19152",540,377,374,2,3,"PDSJE",0
19,"19104",19,15,14,0,1,"PDSJE",0
19,"19210",18,16,16,0,0,"PDSJE",0
40,"40163",42,35,35,1,0,"PDSJE",0
40,"40014",56,39,38,0,1,"PDSJE",1
35,"35006",31373,20764,20476,189,288,"PDSJE",27
40,"40233",399,279,273,0,6,"PDSJE",0
19,"19179",74,64,64,3,0,"PDSJE",0
40,"40165",73,53,52,0,1,"PDSJE",0
19,"19058",7458,5705,5663,40,42,"PDSJE",6
2,"2007",1017,757,746,5,11,"PDSJE",0
2,"2084",298,197,191,2,6,"PDSJE",0
2,"2029",3333,2363,2320,13,43,"PDSJE",2
19,"19154",58,45,45,0,0,"PDSJE",0
19,"19088",91,67,66,0,1,"PDSJE",0
40,"40190",43,37,35,0,2,"PDSJE",0
19,"19037",131,109,108,0,1,"PDSJE",0
40,"40095",453,341,329,2,12,"PDSJE",0
2,"2034",1323,1024,1018,6,6,"PDSJE",0
19,"19170",189,115,115,1,0,"PDSJE",0
40,"40218",80,56,55,0,1,"PDSJE",0
40,"40122",524,398,392,2,6,"PDSJE",0
19,"19169",30,27,27,0,0,"PDSJE",0
40,"40049",37,27,27,0,0,"PDSJE",0
40,"40037",30,17,17,0,0,"PDSJE",0
19,"19254",43,34,34,0,0,"PDSJE",0
19,"19001",43,32,32,0,0,"PDSJE",0
40,"40008",42,36,36,1,0,"PDSJE",0
19,"19277",15,10,10,0,0,"PDSJE",0
19,"19225",851,618,611,2,7,"PDSJE",1
19,"19322",26,20,19,1,1,"PDSJE",0
40,"40148",231,165,163,4,2,"PDSJE",0
19,"19010",9,9,9,0,0,"PDSJE",0
19,"19050",15,13,13,0,0,"PDSJE",0
40,"40068",22,21,21,0,0,"PDSJE",0
40,"40164",186,131,130,0,1,"PDSJE",0
40,"40206",162,126,123,0,3,"PDSJE",0
19,"19073",16,15,15,1,0,"PDSJE",0
19,"19198",17,14,14,0,0,"PDSJE",0
19,"19117",1632,1187,1167,12,20,"PDSJE",6
19,"19246",42,27,27,1,0,"PDSJE",1
40,"40210",97,69,69,1,0,"PDSJE",0
19,"19218",43,31,31,0,0,"PDSJE",0
19,"19155",64,49,49,0,0,"PDSJE",0
19,"19032",145,94,93,2,1,"PDSJE",2
19,"19098",20,17,17,0,0,"PDSJE",0
40,"40176",372,288,287,2,1,"PDSJE",0
2,"2001",687,513,505,1,8,"PDSJE",0
40,"40229",26,22,22,0,0,"PDSJE",0
40,"40111",50,39,39,0,0,"PDSJE",0
19,"19139",26,19,19,2,0,"PDSJE",0
2,"2056",1640,1204,1179,11,25,"PDSJE",0
19,"19134",23,14,14,0,0,"PDSJE",0
19,"19159",87,73,72,1,1,"PDSJE",0
40,"40180",276,215,210,2,5,"PDSJE",0
19,"19129",25,21,21,0,0,"PDSJE",0
19,"19018",142,112,112,1,0,"PDSJE",0
19,"19243",34,32,31,1,1,"PDSJE",0
2,"2008",1103,737,722,8,15,"PDSJE",0
40,"40026",112,101,99,0,2,"PDSJE",0
19,"19283",29,26,26,0,0,"PDSJE",0
19,"19024",8561,6015,5942,44,73,"PDSJE",15
2,"2012",1835,1462,1420,9,42,"PDSJE",0
19,"19065",109,86,85,1,1,"PDSJE",0
19,"19260",38,27,27,1,0,"PDSJE",0
40,"40110",316,237,234,4,3,"PDSJE",0
19,"19127",88,60,60,1,0,"PDSJE",0
19,"19296",29,24,24,0,0,"PDSJE",0
40,"40194",39173,28641,28260,353,381,"PDSJE",44
40,"40081",117,80,76,1,4,"PDSJE",0
19,"19271",41,22,21,1,1,"PDSJE",0
35,"35003",5644,2987,2943,20,44,"PDSJE",5
2,"2018",789,611,606,3,5,"PDSJE",0
40,"40172",47,33,32,0,1,"PDSJE",0
2,"2075",1700,1357,1347,6,10,"PDSJE",0
40,"40034",74,59,58,0,1,"PDSJE",0
19,"19033",47,38,37,1,1,"PDSJE",0
19,"19281",19,18,18,0,0,"PDSJE",0
35,"35001",4566,3148,3105,18,43,"PDSJE",3
19,"19108",95,78,78,0,0,"PDSJE",2
2,"2057",1947,1358,1333,15,25,"PDSJE",1
40,"40003",116,82,79,3,3,"PDSJE",0
40,"40073",387,327,323,1,4,"PDSJE",0
40,"40062",56,43,42,0,1,"PDSJE",0
40,"40183",117,105,99,1,6,"PDSJE",0
40,"40092",105,75,75,2,0,"PDSJE",0
2,"2009",19495,13877,13663,134,214,"PDSJE",7
19,"19229",58,53,53,0,0,"PDSJE",0
19,"19194",91,69,69,0,0,"PDSJE",0
35,"35031",7456,4938,4868,39,70,"PDSJE",8
19,"19204",150,105,104,3,1,"PDSJE",2
35,"35024",14323,8360,8289,81,71,"PDSJE",4
40,"40022",195,144,141,2,3,"PDSJE",0
19,"19123",37,30,28,0,2,"PDSJE",0
19,"19214",74,51,51,0,0,"PDSJE",0
2,"2049",778,506,496,1,10,"PDSJE",2
40,"40031",546,410,406,3,4,"PDSJE",0
19,"19321",34,28,28,0,0,"PDSJE",0
2,"2085",306,232,226,2,6,"PDSJE",0
35,"35013",6593,4596,4516,47,80,"PDSJE",2
40,"40200",38,28,28,0,0,"PDSJE",0
2,"2015",1432,1163,1148,8,15,"PDSJE",0
2,"2079",2807,2000,1978,17,22,"PDSJE",1
19,"19126",1701,1223,1207,6,16,"PDSJE",0
35,"35009",20229,13378,13201,95,177,"PDSJE",8
19,"19249",29,26,26,0,0,"PDSJE",0
19,"19311",85,60,59,0,1,"PDSJE",0
35,"35004",41975,20773,20602,156,171,"PDSJE",14
2,"2060",1268,953,939,7,14,"PDSJE",1
19,"19173",47,40,40,0,0,"PDSJE",0
40,"40059",109,92,91,2,1,"PDSJE",0
19,"19183",70,59,58,0,1,"PDSJE",0
2,"2038",262,197,193,0,4,"PDSJE",0
40,"40106",179,140,139,2,1,"PDSJE",0
19,"19318",26,18,18,0,0,"PDSJE",0
19,"19095",11,7,6,0,1,"PDSJE",0
40,"40901",413,320,315,7,5,"PDSJE",0
2,"2051",1654,1115,1101,13,14,"PDSJE",0
40,"40065",467,338,329,1,9,"PDSJE",0
19,"19147",42,32,32,0,0,"PDSJE",0
2,"2078",891,650,642,4,8,"PDSJE",0
19,"19306",24,18,18,0,0,"PDSJE",0
19,"19053",1906,1323,1304,12,19,"PDSJE",1
2,"2061",605,464,458,3,6,"PDSJE",0
19,"19081",27,21,21,0,0,"PDSJE",0
40,"40161",32,24,23,1,1,"PDSJE",0
40,"40107",90,67,67,0,0,"PDSJE",0
2,"2071",1027,800,795,7,5,"PDSJE",1
19,"19011",237,165,162,3,3,"PDSJE",0
40,"40080",51,31,31,0,0,"PDSJE",0
2,"2045",3609,2797,2752,38,45,"PDSJE",0
40,"40171",40,32,32,1,0,"PDSJE",0
40,"40040",2489,1766,1744,26,22,"PDSJE",3
19,"19113",454,327,322,4,5,"PDSJE",0
2,"2048",1173,912,901,9,11,"PDSJE",0
40,"40196",30,24,24,0,0,"PDSJE",0
19,"19038",19,16,15,0,1,"PDSJE",0
19,"19217",43,36,36,0,0,"PDSJE",1
40,"40902",113,78,76,1,2,"PDSJE",0
19,"19047",55,47,47,1,0,"PDSJE",0
19,"19082",100,72,71,1,1,"PDSJE",0
19,"19059",73,47,47,0,0,"PDSJE",0
19,"19138",215,158,154,4,4,"PDSJE",0
40,"40185",800,560,553,4,7,"PDSJE",0
19,"19248",73,54,54,0,0,"PDSJE",0
2,"2063",1358,987,973,3,14,"PDSJE",0
19,"19096",105,72,70,0,2,"PDSJE",0
19,"19262",125,98,98,0,0,"PDSJE",0
40,"40220",64,46,45,0,1,"PDSJE",0
19,"19057",69,51,51,0,0,"PDSJE",0
40,"40100",262,208,204,4,4,"PDSJE",0
19,"19151",1077,703,693,8,10,"PDSJE",0
40,"40041",966,729,716,8,13,"PDSJE",0
19,"19007",433,316,310,1,6,"PDSJE",2
40,"40091",109,87,85,0,2,"PDSJE",0
40,"40009",41,35,34,0,1,"PDSJE",0
2,"2004",597,459,455,3,4,"PDSJE",0
19,"19172",51,38,38,0,0,"PDSJE",0
19,"19305",139,104,103,1,1,"PDSJE",0
2,"2030",2949,2158,2122,16,36,"PDSJE",3
19,"19239",93,70,70,1,0,"PDSJE",0
19,"19220",2608,1673,1653,10,20,"PDSJE",5
40,"40139",255,194,192,2,2,"PDSJE",0
19,"19242",74,53,53,1,0,"PDSJE",1
33,"33043",656,408,401,2,7,"PH",0
28,"28007",127491,96937,96102,810,835,"PH",57
28,"28066",7575,5771,5718,58,53,"PH",2
35,"35022",51765,29309,29034,184,275,"PH",16
35,"35033",6393,4147,4072,38,75,"PH",4
35,"35030",10046,5584,5505,44,79,"PH",5
28,"28159",589,455,447,4,8,"PH",0
28,"28170",2495,1714,1695,13,19,"PH",1
28,"28049",57814,44977,44559,385,418,"PH",40
28,"28067",4416,3359,3311,18,48,"PH",0
33,"33015",1396,849,842,7,7,"PH",1
28,"28013",41661,29431,29168,241,263,"PH",13
28,"28094",988,711,707,5,4,"PH",1
28,"28092",153631,112460,111341,913,1119,"PH",83
28,"28115",62612,50619,50431,399,188,"PH",19
33,"33078",127,81,81,0,0,"PH",0
33,"33042",4237,2862,2816,49,46,"PH",2
35,"35004",41975,20773,20602,156,171,"PH",3
28,"28083",9836,7278,7206,64,72,"PH",6
28,"28118",61,52,50,0,2,"PH",0
28,"28178",1149,869,853,4,16,"PH",0
33,"33064",240,151,151,0,0,"PH",0
28,"28132",12197,8622,8537,75,85,"PH",13
28,"28113",36951,27912,27604,241,308,"PH",17
28,"28063",252,188,187,1,1,"PH",0
28,"28152",16986,13444,13366,111,78,"PH",11
28,"28065",131232,100864,99883,846,981,"PH",71
33,"33001",1475,758,753,15,5,"PH",1
28,"28019",1272,926,914,6,12,"PH",0
33,"33030",876,632,630,8,2,"PH",0
35,"35023",11742,7787,7651,95,136,"PH",4
28,"28902",521,394,389,3,5,"PH",1
33,"33021",4304,2643,2610,32,33,"PH",2
28,"28179",1451,1043,1033,6,10,"PH",0
28,"28155",487,374,369,0,5,"PH",0
28,"28166",357,281,276,1,5,"PH",0
33,"33061",344,174,174,1,0,"PH",0
28,"28183",1162,823,813,9,10,"PH",0
35,"35015",10752,5289,5222,39,67,"PH",1
28,"28055",944,636,627,4,9,"PH",0
28,"28011",417,295,292,6,3,"PH",0
28,"28175",940,740,730,2,10,"PH",1
28,"28080",49866,39769,39583,346,186,"PH",10
33,"33035",11214,7359,7303,102,56,"PH",7
33,"33025",8956,5493,5453,81,40,"PH",2
28,"28138",60,43,42,0,1,"PH",0
33,"33047",1068,771,759,9,12,"PH",0
28,"28161",52164,38607,38193,306,414,"PH",18
33,"33023",3249,2127,2097,30,30,"PH",1
28,"28095",1719,1236,1226,5,10,"PH",0
28,"28160",8709,6507,6460,62,47,"PH",4
33,"33008",1679,1140,1133,10,7,"PH",1
28,"28038",5213,3801,3753,24,48,"PH",0
33,"33037",33074,20693,20412,259,281,"PH",14
28,"28014",34522,25016,24748,229,268,"PH",24
28,"28112",160,129,129,0,0,"PH",0
28,"28148",89174,65500,64784,566,716,"PH",57
35,"35008",6214,4193,4143,33,50,"PH",1
28,"28144",6525,5032,4987,39,45,"PH",9
28,"28121",209,156,152,1,4,"PH",0
28,"28157",690,471,467,1,4,"PH",1
28,"28021",571,365,364,1,1,"PH",0
28,"28024",168,137,136,2,1,"PH",0
28,"28059",4516,3343,3299,30,44,"PH",2
33,"33069",3379,2249,2231,41,18,"PH",2
28,"28075",6020,4521,4469,37,52,"PH",9
28,"28156",1082,788,784,3,4,"PH",1
33,"33031",33775,20484,20184,276,300,"PH",10
28,"28123",62178,49883,49515,397,368,"PH",25
28,"28174",1858,1284,1273,1,11,"PH",1
28,"28134",63936,48022,47631,421,391,"PH",44
28,"28062",306,232,227,0,5,"PH",0
28,"28110",2029,1498,1478,9,20,"PH",0
28,"28180",5317,4011,3959,35,52,"PH",2
28,"28043",6190,4031,3969,33,62,"PH",3
33,"33026",8201,5014,4974,74,40,"PH",2
33,"33032",11056,7052,6905,109,147,"PH",1
28,"28070",105,80,80,3,0,"PH",0
28,"28029",576,443,443,4,0,"PH",2
28,"28169",1577,1214,1209,7,5,"PH",1
33,"33039",1646,1118,1110,8,8,"PH",1
28,"28146",1806,1232,1218,3,14,"PH",0
28,"28048",514,386,384,4,2,"PH",0
28,"28088",296,196,191,1,5,"PH",0
35,"35005",1009,680,668,2,12,"PH",0
28,"28901",890,624,618,5,6,"PH",1
28,"28027",1215,836,826,8,10,"PH",0
35,"35009",20229,13378,13201,95,177,"PH",5
28,"28172",9915,7715,7652,60,63,"PH",2
35,"35024",14323,8360,8289,81,71,"PH",5
28,"28145",2671,1927,1895,21,32,"PH",2
28,"28086",5446,3643,3600,19,43,"PH",1
35,"35017",27498,15513,15240,121,273,"PH",9
28,"28061",22757,17091,16965,115,126,"PH",8
28,"28031",2129,1501,1486,8,15,"PH",0
33,"33076",12115,7519,7456,76,63,"PH",2
28,"28124",73,51,50,0,1,"PH",0
28,"28058",141836,104142,103011,896,1131,"PH",101
33,"33065",1077,670,657,11,13,"PH",0
28,"28022",37338,30620,30455,229,165,"PH",21
35,"35027",10502,6831,6750,67,81,"PH",2
28,"28116",748,576,569,2,7,"PH",0
33,"33046",480,334,329,0,5,"PH",0
28,"28045",35523,26213,25966,212,247,"PH",22
28,"28091",5491,3709,3650,20,59,"PH",5
35,"35018",13153,7742,7674,80,68,"PH",7
33,"33029",315,145,142,1,3,"PH",0
28,"28056",946,664,660,2,4,"PH",1
33,"33034",9979,5937,5873,64,64,"PH",2
28,"28154",5570,3999,3961,29,38,"PH",3
35,"35032",3331,2293,2252,23,41,"PH",0
33,"33059",4359,2651,2625,33,26,"PH",0
33,"33053",1078,602,599,10,3,"PH",0
33,"33007",1382,804,795,4,9,"PH",0
28,"28047",42984,30772,30486,270,286,"PH",28
28,"28040",16741,10717,10604,79,113,"PH",8
28,"28060",1585,1160,1146,5,14,"PH",0
35,"35014",11962,5994,5888,60,106,"PH",7
28,"28023",5159,4052,4019,27,33,"PH",2
28,"28129",8589,6397,6338,46,59,"PH",3
28,"28016",79,55,55,0,0,"PH",0
28,"28028",1836,1374,1363,3,11,"PH",0
33,"33050",548,316,314,1,2,"PH",0
33,"33010",1722,1085,1069,15,16,"PH",0
28,"28017",1280,975,963,10,12,"PH",0
33,"33005",1357,832,825,11,7,"PH",3
28,"28054",11943,8800,8731,72,69,"PH",6
28,"28025",405,294,291,5,3,"PH",0
33,"33052",681,418,416,3,2,"PH",1
35,"35006",31373,20764,20476,189,288,"PH",17
35,"35016",300581,181532,179831,1458,1701,"PH",123
33,"33036",11281,7240,7153,96,87,"PH",5
28,"28903",35555,28875,28671,341,204,"PH",22
28,"28041",4805,3666,3634,38,32,"PH",1
33,"33057",1525,1005,988,17,17,"PH",1
28,"28072",6176,4716,4673,44,43,"PH",2
33,"33020",12981,8550,8453,120,97,"PH",5
33,"33077",1097,688,683,4,5,"PH",0
33,"33019",2844,1702,1680,11,22,"PH",0
33,"33009",878,545,542,4,3,"PH",0
28,"28082",6110,4622,4581,41,41,"PH",2
28,"28035",1404,981,966,4,15,"PH",0
28,"28004",6618,4502,4457,28,45,"PH",4
33,"33003",603,322,317,7,5,"PH",0
28,"28114",141,97,97,0,0,"PH",0
33,"33041",7101,4564,4513,58,51,"PH",2
33,"33006",1476,862,857,9,5,"PH",0
28,"28167",8640,6564,6504,51,60,"PH",2
35,"35002",24229,15311,15133,101,178,"PH",6
33,"33072",1443,816,814,8,2,"PH",1
28,"28128",453,334,331,1,3,"PH",0
28,"28150",3191,2423,2401,13,22,"PH",1
33,"33044",177059,121380,120421,1543,959,"PH",85
28,"28093",2177,1681,1658,11,23,"PH",0
28,"28003",167,133,131,4,2,"PH",0
28,"28135",998,712,703,2,9,"PH",0
35,"35001",4566,3148,3105,18,43,"PH",1
33,"33054",1601,1025,1010,17,15,"PH",1
33,"33060",13991,8629,8481,109,148,"PH",6
28,"28140",3156,2359,2331,16,28,"PH",5
28,"28036",2699,1977,1957,20,20,"PH",0
28,"28089",3856,2866,2829,21,37,"PH",0
28,"28100",4482,3146,3113,21,33,"PH",1
35,"35011",24859,15025,14833,149,192,"PH",9
28,"28153",816,547,544,3,3,"PH",0
28,"28107",442,316,310,5,6,"PH",0
28,"28119",2294,1760,1738,12,22,"PH",3
28,"28037",1570,1135,1123,4,12,"PH",0
33,"33024",224741,151660,150461,1597,1199,"PH",90
28,"28120",1220,910,897,5,13,"PH",1
28,"28090",9252,7216,7153,58,63,"PH",5
28,"28079",2384271,1765443,1753633,13854,11810,"PH",1198
35,"35025",1752,1113,1095,5,18,"PH",1
28,"28018",4121,3174,3151,22,23,"PH",1
33,"33012",5085,3158,3142,27,16,"PH",2
28,"28001",70,48,47,1,1,"PH",0
35,"35012",10862,5617,5568,40,49,"PH",0
28,"28051",1644,1231,1220,9,11,"PH",4
33,"33071",546,385,383,7,2,"PH",0
28,"28127",66793,53258,53009,458,249,"PH",27
28,"28053",6956,5475,5414,44,61,"PH",3
33,"33004",65304,43473,43153,563,320,"PH",31
33,"33022",802,460,452,4,8,"PH",1
28,"28147",991,702,698,4,4,"PH",0
28,"28164",3230,2371,2345,28,26,"PH",0
28,"28143",77,58,58,0,0,"PH",0
28,"28099",1950,1409,1404,16,5,"PH",0
33,"33066",42818,27780,27466,425,314,"PH",20
28,"28005",136518,101397,100485,871,912,"PH",77
28,"28133",6146,4245,4180,25,65,"PH",3
28,"28131",13510,9647,9544,89,103,"PH",9
28,"28109",1651,1131,1116,8,15,"PH",0
28,"28125",3208,2275,2252,5,23,"PH",1
28,"28096",20022,14440,14238,115,202,"PH",6
28,"28122",578,404,401,1,3,"PH",0
35,"35029",4415,2498,2472,29,26,"PH",1
33,"33063",375,269,267,5,2,"PH",0
28,"28006",80903,60936,60508,482,428,"PH",49
33,"33067",751,543,538,7,5,"PH",0
35,"35031",7456,4938,4868,39,70,"PH",0
28,"28084",16243,11562,11408,90,154,"PH",11
28,"28137",1770,1300,1289,6,11,"PH",1
28,"28163",429,332,326,0,6,"PH",0
28,"28097",126,87,87,2,0,"PH",0
28,"28158",694,501,495,2,6,"PH",0
28,"28009",14593,11026,10913,73,113,"PH",8
28,"28039",134,93,93,1,0,"PH",0
28,"28102",880,639,621,7,18,"PH",0
28,"28068",11740,8615,8543,72,72,"PH",7
28,"28101",226,174,172,1,2,"PH",0
33,"33068",1031,518,510,5,8,"PH",0
28,"28106",78872,54111,53443,412,668,"PH",56
35,"35021",15072,9791,9696,80,95,"PH",3
28,"28074",141137,106626,105602,885,1024,"PH",97
33,"33033",9381,5848,5770,88,78,"PH",2
28,"28151",3274,2344,2310,16,34,"PH",2
28,"28044",6266,4693,4642,36,51,"PH",3
28,"28071",63,46,45,0,1,"PH",0
33,"33051",6787,4318,4268,48,50,"PH",6
28,"28078",40,38,38,0,0,"PH",0
35,"35010",3853,2224,2194,18,30,"PH",1
28,"28069",58,44,42,1,2,"PH",0
33,"33016",18848,12845,12737,173,108,"PH",10
28,"28012",929,707,698,7,9,"PH",0
33,"33058",1668,1050,1035,13,15,"PH",1
35,"35019",32830,18390,18243,87,147,"PH",5
28,"28052",3961,2700,2659,14,41,"PH",1
28,"28149",6298,4751,4699,35,52,"PH",6
33,"33055",1485,992,966,14,26,"PH",4
35,"35007",517,347,345,2,2,"PH",1
33,"33017",2969,1787,1768,38,19,"PH",1
33,"33045",4359,2819,2787,32,32,"PH",0
28,"28177",10851,8550,8485,89,65,"PH",3
33,"33048",132,86,85,1,1,"PH",0
33,"33073",8096,4377,4320,59,57,"PH",1
33,"33011",10563,5646,5578,92,68,"PH",3
33,"33038",2218,1501,1477,17,24,"PH",1
33,"33075",244,125,122,3,3,"PH",0
28,"28087",3301,2539,2519,20,20,"PH",1
28,"28126",50,36,36,0,0,"PH",0
28,"28010",10649,8167,8098,76,69,"PH",2
35,"35034",8392,3946,3908,27,38,"PH",0
28,"28020",193,96,93,0,3,"PH",0
28,"28176",13980,10765,10701,72,64,"PH",6
28,"28181",20801,16353,16243,97,110,"PH",6
28,"28008",2008,1333,1323,7,10,"PH",0
33,"33018",2804,1830,1806,30,24,"PH",2
28,"28030",1832,1319,1297,13,22,"PH",0
35,"35020",5941,3740,3702,27,38,"PH",3
28,"28165",1917,1339,1321,2,18,"PH",1
28,"28168",1347,933,918,6,15,"PH",0
28,"28130",28569,22050,21799,187,251,"PH",20
33,"33056",4850,3068,3044,25,24,"PH",5
35,"35026",83172,48751,48109,449,642,"PH",24
33,"33013",430,294,292,1,2,"PH",0
28,"28108",3736,2681,2652,21,29,"PH",5
28,"28104",15528,12342,12234,103,108,"PH",6
33,"33074",3366,2042,2011,35,31,"PH",0
28,"28182",203,167,163,1,4,"PH",0
33,"33040",4556,2837,2784,58,53,"PH",2
28,"28117",99,87,86,0,1,"PH",0
28,"28064",125,98,95,3,3,"PH",0
33,"33070",3267,2211,2185,27,26,"PH",0
28,"28171",4410,2921,2889,8,32,"PH",0
28,"28050",4406,3202,3167,29,35,"PH",1
28,"28057",1556,1155,1141,7,14,"PH",0
33,"33028",1143,519,518,7,1,"PH",0
28,"28032",5090,3716,3675,22,41,"PH",3
33,"33027",752,412,405,11,7,"PH",1
28,"28034",368,258,255,0,3,"PH",0
33,"33002",9403,5920,5839,69,81,"PH",4
28,"28073",12707,9198,9080,94,118,"PH",4
28,"28026",6767,5058,5024,27,34,"PH",3
28,"28173",523,384,381,1,3,"PH",0
33,"33062",385,194,187,4,7,"PH",0
33,"33014",8735,5744,5689,67,55,"PH",3
28,"28111",629,479,475,2,4,"PH",0
28,"28042",1261,918,908,9,10,"PH",0
28,"28136",693,538,533,2,5,"PH",0
35,"35013",6593,4596,4516,47,80,"PH",5
28,"28046",4824,3726,3707,33,19,"PH",1
35,"35003",5644,2987,2943,20,44,"PH",2
33,"33049",5973,3569,3518,48,51,"PH",1
28,"28076",432,330,327,4,3,"PH",0
35,"35028",10156,5483,5425,56,58,"PH",0
28,"28085",4194,3126,3091,24,35,"PH",3
28,"28002",3250,2261,2243,14,18,"PH",2
28,"28033",4177,2972,2936,20,36,"PH",0
28,"28141",6284,4617,4570,42,47,"PH",4
28,"28015",20885,16237,16104,134,133,"PH",12
28,"28162",2784,2143,2131,20,12,"PH",1
3,"3004",603,425,423,2,2,"P-LIB",0
40,"40079",229,160,159,2,1,"P-LIB",0
40,"40179",620,500,490,3,10,"P-LIB",0
3,"3069",3329,2102,2077,11,25,"P-LIB",0
16,"16175",5071,3807,3732,43,75,"P-LIB",0
40,"40109",69,51,50,3,1,"P-LIB",0
5,"5010",142,102,100,2,2,"P-LIB",0
40,"40146",260,206,204,0,2,"P-LIB",0
5,"5035",92,68,68,0,0,"P-LIB",0
40,"40016",55,44,43,1,1,"P-LIB",0
40,"40080",51,31,31,0,0,"P-LIB",0
39,"39032",1420,1032,1027,7,5,"P-LIB",0
16,"16242",300,245,243,2,2,"P-LIB",0
16,"16061",939,746,727,16,19,"P-LIB",1
16,"16161",51,44,44,1,0,"P-LIB",0
5,"5126",60,47,45,0,2,"P-LIB",0
5,"5224",102,85,84,2,1,"P-LIB",0
40,"40188",83,63,60,0,3,"P-LIB",0
5,"5176",221,163,159,0,4,"P-LIB",0
5,"5082",491,379,369,2,10,"P-LIB",0
3,"3060",105,78,77,0,1,"P-LIB",0
3,"3001",337,260,258,0,2,"P-LIB",0
16,"16089",381,292,289,8,3,"P-LIB",1
3,"3012",1138,863,846,4,17,"P-LIB",1
3,"3128",4285,2849,2819,18,30,"P-LIB",2
5,"5138",283,218,217,1,1,"P-LIB",0
40,"40086",656,513,496,7,17,"P-LIB",0
40,"40156",272,194,190,4,4,"P-LIB",0
3,"3903",2612,1838,1814,7,24,"P-LIB",1
39,"39069",1934,1475,1458,2,17,"P-LIB",1
40,"40206",162,126,123,0,3,"P-LIB",0
40,"40214",198,160,154,0,6,"P-LIB",0
7,"7017",899,604,596,10,8,"P-LIB",1
5,"5018",23,17,17,2,0,"P-LIB",0
16,"16225",55,30,30,0,0,"P-LIB",0
39,"39060",6704,4959,4887,23,72,"P-LIB",1
16,"16099",179,108,105,0,3,"P-LIB",0
39,"39056",2262,1683,1671,14,12,"P-LIB",0
7,"7051",5484,3133,3094,43,39,"P-LIB",1
7,"7003",12521,6457,6381,60,76,"P-LIB",3
3,"3056",8588,6219,6135,29,84,"P-LIB",1
5,"5199",37,31,31,0,0,"P-LIB",0
16,"16199",27,18,18,0,0,"P-LIB",0
39,"39022",970,673,668,2,5,"P-LIB",0
5,"5046",38,35,35,0,0,"P-LIB",0
5,"5166",155,108,104,1,4,"P-LIB",0
5,"5036",118,91,90,0,1,"P-LIB",0
5,"5180",76,55,53,0,2,"P-LIB",1
5,"5073",282,210,207,1,3,"P-LIB",0
39,"39001",2063,1474,1467,5,7,"P-LIB",2
40,"40204",145,102,101,0,1,"P-LIB",0
7,"7039",5019,3066,3017,23,49,"P-LIB",3
39,"39053",212,133,133,4,0,"P-LIB",0
40,"40004",436,330,319,2,11,"P-LIB",0
39,"39004",1479,1050,1031,5,19,"P-LIB",0
3,"3041",6132,4204,4167,22,37,"P-LIB",6
16,"16079",28,16,16,0,0,"P-LIB",0
39,"39065",222,166,163,0,3,"P-LIB",0
7,"7048",18455,9929,9858,116,71,"P-LIB",8
5,"5201",497,404,401,0,3,"P-LIB",0
39,"39072",325,184,182,0,2,"P-LIB",0
7,"7037",3448,1875,1856,18,19,"P-LIB",1
5,"5133",61,44,43,0,1,"P-LIB",0
16,"16007",1153,857,847,3,10,"P-LIB",0
40,"40069",68,59,59,0,0,"P-LIB",0
3,"3009",46125,33613,33319,315,294,"P-LIB",15
40,"40185",800,560,553,4,7,"P-LIB",0
5,"5129",111,70,69,0,1,"P-LIB",0
3,"3034",1404,1028,1010,5,18,"P-LIB",0
40,"40022",195,144,141,2,3,"P-LIB",0
39,"39079",8850,6247,6175,28,72,"P-LIB",0
40,"40014",56,39,38,0,1,"P-LIB",0
40,"40111",50,39,39,0,0,"P-LIB",0
7,"7014",7885,3934,3893,43,41,"P-LIB",4
16,"16125",1607,1166,1150,11,16,"P-LIB",0
5,"5234",45,38,38,0,0,"P-LIB",0
7,"7019",161,104,102,0,2,"P-LIB",0
16,"16060",715,519,513,3,6,"P-LIB",0
40,"40091",109,87,85,0,2,"P-LIB",0
16,"16253",308,230,228,2,2,"P-LIB",0
5,"5213",94,72,70,0,2,"P-LIB",0
5,"5222",140,118,118,0,0,"P-LIB",0
16,"16095",82,70,70,1,0,"P-LIB",0
5,"5221",322,231,231,0,0,"P-LIB",0
3,"3033",101,82,78,0,4,"P-LIB",0
5,"5170",47,34,34,1,0,"P-LIB",0
5,"5104",33,21,19,0,2,"P-LIB",0
39,"39028",3892,2905,2878,20,27,"P-LIB",1
16,"16224",72,60,58,0,2,"P-LIB",0
5,"5015",68,45,44,1,1,"P-LIB",0
16,"16139",317,226,222,1,4,"P-LIB",1
16,"16157",183,150,148,0,2,"P-LIB",0
40,"40015",23,19,19,0,0,"P-LIB",0
40,"40901",413,320,315,7,5,"P-LIB",0
16,"16018",376,290,290,2,0,"P-LIB",0
16,"16122",244,184,182,1,2,"P-LIB",0
16,"16112",1466,972,957,12,15,"P-LIB",0
40,"40165",73,53,52,0,1,"P-LIB",0
5,"5063",31,26,26,0,0,"P-LIB",0
40,"40033",70,55,52,1,3,"P-LIB",0
5,"5094",133,105,105,0,0,"P-LIB",0
40,"40199",101,76,72,2,4,"P-LIB",0
3,"3089",9496,6617,6484,51,133,"P-LIB",1
5,"5200",41,26,26,0,0,"P-LIB",0
7,"7015",22248,12375,12286,202,89,"P-LIB",14
5,"5093",362,251,249,0,2,"P-LIB",0
5,"5102",1681,1252,1228,8,24,"P-LIB",0
39,"39085",7017,5029,4992,23,37,"P-LIB",2
16,"16047",214,154,148,3,6,"P-LIB",0
3,"3140",26036,18637,18267,237,370,"P-LIB",3
40,"40122",524,398,392,2,6,"P-LIB",0
5,"5241",3062,2011,1977,21,34,"P-LIB",3
40,"40138",2102,1585,1565,13,20,"P-LIB",1
5,"5097",464,309,305,0,4,"P-LIB",0
16,"16195",458,343,338,0,5,"P-LIB",0
16,"16012",76,66,66,0,0,"P-LIB",0
40,"40087",85,70,70,0,0,"P-LIB",0
40,"40121",249,188,178,1,10,"P-LIB",0
40,"40154",22,18,18,1,0,"P-LIB",0
39,"39038",1512,992,983,5,9,"P-LIB",0
7,"7036",28132,18650,18510,222,140,"P-LIB",9
3,"3032",97,82,82,0,0,"P-LIB",0
16,"16084",48,34,30,1,4,"P-LIB",0
5,"5140",99,83,81,0,2,"P-LIB",0
5,"5030",40,32,32,0,0,"P-LIB",0
5,"5141",95,79,78,1,1,"P-LIB",0
7,"7052",4853,2765,2743,33,22,"P-LIB",2
39,"39076",3512,2517,2491,13,26,"P-LIB",2
40,"40231",100,79,76,0,3,"P-LIB",0
40,"40076",6576,4700,4607,32,93,"P-LIB",4
7,"7040",289448,169300,167908,1594,1392,"P-LIB",166
3,"3028",959,780,767,7,13,"P-LIB",0
40,"40219",573,382,366,5,16,"P-LIB",0
39,"39050",260,164,164,1,0,"P-LIB",0
5,"5025",78,65,65,0,0,"P-LIB",0
40,"40170",1302,962,948,6,14,"P-LIB",0
5,"5113",62,42,42,0,0,"P-LIB",0
16,"16903",992,750,732,8,18,"P-LIB",0
5,"5239",215,163,163,3,0,"P-LIB",0
5,"5207",645,485,478,4,7,"P-LIB",0
7,"7046",16884,9184,9097,97,87,"P-LIB",8
39,"39044",3921,2805,2783,18,22,"P-LIB",1
40,"40205",228,159,157,1,2,"P-LIB",1
5,"5148",22,19,19,0,0,"P-LIB",0
5,"5086",76,58,58,1,0,"P-LIB",0
7,"7006",5393,3257,3220,34,37,"P-LIB",2
3,"3137",654,449,443,7,6,"P-LIB",2
16,"16185",36,31,31,0,0,"P-LIB",0
40,"40044",134,101,101,3,0,"P-LIB",0
16,"16198",1281,938,928,6,10,"P-LIB",1
3,"3123",7579,5491,5416,50,75,"P-LIB",2
16,"16100",642,518,514,2,4,"P-LIB",0
3,"3085",271,229,227,5,2,"P-LIB",0
39,"39030",1874,1199,1187,6,12,"P-LIB",1
16,"16146",85,49,49,0,0,"P-LIB",0
39,"39097",666,342,335,2,7,"P-LIB",0
3,"3022",140,125,121,1,4,"P-LIB",0
40,"40012",241,160,156,7,4,"P-LIB",0
16,"16159",198,135,135,2,0,"P-LIB",0
40,"40174",319,229,227,3,2,"P-LIB",0
5,"5260",95,73,73,0,0,"P-LIB",0
5,"5165",361,266,261,4,5,"P-LIB",0
40,"40047",37,23,23,0,0,"P-LIB",0
5,"5243",80,57,56,1,1,"P-LIB",0
7,"7013",7353,4725,4639,43,86,"P-LIB",2
3,"3059",20710,14788,14685,89,103,"P-LIB",13
16,"16272",201,149,147,2,2,"P-LIB",0
5,"5105",330,247,242,2,5,"P-LIB",0
16,"16231",45,38,38,0,0,"P-LIB",0
5,"5119",24,17,17,1,0,"P-LIB",0
3,"3068",41,38,37,0,1,"P-LIB",0
16,"16254",199,159,159,0,0,"P-LIB",0
16,"16266",356,269,265,4,4,"P-LIB",0
3,"3107",2785,1766,1746,13,20,"P-LIB",1
5,"5076",468,376,367,1,9,"P-LIB",0
16,"16055",669,429,426,0,3,"P-LIB",0
40,"40057",1397,1081,1067,15,14,"P-LIB",0
16,"16121",227,160,152,0,8,"P-LIB",0
39,"39095",2266,1637,1619,8,18,"P-LIB",0
40,"40070",143,94,92,1,2,"P-LIB",0
40,"40025",129,109,107,1,2,"P-LIB",0
40,"40903",75,61,59,0,2,"P-LIB",0
40,"40097",130,103,102,5,1,"P-LIB",0
3,"3015",12818,9127,9017,46,110,"P-LIB",7
7,"7032",21005,12039,11928,114,111,"P-LIB",11
5,"5026",183,149,147,1,2,"P-LIB",0
3,"3050",19420,13210,13116,70,94,"P-LIB",10
16,"16259",28,22,22,0,0,"P-LIB",0
39,"39051",73,64,64,1,0,"P-LIB",0
40,"40213",93,78,78,1,0,"P-LIB",0
40,"40101",918,672,665,11,7,"P-LIB",0
3,"3040",264,227,221,1,6,"P-LIB",0
16,"16014",558,419,417,6,2,"P-LIB",0
3,"3138",3190,2244,2207,9,37,"P-LIB",2
40,"40124",234,169,164,0,5,"P-LIB",0
40,"40186",35,29,29,0,0,"P-LIB",0
16,"16023",513,367,367,3,0,"P-LIB",0
40,"40077",966,718,704,10,14,"P-LIB",1
16,"16154",4739,3416,3379,33,37,"P-LIB",1
16,"16051",128,96,96,3,0,"P-LIB",0
5,"5263",162,117,115,1,2,"P-LIB",0
16,"16191",850,664,653,11,11,"P-LIB",0
5,"5039",47,43,43,0,0,"P-LIB",0
16,"16065",370,287,287,3,0,"P-LIB",1
7,"7007",416,277,275,4,2,"P-LIB",1
40,"40178",85,61,60,0,1,"P-LIB",0
5,"5246",48,35,35,0,0,"P-LIB",0
5,"5134",47,40,40,0,0,"P-LIB",0
5,"5057",2418,1785,1748,9,37,"P-LIB",0
16,"16042",1091,832,823,4,9,"P-LIB",0
5,"5132",857,548,539,7,9,"P-LIB",0
7,"7025",443,313,310,5,3,"P-LIB",0
5,"5069",73,59,59,0,0,"P-LIB",0
40,"40013",57,47,47,0,0,"P-LIB",0
40,"40142",52,39,37,0,2,"P-LIB",0
5,"5067",73,56,54,0,2,"P-LIB",0
39,"39025",8637,6256,6179,33,77,"P-LIB",1
40,"40221",50,38,35,0,3,"P-LIB",0
3,"3100",499,384,378,0,6,"P-LIB",0
16,"16213",34,27,26,0,1,"P-LIB",0
7,"7065",2319,1429,1411,15,18,"P-LIB",0
16,"16906",70,44,44,1,0,"P-LIB",0
16,"16019",187,141,141,1,0,"P-LIB",0
3,"3105",5510,3879,3792,27,87,"P-LIB",1
16,"16163",64,51,51,0,0,"P-LIB",0
16,"16279",173,109,108,0,1,"P-LIB",0
5,"5101",266,206,205,1,1,"P-LIB",1
16,"16043",88,60,60,3,0,"P-LIB",0
16,"16129",88,72,72,0,0,"P-LIB",0
3,"3124",459,360,358,0,2,"P-LIB",0
16,"16096",278,219,217,1,2,"P-LIB",1
5,"5196",57,43,43,0,0,"P-LIB",0
3,"3084",501,413,413,1,0,"P-LIB",0
5,"5247",231,132,131,1,1,"P-LIB",0
5,"5191",121,99,99,0,0,"P-LIB",0
16,"16115",49,32,32,0,0,"P-LIB",0
39,"39003",261,189,187,2,2,"P-LIB",0
5,"5014",5263,3699,3648,35,51,"P-LIB",0
39,"39037",2033,1431,1420,3,11,"P-LIB",2
39,"39100",849,567,565,5,2,"P-LIB",0
16,"16072",132,84,84,1,0,"P-LIB",0
39,"39078",1410,1004,997,5,7,"P-LIB",0
16,"16228",173,147,145,2,2,"P-LIB",0
40,"40075",152,116,116,0,0,"P-LIB",0
5,"5143",59,52,51,1,1,"P-LIB",0
5,"5206",26,17,17,0,0,"P-LIB",0
16,"16017",336,276,270,1,6,"P-LIB",0
39,"39083",1063,619,611,2,8,"P-LIB",0
5,"5135",399,294,292,2,2,"P-LIB",0
16,"16243",376,316,309,4,7,"P-LIB",0
5,"5116",96,68,68,0,0,"P-LIB",0
40,"40218",80,56,55,0,1,"P-LIB",0
5,"5023",174,148,145,2,3,"P-LIB",0
16,"16203",10221,6960,6883,42,77,"P-LIB",1
5,"5198",70,53,51,0,2,"P-LIB",0
5,"5233",223,174,173,0,1,"P-LIB",0
16,"16111",168,114,111,2,3,"P-LIB",0
5,"5212",197,117,117,0,0,"P-LIB",0
5,"5262",318,238,235,1,3,"P-LIB",0
5,"5197",100,82,79,1,3,"P-LIB",0
16,"16134",4368,3143,3102,22,41,"P-LIB",0
16,"16087",238,184,184,6,0,"P-LIB",0
40,"40035",135,110,110,2,0,"P-LIB",0
5,"5204",578,445,442,3,3,"P-LIB",0
5,"5156",242,145,145,1,0,"P-LIB",0
40,"40021",18,15,15,0,0,"P-LIB",0
40,"40031",546,410,406,3,4,"P-LIB",1
3,"3091",244,194,193,2,1,"P-LIB",0
3,"3094",9795,6528,6481,37,47,"P-LIB",6
40,"40053",79,56,56,1,0,"P-LIB",0
40,"40906",2149,1701,1662,18,39,"P-LIB",0
16,"16150",98,66,66,2,0,"P-LIB",0
5,"5059",92,49,48,0,1,"P-LIB",0
3,"3127",350,260,255,1,5,"P-LIB",0
16,"16091",63,43,42,1,1,"P-LIB",0
5,"5096",76,62,62,0,0,"P-LIB",0
40,"40017",83,71,68,2,3,"P-LIB",0
16,"16142",119,90,90,0,0,"P-LIB",0
16,"16064",651,556,550,4,6,"P-LIB",0
39,"39084",868,608,605,3,3,"P-LIB",0
5,"5183",123,103,100,0,3,"P-LIB",0
40,"40222",161,134,131,1,3,"P-LIB",0
3,"3025",1304,944,934,4,10,"P-LIB",0
3,"3072",352,281,277,3,4,"P-LIB",0
40,"40134",692,522,509,10,13,"P-LIB",0
5,"5209",74,58,58,1,0,"P-LIB",0
5,"5169",218,171,171,1,0,"P-LIB",0
3,"3044",4608,3437,3391,13,46,"P-LIB",1
5,"5904",108,70,69,5,1,"P-LIB",0
5,"5174",62,51,51,1,0,"P-LIB",0
40,"40083",73,52,52,1,0,"P-LIB",0
3,"3051",342,288,286,4,2,"P-LIB",0
16,"16255",132,99,99,0,0,"P-LIB",0
5,"5043",73,58,58,0,0,"P-LIB",0
5,"5231",150,123,122,2,1,"P-LIB",0
16,"16044",43,29,28,0,1,"P-LIB",0
3,"3031",42046,25035,24819,168,216,"P-LIB",17
40,"40061",63,47,44,0,3,"P-LIB",1
3,"3021",5573,4423,4343,23,80,"P-LIB",1
3,"3037",340,261,255,3,6,"P-LIB",0
3,"3121",21997,14689,14572,103,117,"P-LIB",5
39,"39087",41241,29341,29084,152,257,"P-LIB",12
3,"3053",7568,5551,5468,40,83,"P-LIB",2
5,"5038",114,83,82,0,1,"P-LIB",0
16,"16147",54,34,33,0,1,"P-LIB",0
40,"40072",224,175,171,1,4,"P-LIB",0
5,"5056",91,71,70,0,1,"P-LIB",0
5,"5159",224,133,132,3,1,"P-LIB",0
3,"3078",468,340,336,0,4,"P-LIB",0
5,"5266",100,79,79,1,0,"P-LIB",0
40,"40048",35,27,27,0,0,"P-LIB",0
39,"39007",386,265,264,0,1,"P-LIB",0
39,"39088",59,40,40,2,0,"P-LIB",0
39,"39059",7518,5327,5287,23,40,"P-LIB",1
40,"40084",52,41,41,2,0,"P-LIB",0
40,"40108",109,85,85,2,0,"P-LIB",0
40,"40120",195,169,163,0,6,"P-LIB",0
5,"5905",214,148,142,1,6,"P-LIB",0
5,"5066",435,344,341,2,3,"P-LIB",0
5,"5115",509,350,344,0,6,"P-LIB",0
40,"40141",822,584,568,9,16,"P-LIB",0
16,"16031",35,26,26,0,0,"P-LIB",0
3,"3114",1593,1158,1142,4,16,"P-LIB",1
16,"16171",1728,1334,1313,10,21,"P-LIB",0
5,"5001",182,139,138,1,1,"P-LIB",0
40,"40220",64,46,45,0,1,"P-LIB",0
16,"16174",166,130,129,2,1,"P-LIB",0
3,"3010",332,275,268,1,7,"P-LIB",0
5,"5012",117,88,88,1,0,"P-LIB",0
16,"16250",67,52,52,1,0,"P-LIB",0
40,"40184",245,196,194,0,2,"P-LIB",0
3,"3135",195,134,131,1,3,"P-LIB",0
5,"5123",106,78,78,0,0,"P-LIB",0
40,"40099",54,44,42,0,2,"P-LIB",0
7,"7026",31129,17489,17342,178,147,"P-LIB",15
3,"3036",82,73,71,1,2,"P-LIB",0
16,"16085",131,106,106,0,0,"P-LIB",0
3,"3029",236,174,172,2,2,"P-LIB",0
16,"16249",1938,1422,1406,6,16,"P-LIB",0
5,"5208",39,32,32,0,0,"P-LIB",0
39,"39096",669,451,450,1,1,"P-LIB",0
16,"16240",98,71,69,0,2,"P-LIB",0
3,"3117",377,306,302,2,4,"P-LIB",1
39,"39006",1729,1207,1192,1,15,"P-LIB",0
5,"5045",81,58,58,0,0,"P-LIB",0
7,"7047",2399,1504,1477,20,27,"P-LIB",1
5,"5193",179,140,139,2,1,"P-LIB",0
16,"16141",131,98,96,1,2,"P-LIB",0
5,"5002",1905,1361,1329,11,32,"P-LIB",0
5,"5226",63,43,42,0,1,"P-LIB",0
5,"5901",247,154,152,3,2,"P-LIB",0
16,"16132",33,25,25,1,0,"P-LIB",0
16,"16083",44,24,24,0,0,"P-LIB",0
5,"5240",3346,2259,2232,11,27,"P-LIB",1
5,"5179",199,176,172,1,4,"P-LIB",0
40,"40132",45,26,25,0,1,"P-LIB",0
7,"7050",3513,2036,2013,25,23,"P-LIB",0
40,"40088",272,192,192,0,0,"P-LIB",0
3,"3088",5895,4030,3961,29,69,"P-LIB",1
16,"16166",240,173,171,0,2,"P-LIB",0
40,"40149",479,345,338,3,7,"P-LIB",0
16,"16137",37,27,25,0,2,"P-LIB",0
3,"3118",2446,1617,1598,8,19,"P-LIB",0
5,"5189",397,293,291,3,2,"P-LIB",0
16,"16162",39,31,31,0,0,"P-LIB",0
7,"7062",7972,3946,3896,42,50,"P-LIB",1
16,"16205",106,73,73,1,0,"P-LIB",0
40,"40208",724,546,543,5,3,"P-LIB",0
39,"39101",231,134,132,2,2,"P-LIB",0
5,"5072",92,74,72,1,2,"P-LIB",0
39,"39041",1753,1285,1269,7,16,"P-LIB",0
40,"40005",25,23,23,1,0,"P-LIB",0
3,"3079",18422,13560,13378,152,182,"P-LIB",9
16,"16048",404,300,298,2,2,"P-LIB",0
16,"16088",100,86,86,0,0,"P-LIB",0
3,"3136",399,302,301,3,1,"P-LIB",0
3,"3048",4993,3549,3502,13,47,"P-LIB",2
40,"40046",83,67,67,1,0,"P-LIB",0
5,"5168",3503,2536,2511,29,25,"P-LIB",1
40,"40177",139,106,105,0,1,"P-LIB",0
16,"16009",54,44,44,2,0,"P-LIB",0
40,"40155",3897,2920,2880,56,40,"P-LIB",0
40,"40110",316,237,234,4,3,"P-LIB",0
16,"16204",237,179,177,1,2,"P-LIB",0
16,"16181",54,40,40,0,0,"P-LIB",0
16,"16078",41384,28809,28500,322,309,"P-LIB",18
40,"40215",79,66,66,2,0,"P-LIB",0
40,"40078",150,123,123,6,0,"P-LIB",0
5,"5125",56,47,46,0,1,"P-LIB",0
5,"5256",110,88,86,1,2,"P-LIB",0
5,"5218",104,81,79,0,2,"P-LIB",0
16,"16049",137,98,98,2,0,"P-LIB",0
40,"40230",93,66,64,0,2,"P-LIB",0
39,"39042",5910,4354,4315,14,39,"P-LIB",2
5,"5100",260,193,192,3,1,"P-LIB",0
40,"40007",68,55,55,1,0,"P-LIB",0
5,"5053",76,48,48,0,0,"P-LIB",0
5,"5192",92,75,72,1,3,"P-LIB",0
16,"16039",365,241,238,3,3,"P-LIB",0
16,"16910",75,44,44,1,0,"P-LIB",0
40,"40043",1773,1376,1345,21,31,"P-LIB",0
3,"3111",5579,3777,3737,23,40,"P-LIB",2
16,"16116",76,59,58,1,1,"P-LIB",0
5,"5075",96,76,76,0,0,"P-LIB",0
40,"40094",353,265,263,3,2,"P-LIB",0
7,"7044",8812,5679,5569,67,110,"P-LIB",1
40,"40127",36,25,23,0,2,"P-LIB",0
40,"40160",93,65,62,0,3,"P-LIB",0
16,"16158",513,371,366,5,5,"P-LIB",0
7,"7055",8062,4546,4492,40,54,"P-LIB",1
40,"40192",134,106,105,1,1,"P-LIB",0
5,"5109",445,334,329,4,5,"P-LIB",0
16,"16212",233,186,184,0,2,"P-LIB",0
5,"5007",109,73,72,0,1,"P-LIB",0
40,"40052",72,55,55,0,0,"P-LIB",0
7,"7045",1317,931,928,8,3,"P-LIB",2
16,"16052",539,422,419,3,3,"P-LIB",0
5,"5264",54,32,31,4,1,"P-LIB",0
16,"16071",20,16,16,0,0,"P-LIB",0
16,"16271",612,482,481,3,1,"P-LIB",0
5,"5147",144,101,99,0,2,"P-LIB",0
16,"16251",1805,1318,1302,9,16,"P-LIB",0
39,"39031",1237,870,865,1,5,"P-LIB",0
40,"40181",4182,3102,3038,35,64,"P-LIB",0
16,"16046",213,142,142,0,0,"P-LIB",1
3,"3081",1492,1070,1044,12,26,"P-LIB",0
39,"39090",773,557,553,2,4,"P-LIB",0
40,"40136",102,79,77,3,2,"P-LIB",0
5,"5139",71,59,58,1,1,"P-LIB",0
3,"3139",23126,14650,14522,127,128,"P-LIB",12
5,"5235",141,97,97,2,0,"P-LIB",0
39,"39046",1342,910,902,3,8,"P-LIB",1
7,"7041",2090,1454,1434,17,20,"P-LIB",1
40,"40173",140,120,118,2,2,"P-LIB",0
7,"7061",9451,5735,5666,60,69,"P-LIB",7
3,"3113",4339,2978,2935,23,43,"P-LIB",1
5,"5175",144,109,109,0,0,"P-LIB",1
16,"16053",388,306,303,3,3,"P-LIB",3
40,"40056",31,21,20,0,1,"P-LIB",0
40,"40234",375,278,269,3,9,"P-LIB",0
40,"40029",25,21,19,0,2,"P-LIB",0
5,"5215",156,120,113,0,7,"P-LIB",0
3,"3104",27072,19732,19477,218,255,"P-LIB",5
39,"39066",866,616,606,6,10,"P-LIB",0
40,"40904",344,286,284,8,2,"P-LIB",1
3,"3066",41762,28723,28388,358,335,"P-LIB",20
3,"3038",330,260,254,3,6,"P-LIB",0
16,"16056",442,275,270,4,5,"P-LIB",0
5,"5216",209,149,149,0,0,"P-LIB",0
5,"5144",65,47,46,1,1,"P-LIB",0
16,"16217",91,72,72,0,0,"P-LIB",0
7,"7004",4069,2652,2624,27,28,"P-LIB",1
16,"16188",74,57,57,1,0,"P-LIB",0
40,"40195",776,573,565,4,8,"P-LIB",0
7,"7059",3074,1973,1948,17,25,"P-LIB",1
16,"16238",461,380,378,1,2,"P-LIB",0
3,"3020",94,84,84,1,0,"P-LIB",0
5,"5195",199,125,125,1,0,"P-LIB",0
3,"3002",3649,2568,2542,11,26,"P-LIB",0
16,"16902",124,86,86,1,0,"P-LIB",0
40,"40034",74,59,58,0,1,"P-LIB",0
7,"7060",2713,1796,1772,17,24,"P-LIB",3
40,"40123",141,98,94,4,4,"P-LIB",0
5,"5047",4105,3004,2936,23,68,"P-LIB",1
16,"16905",1302,951,934,10,17,"P-LIB",2
16,"16160",58,41,41,1,0,"P-LIB",0
7,"7043",3431,2196,2166,21,30,"P-LIB",2
16,"16067",123,91,90,1,1,"P-LIB",0
7,"7038",2046,1416,1406,12,10,"P-LIB",0
3,"3086",169,140,140,2,0,"P-LIB",0
5,"5251",56,35,34,0,1,"P-LIB",0
5,"5225",355,276,273,6,3,"P-LIB",0
16,"16133",4399,3317,3256,34,61,"P-LIB",1
5,"5171",67,49,47,0,2,"P-LIB",0
3,"3065",169894,121210,120342,1045,868,"P-LIB",118
3,"3097",1014,778,764,5,14,"P-LIB",1
40,"40024",823,582,575,8,7,"P-LIB",1
16,"16135",115,76,76,0,0,"P-LIB",0
40,"40159",130,94,93,2,1,"P-LIB",0
5,"5259",99,80,79,2,1,"P-LIB",0
40,"40148",231,165,163,4,2,"P-LIB",0
3,"3024",3937,2992,2952,19,40,"P-LIB",0
7,"7010",5078,3353,3318,30,35,"P-LIB",3
40,"40082",104,84,84,2,0,"P-LIB",0
5,"5136",83,55,55,0,0,"P-LIB",0
5,"5060",108,79,79,2,0,"P-LIB",0
16,"16035",224,177,174,2,3,"P-LIB",1
39,"39013",517,359,356,1,3,"P-LIB",0
3,"3019",15501,11261,11106,86,155,"P-LIB",6
39,"39064",1352,1007,990,3,17,"P-LIB",0
3,"3035",627,485,485,2,0,"P-LIB",0
40,"40145",1098,824,820,4,4,"P-LIB",0
7,"7029",4393,2888,2855,37,33,"P-LIB",1
7,"7018",389,238,236,1,2,"P-LIB",1
3,"3013",1063,809,794,3,15,"P-LIB",1
3,"3119",17253,12346,12258,81,88,"P-LIB",12
5,"5040",64,47,46,0,1,"P-LIB",0
3,"3116",1155,819,805,5,14,"P-LIB",0
3,"3122",43774,30060,29834,230,226,"P-LIB",21
5,"5078",95,78,78,2,0,"P-LIB",0
40,"40198",24,20,19,0,1,"P-LIB",0
16,"16033",1633,1199,1174,8,25,"P-LIB",0
7,"7016",2970,1891,1865,22,26,"P-LIB",2
40,"40216",785,633,621,9,12,"P-LIB",0
39,"39068",642,442,438,1,4,"P-LIB",0
5,"5161",545,395,395,0,0,"P-LIB",0
16,"16110",90,70,70,1,0,"P-LIB",0
5,"5210",81,56,56,0,0,"P-LIB",0
3,"3061",1060,793,787,5,6,"P-LIB",0
16,"16194",219,169,161,0,8,"P-LIB",1
7,"7064",5566,3232,3204,18,28,"P-LIB",2
5,"5185",96,63,61,1,2,"P-LIB",0
40,"40037",30,17,17,0,0,"P-LIB",0
40,"40161",32,24,23,1,1,"P-LIB",0
5,"5181",46,34,34,0,0,"P-LIB",0
40,"40183",117,105,99,1,6,"P-LIB",0
7,"7054",23257,12613,12464,111,149,"P-LIB",2
39,"39055",1065,747,736,4,11,"P-LIB",1
16,"16170",646,451,449,5,2,"P-LIB",0
7,"7902",1091,663,645,13,18,"P-LIB",0
40,"40028",103,88,87,2,1,"P-LIB",0
5,"5162",76,47,45,1,2,"P-LIB",0
16,"16103",235,183,181,2,2,"P-LIB",0
5,"5229",75,61,61,1,0,"P-LIB",0
40,"40018",73,50,50,0,0,"P-LIB",0
5,"5172",111,83,83,1,0,"P-LIB",0
39,"39016",23850,17235,17106,70,129,"P-LIB",6
40,"40212",26,19,19,1,0,"P-LIB",0
16,"16011",20,14,14,0,0,"P-LIB",0
3,"3095",4807,3453,3410,31,43,"P-LIB",4
40,"40152",732,575,565,10,10,"P-LIB",0
16,"16167",288,225,217,0,8,"P-LIB",0
5,"5019",44865,32917,32586,282,331,"P-LIB",11
5,"5153",86,58,56,3,2,"P-LIB",0
3,"3073",222,178,178,0,0,"P-LIB",0
39,"39073",10260,7537,7482,42,55,"P-LIB",4
3,"3008",158,120,118,1,2,"P-LIB",0
16,"16234",23,17,17,0,0,"P-LIB",0
3,"3057",174,138,136,0,2,"P-LIB",0
40,"40905",130,95,95,0,0,"P-LIB",0
39,"39077",237,151,148,1,3,"P-LIB",0
5,"5188",39,33,33,0,0,"P-LIB",0
16,"16098",521,418,415,2,3,"P-LIB",1
39,"39039",540,355,355,1,0,"P-LIB",0
16,"16245",396,304,298,1,6,"P-LIB",1
5,"5070",30,29,29,0,0,"P-LIB",0
40,"40049",37,27,27,0,0,"P-LIB",0
5,"5062",163,121,119,3,2,"P-LIB",0
3,"3103",238,196,194,2,2,"P-LIB",0
3,"3047",9768,6220,6144,41,76,"P-LIB",8
40,"40194",39173,28641,28260,353,381,"P-LIB",19
39,"39034",255,133,128,2,5,"P-LIB",0
5,"5088",29,22,22,0,0,"P-LIB",0
3,"3120",2433,1688,1652,13,36,"P-LIB",1
3,"3018",12433,8582,8502,54,80,"P-LIB",5
16,"16219",81,58,58,0,0,"P-LIB",0
39,"39093",297,216,214,1,2,"P-LIB",0
16,"16034",155,116,113,0,3,"P-LIB",0
40,"40089",209,155,148,2,7,"P-LIB",0
5,"5127",600,472,469,7,3,"P-LIB",0
3,"3132",512,376,373,2,3,"P-LIB",0
3,"3045",216,176,172,1,4,"P-LIB",0
16,"16063",112,81,81,1,0,"P-LIB",0
7,"7021",229,154,150,3,4,"P-LIB",0
40,"40010",108,83,82,0,1,"P-LIB",0
40,"40130",127,95,87,1,8,"P-LIB",0
16,"16108",44,35,34,1,1,"P-LIB",0
39,"39057",2366,1636,1607,10,29,"P-LIB",1
5,"5227",341,230,228,1,2,"P-LIB",0
3,"3092",6712,4924,4858,35,66,"P-LIB",4
16,"16276",20,17,17,1,0,"P-LIB",0
16,"16269",378,287,285,2,2,"P-LIB",0
40,"40131",51,45,45,0,0,"P-LIB",0
40,"40225",1085,822,809,5,13,"P-LIB",0
16,"16192",42,28,28,0,0,"P-LIB",0
7,"7058",2866,2013,1996,24,17,"P-LIB",1
40,"40162",380,273,265,1,8,"P-LIB",0
39,"39029",629,476,469,1,7,"P-LIB",0
5,"5237",153,125,123,0,2,"P-LIB",0
5,"5164",18,12,12,0,0,"P-LIB",0
16,"16173",175,128,127,0,1,"P-LIB",0
5,"5024",193,127,125,2,2,"P-LIB",0
5,"5158",346,263,261,0,2,"P-LIB",0
3,"3106",559,469,465,3,4,"P-LIB",0
40,"40143",82,68,67,2,1,"P-LIB",0
39,"39081",440,330,327,1,3,"P-LIB",0
5,"5048",107,89,88,2,1,"P-LIB",0
16,"16107",94,56,56,0,0,"P-LIB",0
16,"16010",134,92,88,0,4,"P-LIB",0
40,"40176",372,288,287,2,1,"P-LIB",0
3,"3058",4976,3733,3669,20,64,"P-LIB",1
40,"40062",56,43,42,0,1,"P-LIB",0
7,"7009",737,495,488,3,7,"P-LIB",2
40,"40019",29,23,23,1,0,"P-LIB",0
16,"16013",26,24,24,0,0,"P-LIB",0
5,"5008",202,158,155,0,3,"P-LIB",0
16,"16149",147,105,105,2,0,"P-LIB",0
40,"40041",966,729,716,8,13,"P-LIB",1
16,"16005",234,163,160,1,3,"P-LIB",0
3,"3102",7181,5126,5073,36,53,"P-LIB",3
40,"40104",283,203,200,0,3,"P-LIB",0
3,"3109",3003,2186,2151,14,35,"P-LIB",0
39,"39080",3477,2404,2388,4,16,"P-LIB",0
5,"5085",31,27,27,0,0,"P-LIB",0
16,"16026",91,69,68,0,1,"P-LIB",0
5,"5017",84,70,67,2,3,"P-LIB",0
40,"40112",2813,2126,2087,26,39,"P-LIB",0
5,"5267",103,67,67,1,0,"P-LIB",1
16,"16216",272,207,204,0,3,"P-LIB",0
3,"3115",255,213,213,3,0,"P-LIB",0
39,"39094",840,611,611,2,0,"P-LIB",0
16,"16029",104,76,74,0,2,"P-LIB",0
16,"16124",1807,1367,1347,14,20,"P-LIB",0
3,"3064",5015,3514,3461,15,53,"P-LIB",5
7,"7022",11659,7045,6965,84,80,"P-LIB",7
40,"40166",251,201,201,0,0,"P-LIB",0
40,"40058",306,244,240,1,4,"P-LIB",0
16,"16073",190,153,153,1,0,"P-LIB",0
16,"16070",29,27,27,0,0,"P-LIB",0
5,"5145",43,28,28,0,0,"P-LIB",0
7,"7001",3647,2430,2383,26,47,"P-LIB",1
7,"7012",1908,1301,1282,12,19,"P-LIB",1
39,"39049",304,198,195,2,3,"P-LIB",0
40,"40068",22,21,21,0,0,"P-LIB",0
5,"5037",210,135,135,0,0,"P-LIB",0
16,"16270",154,123,122,1,1,"P-LIB",0
40,"40115",142,100,100,0,0,"P-LIB",0
40,"40045",119,93,93,1,0,"P-LIB",0
16,"16128",50,38,38,0,0,"P-LIB",0
40,"40201",42,37,37,0,0,"P-LIB",0
7,"7031",24972,14866,14757,127,109,"P-LIB",5
39,"39048",1772,1311,1295,8,16,"P-LIB",1
5,"5121",263,194,189,1,5,"P-LIB",0
16,"16258",172,124,119,0,5,"P-LIB",0
16,"16156",84,64,64,0,0,"P-LIB",0
40,"40135",277,212,210,3,2,"P-LIB",0
7,"7002",6678,4149,4108,31,41,"P-LIB",6
16,"16215",237,162,158,1,4,"P-LIB",0
3,"3027",167,142,138,1,4,"P-LIB",0
39,"39023",6563,4788,4753,14,35,"P-LIB",1
5,"5087",147,108,107,3,1,"P-LIB",0
16,"16277",105,74,74,0,0,"P-LIB",0
40,"40103",139,113,113,0,0,"P-LIB",0
5,"5184",238,163,160,2,3,"P-LIB",0
5,"5903",137,84,83,0,1,"P-LIB",1
3,"3071",4000,2858,2813,27,45,"P-LIB",0
40,"40106",179,140,139,2,1,"P-LIB",0
16,"16263",967,724,721,3,3,"P-LIB",0
5,"5042",141,111,111,0,0,"P-LIB",0
5,"5236",105,69,69,1,0,"P-LIB",0
3,"3007",173,141,139,0,2,"P-LIB",0
40,"40228",493,362,361,3,1,"P-LIB",0
40,"40223",235,177,174,1,3,"P-LIB",0
16,"16280",163,122,119,2,3,"P-LIB",0
5,"5054",1192,871,856,6,15,"P-LIB",0
40,"40030",419,317,314,3,3,"P-LIB",0
39,"39018",4284,3211,3177,22,34,"P-LIB",0
39,"39017",550,378,372,1,6,"P-LIB",0
16,"16104",53,42,42,0,0,"P-LIB",0
16,"16130",533,407,404,0,3,"P-LIB",0
3,"3030",559,442,433,2,9,"P-LIB",0
39,"39067",753,476,474,1,2,"P-LIB",0
40,"40150",60,42,42,0,0,"P-LIB",0
5,"5211",425,336,330,2,6,"P-LIB",0
5,"5232",104,86,83,1,3,"P-LIB",0
3,"3096",5786,4355,4281,38,74,"P-LIB",3
16,"16020",9,5,5,1,0,"P-LIB",0
3,"3052",959,747,735,4,12,"P-LIB",0
40,"40001",708,544,536,3,8,"P-LIB",0
16,"16193",55,50,49,0,1,"P-LIB",0
3,"3074",1766,1347,1336,4,11,"P-LIB",0
40,"40081",117,80,76,1,4,"P-LIB",0
16,"16062",25,20,20,0,0,"P-LIB",0
5,"5021",1861,1323,1304,22,19,"P-LIB",0
39,"39089",131,82,82,0,0,"P-LIB",0
3,"3083",5479,3736,3674,39,62,"P-LIB",1
16,"16006",113,100,100,1,0,"P-LIB",0
40,"40210",97,69,69,1,0,"P-LIB",0
16,"16140",18,14,14,1,0,"P-LIB",0
3,"3017",379,320,314,4,6,"P-LIB",0
3,"3099",43101,30222,29885,196,337,"P-LIB",13
7,"7056",5271,3429,3386,44,43,"P-LIB",2
5,"5190",53,44,43,0,1,"P-LIB",0
5,"5049",403,261,253,1,8,"P-LIB",0
5,"5186",1564,1140,1125,5,15,"P-LIB",0
5,"5152",644,498,496,3,2,"P-LIB",0
40,"40191",198,143,138,0,5,"P-LIB",0
5,"5230",65,57,56,1,1,"P-LIB",0
5,"5079",66,53,52,0,1,"P-LIB",0
40,"40032",368,247,244,5,3,"P-LIB",0
39,"39010",610,457,453,1,4,"P-LIB",0
39,"39035",9142,6574,6517,24,57,"P-LIB",2
5,"5187",1714,1247,1221,9,26,"P-LIB",1
3,"3063",27209,18236,18101,164,135,"P-LIB",5
5,"5108",39,21,21,0,0,"P-LIB",0
40,"40144",16,15,15,0,0,"P-LIB",0
7,"7005",6956,4042,3996,35,46,"P-LIB",3
39,"39002",3408,2360,2323,7,37,"P-LIB",0
16,"16068",125,88,88,3,0,"P-LIB",0
16,"16045",180,128,127,0,1,"P-LIB",0
3,"3055",5265,3741,3697,16,44,"P-LIB",0
5,"5261",32,25,25,0,0,"P-LIB",0
5,"5114",1257,989,968,5,21,"P-LIB",0
7,"7027",22101,13161,13028,140,133,"P-LIB",12
16,"16901",624,443,438,5,5,"P-LIB",0
5,"5013",834,658,653,2,5,"P-LIB",1
40,"40211",66,54,54,1,0,"P-LIB",0
3,"3075",154,117,115,1,2,"P-LIB",0
5,"5095",236,181,177,1,4,"P-LIB",1
16,"16117",1018,723,715,9,8,"P-LIB",0
16,"16027",691,500,495,1,5,"P-LIB",2
7,"7024",7283,3574,3538,36,36,"P-LIB",3
16,"16094",121,86,84,0,2,"P-LIB",0
39,"39061",3470,2605,2591,14,14,"P-LIB",1
16,"16106",2701,2029,2001,6,28,"P-LIB",0
3,"3005",7937,5907,5869,40,38,"P-LIB",4
40,"40203",987,753,740,13,13,"P-LIB",1
7,"7035",1595,1095,1078,13,17,"P-LIB",1
16,"16030",24,18,18,1,0,"P-LIB",0
40,"40036",496,395,380,8,15,"P-LIB",0
40,"40224",18,15,15,0,0,"P-LIB",0
7,"7011",28971,17082,16964,164,118,"P-LIB",9
16,"16209",110,95,94,2,1,"P-LIB",0
40,"40006",22,19,19,0,0,"P-LIB",0
40,"40008",42,36,36,1,0,"P-LIB",0
3,"3098",523,382,378,1,4,"P-LIB",0
5,"5182",721,457,436,3,21,"P-LIB",0
16,"16211",335,228,227,1,1,"P-LIB",0
5,"5205",81,59,58,2,1,"P-LIB",0
40,"40039",180,133,133,0,0,"P-LIB",0
5,"5173",60,54,54,0,0,"P-LIB",0
16,"16032",284,220,220,1,0,"P-LIB",0
16,"16016",217,157,157,1,0,"P-LIB",0
39,"39047",1998,1408,1392,8,16,"P-LIB",0
40,"40207",802,593,590,11,3,"P-LIB",1
16,"16113",3065,2142,2108,13,34,"P-LIB",2
39,"39063",936,618,616,4,2,"P-LIB",0
40,"40180",276,215,210,2,5,"P-LIB",0
40,"40164",186,131,130,0,1,"P-LIB",0
39,"39070",126,91,89,0,2,"P-LIB",0
5,"5265",83,59,58,1,1,"P-LIB",0
16,"16202",733,533,526,4,7,"P-LIB",0
16,"16169",49,28,28,0,0,"P-LIB",0
5,"5065",452,339,337,2,2,"P-LIB",0
7,"7028",944,635,628,2,7,"P-LIB",1
16,"16022",76,63,63,0,0,"P-LIB",0
39,"39058",806,556,554,2,2,"P-LIB",0
5,"5131",96,64,64,1,0,"P-LIB",0
5,"5022",1580,1202,1193,6,9,"P-LIB",0
3,"3134",139,107,107,0,0,"P-LIB",0
3,"3101",4933,3502,3462,16,40,"P-LIB",3
5,"5257",132,98,95,4,3,"P-LIB",0
3,"3042",1475,1053,1043,7,10,"P-LIB",0
16,"16248",862,710,700,6,10,"P-LIB",0
5,"5245",353,262,256,0,6,"P-LIB",1
16,"16131",123,84,84,0,0,"P-LIB",0
5,"5118",64,41,41,1,0,"P-LIB",0
5,"5084",66,44,44,0,0,"P-LIB",0
5,"5027",258,209,203,5,6,"P-LIB",0
5,"5228",168,99,98,0,1,"P-LIB",0
5,"5120",33,26,26,0,0,"P-LIB",0
16,"16003",134,108,105,0,3,"P-LIB",0
40,"40063",6913,4948,4838,57,110,"P-LIB",4
16,"16187",55,38,38,3,0,"P-LIB",0
7,"7023",3776,2425,2386,34,39,"P-LIB",1
16,"16196",589,490,476,3,14,"P-LIB",0
3,"3131",176,129,126,1,3,"P-LIB",1
16,"16143",15,10,10,1,0,"P-LIB",0
16,"16264",385,311,305,1,6,"P-LIB",0
40,"40093",74,62,62,1,0,"P-LIB",0
5,"5112",95,59,58,0,1,"P-LIB",0
16,"16246",451,327,322,1,5,"P-LIB",0
3,"3016",88,66,66,0,0,"P-LIB",0
3,"3003",449,368,367,1,1,"P-LIB",0
3,"3070",2115,1399,1376,9,23,"P-LIB",0
39,"39074",7050,5074,5029,26,45,"P-LIB",3
7,"7033",28539,15238,15070,187,168,"P-LIB",14
39,"39091",1881,1297,1291,8,6,"P-LIB",0
7,"7042",10846,6354,6299,77,55,"P-LIB",7
5,"5194",132,105,104,1,1,"P-LIB",0
5,"5902",286,214,211,1,3,"P-LIB",0
5,"5034",15,14,13,0,1,"P-LIB",0
5,"5167",223,177,172,0,5,"P-LIB",1
5,"5178",340,261,255,3,6,"P-LIB",0
3,"3077",1391,1052,1032,10,20,"P-LIB",0
5,"5242",679,571,562,9,9,"P-LIB",0
7,"7030",1598,1127,1098,14,29,"P-LIB",1
40,"40051",34,25,25,0,0,"P-LIB",0
5,"5252",56,46,45,0,1,"P-LIB",0
39,"39086",358,236,235,2,1,"P-LIB",0
7,"7049",1479,935,918,5,17,"P-LIB",1
3,"3054",334,248,245,2,3,"P-LIB",0
3,"3133",41333,24527,24340,146,187,"P-LIB",39
16,"16001",62,45,45,0,0,"P-LIB",0
3,"3076",8846,6105,6029,40,76,"P-LIB",3
16,"16176",29,20,20,0,0,"P-LIB",0
39,"39027",3045,2231,2199,23,32,"P-LIB",0
16,"16119",175,117,115,0,2,"P-LIB",0
40,"40020",149,112,111,1,1,"P-LIB",0
40,"40054",108,79,78,3,1,"P-LIB",0
40,"40100",262,208,204,4,4,"P-LIB",0
40,"40229",26,22,22,0,0,"P-LIB",0
3,"3011",8014,5278,5212,50,66,"P-LIB",2
5,"5130",94,77,77,1,0,"P-LIB",0
16,"16148",544,452,451,2,1,"P-LIB",1
39,"39075",136789,95707,95089,478,618,"P-LIB",49
40,"40105",43,35,35,0,0,"P-LIB",0
5,"5238",728,529,525,1,4,"P-LIB",0
16,"16189",264,196,194,4,2,"P-LIB",0
16,"16909",655,493,488,4,5,"P-LIB",0
16,"16092",149,108,108,1,0,"P-LIB",0
16,"16237",98,82,82,1,0,"P-LIB",0
16,"16109",41,30,30,0,0,"P-LIB",0
39,"39045",352,238,234,0,4,"P-LIB",0
3,"3110",312,258,258,0,0,"P-LIB",0
39,"39005",1419,1039,1030,9,9,"P-LIB",0
39,"39033",536,375,372,1,3,"P-LIB",0
40,"40126",67,44,42,0,2,"P-LIB",0
5,"5110",696,469,464,2,5,"P-LIB",0
16,"16004",228,175,174,0,1,"P-LIB",0
40,"40073",387,327,323,1,4,"P-LIB",0
16,"16227",109,78,76,0,2,"P-LIB",0
40,"40074",246,193,189,2,4,"P-LIB",0
16,"16247",63,51,50,1,1,"P-LIB",0
40,"40196",30,24,24,0,0,"P-LIB",0
3,"3129",1224,934,923,4,11,"P-LIB",0
39,"39019",2232,1628,1603,10,25,"P-LIB",0
16,"16275",12,12,12,1,0,"P-LIB",0
5,"5092",145,111,107,1,4,"P-LIB",0
16,"16123",66,42,41,0,1,"P-LIB",0
5,"5089",455,342,324,0,18,"P-LIB",0
16,"16015",349,242,239,6,3,"P-LIB",0
5,"5220",364,277,274,0,3,"P-LIB",0
5,"5249",96,63,63,0,0,"P-LIB",0
40,"40113",404,308,304,2,4,"P-LIB",0
5,"5016",6355,4677,4584,28,93,"P-LIB",3
3,"3090",18095,12539,12412,75,127,"P-LIB",8
39,"39062",1864,1395,1376,3,19,"P-LIB",0
40,"40118",46,32,32,1,0,"P-LIB",0
39,"39092",863,534,533,3,1,"P-LIB",1
16,"16058",94,71,71,1,0,"P-LIB",0
40,"40128",123,88,87,1,1,"P-LIB",0
16,"16244",698,598,585,7,13,"P-LIB",0
39,"39012",6772,4807,4755,31,52,"P-LIB",2
16,"16025",24,20,20,0,0,"P-LIB",0
3,"3046",1636,1073,1061,7,12,"P-LIB",1
3,"3082",12941,8399,8304,51,95,"P-LIB",3
39,"39014",882,538,536,0,2,"P-LIB",0
39,"39036",965,707,703,4,4,"P-LIB",0
5,"5219",33,23,23,0,0,"P-LIB",0
3,"3904",1434,1032,1022,8,10,"P-LIB",0
39,"39008",13900,9814,9734,63,80,"P-LIB",3
5,"5154",31,23,23,0,0,"P-LIB",0
40,"40157",39,30,30,0,0,"P-LIB",0
40,"40140",76,54,54,0,0,"P-LIB",0
39,"39011",1587,1178,1178,6,0,"P-LIB",1
40,"40009",41,35,34,0,1,"P-LIB",0
5,"5155",46,33,31,1,2,"P-LIB",0
16,"16086",872,699,690,7,9,"P-LIB",0
3,"3006",493,365,360,2,5,"P-LIB",0
40,"40040",2489,1766,1744,26,22,"P-LIB",0
3,"3902",10640,7024,6952,36,72,"P-LIB",2
16,"16165",56,45,45,0,0,"P-LIB",0
40,"40119",166,133,132,2,1,"P-LIB",0
40,"40193",219,156,155,3,1,"P-LIB",0
40,"40065",467,338,329,1,9,"P-LIB",0
5,"5005",165,127,119,0,8,"P-LIB",0
5,"5217",54,42,41,0,1,"P-LIB",0
40,"40071",39,32,26,0,6,"P-LIB",0
40,"40200",38,28,28,0,0,"P-LIB",0
16,"16190",4930,3747,3688,26,59,"P-LIB",0
3,"3067",91,78,78,0,0,"P-LIB",0
5,"5058",71,45,43,0,2,"P-LIB",0
5,"5124",87,67,67,2,0,"P-LIB",0
40,"40151",43,31,31,0,0,"P-LIB",0
16,"16081",50,37,36,0,1,"P-LIB",0
5,"5099",451,350,344,3,6,"P-LIB",0
16,"16082",272,194,192,1,2,"P-LIB",0
3,"3125",332,226,226,2,0,"P-LIB",0
16,"16041",334,244,243,2,1,"P-LIB",0
7,"7901",598,410,402,6,8,"P-LIB",0
16,"16172",325,233,228,1,5,"P-LIB",0
3,"3026",1331,987,975,7,12,"P-LIB",0
16,"16097",139,117,116,0,1,"P-LIB",0
16,"16057",62,45,45,0,0,"P-LIB",0
5,"5041",984,743,732,5,11,"P-LIB",0
39,"39009",3325,2306,2293,7,13,"P-LIB",1
16,"16050",218,172,169,2,3,"P-LIB",0
39,"39099",3193,2363,2346,10,17,"P-LIB",0
5,"5044",244,170,170,1,0,"P-LIB",0
3,"3014",238937,161861,160809,1308,1052,"P-LIB",101
3,"3080",1330,1040,1032,4,8,"P-LIB",0
16,"16066",2280,1765,1734,18,31,"P-LIB",1
5,"5160",289,220,213,0,7,"P-LIB",0
16,"16274",97,76,75,1,1,"P-LIB",0
16,"16186",403,309,305,3,4,"P-LIB",0
5,"5081",37,21,21,3,0,"P-LIB",0
16,"16155",490,389,388,7,1,"P-LIB",0
5,"5254",184,149,147,1,2,"P-LIB",0
5,"5214",28,18,18,0,0,"P-LIB",0
39,"39021",464,370,364,1,6,"P-LIB",0
5,"5163",1702,1258,1233,5,25,"P-LIB",2
16,"16904",453,348,345,11,3,"P-LIB",0
16,"16008",80,63,63,1,0,"P-LIB",0
40,"40189",471,344,329,1,15,"P-LIB",0
39,"39026",1702,1160,1151,11,9,"P-LIB",0
40,"40163",42,35,35,1,0,"P-LIB",0
40,"40125",76,48,46,0,2,"P-LIB",0
16,"16197",67,44,43,0,1,"P-LIB",0
40,"40168",27,20,20,0,0,"P-LIB",0
40,"40171",40,32,32,1,0,"P-LIB",0
5,"5077",154,113,110,0,3,"P-LIB",0
5,"5122",118,91,89,1,2,"P-LIB",0
16,"16239",118,88,87,0,1,"P-LIB",0
40,"40190",43,37,35,0,2,"P-LIB",0
16,"16278",61,45,45,0,0,"P-LIB",0
7,"7053",1209,870,864,10,6,"P-LIB",1
3,"3093",19702,13903,13728,113,175,"P-LIB",7
5,"5052",85,70,69,0,1,"P-LIB",0
5,"5142",88,76,75,0,1,"P-LIB",0
7,"7034",1074,796,779,9,17,"P-LIB",2
16,"16036",120,94,93,0,1,"P-LIB",0
5,"5074",668,540,537,5,3,"P-LIB",0
3,"3023",1377,1138,1122,9,16,"P-LIB",3
16,"16908",166,133,132,2,1,"P-LIB",0
40,"40003",116,82,79,3,3,"P-LIB",0
5,"5157",227,146,146,3,0,"P-LIB",0
40,"40095",453,341,329,2,12,"P-LIB",0
16,"16265",22,18,18,0,0,"P-LIB",0
5,"5033",169,135,134,0,1,"P-LIB",0
5,"5083",137,92,91,0,1,"P-LIB",0
40,"40172",47,33,32,0,1,"P-LIB",0
40,"40129",159,119,117,2,2,"P-LIB",0
40,"40202",56,33,33,0,0,"P-LIB",0
16,"16236",857,615,608,1,7,"P-LIB",1
7,"7063",1434,1025,1016,10,9,"P-LIB",1
16,"16024",121,85,84,0,1,"P-LIB",0
5,"5117",191,155,153,1,2,"P-LIB",0
5,"5080",42,30,30,0,0,"P-LIB",0
40,"40182",169,112,112,1,0,"P-LIB",0
5,"5107",54,36,35,2,1,"P-LIB",0
39,"39020",23993,15944,15792,89,152,"P-LIB",2
16,"16101",137,111,109,1,2,"P-LIB",0
39,"39102",2229,1524,1514,10,10,"P-LIB",0
39,"39024",1802,1325,1314,7,11,"P-LIB",0
40,"40107",90,67,67,0,0,"P-LIB",0
16,"16151",61,51,51,1,0,"P-LIB",0
16,"16145",413,333,326,6,7,"P-LIB",0
3,"3901",1137,783,776,9,7,"P-LIB",1
5,"5055",532,417,413,3,4,"P-LIB",0
5,"5061",257,193,189,1,4,"P-LIB",0
5,"5051",157,117,115,1,2,"P-LIB",0
40,"40139",255,194,192,2,2,"P-LIB",0
39,"39043",1517,1167,1154,3,13,"P-LIB",0
5,"5253",75,54,54,0,0,"P-LIB",0
16,"16102",1159,815,767,9,48,"P-LIB",0
7,"7057",7471,4430,4392,41,38,"P-LIB",3
7,"7020",3707,2522,2493,40,29,"P-LIB",1
40,"40060",67,40,40,1,0,"P-LIB",0
40,"40092",105,75,75,2,0,"P-LIB",0
5,"5128",339,258,253,5,5,"P-LIB",0
16,"16152",32,26,26,3,0,"P-LIB",0
40,"40233",399,279,273,0,6,"P-LIB",0
16,"16002",192,160,158,2,2,"P-LIB",0
16,"16153",924,751,741,4,10,"P-LIB",0
39,"39054",4541,3271,3252,30,19,"P-LIB",2
3,"3062",228,173,172,3,1,"P-LIB",0
5,"5177",136,117,116,0,1,"P-LIB",0
5,"5151",83,60,60,0,0,"P-LIB",0
3,"3130",28,19,19,0,0,"P-LIB",0
7,"7008",6113,4003,3961,26,42,"P-LIB",3
3,"3043",2906,2360,2334,27,26,"P-LIB",2
39,"39052",19005,13859,13748,83,111,"P-LIB",7
16,"16273",300,214,211,3,3,"P-LIB",1
5,"5258",107,80,80,1,0,"P-LIB",0
3,"3039",89,65,65,0,0,"P-LIB",1
16,"16038",27,20,20,0,0,"P-LIB",0
40,"40158",15,11,11,0,0,"P-LIB",0
39,"39015",828,559,556,3,3,"P-LIB",0
16,"16218",184,134,133,1,1,"P-LIB",0
39,"39040",4271,3103,3080,18,23,"P-LIB",3
5,"5029",100,73,73,1,0,"P-LIB",0
16,"16126",720,552,545,3,7,"P-LIB",0
40,"40059",109,92,91,2,1,"P-LIB",0
16,"16206",184,126,125,4,1,"P-LIB",0
3,"3112",650,503,497,3,6,"P-LIB",2
16,"16040",91,76,76,2,0,"P-LIB",0
16,"16093",54,45,45,0,0,"P-LIB",0
5,"5106",27,14,14,0,0,"P-LIB",0
5,"5244",39,29,29,0,0,"P-LIB",0
16,"16177",83,65,65,1,0,"P-LIB",0
5,"5103",63,44,44,1,0,"P-LIB",0
40,"40002",32,22,21,0,1,"P-LIB",0
5,"5149",101,72,71,2,1,"P-LIB",0
40,"40902",113,78,76,1,2,"P-LIB",0
40,"40026",112,101,99,0,2,"P-LIB",0
16,"16074",30,25,25,0,0,"P-LIB",0
39,"39071",410,251,250,1,1,"P-LIB",0
39,"39082",1611,1108,1102,8,6,"P-LIB",0
40,"40055",31,26,26,0,0,"P-LIB",0
16,"16118",1351,1022,1009,13,13,"P-LIB",0
3,"3049",12103,8872,8785,57,87,"P-LIB",0
5,"5090",73,63,62,0,1,"P-LIB",0
39,"39098",1381,1088,1080,5,8,"P-LIB",0
5,"5064",101,77,77,0,0,"P-LIB",0
15,"15001",4697,3069,3022,45,47,"PODEMOS-EU",270
36,"36049",6990,4877,4787,40,90,"PODEMOS-EU",744
36,"36008",21845,14553,14373,138,180,"PODEMOS-EU",3469
27,"27048",1992,1317,1285,21,32,"PODEMOS-EU",51
32,"32047",1761,1192,1175,10,17,"PODEMOS-EU",50
15,"15901",3334,1948,1928,27,20,"PODEMOS-EU",257
15,"15087",5710,3436,3392,31,44,"PODEMOS-EU",428
27,"27066",12588,8116,7954,109,162,"PODEMOS-EU",1096
15,"15032",3430,2243,2197,12,46,"PODEMOS-EU",149
36,"36033",12305,8759,8597,67,162,"PODEMOS-EU",1476
32,"32046",1089,679,670,4,9,"PODEMOS-EU",45
27,"27062",583,403,400,2,3,"PODEMOS-EU",23
27,"27061",1018,704,683,12,21,"PODEMOS-EU",48
32,"32090",734,448,441,2,7,"PODEMOS-EU",37
32,"32071",1351,821,814,6,7,"PODEMOS-EU",41
27,"27902",7122,4472,4385,43,87,"PODEMOS-EU",563
36,"36050",7645,5137,5049,48,88,"PODEMOS-EU",713
15,"15074",3902,2629,2589,23,40,"PODEMOS-EU",200
32,"32010",364,271,267,2,4,"PODEMOS-EU",21
36,"36053",5783,3955,3899,39,56,"PODEMOS-EU",547
15,"15014",3836,2191,2158,27,33,"PODEMOS-EU",193
27,"27003",1743,1161,1134,18,27,"PODEMOS-EU",69
32,"32074",977,642,631,2,11,"PODEMOS-EU",29
15,"15070",8778,5802,5656,131,146,"PODEMOS-EU",784
32,"32044",794,547,540,2,7,"PODEMOS-EU",21
32,"32083",805,498,494,3,4,"PODEMOS-EU",19
32,"32034",1062,763,753,6,10,"PODEMOS-EU",35
27,"27030",3117,1945,1898,19,47,"PODEMOS-EU",143
36,"36023",8258,5504,5384,44,120,"PODEMOS-EU",876
32,"32013",1985,1242,1230,16,12,"PODEMOS-EU",35
32,"32087",1669,1158,1136,14,22,"PODEMOS-EU",55
32,"32050",2254,1630,1612,15,18,"PODEMOS-EU",80
36,"36026",19890,13041,12891,169,150,"PODEMOS-EU",1715
27,"27045",926,588,583,6,5,"PODEMOS-EU",16
36,"36057",238417,165843,164264,1641,1579,"PODEMOS-EU",30930
27,"27038",923,624,619,8,5,"PODEMOS-EU",36
32,"32030",945,642,641,8,1,"PODEMOS-EU",38
15,"15064",2103,1458,1447,20,11,"PODEMOS-EU",103
36,"36035",14615,10011,9880,103,131,"PODEMOS-EU",1469
27,"27029",1425,925,910,11,15,"PODEMOS-EU",67
15,"15091",1097,705,686,17,19,"PODEMOS-EU",76
36,"36019",1462,916,908,8,8,"PODEMOS-EU",81
32,"32059",1686,1099,1082,20,17,"PODEMOS-EU",63
15,"15075",12871,8751,8637,129,114,"PODEMOS-EU",1140
15,"15077",8103,4893,4818,61,75,"PODEMOS-EU",260
32,"32043",2497,1607,1582,14,25,"PODEMOS-EU",127
36,"36017",17364,11771,11598,123,173,"PODEMOS-EU",1177
36,"36036",2546,1763,1742,14,21,"PODEMOS-EU",224
32,"32066",547,396,396,0,0,"PODEMOS-EU",5
32,"32007",1413,873,862,2,11,"PODEMOS-EU",43
27,"27023",2453,1674,1644,25,30,"PODEMOS-EU",70
27,"27022",4654,2760,2696,20,64,"PODEMOS-EU",278
27,"27013",3690,2811,2766,30,45,"PODEMOS-EU",464
32,"32041",752,462,458,4,4,"PODEMOS-EU",19
27,"27034",1010,565,558,3,7,"PODEMOS-EU",26
32,"32038",387,253,251,4,2,"PODEMOS-EU",17
32,"32023",1130,787,782,2,5,"PODEMOS-EU",61
15,"15040",2647,1779,1762,15,17,"PODEMOS-EU",134
36,"36020",2172,1435,1418,19,17,"PODEMOS-EU",72
15,"15049",1068,752,747,7,5,"PODEMOS-EU",32
36,"36004",10109,6611,6502,79,109,"PODEMOS-EU",1115
32,"32079",1280,880,869,13,11,"PODEMOS-EU",49
32,"32085",10584,6687,6611,58,76,"PODEMOS-EU",488
36,"36060",30431,19909,19673,206,236,"PODEMOS-EU",2919
36,"36010",2825,1983,1947,19,36,"PODEMOS-EU",247
32,"32031",997,684,680,5,4,"PODEMOS-EU",43
36,"36042",18125,11975,11775,126,200,"PODEMOS-EU",2252
36,"36025",2127,1235,1221,5,14,"PODEMOS-EU",99
15,"15004",4924,3333,3292,38,41,"PODEMOS-EU",459
15,"15017",19866,13497,13344,195,153,"PODEMOS-EU",2104
15,"15053",7469,4622,4579,44,43,"PODEMOS-EU",574
15,"15033",2421,1673,1655,6,18,"PODEMOS-EU",171
32,"32014",1028,719,708,6,11,"PODEMOS-EU",29
27,"27059",2035,1356,1322,7,34,"PODEMOS-EU",97
36,"36029",16126,10936,10771,96,165,"PODEMOS-EU",2141
36,"36018",3033,1951,1926,9,25,"PODEMOS-EU",118
36,"36047",2248,1379,1363,11,16,"PODEMOS-EU",54
15,"15081",976,713,695,4,18,"PODEMOS-EU",50
32,"32024",4817,3064,3014,34,50,"PODEMOS-EU",176
32,"32060",753,520,515,5,5,"PODEMOS-EU",53
27,"27033",591,334,328,0,6,"PODEMOS-EU",20
36,"36039",15609,10562,10341,102,221,"PODEMOS-EU",1946
15,"15084",3039,2002,1981,12,21,"PODEMOS-EU",73
32,"32001",5100,3377,3333,32,44,"PODEMOS-EU",335
36,"36902",5028,3453,3396,19,57,"PODEMOS-EU",303
36,"36003",10023,6877,6789,66,88,"PODEMOS-EU",1004
27,"27055",1191,773,764,7,9,"PODEMOS-EU",33
32,"32035",1352,782,768,6,14,"PODEMOS-EU",26
15,"15021",5254,3473,3422,58,51,"PODEMOS-EU",399
15,"15031",23868,16113,15954,207,159,"PODEMOS-EU",2264
27,"27043",1222,746,737,12,9,"PODEMOS-EU",49
36,"36056",4932,3368,3310,24,58,"PODEMOS-EU",381
27,"27058",3283,2275,2241,12,34,"PODEMOS-EU",92
36,"36045",24459,16966,16735,124,231,"PODEMOS-EU",3214
15,"15066",3995,2746,2695,29,51,"PODEMOS-EU",196
36,"36015",4079,2653,2606,29,47,"PODEMOS-EU",262
36,"36007",1610,1047,1016,5,31,"PODEMOS-EU",67
15,"15044",1194,806,788,7,18,"PODEMOS-EU",61
27,"27044",2703,1495,1463,15,32,"PODEMOS-EU",91
32,"32017",1193,735,724,3,11,"PODEMOS-EU",32
15,"15007",3164,2081,2060,24,21,"PODEMOS-EU",116
32,"32029",441,286,283,2,3,"PODEMOS-EU",15
15,"15055",4446,2829,2762,50,67,"PODEMOS-EU",426
32,"32078",1099,715,707,4,8,"PODEMOS-EU",16
36,"36061",8613,5822,5718,56,104,"PODEMOS-EU",509
15,"15050",1732,931,917,15,14,"PODEMOS-EU",52
15,"15052",4070,2512,2488,18,24,"PODEMOS-EU",195
32,"32070",495,247,238,4,9,"PODEMOS-EU",19
27,"27024",1447,1048,1032,6,16,"PODEMOS-EU",50
15,"15073",21725,13008,12820,126,188,"PODEMOS-EU",1466
15,"15062",5597,3406,3360,16,46,"PODEMOS-EU",268
15,"15054",31805,19579,19321,335,258,"PODEMOS-EU",3100
32,"32018",1181,883,871,5,12,"PODEMOS-EU",55
15,"15005",25347,15441,15211,226,230,"PODEMOS-EU",2405
15,"15071",7780,4937,4848,34,89,"PODEMOS-EU",498
32,"32091",1695,1163,1156,2,7,"PODEMOS-EU",45
36,"36016",1069,639,633,5,6,"PODEMOS-EU",17
36,"36021",12180,8188,8058,115,130,"PODEMOS-EU",1371
15,"15082",15446,10821,10687,130,134,"PODEMOS-EU",1405
36,"36048",5248,3429,3378,25,51,"PODEMOS-EU",507
32,"32069",4223,3064,3023,31,41,"PODEMOS-EU",361
32,"32009",10558,6621,6549,50,72,"PODEMOS-EU",532
27,"27020",3365,2544,2500,42,44,"PODEMOS-EU",101
32,"32054",86117,56997,56376,581,621,"PODEMOS-EU",5850
32,"32037",679,454,446,6,8,"PODEMOS-EU",20
32,"32033",667,439,436,4,3,"PODEMOS-EU",15
27,"27065",12055,7566,7379,119,187,"PODEMOS-EU",643
15,"15048",5087,3426,3383,40,43,"PODEMOS-EU",461
32,"32058",5247,3547,3489,30,58,"PODEMOS-EU",292
36,"36041",13691,9022,8916,85,106,"PODEMOS-EU",1097
15,"15083",1029,627,614,5,13,"PODEMOS-EU",35
27,"27054",1135,807,782,5,25,"PODEMOS-EU",40
32,"32005",810,576,568,9,8,"PODEMOS-EU",10
15,"15045",3610,2057,2044,15,13,"PODEMOS-EU",117
15,"15069",6604,4587,4520,55,67,"PODEMOS-EU",705
32,"32065",633,422,419,8,3,"PODEMOS-EU",20
32,"32062",784,557,550,1,7,"PODEMOS-EU",17
15,"15042",2928,1879,1853,11,26,"PODEMOS-EU",179
27,"27035",183,110,110,3,0,"PODEMOS-EU",18
36,"36009",4401,2712,2649,33,63,"PODEMOS-EU",301
15,"15067",7933,5329,5282,43,47,"PODEMOS-EU",985
32,"32051",1369,1062,1058,13,4,"PODEMOS-EU",23
15,"15038",2126,1312,1296,12,16,"PODEMOS-EU",82
15,"15043",4944,3184,3117,27,67,"PODEMOS-EU",307
27,"27042",1639,1120,1107,8,13,"PODEMOS-EU",40
15,"15902",4507,2885,2837,34,48,"PODEMOS-EU",210
32,"32011",916,512,507,3,5,"PODEMOS-EU",17
36,"36032",3527,2407,2369,24,38,"PODEMOS-EU",163
15,"15080",1637,1009,992,11,17,"PODEMOS-EU",54
32,"32082",1164,736,728,11,8,"PODEMOS-EU",23
32,"32012",708,448,440,2,8,"PODEMOS-EU",31
36,"36006",11502,8057,7927,53,130,"PODEMOS-EU",918
36,"36022",9046,5834,5720,37,114,"PODEMOS-EU",1224
32,"32072",3664,2387,2355,24,32,"PODEMOS-EU",229
32,"32056",1490,1009,1003,10,6,"PODEMOS-EU",25
27,"27056",1218,787,778,6,9,"PODEMOS-EU",68
15,"15041",9569,6362,6269,104,93,"PODEMOS-EU",669
32,"32081",2057,1466,1445,17,21,"PODEMOS-EU",77
32,"32061",1078,777,770,5,7,"PODEMOS-EU",28
36,"36005",8105,5258,5152,54,106,"PODEMOS-EU",531
27,"27009",2005,1324,1303,11,21,"PODEMOS-EU",42
32,"32019",11469,7336,7225,98,111,"PODEMOS-EU",512
15,"15079",1437,887,868,8,19,"PODEMOS-EU",52
32,"32053",1362,1001,989,10,12,"PODEMOS-EU",59
32,"32048",846,460,458,1,2,"PODEMOS-EU",26
15,"15002",24040,16302,16117,183,185,"PODEMOS-EU",2313
15,"15010",1805,1047,1031,19,16,"PODEMOS-EU",45
27,"27051",7986,5324,5241,58,83,"PODEMOS-EU",662
36,"36028",4049,2783,2739,22,44,"PODEMOS-EU",231
32,"32021",872,555,550,6,5,"PODEMOS-EU",34
32,"32049",683,375,372,3,3,"PODEMOS-EU",26
15,"15003",1675,1029,1020,9,9,"PODEMOS-EU",57
27,"27006",2441,1479,1460,11,19,"PODEMOS-EU",100
27,"27037",1001,714,707,11,7,"PODEMOS-EU",32
36,"36055",13585,9177,8986,115,191,"PODEMOS-EU",1057
32,"32086",2531,1348,1332,11,16,"PODEMOS-EU",64
15,"15059",10229,6900,6734,85,166,"PODEMOS-EU",518
15,"15090",1115,711,701,19,10,"PODEMOS-EU",26
36,"36034",3299,2155,2132,15,23,"PODEMOS-EU",268
27,"27015",3995,2518,2460,25,58,"PODEMOS-EU",174
15,"15036",56053,36487,36175,501,312,"PODEMOS-EU",5770
15,"15046",6157,3965,3865,23,100,"PODEMOS-EU",321
32,"32075",4362,3117,3077,30,40,"PODEMOS-EU",242
15,"15060",5871,4044,3978,58,66,"PODEMOS-EU",405
27,"27014",3144,2009,1985,24,24,"PODEMOS-EU",112
32,"32055",1216,781,764,10,17,"PODEMOS-EU",62
15,"15088",3396,2047,2022,22,25,"PODEMOS-EU",136
15,"15051",4545,2978,2945,47,33,"PODEMOS-EU",518
32,"32067",1189,696,692,4,4,"PODEMOS-EU",47
15,"15065",7134,4869,4785,53,84,"PODEMOS-EU",596
15,"15011",15501,9988,9846,78,142,"PODEMOS-EU",1298
15,"15047",2256,1429,1405,25,24,"PODEMOS-EU",113
15,"15072",9434,6304,6228,48,76,"PODEMOS-EU",823
32,"32089",1206,740,726,8,14,"PODEMOS-EU",22
27,"27046",1444,945,921,7,24,"PODEMOS-EU",62
27,"27047",1517,955,940,12,15,"PODEMOS-EU",66
15,"15020",3568,2226,2217,19,9,"PODEMOS-EU",207
32,"32008",8647,5570,5495,56,75,"PODEMOS-EU",613
32,"32020",2428,1728,1714,10,14,"PODEMOS-EU",56
36,"36044",2527,1535,1499,12,36,"PODEMOS-EU",227
15,"15086",2760,1829,1810,26,19,"PODEMOS-EU",104
32,"32015",817,454,452,2,2,"PODEMOS-EU",20
27,"27901",2249,1373,1360,22,13,"PODEMOS-EU",77
15,"15022",5580,3508,3472,47,36,"PODEMOS-EU",359
15,"15058",28761,20250,20098,261,152,"PODEMOS-EU",2735
32,"32052",1817,1278,1268,12,10,"PODEMOS-EU",63
15,"15035",11189,7256,7165,104,91,"PODEMOS-EU",1271
15,"15093",4012,2413,2386,24,27,"PODEMOS-EU",147
36,"36052",7266,4772,4685,43,87,"PODEMOS-EU",372
27,"27026",2299,1385,1368,9,17,"PODEMOS-EU",105
15,"15024",4314,2859,2790,44,69,"PODEMOS-EU",193
32,"32025",1014,731,718,5,13,"PODEMOS-EU",55
15,"15076",2490,1539,1517,25,22,"PODEMOS-EU",109
27,"27010",4378,2719,2670,49,49,"PODEMOS-EU",210
15,"15057",12077,8109,8018,83,91,"PODEMOS-EU",919
27,"27049",1324,847,829,8,18,"PODEMOS-EU",26
32,"32028",1537,1012,1004,5,8,"PODEMOS-EU",36
15,"15025",986,529,517,6,12,"PODEMOS-EU",34
15,"15028",1392,944,936,4,8,"PODEMOS-EU",145
15,"15034",2712,1605,1585,15,20,"PODEMOS-EU",98
15,"15008",5646,3859,3836,52,23,"PODEMOS-EU",357
32,"32002",2028,1349,1340,4,9,"PODEMOS-EU",100
27,"27021",1632,962,935,23,27,"PODEMOS-EU",50
27,"27027",1791,1198,1167,17,31,"PODEMOS-EU",80
32,"32022",1238,840,835,10,5,"PODEMOS-EU",58
27,"27017",952,568,562,3,6,"PODEMOS-EU",45
15,"15009",10605,7245,7133,101,112,"PODEMOS-EU",842
27,"27032",3197,1979,1956,30,23,"PODEMOS-EU",168
27,"27008",1326,865,853,5,12,"PODEMOS-EU",47
36,"36030",3921,2516,2484,31,32,"PODEMOS-EU",347
32,"32077",1104,703,700,9,3,"PODEMOS-EU",47
15,"15016",4558,2747,2705,16,42,"PODEMOS-EU",127
27,"27050",2821,1980,1954,11,26,"PODEMOS-EU",128
15,"15012",3603,2484,2422,20,62,"PODEMOS-EU",191
15,"15092",6220,3810,3756,30,54,"PODEMOS-EU",249
32,"32045",2346,1604,1579,20,25,"PODEMOS-EU",84
36,"36031",563,426,420,7,6,"PODEMOS-EU",28
15,"15023",6277,4021,3968,34,53,"PODEMOS-EU",400
27,"27028",78725,52642,51965,642,677,"PODEMOS-EU",5712
32,"32063",1795,1135,1119,16,16,"PODEMOS-EU",81
15,"15039",1224,802,785,9,17,"PODEMOS-EU",52
36,"36058",4957,3043,2994,55,49,"PODEMOS-EU",358
32,"32032",7900,5186,5091,48,95,"PODEMOS-EU",382
15,"15056",5615,3697,3646,31,51,"PODEMOS-EU",283
15,"15006",5159,3008,2960,44,48,"PODEMOS-EU",210
15,"15019",25981,15866,15672,207,194,"PODEMOS-EU",1457
27,"27019",8188,5478,5395,88,83,"PODEMOS-EU",595
36,"36059",4641,2844,2796,29,48,"PODEMOS-EU",152
27,"27057",11047,7078,6941,64,137,"PODEMOS-EU",638
27,"27002",1535,990,968,13,22,"PODEMOS-EU",52
36,"36901",4154,3094,3029,21,65,"PODEMOS-EU",407
27,"27016",6958,4697,4616,50,81,"PODEMOS-EU",378
32,"32057",505,334,328,3,6,"PODEMOS-EU",26
36,"36038",66807,46235,45781,493,454,"PODEMOS-EU",6136
36,"36027",4401,2940,2781,20,159,"PODEMOS-EU",239
32,"32003",863,632,619,3,13,"PODEMOS-EU",38
15,"15078",78810,55693,55183,569,510,"PODEMOS-EU",6857
32,"32027",989,670,660,5,10,"PODEMOS-EU",36
27,"27040",3008,2071,2046,21,25,"PODEMOS-EU",128
32,"32006",1418,986,970,14,16,"PODEMOS-EU",38
36,"36037",2538,1650,1625,12,25,"PODEMOS-EU",237
15,"15029",5354,3082,3050,46,32,"PODEMOS-EU",215
32,"32026",2655,1762,1731,17,31,"PODEMOS-EU",177
27,"27052",860,564,558,7,6,"PODEMOS-EU",23
32,"32004",1608,835,824,5,11,"PODEMOS-EU",15
32,"32039",1154,801,790,11,11,"PODEMOS-EU",46
27,"27031",15107,9759,9593,87,166,"PODEMOS-EU",974
36,"36040",2505,1597,1563,15,34,"PODEMOS-EU",131
15,"15037",4026,2375,2349,10,26,"PODEMOS-EU",314
36,"36051",14358,9408,9255,86,153,"PODEMOS-EU",1046
15,"15015",2877,1845,1821,26,24,"PODEMOS-EU",268
27,"27012",1264,658,650,6,8,"PODEMOS-EU",23
27,"27063",1699,1131,1109,7,22,"PODEMOS-EU",85
27,"27053",497,342,334,2,8,"PODEMOS-EU",9
36,"36054",11107,7027,6894,57,133,"PODEMOS-EU",929
15,"15068",4824,2976,2937,54,39,"PODEMOS-EU",273
32,"32040",1400,1001,990,10,11,"PODEMOS-EU",48
27,"27025",2731,2047,2006,18,41,"PODEMOS-EU",225
15,"15061",5149,3221,3168,44,53,"PODEMOS-EU",240
32,"32073",1273,863,857,6,6,"PODEMOS-EU",95
27,"27041",2216,1463,1445,19,18,"PODEMOS-EU",104
15,"15013",6324,4132,4083,35,49,"PODEMOS-EU",502
15,"15027",1563,1159,1140,23,19,"PODEMOS-EU",95
32,"32092",491,280,275,0,5,"PODEMOS-EU",24
15,"15018",1087,680,670,13,10,"PODEMOS-EU",83
32,"32080",284,209,209,1,0,"PODEMOS-EU",10
27,"27007",2723,1822,1776,23,46,"PODEMOS-EU",106
36,"36001",2397,1674,1651,6,23,"PODEMOS-EU",172
15,"15030",199701,137611,136590,1540,1021,"PODEMOS-EU",19439
36,"36043",4696,3038,3003,21,35,"PODEMOS-EU",359
27,"27060",2434,1458,1434,17,24,"PODEMOS-EU",101
36,"36014",1867,1265,1243,16,22,"PODEMOS-EU",95
32,"32068",1401,882,878,4,4,"PODEMOS-EU",47
32,"32036",1242,856,838,14,18,"PODEMOS-EU",43
36,"36046",4073,2887,2818,31,69,"PODEMOS-EU",291
36,"36013",2216,1298,1290,18,8,"PODEMOS-EU",141
27,"27039",4467,3179,3121,47,58,"PODEMOS-EU",240
32,"32076",1935,1320,1306,15,14,"PODEMOS-EU",29
27,"27018",3211,1830,1800,17,30,"PODEMOS-EU",104
27,"27001",2187,1111,1102,17,9,"PODEMOS-EU",50
27,"27011",2341,1387,1362,7,25,"PODEMOS-EU",106
32,"32064",453,304,302,0,2,"PODEMOS-EU",19
32,"32088",1636,955,944,17,11,"PODEMOS-EU",87
27,"27005",2560,1691,1662,19,29,"PODEMOS-EU",127
36,"36024",16335,11431,11256,99,175,"PODEMOS-EU",732
32,"32084",878,532,527,8,5,"PODEMOS-EU",15
27,"27064",1505,972,951,9,21,"PODEMOS-EU",58
32,"32016",714,494,493,12,1,"PODEMOS-EU",8
27,"27004",1143,640,625,2,15,"PODEMOS-EU",25
32,"32042",1487,1010,1001,12,9,"PODEMOS-EU",60
15,"15085",3176,2073,2047,29,26,"PODEMOS-EU",144
15,"15089",4299,2924,2887,41,37,"PODEMOS-EU",268
36,"36002",3049,1994,1968,22,26,"PODEMOS-EU",134
7,"7052",4853,2765,2743,33,22,"PODEMOS-EUIB",688
7,"7035",1595,1095,1078,13,17,"PODEMOS-EUIB",221
7,"7034",1074,796,779,9,17,"PODEMOS-EUIB",139
7,"7009",737,495,488,3,7,"PODEMOS-EUIB",84
7,"7902",1091,663,645,13,18,"PODEMOS-EUIB",135
7,"7063",1434,1025,1016,10,9,"PODEMOS-EUIB",195
7,"7008",6113,4003,3961,26,42,"PODEMOS-EUIB",841
7,"7003",12521,6457,6381,60,76,"PODEMOS-EUIB",1202
7,"7020",3707,2522,2493,40,29,"PODEMOS-EUIB",659
7,"7050",3513,2036,2013,25,23,"PODEMOS-EUIB",315
7,"7014",7885,3934,3893,43,41,"PODEMOS-EUIB",744
7,"7065",2319,1429,1411,15,18,"PODEMOS-EUIB",343
7,"7038",2046,1416,1406,12,10,"PODEMOS-EUIB",246
7,"7032",21005,12039,11928,114,111,"PODEMOS-EUIB",2515
7,"7054",23257,12613,12464,111,149,"PODEMOS-EUIB",2123
7,"7012",1908,1301,1282,12,19,"PODEMOS-EUIB",255
7,"7060",2713,1796,1772,17,24,"PODEMOS-EUIB",337
7,"7002",6678,4149,4108,31,41,"PODEMOS-EUIB",864
7,"7027",22101,13161,13028,140,133,"PODEMOS-EUIB",2070
7,"7043",3431,2196,2166,21,30,"PODEMOS-EUIB",302
7,"7044",8812,5679,5569,67,110,"PODEMOS-EUIB",872
7,"7010",5078,3353,3318,30,35,"PODEMOS-EUIB",708
7,"7041",2090,1454,1434,17,20,"PODEMOS-EUIB",250
7,"7011",28971,17082,16964,164,118,"PODEMOS-EUIB",2532
7,"7019",161,104,102,0,2,"PODEMOS-EUIB",6
7,"7006",5393,3257,3220,34,37,"PODEMOS-EUIB",729
7,"7031",24972,14866,14757,127,109,"PODEMOS-EUIB",2247
7,"7046",16884,9184,9097,97,87,"PODEMOS-EUIB",1579
7,"7021",229,154,150,3,4,"PODEMOS-EUIB",28
7,"7055",8062,4546,4492,40,54,"PODEMOS-EUIB",562
7,"7030",1598,1127,1098,14,29,"PODEMOS-EUIB",175
7,"7037",3448,1875,1856,18,19,"PODEMOS-EUIB",409
7,"7036",28132,18650,18510,222,140,"PODEMOS-EUIB",3068
7,"7022",11659,7045,6965,84,80,"PODEMOS-EUIB",1037
7,"7001",3647,2430,2383,26,47,"PODEMOS-EUIB",462
7,"7040",289448,169300,167908,1594,1392,"PODEMOS-EUIB",30271
7,"7024",7283,3574,3538,36,36,"PODEMOS-EUIB",753
7,"7057",7471,4430,4392,41,38,"PODEMOS-EUIB",588
7,"7016",2970,1891,1865,22,26,"PODEMOS-EUIB",340
7,"7028",944,635,628,2,7,"PODEMOS-EUIB",158
7,"7042",10846,6354,6299,77,55,"PODEMOS-EUIB",1431
7,"7025",443,313,310,5,3,"PODEMOS-EUIB",62
7,"7029",4393,2888,2855,37,33,"PODEMOS-EUIB",440
7,"7064",5566,3232,3204,18,28,"PODEMOS-EUIB",775
7,"7004",4069,2652,2624,27,28,"PODEMOS-EUIB",461
7,"7061",9451,5735,5666,60,69,"PODEMOS-EUIB",1106
7,"7015",22248,12375,12286,202,89,"PODEMOS-EUIB",2832
7,"7039",5019,3066,3017,23,49,"PODEMOS-EUIB",378
7,"7007",416,277,275,4,2,"PODEMOS-EUIB",53
7,"7017",899,604,596,10,8,"PODEMOS-EUIB",131
7,"7013",7353,4725,4639,43,86,"PODEMOS-EUIB",591
7,"7026",31129,17489,17342,178,147,"PODEMOS-EUIB",2990
7,"7053",1209,870,864,10,6,"PODEMOS-EUIB",175
7,"7062",7972,3946,3896,42,50,"PODEMOS-EUIB",751
7,"7049",1479,935,918,5,17,"PODEMOS-EUIB",186
7,"7045",1317,931,928,8,3,"PODEMOS-EUIB",203
7,"7058",2866,2013,1996,24,17,"PODEMOS-EUIB",371
7,"7018",389,238,236,1,2,"PODEMOS-EUIB",50
7,"7051",5484,3133,3094,43,39,"PODEMOS-EUIB",525
7,"7059",3074,1973,1948,17,25,"PODEMOS-EUIB",221
7,"7033",28539,15238,15070,187,168,"PODEMOS-EUIB",2802
7,"7047",2399,1504,1477,20,27,"PODEMOS-EUIB",309
7,"7005",6956,4042,3996,35,46,"PODEMOS-EUIB",695
7,"7048",18455,9929,9858,116,71,"PODEMOS-EUIB",2007
7,"7056",5271,3429,3386,44,43,"PODEMOS-EUIB",773
7,"7901",598,410,402,6,8,"PODEMOS-EUIB",46
7,"7023",3776,2425,2386,34,39,"PODEMOS-EUIB",555
46,"46200",1840,1475,1455,5,20,"PODEMOS-EUPV",155
46,"46182",1312,908,904,5,4,"PODEMOS-EUPV",192
46,"46094",20805,15353,15211,122,142,"PODEMOS-EUPV",2054
46,"46123",1926,1392,1368,11,24,"PODEMOS-EUPV",259
3,"3060",105,78,77,0,1,"PODEMOS-EUPV",18
3,"3118",2446,1617,1598,8,19,"PODEMOS-EUPV",157
12,"12129",1783,1207,1184,16,23,"PODEMOS-EUPV",199
46,"46164",12145,8373,8248,44,125,"PODEMOS-EUPV",1086
46,"46185",361,301,299,5,2,"PODEMOS-EUPV",53
12,"12007",724,622,614,2,8,"PODEMOS-EUPV",92
46,"46231",2403,1670,1652,11,18,"PODEMOS-EUPV",369
46,"46111",11367,7995,7908,66,87,"PODEMOS-EUPV",1012
12,"12080",1883,1472,1438,8,34,"PODEMOS-EUPV",145
12,"12071",1272,936,925,3,11,"PODEMOS-EUPV",97
12,"12061",374,263,261,4,2,"PODEMOS-EUPV",29
3,"3034",1404,1028,1010,5,18,"PODEMOS-EUPV",139
46,"46230",14116,10038,9946,63,92,"PODEMOS-EUPV",1326
46,"46124",786,638,625,1,13,"PODEMOS-EUPV",43
46,"46220",49112,33766,33424,312,342,"PODEMOS-EUPV",6938
46,"46189",469,374,367,2,7,"PODEMOS-EUPV",34
3,"3068",41,38,37,0,1,"PODEMOS-EUPV",2
46,"46049",268,221,217,2,4,"PODEMOS-EUPV",29
46,"46202",17801,13010,12906,87,104,"PODEMOS-EUPV",1725
46,"46093",2151,1652,1640,10,12,"PODEMOS-EUPV",144
46,"46237",7172,5199,5146,53,53,"PODEMOS-EUPV",770
3,"3028",959,780,767,7,13,"PODEMOS-EUPV",107
46,"46101",819,670,663,8,7,"PODEMOS-EUPV",92
3,"3098",523,382,378,1,4,"PODEMOS-EUPV",53
46,"46137",248,201,197,3,4,"PODEMOS-EUPV",29
12,"12032",23728,16870,16726,121,144,"PODEMOS-EUPV",1896
46,"46157",2959,2145,2126,11,19,"PODEMOS-EUPV",248
3,"3131",176,129,126,1,3,"PODEMOS-EUPV",23
46,"46010",943,691,681,7,10,"PODEMOS-EUPV",142
46,"46208",1071,854,845,2,9,"PODEMOS-EUPV",93
3,"3041",6132,4204,4167,22,37,"PODEMOS-EUPV",661
3,"3048",4993,3549,3502,13,47,"PODEMOS-EUPV",309
3,"3101",4933,3502,3462,16,40,"PODEMOS-EUPV",716
12,"12102",518,424,417,4,7,"PODEMOS-EUPV",25
3,"3050",19420,13210,13116,70,94,"PODEMOS-EUPV",1793
12,"12137",40,28,28,0,0,"PODEMOS-EUPV",6
46,"46032",5719,4297,4262,35,35,"PODEMOS-EUPV",681
12,"12131",97,87,87,0,0,"PODEMOS-EUPV",5
46,"46031",10574,7233,7158,58,75,"PODEMOS-EUPV",1066
46,"46187",1292,924,920,4,4,"PODEMOS-EUPV",120
46,"46215",1407,1088,1068,10,20,"PODEMOS-EUPV",259
46,"46225",351,267,262,1,5,"PODEMOS-EUPV",44
46,"46238",13117,9172,9088,50,84,"PODEMOS-EUPV",1562
46,"46216",5277,4146,4111,42,35,"PODEMOS-EUPV",533
3,"3057",174,138,136,0,2,"PODEMOS-EUPV",18
3,"3140",26036,18637,18267,237,370,"PODEMOS-EUPV",2458
46,"46212",1620,1130,1112,12,18,"PODEMOS-EUPV",171
46,"46069",152,112,111,1,1,"PODEMOS-EUPV",5
46,"46022",15392,10624,10546,69,78,"PODEMOS-EUPV",1553
12,"12094",871,671,661,1,10,"PODEMOS-EUPV",124
46,"46079",314,244,240,0,4,"PODEMOS-EUPV",17
3,"3044",4608,3437,3391,13,46,"PODEMOS-EUPV",233
46,"46117",493,386,380,2,6,"PODEMOS-EUPV",54
46,"46068",345,283,279,2,4,"PODEMOS-EUPV",22
12,"12105",825,602,598,6,4,"PODEMOS-EUPV",36
3,"3096",5786,4355,4281,38,74,"PODEMOS-EUPV",634
46,"46205",14237,10641,10533,77,108,"PODEMOS-EUPV",1337
12,"12052",537,409,398,5,11,"PODEMOS-EUPV",21
12,"12134",135,95,95,1,0,"PODEMOS-EUPV",16
46,"46902",352,283,283,0,0,"PODEMOS-EUPV",33
3,"3053",7568,5551,5468,40,83,"PODEMOS-EUPV",761
3,"3009",46125,33613,33319,315,294,"PODEMOS-EUPV",5299
46,"46261",1708,1259,1237,12,22,"PODEMOS-EUPV",213
3,"3024",3937,2992,2952,19,40,"PODEMOS-EUPV",192
3,"3007",173,141,139,0,2,"PODEMOS-EUPV",29
12,"12021",4398,3314,3277,32,37,"PODEMOS-EUPV",569
3,"3086",169,140,140,2,0,"PODEMOS-EUPV",25
12,"12053",2040,1587,1579,8,8,"PODEMOS-EUPV",208
46,"46163",1883,1471,1460,8,11,"PODEMOS-EUPV",193
12,"12096",732,526,519,4,7,"PODEMOS-EUPV",78
46,"46903",6306,4762,4743,44,19,"PODEMOS-EUPV",538
12,"12079",414,310,305,2,5,"PODEMOS-EUPV",22
46,"46257",5436,3972,3933,28,39,"PODEMOS-EUPV",633
12,"12058",59,47,45,1,2,"PODEMOS-EUPV",5
3,"3005",7937,5907,5869,40,38,"PODEMOS-EUPV",516
3,"3011",8014,5278,5212,50,66,"PODEMOS-EUPV",616
3,"3006",493,365,360,2,5,"PODEMOS-EUPV",74
3,"3013",1063,809,794,3,15,"PODEMOS-EUPV",63
3,"3004",603,425,423,2,2,"PODEMOS-EUPV",56
46,"46071",471,355,349,1,6,"PODEMOS-EUPV",58
46,"46193",8959,6880,6824,66,56,"PODEMOS-EUPV",1045
46,"46246",1049,808,793,3,15,"PODEMOS-EUPV",68
46,"46086",80,66,65,1,1,"PODEMOS-EUPV",21
3,"3123",7579,5491,5416,50,75,"PODEMOS-EUPV",641
46,"46213",15499,10610,10482,173,128,"PODEMOS-EUPV",1025
3,"3114",1593,1158,1142,4,16,"PODEMOS-EUPV",96
46,"46122",2726,1957,1934,13,23,"PODEMOS-EUPV",284
12,"12006",177,133,133,2,0,"PODEMOS-EUPV",24
46,"46146",1647,1241,1229,12,12,"PODEMOS-EUPV",108
3,"3019",15501,11261,11106,86,155,"PODEMOS-EUPV",1394
3,"3081",1492,1070,1044,12,26,"PODEMOS-EUPV",118
46,"46053",525,433,428,2,5,"PODEMOS-EUPV",63
46,"46147",17186,11507,11399,72,108,"PODEMOS-EUPV",1549
46,"46040",993,745,733,3,12,"PODEMOS-EUPV",112
46,"46033",196,155,153,0,2,"PODEMOS-EUPV",4
12,"12113",90,59,59,1,0,"PODEMOS-EUPV",5
3,"3001",337,260,258,0,2,"PODEMOS-EUPV",31
46,"46139",4520,3486,3457,18,29,"PODEMOS-EUPV",334
12,"12103",87,61,60,0,1,"PODEMOS-EUPV",6
3,"3021",5573,4423,4343,23,80,"PODEMOS-EUPV",457
46,"46255",3220,2361,2340,20,21,"PODEMOS-EUPV",365
46,"46008",2617,1954,1931,17,23,"PODEMOS-EUPV",295
3,"3015",12818,9127,9017,46,110,"PODEMOS-EUPV",986
3,"3105",5510,3879,3792,27,87,"PODEMOS-EUPV",351
46,"46078",28484,19694,19520,173,174,"PODEMOS-EUPV",3277
12,"12115",205,161,161,1,0,"PODEMOS-EUPV",12
46,"46012",965,689,675,4,14,"PODEMOS-EUPV",84
46,"46236",929,723,716,2,7,"PODEMOS-EUPV",140
46,"46227",893,687,675,6,12,"PODEMOS-EUPV",136
12,"12025",116,82,79,1,3,"PODEMOS-EUPV",19
46,"46144",628,483,478,4,5,"PODEMOS-EUPV",40
46,"46177",4832,3592,3539,20,53,"PODEMOS-EUPV",542
46,"46222",402,329,326,0,3,"PODEMOS-EUPV",66
46,"46240",200,167,155,1,12,"PODEMOS-EUPV",21
46,"46056",176,142,142,0,0,"PODEMOS-EUPV",19
46,"46121",106,91,90,1,1,"PODEMOS-EUPV",4
3,"3903",2612,1838,1814,7,24,"PODEMOS-EUPV",181
12,"12074",756,611,601,3,10,"PODEMOS-EUPV",24
12,"12073",133,97,97,0,0,"PODEMOS-EUPV",14
46,"46104",1906,1422,1409,5,13,"PODEMOS-EUPV",118
3,"3107",2785,1766,1746,13,20,"PODEMOS-EUPV",281
3,"3032",97,82,82,0,0,"PODEMOS-EUPV",14
3,"3022",140,125,121,1,4,"PODEMOS-EUPV",25
3,"3128",4285,2849,2819,18,30,"PODEMOS-EUPV",338
3,"3078",468,340,336,0,4,"PODEMOS-EUPV",25
46,"46025",2445,1875,1853,16,22,"PODEMOS-EUPV",257
46,"46048",3504,2609,2576,17,33,"PODEMOS-EUPV",272
12,"12003",954,710,702,6,8,"PODEMOS-EUPV",87
46,"46003",948,770,757,8,13,"PODEMOS-EUPV",75
12,"12041",92,69,69,2,0,"PODEMOS-EUPV",4
46,"46007",12333,8890,8803,79,87,"PODEMOS-EUPV",1190
46,"46039",2111,1657,1640,16,17,"PODEMOS-EUPV",170
46,"46221",348,292,290,1,2,"PODEMOS-EUPV",29
12,"12015",115,94,94,0,0,"PODEMOS-EUPV",16
46,"46109",6248,4516,4440,37,76,"PODEMOS-EUPV",686
46,"46162",1168,839,832,3,7,"PODEMOS-EUPV",51
46,"46235",21229,15171,15011,126,160,"PODEMOS-EUPV",2095
12,"12043",570,405,397,1,8,"PODEMOS-EUPV",55
46,"46066",1274,972,970,4,2,"PODEMOS-EUPV",118
3,"3091",244,194,193,2,1,"PODEMOS-EUPV",17
12,"12083",88,69,67,9,2,"PODEMOS-EUPV",3
46,"46159",23038,16719,16596,127,123,"PODEMOS-EUPV",2750
12,"12110",222,156,155,3,1,"PODEMOS-EUPV",15
46,"46250",582242,437146,434438,3315,2708,"PODEMOS-EUPV",59682
12,"12125",215,179,179,2,0,"PODEMOS-EUPV",21
12,"12064",80,71,69,0,2,"PODEMOS-EUPV",5
46,"46106",1471,1033,1028,8,5,"PODEMOS-EUPV",160
12,"12118",78,64,63,0,1,"PODEMOS-EUPV",7
3,"3029",236,174,172,2,2,"PODEMOS-EUPV",19
3,"3137",654,449,443,7,6,"PODEMOS-EUPV",77
46,"46030",810,641,625,7,16,"PODEMOS-EUPV",84
46,"46195",2000,1540,1532,3,8,"PODEMOS-EUPV",182
3,"3085",271,229,227,5,2,"PODEMOS-EUPV",30
46,"46136",2598,1875,1851,14,24,"PODEMOS-EUPV",277
46,"46160",1922,1395,1381,4,14,"PODEMOS-EUPV",227
12,"12135",36287,25912,25655,184,257,"PODEMOS-EUPV",3657
12,"12126",24374,17741,17553,111,188,"PODEMOS-EUPV",2931
12,"12034",1389,1022,1002,5,20,"PODEMOS-EUPV",123
12,"12119",139,97,94,3,3,"PODEMOS-EUPV",10
46,"46149",350,252,249,3,3,"PODEMOS-EUPV",18
3,"3071",4000,2858,2813,27,45,"PODEMOS-EUPV",397
3,"3010",332,275,268,1,7,"PODEMOS-EUPV",42
3,"3002",3649,2568,2542,11,26,"PODEMOS-EUPV",329
46,"46142",778,536,524,3,12,"PODEMOS-EUPV",51
12,"12082",9602,7323,7248,53,75,"PODEMOS-EUPV",773
3,"3094",9795,6528,6481,37,47,"PODEMOS-EUPV",885
3,"3124",459,360,358,0,2,"PODEMOS-EUPV",64
46,"46055",1298,992,977,9,15,"PODEMOS-EUPV",141
3,"3040",264,227,221,1,6,"PODEMOS-EUPV",41
3,"3069",3329,2102,2077,11,25,"PODEMOS-EUPV",247
3,"3056",8588,6219,6135,29,84,"PODEMOS-EUPV",851
3,"3083",5479,3736,3674,39,62,"PODEMOS-EUPV",516
46,"46061",351,276,272,6,4,"PODEMOS-EUPV",35
12,"12099",597,444,436,6,8,"PODEMOS-EUPV",50
46,"46050",185,141,141,1,0,"PODEMOS-EUPV",19
46,"46223",7776,5848,5798,36,50,"PODEMOS-EUPV",680
46,"46150",1794,1276,1272,8,4,"PODEMOS-EUPV",128
3,"3045",216,176,172,1,4,"PODEMOS-EUPV",14
46,"46091",110,100,100,0,0,"PODEMOS-EUPV",9
3,"3037",340,261,255,3,6,"PODEMOS-EUPV",38
12,"12111",327,259,255,8,4,"PODEMOS-EUPV",15
46,"46120",1179,903,880,5,23,"PODEMOS-EUPV",133
46,"46254",944,673,661,6,12,"PODEMOS-EUPV",57
3,"3035",627,485,485,2,0,"PODEMOS-EUPV",57
12,"12059",220,183,183,2,0,"PODEMOS-EUPV",26
46,"46181",16967,11951,11835,98,116,"PODEMOS-EUPV",1410
3,"3090",18095,12539,12412,75,127,"PODEMOS-EUPV",1778
12,"12001",1028,783,768,6,15,"PODEMOS-EUPV",85
3,"3072",352,281,277,3,4,"PODEMOS-EUPV",49
12,"12031",3960,2913,2869,13,44,"PODEMOS-EUPV",429
3,"3059",20710,14788,14685,89,103,"PODEMOS-EUPV",1739
46,"46113",2558,1791,1773,7,18,"PODEMOS-EUPV",189
46,"46114",552,417,412,6,5,"PODEMOS-EUPV",27
46,"46017",33041,23469,23277,173,192,"PODEMOS-EUPV",2845
3,"3065",169894,121210,120342,1045,868,"PODEMOS-EUPV",14202
12,"12901",3339,2583,2561,25,22,"PODEMOS-EUPV",297
46,"46252",125,89,86,1,3,"PODEMOS-EUPV",3
3,"3102",7181,5126,5073,36,53,"PODEMOS-EUPV",810
3,"3079",18422,13560,13378,152,182,"PODEMOS-EUPV",1894
46,"46042",3335,2655,2620,12,35,"PODEMOS-EUPV",247
46,"46001",771,562,560,3,2,"PODEMOS-EUPV",46
3,"3111",5579,3777,3737,23,40,"PODEMOS-EUPV",366
46,"46035",6828,5155,5089,33,66,"PODEMOS-EUPV",717
46,"46005",23129,16610,16437,148,173,"PODEMOS-EUPV",2554
3,"3127",350,260,255,1,5,"PODEMOS-EUPV",19
3,"3038",330,260,254,3,6,"PODEMOS-EUPV",23
3,"3089",9496,6617,6484,51,133,"PODEMOS-EUPV",885
3,"3136",399,302,301,3,1,"PODEMOS-EUPV",55
12,"12084",17785,12557,12422,108,135,"PODEMOS-EUPV",1427
3,"3095",4807,3453,3410,31,43,"PODEMOS-EUPV",553
46,"46019",8932,6721,6647,40,74,"PODEMOS-EUPV",670
12,"12076",72,54,54,0,0,"PODEMOS-EUPV",5
46,"46075",144,125,122,2,3,"PODEMOS-EUPV",9
46,"46045",1245,984,961,3,23,"PODEMOS-EUPV",264
12,"12130",414,329,327,0,2,"PODEMOS-EUPV",10
46,"46084",1487,1136,1123,4,13,"PODEMOS-EUPV",128
12,"12127",63,45,44,1,1,"PODEMOS-EUPV",11
12,"12121",1043,878,856,5,22,"PODEMOS-EUPV",68
46,"46192",786,534,519,7,15,"PODEMOS-EUPV",52
46,"46167",342,240,239,0,1,"PODEMOS-EUPV",26
46,"46067",1753,1356,1341,8,15,"PODEMOS-EUPV",113
12,"12065",167,142,141,0,1,"PODEMOS-EUPV",10
3,"3012",1138,863,846,4,17,"PODEMOS-EUPV",79
46,"46188",693,565,560,2,5,"PODEMOS-EUPV",54
46,"46082",4981,3547,3523,29,24,"PODEMOS-EUPV",596
12,"12097",62,53,51,0,2,"PODEMOS-EUPV",6
12,"12055",103,77,76,2,1,"PODEMOS-EUPV",10
46,"46018",562,442,436,2,6,"PODEMOS-EUPV",40
46,"46098",2405,1778,1751,7,27,"PODEMOS-EUPV",175
46,"46154",795,619,608,5,11,"PODEMOS-EUPV",54
46,"46020",3757,2834,2783,16,51,"PODEMOS-EUPV",332
12,"12132",477,391,385,3,6,"PODEMOS-EUPV",65
46,"46243",124,93,90,1,3,"PODEMOS-EUPV",8
12,"12014",164,111,111,0,0,"PODEMOS-EUPV",11
12,"12122",754,608,600,3,8,"PODEMOS-EUPV",36
3,"3018",12433,8582,8502,54,80,"PODEMOS-EUPV",1100
46,"46155",972,731,716,3,15,"PODEMOS-EUPV",96
12,"12009",17943,12389,12292,102,97,"PODEMOS-EUPV",1429
46,"46259",457,374,371,2,3,"PODEMOS-EUPV",35
46,"46038",302,221,220,1,1,"PODEMOS-EUPV",40
3,"3027",167,142,138,1,4,"PODEMOS-EUPV",18
46,"46239",446,357,352,1,5,"PODEMOS-EUPV",21
3,"3135",195,134,131,1,3,"PODEMOS-EUPV",27
46,"46103",1354,993,978,8,15,"PODEMOS-EUPV",153
46,"46099",744,539,535,2,4,"PODEMOS-EUPV",46
46,"46037",1120,891,879,7,12,"PODEMOS-EUPV",84
46,"46041",313,229,228,1,1,"PODEMOS-EUPV",48
46,"46190",50042,35290,35066,284,224,"PODEMOS-EUPV",4975
46,"46013",17761,13652,13548,144,104,"PODEMOS-EUPV",1992
46,"46023",322,254,252,1,2,"PODEMOS-EUPV",49
46,"46105",16126,10958,10847,76,111,"PODEMOS-EUPV",1178
12,"12008",228,195,194,1,1,"PODEMOS-EUPV",22
46,"46065",1584,1199,1183,11,16,"PODEMOS-EUPV",154
12,"12109",646,489,482,4,7,"PODEMOS-EUPV",41
12,"12091",171,110,108,4,2,"PODEMOS-EUPV",4
46,"46063",1786,1270,1255,8,15,"PODEMOS-EUPV",204
46,"46172",5488,3724,3674,26,50,"PODEMOS-EUPV",579
12,"12004",4149,2945,2910,25,35,"PODEMOS-EUPV",329
46,"46228",2426,1819,1802,19,17,"PODEMOS-EUPV",237
3,"3003",449,368,367,1,1,"PODEMOS-EUPV",38
12,"12017",145,111,110,2,1,"PODEMOS-EUPV",7
3,"3121",21997,14689,14572,103,117,"PODEMOS-EUPV",1852
46,"46211",1862,1395,1381,12,14,"PODEMOS-EUPV",155
46,"46051",8469,6120,6070,40,50,"PODEMOS-EUPV",559
3,"3042",1475,1053,1043,7,10,"PODEMOS-EUPV",145
46,"46175",429,362,355,3,7,"PODEMOS-EUPV",45
12,"12117",3532,2512,2479,12,33,"PODEMOS-EUPV",274
46,"46027",924,746,737,2,9,"PODEMOS-EUPV",74
12,"12088",57,53,53,0,0,"PODEMOS-EUPV",7
3,"3093",19702,13903,13728,113,175,"PODEMOS-EUPV",2006
46,"46029",20448,14673,14556,99,117,"PODEMOS-EUPV",1497
46,"46036",558,339,331,6,8,"PODEMOS-EUPV",30
46,"46219",125,107,104,0,3,"PODEMOS-EUPV",11
12,"12044",442,371,368,1,3,"PODEMOS-EUPV",41
46,"46110",21364,15132,15019,120,113,"PODEMOS-EUPV",2240
3,"3031",42046,25035,24819,168,216,"PODEMOS-EUPV",2746
3,"3120",2433,1688,1652,13,36,"PODEMOS-EUPV",189
46,"46132",2176,1725,1708,5,17,"PODEMOS-EUPV",185
46,"46133",462,359,352,1,7,"PODEMOS-EUPV",27
46,"46207",6761,4966,4909,46,57,"PODEMOS-EUPV",624
12,"12002",114,96,94,1,2,"PODEMOS-EUPV",18
3,"3116",1155,819,805,5,14,"PODEMOS-EUPV",107
3,"3025",1304,944,934,4,10,"PODEMOS-EUPV",48
46,"46058",1734,1245,1230,8,15,"PODEMOS-EUPV",131
12,"12038",157,101,100,3,1,"PODEMOS-EUPV",7
46,"46127",2748,2035,2009,6,26,"PODEMOS-EUPV",294
46,"46262",206,136,134,1,2,"PODEMOS-EUPV",17
3,"3092",6712,4924,4858,35,66,"PODEMOS-EUPV",857
46,"46258",2617,1925,1914,5,11,"PODEMOS-EUPV",278
3,"3070",2115,1399,1376,9,23,"PODEMOS-EUPV",186
46,"46002",1253,946,940,4,6,"PODEMOS-EUPV",128
3,"3051",342,288,286,4,2,"PODEMOS-EUPV",24
46,"46108",420,328,324,1,4,"PODEMOS-EUPV",23
3,"3049",12103,8872,8785,57,87,"PODEMOS-EUPV",855
46,"46206",555,417,408,0,9,"PODEMOS-EUPV",57
46,"46229",903,715,708,5,7,"PODEMOS-EUPV",118
3,"3117",377,306,302,2,4,"PODEMOS-EUPV",44
46,"46070",17824,12888,12802,106,86,"PODEMOS-EUPV",1401
12,"12060",434,366,360,1,6,"PODEMOS-EUPV",50
46,"46232",853,661,648,7,13,"PODEMOS-EUPV",46
3,"3066",41762,28723,28388,358,335,"PODEMOS-EUPV",3766
46,"46028",383,305,299,8,6,"PODEMOS-EUPV",42
46,"46081",9999,7486,7412,47,74,"PODEMOS-EUPV",874
3,"3080",1330,1040,1032,4,8,"PODEMOS-EUPV",61
46,"46085",11089,7581,7503,60,78,"PODEMOS-EUPV",724
46,"46198",862,670,660,3,10,"PODEMOS-EUPV",94
12,"12012",2622,2084,2056,12,28,"PODEMOS-EUPV",308
46,"46169",32403,23890,23698,222,192,"PODEMOS-EUPV",3585
3,"3902",10640,7024,6952,36,72,"PODEMOS-EUPV",554
46,"46171",16446,11616,11499,94,117,"PODEMOS-EUPV",1629
46,"46072",3522,2792,2741,25,51,"PODEMOS-EUPV",323
46,"46014",3156,2324,2294,13,30,"PODEMOS-EUPV",313
46,"46904",812,615,605,2,10,"PODEMOS-EUPV",80
3,"3119",17253,12346,12258,81,88,"PODEMOS-EUPV",1724
46,"46073",1066,823,817,11,6,"PODEMOS-EUPV",167
3,"3030",559,442,433,2,9,"PODEMOS-EUPV",73
3,"3104",27072,19732,19477,218,255,"PODEMOS-EUPV",3083
46,"46119",761,587,580,6,7,"PODEMOS-EUPV",80
46,"46186",19689,14688,14576,118,112,"PODEMOS-EUPV",2058
46,"46102",19696,14700,14579,125,121,"PODEMOS-EUPV",2222
46,"46244",59910,42120,41826,338,294,"PODEMOS-EUPV",5025
3,"3122",43774,30060,29834,230,226,"PODEMOS-EUPV",4590
3,"3047",9768,6220,6144,41,76,"PODEMOS-EUPV",760
3,"3115",255,213,213,3,0,"PODEMOS-EUPV",29
12,"12085",5081,3271,3235,17,36,"PODEMOS-EUPV",392
12,"12092",123,95,95,0,0,"PODEMOS-EUPV",21
3,"3075",154,117,115,1,2,"PODEMOS-EUPV",18
12,"12056",257,205,199,1,6,"PODEMOS-EUPV",41
46,"46064",532,395,387,3,8,"PODEMOS-EUPV",42
12,"12027",17506,11776,11649,84,127,"PODEMOS-EUPV",1618
12,"12045",333,243,235,2,8,"PODEMOS-EUPV",29
46,"46173",1309,1029,1010,13,19,"PODEMOS-EUPV",142
46,"46087",109,94,94,2,0,"PODEMOS-EUPV",11
46,"46245",527,407,404,2,3,"PODEMOS-EUPV",68
3,"3084",501,413,413,1,0,"PODEMOS-EUPV",39
3,"3036",82,73,71,1,2,"PODEMOS-EUPV",7
3,"3097",1014,778,764,5,14,"PODEMOS-EUPV",110
3,"3106",559,469,465,3,4,"PODEMOS-EUPV",52
12,"12136",2603,2151,2119,20,32,"PODEMOS-EUPV",113
46,"46047",540,428,420,1,8,"PODEMOS-EUPV",54
46,"46184",26514,19610,19399,180,211,"PODEMOS-EUPV",2939
3,"3016",88,66,66,0,0,"PODEMOS-EUPV",8
46,"46015",7519,5575,5532,34,43,"PODEMOS-EUPV",832
3,"3132",512,376,373,2,3,"PODEMOS-EUPV",56
46,"46179",2136,1624,1596,17,28,"PODEMOS-EUPV",177
12,"12051",437,297,295,3,2,"PODEMOS-EUPV",15
12,"12140",1147,849,841,5,8,"PODEMOS-EUPV",121
46,"46011",7523,5154,5077,34,77,"PODEMOS-EUPV",563
3,"3130",28,19,19,0,0,"PODEMOS-EUPV",1
12,"12101",354,274,270,5,4,"PODEMOS-EUPV",51
46,"46166",8214,6093,6031,38,62,"PODEMOS-EUPV",898
46,"46057",463,308,304,1,4,"PODEMOS-EUPV",25
3,"3109",3003,2186,2151,14,35,"PODEMOS-EUPV",155
46,"46178",5001,3513,3477,26,36,"PODEMOS-EUPV",534
12,"12123",40,32,32,0,0,"PODEMOS-EUPV",4
46,"46116",13606,10262,10200,87,62,"PODEMOS-EUPV",1431
46,"46024",454,343,339,1,4,"PODEMOS-EUPV",33
12,"12028",13004,9801,9732,74,69,"PODEMOS-EUPV",1281
46,"46196",134,111,110,0,1,"PODEMOS-EUPV",7
46,"46197",1930,1430,1411,11,19,"PODEMOS-EUPV",370
46,"46138",361,289,287,1,2,"PODEMOS-EUPV",30
46,"46130",862,633,625,6,8,"PODEMOS-EUPV",64
12,"12107",350,299,295,3,4,"PODEMOS-EUPV",41
12,"12013",135,106,106,1,0,"PODEMOS-EUPV",23
46,"46210",338,256,251,0,5,"PODEMOS-EUPV",25
12,"12069",50,38,38,0,0,"PODEMOS-EUPV",4
46,"46096",263,204,202,0,2,"PODEMOS-EUPV",28
12,"12040",119116,85613,84993,620,620,"PODEMOS-EUPV",11665
46,"46233",3766,2688,2650,14,38,"PODEMOS-EUPV",359
3,"3062",228,173,172,3,1,"PODEMOS-EUPV",19
46,"46060",9278,6796,6724,49,72,"PODEMOS-EUPV",779
46,"46151",757,560,552,2,8,"PODEMOS-EUPV",117
12,"12116",61,49,49,0,0,"PODEMOS-EUPV",4
46,"46241",388,288,283,5,5,"PODEMOS-EUPV",58
12,"12072",1083,852,827,10,25,"PODEMOS-EUPV",62
46,"46183",6036,4276,4213,21,63,"PODEMOS-EUPV",391
46,"46062",4552,3402,3362,27,40,"PODEMOS-EUPV",324
46,"46199",5878,4217,4182,21,35,"PODEMOS-EUPV",507
46,"46176",2077,1362,1348,14,14,"PODEMOS-EUPV",182
46,"46161",1467,1129,1113,5,16,"PODEMOS-EUPV",128
12,"12112",102,79,79,1,0,"PODEMOS-EUPV",1
3,"3088",5895,4030,3961,29,69,"PODEMOS-EUPV",522
46,"46077",7338,5447,5356,44,91,"PODEMOS-EUPV",1627
3,"3110",312,258,258,0,0,"PODEMOS-EUPV",48
12,"12024",138,107,107,1,0,"PODEMOS-EUPV",25
3,"3073",222,178,178,0,0,"PODEMOS-EUPV",29
3,"3064",5015,3514,3461,15,53,"PODEMOS-EUPV",250
46,"46135",9817,7596,7558,58,38,"PODEMOS-EUPV",1055
46,"46224",156,125,124,0,1,"PODEMOS-EUPV",11
12,"12010",232,191,187,3,4,"PODEMOS-EUPV",34
3,"3043",2906,2360,2334,27,26,"PODEMOS-EUPV",320
12,"12050",1226,904,891,3,13,"PODEMOS-EUPV",120
46,"46076",610,500,494,1,6,"PODEMOS-EUPV",53
46,"46129",511,389,379,9,10,"PODEMOS-EUPV",110
3,"3134",139,107,107,0,0,"PODEMOS-EUPV",13
12,"12033",1953,1391,1368,6,23,"PODEMOS-EUPV",148
46,"46165",7349,5460,5412,39,48,"PODEMOS-EUPV",746
46,"46074",2687,2033,2020,18,13,"PODEMOS-EUPV",295
12,"12139",299,202,200,3,2,"PODEMOS-EUPV",17
12,"12108",443,354,352,4,2,"PODEMOS-EUPV",27
46,"46095",580,445,438,5,7,"PODEMOS-EUPV",36
12,"12077",4828,3395,3357,28,38,"PODEMOS-EUPV",456
12,"12128",1365,990,972,16,18,"PODEMOS-EUPV",104
12,"12005",8049,5643,5552,71,91,"PODEMOS-EUPV",829
12,"12048",243,159,155,4,4,"PODEMOS-EUPV",13
46,"46009",3144,2473,2449,22,24,"PODEMOS-EUPV",256
46,"46115",330,219,213,0,6,"PODEMOS-EUPV",7
3,"3058",4976,3733,3669,20,64,"PODEMOS-EUPV",257
46,"46247",972,649,646,3,3,"PODEMOS-EUPV",74
46,"46260",2685,2072,2053,14,19,"PODEMOS-EUPV",323
46,"46234",317,247,245,1,2,"PODEMOS-EUPV",34
12,"12138",19207,13018,12891,87,127,"PODEMOS-EUPV",2549
12,"12049",415,317,305,4,12,"PODEMOS-EUPV",50
3,"3067",91,78,78,0,0,"PODEMOS-EUPV",5
12,"12036",541,401,395,6,6,"PODEMOS-EUPV",40
46,"46080",979,720,712,2,8,"PODEMOS-EUPV",110
12,"12037",17,13,13,1,0,"PODEMOS-EUPV",1
3,"3039",89,65,65,0,0,"PODEMOS-EUPV",8
12,"12087",26,16,16,0,0,"PODEMOS-EUPV",0
46,"46168",2004,1463,1447,12,16,"PODEMOS-EUPV",161
46,"46128",1569,1216,1179,7,37,"PODEMOS-EUPV",113
3,"3061",1060,793,787,5,6,"PODEMOS-EUPV",54
12,"12018",279,233,231,3,2,"PODEMOS-EUPV",28
12,"12114",200,144,140,0,4,"PODEMOS-EUPV",19
3,"3904",1434,1032,1022,8,10,"PODEMOS-EUPV",107
3,"3008",158,120,118,1,2,"PODEMOS-EUPV",13
12,"12022",323,257,254,5,3,"PODEMOS-EUPV",32
46,"46158",1047,771,763,7,8,"PODEMOS-EUPV",139
46,"46046",901,623,609,2,14,"PODEMOS-EUPV",90
3,"3901",1137,783,776,9,7,"PODEMOS-EUPV",105
46,"46170",3417,2618,2577,11,41,"PODEMOS-EUPV",159
46,"46256",7280,4996,4940,32,56,"PODEMOS-EUPV",590
3,"3020",94,84,84,1,0,"PODEMOS-EUPV",17
3,"3063",27209,18236,18101,164,135,"PODEMOS-EUPV",2734
46,"46152",90,63,63,0,0,"PODEMOS-EUPV",5
46,"46180",659,509,500,7,9,"PODEMOS-EUPV",59
3,"3055",5265,3741,3697,16,44,"PODEMOS-EUPV",387
46,"46253",112,84,84,0,0,"PODEMOS-EUPV",7
12,"12142",142,113,113,0,0,"PODEMOS-EUPV",1
12,"12141",92,72,72,0,0,"PODEMOS-EUPV",4
46,"46217",900,672,667,7,5,"PODEMOS-EUPV",60
3,"3017",379,320,314,4,6,"PODEMOS-EUPV",96
46,"46097",948,670,663,1,7,"PODEMOS-EUPV",75
46,"46034",1826,1345,1335,3,10,"PODEMOS-EUPV",176
46,"46214",16637,12113,12014,84,99,"PODEMOS-EUPV",1715
46,"46100",281,190,187,1,3,"PODEMOS-EUPV",28
3,"3139",23126,14650,14522,127,128,"PODEMOS-EUPV",2044
46,"46218",1043,842,829,6,13,"PODEMOS-EUPV",73
46,"46209",1903,1406,1383,5,23,"PODEMOS-EUPV",115
3,"3054",334,248,245,2,3,"PODEMOS-EUPV",36
46,"46126",5580,4361,4328,36,33,"PODEMOS-EUPV",584
12,"12057",572,456,437,1,19,"PODEMOS-EUPV",36
3,"3076",8846,6105,6029,40,76,"PODEMOS-EUPV",687
12,"12089",4555,3070,3045,22,25,"PODEMOS-EUPV",317
46,"46194",15852,11124,11009,86,115,"PODEMOS-EUPV",1468
46,"46118",3649,2730,2701,20,29,"PODEMOS-EUPV",290
3,"3113",4339,2978,2935,23,43,"PODEMOS-EUPV",324
46,"46107",1857,1421,1402,4,19,"PODEMOS-EUPV",218
12,"12104",6843,5181,5111,32,70,"PODEMOS-EUPV",691
46,"46204",6625,4946,4882,52,64,"PODEMOS-EUPV",613
3,"3052",959,747,735,4,12,"PODEMOS-EUPV",58
12,"12020",118,104,103,1,1,"PODEMOS-EUPV",2
12,"12090",102,79,78,1,1,"PODEMOS-EUPV",5
46,"46242",326,260,257,3,3,"PODEMOS-EUPV",17
12,"12081",606,454,446,2,8,"PODEMOS-EUPV",55
3,"3074",1766,1347,1336,4,11,"PODEMOS-EUPV",86
46,"46004",1932,1530,1512,10,18,"PODEMOS-EUPV",142
12,"12100",1273,1069,1052,5,17,"PODEMOS-EUPV",125
12,"12046",188,135,135,4,0,"PODEMOS-EUPV",13
46,"46249",9136,6538,6439,73,99,"PODEMOS-EUPV",674
46,"46112",533,435,432,7,3,"PODEMOS-EUPV",50
46,"46016",1070,827,814,10,13,"PODEMOS-EUPV",149
12,"12124",1842,1343,1328,13,15,"PODEMOS-EUPV",97
12,"12011",4583,3228,3177,24,51,"PODEMOS-EUPV",382
12,"12067",514,381,373,3,8,"PODEMOS-EUPV",40
3,"3129",1224,934,923,4,11,"PODEMOS-EUPV",122
3,"3046",1636,1073,1061,7,12,"PODEMOS-EUPV",157
3,"3082",12941,8399,8304,51,95,"PODEMOS-EUPV",1173
46,"46134",2419,1697,1678,14,19,"PODEMOS-EUPV",280
46,"46148",1515,1131,1113,5,18,"PODEMOS-EUPV",114
3,"3026",1331,987,975,7,12,"PODEMOS-EUPV",161
46,"46203",3546,2717,2689,28,28,"PODEMOS-EUPV",477
12,"12029",670,524,514,5,10,"PODEMOS-EUPV",75
46,"46131",49805,35527,35231,298,296,"PODEMOS-EUPV",4249
12,"12068",41,22,21,0,1,"PODEMOS-EUPV",3
12,"12078",334,224,221,2,3,"PODEMOS-EUPV",22
3,"3103",238,196,194,2,2,"PODEMOS-EUPV",31
46,"46089",2182,1590,1576,9,14,"PODEMOS-EUPV",215
12,"12133",59,46,45,0,1,"PODEMOS-EUPV",4
46,"46156",2017,1538,1524,9,14,"PODEMOS-EUPV",185
12,"12106",1151,928,908,9,20,"PODEMOS-EUPV",121
12,"12026",828,577,566,11,11,"PODEMOS-EUPV",42
3,"3099",43101,30222,29885,196,337,"PODEMOS-EUPV",2619
46,"46026",1220,974,965,7,9,"PODEMOS-EUPV",112
46,"46153",443,353,349,2,4,"PODEMOS-EUPV",58
46,"46083",15372,10939,10815,78,124,"PODEMOS-EUPV",1584
46,"46092",262,176,174,2,2,"PODEMOS-EUPV",31
12,"12093",161,111,109,2,2,"PODEMOS-EUPV",18
46,"46088",152,114,110,1,4,"PODEMOS-EUPV",18
46,"46090",1631,1360,1339,6,21,"PODEMOS-EUPV",147
46,"46125",852,660,650,5,10,"PODEMOS-EUPV",89
12,"12902",2250,1557,1532,16,25,"PODEMOS-EUPV",166
3,"3077",1391,1052,1032,10,20,"PODEMOS-EUPV",117
3,"3100",499,384,378,0,6,"PODEMOS-EUPV",81
46,"46059",1244,1007,995,5,12,"PODEMOS-EUPV",218
12,"12039",792,665,659,2,6,"PODEMOS-EUPV",72
46,"46191",1956,1439,1414,8,25,"PODEMOS-EUPV",233
46,"46021",24053,17331,17194,159,137,"PODEMOS-EUPV",2545
12,"12070",505,407,398,2,9,"PODEMOS-EUPV",34
3,"3138",3190,2244,2207,9,37,"PODEMOS-EUPV",262
12,"12098",529,417,413,3,4,"PODEMOS-EUPV",25
46,"46251",2465,1938,1903,19,35,"PODEMOS-EUPV",231
46,"46174",942,746,736,1,10,"PODEMOS-EUPV",82
46,"46248",4868,3434,3374,16,60,"PODEMOS-EUPV",382
46,"46141",433,340,337,6,3,"PODEMOS-EUPV",38
3,"3125",332,226,226,2,0,"PODEMOS-EUPV",38
3,"3023",1377,1138,1122,9,16,"PODEMOS-EUPV",164
12,"12016",1549,1244,1234,9,10,"PODEMOS-EUPV",89
46,"46006",4454,3527,3486,27,41,"PODEMOS-EUPV",357
46,"46263",235,182,180,2,2,"PODEMOS-EUPV",16
46,"46044",4159,3062,2997,26,65,"PODEMOS-EUPV",363
12,"12120",149,125,121,3,4,"PODEMOS-EUPV",7
46,"46043",135,119,118,0,1,"PODEMOS-EUPV",12
3,"3133",41333,24527,24340,146,187,"PODEMOS-EUPV",3043
46,"46143",4274,3027,2995,19,32,"PODEMOS-EUPV",437
3,"3014",238937,161861,160809,1308,1052,"PODEMOS-EUPV",20364
12,"12075",110,85,83,3,2,"PODEMOS-EUPV",13
3,"3112",650,503,497,3,6,"PODEMOS-EUPV",46
46,"46145",22215,15688,15538,127,150,"PODEMOS-EUPV",2520
46,"46140",383,321,321,2,0,"PODEMOS-EUPV",37
46,"46054",11389,8266,8190,54,76,"PODEMOS-EUPV",1294
46,"46201",62,40,40,0,0,"PODEMOS-EUPV",1
46,"46052",515,423,419,4,4,"PODEMOS-EUPV",42
12,"12063",41,31,31,1,0,"PODEMOS-EUPV",9
3,"3033",101,82,78,0,4,"PODEMOS-EUPV",7
12,"12095",950,723,712,5,11,"PODEMOS-EUPV",90
12,"12042",574,459,446,9,13,"PODEMOS-EUPV",18
46,"46226",29,20,19,0,1,"PODEMOS-EUPV",1
48,"48914",332,276,275,0,1,"PODEMOS-IU",10
48,"48067",1133,810,805,0,5,"PODEMOS-IU",56
48,"48039",254,221,220,2,1,"PODEMOS-IU",11
48,"48029",8681,6057,6027,41,30,"PODEMOS-IU",1287
48,"48095",2324,1568,1555,13,13,"PODEMOS-IU",239
20,"20006",261,154,153,1,1,"PODEMOS-IU",15
48,"48002",7791,5510,5471,42,39,"PODEMOS-IU",1217
1,"1020",323,228,224,1,4,"PODEMOS-IU",22
48,"48024",1000,761,752,1,9,"PODEMOS-IU",59
48,"48001",5899,4094,4074,19,20,"PODEMOS-IU",621
20,"20001",253,163,163,1,0,"PODEMOS-IU",8
20,"20079",18151,13106,13054,58,52,"PODEMOS-IU",1619
20,"20037",101,69,69,0,0,"PODEMOS-IU",5
48,"48030",591,449,447,2,2,"PODEMOS-IU",18
1,"1036",14698,10207,10131,51,76,"PODEMOS-IU",1689
20,"20052",1050,746,743,4,3,"PODEMOS-IU",94
20,"20048",183,112,112,0,0,"PODEMOS-IU",14
20,"20022",849,574,571,8,3,"PODEMOS-IU",39
1,"1006",174,124,122,1,2,"PODEMOS-IU",28
48,"48058",947,682,679,2,3,"PODEMOS-IU",70
20,"20078",1143,819,816,1,3,"PODEMOS-IU",53
48,"48052",1562,1220,1210,5,10,"PODEMOS-IU",99
48,"48042",1359,1055,1045,7,10,"PODEMOS-IU",116
20,"20057",198,148,147,1,1,"PODEMOS-IU",15
1,"1063",1852,1316,1303,6,13,"PODEMOS-IU",167
48,"48011",9640,6753,6722,41,31,"PODEMOS-IU",1202
48,"48051",220,151,150,0,1,"PODEMOS-IU",24
48,"48077",3366,2483,2467,9,16,"PODEMOS-IU",326
48,"48012",2057,1610,1600,1,10,"PODEMOS-IU",161
20,"20002",359,234,231,7,3,"PODEMOS-IU",21
1,"1013",710,469,465,2,4,"PODEMOS-IU",71
1,"1037",589,378,374,1,4,"PODEMOS-IU",44
48,"48908",250,212,210,1,2,"PODEMOS-IU",7
48,"48057",5730,4126,4115,14,11,"PODEMOS-IU",285
20,"20061",4427,3073,3053,13,20,"PODEMOS-IU",336
20,"20047",455,314,314,1,0,"PODEMOS-IU",30
1,"1062",318,221,219,2,2,"PODEMOS-IU",47
48,"48048",527,381,380,3,1,"PODEMOS-IU",35
20,"20038",387,294,293,2,1,"PODEMOS-IU",14
48,"48076",288,211,211,1,0,"PODEMOS-IU",11
1,"1008",808,546,536,6,10,"PODEMOS-IU",55
48,"48043",4591,3337,3325,20,12,"PODEMOS-IU",454
48,"48089",3540,2561,2555,7,6,"PODEMOS-IU",420
48,"48055",2603,1833,1820,14,13,"PODEMOS-IU",213
20,"20025",1110,791,788,4,3,"PODEMOS-IU",63
1,"1028",1091,735,728,5,7,"PODEMOS-IU",102
20,"20008",713,424,424,5,0,"PODEMOS-IU",23
1,"1052",272,189,186,2,3,"PODEMOS-IU",21
20,"20027",2761,1866,1861,10,5,"PODEMOS-IU",191
20,"20017",8462,5944,5917,11,27,"PODEMOS-IU",592
48,"48020",272771,184893,183922,1227,971,"PODEMOS-IU",27791
48,"48062",295,236,236,0,0,"PODEMOS-IU",16
20,"20026",207,172,171,4,1,"PODEMOS-IU",7
1,"1034",152,107,107,1,0,"PODEMOS-IU",12
1,"1057",235,196,194,0,2,"PODEMOS-IU",16
20,"20049",4195,2918,2901,12,17,"PODEMOS-IU",340
48,"48049",543,415,414,1,1,"PODEMOS-IU",36
48,"48015",33077,22441,22295,145,146,"PODEMOS-IU",3807
48,"48034",12623,8789,8711,76,78,"PODEMOS-IU",1553
20,"20058",740,523,522,3,1,"PODEMOS-IU",75
20,"20071",15062,10442,10407,47,35,"PODEMOS-IU",1303
48,"48086",2024,1371,1358,5,13,"PODEMOS-IU",282
1,"1043",2340,1487,1468,11,19,"PODEMOS-IU",254
20,"20907",118,82,82,0,0,"PODEMOS-IU",16
20,"20068",179,119,119,2,0,"PODEMOS-IU",10
48,"48907",343,274,273,0,1,"PODEMOS-IU",17
48,"48047",147,105,105,2,0,"PODEMOS-IU",7
20,"20035",480,361,361,0,0,"PODEMOS-IU",41
20,"20065",2921,1983,1970,16,13,"PODEMOS-IU",219
48,"48037",696,497,485,0,12,"PODEMOS-IU",71
48,"48911",381,303,302,1,1,"PODEMOS-IU",19
48,"48061",789,602,601,2,1,"PODEMOS-IU",64
20,"20039",2126,1623,1618,9,5,"PODEMOS-IU",115
20,"20031",185,113,112,3,1,"PODEMOS-IU",7
1,"1004",1357,952,945,5,7,"PODEMOS-IU",147
48,"48070",527,357,355,0,2,"PODEMOS-IU",19
20,"20007",337,223,221,2,2,"PODEMOS-IU",27
1,"1009",1258,839,833,2,6,"PODEMOS-IU",125
1,"1017",817,537,532,3,5,"PODEMOS-IU",51
48,"48046",12626,9300,9250,31,50,"PODEMOS-IU",917
20,"20013",5433,3906,3893,24,13,"PODEMOS-IU",495
1,"1030",141,102,102,0,0,"PODEMOS-IU",11
20,"20905",160,123,123,2,0,"PODEMOS-IU",7
48,"48090",6004,4305,4254,28,51,"PODEMOS-IU",617
1,"1032",498,363,353,1,10,"PODEMOS-IU",36
20,"20042",3180,2056,2053,7,3,"PODEMOS-IU",271
1,"1021",471,321,319,3,2,"PODEMOS-IU",42
48,"48901",5160,3705,3684,16,21,"PODEMOS-IU",592
20,"20004",230,133,133,2,0,"PODEMOS-IU",11
48,"48074",3275,2308,2295,11,13,"PODEMOS-IU",260
1,"1051",3569,2259,2244,3,15,"PODEMOS-IU",318
48,"48016",5471,3964,3935,31,29,"PODEMOS-IU",550
48,"48081",1903,1455,1447,7,8,"PODEMOS-IU",130
48,"48038",1151,829,829,1,0,"PODEMOS-IU",88
20,"20012",149,104,104,1,0,"PODEMOS-IU",7
48,"48053",926,704,702,6,2,"PODEMOS-IU",32
20,"20018",11231,7640,7611,33,29,"PODEMOS-IU",508
48,"48036",24015,16501,16425,83,76,"PODEMOS-IU",2744
20,"20045",47031,30933,30787,172,146,"PODEMOS-IU",5841
20,"20072",4762,3175,3153,21,22,"PODEMOS-IU",552
20,"20076",7013,5011,4991,16,20,"PODEMOS-IU",800
20,"20028",2254,1442,1441,6,1,"PODEMOS-IU",188
48,"48019",3429,2424,2411,14,13,"PODEMOS-IU",396
48,"48066",344,246,246,2,0,"PODEMOS-IU",17
48,"48902",18987,12762,12670,88,92,"PODEMOS-IU",2168
1,"1002",8014,5838,5786,24,52,"PODEMOS-IU",866
48,"48028",682,551,548,3,3,"PODEMOS-IU",29
20,"20003",549,360,355,1,5,"PODEMOS-IU",33
20,"20067",30609,20017,19927,111,90,"PODEMOS-IU",4170
1,"1044",232,151,148,2,3,"PODEMOS-IU",17
48,"48093",891,669,666,5,3,"PODEMOS-IU",51
20,"20051",6736,4829,4804,22,25,"PODEMOS-IU",687
1,"1047",982,653,642,6,11,"PODEMOS-IU",102
1,"1056",202,107,107,0,0,"PODEMOS-IU",10
48,"48073",6827,4614,4591,38,23,"PODEMOS-IU",444
48,"48007",389,243,243,0,0,"PODEMOS-IU",14
20,"20062",941,688,683,1,5,"PODEMOS-IU",71
20,"20023",441,254,251,1,3,"PODEMOS-IU",25
1,"1018",1399,953,947,1,6,"PODEMOS-IU",142
20,"20063",8023,5611,5597,19,14,"PODEMOS-IU",715
48,"48906",736,550,548,2,2,"PODEMOS-IU",40
20,"20906",128,87,87,0,0,"PODEMOS-IU",12
1,"1049",130,94,94,1,0,"PODEMOS-IU",3
1,"1061",155,116,116,1,0,"PODEMOS-IU",17
48,"48065",3285,2341,2326,8,15,"PODEMOS-IU",344
20,"20901",1399,960,957,3,3,"PODEMOS-IU",168
1,"1901",2473,1633,1612,9,21,"PODEMOS-IU",305
48,"48904",3547,2563,2541,18,22,"PODEMOS-IU",332
48,"48005",116,80,79,0,1,"PODEMOS-IU",14
1,"1042",911,680,671,8,9,"PODEMOS-IU",110
48,"48072",965,730,724,3,6,"PODEMOS-IU",49
48,"48094",3121,2201,2188,7,13,"PODEMOS-IU",164
48,"48091",1078,758,757,5,1,"PODEMOS-IU",64
1,"1023",262,193,190,1,3,"PODEMOS-IU",27
1,"1033",654,476,476,0,0,"PODEMOS-IU",40
20,"20053",4856,3169,3153,15,16,"PODEMOS-IU",548
48,"48905",2496,1778,1766,12,12,"PODEMOS-IU",198
20,"20059",8892,6505,6490,18,15,"PODEMOS-IU",594
48,"48035",406,314,314,0,0,"PODEMOS-IU",38
48,"48080",9916,6849,6793,44,56,"PODEMOS-IU",1290
20,"20075",4312,2848,2845,8,3,"PODEMOS-IU",320
20,"20902",14282,9670,9618,52,52,"PODEMOS-IU",1642
48,"48003",14518,10375,10310,49,65,"PODEMOS-IU",1367
20,"20032",8654,6000,5972,21,28,"PODEMOS-IU",724
48,"48085",10716,7707,7679,51,28,"PODEMOS-IU",1357
48,"48075",2066,1524,1508,9,16,"PODEMOS-IU",179
1,"1011",213,162,160,3,2,"PODEMOS-IU",6
48,"48096",6516,4862,4816,33,46,"PODEMOS-IU",742
20,"20077",5269,3845,3830,9,15,"PODEMOS-IU",529
48,"48068",1534,1154,1149,1,5,"PODEMOS-IU",102
20,"20055",17300,11784,11725,43,59,"PODEMOS-IU",1725
48,"48009",774,585,578,0,7,"PODEMOS-IU",37
20,"20074",11520,8379,8357,19,22,"PODEMOS-IU",1025
48,"48027",22745,16240,16158,74,82,"PODEMOS-IU",2351
20,"20073",4707,3272,3260,14,12,"PODEMOS-IU",382
20,"20070",1084,798,795,7,3,"PODEMOS-IU",51
48,"48025",874,667,662,2,5,"PODEMOS-IU",73
20,"20016",1529,887,883,3,4,"PODEMOS-IU",94
1,"1058",1414,893,884,1,9,"PODEMOS-IU",144
20,"20033",858,644,638,1,6,"PODEMOS-IU",64
1,"1014",366,271,266,2,5,"PODEMOS-IU",37
48,"48044",61957,45253,45063,299,190,"PODEMOS-IU",4781
48,"48078",37858,25959,25819,157,140,"PODEMOS-IU",4795
20,"20005",1274,822,822,1,0,"PODEMOS-IU",82
48,"48018",854,563,560,5,3,"PODEMOS-IU",30
48,"48014",1229,845,843,8,2,"PODEMOS-IU",125
20,"20014",1161,699,693,0,6,"PODEMOS-IU",77
1,"1059",189597,128849,127910,688,939,"PODEMOS-IU",21740
48,"48079",397,289,287,1,2,"PODEMOS-IU",30
20,"20066",437,288,286,1,2,"PODEMOS-IU",9
20,"20009",11369,7402,7355,32,47,"PODEMOS-IU",1224
48,"48063",354,256,252,1,4,"PODEMOS-IU",21
1,"1041",150,103,102,1,1,"PODEMOS-IU",9
48,"48045",5207,3851,3817,9,34,"PODEMOS-IU",579
20,"20021",185,104,104,2,0,"PODEMOS-IU",9
48,"48041",687,548,547,4,1,"PODEMOS-IU",48
20,"20019",9892,6740,6717,40,23,"PODEMOS-IU",911
20,"20036",13208,9102,9056,59,46,"PODEMOS-IU",1516
20,"20024",395,245,245,4,0,"PODEMOS-IU",26
20,"20904",87,56,55,1,1,"PODEMOS-IU",1
48,"48903",1800,1358,1353,4,5,"PODEMOS-IU",139
48,"48056",980,731,728,3,3,"PODEMOS-IU",83
1,"1039",188,150,147,2,3,"PODEMOS-IU",32
1,"1053",596,364,362,1,2,"PODEMOS-IU",47
48,"48060",3625,2429,2418,12,11,"PODEMOS-IU",197
48,"48082",37358,25328,25167,125,161,"PODEMOS-IU",4827
48,"48910",2811,1952,1942,11,10,"PODEMOS-IU",234
48,"48913",1236,899,890,8,9,"PODEMOS-IU",140
20,"20903",5033,3355,3341,18,14,"PODEMOS-IU",625
1,"1022",755,532,523,4,9,"PODEMOS-IU",70
48,"48069",13131,9211,9162,55,49,"PODEMOS-IU",1179
1,"1060",204,159,151,0,8,"PODEMOS-IU",15
20,"20056",4077,2796,2781,12,15,"PODEMOS-IU",270
20,"20011",1624,1234,1225,3,9,"PODEMOS-IU",127
1,"1001",2020,1385,1372,5,13,"PODEMOS-IU",249
1,"1027",444,273,271,0,2,"PODEMOS-IU",45
48,"48022",2305,1434,1425,11,9,"PODEMOS-IU",183
20,"20064",12395,7959,7916,42,43,"PODEMOS-IU",1578
1,"1010",2315,1705,1688,6,17,"PODEMOS-IU",244
20,"20043",1718,1189,1183,2,6,"PODEMOS-IU",59
20,"20030",21147,14598,14521,92,77,"PODEMOS-IU",2213
20,"20050",275,174,174,2,0,"PODEMOS-IU",15
20,"20081",7690,5382,5363,31,19,"PODEMOS-IU",654
48,"48032",5762,4287,4262,14,25,"PODEMOS-IU",491
1,"1902",723,485,478,8,7,"PODEMOS-IU",73
48,"48008",609,415,407,4,8,"PODEMOS-IU",55
48,"48092",872,614,608,3,6,"PODEMOS-IU",76
20,"20054",461,294,294,1,0,"PODEMOS-IU",17
48,"48023",579,451,448,0,3,"PODEMOS-IU",37
20,"20034",3200,2193,2180,8,13,"PODEMOS-IU",306
20,"20060",87,75,75,0,0,"PODEMOS-IU",0
1,"1019",148,112,112,0,0,"PODEMOS-IU",8
48,"48097",1314,886,882,6,4,"PODEMOS-IU",135
20,"20020",114,64,64,0,0,"PODEMOS-IU",4
1,"1055",839,557,552,11,5,"PODEMOS-IU",57
48,"48054",25063,17705,17597,122,108,"PODEMOS-IU",2912
20,"20040",15771,10549,10481,54,68,"PODEMOS-IU",1810
48,"48059",402,299,297,0,2,"PODEMOS-IU",11
20,"20015",1245,880,876,5,4,"PODEMOS-IU",45
48,"48040",1303,933,926,7,7,"PODEMOS-IU",94
1,"1031",1136,844,830,1,14,"PODEMOS-IU",88
1,"1003",1166,843,837,6,6,"PODEMOS-IU",78
48,"48083",6934,4800,4765,21,35,"PODEMOS-IU",1268
48,"48017",13121,8929,8886,45,43,"PODEMOS-IU",956
48,"48026",1132,834,832,2,2,"PODEMOS-IU",60
1,"1016",428,194,192,4,2,"PODEMOS-IU",27
48,"48033",217,162,162,1,0,"PODEMOS-IU",11
48,"48010",476,343,343,1,0,"PODEMOS-IU",43
48,"48006",307,242,240,3,2,"PODEMOS-IU",26
48,"48004",326,245,245,1,0,"PODEMOS-IU",11
48,"48050",188,141,141,0,0,"PODEMOS-IU",10
20,"20080",7705,5276,5244,21,32,"PODEMOS-IU",895
20,"20046",1243,822,816,1,6,"PODEMOS-IU",101
20,"20069",147446,102068,101696,564,372,"PODEMOS-IU",16069
48,"48909",201,158,157,0,1,"PODEMOS-IU",8
1,"1046",639,433,432,2,1,"PODEMOS-IU",63
48,"48013",79353,53591,53205,331,386,"PODEMOS-IU",10523
1,"1054",998,701,700,4,1,"PODEMOS-IU",107
48,"48064",608,461,461,0,0,"PODEMOS-IU",30
20,"20041",241,143,142,2,1,"PODEMOS-IU",9
20,"20029",4264,3116,3104,14,12,"PODEMOS-IU",416
48,"48915",339,245,243,0,2,"PODEMOS-IU",6
48,"48071",6013,4240,4205,23,35,"PODEMOS-IU",746
48,"48088",134,95,95,0,0,"PODEMOS-IU",5
20,"20044",355,261,261,1,0,"PODEMOS-IU",34
20,"20010",1524,1057,1053,5,4,"PODEMOS-IU",134
48,"48087",437,335,332,0,3,"PODEMOS-IU",30
48,"48021",1325,891,888,3,3,"PODEMOS-IU",98
48,"48912",2321,1684,1670,8,14,"PODEMOS-IU",247
48,"48031",303,221,221,0,0,"PODEMOS-IU",8
48,"48084",21780,14368,14271,79,97,"PODEMOS-IU",2941
24,"24101",370,219,213,4,6,"PODEMOS-IU",18
5,"5144",65,47,46,1,1,"PODEMOS-IU",2
24,"24184",177,106,105,0,1,"PODEMOS-IU",11
6,"6093",4325,3176,3073,26,103,"PODEMOS-IU",165
5,"5148",22,19,19,0,0,"PODEMOS-IU",1
37,"37369",126,83,81,0,2,"PODEMOS-IU",5
47,"47025",114,85,85,3,0,"PODEMOS-IU",1
19,"19282",138,107,106,0,1,"PODEMOS-IU",6
24,"24036",252,146,146,1,0,"PODEMOS-IU",12
49,"49015",198,156,155,0,1,"PODEMOS-IU",6
37,"37306",238,140,136,3,4,"PODEMOS-IU",2
6,"6047",829,618,605,1,13,"PODEMOS-IU",46
9,"9410",3019,1924,1898,21,26,"PODEMOS-IU",403
28,"28058",141836,104142,103011,896,1131,"PODEMOS-IU",15499
44,"44142",29,21,21,0,0,"PODEMOS-IU",2
10,"10055",697,488,473,3,15,"PODEMOS-IU",55
16,"16902",124,86,86,1,0,"PODEMOS-IU",4
44,"44156",47,31,31,0,0,"PODEMOS-IU",0
44,"44208",27,17,17,0,0,"PODEMOS-IU",0
37,"37212",104,76,76,0,0,"PODEMOS-IU",9
10,"10082",1793,1333,1305,11,28,"PODEMOS-IU",72
13,"13067",334,279,271,2,8,"PODEMOS-IU",23
35,"35025",1752,1113,1095,5,18,"PODEMOS-IU",113
24,"24017",532,375,374,1,1,"PODEMOS-IU",28
44,"44048",52,47,47,0,0,"PODEMOS-IU",2
37,"37320",85,65,64,1,1,"PODEMOS-IU",2
42,"42216",26,20,20,0,0,"PODEMOS-IU",0
39,"39006",1729,1207,1192,1,15,"PODEMOS-IU",64
34,"34011",379,290,284,2,6,"PODEMOS-IU",5
44,"44263",373,267,267,2,0,"PODEMOS-IU",15
37,"37368",17,12,11,0,1,"PODEMOS-IU",2
45,"45083",568,433,429,2,4,"PODEMOS-IU",26
9,"9406",239,165,162,2,3,"PODEMOS-IU",24
47,"47227",53,36,35,0,1,"PODEMOS-IU",1
37,"37226",152,113,113,2,0,"PODEMOS-IU",2
5,"5010",142,102,100,2,2,"PODEMOS-IU",3
9,"9425",472,311,309,3,2,"PODEMOS-IU",59
28,"28020",193,96,93,0,3,"PODEMOS-IU",16
19,"19041",163,118,117,1,1,"PODEMOS-IU",17
9,"9058",394,286,284,6,2,"PODEMOS-IU",31
50,"50149",34,25,25,0,0,"PODEMOS-IU",0
28,"28124",73,51,50,0,1,"PODEMOS-IU",4
44,"44216",27003,19997,19909,80,88,"PODEMOS-IU",688
49,"49151",591,389,388,3,1,"PODEMOS-IU",34
44,"44145",974,698,697,3,1,"PODEMOS-IU",33
34,"34171",928,572,562,2,10,"PODEMOS-IU",39
37,"37011",100,78,78,3,0,"PODEMOS-IU",7
45,"45193",586,478,469,0,9,"PODEMOS-IU",32
28,"28175",940,740,730,2,10,"PODEMOS-IU",93
28,"28183",1162,823,813,9,10,"PODEMOS-IU",197
42,"42073",73,56,55,0,1,"PODEMOS-IU",4
50,"50273",33,24,24,1,0,"PODEMOS-IU",1
37,"37037",108,72,72,0,0,"PODEMOS-IU",0
45,"45144",736,562,557,1,5,"PODEMOS-IU",45
16,"16266",356,269,265,4,4,"PODEMOS-IU",3
49,"49241",235,178,177,1,1,"PODEMOS-IU",3
6,"6154",2799,1851,1782,20,69,"PODEMOS-IU",105
49,"49233",85,51,51,0,0,"PODEMOS-IU",0
5,"5045",81,58,58,0,0,"PODEMOS-IU",1
19,"19156",917,686,679,2,7,"PODEMOS-IU",31
47,"47138",224,169,166,0,3,"PODEMOS-IU",7
28,"28015",20885,16237,16104,134,133,"PODEMOS-IU",1695
44,"44239",21,19,19,0,0,"PODEMOS-IU",3
24,"24050",105,77,77,2,0,"PODEMOS-IU",0
40,"40084",52,41,41,2,0,"PODEMOS-IU",4
10,"10213",533,397,385,0,12,"PODEMOS-IU",11
16,"16150",98,66,66,2,0,"PODEMOS-IU",7
9,"9361",103,64,64,1,0,"PODEMOS-IU",2
34,"34234",66,48,45,0,3,"PODEMOS-IU",2
24,"24012",278,182,180,0,2,"PODEMOS-IU",16
50,"50100",304,215,212,1,3,"PODEMOS-IU",18
6,"6092",558,438,426,2,12,"PODEMOS-IU",13
26,"26105",2188,1564,1536,24,28,"PODEMOS-IU",120
49,"49050",498,305,305,2,0,"PODEMOS-IU",28
50,"50009",97,61,61,1,0,"PODEMOS-IU",3
34,"34018",199,151,149,4,2,"PODEMOS-IU",12
49,"49127",2402,1640,1604,18,36,"PODEMOS-IU",108
28,"28011",417,295,292,6,3,"PODEMOS-IU",37
9,"9428",102,73,73,1,0,"PODEMOS-IU",3
47,"47178",170,128,124,2,4,"PODEMOS-IU",9
34,"34067",129,80,78,1,2,"PODEMOS-IU",6
40,"40056",31,21,20,0,1,"PODEMOS-IU",0
9,"9054",89,65,63,4,2,"PODEMOS-IU",2
16,"16023",513,367,367,3,0,"PODEMOS-IU",44
6,"6042",984,644,629,5,15,"PODEMOS-IU",87
10,"10133",1159,914,893,4,21,"PODEMOS-IU",92
47,"47119",89,59,58,2,1,"PODEMOS-IU",3
9,"9447",43,37,36,0,1,"PODEMOS-IU",0
44,"44050",3113,2173,2154,14,19,"PODEMOS-IU",61
44,"44250",20,15,15,0,0,"PODEMOS-IU",0
50,"50004",475,360,356,2,4,"PODEMOS-IU",19
47,"47064",37,30,29,1,1,"PODEMOS-IU",8
50,"50121",270,209,208,3,1,"PODEMOS-IU",14
42,"42149",386,273,270,2,3,"PODEMOS-IU",23
49,"49167",180,131,131,2,0,"PODEMOS-IU",8
9,"9166",96,77,77,0,0,"PODEMOS-IU",4
6,"6087",1999,1472,1455,13,17,"PODEMOS-IU",78
5,"5240",3346,2259,2232,11,27,"PODEMOS-IU",157
37,"37338",77,58,58,0,0,"PODEMOS-IU",4
37,"37132",317,211,207,0,4,"PODEMOS-IU",20
24,"24123",709,461,457,2,4,"PODEMOS-IU",28
26,"26144",187,147,143,1,4,"PODEMOS-IU",11
50,"50124",394,269,266,0,3,"PODEMOS-IU",6
10,"10083",96,76,74,0,2,"PODEMOS-IU",9
26,"26029",34,26,26,1,0,"PODEMOS-IU",2
28,"28041",4805,3666,3634,38,32,"PODEMOS-IU",352
6,"6016",2937,2042,1978,12,64,"PODEMOS-IU",151
28,"28025",405,294,291,5,3,"PODEMOS-IU",21
47,"47004",1135,878,872,5,6,"PODEMOS-IU",31
44,"44064",62,46,46,0,0,"PODEMOS-IU",1
50,"50135",85,59,59,0,0,"PODEMOS-IU",6
45,"45171",1329,958,940,4,18,"PODEMOS-IU",63
34,"34096",48,39,38,0,1,"PODEMOS-IU",2
19,"19038",19,16,15,0,1,"PODEMOS-IU",0
16,"16188",74,57,57,1,0,"PODEMOS-IU",7
37,"37096",203,144,144,2,0,"PODEMOS-IU",5
37,"37222",78,55,55,2,0,"PODEMOS-IU",5
39,"39047",1998,1408,1392,8,16,"PODEMOS-IU",96
9,"9209",4404,2997,2950,31,47,"PODEMOS-IU",304
44,"44121",52,42,42,1,0,"PODEMOS-IU",1
37,"37086",107,86,85,2,1,"PODEMOS-IU",2
40,"40101",918,672,665,11,7,"PODEMOS-IU",90
42,"42173",29860,19581,19206,337,375,"PODEMOS-IU",1709
5,"5140",99,83,81,0,2,"PODEMOS-IU",1
44,"44061",77,60,58,1,2,"PODEMOS-IU",1
10,"10137",394,297,296,3,1,"PODEMOS-IU",15
49,"49163",203,139,138,3,1,"PODEMOS-IU",4
49,"49101",144,88,82,1,6,"PODEMOS-IU",1
40,"40003",116,82,79,3,3,"PODEMOS-IU",2
47,"47059",94,64,64,0,0,"PODEMOS-IU",8
24,"24088",996,750,745,9,5,"PODEMOS-IU",64
26,"26104",10,9,9,1,0,"PODEMOS-IU",2
19,"19091",23,17,17,0,0,"PODEMOS-IU",0
28,"28093",2177,1681,1658,11,23,"PODEMOS-IU",142
28,"28127",66793,53258,53009,458,249,"PODEMOS-IU",3690
6,"6091",3669,2581,2525,20,56,"PODEMOS-IU",142
5,"5266",100,79,79,1,0,"PODEMOS-IU",0
44,"44037",447,288,288,1,0,"PODEMOS-IU",28
37,"37203",151,114,113,1,1,"PODEMOS-IU",7
50,"50123",430,304,297,3,7,"PODEMOS-IU",16
9,"9230",33,26,26,0,0,"PODEMOS-IU",0
40,"40089",209,155,148,2,7,"PODEMOS-IU",13
47,"47194",295,228,227,1,1,"PODEMOS-IU",70
47,"47127",138,89,88,2,1,"PODEMOS-IU",13
40,"40170",1302,962,948,6,14,"PODEMOS-IU",48
24,"24014",7152,4494,4448,47,46,"PODEMOS-IU",532
10,"10197",106,74,74,0,0,"PODEMOS-IU",3
50,"50046",162,125,125,6,0,"PODEMOS-IU",5
45,"45022",395,292,292,2,0,"PODEMOS-IU",14
45,"45142",7792,5717,5624,62,93,"PODEMOS-IU",433
45,"45110",1685,1288,1274,5,14,"PODEMOS-IU",33
10,"10087",1588,1105,1093,10,12,"PODEMOS-IU",69
40,"40048",35,27,27,0,0,"PODEMOS-IU",1
47,"47151",26,22,22,0,0,"PODEMOS-IU",4
39,"39096",669,451,450,1,1,"PODEMOS-IU",16
24,"24049",1417,983,975,14,8,"PODEMOS-IU",117
37,"37110",104,81,79,1,2,"PODEMOS-IU",3
19,"19214",74,51,51,0,0,"PODEMOS-IU",5
28,"28133",6146,4245,4180,25,65,"PODEMOS-IU",440
42,"42142",42,36,36,1,0,"PODEMOS-IU",0
5,"5167",223,177,172,0,5,"PODEMOS-IU",19
5,"5225",355,276,273,6,3,"PODEMOS-IU",11
47,"47197",875,659,656,9,3,"PODEMOS-IU",18
39,"39009",3325,2306,2293,7,13,"PODEMOS-IU",191
34,"34093",83,61,60,0,1,"PODEMOS-IU",2
9,"9122",86,55,55,0,0,"PODEMOS-IU",3
50,"50202",124,76,74,0,2,"PODEMOS-IU",3
6,"6153",20252,14183,13924,154,259,"PODEMOS-IU",1300
26,"26174",134,100,99,3,1,"PODEMOS-IU",14
5,"5097",464,309,305,0,4,"PODEMOS-IU",15
40,"40174",319,229,227,3,2,"PODEMOS-IU",12
26,"26158",242,184,181,1,3,"PODEMOS-IU",9
19,"19098",20,17,17,0,0,"PODEMOS-IU",0
40,"40104",283,203,200,0,3,"PODEMOS-IU",30
50,"50243",307,227,224,2,3,"PODEMOS-IU",5
6,"6126",2121,1443,1429,14,14,"PODEMOS-IU",84
37,"37073",613,448,440,4,8,"PODEMOS-IU",21
40,"40144",16,15,15,0,0,"PODEMOS-IU",0
50,"50017",1773,1283,1265,13,18,"PODEMOS-IU",155
42,"42075",78,50,50,1,0,"PODEMOS-IU",4
44,"44086",410,302,298,3,4,"PODEMOS-IU",28
28,"28028",1836,1374,1363,3,11,"PODEMOS-IU",355
42,"42154",103,76,76,1,0,"PODEMOS-IU",2
9,"9323",57,37,36,0,1,"PODEMOS-IU",4
10,"10127",4691,3044,2974,34,70,"PODEMOS-IU",342
10,"10204",423,289,287,1,2,"PODEMOS-IU",26
37,"37243",89,66,66,0,0,"PODEMOS-IU",0
49,"49136",313,218,217,5,1,"PODEMOS-IU",0
24,"24160",633,404,403,2,1,"PODEMOS-IU",34
47,"47111",1001,738,732,5,6,"PODEMOS-IU",45
44,"44218",28,24,24,3,0,"PODEMOS-IU",2
49,"49226",240,200,198,2,2,"PODEMOS-IU",16
50,"50192",227,182,181,0,1,"PODEMOS-IU",20
47,"47174",271,215,213,4,2,"PODEMOS-IU",29
9,"9217",342,240,237,1,3,"PODEMOS-IU",45
2,"2036",93,66,66,0,0,"PODEMOS-IU",0
34,"34181",422,289,285,0,4,"PODEMOS-IU",16
19,"19045",122,97,96,0,1,"PODEMOS-IU",2
37,"37050",66,52,52,1,0,"PODEMOS-IU",0
16,"16032",284,220,220,1,0,"PODEMOS-IU",12
44,"44115",102,91,91,0,0,"PODEMOS-IU",10
26,"26072",287,239,235,3,4,"PODEMOS-IU",18
50,"50163",3846,2863,2840,25,23,"PODEMOS-IU",353
37,"37289",210,147,144,0,3,"PODEMOS-IU",2
37,"37142",554,396,394,5,2,"PODEMOS-IU",27
50,"50218",112,88,88,1,0,"PODEMOS-IU",3
44,"44038",101,85,83,1,2,"PODEMOS-IU",8
10,"10199",154,99,99,2,0,"PODEMOS-IU",3
16,"16099",179,108,105,0,3,"PODEMOS-IU",1
6,"6010",1063,760,732,2,28,"PODEMOS-IU",98
50,"50053",643,476,466,3,10,"PODEMOS-IU",28
40,"40123",141,98,94,4,4,"PODEMOS-IU",13
39,"39024",1802,1325,1314,7,11,"PODEMOS-IU",119
42,"42119",141,78,78,1,0,"PODEMOS-IU",2
26,"26152",27,20,20,1,0,"PODEMOS-IU",2
16,"16165",56,45,45,0,0,"PODEMOS-IU",5
26,"26112",218,152,148,1,4,"PODEMOS-IU",6
19,"19243",34,32,31,1,1,"PODEMOS-IU",2
2,"2039",945,745,734,8,11,"PODEMOS-IU",55
24,"24155",441,340,334,2,6,"PODEMOS-IU",24
45,"45176",3859,2694,2662,24,32,"PODEMOS-IU",371
19,"19297",32,28,28,0,0,"PODEMOS-IU",0
49,"49085",904,583,579,5,4,"PODEMOS-IU",31
45,"45172",640,475,462,6,13,"PODEMOS-IU",23
44,"44251",239,187,183,1,4,"PODEMOS-IU",1
24,"24071",947,618,611,6,7,"PODEMOS-IU",71
40,"40901",413,320,315,7,5,"PODEMOS-IU",40
50,"50130",354,225,222,1,3,"PODEMOS-IU",15
9,"9427",1363,854,842,7,12,"PODEMOS-IU",77
37,"37270",184,139,136,2,3,"PODEMOS-IU",1
24,"24196",1907,1322,1299,4,23,"PODEMOS-IU",203
50,"50136",532,366,361,3,5,"PODEMOS-IU",10
2,"2081",18287,12910,12675,130,235,"PODEMOS-IU",1218
34,"34169",371,263,259,5,4,"PODEMOS-IU",13
10,"10161",81,50,50,0,0,"PODEMOS-IU",4
24,"24125",416,233,231,3,2,"PODEMOS-IU",8
38,"38034",3997,2687,2648,19,39,"PODEMOS-IU",260
9,"9179",39,30,30,1,0,"PODEMOS-IU",4
49,"49143",201,119,118,1,1,"PODEMOS-IU",7
9,"9327",26,20,20,0,0,"PODEMOS-IU",1
19,"19107",306,245,244,0,1,"PODEMOS-IU",12
28,"28030",1832,1319,1297,13,22,"PODEMOS-IU",233
26,"26151",412,317,317,4,0,"PODEMOS-IU",19
44,"44094",127,103,103,0,0,"PODEMOS-IU",5
24,"24162",1753,1259,1245,12,14,"PODEMOS-IU",117
30,"30006",833,699,695,1,4,"PODEMOS-IU",62
19,"19044",275,186,182,0,4,"PODEMOS-IU",9
16,"16086",872,699,690,7,9,"PODEMOS-IU",38
6,"6035",851,630,620,0,10,"PODEMOS-IU",36
40,"40164",186,131,130,0,1,"PODEMOS-IU",2
28,"28112",160,129,129,0,0,"PODEMOS-IU",12
5,"5211",425,336,330,2,6,"PODEMOS-IU",11
34,"34170",50,30,30,1,0,"PODEMOS-IU",1
9,"9292",72,55,55,3,0,"PODEMOS-IU",2
49,"49170",99,68,68,1,0,"PODEMOS-IU",0
49,"49208",352,223,214,1,9,"PODEMOS-IU",5
9,"9353",74,56,54,1,2,"PODEMOS-IU",7
49,"49062",103,58,58,0,0,"PODEMOS-IU",4
42,"42054",18,12,12,0,0,"PODEMOS-IU",0
40,"40130",127,95,87,1,8,"PODEMOS-IU",5
9,"9133",38,33,33,0,0,"PODEMOS-IU",2
5,"5088",29,22,22,0,0,"PODEMOS-IU",0
19,"19031",8,8,8,0,0,"PODEMOS-IU",1
26,"26130",205,153,150,1,3,"PODEMOS-IU",2
30,"30020",6503,4521,4484,35,37,"PODEMOS-IU",387
45,"45181",2330,1693,1661,10,32,"PODEMOS-IU",66
44,"44027",144,113,113,2,0,"PODEMOS-IU",19
39,"39038",1512,992,983,5,9,"PODEMOS-IU",122
50,"50078",227,168,166,0,2,"PODEMOS-IU",16
44,"44225",105,82,81,2,1,"PODEMOS-IU",10
40,"40015",23,19,19,0,0,"PODEMOS-IU",0
50,"50039",462,339,333,1,6,"PODEMOS-IU",34
13,"13058",4026,2822,2766,29,56,"PODEMOS-IU",116
9,"9362",198,156,156,4,0,"PODEMOS-IU",16
37,"37026",180,148,147,5,1,"PODEMOS-IU",1
19,"19090",90,69,68,1,1,"PODEMOS-IU",12
5,"5073",282,210,207,1,3,"PODEMOS-IU",7
24,"24019",338,259,256,4,3,"PODEMOS-IU",37
42,"42200",74,49,46,0,3,"PODEMOS-IU",1
35,"35023",11742,7787,7651,95,136,"PODEMOS-IU",979
16,"16269",378,287,285,2,2,"PODEMOS-IU",8
2,"2026",834,644,633,4,11,"PODEMOS-IU",60
35,"35011",24859,15025,14833,149,192,"PODEMOS-IU",2313
28,"28169",1577,1214,1209,7,5,"PODEMOS-IU",110
10,"10067",10210,7090,6946,62,144,"PODEMOS-IU",603
16,"16010",134,92,88,0,4,"PODEMOS-IU",0
45,"45024",1034,742,733,1,9,"PODEMOS-IU",25
6,"6081",1036,760,745,2,15,"PODEMOS-IU",98
47,"47216",111,94,91,0,3,"PODEMOS-IU",2
34,"34123",1634,1274,1258,4,16,"PODEMOS-IU",66
24,"24202",7504,4607,4538,51,69,"PODEMOS-IU",972
40,"40159",130,94,93,2,1,"PODEMOS-IU",5
49,"49119",217,158,156,2,2,"PODEMOS-IU",0
37,"37118",117,86,86,3,0,"PODEMOS-IU",0
16,"16098",521,418,415,2,3,"PODEMOS-IU",37
13,"13031",2475,1855,1834,9,21,"PODEMOS-IU",93
28,"28155",487,374,369,0,5,"PODEMOS-IU",20
49,"49200",936,679,670,9,9,"PODEMOS-IU",59
34,"34186",49,44,44,0,0,"PODEMOS-IU",1
35,"35002",24229,15311,15133,101,178,"PODEMOS-IU",2465
2,"2069",11401,8055,7975,30,80,"PODEMOS-IU",523
6,"6143",3389,2430,2371,24,59,"PODEMOS-IU",174
47,"47175",6755,4950,4870,49,80,"PODEMOS-IU",662
24,"24139",2071,1371,1346,15,25,"PODEMOS-IU",88
45,"45074",397,300,293,2,7,"PODEMOS-IU",11
9,"9343",92,66,65,0,1,"PODEMOS-IU",1
45,"45112",1844,1121,1086,8,35,"PODEMOS-IU",76
13,"13078",8946,6166,6103,49,63,"PODEMOS-IU",372
47,"47035",901,659,653,4,6,"PODEMOS-IU",39
9,"9375",42,35,35,0,0,"PODEMOS-IU",1
37,"37157",76,64,63,1,1,"PODEMOS-IU",1
9,"9905",373,239,238,2,1,"PODEMOS-IU",50
9,"9432",170,125,123,0,2,"PODEMOS-IU",22
35,"35015",10752,5289,5222,39,67,"PODEMOS-IU",744
47,"47208",53,35,35,1,0,"PODEMOS-IU",9
10,"10107",1019,766,755,12,11,"PODEMOS-IU",75
40,"40131",51,45,45,0,0,"PODEMOS-IU",2
19,"19064",64,56,56,0,0,"PODEMOS-IU",3
28,"28009",14593,11026,10913,73,113,"PODEMOS-IU",1121
9,"9347",140,111,107,1,4,"PODEMOS-IU",15
19,"19201",60,44,44,0,0,"PODEMOS-IU",6
34,"34158",283,170,167,0,3,"PODEMOS-IU",11
9,"9365",26,17,17,0,0,"PODEMOS-IU",1
24,"24007",735,500,496,8,4,"PODEMOS-IU",85
28,"28136",693,538,533,2,5,"PODEMOS-IU",42
44,"44221",386,307,304,1,3,"PODEMOS-IU",21
9,"9304",198,152,149,1,3,"PODEMOS-IU",7
2,"2046",1125,892,870,12,22,"PODEMOS-IU",62
44,"44161",428,294,292,2,2,"PODEMOS-IU",6
49,"49021",14204,9429,9295,87,134,"PODEMOS-IU",808
50,"50143",541,373,367,2,6,"PODEMOS-IU",15
5,"5242",679,571,562,9,9,"PODEMOS-IU",8
49,"49100",281,164,157,2,7,"PODEMOS-IU",4
24,"24122",1292,818,810,7,8,"PODEMOS-IU",64
30,"30025",5016,3663,3623,22,40,"PODEMOS-IU",239
38,"38010",3969,2463,2418,11,45,"PODEMOS-IU",402
16,"16141",131,98,96,1,2,"PODEMOS-IU",5
37,"37250",325,212,211,0,1,"PODEMOS-IU",13
2,"2028",111,81,81,0,0,"PODEMOS-IU",2
26,"26125",2665,1885,1853,21,32,"PODEMOS-IU",104
19,"19002",55,45,45,0,0,"PODEMOS-IU",1
5,"5182",721,457,436,3,21,"PODEMOS-IU",27
26,"26140",239,180,177,1,3,"PODEMOS-IU",21
37,"37240",928,648,637,2,11,"PODEMOS-IU",40
50,"50012",94,76,72,0,4,"PODEMOS-IU",5
19,"19274",953,693,676,9,17,"PODEMOS-IU",85
44,"44174",402,289,288,1,1,"PODEMOS-IU",3
9,"9351",61,46,45,1,1,"PODEMOS-IU",1
37,"37001",165,120,120,0,0,"PODEMOS-IU",2
50,"50274",64,46,43,1,3,"PODEMOS-IU",5
42,"42070",31,23,23,1,0,"PODEMOS-IU",0
24,"24144",621,419,412,4,7,"PODEMOS-IU",34
50,"50104",320,251,251,1,0,"PODEMOS-IU",2
6,"6038",785,561,550,5,11,"PODEMOS-IU",29
2,"2029",3333,2363,2320,13,43,"PODEMOS-IU",278
9,"9439",1061,801,790,2,11,"PODEMOS-IU",88
9,"9056",4833,3191,3156,37,35,"PODEMOS-IU",351
37,"37077",251,206,204,1,2,"PODEMOS-IU",3
44,"44228",96,75,74,0,1,"PODEMOS-IU",0
10,"10130",1754,1199,1189,10,10,"PODEMOS-IU",171
44,"44117",327,258,258,0,0,"PODEMOS-IU",6
50,"50174",80,58,57,0,1,"PODEMOS-IU",1
24,"24022",304,198,195,2,3,"PODEMOS-IU",24
37,"37009",197,145,144,1,1,"PODEMOS-IU",5
50,"50901",133,96,96,0,0,"PODEMOS-IU",8
28,"28126",50,36,36,0,0,"PODEMOS-IU",3
44,"44249",40,30,30,0,0,"PODEMOS-IU",0
40,"40132",45,26,25,0,1,"PODEMOS-IU",0
2,"2012",1835,1462,1420,9,42,"PODEMOS-IU",90
50,"50177",288,196,193,0,3,"PODEMOS-IU",8
10,"10118",278,232,231,1,1,"PODEMOS-IU",17
5,"5214",28,18,18,0,0,"PODEMOS-IU",3
50,"50283",69,46,46,0,0,"PODEMOS-IU",0
5,"5152",644,498,496,3,2,"PODEMOS-IU",7
42,"42097",14,9,9,1,0,"PODEMOS-IU",0
47,"47213",104,78,78,0,0,"PODEMOS-IU",5
45,"45131",259,219,216,1,3,"PODEMOS-IU",20
47,"47118",147,97,97,2,0,"PODEMOS-IU",10
47,"47054",599,465,460,1,5,"PODEMOS-IU",23
39,"39065",222,166,163,0,3,"PODEMOS-IU",9
40,"40120",195,169,163,0,6,"PODEMOS-IU",11
30,"30901",10556,7862,7775,58,87,"PODEMOS-IU",850
10,"10005",527,325,301,1,24,"PODEMOS-IU",12
26,"26053",191,144,140,2,4,"PODEMOS-IU",16
10,"10101",178,129,125,0,4,"PODEMOS-IU",3
50,"50257",159,128,125,2,3,"PODEMOS-IU",12
6,"6017",250,202,198,0,4,"PODEMOS-IU",12
9,"9078",32,27,27,0,0,"PODEMOS-IU",1
16,"16107",94,56,56,0,0,"PODEMOS-IU",1
10,"10151",189,145,142,2,3,"PODEMOS-IU",4
42,"42202",19,11,10,0,1,"PODEMOS-IU",0
40,"40076",6576,4700,4607,32,93,"PODEMOS-IU",569
19,"19146",47,35,35,0,0,"PODEMOS-IU",7
45,"45059",1702,1315,1303,1,12,"PODEMOS-IU",71
38,"38030",1962,1332,1318,9,14,"PODEMOS-IU",114
49,"49261",1504,1044,1026,7,18,"PODEMOS-IU",88
37,"37380",55,41,40,2,1,"PODEMOS-IU",4
2,"2011",556,429,427,1,2,"PODEMOS-IU",13
5,"5001",182,139,138,1,1,"PODEMOS-IU",5
9,"9125",555,386,382,4,4,"PODEMOS-IU",23
28,"28047",42984,30772,30486,270,286,"PODEMOS-IU",4247
49,"49172",474,278,271,1,7,"PODEMOS-IU",5
38,"38018",4466,2867,2821,21,46,"PODEMOS-IU",244
42,"42014",57,35,35,0,0,"PODEMOS-IU",2
19,"19096",105,72,70,0,2,"PODEMOS-IU",10
5,"5258",107,80,80,1,0,"PODEMOS-IU",2
40,"40100",262,208,204,4,4,"PODEMOS-IU",8
40,"40006",22,19,19,0,0,"PODEMOS-IU",3
42,"42011",16,11,11,0,0,"PODEMOS-IU",0
6,"6070",7668,5404,5228,59,176,"PODEMOS-IU",597
49,"49017",247,176,176,1,0,"PODEMOS-IU",9
9,"9419",67,52,49,0,3,"PODEMOS-IU",2
49,"49014",116,83,83,1,0,"PODEMOS-IU",4
6,"6141",1678,1183,1158,15,25,"PODEMOS-IU",78
19,"19311",85,60,59,0,1,"PODEMOS-IU",4
44,"44189",44,35,35,0,0,"PODEMOS-IU",1
9,"9084",165,116,111,1,5,"PODEMOS-IU",2
49,"49174",127,86,85,1,1,"PODEMOS-IU",2
49,"49275",51064,34471,34017,475,454,"PODEMOS-IU",3046
35,"35032",3331,2293,2252,23,41,"PODEMOS-IU",232
39,"39078",1410,1004,997,5,7,"PODEMOS-IU",71
5,"5159",224,133,132,3,1,"PODEMOS-IU",2
16,"16191",850,664,653,11,11,"PODEMOS-IU",14
42,"42033",50,48,48,2,0,"PODEMOS-IU",1
24,"24005",342,218,217,0,1,"PODEMOS-IU",11
10,"10051",421,316,308,0,8,"PODEMOS-IU",4
34,"34156",51,42,42,0,0,"PODEMOS-IU",0
19,"19270",14,13,13,0,0,"PODEMOS-IU",2
37,"37254",174,140,135,0,5,"PODEMOS-IU",8
47,"47224",93,75,75,1,0,"PODEMOS-IU",8
9,"9345",111,87,86,2,1,"PODEMOS-IU",8
34,"34107",73,47,46,1,1,"PODEMOS-IU",0
13,"13063",3648,2464,2406,28,58,"PODEMOS-IU",224
5,"5061",257,193,189,1,4,"PODEMOS-IU",14
39,"39051",73,64,64,1,0,"PODEMOS-IU",6
50,"50269",287,172,167,2,5,"PODEMOS-IU",4
47,"47196",29,21,21,0,0,"PODEMOS-IU",0
19,"19157",53,37,37,0,0,"PODEMOS-IU",8
5,"5058",71,45,43,0,2,"PODEMOS-IU",3
19,"19171",5380,3964,3919,22,45,"PODEMOS-IU",566
5,"5117",191,155,153,1,2,"PODEMOS-IU",8
6,"6084",1061,780,769,11,11,"PODEMOS-IU",29
13,"13064",1845,1314,1298,10,16,"PODEMOS-IU",131
45,"45064",3987,2918,2880,33,38,"PODEMOS-IU",487
24,"24079",861,601,595,9,6,"PODEMOS-IU",36
6,"6161",289,199,197,1,2,"PODEMOS-IU",11
47,"47188",98,73,70,0,3,"PODEMOS-IU",4
34,"34048",62,51,51,1,0,"PODEMOS-IU",4
45,"45012",623,482,472,0,10,"PODEMOS-IU",51
38,"38024",15316,9131,9005,60,126,"PODEMOS-IU",780
50,"50212",32,26,26,0,0,"PODEMOS-IU",5
9,"9441",94,76,76,0,0,"PODEMOS-IU",1
34,"34136",143,89,89,1,0,"PODEMOS-IU",0
49,"49255",387,304,298,3,6,"PODEMOS-IU",11
5,"5017",84,70,67,2,3,"PODEMOS-IU",6
10,"10095",317,245,239,0,6,"PODEMOS-IU",9
40,"40071",39,32,26,0,6,"PODEMOS-IU",1
2,"2050",85,66,66,1,0,"PODEMOS-IU",5
13,"13036",752,552,546,1,6,"PODEMOS-IU",26
16,"16063",112,81,81,1,0,"PODEMOS-IU",8
37,"37344",229,157,147,2,10,"PODEMOS-IU",2
50,"50287",253,189,188,11,1,"PODEMOS-IU",23
28,"28137",1770,1300,1289,6,11,"PODEMOS-IU",135
10,"10110",2226,1431,1400,7,31,"PODEMOS-IU",116
45,"45103",363,286,283,0,3,"PODEMOS-IU",8
49,"49011",214,147,146,5,1,"PODEMOS-IU",11
6,"6103",4756,3285,3224,38,61,"PODEMOS-IU",242
26,"26113",29,28,28,0,0,"PODEMOS-IU",0
45,"45152",545,402,393,1,9,"PODEMOS-IU",27
10,"10014",1816,1285,1254,13,31,"PODEMOS-IU",82
10,"10097",107,84,80,0,4,"PODEMOS-IU",8
45,"45042",172,122,121,0,1,"PODEMOS-IU",10
44,"44062",31,20,20,0,0,"PODEMOS-IU",0
2,"2040",548,476,474,1,2,"PODEMOS-IU",26
40,"40213",93,78,78,1,0,"PODEMOS-IU",3
47,"47117",287,199,197,6,2,"PODEMOS-IU",0
44,"44049",784,539,532,3,7,"PODEMOS-IU",61
28,"28177",10851,8550,8485,89,65,"PODEMOS-IU",705
5,"5077",154,113,110,0,3,"PODEMOS-IU",4
5,"5121",263,194,189,1,5,"PODEMOS-IU",12
34,"34055",254,185,184,3,1,"PODEMOS-IU",5
19,"19004",59,44,44,0,0,"PODEMOS-IU",0
9,"9314",90,75,75,2,0,"PODEMOS-IU",3
19,"19057",69,51,51,0,0,"PODEMOS-IU",16
9,"9041",25,21,21,2,0,"PODEMOS-IU",1
24,"24188",3795,2877,2825,40,52,"PODEMOS-IU",188
26,"26177",306,233,229,2,4,"PODEMOS-IU",12
9,"9309",293,198,193,5,5,"PODEMOS-IU",20
49,"49177",255,145,144,1,1,"PODEMOS-IU",13
10,"10090",489,307,302,1,5,"PODEMOS-IU",9
39,"39049",304,198,195,2,3,"PODEMOS-IU",2
45,"45053",7820,5814,5712,56,102,"PODEMOS-IU",408
19,"19075",58,38,37,3,1,"PODEMOS-IU",1
16,"16215",237,162,158,1,4,"PODEMOS-IU",6
19,"19279",54,42,42,0,0,"PODEMOS-IU",2
38,"38037",12817,7582,7494,55,88,"PODEMOS-IU",836
2,"2009",19495,13877,13663,134,214,"PODEMOS-IU",1464
34,"34071",158,128,128,2,0,"PODEMOS-IU",4
45,"45192",2380,1890,1854,8,36,"PODEMOS-IU",79
40,"40161",32,24,23,1,1,"PODEMOS-IU",3
10,"10181",676,470,462,2,8,"PODEMOS-IU",28
50,"50133",98,76,76,0,0,"PODEMOS-IU",5
50,"50106",123,78,78,0,0,"PODEMOS-IU",5
40,"40108",109,85,85,2,0,"PODEMOS-IU",8
16,"16043",88,60,60,3,0,"PODEMOS-IU",3
10,"10195",7514,5243,5148,47,95,"PODEMOS-IU",358
16,"16199",27,18,18,0,0,"PODEMOS-IU",1
5,"5101",266,206,205,1,1,"PODEMOS-IU",7
19,"19289",23,16,16,0,0,"PODEMOS-IU",3
39,"39075",136789,95707,95089,478,618,"PODEMOS-IU",7443
45,"45108",465,343,341,0,2,"PODEMOS-IU",13
50,"50242",99,74,74,0,0,"PODEMOS-IU",3
28,"28143",77,58,58,0,0,"PODEMOS-IU",3
10,"10170",231,164,162,2,2,"PODEMOS-IU",16
44,"44137",187,139,139,0,0,"PODEMOS-IU",4
37,"37005",65,44,44,1,0,"PODEMOS-IU",1
50,"50089",8616,6420,6364,50,56,"PODEMOS-IU",635
9,"9034",291,227,224,1,3,"PODEMOS-IU",5
50,"50065",56,37,37,0,0,"PODEMOS-IU",4
16,"16148",544,452,451,2,1,"PODEMOS-IU",14
26,"26079",633,503,499,2,4,"PODEMOS-IU",19
13,"13029",89,67,65,0,2,"PODEMOS-IU",8
47,"47047",199,136,135,4,1,"PODEMOS-IU",7
37,"37117",1572,1103,1092,12,11,"PODEMOS-IU",102
34,"34126",248,177,176,3,1,"PODEMOS-IU",5
5,"5118",64,41,41,1,0,"PODEMOS-IU",6
39,"39023",6563,4788,4753,14,35,"PODEMOS-IU",380
26,"26076",115,83,83,0,0,"PODEMOS-IU",2
2,"2068",323,239,239,3,0,"PODEMOS-IU",21
9,"9450",23,18,18,1,0,"PODEMOS-IU",2
39,"39099",3193,2363,2346,10,17,"PODEMOS-IU",207
40,"40020",149,112,111,1,1,"PODEMOS-IU",7
9,"9176",58,46,45,2,1,"PODEMOS-IU",6
16,"16034",155,116,113,0,3,"PODEMOS-IU",4
10,"10077",626,444,441,5,3,"PODEMOS-IU",24
9,"9903",3112,2087,2058,24,29,"PODEMOS-IU",211
26,"26044",51,38,36,0,2,"PODEMOS-IU",3
44,"44258",53,46,46,0,0,"PODEMOS-IU",0
34,"34238",294,238,236,1,2,"PODEMOS-IU",17
26,"26008",1821,1310,1290,15,20,"PODEMOS-IU",57
6,"6036",4930,3492,3394,20,98,"PODEMOS-IU",273
47,"47048",175,124,122,0,2,"PODEMOS-IU",5
50,"50162",135,100,99,3,1,"PODEMOS-IU",0
37,"37237",296,212,204,1,8,"PODEMOS-IU",11
6,"6127",2809,2105,2074,9,31,"PODEMOS-IU",104
47,"47155",3454,2445,2405,26,40,"PODEMOS-IU",334
30,"30023",3874,2831,2788,18,43,"PODEMOS-IU",334
26,"26098",92,63,63,1,0,"PODEMOS-IU",15
19,"19303",41,32,32,0,0,"PODEMOS-IU",1
49,"49153",150,110,107,2,3,"PODEMOS-IU",2
45,"45148",263,184,184,0,0,"PODEMOS-IU",6
28,"28114",141,97,97,0,0,"PODEMOS-IU",14
44,"44200",39,26,26,0,0,"PODEMOS-IU",0
6,"6069",2985,1921,1874,17,47,"PODEMOS-IU",115
38,"38033",3593,2277,2242,15,35,"PODEMOS-IU",193
5,"5127",600,472,469,7,3,"PODEMOS-IU",23
10,"10202",583,457,453,1,4,"PODEMOS-IU",32
16,"16012",76,66,66,0,0,"PODEMOS-IU",0
37,"37195",39,31,31,0,0,"PODEMOS-IU",4
19,"19304",224,169,166,3,3,"PODEMOS-IU",26
37,"37216",294,234,227,5,7,"PODEMOS-IU",1
47,"47030",935,680,669,5,11,"PODEMOS-IU",83
5,"5029",100,73,73,1,0,"PODEMOS-IU",1
16,"16025",24,20,20,0,0,"PODEMOS-IU",1
42,"42195",86,51,51,2,0,"PODEMOS-IU",2
16,"16190",4930,3747,3688,26,59,"PODEMOS-IU",155
9,"9180",132,94,91,1,3,"PODEMOS-IU",10
50,"50024",543,400,397,3,3,"PODEMOS-IU",34
19,"19053",1906,1323,1304,12,19,"PODEMOS-IU",121
34,"34089",141,102,101,4,1,"PODEMOS-IU",13
16,"16101",137,111,109,1,2,"PODEMOS-IU",5
47,"47187",71,49,49,0,0,"PODEMOS-IU",1
40,"40211",66,54,54,1,0,"PODEMOS-IU",2
19,"19126",1701,1223,1207,6,16,"PODEMOS-IU",168
5,"5107",54,36,35,2,1,"PODEMOS-IU",2
10,"10203",4421,2810,2764,15,46,"PODEMOS-IU",216
19,"19173",47,40,40,0,0,"PODEMOS-IU",3
10,"10150",339,279,275,3,4,"PODEMOS-IU",18
5,"5204",578,445,442,3,3,"PODEMOS-IU",26
26,"26049",156,120,115,0,5,"PODEMOS-IU",11
49,"49267",96,67,63,2,4,"PODEMOS-IU",2
9,"9437",266,207,203,4,4,"PODEMOS-IU",6
6,"6041",456,329,321,2,8,"PODEMOS-IU",41
30,"30002",9701,6794,6717,27,77,"PODEMOS-IU",512
28,"28180",5317,4011,3959,35,52,"PODEMOS-IU",393
9,"9387",107,89,88,0,1,"PODEMOS-IU",15
19,"19321",34,28,28,0,0,"PODEMOS-IU",4
24,"24044",150,91,89,2,2,"PODEMOS-IU",11
50,"50263",171,110,108,1,2,"PODEMOS-IU",10
2,"2018",789,611,606,3,5,"PODEMOS-IU",23
34,"34113",40,38,38,0,0,"PODEMOS-IU",4
47,"47189",151,128,122,1,6,"PODEMOS-IU",6
45,"45030",471,346,334,4,12,"PODEMOS-IU",32
40,"40160",93,65,62,0,3,"PODEMOS-IU",1
37,"37242",82,59,59,1,0,"PODEMOS-IU",2
44,"44204",27,18,18,0,0,"PODEMOS-IU",2
47,"47179",368,256,254,2,2,"PODEMOS-IU",23
19,"19059",73,47,47,0,0,"PODEMOS-IU",2
2,"2030",2949,2158,2122,16,36,"PODEMOS-IU",155
19,"19049",8,8,7,0,1,"PODEMOS-IU",0
34,"34114",200,134,134,0,0,"PODEMOS-IU",2
16,"16213",34,27,26,0,1,"PODEMOS-IU",5
19,"19235",98,77,76,1,1,"PODEMOS-IU",9
26,"26111",250,191,187,3,4,"PODEMOS-IU",22
16,"16244",698,598,585,7,13,"PODEMOS-IU",11
50,"50003",117,89,89,1,0,"PODEMOS-IU",2
9,"9257",85,67,67,2,0,"PODEMOS-IU",5
2,"2005",554,426,419,8,7,"PODEMOS-IU",23
35,"35034",8392,3946,3908,27,38,"PODEMOS-IU",625
37,"37030",82,60,60,0,0,"PODEMOS-IU",2
19,"19155",64,49,49,0,0,"PODEMOS-IU",8
10,"10045",971,686,682,4,4,"PODEMOS-IU",67
16,"16094",121,86,84,0,2,"PODEMOS-IU",4
49,"49235",415,300,290,4,10,"PODEMOS-IU",22
40,"40129",159,119,117,2,2,"PODEMOS-IU",4
9,"9483",189,156,155,2,1,"PODEMOS-IU",15
2,"2031",535,406,401,4,5,"PODEMOS-IU",19
13,"13904",496,353,342,5,11,"PODEMOS-IU",27
47,"47086",3818,2835,2784,36,51,"PODEMOS-IU",163
19,"19145",40,32,32,0,0,"PODEMOS-IU",1
45,"45107",3463,2621,2585,23,36,"PODEMOS-IU",307
50,"50167",208,166,163,1,3,"PODEMOS-IU",10
10,"10128",5618,3799,3630,37,169,"PODEMOS-IU",240
37,"37082",733,468,456,7,12,"PODEMOS-IU",23
47,"47214",1349,1036,1019,5,17,"PODEMOS-IU",62
34,"34151",148,98,96,1,2,"PODEMOS-IU",3
9,"9276",390,256,244,4,12,"PODEMOS-IU",86
50,"50047",38,24,24,0,0,"PODEMOS-IU",1
19,"19209",40,30,29,0,1,"PODEMOS-IU",1
10,"10182",122,81,81,0,0,"PODEMOS-IU",5
10,"10129",340,234,227,2,7,"PODEMOS-IU",16
34,"34102",197,158,156,1,2,"PODEMOS-IU",6
13,"13028",10230,7682,7559,65,123,"PODEMOS-IU",532
6,"6123",4502,2989,2894,29,95,"PODEMOS-IU",356
16,"16033",1633,1199,1174,8,25,"PODEMOS-IU",84
28,"28173",523,384,381,1,3,"PODEMOS-IU",35
24,"24222",14499,10219,10076,99,143,"PODEMOS-IU",1161
5,"5197",100,82,79,1,3,"PODEMOS-IU",5
40,"40055",31,26,26,0,0,"PODEMOS-IU",2
28,"28078",40,38,38,0,0,"PODEMOS-IU",12
50,"50142",23,16,16,1,0,"PODEMOS-IU",1
50,"50169",333,231,230,0,1,"PODEMOS-IU",21
44,"44075",321,255,252,1,3,"PODEMOS-IU",3
13,"13091",537,466,464,3,2,"PODEMOS-IU",12
39,"39021",464,370,364,1,6,"PODEMOS-IU",22
9,"9194",1970,1376,1359,15,17,"PODEMOS-IU",160
2,"2079",2807,2000,1978,17,22,"PODEMOS-IU",536
47,"47099",154,123,118,0,5,"PODEMOS-IU",3
9,"9228",155,129,129,0,0,"PODEMOS-IU",8
49,"49162",170,117,116,1,1,"PODEMOS-IU",10
19,"19123",37,30,28,0,2,"PODEMOS-IU",4
26,"26121",30,19,19,0,0,"PODEMOS-IU",0
5,"5013",834,658,653,2,5,"PODEMOS-IU",121
37,"37277",74,55,55,0,0,"PODEMOS-IU",2
19,"19240",49,36,36,0,0,"PODEMOS-IU",3
42,"42135",69,40,40,1,0,"PODEMOS-IU",3
28,"28903",35555,28875,28671,341,204,"PODEMOS-IU",3519
10,"10212",1658,1113,1068,19,45,"PODEMOS-IU",213
28,"28048",514,386,384,4,2,"PODEMOS-IU",74
47,"47217",1984,1460,1437,11,23,"PODEMOS-IU",184
37,"37122",203,162,161,3,1,"PODEMOS-IU",7
42,"42211",84,67,67,0,0,"PODEMOS-IU",6
9,"9068",23,16,16,0,0,"PODEMOS-IU",2
19,"19009",263,186,184,0,2,"PODEMOS-IU",9
9,"9398",73,52,52,0,0,"PODEMOS-IU",0
28,"28008",2008,1333,1323,7,10,"PODEMOS-IU",154
10,"10173",558,389,385,5,4,"PODEMOS-IU",31
50,"50153",914,683,675,9,8,"PODEMOS-IU",41
28,"28018",4121,3174,3151,22,23,"PODEMOS-IU",367
37,"37248",150,116,116,1,0,"PODEMOS-IU",5
9,"9381",28,19,19,0,0,"PODEMOS-IU",2
40,"40047",37,23,23,0,0,"PODEMOS-IU",3
34,"34227",70,56,52,1,4,"PODEMOS-IU",4
19,"19200",66,53,52,0,1,"PODEMOS-IU",9
19,"19095",11,7,6,0,1,"PODEMOS-IU",0
47,"47176",199,110,110,0,0,"PODEMOS-IU",1
44,"44191",714,509,500,5,9,"PODEMOS-IU",78
42,"42022",206,147,146,6,1,"PODEMOS-IU",2
19,"19136",11,10,10,0,0,"PODEMOS-IU",0
37,"37175",412,298,293,4,5,"PODEMOS-IU",11
19,"19001",43,32,32,0,0,"PODEMOS-IU",2
39,"39060",6704,4959,4887,23,72,"PODEMOS-IU",544
19,"19037",131,109,108,0,1,"PODEMOS-IU",8
45,"45027",315,249,246,2,3,"PODEMOS-IU",12
47,"47049",91,58,58,0,0,"PODEMOS-IU",4
37,"37101",138,101,100,1,1,"PODEMOS-IU",1
49,"49068",422,263,261,4,2,"PODEMOS-IU",6
24,"24114",2866,1753,1742,15,11,"PODEMOS-IU",225
10,"10135",1240,834,826,3,8,"PODEMOS-IU",18
24,"24215",149,116,115,0,1,"PODEMOS-IU",5
47,"47071",396,321,316,5,5,"PODEMOS-IU",55
50,"50262",1161,849,832,11,17,"PODEMOS-IU",104
26,"26178",72,56,56,1,0,"PODEMOS-IU",1
42,"42079",21,17,17,1,0,"PODEMOS-IU",0
34,"34159",375,221,214,4,7,"PODEMOS-IU",33
37,"37054",233,190,186,2,4,"PODEMOS-IU",9
40,"40092",105,75,75,2,0,"PODEMOS-IU",1
19,"19233",79,65,65,2,0,"PODEMOS-IU",16
10,"10216",1518,1082,1056,11,26,"PODEMOS-IU",69
45,"45004",546,400,398,2,2,"PODEMOS-IU",32
10,"10217",506,378,377,3,1,"PODEMOS-IU",14
24,"24104",243,167,166,0,1,"PODEMOS-IU",17
47,"47221",97,85,84,1,1,"PODEMOS-IU",4
47,"47148",419,332,324,3,8,"PODEMOS-IU",15
5,"5053",76,48,48,0,0,"PODEMOS-IU",0
50,"50255",199,152,147,3,5,"PODEMOS-IU",11
49,"49058",301,222,221,1,1,"PODEMOS-IU",7
42,"42051",15,9,9,0,0,"PODEMOS-IU",0
50,"50131",212,152,147,4,5,"PODEMOS-IU",11
13,"13053",14031,9930,9796,97,134,"PODEMOS-IU",765
44,"44222",125,92,92,0,0,"PODEMOS-IU",1
9,"9075",104,82,82,0,0,"PODEMOS-IU",5
39,"39044",3921,2805,2783,18,22,"PODEMOS-IU",243
37,"37116",70,50,50,0,0,"PODEMOS-IU",5
34,"34216",61,41,41,0,0,"PODEMOS-IU",0
5,"5007",109,73,72,0,1,"PODEMOS-IU",0
49,"49146",265,183,181,4,2,"PODEMOS-IU",12
37,"37209",415,276,275,2,1,"PODEMOS-IU",24
5,"5206",26,17,17,0,0,"PODEMOS-IU",1
16,"16117",1018,723,715,9,8,"PODEMOS-IU",37
16,"16005",234,163,160,1,3,"PODEMOS-IU",12
19,"19245",1138,798,778,6,20,"PODEMOS-IU",53
50,"50280",290,220,216,1,4,"PODEMOS-IU",16
24,"24059",804,466,463,5,3,"PODEMOS-IU",36
24,"24158",296,197,192,0,5,"PODEMOS-IU",12
49,"49002",58,43,40,0,3,"PODEMOS-IU",5
28,"28004",6618,4502,4457,28,45,"PODEMOS-IU",522
24,"24011",182,104,102,3,2,"PODEMOS-IU",4
47,"47075",4772,3557,3512,34,45,"PODEMOS-IU",233
9,"9184",6,6,6,0,0,"PODEMOS-IU",2
49,"49111",119,84,84,3,0,"PODEMOS-IU",1
47,"47223",148,105,102,4,3,"PODEMOS-IU",4
50,"50080",34,27,27,0,0,"PODEMOS-IU",5
24,"24193",363,264,264,1,0,"PODEMOS-IU",23
50,"50265",74,54,54,1,0,"PODEMOS-IU",11
49,"49013",219,160,159,0,1,"PODEMOS-IU",2
16,"16146",85,49,49,0,0,"PODEMOS-IU",2
26,"26052",146,106,105,0,1,"PODEMOS-IU",7
13,"13087",23255,15400,15127,213,273,"PODEMOS-IU",1514
47,"47096",127,94,93,1,1,"PODEMOS-IU",4
28,"28096",20022,14440,14238,115,202,"PODEMOS-IU",1512
2,"2065",441,368,361,0,7,"PODEMOS-IU",23
5,"5218",104,81,79,0,2,"PODEMOS-IU",3
47,"47065",820,608,602,2,6,"PODEMOS-IU",17
2,"2076",313,233,230,2,3,"PODEMOS-IU",3
13,"13042",880,638,626,2,12,"PODEMOS-IU",25
24,"24181",1404,944,925,7,19,"PODEMOS-IU",37
47,"47130",94,64,63,0,1,"PODEMOS-IU",4
24,"24073",437,285,282,1,3,"PODEMOS-IU",21
9,"9117",71,58,58,0,0,"PODEMOS-IU",2
45,"45120",113,86,86,0,0,"PODEMOS-IU",7
50,"50056",399,296,296,3,0,"PODEMOS-IU",26
9,"9226",54,45,45,2,0,"PODEMOS-IU",1
5,"5230",65,57,56,1,1,"PODEMOS-IU",0
39,"39085",7017,5029,4992,23,37,"PODEMOS-IU",398
50,"50266",120,77,76,3,1,"PODEMOS-IU",3
47,"47215",48,43,43,0,0,"PODEMOS-IU",2
49,"49199",236,159,157,3,2,"PODEMOS-IU",11
44,"44101",55,41,40,1,1,"PODEMOS-IU",0
45,"45048",360,276,271,2,5,"PODEMOS-IU",17
44,"44128",58,39,37,0,2,"PODEMOS-IU",0
16,"16217",91,72,72,0,0,"PODEMOS-IU",6
16,"16045",180,128,127,0,1,"PODEMOS-IU",6
5,"5134",47,40,40,0,0,"PODEMOS-IU",0
10,"10157",246,163,161,0,2,"PODEMOS-IU",21
49,"49250",1191,844,824,8,20,"PODEMOS-IU",26
5,"5221",322,231,231,0,0,"PODEMOS-IU",43
47,"47164",349,283,281,1,2,"PODEMOS-IU",14
24,"24027",1214,841,828,6,13,"PODEMOS-IU",120
24,"24004",495,387,384,10,3,"PODEMOS-IU",23
9,"9083",26,21,21,0,0,"PODEMOS-IU",0
26,"26081",15,14,14,1,0,"PODEMOS-IU",0
5,"5081",37,21,21,3,0,"PODEMOS-IU",0
35,"35009",20229,13378,13201,95,177,"PODEMOS-IU",1739
19,"19249",29,26,26,0,0,"PODEMOS-IU",0
10,"10022",409,301,291,1,10,"PODEMOS-IU",36
37,"37193",362,253,252,4,1,"PODEMOS-IU",9
19,"19159",87,73,72,1,1,"PODEMOS-IU",1
10,"10145",123,90,84,0,6,"PODEMOS-IU",4
24,"24077",212,166,162,0,4,"PODEMOS-IU",5
40,"40198",24,20,19,0,1,"PODEMOS-IU",0
45,"45123",3196,2252,2218,11,34,"PODEMOS-IU",332
42,"42020",4170,2732,2686,35,46,"PODEMOS-IU",194
26,"26069",230,166,166,0,0,"PODEMOS-IU",10
6,"6112",379,295,293,0,2,"PODEMOS-IU",18
19,"19092",395,286,279,2,7,"PODEMOS-IU",18
49,"49128",520,384,378,7,6,"PODEMOS-IU",17
44,"44180",74,56,56,0,0,"PODEMOS-IU",1
44,"44059",562,411,407,2,4,"PODEMOS-IU",16
2,"2047",110,83,81,0,2,"PODEMOS-IU",1
47,"47080",33,25,24,0,1,"PODEMOS-IU",3
9,"9287",191,144,143,2,1,"PODEMOS-IU",22
50,"50128",26,23,23,0,0,"PODEMOS-IU",4
2,"2025",7345,5388,5278,51,110,"PODEMOS-IU",482
26,"26110",149,116,114,0,2,"PODEMOS-IU",6
47,"47081",39,32,32,0,0,"PODEMOS-IU",4
50,"50297",503800,365284,362768,3385,2516,"PODEMOS-IU",43667
45,"45100",178,141,138,0,3,"PODEMOS-IU",6
19,"19231",10,6,6,0,0,"PODEMOS-IU",0
44,"44105",68,53,53,0,0,"PODEMOS-IU",4
40,"40026",112,101,99,0,2,"PODEMOS-IU",22
24,"24065",2164,1524,1492,12,32,"PODEMOS-IU",123
37,"37088",199,135,133,0,2,"PODEMOS-IU",4
9,"9433",52,40,40,0,0,"PODEMOS-IU",7
47,"47040",56,42,41,0,1,"PODEMOS-IU",2
37,"37020",431,320,314,3,6,"PODEMOS-IU",29
37,"37217",59,43,43,3,0,"PODEMOS-IU",5
19,"19081",27,21,21,0,0,"PODEMOS-IU",0
9,"9023",1190,891,879,17,12,"PODEMOS-IU",116
42,"42108",10,7,7,0,0,"PODEMOS-IU",0
10,"10189",2499,1747,1700,15,47,"PODEMOS-IU",180
45,"45138",1058,813,802,5,11,"PODEMOS-IU",37
50,"50129",212,129,127,0,2,"PODEMOS-IU",13
50,"50035",74,57,57,0,0,"PODEMOS-IU",22
34,"34110",75,64,64,0,0,"PODEMOS-IU",9
47,"47230",285,209,206,1,3,"PODEMOS-IU",15
50,"50060",171,126,125,1,1,"PODEMOS-IU",15
19,"19022",592,423,420,6,3,"PODEMOS-IU",27
9,"9128",76,56,56,0,0,"PODEMOS-IU",3
24,"24043",116,54,52,0,2,"PODEMOS-IU",4
16,"16154",4739,3416,3379,33,37,"PODEMOS-IU",212
40,"40138",2102,1585,1565,13,20,"PODEMOS-IU",145
5,"5192",92,75,72,1,3,"PODEMOS-IU",6
19,"19058",7458,5705,5663,40,42,"PODEMOS-IU",763
44,"44125",63,41,41,0,0,"PODEMOS-IU",1
13,"13007",1219,871,852,4,19,"PODEMOS-IU",79
26,"26074",107,87,86,2,1,"PODEMOS-IU",14
45,"45091",376,270,269,3,1,"PODEMOS-IU",14
13,"13098",1946,1404,1361,13,43,"PODEMOS-IU",67
9,"9478",45,34,34,1,0,"PODEMOS-IU",3
9,"9026",377,288,288,1,0,"PODEMOS-IU",31
24,"24068",430,289,281,0,8,"PODEMOS-IU",20
5,"5018",23,17,17,2,0,"PODEMOS-IU",3
9,"9388",31,26,25,0,1,"PODEMOS-IU",2
28,"28160",8709,6507,6460,62,47,"PODEMOS-IU",754
26,"26127",182,149,149,1,0,"PODEMOS-IU",2
28,"28022",37338,30620,30455,229,165,"PODEMOS-IU",1861
42,"42218",68,44,43,0,1,"PODEMOS-IU",7
40,"40106",179,140,139,2,1,"PODEMOS-IU",2
16,"16246",451,327,322,1,5,"PODEMOS-IU",14
19,"19110",51,39,39,0,0,"PODEMOS-IU",3
50,"50198",47,32,32,0,0,"PODEMOS-IU",2
9,"9480",105,84,84,0,0,"PODEMOS-IU",6
44,"44223",73,48,48,0,0,"PODEMOS-IU",8
49,"49023",899,627,620,3,7,"PODEMOS-IU",25
34,"34056",1926,1335,1311,10,24,"PODEMOS-IU",120
45,"45203",2777,1986,1961,18,25,"PODEMOS-IU",188
13,"13055",616,445,444,3,1,"PODEMOS-IU",39
44,"44165",168,125,125,2,0,"PODEMOS-IU",3
2,"2053",2888,2086,2042,14,44,"PODEMOS-IU",231
2,"2086",2389,1567,1554,10,13,"PODEMOS-IU",89
24,"24219",489,334,329,7,5,"PODEMOS-IU",27
5,"5251",56,35,34,0,1,"PODEMOS-IU",2
45,"45033",297,205,201,1,4,"PODEMOS-IU",12
26,"26091",147,115,114,0,1,"PODEMOS-IU",5
37,"37316",711,546,541,7,5,"PODEMOS-IU",17
39,"39083",1063,619,611,2,8,"PODEMOS-IU",34
9,"9132",170,121,120,0,1,"PODEMOS-IU",4
44,"44076",2089,1577,1565,8,12,"PODEMOS-IU",54
49,"49148",259,119,115,1,4,"PODEMOS-IU",4
16,"16007",1153,857,847,3,10,"PODEMOS-IU",10
44,"44215",167,113,113,2,0,"PODEMOS-IU",7
40,"40010",108,83,82,0,1,"PODEMOS-IU",4
26,"26004",69,47,46,0,1,"PODEMOS-IU",0
13,"13057",1099,858,849,2,9,"PODEMOS-IU",38
49,"49036",503,319,316,5,3,"PODEMOS-IU",18
37,"37004",25,18,18,0,0,"PODEMOS-IU",1
44,"44167",34,26,26,0,0,"PODEMOS-IU",1
37,"37359",165,105,103,0,2,"PODEMOS-IU",3
5,"5219",33,23,23,0,0,"PODEMOS-IU",1
2,"2055",1055,672,668,2,4,"PODEMOS-IU",44
34,"34087",125,99,99,2,0,"PODEMOS-IU",4
37,"37070",523,371,365,4,6,"PODEMOS-IU",14
44,"44235",87,65,64,1,1,"PODEMOS-IU",3
50,"50098",162,119,118,1,1,"PODEMOS-IU",4
37,"37130",173,135,134,2,1,"PODEMOS-IU",2
47,"47131",167,122,120,2,2,"PODEMOS-IU",7
44,"44157",61,37,37,0,0,"PODEMOS-IU",2
42,"42164",1580,1043,1029,8,14,"PODEMOS-IU",53
40,"40012",241,160,156,7,4,"PODEMOS-IU",4
9,"9155",25,23,23,0,0,"PODEMOS-IU",0
40,"40110",316,237,234,4,3,"PODEMOS-IU",18
16,"16203",10221,6960,6883,42,77,"PODEMOS-IU",554
34,"34104",231,164,162,2,2,"PODEMOS-IU",2
37,"37006",116,71,70,3,1,"PODEMOS-IU",7
26,"26120",1441,1027,1011,11,16,"PODEMOS-IU",72
47,"47007",4051,2987,2954,27,33,"PODEMOS-IU",422
44,"44102",26,19,19,0,0,"PODEMOS-IU",0
37,"37381",138,98,93,0,5,"PODEMOS-IU",2
37,"37246",5146,3791,3737,42,54,"PODEMOS-IU",229
50,"50152",1351,942,932,14,10,"PODEMOS-IU",55
9,"9066",54,37,37,0,0,"PODEMOS-IU",1
42,"42019",519,345,341,3,4,"PODEMOS-IU",30
34,"34237",579,408,400,1,8,"PODEMOS-IU",14
40,"40013",57,47,47,0,0,"PODEMOS-IU",1
39,"39058",806,556,554,2,2,"PODEMOS-IU",46
5,"5135",399,294,292,2,2,"PODEMOS-IU",8
5,"5038",114,83,82,0,1,"PODEMOS-IU",6
40,"40906",2149,1701,1662,18,39,"PODEMOS-IU",193
2,"2024",3361,2444,2411,24,33,"PODEMOS-IU",279
19,"19170",189,115,115,1,0,"PODEMOS-IU",18
40,"40014",56,39,38,0,1,"PODEMOS-IU",2
49,"49007",361,241,233,7,8,"PODEMOS-IU",16
34,"34091",118,82,82,1,0,"PODEMOS-IU",3
5,"5104",33,21,19,0,2,"PODEMOS-IU",2
40,"40112",2813,2126,2087,26,39,"PODEMOS-IU",189
2,"2058",300,186,177,1,9,"PODEMOS-IU",14
37,"37074",136,93,90,1,3,"PODEMOS-IU",4
9,"9104",49,35,34,0,1,"PODEMOS-IU",1
42,"42212",57,45,45,2,0,"PODEMOS-IU",1
6,"6052",3962,2728,2642,26,86,"PODEMOS-IU",199
9,"9267",117,95,93,1,2,"PODEMOS-IU",1
44,"44082",84,66,66,0,0,"PODEMOS-IU",1
26,"26022",177,130,128,0,2,"PODEMOS-IU",8
34,"34241",17,17,16,3,1,"PODEMOS-IU",0
47,"47165",6823,4999,4906,48,93,"PODEMOS-IU",403
19,"19036",242,202,200,1,2,"PODEMOS-IU",7
45,"45124",2080,1628,1595,15,33,"PODEMOS-IU",75
50,"50236",95,77,75,0,2,"PODEMOS-IU",3
39,"39089",131,82,82,0,0,"PODEMOS-IU",5
9,"9139",98,79,79,2,0,"PODEMOS-IU",7
9,"9268",89,62,62,0,0,"PODEMOS-IU",3
2,"2059",320,225,217,0,8,"PODEMOS-IU",5
37,"37373",692,451,442,4,9,"PODEMOS-IU",35
19,"19172",51,38,38,0,0,"PODEMOS-IU",3
19,"19284",10,10,10,0,0,"PODEMOS-IU",1
40,"40233",399,279,273,0,6,"PODEMOS-IU",25
44,"44132",54,49,49,0,0,"PODEMOS-IU",2
5,"5027",258,209,203,5,6,"PODEMOS-IU",18
50,"50253",379,294,290,1,4,"PODEMOS-IU",12
34,"34109",60,34,34,0,0,"PODEMOS-IU",3
47,"47092",101,81,79,0,2,"PODEMOS-IU",6
42,"42157",10,9,9,0,0,"PODEMOS-IU",0
13,"13081",584,412,405,0,7,"PODEMOS-IU",35
28,"28104",15528,12342,12234,103,108,"PODEMOS-IU",1155
13,"13066",2621,2029,1998,12,31,"PODEMOS-IU",71
39,"39034",255,133,128,2,5,"PODEMOS-IU",1
45,"45028",3613,2675,2647,22,28,"PODEMOS-IU",168
37,"37206",87,65,54,0,11,"PODEMOS-IU",2
34,"34141",176,149,146,0,3,"PODEMOS-IU",5
10,"10122",219,159,157,2,2,"PODEMOS-IU",15
5,"5041",984,743,732,5,11,"PODEMOS-IU",31
37,"37041",71,53,53,0,0,"PODEMOS-IU",1
9,"9329",113,76,75,5,1,"PODEMOS-IU",14
50,"50221",29,18,18,0,0,"PODEMOS-IU",0
40,"40081",117,80,76,1,4,"PODEMOS-IU",8
34,"34052",164,127,125,1,2,"PODEMOS-IU",10
9,"9112",102,73,73,0,0,"PODEMOS-IU",4
47,"47083",81,63,61,0,2,"PODEMOS-IU",9
19,"19331",2677,1892,1841,18,51,"PODEMOS-IU",188
6,"6072",2211,1610,1586,11,24,"PODEMOS-IU",100
5,"5030",40,32,32,0,0,"PODEMOS-IU",10
5,"5130",94,77,77,1,0,"PODEMOS-IU",3
16,"16104",53,42,42,0,0,"PODEMOS-IU",1
45,"45068",179,129,127,0,2,"PODEMOS-IU",7
42,"42145",129,105,104,1,1,"PODEMOS-IU",2
9,"9113",453,321,315,8,6,"PODEMOS-IU",29
28,"28043",6190,4031,3969,33,62,"PODEMOS-IU",437
34,"34146",53,43,43,0,0,"PODEMOS-IU",4
5,"5237",153,125,123,0,2,"PODEMOS-IU",1
5,"5033",169,135,134,0,1,"PODEMOS-IU",2
5,"5154",31,23,23,0,0,"PODEMOS-IU",0
39,"39035",9142,6574,6517,24,57,"PODEMOS-IU",538
49,"49046",246,174,169,0,5,"PODEMOS-IU",7
49,"49269",218,126,124,1,2,"PODEMOS-IU",7
42,"42039",216,144,141,1,3,"PODEMOS-IU",21
40,"40172",47,33,32,0,1,"PODEMOS-IU",2
19,"19226",37,22,22,0,0,"PODEMOS-IU",1
42,"42115",89,68,66,0,2,"PODEMOS-IU",5
47,"47140",106,83,83,0,0,"PODEMOS-IU",3
16,"16156",84,64,64,0,0,"PODEMOS-IU",2
2,"2020",425,336,332,4,4,"PODEMOS-IU",17
24,"24157",2542,1846,1809,16,37,"PODEMOS-IU",124
34,"34165",57,45,44,1,1,"PODEMOS-IU",0
13,"13086",158,122,120,0,2,"PODEMOS-IU",4
30,"30004",1129,838,833,1,5,"PODEMOS-IU",51
44,"44196",121,88,88,0,0,"PODEMOS-IU",1
28,"28182",203,167,163,1,4,"PODEMOS-IU",30
5,"5207",645,485,478,4,7,"PODEMOS-IU",35
5,"5239",215,163,163,3,0,"PODEMOS-IU",4
50,"50071",126,84,84,0,0,"PODEMOS-IU",2
24,"24096",105,56,54,1,2,"PODEMOS-IU",3
34,"34902",123,91,91,0,0,"PODEMOS-IU",1
42,"42130",51,42,40,1,2,"PODEMOS-IU",0
16,"16132",33,25,25,1,0,"PODEMOS-IU",4
40,"40053",79,56,56,1,0,"PODEMOS-IU",6
47,"47055",188,147,147,2,0,"PODEMOS-IU",8
42,"42177",61,42,41,0,1,"PODEMOS-IU",1
19,"19267",20,15,14,0,1,"PODEMOS-IU",0
5,"5112",95,59,58,0,1,"PODEMOS-IU",5
16,"16018",376,290,290,2,0,"PODEMOS-IU",6
5,"5012",117,88,88,1,0,"PODEMOS-IU",1
26,"26172",25,16,15,0,1,"PODEMOS-IU",3
47,"47204",235,159,157,3,2,"PODEMOS-IU",5
30,"30013",7421,5171,5094,32,77,"PODEMOS-IU",364
16,"16008",80,63,63,1,0,"PODEMOS-IU",9
24,"24086",258,197,196,1,1,"PODEMOS-IU",5
49,"49037",174,139,136,1,3,"PODEMOS-IU",8
19,"19268",50,37,35,0,2,"PODEMOS-IU",5
5,"5145",43,28,28,0,0,"PODEMOS-IU",0
28,"28046",4824,3726,3707,33,19,"PODEMOS-IU",446
44,"44028",171,136,136,0,0,"PODEMOS-IU",7
10,"10007",627,457,447,3,10,"PODEMOS-IU",9
24,"24197",717,500,499,2,1,"PODEMOS-IU",33
6,"6095",9506,6616,6425,109,191,"PODEMOS-IU",774
16,"16159",198,135,135,2,0,"PODEMOS-IU",2
9,"9377",626,468,460,6,8,"PODEMOS-IU",24
40,"40077",966,718,704,10,14,"PODEMOS-IU",89
6,"6065",293,230,228,2,2,"PODEMOS-IU",5
9,"9246",599,381,372,2,9,"PODEMOS-IU",43
34,"34122",83,56,56,0,0,"PODEMOS-IU",5
24,"24183",748,464,460,9,4,"PODEMOS-IU",41
19,"19326",2463,1671,1650,13,21,"PODEMOS-IU",193
50,"50275",111,50,50,0,0,"PODEMOS-IU",2
9,"9340",74,49,49,1,0,"PODEMOS-IU",1
19,"19079",7,6,6,0,0,"PODEMOS-IU",0
10,"10131",12803,8477,8347,77,130,"PODEMOS-IU",737
35,"35024",14323,8360,8289,81,71,"PODEMOS-IU",1243
47,"47122",2007,1520,1492,8,28,"PODEMOS-IU",138
47,"47123",461,360,358,2,2,"PODEMOS-IU",49
24,"24063",362,247,245,2,2,"PODEMOS-IU",10
10,"10091",351,275,271,2,4,"PODEMOS-IU",18
9,"9281",136,97,97,2,0,"PODEMOS-IU",8
45,"45185",7573,5422,5320,31,102,"PODEMOS-IU",425
28,"28156",1082,788,784,3,4,"PODEMOS-IU",90
26,"26096",257,198,193,2,5,"PODEMOS-IU",11
5,"5115",509,350,344,0,6,"PODEMOS-IU",21
50,"50228",249,207,207,3,0,"PODEMOS-IU",2
9,"9124",1405,946,928,6,18,"PODEMOS-IU",66
40,"40124",234,169,164,0,5,"PODEMOS-IU",25
37,"37310",166,116,115,3,1,"PODEMOS-IU",7
44,"44209",799,584,573,2,11,"PODEMOS-IU",8
44,"44122",1277,939,934,5,5,"PODEMOS-IU",55
24,"24054",410,275,271,0,4,"PODEMOS-IU",7
9,"9471",140,108,107,1,1,"PODEMOS-IU",12
44,"44113",74,51,51,0,0,"PODEMOS-IU",24
13,"13048",495,392,391,4,1,"PODEMOS-IU",53
45,"45136",5827,3908,3864,22,44,"PODEMOS-IU",220
37,"37300",540,355,352,7,3,"PODEMOS-IU",35
39,"39042",5910,4354,4315,14,39,"PODEMOS-IU",284
34,"34140",93,57,57,1,0,"PODEMOS-IU",1
10,"10093",387,278,253,4,25,"PODEMOS-IU",17
10,"10012",553,427,421,1,6,"PODEMOS-IU",35
24,"24164",351,175,174,0,1,"PODEMOS-IU",11
5,"5245",353,262,256,0,6,"PODEMOS-IU",16
40,"40179",620,500,490,3,10,"PODEMOS-IU",30
50,"50146",189,149,149,3,0,"PODEMOS-IU",11
42,"42049",108,71,71,1,0,"PODEMOS-IU",2
49,"49108",446,312,309,2,3,"PODEMOS-IU",19
28,"28060",1585,1160,1146,5,14,"PODEMOS-IU",140
24,"24080",207,155,154,1,1,"PODEMOS-IU",7
50,"50270",38,26,25,0,1,"PODEMOS-IU",2
38,"38002",971,577,570,8,7,"PODEMOS-IU",43
45,"45114",549,400,394,1,6,"PODEMOS-IU",25
37,"37280",70,47,46,0,1,"PODEMOS-IU",1
28,"28021",571,365,364,1,1,"PODEMOS-IU",89
9,"9289",1353,873,861,4,12,"PODEMOS-IU",60
47,"47125",49,42,42,0,0,"PODEMOS-IU",4
40,"40126",67,44,42,0,2,"PODEMOS-IU",3
50,"50230",1140,771,767,11,4,"PODEMOS-IU",76
26,"26100",54,43,43,0,0,"PODEMOS-IU",2
39,"39043",1517,1167,1154,3,13,"PODEMOS-IU",64
50,"50254",179,115,113,0,2,"PODEMOS-IU",5
5,"5085",31,27,27,0,0,"PODEMOS-IU",1
9,"9350",421,316,311,5,5,"PODEMOS-IU",8
44,"44153",1733,1131,1125,0,6,"PODEMOS-IU",38
50,"50077",201,140,140,1,0,"PODEMOS-IU",9
37,"37219",169,88,85,1,3,"PODEMOS-IU",5
2,"2006",573,425,424,1,1,"PODEMOS-IU",15
42,"42188",46,35,35,1,0,"PODEMOS-IU",1
6,"6058",1984,1372,1331,13,41,"PODEMOS-IU",114
37,"37021",66,45,44,0,1,"PODEMOS-IU",1
40,"40139",255,194,192,2,2,"PODEMOS-IU",13
45,"45080",3,3,3,0,0,"PODEMOS-IU",0
50,"50247",852,600,594,8,6,"PODEMOS-IU",49
9,"9182",74,54,54,0,0,"PODEMOS-IU",2
35,"35028",10156,5483,5425,56,58,"PODEMOS-IU",753
30,"30026",16345,10049,9914,84,135,"PODEMOS-IU",691
34,"34217",1269,999,983,14,16,"PODEMOS-IU",97
19,"19074",67,57,57,1,0,"PODEMOS-IU",13
24,"24191",106,70,69,2,1,"PODEMOS-IU",1
9,"9295",52,36,35,1,1,"PODEMOS-IU",1
24,"24218",451,310,308,3,2,"PODEMOS-IU",23
35,"35005",1009,680,668,2,12,"PODEMOS-IU",44
47,"47190",95,75,75,1,0,"PODEMOS-IU",3
9,"9169",97,72,70,1,2,"PODEMOS-IU",5
45,"45117",718,552,548,0,4,"PODEMOS-IU",17
50,"50139",318,237,237,1,0,"PODEMOS-IU",7
26,"26015",185,140,138,2,2,"PODEMOS-IU",7
2,"2052",466,371,370,6,1,"PODEMOS-IU",26
34,"34084",158,125,125,1,0,"PODEMOS-IU",4
26,"26103",814,617,603,10,14,"PODEMOS-IU",62
47,"47013",91,77,77,1,0,"PODEMOS-IU",3
34,"34132",106,73,72,0,1,"PODEMOS-IU",11
5,"5132",857,548,539,7,9,"PODEMOS-IU",45
44,"44147",401,264,256,7,8,"PODEMOS-IU",35
24,"24146",254,202,201,1,1,"PODEMOS-IU",15
28,"28024",168,137,136,2,1,"PODEMOS-IU",16
9,"9030",116,81,81,1,0,"PODEMOS-IU",3
2,"2042",810,581,577,1,4,"PODEMOS-IU",47
50,"50006",913,670,654,13,16,"PODEMOS-IU",59
42,"42191",183,116,114,5,2,"PODEMOS-IU",4
26,"26183",66,48,48,0,0,"PODEMOS-IU",7
19,"19187",42,32,32,0,0,"PODEMOS-IU",2
6,"6062",564,394,391,0,3,"PODEMOS-IU",18
47,"47161",3970,3111,3089,24,22,"PODEMOS-IU",283
47,"47192",89,78,76,3,2,"PODEMOS-IU",8
37,"37025",245,198,196,5,2,"PODEMOS-IU",2
5,"5186",1564,1140,1125,5,15,"PODEMOS-IU",53
5,"5252",56,46,45,0,1,"PODEMOS-IU",0
5,"5057",2418,1785,1748,9,37,"PODEMOS-IU",78
9,"9033",80,64,63,1,1,"PODEMOS-IU",6
50,"50233",96,78,78,0,0,"PODEMOS-IU",2
50,"50200",479,389,383,5,6,"PODEMOS-IU",23
16,"16216",272,207,204,0,3,"PODEMOS-IU",13
13,"13073",501,392,385,2,7,"PODEMOS-IU",12
37,"37150",34,31,31,0,0,"PODEMOS-IU",0
37,"37245",331,221,220,4,1,"PODEMOS-IU",2
28,"28056",946,664,660,2,4,"PODEMOS-IU",137
38,"38022",18630,11420,11284,87,136,"PODEMOS-IU",960
37,"37097",42,29,29,0,0,"PODEMOS-IU",2
6,"6064",847,616,601,3,15,"PODEMOS-IU",113
37,"37318",196,132,132,0,0,"PODEMOS-IU",3
16,"16134",4368,3143,3102,22,41,"PODEMOS-IU",322
44,"44158",1153,879,872,6,7,"PODEMOS-IU",37
42,"42006",154,105,103,0,2,"PODEMOS-IU",10
5,"5114",1257,989,968,5,21,"PODEMOS-IU",29
47,"47088",101,79,79,0,0,"PODEMOS-IU",4
47,"47110",445,335,327,1,8,"PODEMOS-IU",34
28,"28902",521,394,389,3,5,"PODEMOS-IU",65
50,"50125",340,230,229,2,1,"PODEMOS-IU",6
24,"24136",495,347,344,1,3,"PODEMOS-IU",12
26,"26173",8,8,8,1,0,"PODEMOS-IU",0
16,"16149",147,105,105,2,0,"PODEMOS-IU",13
35,"35031",7456,4938,4868,39,70,"PODEMOS-IU",784
6,"6111",487,318,314,2,4,"PODEMOS-IU",24
13,"13046",686,524,521,6,3,"PODEMOS-IU",31
37,"37225",97,78,74,0,4,"PODEMOS-IU",4
50,"50082",82,57,57,0,0,"PODEMOS-IU",1
47,"47132",39,32,32,1,0,"PODEMOS-IU",0
9,"9247",21,18,18,0,0,"PODEMOS-IU",0
42,"42058",103,74,72,1,2,"PODEMOS-IU",1
5,"5059",92,49,48,0,1,"PODEMOS-IU",6
10,"10146",1494,924,903,1,21,"PODEMOS-IU",82
45,"45050",505,338,332,2,6,"PODEMOS-IU",33
6,"6067",1897,1268,1242,14,26,"PODEMOS-IU",57
39,"39050",260,164,164,1,0,"PODEMOS-IU",9
24,"24112",288,188,186,2,2,"PODEMOS-IU",18
42,"42183",102,74,74,1,0,"PODEMOS-IU",4
9,"9138",84,67,66,1,1,"PODEMOS-IU",2
28,"28167",8640,6564,6504,51,60,"PODEMOS-IU",938
24,"24041",513,312,305,4,7,"PODEMOS-IU",22
9,"9086",652,479,471,3,8,"PODEMOS-IU",45
49,"49164",141,95,92,1,3,"PODEMOS-IU",2
42,"42123",157,103,102,6,1,"PODEMOS-IU",2
24,"24029",686,430,428,6,2,"PODEMOS-IU",41
37,"37205",212,157,155,1,2,"PODEMOS-IU",15
9,"9038",109,87,86,1,1,"PODEMOS-IU",6
6,"6008",615,522,507,2,15,"PODEMOS-IU",22
50,"50285",657,448,442,4,6,"PODEMOS-IU",37
9,"9308",58,34,34,1,0,"PODEMOS-IU",5
16,"16112",1466,972,957,12,15,"PODEMOS-IU",74
44,"44012",303,215,215,2,0,"PODEMOS-IU",14
35,"35026",83172,48751,48109,449,642,"PODEMOS-IU",7519
37,"37113",404,286,285,13,1,"PODEMOS-IU",5
37,"37124",195,137,137,2,0,"PODEMOS-IU",13
40,"40157",39,30,30,0,0,"PODEMOS-IU",2
2,"2049",778,506,496,1,10,"PODEMOS-IU",31
9,"9140",117,78,77,1,1,"PODEMOS-IU",3
37,"37155",68,48,48,0,0,"PODEMOS-IU",1
6,"6009",221,166,166,2,0,"PODEMOS-IU",18
24,"24102",587,403,399,7,4,"PODEMOS-IU",24
2,"2004",597,459,455,3,4,"PODEMOS-IU",17
19,"19272",66,55,55,2,0,"PODEMOS-IU",1
16,"16905",1302,951,934,10,17,"PODEMOS-IU",76
47,"47135",82,65,65,3,0,"PODEMOS-IU",0
9,"9198",100,75,74,2,1,"PODEMOS-IU",15
42,"42062",20,10,10,0,0,"PODEMOS-IU",2
50,"50286",75,54,53,0,1,"PODEMOS-IU",0
38,"38051",7328,5017,4969,32,48,"PODEMOS-IU",330
16,"16153",924,751,741,4,10,"PODEMOS-IU",38
39,"39053",212,133,133,4,0,"PODEMOS-IU",3
37,"37065",276,167,167,2,0,"PODEMOS-IU",2
44,"44107",212,135,135,0,0,"PODEMOS-IU",7
28,"28062",306,232,227,0,5,"PODEMOS-IU",29
39,"39025",8637,6256,6179,33,77,"PODEMOS-IU",542
47,"47103",252,195,192,1,3,"PODEMOS-IU",12
45,"45017",264,199,196,4,3,"PODEMOS-IU",23
38,"38003",1517,899,890,5,9,"PODEMOS-IU",88
42,"42063",45,31,30,1,1,"PODEMOS-IU",1
47,"47042",51,39,39,0,0,"PODEMOS-IU",6
24,"24229",376,275,269,2,6,"PODEMOS-IU",12
24,"24009",274,136,135,1,1,"PODEMOS-IU",21
24,"24217",135,93,93,0,0,"PODEMOS-IU",4
30,"30018",8399,6226,6148,28,78,"PODEMOS-IU",403
9,"9454",41,34,33,1,1,"PODEMOS-IU",5
50,"50113",587,471,461,2,10,"PODEMOS-IU",24
6,"6119",674,516,511,1,5,"PODEMOS-IU",24
34,"34131",56,46,46,0,0,"PODEMOS-IU",0
42,"42026",28,25,25,0,0,"PODEMOS-IU",2
47,"47104",2816,2153,2099,20,54,"PODEMOS-IU",125
16,"16212",233,186,184,0,2,"PODEMOS-IU",5
6,"6029",1174,873,865,5,8,"PODEMOS-IU",46
16,"16196",589,490,476,3,14,"PODEMOS-IU",30
16,"16197",67,44,43,0,1,"PODEMOS-IU",6
47,"47074",141,110,109,0,1,"PODEMOS-IU",15
10,"10098",387,272,267,0,5,"PODEMOS-IU",28
5,"5034",15,14,13,0,1,"PODEMOS-IU",0
10,"10193",1392,1045,1025,6,20,"PODEMOS-IU",47
24,"24046",893,595,583,6,12,"PODEMOS-IU",53
5,"5175",144,109,109,0,0,"PODEMOS-IU",3
6,"6075",470,363,360,7,3,"PODEMOS-IU",34
37,"37263",339,215,210,0,5,"PODEMOS-IU",20
5,"5021",1861,1323,1304,22,19,"PODEMOS-IU",132
37,"37189",114,75,74,1,1,"PODEMOS-IU",1
34,"34101",48,36,36,1,0,"PODEMOS-IU",1
35,"35029",4415,2498,2472,29,26,"PODEMOS-IU",340
16,"16006",113,100,100,1,0,"PODEMOS-IU",4
16,"16118",1351,1022,1009,13,13,"PODEMOS-IU",42
42,"42028",75,57,56,0,1,"PODEMOS-IU",9
6,"6076",825,573,562,1,11,"PODEMOS-IU",78
5,"5229",75,61,61,1,0,"PODEMOS-IU",0
5,"5035",92,68,68,0,0,"PODEMOS-IU",6
34,"34042",294,224,221,1,3,"PODEMOS-IU",4
13,"13011",4439,2762,2694,16,68,"PODEMOS-IU",202
9,"9098",470,318,309,3,9,"PODEMOS-IU",18
19,"19257",3279,2233,2206,21,27,"PODEMOS-IU",196
40,"40141",822,584,568,9,16,"PODEMOS-IU",36
26,"26118",71,54,53,1,1,"PODEMOS-IU",4
42,"42207",48,42,41,0,1,"PODEMOS-IU",7
19,"19228",27,17,17,1,0,"PODEMOS-IU",2
39,"39057",2366,1636,1607,10,29,"PODEMOS-IU",150
42,"42069",1483,896,878,2,18,"PODEMOS-IU",109
6,"6033",1276,986,972,5,14,"PODEMOS-IU",39
5,"5133",61,44,43,0,1,"PODEMOS-IU",0
16,"16044",43,29,28,0,1,"PODEMOS-IU",3
16,"16084",48,34,30,1,4,"PODEMOS-IU",0
6,"6063",2924,2141,2108,8,33,"PODEMOS-IU",108
39,"39076",3512,2517,2491,13,26,"PODEMOS-IU",200
10,"10196",294,208,206,3,2,"PODEMOS-IU",20
38,"38031",29301,20926,20701,157,225,"PODEMOS-IU",2316
45,"45169",179,114,111,1,3,"PODEMOS-IU",1
47,"47205",355,248,244,2,4,"PODEMOS-IU",13
6,"6079",649,451,445,3,6,"PODEMOS-IU",13
40,"40206",162,126,123,0,3,"PODEMOS-IU",25
9,"9051",164,125,125,0,0,"PODEMOS-IU",10
6,"6125",1644,1251,1222,7,29,"PODEMOS-IU",77
10,"10117",238,133,130,0,3,"PODEMOS-IU",1
16,"16009",54,44,44,2,0,"PODEMOS-IU",4
16,"16097",139,117,116,0,1,"PODEMOS-IU",6
28,"28027",1215,836,826,8,10,"PODEMOS-IU",85
9,"9464",33,24,24,0,0,"PODEMOS-IU",0
26,"26108",309,240,231,2,9,"PODEMOS-IU",21
16,"16901",624,443,438,5,5,"PODEMOS-IU",29
26,"26080",451,347,344,0,3,"PODEMOS-IU",12
42,"42166",55,38,37,0,1,"PODEMOS-IU",3
50,"50193",664,487,475,4,12,"PODEMOS-IU",68
9,"9265",38,31,31,1,0,"PODEMOS-IU",3
19,"19291",1143,803,794,2,9,"PODEMOS-IU",78
50,"50016",44,31,31,0,0,"PODEMOS-IU",0
26,"26007",482,360,348,0,12,"PODEMOS-IU",65
40,"40207",802,593,590,11,3,"PODEMOS-IU",85
16,"16161",51,44,44,1,0,"PODEMOS-IU",4
10,"10158",344,247,246,7,1,"PODEMOS-IU",12
26,"26045",11,10,10,1,0,"PODEMOS-IU",0
24,"24089",101036,71905,71305,744,600,"PODEMOS-IU",6551
10,"10036",304,194,192,4,2,"PODEMOS-IU",23
5,"5072",92,74,72,1,2,"PODEMOS-IU",2
19,"19105",2550,1913,1889,10,24,"PODEMOS-IU",253
45,"45099",3700,2524,2501,9,23,"PODEMOS-IU",362
50,"50119",876,633,625,11,8,"PODEMOS-IU",25
34,"34092",257,189,189,1,0,"PODEMOS-IU",3
50,"50042",19,17,17,1,0,"PODEMOS-IU",1
10,"10160",240,179,177,2,2,"PODEMOS-IU",10
45,"45063",375,268,264,0,4,"PODEMOS-IU",19
37,"37087",911,675,665,5,10,"PODEMOS-IU",53
5,"5060",108,79,79,2,0,"PODEMOS-IU",5
47,"47195",426,314,310,2,4,"PODEMOS-IU",49
26,"26123",128,110,110,0,0,"PODEMOS-IU",7
45,"45161",15469,10281,10167,68,114,"PODEMOS-IU",1547
9,"9382",27,22,22,0,0,"PODEMOS-IU",0
13,"13018",774,625,622,0,3,"PODEMOS-IU",28
47,"47145",583,430,426,6,4,"PODEMOS-IU",55
9,"9163",573,436,432,7,4,"PODEMOS-IU",20
24,"24201",1029,683,676,9,7,"PODEMOS-IU",44
50,"50002",125,91,86,0,5,"PODEMOS-IU",0
37,"37259",39,28,28,1,0,"PODEMOS-IU",0
16,"16038",27,20,20,0,0,"PODEMOS-IU",0
10,"10080",353,243,238,1,5,"PODEMOS-IU",7
9,"9009",158,127,124,5,3,"PODEMOS-IU",8
10,"10148",33054,21731,21379,231,352,"PODEMOS-IU",2250
45,"45125",2256,1711,1689,16,22,"PODEMOS-IU",150
9,"9418",73,54,51,0,3,"PODEMOS-IU",2
9,"9039",54,38,37,0,1,"PODEMOS-IU",0
5,"5062",163,121,119,3,2,"PODEMOS-IU",3
40,"40180",276,215,210,2,5,"PODEMOS-IU",5
26,"26086",15,15,15,0,0,"PODEMOS-IU",0
6,"6085",3429,2439,2382,21,57,"PODEMOS-IU",331
45,"45065",264,211,206,1,5,"PODEMOS-IU",14
45,"45066",7815,5540,5447,25,93,"PODEMOS-IU",470
39,"39062",1864,1395,1376,3,19,"PODEMOS-IU",82
19,"19296",29,24,24,0,0,"PODEMOS-IU",3
47,"47051",324,261,258,6,3,"PODEMOS-IU",34
24,"24020",436,230,228,0,2,"PODEMOS-IU",9
42,"42125",71,55,55,0,0,"PODEMOS-IU",2
37,"37334",71,30,30,0,0,"PODEMOS-IU",0
16,"16166",240,173,171,0,2,"PODEMOS-IU",13
30,"30017",11428,8196,8113,44,83,"PODEMOS-IU",608
37,"37271",349,262,258,2,4,"PODEMOS-IU",3
5,"5075",96,76,76,0,0,"PODEMOS-IU",1
9,"9272",251,166,166,1,0,"PODEMOS-IU",5
19,"19073",16,15,15,1,0,"PODEMOS-IU",1
10,"10041",1022,720,706,2,14,"PODEMOS-IU",46
19,"19203",29,25,25,0,0,"PODEMOS-IU",3
9,"9044",55,46,44,1,2,"PODEMOS-IU",3
37,"37055",117,97,93,0,4,"PODEMOS-IU",2
6,"6118",155,114,112,0,2,"PODEMOS-IU",6
44,"44024",31,26,25,0,1,"PODEMOS-IU",0
37,"37335",384,282,279,1,3,"PODEMOS-IU",7
44,"44051",2579,1924,1901,10,23,"PODEMOS-IU",82
47,"47052",6781,5213,5156,50,57,"PODEMOS-IU",712
50,"50020",795,548,545,4,3,"PODEMOS-IU",44
34,"34130",195,154,153,5,1,"PODEMOS-IU",8
19,"19265",134,97,97,5,0,"PODEMOS-IU",9
19,"19003",36,30,30,0,0,"PODEMOS-IU",4
28,"28151",3274,2344,2310,16,34,"PODEMOS-IU",259
5,"5174",62,51,51,1,0,"PODEMOS-IU",2
5,"5076",468,376,367,1,9,"PODEMOS-IU",20
5,"5904",108,70,69,5,1,"PODEMOS-IU",10
45,"45105",376,277,268,5,9,"PODEMOS-IU",17
37,"37033",94,67,67,0,0,"PODEMOS-IU",3
9,"9149",36,29,29,0,0,"PODEMOS-IU",3
42,"42083",26,20,20,0,0,"PODEMOS-IU",3
37,"37106",248,161,160,4,1,"PODEMOS-IU",4
50,"50140",153,96,95,1,1,"PODEMOS-IU",10
9,"9373",399,254,251,5,3,"PODEMOS-IU",12
16,"16278",61,45,45,0,0,"PODEMOS-IU",1
19,"19195",36,26,25,2,1,"PODEMOS-IU",4
50,"50199",318,206,201,1,5,"PODEMOS-IU",12
16,"16017",336,276,270,1,6,"PODEMOS-IU",21
50,"50223",906,702,693,9,9,"PODEMOS-IU",42
16,"16053",388,306,303,3,3,"PODEMOS-IU",28
44,"44232",364,255,255,3,0,"PODEMOS-IU",2
9,"9391",347,247,246,2,1,"PODEMOS-IU",8
19,"19005",91,63,62,0,1,"PODEMOS-IU",14
42,"42041",31,23,23,0,0,"PODEMOS-IU",1
5,"5143",59,52,51,1,1,"PODEMOS-IU",1
37,"37244",129,97,97,1,0,"PODEMOS-IU",8
45,"45143",1192,877,865,9,12,"PODEMOS-IU",130
2,"2032",259,183,178,2,5,"PODEMOS-IU",32
40,"40152",732,575,565,10,10,"PODEMOS-IU",53
9,"9337",113,80,77,2,3,"PODEMOS-IU",15
26,"26017",364,274,269,2,5,"PODEMOS-IU",47
39,"39066",866,616,606,6,10,"PODEMOS-IU",58
24,"24097",200,138,137,1,1,"PODEMOS-IU",7
6,"6048",821,666,653,1,13,"PODEMOS-IU",40
19,"19112",53,35,34,0,1,"PODEMOS-IU",0
24,"24120",305,182,181,1,1,"PODEMOS-IU",16
39,"39029",629,476,469,1,7,"PODEMOS-IU",25
34,"34206",810,608,602,5,6,"PODEMOS-IU",28
26,"26131",34,33,33,0,0,"PODEMOS-IU",2
24,"24134",3287,2278,2226,18,52,"PODEMOS-IU",272
5,"5080",42,30,30,0,0,"PODEMOS-IU",1
45,"45072",653,469,462,1,7,"PODEMOS-IU",51
37,"37339",295,219,219,5,0,"PODEMOS-IU",7
19,"19210",18,16,16,0,0,"PODEMOS-IU",3
9,"9065",136,112,111,0,1,"PODEMOS-IU",8
49,"49052",183,120,117,2,3,"PODEMOS-IU",3
50,"50048",33,25,25,0,0,"PODEMOS-IU",3
24,"24015",2193,1532,1500,12,32,"PODEMOS-IU",65
9,"9101",72,52,52,0,0,"PODEMOS-IU",3
50,"50040",82,66,66,1,0,"PODEMOS-IU",1
2,"2001",687,513,505,1,8,"PODEMOS-IU",34
28,"28037",1570,1135,1123,4,12,"PODEMOS-IU",101
19,"19179",74,64,64,3,0,"PODEMOS-IU",1
5,"5147",144,101,99,0,2,"PODEMOS-IU",2
44,"44236",60,38,38,0,0,"PODEMOS-IU",5
37,"37151",142,109,109,1,0,"PODEMOS-IU",1
50,"50099",3036,2137,2113,17,24,"PODEMOS-IU",191
19,"19211",350,272,269,0,3,"PODEMOS-IU",26
35,"35001",4566,3148,3105,18,43,"PODEMOS-IU",416
6,"6005",1694,1167,1139,9,28,"PODEMOS-IU",79
37,"37121",536,413,403,4,10,"PODEMOS-IU",19
28,"28123",62178,49883,49515,397,368,"PODEMOS-IU",10558
24,"24212",983,693,684,10,9,"PODEMOS-IU",36
10,"10050",987,707,704,4,3,"PODEMOS-IU",23
40,"40156",272,194,190,4,4,"PODEMOS-IU",19
34,"34061",91,70,69,1,1,"PODEMOS-IU",1
49,"49093",280,226,223,5,3,"PODEMOS-IU",4
37,"37152",400,268,261,4,7,"PODEMOS-IU",10
44,"44056",446,327,325,1,2,"PODEMOS-IU",7
49,"49240",185,125,123,3,2,"PODEMOS-IU",3
19,"19150",116,89,89,0,0,"PODEMOS-IU",4
42,"42089",57,44,43,0,1,"PODEMOS-IU",1
16,"16174",166,130,129,2,1,"PODEMOS-IU",4
16,"16162",39,31,31,0,0,"PODEMOS-IU",2
34,"34139",160,117,115,2,2,"PODEMOS-IU",5
37,"37238",105,83,80,0,3,"PODEMOS-IU",9
45,"45001",1846,1213,1181,10,32,"PODEMOS-IU",85
5,"5170",47,34,34,1,0,"PODEMOS-IU",5
9,"9231",57,35,35,2,0,"PODEMOS-IU",0
40,"40091",109,87,85,0,2,"PODEMOS-IU",1
26,"26099",1220,956,931,7,25,"PODEMOS-IU",64
40,"40125",76,48,46,0,2,"PODEMOS-IU",2
47,"47060",224,171,168,1,3,"PODEMOS-IU",12
34,"34001",39,27,27,1,0,"PODEMOS-IU",7
34,"34050",187,136,136,1,0,"PODEMOS-IU",6
47,"47113",134,110,110,0,0,"PODEMOS-IU",4
28,"28050",4406,3202,3167,29,35,"PODEMOS-IU",322
5,"5084",66,44,44,0,0,"PODEMOS-IU",4
49,"49165",55,52,52,1,0,"PODEMOS-IU",3
19,"19152",540,377,374,2,3,"PODEMOS-IU",31
10,"10094",220,167,165,0,2,"PODEMOS-IU",18
38,"38042",3778,2410,2386,11,24,"PODEMOS-IU",302
47,"47114",3900,2549,2514,18,35,"PODEMOS-IU",185
9,"9232",139,100,97,1,3,"PODEMOS-IU",9
6,"6100",845,626,624,2,2,"PODEMOS-IU",28
16,"16274",97,76,75,1,1,"PODEMOS-IU",10
6,"6055",1976,1343,1313,11,30,"PODEMOS-IU",89
6,"6147",329,234,234,1,0,"PODEMOS-IU",41
26,"26139",58,43,43,2,0,"PODEMOS-IU",2
39,"39015",828,559,556,3,3,"PODEMOS-IU",20
40,"40158",15,11,11,0,0,"PODEMOS-IU",0
9,"9235",144,107,105,0,2,"PODEMOS-IU",10
34,"34215",161,126,125,6,1,"PODEMOS-IU",7
6,"6011",24731,16786,16538,167,248,"PODEMOS-IU",1418
28,"28159",589,455,447,4,8,"PODEMOS-IU",38
42,"42093",36,28,28,1,0,"PODEMOS-IU",0
37,"37375",678,539,523,8,16,"PODEMOS-IU",22
37,"37156",4261,2928,2869,23,59,"PODEMOS-IU",122
47,"47158",859,618,608,4,10,"PODEMOS-IU",59
10,"10015",630,429,424,1,5,"PODEMOS-IU",37
45,"45079",355,250,250,0,0,"PODEMOS-IU",29
45,"45041",3967,2723,2689,18,34,"PODEMOS-IU",314
45,"45005",225,170,167,3,3,"PODEMOS-IU",14
37,"37231",236,185,183,5,2,"PODEMOS-IU",11
30,"30042",2218,1645,1625,10,20,"PODEMOS-IU",118
28,"28053",6956,5475,5414,44,61,"PODEMOS-IU",658
6,"6149",10177,7582,7455,64,127,"PODEMOS-IU",585
6,"6012",3231,2306,2278,25,28,"PODEMOS-IU",165
19,"19013",111,89,89,0,0,"PODEMOS-IU",10
50,"50206",457,349,345,5,4,"PODEMOS-IU",31
9,"9168",270,211,210,5,1,"PODEMOS-IU",8
42,"42190",94,61,61,1,0,"PODEMOS-IU",6
44,"44034",124,90,90,0,0,"PODEMOS-IU",3
44,"44097",126,76,73,0,3,"PODEMOS-IU",0
2,"2007",1017,757,746,5,11,"PODEMOS-IU",79
47,"47033",205,151,150,2,1,"PODEMOS-IU",5
28,"28128",453,334,331,1,3,"PODEMOS-IU",33
50,"50256",70,43,43,0,0,"PODEMOS-IU",3
50,"50021",25,21,21,0,0,"PODEMOS-IU",0
10,"10140",1109,778,769,7,9,"PODEMOS-IU",31
10,"10044",1405,968,955,11,13,"PODEMOS-IU",63
40,"40031",546,410,406,3,4,"PODEMOS-IU",61
19,"19186",76,60,60,0,0,"PODEMOS-IU",3
50,"50013",199,158,158,0,0,"PODEMOS-IU",12
9,"9115",90,65,63,3,2,"PODEMOS-IU",10
26,"26064",2335,1617,1584,28,33,"PODEMOS-IU",181
47,"47191",111,81,81,0,0,"PODEMOS-IU",12
34,"34070",131,98,96,0,2,"PODEMOS-IU",5
28,"28162",2784,2143,2131,20,12,"PODEMOS-IU",160
49,"49134",158,100,99,1,1,"PODEMOS-IU",10
13,"13041",236,155,155,3,0,"PODEMOS-IU",20
19,"19016",57,40,40,0,0,"PODEMOS-IU",1
19,"19308",57,49,49,0,0,"PODEMOS-IU",3
50,"50055",3635,2298,2244,36,54,"PODEMOS-IU",228
2,"2043",1165,872,858,6,14,"PODEMOS-IU",29
42,"42016",20,13,13,0,0,"PODEMOS-IU",1
5,"5089",455,342,324,0,18,"PODEMOS-IU",19
40,"40162",380,273,265,1,8,"PODEMOS-IU",17
44,"44008",1556,1109,1100,7,9,"PODEMOS-IU",54
16,"16067",123,91,90,1,1,"PODEMOS-IU",1
9,"9242",66,53,52,3,1,"PODEMOS-IU",0
37,"37348",100,76,76,0,0,"PODEMOS-IU",2
28,"28163",429,332,326,0,6,"PODEMOS-IU",56
40,"40099",54,44,42,0,2,"PODEMOS-IU",3
50,"50282",55,38,38,1,0,"PODEMOS-IU",0
10,"10088",198,112,112,1,0,"PODEMOS-IU",3
24,"24133",357,256,256,1,0,"PODEMOS-IU",18
26,"26145",239,194,187,3,7,"PODEMOS-IU",10
19,"19017",56,47,47,0,0,"PODEMOS-IU",5
40,"40163",42,35,35,1,0,"PODEMOS-IU",2
6,"6109",3821,2943,2813,16,130,"PODEMOS-IU",217
40,"40033",70,55,52,1,3,"PODEMOS-IU",11
30,"30005",30268,20979,20778,148,201,"PODEMOS-IU",1515
28,"28057",1556,1155,1141,7,14,"PODEMOS-IU",144
16,"16280",163,122,119,2,3,"PODEMOS-IU",6
44,"44217",32,25,25,0,0,"PODEMOS-IU",1
24,"24038",3024,2121,2071,25,50,"PODEMOS-IU",294
49,"49126",260,153,150,1,3,"PODEMOS-IU",8
37,"37370",316,238,237,2,1,"PODEMOS-IU",13
37,"37214",120,70,68,2,2,"PODEMOS-IU",4
5,"5188",39,33,33,0,0,"PODEMOS-IU",0
16,"16218",184,134,133,1,1,"PODEMOS-IU",4
37,"37256",191,123,123,1,0,"PODEMOS-IU",7
37,"37060",283,205,202,1,3,"PODEMOS-IU",6
38,"38048",3952,2543,2519,22,24,"PODEMOS-IU",341
42,"42057",145,70,70,0,0,"PODEMOS-IU",5
10,"10144",915,618,614,0,4,"PODEMOS-IU",25
9,"9414",180,137,135,1,2,"PODEMOS-IU",9
45,"45196",1382,1029,1005,7,24,"PODEMOS-IU",59
49,"49066",437,276,272,2,4,"PODEMOS-IU",14
37,"37257",51,36,36,1,0,"PODEMOS-IU",2
50,"50186",37,26,26,1,0,"PODEMOS-IU",5
19,"19020",46,31,31,0,0,"PODEMOS-IU",1
6,"6021",898,628,617,16,11,"PODEMOS-IU",19
2,"2013",125,90,88,0,2,"PODEMOS-IU",10
16,"16111",168,114,111,2,3,"PODEMOS-IU",6
10,"10064",1400,998,972,3,26,"PODEMOS-IU",38
26,"26070",152,125,122,1,3,"PODEMOS-IU",4
49,"49105",135,94,94,2,0,"PODEMOS-IU",1
44,"44011",47,34,34,0,0,"PODEMOS-IU",1
9,"9416",52,30,30,0,0,"PODEMOS-IU",9
26,"26149",42,34,34,0,0,"PODEMOS-IU",1
44,"44151",180,134,134,1,0,"PODEMOS-IU",15
44,"44031",83,50,50,0,0,"PODEMOS-IU",0
45,"45038",3528,2556,2521,26,35,"PODEMOS-IU",352
19,"19124",378,230,229,2,1,"PODEMOS-IU",31
9,"9249",47,35,35,3,0,"PODEMOS-IU",1
24,"24152",433,269,267,4,2,"PODEMOS-IU",23
16,"16904",453,348,345,11,3,"PODEMOS-IU",24
44,"44131",26,22,22,0,0,"PODEMOS-IU",0
16,"16152",32,26,26,3,0,"PODEMOS-IU",2
5,"5224",102,85,84,2,1,"PODEMOS-IU",3
37,"37051",79,58,58,0,0,"PODEMOS-IU",0
45,"45187",3967,3133,3074,16,59,"PODEMOS-IU",194
47,"47029",50,37,35,1,2,"PODEMOS-IU",5
40,"40070",143,94,92,1,2,"PODEMOS-IU",12
19,"19252",56,44,44,0,0,"PODEMOS-IU",4
34,"34035",97,76,75,3,1,"PODEMOS-IU",2
24,"24042",60,47,47,2,0,"PODEMOS-IU",1
37,"37196",70,50,50,0,0,"PODEMOS-IU",0
26,"26071",8644,5668,5591,53,77,"PODEMOS-IU",722
28,"28158",694,501,495,2,6,"PODEMOS-IU",54
9,"9088",63,31,30,0,1,"PODEMOS-IU",4
26,"26035",16,12,11,0,1,"PODEMOS-IU",1
37,"37354",5479,3969,3905,37,64,"PODEMOS-IU",361
6,"6025",5083,3543,3469,28,74,"PODEMOS-IU",352
24,"24154",952,625,618,5,7,"PODEMOS-IU",64
19,"19223",99,66,65,1,1,"PODEMOS-IU",4
2,"2017",760,498,493,1,5,"PODEMOS-IU",19
47,"47198",64,43,43,0,0,"PODEMOS-IU",5
16,"16195",458,343,338,0,5,"PODEMOS-IU",12
24,"24189",5872,3915,3873,42,42,"PODEMOS-IU",376
9,"9366",76,55,55,2,0,"PODEMOS-IU",9
42,"42110",54,43,43,0,0,"PODEMOS-IU",4
47,"47137",29,25,25,0,0,"PODEMOS-IU",2
40,"40072",224,175,171,1,4,"PODEMOS-IU",18
42,"42201",23,21,21,0,0,"PODEMOS-IU",2
47,"47231",4439,3359,3323,36,36,"PODEMOS-IU",406
19,"19023",119,87,85,0,2,"PODEMOS-IU",7
37,"37067",3278,2568,2529,30,39,"PODEMOS-IU",245
37,"37355",159,121,120,1,1,"PODEMOS-IU",10
9,"9091",686,479,467,4,12,"PODEMOS-IU",23
24,"24069",37,26,25,0,1,"PODEMOS-IU",0
47,"47094",120,100,100,0,0,"PODEMOS-IU",5
40,"40073",387,327,323,1,4,"PODEMOS-IU",5
50,"50189",678,494,487,6,7,"PODEMOS-IU",68
6,"6028",4098,3457,3350,22,107,"PODEMOS-IU",161
50,"50288",3440,2513,2486,26,27,"PODEMOS-IU",231
5,"5064",101,77,77,0,0,"PODEMOS-IU",0
39,"39082",1611,1108,1102,8,6,"PODEMOS-IU",49
45,"45092",223,193,190,1,3,"PODEMOS-IU",2
24,"24082",847,615,608,16,7,"PODEMOS-IU",73
37,"37104",24,16,16,0,0,"PODEMOS-IU",0
49,"49034",408,282,281,2,1,"PODEMOS-IU",15
49,"49180",135,82,81,5,1,"PODEMOS-IU",9
49,"49258",111,93,93,2,0,"PODEMOS-IU",9
5,"5131",96,64,64,1,0,"PODEMOS-IU",0
44,"44016",424,299,297,1,2,"PODEMOS-IU",11
26,"26039",40,31,31,0,0,"PODEMOS-IU",2
19,"19024",8561,6015,5942,44,73,"PODEMOS-IU",836
24,"24083",997,659,647,9,12,"PODEMOS-IU",53
34,"34039",58,48,47,0,1,"PODEMOS-IU",1
34,"34041",82,64,64,3,0,"PODEMOS-IU",2
37,"37023",1624,1233,1211,15,22,"PODEMOS-IU",87
50,"50079",226,162,160,1,2,"PODEMOS-IU",5
37,"37199",128,92,92,2,0,"PODEMOS-IU",2
10,"10071",126,78,71,0,7,"PODEMOS-IU",4
45,"45094",365,274,271,3,3,"PODEMOS-IU",21
50,"50289",53,42,42,1,0,"PODEMOS-IU",1
39,"39055",1065,747,736,4,11,"PODEMOS-IU",33
6,"6031",462,285,280,2,5,"PODEMOS-IU",7
47,"47203",54,40,40,0,0,"PODEMOS-IU",1
26,"26077",16,16,16,0,0,"PODEMOS-IU",1
16,"16248",862,710,700,6,10,"PODEMOS-IU",46
42,"42163",50,27,27,1,0,"PODEMOS-IU",4
49,"49077",157,80,80,0,0,"PODEMOS-IU",0
5,"5100",260,193,192,3,1,"PODEMOS-IU",22
19,"19323",36,26,26,0,0,"PODEMOS-IU",1
38,"38053",3768,2275,2244,16,31,"PODEMOS-IU",217
37,"37170",1361,909,884,9,25,"PODEMOS-IU",46
9,"9259",230,178,176,2,2,"PODEMOS-IU",11
50,"50116",169,124,123,0,1,"PODEMOS-IU",6
50,"50241",582,414,406,2,8,"PODEMOS-IU",21
13,"13013",7056,5041,4945,52,96,"PODEMOS-IU",284
19,"19132",86,65,63,0,2,"PODEMOS-IU",2
5,"5036",118,91,90,0,1,"PODEMOS-IU",1
26,"26106",79,67,67,0,0,"PODEMOS-IU",5
52,"52001",54293,31015,30776,185,239,"PODEMOS-IU",792
9,"9317",20,18,18,0,0,"PODEMOS-IU",8
42,"42117",129,98,95,1,3,"PODEMOS-IU",11
44,"44257",149,92,91,0,1,"PODEMOS-IU",2
28,"28006",80903,60936,60508,482,428,"PODEMOS-IU",6232
28,"28036",2699,1977,1957,20,20,"PODEMOS-IU",344
50,"50217",426,333,333,1,0,"PODEMOS-IU",6
50,"50267",565,380,375,4,5,"PODEMOS-IU",30
26,"26160",731,539,533,4,6,"PODEMOS-IU",33
10,"10035",1798,1201,1171,8,30,"PODEMOS-IU",171
10,"10034",337,244,240,0,4,"PODEMOS-IU",13
50,"50090",134,96,96,0,0,"PODEMOS-IU",1
13,"13045",622,459,451,0,8,"PODEMOS-IU",16
37,"37297",394,298,297,0,1,"PODEMOS-IU",6
34,"34223",203,147,143,1,4,"PODEMOS-IU",4
49,"49263",44,32,32,1,0,"PODEMOS-IU",0
45,"45098",2090,1488,1469,7,19,"PODEMOS-IU",87
49,"49115",167,121,121,2,0,"PODEMOS-IU",4
37,"37007",391,289,281,7,8,"PODEMOS-IU",8
16,"16123",66,42,41,0,1,"PODEMOS-IU",7
37,"37266",68,44,44,0,0,"PODEMOS-IU",3
5,"5103",63,44,44,1,0,"PODEMOS-IU",2
13,"13061",5616,3679,3634,51,45,"PODEMOS-IU",261
50,"50117",123,93,93,4,0,"PODEMOS-IU",9
9,"9214",632,409,407,2,2,"PODEMOS-IU",60
2,"2057",1947,1358,1333,15,25,"PODEMOS-IU",174
16,"16124",1807,1367,1347,14,20,"PODEMOS-IU",154
49,"49186",230,172,170,0,2,"PODEMOS-IU",7
49,"49228",53,36,36,0,0,"PODEMOS-IU",2
37,"37361",84,55,54,1,1,"PODEMOS-IU",1
5,"5169",218,171,171,1,0,"PODEMOS-IU",6
6,"6128",4457,2996,2934,28,62,"PODEMOS-IU",332
9,"9431",116,85,84,2,1,"PODEMOS-IU",5
28,"28146",1806,1232,1218,3,14,"PODEMOS-IU",112
5,"5105",330,247,242,2,5,"PODEMOS-IU",24
42,"42121",54,39,39,0,0,"PODEMOS-IU",0
10,"10079",848,641,632,2,9,"PODEMOS-IU",54
5,"5200",41,26,26,0,0,"PODEMOS-IU",0
10,"10065",199,135,135,0,0,"PODEMOS-IU",18
49,"49008",423,263,259,1,4,"PODEMOS-IU",6
49,"49230",84,69,69,0,0,"PODEMOS-IU",0
16,"16205",106,73,73,1,0,"PODEMOS-IU",9
40,"40079",229,160,159,2,1,"PODEMOS-IU",18
24,"24163",4076,2979,2954,35,25,"PODEMOS-IU",278
10,"10201",178,142,141,2,1,"PODEMOS-IU",4
50,"50195",53,42,38,0,4,"PODEMOS-IU",6
26,"26046",1552,1056,1027,11,29,"PODEMOS-IU",89
45,"45174",300,218,217,2,1,"PODEMOS-IU",3
5,"5191",121,99,99,0,0,"PODEMOS-IU",14
16,"16163",64,51,51,0,0,"PODEMOS-IU",1
24,"24091",575,368,362,5,6,"PODEMOS-IU",49
16,"16126",720,552,545,3,7,"PODEMOS-IU",51
9,"9907",1526,1140,1119,18,21,"PODEMOS-IU",174
44,"44201",477,399,395,1,4,"PODEMOS-IU",32
49,"49118",193,151,151,2,0,"PODEMOS-IU",3
34,"34080",5231,3207,3161,35,46,"PODEMOS-IU",256
47,"47082",805,641,630,3,11,"PODEMOS-IU",26
47,"47209",32,23,23,0,0,"PODEMOS-IU",7
5,"5235",141,97,97,2,0,"PODEMOS-IU",2
50,"50019",63,46,46,0,0,"PODEMOS-IU",2
28,"28010",10649,8167,8098,76,69,"PODEMOS-IU",1033
30,"30041",14040,8999,8876,94,123,"PODEMOS-IU",882
9,"9109",1072,575,558,0,17,"PODEMOS-IU",188
19,"19139",26,19,19,2,0,"PODEMOS-IU",1
19,"19330",69,62,62,0,0,"PODEMOS-IU",2
28,"28083",9836,7278,7206,64,72,"PODEMOS-IU",899
16,"16258",172,124,119,0,5,"PODEMOS-IU",2
45,"45139",144,111,111,0,0,"PODEMOS-IU",2
49,"49232",85,64,64,0,0,"PODEMOS-IU",2
16,"16128",50,38,38,0,0,"PODEMOS-IU",0
16,"16050",218,172,169,2,3,"PODEMOS-IU",9
37,"37079",77,59,59,1,0,"PODEMOS-IU",3
49,"49190",50,42,42,3,0,"PODEMOS-IU",2
42,"42081",126,88,88,0,0,"PODEMOS-IU",2
34,"34098",790,562,558,3,4,"PODEMOS-IU",55
50,"50044",224,159,159,2,0,"PODEMOS-IU",8
6,"6901",2125,1549,1520,28,29,"PODEMOS-IU",135
44,"44164",19,16,16,1,0,"PODEMOS-IU",0
40,"40118",46,32,32,1,0,"PODEMOS-IU",3
49,"49121",372,239,233,1,6,"PODEMOS-IU",29
10,"10124",867,622,612,1,10,"PODEMOS-IU",41
47,"47084",1077,794,784,11,10,"PODEMOS-IU",44
19,"19039",56,48,48,2,0,"PODEMOS-IU",1
2,"2063",1358,987,973,3,14,"PODEMOS-IU",34
28,"28150",3191,2423,2401,13,22,"PODEMOS-IU",325
49,"49012",70,34,34,0,0,"PODEMOS-IU",1
37,"37366",40,34,33,2,1,"PODEMOS-IU",2
45,"45141",848,626,615,0,11,"PODEMOS-IU",45
34,"34246",68,52,52,0,0,"PODEMOS-IU",1
39,"39007",386,265,264,0,1,"PODEMOS-IU",17
28,"28181",20801,16353,16243,97,110,"PODEMOS-IU",1235
9,"9389",63,45,45,0,0,"PODEMOS-IU",5
9,"9223",42,36,36,0,0,"PODEMOS-IU",5
47,"47180",57,41,41,1,0,"PODEMOS-IU",2
19,"19298",53,43,41,0,2,"PODEMOS-IU",4
5,"5905",214,148,142,1,6,"PODEMOS-IU",6
24,"24131",684,416,415,2,1,"PODEMOS-IU",21
45,"45204",630,453,449,1,4,"PODEMOS-IU",27
28,"28109",1651,1131,1116,8,15,"PODEMOS-IU",132
9,"9224",147,113,112,0,1,"PODEMOS-IU",3
44,"44205",619,420,415,5,5,"PODEMOS-IU",15
26,"26129",939,657,644,2,13,"PODEMOS-IU",38
28,"28075",6020,4521,4469,37,52,"PODEMOS-IU",646
9,"9440",80,61,61,0,0,"PODEMOS-IU",4
28,"28085",4194,3126,3091,24,35,"PODEMOS-IU",371
28,"28014",34522,25016,24748,229,268,"PODEMOS-IU",2954
37,"37274",118296,84144,83280,880,864,"PODEMOS-IU",6729
39,"39093",297,216,214,1,2,"PODEMOS-IU",13
44,"44177",101,68,68,1,0,"PODEMOS-IU",3
26,"26170",423,303,301,2,2,"PODEMOS-IU",19
19,"19299",100,72,71,1,1,"PODEMOS-IU",3
5,"5176",221,163,159,0,4,"PODEMOS-IU",6
37,"37014",1140,747,737,7,10,"PODEMOS-IU",35
49,"49236",71,54,54,0,0,"PODEMOS-IU",3
47,"47182",1328,940,934,8,6,"PODEMOS-IU",81
24,"24170",1806,1232,1220,9,12,"PODEMOS-IU",191
5,"5208",39,32,32,0,0,"PODEMOS-IU",0
28,"28087",3301,2539,2519,20,20,"PODEMOS-IU",229
49,"49124",238,170,164,2,6,"PODEMOS-IU",16
26,"26171",155,109,107,2,2,"PODEMOS-IU",5
9,"9901",334,228,226,4,2,"PODEMOS-IU",18
9,"9277",103,84,82,1,2,"PODEMOS-IU",17
28,"28153",816,547,544,3,3,"PODEMOS-IU",137
42,"42085",179,107,106,2,1,"PODEMOS-IU",5
40,"40122",524,398,392,2,6,"PODEMOS-IU",57
2,"2066",222,165,163,1,2,"PODEMOS-IU",23
9,"9119",42,24,24,0,0,"PODEMOS-IU",3
47,"47087",362,272,268,1,4,"PODEMOS-IU",25
44,"44267",70,47,46,0,1,"PODEMOS-IU",2
6,"6049",956,625,604,8,21,"PODEMOS-IU",63
44,"44178",52,34,34,0,0,"PODEMOS-IU",0
44,"44120",219,147,145,3,2,"PODEMOS-IU",6
44,"44179",324,201,201,2,0,"PODEMOS-IU",21
44,"44112",400,265,265,2,0,"PODEMOS-IU",7
26,"26056",404,312,301,2,11,"PODEMOS-IU",26
5,"5178",340,261,255,3,6,"PODEMOS-IU",8
40,"40024",823,582,575,8,7,"PODEMOS-IU",37
38,"38040",5482,3094,3060,14,34,"PODEMOS-IU",227
26,"26019",346,260,251,2,9,"PODEMOS-IU",30
37,"37182",75,47,47,1,0,"PODEMOS-IU",4
34,"34155",122,95,95,0,0,"PODEMOS-IU",2
9,"9445",41,28,27,1,1,"PODEMOS-IU",2
47,"47089",133,111,111,2,0,"PODEMOS-IU",6
9,"9020",233,170,166,3,4,"PODEMOS-IU",7
34,"34106",110,92,92,3,0,"PODEMOS-IU",5
42,"42007",108,80,80,1,0,"PODEMOS-IU",0
40,"40186",35,29,29,0,0,"PODEMOS-IU",1
49,"49239",599,393,384,6,9,"PODEMOS-IU",10
47,"47027",2799,2059,2025,12,34,"PODEMOS-IU",243
42,"42088",62,45,44,0,1,"PODEMOS-IU",1
49,"49018",277,197,190,2,7,"PODEMOS-IU",2
9,"9446",10,7,7,0,0,"PODEMOS-IU",0
37,"37371",252,156,155,0,1,"PODEMOS-IU",0
45,"45111",56,47,47,1,0,"PODEMOS-IU",1
16,"16271",612,482,481,3,1,"PODEMOS-IU",52
44,"44029",585,454,451,2,3,"PODEMOS-IU",30
50,"50050",87,62,62,1,0,"PODEMOS-IU",3
37,"37372",133,99,98,0,1,"PODEMOS-IU",3
42,"42139",21,16,16,2,0,"PODEMOS-IU",1
24,"24018",172,129,128,0,1,"PODEMOS-IU",15
26,"26175",47,40,38,1,2,"PODEMOS-IU",1
39,"39041",1753,1285,1269,7,16,"PODEMOS-IU",117
39,"39070",126,91,89,0,2,"PODEMOS-IU",2
42,"42009",77,58,58,0,0,"PODEMOS-IU",3
49,"49094",210,111,111,0,0,"PODEMOS-IU",7
39,"39098",1381,1088,1080,5,8,"PODEMOS-IU",56
9,"9400",307,225,224,4,1,"PODEMOS-IU",27
2,"2070",373,306,301,6,5,"PODEMOS-IU",16
5,"5213",94,72,70,0,2,"PODEMOS-IU",2
5,"5138",283,218,217,1,1,"PODEMOS-IU",6
49,"49129",810,541,527,4,14,"PODEMOS-IU",50
45,"45039",201,157,157,0,0,"PODEMOS-IU",3
19,"19182",37,32,32,0,0,"PODEMOS-IU",12
19,"19116",12,10,10,0,0,"PODEMOS-IU",1
10,"10175",1351,918,901,8,17,"PODEMOS-IU",76
34,"34020",49,37,37,1,0,"PODEMOS-IU",1
40,"40190",43,37,35,0,2,"PODEMOS-IU",4
44,"44004",379,275,275,2,0,"PODEMOS-IU",39
49,"49130",155,116,112,1,4,"PODEMOS-IU",8
9,"9449",91,78,76,1,2,"PODEMOS-IU",3
39,"39014",882,538,536,0,2,"PODEMOS-IU",58
5,"5151",83,60,60,0,0,"PODEMOS-IU",3
37,"37089",60,44,43,0,1,"PODEMOS-IU",2
37,"37374",1138,889,872,2,17,"PODEMOS-IU",20
44,"44124",71,57,57,0,0,"PODEMOS-IU",3
26,"26060",78,51,50,2,1,"PODEMOS-IU",4
38,"38019",13884,7888,7809,49,79,"PODEMOS-IU",621
34,"34160",133,107,106,0,1,"PODEMOS-IU",14
26,"26061",1542,1104,1079,12,25,"PODEMOS-IU",121
24,"24103",274,134,134,0,0,"PODEMOS-IU",7
16,"16027",691,500,495,1,5,"PODEMOS-IU",54
50,"50155",95,65,65,0,0,"PODEMOS-IU",0
49,"49243",107,74,74,0,0,"PODEMOS-IU",10
24,"24216",666,453,445,4,8,"PODEMOS-IU",25
9,"9073",964,713,706,3,7,"PODEMOS-IU",99
45,"45115",2602,2013,1969,12,44,"PODEMOS-IU",102
2,"2073",4825,3433,3394,35,39,"PODEMOS-IU",391
37,"37313",535,395,394,1,1,"PODEMOS-IU",8
16,"16167",288,225,217,0,8,"PODEMOS-IU",10
34,"34161",22,12,12,0,0,"PODEMOS-IU",0
26,"26141",98,70,70,0,0,"PODEMOS-IU",2
9,"9294",99,81,78,0,3,"PODEMOS-IU",9
28,"28052",3961,2700,2659,14,41,"PODEMOS-IU",263
49,"49244",46,23,23,0,0,"PODEMOS-IU",0
44,"44212",41,29,29,0,0,"PODEMOS-IU",1
26,"26180",221,164,162,4,2,"PODEMOS-IU",11
50,"50054",55,37,37,2,0,"PODEMOS-IU",2
6,"6059",1724,1084,1067,6,17,"PODEMOS-IU",70
26,"26102",6076,4276,4205,52,71,"PODEMOS-IU",428
40,"40061",63,47,44,0,3,"PODEMOS-IU",7
5,"5019",44865,32917,32586,282,331,"PODEMOS-IU",2155
5,"5185",96,63,61,1,2,"PODEMOS-IU",3
9,"9131",485,390,388,7,2,"PODEMOS-IU",56
37,"37091",161,104,104,0,0,"PODEMOS-IU",1
45,"45081",19268,13690,13516,104,174,"PODEMOS-IU",1521
47,"47034",75,58,58,2,0,"PODEMOS-IU",1
16,"16030",24,18,18,1,0,"PODEMOS-IU",4
45,"45154",1491,1033,1024,11,9,"PODEMOS-IU",98
47,"47095",41,29,28,0,1,"PODEMOS-IU",0
34,"34010",550,407,399,7,8,"PODEMOS-IU",22
16,"16234",23,17,17,0,0,"PODEMOS-IU",1
50,"50005",228,185,184,2,1,"PODEMOS-IU",12
47,"47160",395,296,294,3,2,"PODEMOS-IU",21
37,"37378",92,54,54,0,0,"PODEMOS-IU",1
40,"40095",453,341,329,2,12,"PODEMOS-IU",6
26,"26028",135,111,110,3,1,"PODEMOS-IU",13
37,"37092",1933,1342,1327,13,15,"PODEMOS-IU",108
40,"40193",219,156,155,3,1,"PODEMOS-IU",8
2,"2075",1700,1357,1347,6,10,"PODEMOS-IU",82
34,"34027",1049,677,665,15,12,"PODEMOS-IU",57
10,"10903",806,555,545,8,10,"PODEMOS-IU",45
38,"38021",1609,900,876,2,24,"PODEMOS-IU",70
49,"49247",412,255,252,2,3,"PODEMOS-IU",10
34,"34120",63790,46117,45597,464,520,"PODEMOS-IU",3921
19,"19089",23,17,17,0,0,"PODEMOS-IU",1
37,"37284",317,229,222,2,7,"PODEMOS-IU",18
45,"45009",455,277,274,2,3,"PODEMOS-IU",18
37,"37190",189,141,139,1,2,"PODEMOS-IU",1
16,"16108",44,35,34,1,1,"PODEMOS-IU",5
37,"37379",169,133,132,0,1,"PODEMOS-IU",4
42,"42017",131,99,96,1,3,"PODEMOS-IU",5
50,"50023",199,145,143,2,2,"PODEMOS-IU",1
16,"16237",98,82,82,1,0,"PODEMOS-IU",8
5,"5123",106,78,78,0,0,"PODEMOS-IU",4
28,"28026",6767,5058,5024,27,34,"PODEMOS-IU",610
42,"42018",127,94,94,1,0,"PODEMOS-IU",3
9,"9134",217,142,138,1,4,"PODEMOS-IU",35
13,"13089",1609,1248,1228,10,20,"PODEMOS-IU",44
10,"10102",496,378,377,1,1,"PODEMOS-IU",14
19,"19188",36,31,31,0,0,"PODEMOS-IU",0
16,"16070",29,27,27,0,0,"PODEMOS-IU",2
50,"50184",87,70,70,0,0,"PODEMOS-IU",1
24,"24149",149,123,123,0,0,"PODEMOS-IU",5
42,"42103",543,383,374,2,9,"PODEMOS-IU",14
19,"19269",86,61,61,0,0,"PODEMOS-IU",17
37,"37098",290,197,197,1,0,"PODEMOS-IU",17
49,"49028",108,90,89,1,1,"PODEMOS-IU",1
10,"10103",422,290,286,1,4,"PODEMOS-IU",21
40,"40196",30,24,24,0,0,"PODEMOS-IU",0
16,"16239",118,88,87,0,1,"PODEMOS-IU",14
50,"50058",63,45,43,0,2,"PODEMOS-IU",1
50,"50134",120,85,82,4,3,"PODEMOS-IU",2
10,"10062",389,303,299,2,4,"PODEMOS-IU",42
10,"10185",558,376,374,2,2,"PODEMOS-IU",35
9,"9136",169,129,125,2,4,"PODEMOS-IU",16
44,"44129",35,29,29,1,0,"PODEMOS-IU",2
49,"49138",205,141,140,2,1,"PODEMOS-IU",2
9,"9137",187,129,127,0,2,"PODEMOS-IU",10
9,"9466",113,84,83,1,1,"PODEMOS-IU",3
6,"6066",1708,1180,1171,6,9,"PODEMOS-IU",51
5,"5125",56,47,46,0,1,"PODEMOS-IU",0
19,"19250",16,12,12,0,0,"PODEMOS-IU",0
13,"13001",1188,865,858,4,7,"PODEMOS-IU",40
10,"10186",951,756,735,6,21,"PODEMOS-IU",39
9,"9360",26,19,19,0,0,"PODEMOS-IU",4
50,"50211",236,174,173,0,1,"PODEMOS-IU",8
37,"37194",229,161,160,0,1,"PODEMOS-IU",15
10,"10105",2442,1541,1515,11,26,"PODEMOS-IU",102
37,"37164",232,176,175,3,1,"PODEMOS-IU",27
6,"6022",2635,1920,1862,15,58,"PODEMOS-IU",144
28,"28091",5491,3709,3650,20,59,"PODEMOS-IU",480
37,"37382",162,127,124,0,3,"PODEMOS-IU",1
5,"5026",183,149,147,1,2,"PODEMOS-IU",22
47,"47100",118,93,87,2,6,"PODEMOS-IU",3
24,"24078",324,228,225,0,3,"PODEMOS-IU",7
34,"34125",105,80,80,2,0,"PODEMOS-IU",5
40,"40103",139,113,113,0,0,"PODEMOS-IU",10
28,"28029",576,443,443,4,0,"PODEMOS-IU",76
19,"19251",39,30,30,0,0,"PODEMOS-IU",1
50,"50059",757,556,551,5,5,"PODEMOS-IU",35
6,"6054",5452,3773,3657,34,116,"PODEMOS-IU",325
19,"19192",1762,1251,1240,5,11,"PODEMOS-IU",43
50,"50237",100,75,75,2,0,"PODEMOS-IU",9
39,"39079",8850,6247,6175,28,72,"PODEMOS-IU",423
47,"47166",251,183,181,2,2,"PODEMOS-IU",6
44,"44106",151,107,106,0,1,"PODEMOS-IU",13
28,"28135",998,712,703,2,9,"PODEMOS-IU",106
28,"28168",1347,933,918,6,15,"PODEMOS-IU",103
5,"5095",236,181,177,1,4,"PODEMOS-IU",11
37,"37063",58,47,47,0,0,"PODEMOS-IU",0
49,"49031",148,107,105,2,2,"PODEMOS-IU",4
47,"47010",14718,11521,11392,137,129,"PODEMOS-IU",1309
10,"10149",432,284,280,2,4,"PODEMOS-IU",13
30,"30009",12728,9487,9365,46,122,"PODEMOS-IU",771
13,"13005",23256,16610,16367,132,243,"PODEMOS-IU",1960
9,"9090",49,41,39,2,2,"PODEMOS-IU",3
39,"39052",19005,13859,13748,83,111,"PODEMOS-IU",1177
30,"30033",10377,7330,7215,59,115,"PODEMOS-IU",528
24,"24228",619,370,364,2,6,"PODEMOS-IU",31
19,"19224",106,83,83,1,0,"PODEMOS-IU",1
28,"28031",2129,1501,1486,8,15,"PODEMOS-IU",121
42,"42024",84,64,62,1,2,"PODEMOS-IU",2
45,"45016",4486,3288,3251,19,37,"PODEMOS-IU",343
9,"9476",60,46,46,0,0,"PODEMOS-IU",3
2,"2083",209,181,181,0,0,"PODEMOS-IU",2
37,"37291",269,186,185,1,1,"PODEMOS-IU",11
50,"50061",190,157,155,2,2,"PODEMOS-IU",12
50,"50138",45,37,37,3,0,"PODEMOS-IU",2
5,"5260",95,73,73,0,0,"PODEMOS-IU",1
13,"13083",2382,1623,1587,12,36,"PODEMOS-IU",110
50,"50213",92,70,70,2,0,"PODEMOS-IU",0
44,"44194",103,67,64,0,3,"PODEMOS-IU",8
16,"16004",228,175,174,0,1,"PODEMOS-IU",6
19,"19165",45,39,39,0,0,"PODEMOS-IU",8
28,"28002",3250,2261,2243,14,18,"PODEMOS-IU",201
28,"28108",3736,2681,2652,21,29,"PODEMOS-IU",382
45,"45128",2569,1676,1652,6,24,"PODEMOS-IU",141
28,"28033",4177,2972,2936,20,36,"PODEMOS-IU",281
40,"40902",113,78,76,1,2,"PODEMOS-IU",2
40,"40140",76,54,54,0,0,"PODEMOS-IU",1
28,"28138",60,43,42,0,1,"PODEMOS-IU",7
9,"9423",27,24,24,1,0,"PODEMOS-IU",1
26,"26115",23,22,21,3,1,"PODEMOS-IU",0
13,"13009",1383,1081,1070,3,11,"PODEMOS-IU",27
45,"45057",224,177,173,0,4,"PODEMOS-IU",7
40,"40009",41,35,34,0,1,"PODEMOS-IU",4
16,"16247",63,51,50,1,1,"PODEMOS-IU",2
37,"37137",98,60,59,2,1,"PODEMOS-IU",1
40,"40074",246,193,189,2,4,"PODEMOS-IU",6
50,"50037",125,85,80,0,5,"PODEMOS-IU",4
49,"49133",287,206,203,1,3,"PODEMOS-IU",7
44,"44136",48,43,43,1,0,"PODEMOS-IU",1
19,"19287",134,100,98,2,2,"PODEMOS-IU",5
28,"28034",368,258,255,0,3,"PODEMOS-IU",28
9,"9315",384,245,242,3,3,"PODEMOS-IU",27
50,"50115",3279,2170,2131,27,39,"PODEMOS-IU",149
26,"26157",283,222,217,0,5,"PODEMOS-IU",16
39,"39027",3045,2231,2199,23,32,"PODEMOS-IU",146
37,"37233",53,39,39,1,0,"PODEMOS-IU",3
45,"45020",1240,905,900,5,5,"PODEMOS-IU",42
47,"47141",112,90,89,0,1,"PODEMOS-IU",0
40,"40903",75,61,59,0,2,"PODEMOS-IU",2
50,"50038",1404,1024,1007,15,17,"PODEMOS-IU",99
19,"19061",56,42,41,0,1,"PODEMOS-IU",3
9,"9152",244,161,161,0,0,"PODEMOS-IU",15
38,"38005",5646,3302,3283,24,19,"PODEMOS-IU",403
10,"10115",3460,2584,2503,15,81,"PODEMOS-IU",245
47,"47045",732,558,549,3,9,"PODEMOS-IU",97
44,"44110",37,30,30,0,0,"PODEMOS-IU",0
37,"37265",198,167,163,1,4,"PODEMOS-IU",7
47,"47077",234,172,170,1,2,"PODEMOS-IU",3
37,"37201",238,170,168,0,2,"PODEMOS-IU",9
16,"16158",513,371,366,5,5,"PODEMOS-IU",36
5,"5067",73,56,54,0,2,"PODEMOS-IU",0
28,"28066",7575,5771,5718,58,53,"PODEMOS-IU",518
16,"16249",1938,1422,1406,6,16,"PODEMOS-IU",53
9,"9154",123,90,90,7,0,"PODEMOS-IU",5
49,"49038",88,63,58,1,5,"PODEMOS-IU",4
40,"40205",228,159,157,1,2,"PODEMOS-IU",13
16,"16085",131,106,106,0,0,"PODEMOS-IU",11
45,"45060",152,109,109,1,0,"PODEMOS-IU",8
19,"19168",265,182,175,4,7,"PODEMOS-IU",23
45,"45023",2300,1700,1685,19,15,"PODEMOS-IU",181
49,"49149",368,270,266,1,4,"PODEMOS-IU",11
47,"47016",65,55,55,0,0,"PODEMOS-IU",4
9,"9321",1576,1151,1135,10,16,"PODEMOS-IU",66
28,"28067",4416,3359,3311,18,48,"PODEMOS-IU",406
19,"19325",154,86,86,1,0,"PODEMOS-IU",4
49,"49150",123,95,92,3,3,"PODEMOS-IU",1
47,"47078",157,114,107,0,7,"PODEMOS-IU",1
49,"49262",367,263,261,1,2,"PODEMOS-IU",17
45,"45134",1622,1187,1177,8,10,"PODEMOS-IU",134
39,"39002",3408,2360,2323,7,37,"PODEMOS-IU",203
39,"39086",358,236,235,2,1,"PODEMOS-IU",12
37,"37298",170,109,109,0,0,"PODEMOS-IU",2
6,"6080",1898,1336,1307,6,29,"PODEMOS-IU",124
24,"24016",488,244,243,0,1,"PODEMOS-IU",8
49,"49080",622,440,437,4,3,"PODEMOS-IU",8
5,"5168",3503,2536,2511,29,25,"PODEMOS-IU",123
47,"47017",190,146,146,0,0,"PODEMOS-IU",4
28,"28068",11740,8615,8543,72,72,"PODEMOS-IU",897
49,"49116",356,239,234,4,5,"PODEMOS-IU",8
6,"6082",399,295,291,6,4,"PODEMOS-IU",24
50,"50066",2903,2095,2078,19,17,"PODEMOS-IU",251
50,"50292",130,108,107,0,1,"PODEMOS-IU",4
26,"26163",126,104,104,1,0,"PODEMOS-IU",10
44,"44171",176,115,115,0,0,"PODEMOS-IU",40
34,"34240",84,67,66,1,1,"PODEMOS-IU",0
34,"34189",53,33,33,0,0,"PODEMOS-IU",3
40,"40208",724,546,543,5,3,"PODEMOS-IU",33
37,"37204",253,176,173,2,3,"PODEMOS-IU",1
19,"19261",33,23,23,0,0,"PODEMOS-IU",1
39,"39088",59,40,40,2,0,"PODEMOS-IU",2
50,"50067",13928,9831,9699,92,132,"PODEMOS-IU",705
47,"47018",36,31,31,0,0,"PODEMOS-IU",3
24,"24090",323,200,200,2,0,"PODEMOS-IU",16
24,"24199",398,263,256,4,7,"PODEMOS-IU",20
44,"44021",104,77,77,1,0,"PODEMOS-IU",0
5,"5234",45,38,38,0,0,"PODEMOS-IU",0
26,"26083",337,255,250,3,5,"PODEMOS-IU",17
49,"49041",409,287,282,1,5,"PODEMOS-IU",12
44,"44261",713,553,549,3,4,"PODEMOS-IU",18
26,"26124",768,603,590,4,13,"PODEMOS-IU",30
50,"50293",392,257,255,2,2,"PODEMOS-IU",33
9,"9105",95,65,64,1,1,"PODEMOS-IU",7
37,"37363",104,81,80,0,1,"PODEMOS-IU",1
28,"28115",62612,50619,50431,399,188,"PODEMOS-IU",2425
44,"44084",54,46,46,1,0,"PODEMOS-IU",2
40,"40115",142,100,100,0,0,"PODEMOS-IU",9
37,"37010",925,645,638,5,7,"PODEMOS-IU",57
40,"40113",404,308,304,2,4,"PODEMOS-IU",57
6,"6040",993,679,668,3,11,"PODEMOS-IU",31
19,"19202",16,13,13,1,0,"PODEMOS-IU",6
37,"37176",128,99,98,1,1,"PODEMOS-IU",1
39,"39033",536,375,372,1,3,"PODEMOS-IU",22
34,"34003",147,104,103,0,1,"PODEMOS-IU",12
47,"47020",270,212,207,5,5,"PODEMOS-IU",1
5,"5139",71,59,58,1,1,"PODEMOS-IU",0
42,"42036",40,33,32,1,1,"PODEMOS-IU",10
40,"40017",83,71,68,2,3,"PODEMOS-IU",4
9,"9219",27097,17874,17629,192,245,"PODEMOS-IU",3189
44,"44230",149,111,110,2,1,"PODEMOS-IU",13
45,"45029",186,154,154,2,0,"PODEMOS-IU",3
19,"19108",95,78,78,0,0,"PODEMOS-IU",10
6,"6132",823,543,533,4,10,"PODEMOS-IU",96
16,"16014",558,419,417,6,2,"PODEMOS-IU",30
24,"24057",1295,909,891,7,18,"PODEMOS-IU",82
16,"16211",335,228,227,1,1,"PODEMOS-IU",5
50,"50295",48,41,41,0,0,"PODEMOS-IU",4
5,"5042",141,111,111,0,0,"PODEMOS-IU",3
40,"40039",180,133,133,0,0,"PODEMOS-IU",10
19,"19264",33,25,25,0,0,"PODEMOS-IU",0
28,"28084",16243,11562,11408,90,154,"PODEMOS-IU",1789
28,"28117",99,87,86,0,1,"PODEMOS-IU",17
34,"34053",194,156,154,3,2,"PODEMOS-IU",5
37,"37303",179,118,117,1,1,"PODEMOS-IU",0
37,"37012",144,111,111,0,0,"PODEMOS-IU",1
40,"40212",26,19,19,1,0,"PODEMOS-IU",0
37,"37208",71,49,49,0,0,"PODEMOS-IU",2
9,"9012",93,70,68,0,2,"PODEMOS-IU",7
24,"24094",1320,866,852,11,14,"PODEMOS-IU",78
44,"44146",164,133,133,2,0,"PODEMOS-IU",2
49,"49156",218,149,144,0,5,"PODEMOS-IU",8
44,"44025",5804,4024,3991,11,33,"PODEMOS-IU",351
28,"28118",61,52,50,0,2,"PODEMOS-IU",7
16,"16130",533,407,404,0,3,"PODEMOS-IU",5
5,"5109",445,334,329,4,5,"PODEMOS-IU",12
50,"50122",68,43,42,1,1,"PODEMOS-IU",1
13,"13070",747,575,556,7,19,"PODEMOS-IU",36
39,"39064",1352,1007,990,3,17,"PODEMOS-IU",59
13,"13025",290,233,231,0,2,"PODEMOS-IU",3
45,"45130",294,222,222,1,0,"PODEMOS-IU",12
37,"37180",68,45,44,1,1,"PODEMOS-IU",0
35,"35022",51765,29309,29034,184,275,"PODEMOS-IU",4500
49,"49087",476,246,244,0,2,"PODEMOS-IU",2
9,"9275",167,114,114,1,0,"PODEMOS-IU",6
19,"19333",96,68,67,0,1,"PODEMOS-IU",10
34,"34149",23,20,20,0,0,"PODEMOS-IU",1
44,"44118",154,109,106,1,3,"PODEMOS-IU",3
9,"9016",85,54,54,0,0,"PODEMOS-IU",6
50,"50249",283,202,200,0,2,"PODEMOS-IU",6
9,"9172",131,88,88,1,0,"PODEMOS-IU",3
6,"6046",1250,983,959,6,24,"PODEMOS-IU",29
19,"19111",160,128,125,0,3,"PODEMOS-IU",10
28,"28086",5446,3643,3600,19,43,"PODEMOS-IU",340
47,"47024",223,170,168,1,2,"PODEMOS-IU",6
34,"34057",464,308,302,4,6,"PODEMOS-IU",23
40,"40121",249,188,178,1,10,"PODEMOS-IU",11
44,"44026",100,73,72,0,1,"PODEMOS-IU",9
49,"49271",176,128,127,3,1,"PODEMOS-IU",6
39,"39037",2033,1431,1420,3,11,"PODEMOS-IU",113
49,"49272",73,49,46,2,3,"PODEMOS-IU",3
28,"28120",1220,910,897,5,13,"PODEMOS-IU",81
49,"49237",142,78,78,0,0,"PODEMOS-IU",2
5,"5113",62,42,42,0,0,"PODEMOS-IU",1
45,"45182",996,760,754,5,6,"PODEMOS-IU",47
47,"47056",81,57,57,0,0,"PODEMOS-IU",1
49,"49197",155,109,104,0,5,"PODEMOS-IU",8
26,"26018",10443,7664,7538,80,126,"PODEMOS-IU",762
47,"47121",517,410,398,2,12,"PODEMOS-IU",16
50,"50225",1532,983,971,12,12,"PODEMOS-IU",68
9,"9018",24624,17232,16983,192,249,"PODEMOS-IU",1835
37,"37015",198,127,125,2,2,"PODEMOS-IU",7
6,"6094",1457,868,858,5,10,"PODEMOS-IU",17
9,"9174",768,536,522,6,14,"PODEMOS-IU",55
9,"9120",41,34,33,3,1,"PODEMOS-IU",5
40,"40087",85,70,70,0,0,"PODEMOS-IU",3
44,"44268",32,30,30,0,0,"PODEMOS-IU",1
28,"28122",578,404,401,1,3,"PODEMOS-IU",42
44,"44001",65,43,43,1,0,"PODEMOS-IU",5
24,"24026",1085,724,712,14,12,"PODEMOS-IU",36
50,"50201",449,345,344,4,1,"PODEMOS-IU",30
19,"19043",99,80,79,0,1,"PODEMOS-IU",5
40,"40022",195,144,141,2,3,"PODEMOS-IU",11
42,"42086",33,19,19,1,0,"PODEMOS-IU",0
16,"16020",9,5,5,1,0,"PODEMOS-IU",0
44,"44092",70,53,52,0,1,"PODEMOS-IU",5
42,"42182",49,39,39,1,0,"PODEMOS-IU",0
24,"24099",153,111,110,1,1,"PODEMOS-IU",14
6,"6096",206,158,153,0,5,"PODEMOS-IU",13
37,"37017",226,169,168,4,1,"PODEMOS-IU",9
40,"40088",272,192,192,0,0,"PODEMOS-IU",10
47,"47090",2447,1823,1784,15,39,"PODEMOS-IU",154
45,"45147",592,449,443,2,6,"PODEMOS-IU",48
24,"24100",737,506,502,9,4,"PODEMOS-IU",72
47,"47028",30,17,17,0,0,"PODEMOS-IU",0
6,"6097",2258,1631,1602,10,29,"PODEMOS-IU",136
26,"26135",152,115,114,0,1,"PODEMOS-IU",10
6,"6051",1523,1147,1137,5,10,"PODEMOS-IU",41
24,"24213",158,127,126,1,1,"PODEMOS-IU",4
13,"13032",1076,772,765,0,7,"PODEMOS-IU",45
10,"10010",2206,1308,1281,8,27,"PODEMOS-IU",101
16,"16137",37,27,25,0,2,"PODEMOS-IU",2
38,"38016",1174,595,589,2,6,"PODEMOS-IU",85
19,"19212",678,501,491,1,10,"PODEMOS-IU",30
2,"2003",134196,96374,95521,913,853,"PODEMOS-IU",10219
34,"34157",2353,1697,1669,18,28,"PODEMOS-IU",124
45,"45002",2619,1676,1663,14,13,"PODEMOS-IU",168
28,"28019",1272,926,914,6,12,"PODEMOS-IU",109
50,"50277",45,34,34,0,0,"PODEMOS-IU",1
47,"47219",39,31,28,1,3,"PODEMOS-IU",0
37,"37123",159,124,123,2,1,"PODEMOS-IU",1
37,"37311",201,157,156,1,1,"PODEMOS-IU",8
44,"44123",95,68,68,0,0,"PODEMOS-IU",2
24,"24175",1821,1316,1305,15,11,"PODEMOS-IU",150
40,"40058",306,244,240,1,4,"PODEMOS-IU",7
37,"37019",138,111,109,0,2,"PODEMOS-IU",2
47,"47091",76,60,59,2,1,"PODEMOS-IU",8
34,"34063",84,74,74,1,0,"PODEMOS-IU",1
9,"9072",331,261,260,4,1,"PODEMOS-IU",24
5,"5051",157,117,115,1,2,"PODEMOS-IU",7
45,"45150",428,322,319,3,3,"PODEMOS-IU",18
19,"19183",70,59,58,0,1,"PODEMOS-IU",7
49,"49203",280,218,212,1,6,"PODEMOS-IU",1
47,"47157",490,398,397,2,1,"PODEMOS-IU",43
45,"45040",1247,727,715,3,12,"PODEMOS-IU",62
28,"28051",1644,1231,1220,9,11,"PODEMOS-IU",171
40,"40059",109,92,91,2,1,"PODEMOS-IU",7
42,"42187",58,44,39,1,5,"PODEMOS-IU",1
35,"35004",41975,20773,20602,156,171,"PODEMOS-IU",3256
10,"10136",274,205,202,1,3,"PODEMOS-IU",12
35,"35027",10502,6831,6750,67,81,"PODEMOS-IU",923
45,"45078",1333,1084,1077,6,7,"PODEMOS-IU",38
50,"50181",999,748,732,3,16,"PODEMOS-IU",93
24,"24031",207,160,158,0,2,"PODEMOS-IU",16
37,"37218",51,25,23,0,2,"PODEMOS-IU",1
19,"19011",237,165,162,3,3,"PODEMOS-IU",10
42,"42013",34,22,22,2,0,"PODEMOS-IU",1
40,"40029",25,21,19,0,2,"PODEMOS-IU",1
34,"34023",5103,3585,3543,45,42,"PODEMOS-IU",473
37,"37090",68,47,47,0,0,"PODEMOS-IU",5
6,"6057",530,409,400,0,9,"PODEMOS-IU",13
40,"40093",74,62,62,1,0,"PODEMOS-IU",7
26,"26179",39,27,27,0,0,"PODEMOS-IU",1
40,"40127",36,25,23,0,2,"PODEMOS-IU",1
9,"9238",931,473,461,1,12,"PODEMOS-IU",47
40,"40223",235,177,174,1,3,"PODEMOS-IU",19
26,"26026",1268,986,970,4,16,"PODEMOS-IU",40
5,"5247",231,132,131,1,1,"PODEMOS-IU",5
50,"50182",3657,2499,2485,23,14,"PODEMOS-IU",291
5,"5249",96,63,63,0,0,"PODEMOS-IU",22
39,"39101",231,134,132,2,2,"PODEMOS-IU",21
49,"49132",310,220,215,2,5,"PODEMOS-IU",6
45,"45043",776,608,598,3,10,"PODEMOS-IU",30
37,"37188",158,107,105,3,2,"PODEMOS-IU",4
34,"34163",46,37,37,0,0,"PODEMOS-IU",2
28,"28054",11943,8800,8731,72,69,"PODEMOS-IU",1160
2,"2008",1103,737,722,8,15,"PODEMOS-IU",55
19,"19278",24,20,20,0,0,"PODEMOS-IU",0
34,"34025",52,34,34,1,0,"PODEMOS-IU",1
10,"10099",563,369,358,3,11,"PODEMOS-IU",21
44,"44035",102,82,80,1,2,"PODEMOS-IU",0
9,"9352",102,74,74,0,0,"PODEMOS-IU",1
37,"37221",391,259,257,2,2,"PODEMOS-IU",12
44,"44213",68,47,47,0,0,"PODEMOS-IU",2
49,"49246",214,183,180,3,3,"PODEMOS-IU",7
34,"34220",152,133,132,1,1,"PODEMOS-IU",3
19,"19217",43,36,36,0,0,"PODEMOS-IU",2
44,"44007",149,112,111,1,1,"PODEMOS-IU",1
49,"49207",215,144,143,1,1,"PODEMOS-IU",6
10,"10058",979,628,599,6,29,"PODEMOS-IU",49
9,"9298",72,52,52,1,0,"PODEMOS-IU",2
45,"45155",311,240,240,0,0,"PODEMOS-IU",21
44,"44100",177,136,135,1,1,"PODEMOS-IU",14
45,"45008",144,112,110,1,2,"PODEMOS-IU",5
24,"24107",206,147,147,1,0,"PODEMOS-IU",7
42,"42151",38,27,27,0,0,"PODEMOS-IU",1
5,"5156",242,145,145,1,0,"PODEMOS-IU",18
49,"49171",603,433,427,4,6,"PODEMOS-IU",25
9,"9190",86,58,54,2,4,"PODEMOS-IU",17
34,"34168",45,39,39,1,0,"PODEMOS-IU",2
50,"50159",640,493,486,3,7,"PODEMOS-IU",28
40,"40001",708,544,536,3,8,"PODEMOS-IU",26
49,"49248",171,128,128,1,0,"PODEMOS-IU",6
50,"50234",242,159,154,4,5,"PODEMOS-IU",15
35,"35007",517,347,345,2,2,"PODEMOS-IU",23
40,"40228",493,362,361,3,1,"PODEMOS-IU",19
28,"28131",13510,9647,9544,89,103,"PODEMOS-IU",1140
9,"9355",85,67,67,1,0,"PODEMOS-IU",1
50,"50160",2140,1421,1394,14,27,"PODEMOS-IU",148
34,"34029",665,524,518,1,6,"PODEMOS-IU",7
45,"45121",7345,4949,4899,24,50,"PODEMOS-IU",354
6,"6018",727,483,476,0,7,"PODEMOS-IU",70
9,"9463",246,174,174,4,0,"PODEMOS-IU",15
10,"10143",141,109,105,0,4,"PODEMOS-IU",5
30,"30030",321454,235061,233183,1744,1878,"PODEMOS-IU",21362
6,"6019",2010,1367,1330,23,37,"PODEMOS-IU",147
19,"19281",19,18,18,0,0,"PODEMOS-IU",1
5,"5254",184,149,147,1,2,"PODEMOS-IU",4
42,"42194",144,101,100,2,1,"PODEMOS-IU",3
47,"47036",204,159,156,1,3,"PODEMOS-IU",7
47,"47037",161,128,125,1,3,"PODEMOS-IU",6
50,"50008",5187,3334,3288,37,46,"PODEMOS-IU",528
38,"38023",126137,79423,78706,605,717,"PODEMOS-IU",14961
37,"37192",361,200,198,3,2,"PODEMOS-IU",16
5,"5092",145,111,107,1,4,"PODEMOS-IU",6
49,"49173",335,165,163,4,2,"PODEMOS-IU",5
5,"5070",30,29,29,0,0,"PODEMOS-IU",0
34,"34032",38,30,30,0,0,"PODEMOS-IU",4
44,"44039",204,144,143,1,1,"PODEMOS-IU",2
50,"50235",2421,1721,1702,18,19,"PODEMOS-IU",182
40,"40230",93,66,64,0,2,"PODEMOS-IU",7
40,"40034",74,59,58,0,1,"PODEMOS-IU",4
40,"40134",692,522,509,10,13,"PODEMOS-IU",23
37,"37163",34,24,24,0,0,"PODEMOS-IU",6
42,"42196",7,7,7,1,0,"PODEMOS-IU",0
50,"50033",61,44,44,1,0,"PODEMOS-IU",3
13,"13047",5782,4232,4160,27,72,"PODEMOS-IU",290
6,"6158",13367,9319,9131,90,188,"PODEMOS-IU",1230
34,"34033",18,14,14,0,0,"PODEMOS-IU",1
49,"49139",149,112,112,0,0,"PODEMOS-IU",6
34,"34077",395,282,278,7,4,"PODEMOS-IU",23
28,"28166",357,281,276,1,5,"PODEMOS-IU",36
34,"34034",112,82,82,1,0,"PODEMOS-IU",5
47,"47228",432,324,320,2,4,"PODEMOS-IU",11
50,"50083",81,64,64,2,0,"PODEMOS-IU",10
37,"37228",324,262,262,1,0,"PODEMOS-IU",11
49,"49175",204,136,135,3,1,"PODEMOS-IU",3
9,"9197",144,105,103,2,2,"PODEMOS-IU",8
44,"44219",173,118,115,1,3,"PODEMOS-IU",5
13,"13003",448,329,319,1,10,"PODEMOS-IU",20
16,"16151",61,51,51,1,0,"PODEMOS-IU",6
49,"49141",290,191,191,1,0,"PODEMOS-IU",8
45,"45199",3188,2077,2055,20,22,"PODEMOS-IU",298
19,"19318",26,18,18,0,0,"PODEMOS-IU",1
40,"40136",102,79,77,3,2,"PODEMOS-IU",17
19,"19162",67,41,41,0,0,"PODEMOS-IU",5
13,"13004",976,698,694,6,4,"PODEMOS-IU",31
16,"16193",55,50,49,0,1,"PODEMOS-IU",1
47,"47102",257,212,210,2,2,"PODEMOS-IU",4
40,"40200",38,28,28,0,0,"PODEMOS-IU",0
10,"10066",161,121,120,1,1,"PODEMOS-IU",6
37,"37134",209,143,141,3,2,"PODEMOS-IU",8
24,"24227",1527,1036,1032,13,4,"PODEMOS-IU",70
16,"16074",30,25,25,0,0,"PODEMOS-IU",2
49,"49220",146,102,98,3,4,"PODEMOS-IU",5
50,"50111",181,130,130,1,0,"PODEMOS-IU",14
13,"13096",7526,5212,5131,25,81,"PODEMOS-IU",259
13,"13051",336,253,249,1,4,"PODEMOS-IU",22
19,"19285",20,16,16,0,0,"PODEMOS-IU",1
37,"37260",137,110,109,0,1,"PODEMOS-IU",8
40,"40007",68,55,55,1,0,"PODEMOS-IU",3
16,"16039",365,241,238,3,3,"PODEMOS-IU",10
47,"47041",147,105,103,3,2,"PODEMOS-IU",11
28,"28061",22757,17091,16965,115,126,"PODEMOS-IU",2122
10,"10028",83,62,61,1,1,"PODEMOS-IU",1
50,"50086",176,106,102,1,4,"PODEMOS-IU",12
16,"16906",70,44,44,1,0,"PODEMOS-IU",0
34,"34177",178,149,149,1,0,"PODEMOS-IU",10
37,"37135",1146,849,837,5,12,"PODEMOS-IU",24
10,"10191",511,374,365,5,9,"PODEMOS-IU",42
34,"34230",16,11,11,0,0,"PODEMOS-IU",0
9,"9368",29,19,19,1,0,"PODEMOS-IU",0
37,"37032",553,388,388,2,0,"PODEMOS-IU",13
44,"44133",15,12,12,0,0,"PODEMOS-IU",0
50,"50165",1768,1255,1222,20,33,"PODEMOS-IU",204
49,"49179",337,210,209,3,1,"PODEMOS-IU",17
9,"9045",269,159,158,0,1,"PODEMOS-IU",19
37,"37136",625,388,387,7,1,"PODEMOS-IU",15
34,"34083",1647,1089,1080,2,9,"PODEMOS-IU",93
28,"28171",4410,2921,2889,8,32,"PODEMOS-IU",252
2,"2051",1654,1115,1101,13,14,"PODEMOS-IU",38
34,"34231",211,157,153,3,4,"PODEMOS-IU",2
24,"24190",146,103,103,2,0,"PODEMOS-IU",2
26,"26154",10,10,9,1,1,"PODEMOS-IU",0
40,"40202",56,33,33,0,0,"PODEMOS-IU",0
2,"2085",306,232,226,2,6,"PODEMOS-IU",3
28,"28064",125,98,95,3,3,"PODEMOS-IU",10
19,"19322",26,20,19,1,1,"PODEMOS-IU",1
50,"50114",132,108,108,0,0,"PODEMOS-IU",7
47,"47200",70,60,60,0,0,"PODEMOS-IU",4
42,"42161",136,99,99,0,0,"PODEMOS-IU",5
50,"50014",119,81,81,0,0,"PODEMOS-IU",7
5,"5099",451,350,344,3,6,"PODEMOS-IU",1
37,"37232",377,303,303,2,0,"PODEMOS-IU",13
42,"42205",77,59,57,3,2,"PODEMOS-IU",1
44,"44044",82,65,65,2,0,"PODEMOS-IU",1
44,"44017",269,217,216,0,1,"PODEMOS-IU",9
19,"19256",46,36,36,0,0,"PODEMOS-IU",0
50,"50088",274,195,191,2,4,"PODEMOS-IU",5
9,"9424",31,24,23,0,1,"PODEMOS-IU",1
9,"9151",446,352,346,3,6,"PODEMOS-IU",27
49,"49147",250,164,162,1,2,"PODEMOS-IU",6
28,"28005",136518,101397,100485,871,912,"PODEMOS-IU",12626
50,"50064",439,348,346,1,2,"PODEMOS-IU",29
37,"37234",314,194,192,3,2,"PODEMOS-IU",5
51,"51001",59820,33614,33265,323,349,"PODEMOS-IU",1287
45,"45058",344,245,236,1,9,"PODEMOS-IU",18
38,"38901",1466,908,894,4,14,"PODEMOS-IU",122
6,"6032",80,68,68,1,0,"PODEMOS-IU",8
13,"13012",381,265,261,1,4,"PODEMOS-IU",20
45,"45168",62836,46917,46353,424,564,"PODEMOS-IU",5250
45,"45095",663,496,492,2,4,"PODEMOS-IU",17
2,"2021",1013,806,798,6,8,"PODEMOS-IU",56
30,"30037",19407,13252,13120,99,132,"PODEMOS-IU",835
40,"40109",69,51,50,3,1,"PODEMOS-IU",2
16,"16121",227,160,152,0,8,"PODEMOS-IU",18
19,"19197",28,22,22,1,0,"PODEMOS-IU",4
6,"6078",500,363,359,1,4,"PODEMOS-IU",14
19,"19103",247,205,202,1,3,"PODEMOS-IU",8
37,"37329",38,29,28,1,1,"PODEMOS-IU",0
16,"16250",67,52,52,1,0,"PODEMOS-IU",1
5,"5102",1681,1252,1228,8,24,"PODEMOS-IU",56
5,"5231",150,123,122,2,1,"PODEMOS-IU",4
45,"45170",194,146,140,0,6,"PODEMOS-IU",8
47,"47046",124,99,99,1,0,"PODEMOS-IU",6
13,"13014",472,361,352,4,9,"PODEMOS-IU",24
42,"42208",20,12,12,1,0,"PODEMOS-IU",0
13,"13060",274,205,202,3,3,"PODEMOS-IU",32
44,"44111",78,61,61,0,0,"PODEMOS-IU",9
26,"26043",346,243,235,2,8,"PODEMOS-IU",23
2,"2056",1640,1204,1179,11,25,"PODEMOS-IU",38
47,"47206",79,66,66,0,0,"PODEMOS-IU",3
37,"37072",144,121,118,5,3,"PODEMOS-IU",0
9,"9001",32,25,25,0,0,"PODEMOS-IU",0
16,"16251",1805,1318,1302,9,16,"PODEMOS-IU",61
28,"28145",2671,1927,1895,21,32,"PODEMOS-IU",259
40,"40045",119,93,93,1,0,"PODEMOS-IU",9
37,"37309",36,21,21,0,0,"PODEMOS-IU",4
37,"37236",123,85,82,1,3,"PODEMOS-IU",3
44,"44141",122,88,85,0,3,"PODEMOS-IU",16
40,"40046",83,67,67,1,0,"PODEMOS-IU",7
34,"34047",1711,1275,1248,18,27,"PODEMOS-IU",47
16,"16204",237,179,177,1,2,"PODEMOS-IU",7
9,"9052",28,21,20,0,1,"PODEMOS-IU",0
45,"45062",1075,816,808,11,8,"PODEMOS-IU",17
50,"50244",192,131,130,1,1,"PODEMOS-IU",9
26,"26122",115,81,80,4,1,"PODEMOS-IU",9
10,"10159",314,207,207,2,0,"PODEMOS-IU",1
10,"10037",76966,54717,53914,546,803,"PODEMOS-IU",5943
37,"37174",975,716,705,2,11,"PODEMOS-IU",22
19,"19293",1945,1402,1388,19,14,"PODEMOS-IU",215
19,"19199",19,15,15,0,0,"PODEMOS-IU",3
13,"13017",240,178,176,0,2,"PODEMOS-IU",4
45,"45173",9756,6811,6720,49,91,"PODEMOS-IU",516
37,"37038",756,531,517,4,14,"PODEMOS-IU",31
50,"50091",39,32,32,0,0,"PODEMOS-IU",0
50,"50018",883,622,616,5,6,"PODEMOS-IU",23
9,"9055",47,33,32,0,1,"PODEMOS-IU",2
26,"26010",85,66,63,1,3,"PODEMOS-IU",1
42,"42076",200,149,143,2,6,"PODEMOS-IU",11
42,"42213",25,17,16,1,1,"PODEMOS-IU",0
6,"6130",185,152,149,0,3,"PODEMOS-IU",16
38,"38009",4315,2846,2817,27,29,"PODEMOS-IU",324
19,"19070",65,45,45,0,0,"PODEMOS-IU",1
47,"47146",275,215,214,1,1,"PODEMOS-IU",31
5,"5040",64,47,46,0,1,"PODEMOS-IU",2
35,"35018",13153,7742,7674,80,68,"PODEMOS-IU",1386
45,"45101",3671,2842,2808,13,34,"PODEMOS-IU",193
40,"40210",97,69,69,1,0,"PODEMOS-IU",3
2,"2060",1268,953,939,7,14,"PODEMOS-IU",42
34,"34242",91,65,62,2,3,"PODEMOS-IU",2
44,"44173",103,81,79,0,2,"PODEMOS-IU",8
50,"50220",45,38,38,0,0,"PODEMOS-IU",9
45,"45102",3613,2495,2464,27,31,"PODEMOS-IU",222
44,"44023",18,15,14,0,1,"PODEMOS-IU",1
37,"37040",376,291,288,0,3,"PODEMOS-IU",13
44,"44229",141,99,98,1,1,"PODEMOS-IU",4
34,"34051",91,72,70,0,2,"PODEMOS-IU",2
38,"38035",10518,5870,5819,37,51,"PODEMOS-IU",662
47,"47147",103,86,82,0,4,"PODEMOS-IU",4
28,"28071",63,46,45,0,1,"PODEMOS-IU",3
44,"44085",49,29,29,0,0,"PODEMOS-IU",0
39,"39090",773,557,553,2,4,"PODEMOS-IU",51
5,"5172",111,83,83,1,0,"PODEMOS-IU",4
44,"44262",141,104,103,0,1,"PODEMOS-IU",2
19,"19071",8277,5838,5763,53,75,"PODEMOS-IU",708
24,"24129",114,79,78,2,1,"PODEMOS-IU",2
50,"50093",87,66,64,1,2,"PODEMOS-IU",11
26,"26166",144,125,124,0,1,"PODEMOS-IU",4
5,"5173",60,54,54,0,0,"PODEMOS-IU",2
42,"42080",153,108,108,1,0,"PODEMOS-IU",2
39,"39063",936,618,616,4,2,"PODEMOS-IU",42
2,"2062",382,261,256,2,5,"PODEMOS-IU",9
34,"34005",786,601,593,3,8,"PODEMOS-IU",37
26,"26014",443,278,273,3,5,"PODEMOS-IU",27
42,"42174",174,121,118,4,3,"PODEMOS-IU",17
13,"13023",8944,6251,6165,50,86,"PODEMOS-IU",187
37,"37241",167,121,119,3,2,"PODEMOS-IU",1
24,"24021",1595,1037,1025,7,12,"PODEMOS-IU",131
47,"47149",46,33,32,1,1,"PODEMOS-IU",12
24,"24130",415,291,289,2,2,"PODEMOS-IU",22
50,"50248",501,344,328,3,16,"PODEMOS-IU",35
37,"37272",132,97,95,0,2,"PODEMOS-IU",1
50,"50095",12149,8322,8239,91,83,"PODEMOS-IU",914
47,"47053",123,101,97,3,4,"PODEMOS-IU",14
37,"37147",184,126,124,1,2,"PODEMOS-IU",12
9,"9221",498,380,377,8,3,"PODEMOS-IU",51
10,"10166",307,197,195,0,2,"PODEMOS-IU",10
40,"40119",166,133,132,2,1,"PODEMOS-IU",7
40,"40052",72,55,55,0,0,"PODEMOS-IU",6
44,"44264",254,170,170,0,0,"PODEMOS-IU",5
13,"13024",875,587,577,7,10,"PODEMOS-IU",14
47,"47150",253,193,187,3,6,"PODEMOS-IU",15
30,"30019",25911,17485,17264,157,221,"PODEMOS-IU",1914
34,"34202",28,23,23,2,0,"PODEMOS-IU",0
44,"44176",152,114,113,1,1,"PODEMOS-IU",4
9,"9335",86,66,66,3,0,"PODEMOS-IU",8
16,"16265",22,18,18,0,0,"PODEMOS-IU",0
9,"9062",40,34,33,0,1,"PODEMOS-IU",2
9,"9390",554,455,450,6,5,"PODEMOS-IU",27
10,"10167",301,198,198,0,0,"PODEMOS-IU",4
42,"42219",40,34,34,1,0,"PODEMOS-IU",2
50,"50022",504,373,369,12,4,"PODEMOS-IU",14
19,"19176",227,172,172,0,0,"PODEMOS-IU",8
10,"10086",304,228,225,4,3,"PODEMOS-IU",5
24,"24209",2597,1651,1636,12,15,"PODEMOS-IU",157
37,"37045",27,19,19,0,0,"PODEMOS-IU",0
50,"50072",183,131,129,0,2,"PODEMOS-IU",10
40,"40151",43,31,31,0,0,"PODEMOS-IU",2
28,"28152",16986,13444,13366,111,78,"PODEMOS-IU",1066
24,"24025",283,190,185,3,5,"PODEMOS-IU",6
16,"16055",669,429,426,0,3,"PODEMOS-IU",26
9,"9225",80,55,55,0,0,"PODEMOS-IU",1
19,"19006",755,506,494,4,12,"PODEMOS-IU",53
44,"44206",100,73,73,3,0,"PODEMOS-IU",8
9,"9392",49,28,28,0,0,"PODEMOS-IU",5
19,"19238",43,30,28,0,2,"PODEMOS-IU",2
40,"40086",656,513,496,7,17,"PODEMOS-IU",55
37,"37275",98,67,67,0,0,"PODEMOS-IU",1
26,"26093",48,34,33,0,1,"PODEMOS-IU",3
10,"10169",497,370,366,0,4,"PODEMOS-IU",17
28,"28016",79,55,55,0,0,"PODEMOS-IU",8
34,"34205",55,38,38,0,0,"PODEMOS-IU",1
34,"34059",411,304,292,6,12,"PODEMOS-IU",14
10,"10047",938,710,694,1,16,"PODEMOS-IU",83
40,"40154",22,18,18,1,0,"PODEMOS-IU",0
19,"19178",27,17,16,0,1,"PODEMOS-IU",4
37,"37120",98,78,76,0,2,"PODEMOS-IU",1
49,"49238",273,205,200,4,5,"PODEMOS-IU",6
47,"47183",135,100,100,1,0,"PODEMOS-IU",2
45,"45036",638,455,449,1,6,"PODEMOS-IU",25
2,"2067",1137,808,794,2,14,"PODEMOS-IU",65
10,"10008",1274,921,908,1,13,"PODEMOS-IU",61
49,"49053",919,676,661,8,15,"PODEMOS-IU",47
42,"42087",51,45,42,1,3,"PODEMOS-IU",19
5,"5210",81,56,56,0,0,"PODEMOS-IU",1
38,"38015",4055,2635,2601,16,34,"PODEMOS-IU",186
16,"16058",94,71,71,1,0,"PODEMOS-IU",1
44,"44066",85,62,62,0,0,"PODEMOS-IU",1
50,"50227",107,62,62,1,0,"PODEMOS-IU",2
39,"39012",6772,4807,4755,31,52,"PODEMOS-IU",508
9,"9396",149,121,121,4,0,"PODEMOS-IU",7
6,"6006",4479,2991,2934,27,57,"PODEMOS-IU",300
16,"16022",76,63,63,0,0,"PODEMOS-IU",3
10,"10009",255,165,162,1,3,"PODEMOS-IU",7
40,"40155",3897,2920,2880,56,40,"PODEMOS-IU",349
47,"47058",199,126,125,3,1,"PODEMOS-IU",8
16,"16060",715,519,513,3,6,"PODEMOS-IU",23
44,"44150",28,17,17,0,0,"PODEMOS-IU",0
42,"42008",54,41,41,0,0,"PODEMOS-IU",6
9,"9177",1140,790,780,7,10,"PODEMOS-IU",51
9,"9123",42,36,36,0,0,"PODEMOS-IU",5
5,"5116",96,68,68,0,0,"PODEMOS-IU",2
34,"34211",171,154,153,2,1,"PODEMOS-IU",2
50,"50178",269,165,163,6,2,"PODEMOS-IU",20
50,"50252",5019,3486,3456,53,30,"PODEMOS-IU",218
50,"50203",1065,817,804,5,13,"PODEMOS-IU",120
16,"16139",317,226,222,1,4,"PODEMOS-IU",18
38,"38041",7025,4729,4684,42,45,"PODEMOS-IU",652
16,"16175",5071,3807,3732,43,75,"PODEMOS-IU",183
10,"10052",172,114,113,3,1,"PODEMOS-IU",3
39,"39069",1934,1475,1458,2,17,"PODEMOS-IU",105
16,"16061",939,746,727,16,19,"PODEMOS-IU",49
45,"45186",2943,2142,2121,12,21,"PODEMOS-IU",458
30,"30024",60389,42200,41831,281,369,"PODEMOS-IU",3078
49,"49202",173,103,101,0,2,"PODEMOS-IU",2
50,"50229",65,46,46,1,0,"PODEMOS-IU",8
28,"28125",3208,2275,2252,5,23,"PODEMOS-IU",271
26,"26138",4504,2982,2930,32,52,"PODEMOS-IU",237
50,"50154",114,92,92,1,0,"PODEMOS-IU",2
45,"45113",1770,1189,1171,5,18,"PODEMOS-IU",47
44,"44181",65,57,57,0,0,"PODEMOS-IU",2
24,"24141",96,74,74,0,0,"PODEMOS-IU",5
47,"47156",150,117,117,0,0,"PODEMOS-IU",12
50,"50027",223,166,161,2,5,"PODEMOS-IU",13
24,"24176",302,232,226,0,6,"PODEMOS-IU",9
50,"50180",107,85,85,1,0,"PODEMOS-IU",18
45,"45188",2770,1925,1886,12,39,"PODEMOS-IU",212
24,"24142",24715,16839,16616,159,223,"PODEMOS-IU",1835
50,"50204",2396,1723,1712,17,11,"PODEMOS-IU",189
24,"24067",602,327,324,6,3,"PODEMOS-IU",11
40,"40028",103,88,87,2,1,"PODEMOS-IU",1
49,"49057",107,74,71,0,3,"PODEMOS-IU",1
34,"34214",176,121,120,1,1,"PODEMOS-IU",6
10,"10054",523,389,380,1,9,"PODEMOS-IU",30
45,"45151",544,413,409,0,4,"PODEMOS-IU",50
16,"16275",12,12,12,1,0,"PODEMOS-IU",2
40,"40060",67,40,40,1,0,"PODEMOS-IU",0
19,"19153",22,20,20,2,0,"PODEMOS-IU",5
9,"9236",34,25,25,1,0,"PODEMOS-IU",0
10,"10177",1702,1241,1186,10,55,"PODEMOS-IU",104
49,"49097",67,44,44,0,0,"PODEMOS-IU",3
6,"6102",1027,834,815,3,19,"PODEMOS-IU",51
38,"38043",19365,12355,12212,126,143,"PODEMOS-IU",1755
19,"19306",24,18,18,0,0,"PODEMOS-IU",1
50,"50205",72,51,49,0,2,"PODEMOS-IU",4
44,"44154",240,164,161,1,3,"PODEMOS-IU",14
10,"10218",1074,685,672,0,13,"PODEMOS-IU",19
19,"19215",135,109,109,0,0,"PODEMOS-IU",3
19,"19184",59,47,47,0,0,"PODEMOS-IU",3
5,"5183",123,103,100,0,3,"PODEMOS-IU",0
19,"19154",58,45,45,0,0,"PODEMOS-IU",0
38,"38044",2215,1270,1257,5,13,"PODEMOS-IU",70
42,"42052",16,14,14,0,0,"PODEMOS-IU",2
5,"5153",86,58,56,3,2,"PODEMOS-IU",5
6,"6013",261,209,204,4,5,"PODEMOS-IU",28
16,"16029",104,76,74,0,2,"PODEMOS-IU",11
24,"24145",612,338,337,1,1,"PODEMOS-IU",18
44,"44155",1063,779,778,3,1,"PODEMOS-IU",70
10,"10179",272,209,209,2,0,"PODEMOS-IU",24
6,"6150",777,592,588,0,4,"PODEMOS-IU",83
28,"28129",8589,6397,6338,46,59,"PODEMOS-IU",602
39,"39046",1342,910,902,3,8,"PODEMOS-IU",79
13,"13040",839,639,623,7,16,"PODEMOS-IU",49
45,"45082",1145,904,893,7,11,"PODEMOS-IU",56
50,"50030",197,124,124,1,0,"PODEMOS-IU",24
50,"50132",780,549,538,7,11,"PODEMOS-IU",54
24,"24106",218,139,139,1,0,"PODEMOS-IU",5
42,"42015",30,20,20,0,0,"PODEMOS-IU",0
47,"47003",206,167,166,5,1,"PODEMOS-IU",9
40,"40062",56,43,42,0,1,"PODEMOS-IU",2
39,"39102",2229,1524,1514,10,10,"PODEMOS-IU",96
10,"10100",783,494,447,5,47,"PODEMOS-IU",58
26,"26027",139,99,97,0,2,"PODEMOS-IU",6
16,"16187",55,38,38,3,0,"PODEMOS-IU",1
49,"49025",157,121,118,0,3,"PODEMOS-IU",6
5,"5056",91,71,70,0,1,"PODEMOS-IU",2
34,"34167",110,84,83,0,1,"PODEMOS-IU",4
19,"19051",61,52,52,0,0,"PODEMOS-IU",2
24,"24001",165,93,93,0,0,"PODEMOS-IU",4
49,"49135",576,368,366,3,2,"PODEMOS-IU",18
40,"40097",130,103,102,5,1,"PODEMOS-IU",5
37,"37160",597,380,370,3,10,"PODEMOS-IU",17
42,"42098",8,7,7,0,0,"PODEMOS-IU",0
10,"10059",329,202,201,1,1,"PODEMOS-IU",8
24,"24002",224,165,162,1,3,"PODEMOS-IU",7
10,"10904",714,487,473,8,14,"PODEMOS-IU",31
42,"42193",14,7,7,0,0,"PODEMOS-IU",0
2,"2044",1040,665,656,5,9,"PODEMOS-IU",28
34,"34222",107,71,68,1,3,"PODEMOS-IU",3
50,"50107",988,758,755,8,3,"PODEMOS-IU",46
19,"19018",142,112,112,1,0,"PODEMOS-IU",3
47,"47162",70,57,57,2,0,"PODEMOS-IU",2
39,"39048",1772,1311,1295,8,16,"PODEMOS-IU",116
5,"5023",174,148,145,2,3,"PODEMOS-IU",5
5,"5157",227,146,146,3,0,"PODEMOS-IU",2
44,"44245",240,177,174,0,3,"PODEMOS-IU",12
13,"13044",2582,1838,1804,13,34,"PODEMOS-IU",98
28,"28164",3230,2371,2345,28,26,"PODEMOS-IU",229
6,"6155",1810,1172,1140,23,32,"PODEMOS-IU",114
47,"47067",153,112,112,3,0,"PODEMOS-IU",0
40,"40068",22,21,21,0,0,"PODEMOS-IU",0
39,"39077",237,151,148,1,3,"PODEMOS-IU",4
47,"47163",277,208,205,3,3,"PODEMOS-IU",28
26,"26147",34,26,25,0,1,"PODEMOS-IU",0
6,"6156",1170,829,814,12,15,"PODEMOS-IU",50
10,"10021",4987,3574,3475,31,99,"PODEMOS-IU",372
42,"42153",12,10,10,0,0,"PODEMOS-IU",2
28,"28007",127491,96937,96102,810,835,"PODEMOS-IU",13802
47,"47143",104,67,67,0,0,"PODEMOS-IU",2
44,"44246",1599,1012,1001,11,11,"PODEMOS-IU",114
40,"40069",68,59,59,0,0,"PODEMOS-IU",2
37,"37351",268,229,226,0,3,"PODEMOS-IU",3
47,"47068",29,21,21,0,0,"PODEMOS-IU",0
19,"19314",44,33,33,0,0,"PODEMOS-IU",1
42,"42105",47,40,40,2,0,"PODEMOS-IU",0
37,"37287",297,204,202,2,2,"PODEMOS-IU",2
19,"19019",14,11,11,1,0,"PODEMOS-IU",0
9,"9467",59,46,46,2,0,"PODEMOS-IU",2
28,"28101",226,174,172,1,2,"PODEMOS-IU",24
42,"42155",146,83,80,2,3,"PODEMOS-IU",0
37,"37061",195,136,136,1,0,"PODEMOS-IU",3
16,"16072",132,84,84,1,0,"PODEMOS-IU",0
30,"30031",497,387,382,1,5,"PODEMOS-IU",15
47,"47069",115,87,87,0,0,"PODEMOS-IU",2
50,"50109",95,65,62,2,3,"PODEMOS-IU",8
9,"9085",481,349,342,2,7,"PODEMOS-IU",32
45,"45198",1808,1442,1428,6,14,"PODEMOS-IU",53
49,"49219",7196,4613,4528,64,85,"PODEMOS-IU",441
50,"50261",201,154,151,0,3,"PODEMOS-IU",20
37,"37352",209,157,155,3,2,"PODEMOS-IU",4
44,"44068",634,497,493,2,4,"PODEMOS-IU",27
16,"16192",42,28,28,0,0,"PODEMOS-IU",1
16,"16001",62,45,45,0,0,"PODEMOS-IU",3
24,"24187",834,559,549,11,10,"PODEMOS-IU",43
47,"47009",98,84,84,0,0,"PODEMOS-IU",7
24,"24226",194,118,118,1,0,"PODEMOS-IU",2
9,"9250",264,195,193,3,2,"PODEMOS-IU",16
44,"44220",113,82,82,1,0,"PODEMOS-IU",0
45,"45089",1432,1076,1064,10,12,"PODEMOS-IU",162
42,"42023",57,48,48,0,0,"PODEMOS-IU",2
50,"50084",67,47,47,1,0,"PODEMOS-IU",1
47,"47070",29,24,24,0,0,"PODEMOS-IU",0
13,"13095",66,56,56,3,0,"PODEMOS-IU",3
50,"50188",26,23,23,0,0,"PODEMOS-IU",4
40,"40168",27,20,20,0,0,"PODEMOS-IU",7
40,"40146",260,206,204,0,2,"PODEMOS-IU",12
28,"28178",1149,869,853,4,16,"PODEMOS-IU",109
6,"6115",1243,808,798,8,10,"PODEMOS-IU",81
6,"6024",1123,876,849,3,27,"PODEMOS-IU",88
38,"38026",33585,24091,23889,170,202,"PODEMOS-IU",2685
40,"40201",42,37,37,0,0,"PODEMOS-IU",0
19,"19319",4609,3303,3273,22,30,"PODEMOS-IU",510
5,"5259",99,80,79,2,1,"PODEMOS-IU",6
16,"16194",219,169,161,0,8,"PODEMOS-IU",15
44,"44070",55,49,49,0,0,"PODEMOS-IU",0
16,"16078",41384,28809,28500,322,309,"PODEMOS-IU",2316
45,"45090",370,262,261,2,1,"PODEMOS-IU",8
45,"45201",3692,2198,2175,15,23,"PODEMOS-IU",259
44,"44071",585,419,418,6,1,"PODEMOS-IU",29
47,"47168",30,26,26,1,0,"PODEMOS-IU",3
47,"47073",116,80,79,2,1,"PODEMOS-IU",0
30,"30010",6852,5161,5106,25,55,"PODEMOS-IU",336
45,"45055",1004,768,755,4,13,"PODEMOS-IU",33
13,"13052",6288,4360,4278,36,82,"PODEMOS-IU",209
49,"49222",369,250,247,2,3,"PODEMOS-IU",20
6,"6902",1651,1198,1174,19,24,"PODEMOS-IU",94
49,"49110",344,196,195,2,1,"PODEMOS-IU",16
26,"26153",10,10,10,1,0,"PODEMOS-IU",1
9,"9093",162,131,131,1,0,"PODEMOS-IU",10
45,"45129",98,77,77,1,0,"PODEMOS-IU",15
37,"37198",202,147,144,2,3,"PODEMOS-IU",15
45,"45018",550,385,380,1,5,"PODEMOS-IU",66
9,"9312",89,68,68,1,0,"PODEMOS-IU",8
5,"5164",18,12,12,0,0,"PODEMOS-IU",0
47,"47232",96,67,65,0,2,"PODEMOS-IU",5
50,"50902",77,65,62,0,3,"PODEMOS-IU",3
42,"42065",23,18,18,1,0,"PODEMOS-IU",1
5,"5228",168,99,98,0,1,"PODEMOS-IU",2
13,"13902",449,329,326,4,3,"PODEMOS-IU",20
47,"47012",100,72,71,0,1,"PODEMOS-IU",1
50,"50240",943,693,683,12,10,"PODEMOS-IU",62
47,"47170",43,36,30,0,6,"PODEMOS-IU",1
9,"9482",34,22,22,0,0,"PODEMOS-IU",2
38,"38004",4536,2914,2887,28,27,"PODEMOS-IU",427
19,"19060",157,123,122,0,1,"PODEMOS-IU",42
44,"44252",73,56,55,0,1,"PODEMOS-IU",2
9,"9095",103,54,53,3,1,"PODEMOS-IU",1
6,"6030",168,131,128,1,3,"PODEMOS-IU",4
24,"24047",708,462,459,1,3,"PODEMOS-IU",26
47,"47106",44,30,30,0,0,"PODEMOS-IU",0
28,"28172",9915,7715,7652,60,63,"PODEMOS-IU",814
49,"49224",166,102,100,0,2,"PODEMOS-IU",12
37,"37107",10444,6997,6884,76,113,"PODEMOS-IU",393
37,"37034",77,63,62,0,1,"PODEMOS-IU",0
49,"49112",118,72,72,2,0,"PODEMOS-IU",11
5,"5195",199,125,125,1,0,"PODEMOS-IU",4
34,"34086",102,81,81,2,0,"PODEMOS-IU",7
37,"37200",190,132,131,0,1,"PODEMOS-IU",0
37,"37264",56,39,39,0,0,"PODEMOS-IU",4
49,"49113",162,131,131,2,0,"PODEMOS-IU",2
39,"39084",868,608,605,3,3,"PODEMOS-IU",28
40,"40142",52,39,37,0,2,"PODEMOS-IU",0
24,"24159",1716,1238,1216,6,22,"PODEMOS-IU",55
47,"47109",161,120,120,1,0,"PODEMOS-IU",8
9,"9050",57,38,38,1,0,"PODEMOS-IU",5
37,"37139",189,150,148,1,2,"PODEMOS-IU",14
34,"34045",72,62,62,0,0,"PODEMOS-IU",0
10,"10033",397,269,268,0,1,"PODEMOS-IU",2
28,"28111",629,479,475,2,4,"PODEMOS-IU",76
45,"45132",2387,1765,1754,13,11,"PODEMOS-IU",110
45,"45901",779,542,534,5,8,"PODEMOS-IU",40
34,"34134",44,25,25,0,0,"PODEMOS-IU",0
44,"44138",120,92,92,0,0,"PODEMOS-IU",4
6,"6034",171,114,114,2,0,"PODEMOS-IU",7
24,"24051",389,275,269,1,6,"PODEMOS-IU",12
44,"44077",68,52,51,0,1,"PODEMOS-IU",1
44,"44169",298,216,216,0,0,"PODEMOS-IU",7
16,"16122",244,184,182,1,2,"PODEMOS-IU",13
19,"19290",851,551,550,4,1,"PODEMOS-IU",73
47,"47173",879,627,622,9,5,"PODEMOS-IU",67
10,"10198",1053,897,889,4,8,"PODEMOS-IU",10
9,"9262",160,122,120,2,2,"PODEMOS-IU",3
49,"49039",324,249,239,3,10,"PODEMOS-IU",19
44,"44080",281,202,199,0,3,"PODEMOS-IU",23
9,"9102",33,22,22,0,0,"PODEMOS-IU",7
49,"49006",139,98,95,3,3,"PODEMOS-IU",7
39,"39011",1587,1178,1178,6,0,"PODEMOS-IU",76
6,"6050",4031,3005,2934,38,71,"PODEMOS-IU",192
19,"19134",23,14,14,0,0,"PODEMOS-IU",1
37,"37141",149,101,100,0,1,"PODEMOS-IU",12
40,"40143",82,68,67,2,1,"PODEMOS-IU",4
16,"16135",115,76,76,0,0,"PODEMOS-IU",4
5,"5232",104,86,83,1,3,"PODEMOS-IU",4
39,"39003",261,189,187,2,2,"PODEMOS-IU",13
9,"9430",25,21,21,0,0,"PODEMOS-IU",1
37,"37173",1412,951,937,15,14,"PODEMOS-IU",49
19,"19135",90,71,69,1,2,"PODEMOS-IU",4
28,"28176",13980,10765,10701,72,64,"PODEMOS-IU",683
44,"44260",137,93,93,1,0,"PODEMOS-IU",2
30,"30015",19344,13502,13347,107,155,"PODEMOS-IU",799
40,"40177",139,106,105,0,1,"PODEMOS-IU",4
13,"13062",567,450,446,4,4,"PODEMOS-IU",33
49,"49264",529,334,329,2,5,"PODEMOS-IU",12
47,"47207",256,198,195,3,3,"PODEMOS-IU",4
50,"50144",31,24,24,0,0,"PODEMOS-IU",2
9,"9007",54,37,35,0,2,"PODEMOS-IU",0
19,"19327",385,313,308,2,5,"PODEMOS-IU",0
16,"16088",100,86,86,0,0,"PODEMOS-IU",5
37,"37268",106,62,61,1,1,"PODEMOS-IU",0
37,"37362",4783,3469,3420,44,49,"PODEMOS-IU",271
28,"28147",991,702,698,4,4,"PODEMOS-IU",79
40,"40178",85,61,60,0,1,"PODEMOS-IU",2
5,"5201",497,404,401,0,3,"PODEMOS-IU",18
37,"37039",279,202,197,2,5,"PODEMOS-IU",4
47,"47019",92,68,68,1,0,"PODEMOS-IU",4
28,"28039",134,93,93,1,0,"PODEMOS-IU",10
6,"6083",46577,31113,30748,338,365,"PODEMOS-IU",3438
49,"49265",110,79,78,2,1,"PODEMOS-IU",3
34,"34190",50,33,33,1,0,"PODEMOS-IU",0
44,"44114",233,161,159,0,2,"PODEMOS-IU",7
42,"42035",730,464,460,3,4,"PODEMOS-IU",14
9,"9164",147,112,111,0,1,"PODEMOS-IU",5
34,"34094",61,45,45,2,0,"PODEMOS-IU",2
24,"24092",731,506,504,1,2,"PODEMOS-IU",39
9,"9024",150,100,99,1,1,"PODEMOS-IU",9
26,"26059",1109,801,791,6,10,"PODEMOS-IU",41
50,"50196",101,73,73,0,0,"PODEMOS-IU",6
49,"49009",382,251,251,0,0,"PODEMOS-IU",13
9,"9270",157,112,109,2,3,"PODEMOS-IU",3
37,"37364",760,502,500,0,2,"PODEMOS-IU",18
37,"37078",781,626,603,9,23,"PODEMOS-IU",44
50,"50147",744,508,506,5,2,"PODEMOS-IU",53
37,"37114",74,58,55,1,3,"PODEMOS-IU",0
37,"37302",262,161,161,2,0,"PODEMOS-IU",4
9,"9908",423,254,253,4,1,"PODEMOS-IU",31
13,"13021",412,325,320,1,5,"PODEMOS-IU",20
6,"6086",1174,767,750,6,17,"PODEMOS-IU",62
10,"10001",287,207,203,2,4,"PODEMOS-IU",13
47,"47210",399,278,275,3,3,"PODEMOS-IU",15
9,"9110",77,50,50,0,0,"PODEMOS-IU",1
49,"49120",54,35,35,0,0,"PODEMOS-IU",0
19,"19234",44,30,30,0,0,"PODEMOS-IU",3
37,"37207",336,244,240,4,4,"PODEMOS-IU",23
37,"37365",162,125,121,0,4,"PODEMOS-IU",1
10,"10205",1934,1071,1042,4,29,"PODEMOS-IU",127
37,"37177",259,198,197,3,1,"PODEMOS-IU",6
16,"16092",149,108,108,1,0,"PODEMOS-IU",4
5,"5005",165,127,119,0,8,"PODEMOS-IU",4
50,"50271",246,179,173,4,6,"PODEMOS-IU",12
34,"34099",53,44,42,0,2,"PODEMOS-IU",4
39,"39092",863,534,533,3,1,"PODEMOS-IU",42
50,"50045",1217,891,878,10,13,"PODEMOS-IU",60
10,"10002",360,239,236,1,3,"PODEMOS-IU",13
5,"5043",73,58,58,0,0,"PODEMOS-IU",6
26,"26050",125,92,91,1,1,"PODEMOS-IU",11
49,"49234",394,282,277,0,5,"PODEMOS-IU",14
44,"44175",112,76,75,1,1,"PODEMOS-IU",7
19,"19040",53,43,42,1,1,"PODEMOS-IU",5
26,"26051",213,165,165,1,0,"PODEMOS-IU",17
9,"9274",1035,774,762,8,12,"PODEMOS-IU",72
16,"16052",539,422,419,3,3,"PODEMOS-IU",40
44,"44052",75,54,54,0,0,"PODEMOS-IU",3
45,"45069",1820,1370,1355,1,15,"PODEMOS-IU",117
40,"40150",60,42,42,0,0,"PODEMOS-IU",4
19,"19237",39,34,34,0,0,"PODEMOS-IU",3
10,"10126",1455,966,948,9,18,"PODEMOS-IU",43
24,"24023",264,188,185,1,3,"PODEMOS-IU",19
16,"16170",646,451,449,5,2,"PODEMOS-IU",44
47,"47085",16330,11556,11419,121,137,"PODEMOS-IU",1084
45,"45106",7418,5380,5306,34,74,"PODEMOS-IU",513
42,"42129",678,485,480,6,5,"PODEMOS-IU",23
24,"24168",430,325,322,6,3,"PODEMOS-IU",13
42,"42003",65,49,47,0,2,"PODEMOS-IU",1
2,"2064",371,288,283,2,5,"PODEMOS-IU",12
45,"45070",1412,1158,1136,7,22,"PODEMOS-IU",90
24,"24132",610,330,329,5,1,"PODEMOS-IU",36
5,"5110",696,469,464,2,5,"PODEMOS-IU",16
44,"44234",71,49,49,0,0,"PODEMOS-IU",4
50,"50224",61,44,44,2,0,"PODEMOS-IU",1
6,"6001",664,474,460,3,14,"PODEMOS-IU",33
24,"24060",561,297,296,2,1,"PODEMOS-IU",18
19,"19042",22,18,17,0,1,"PODEMOS-IU",0
19,"19334",43,35,35,0,0,"PODEMOS-IU",4
16,"16095",82,70,70,1,0,"PODEMOS-IU",4
5,"5209",74,58,58,1,0,"PODEMOS-IU",0
39,"39094",840,611,611,2,0,"PODEMOS-IU",42
34,"34058",182,152,152,0,0,"PODEMOS-IU",4
2,"2033",1864,1352,1315,12,37,"PODEMOS-IU",146
19,"19300",782,591,588,5,3,"PODEMOS-IU",94
38,"38039",11149,7375,7326,68,49,"PODEMOS-IU",672
24,"24210",524,353,353,1,0,"PODEMOS-IU",32
5,"5241",3062,2011,1977,21,34,"PODEMOS-IU",170
13,"13074",943,759,749,5,10,"PODEMOS-IU",39
10,"10089",1334,864,837,8,27,"PODEMOS-IU",80
9,"9443",151,113,112,0,1,"PODEMOS-IU",6
24,"24062",126,79,79,0,0,"PODEMOS-IU",13
28,"28901",890,624,618,5,6,"PODEMOS-IU",96
9,"9019",146,105,103,4,2,"PODEMOS-IU",10
39,"39039",540,355,355,1,0,"PODEMOS-IU",17
39,"39040",4271,3103,3080,18,23,"PODEMOS-IU",224
37,"37276",125,92,92,0,0,"PODEMOS-IU",2
37,"37016",563,419,411,4,8,"PODEMOS-IU",34
34,"34060",133,109,107,0,2,"PODEMOS-IU",8
13,"13030",115,81,81,0,0,"PODEMOS-IU",2
44,"44090",66,49,49,0,0,"PODEMOS-IU",1
34,"34154",77,48,48,1,0,"PODEMOS-IU",6
37,"37340",141,97,97,1,0,"PODEMOS-IU",0
49,"49064",478,297,296,6,1,"PODEMOS-IU",10
50,"50259",82,55,55,2,0,"PODEMOS-IU",5
9,"9280",26,18,18,0,0,"PODEMOS-IU",0
16,"16270",154,123,122,1,1,"PODEMOS-IU",4
13,"13076",455,359,356,0,3,"PODEMOS-IU",13
45,"45159",83,71,69,0,2,"PODEMOS-IU",0
28,"28089",3856,2866,2829,21,37,"PODEMOS-IU",332
37,"37183",377,267,267,5,0,"PODEMOS-IU",6
26,"26057",50,45,45,2,0,"PODEMOS-IU",1
24,"24064",1501,1030,1012,2,18,"PODEMOS-IU",171
50,"50276",118,91,91,0,0,"PODEMOS-IU",2
40,"40188",83,63,60,0,3,"PODEMOS-IU",4
5,"5243",80,57,56,1,1,"PODEMOS-IU",2
28,"28090",9252,7216,7153,58,63,"PODEMOS-IU",986
13,"13077",3383,2050,1997,20,53,"PODEMOS-IU",157
19,"19080",67,47,47,0,0,"PODEMOS-IU",8
24,"24174",457,294,289,3,5,"PODEMOS-IU",21
37,"37278",793,570,567,6,3,"PODEMOS-IU",63
39,"39013",517,359,356,1,3,"PODEMOS-IU",13
37,"37018",106,75,75,0,0,"PODEMOS-IU",2
50,"50025",4541,3110,3083,39,27,"PODEMOS-IU",218
44,"44093",78,62,61,0,1,"PODEMOS-IU",1
19,"19151",1077,703,693,8,10,"PODEMOS-IU",89
40,"40189",471,344,329,1,15,"PODEMOS-IU",23
37,"37185",539,372,363,2,9,"PODEMOS-IU",24
34,"34108",499,391,384,3,7,"PODEMOS-IU",18
47,"47186",244314,182449,180833,1818,1616,"PODEMOS-IU",21030
49,"49019",232,162,152,2,10,"PODEMOS-IU",5
42,"42010",21,15,14,0,1,"PODEMOS-IU",0
16,"16100",642,518,514,2,4,"PODEMOS-IU",24
28,"28092",153631,112460,111341,913,1119,"PODEMOS-IU",15700
19,"19046",22204,16001,15752,156,249,"PODEMOS-IU",2306
44,"44152",70,46,46,0,0,"PODEMOS-IU",1
5,"5181",46,34,34,0,0,"PODEMOS-IU",3
10,"10134",550,361,354,1,7,"PODEMOS-IU",15
5,"5016",6355,4677,4584,28,93,"PODEMOS-IU",290
16,"16227",109,78,76,0,2,"PODEMOS-IU",2
2,"2071",1027,800,795,7,5,"PODEMOS-IU",26
16,"16113",3065,2142,2108,13,34,"PODEMOS-IU",125
16,"16209",110,95,94,2,1,"PODEMOS-IU",12
10,"10176",344,223,213,2,10,"PODEMOS-IU",20
42,"42141",101,59,59,0,0,"PODEMOS-IU",3
47,"47126",42,35,35,1,0,"PODEMOS-IU",0
49,"49166",1193,835,821,7,14,"PODEMOS-IU",74
44,"44032",17,13,13,0,0,"PODEMOS-IU",0
10,"10053",279,171,169,1,2,"PODEMOS-IU",4
40,"40222",161,134,131,1,3,"PODEMOS-IU",9
34,"34022",1022,813,798,7,15,"PODEMOS-IU",34
47,"47061",237,185,184,0,1,"PODEMOS-IU",9
16,"16177",83,65,65,1,0,"PODEMOS-IU",3
16,"16103",235,183,181,2,2,"PODEMOS-IU",6
42,"42144",419,302,298,6,4,"PODEMOS-IU",28
9,"9181",276,194,191,7,3,"PODEMOS-IU",13
5,"5119",24,17,17,1,0,"PODEMOS-IU",0
42,"42012",29,22,22,0,0,"PODEMOS-IU",1
9,"9451",237,196,189,1,7,"PODEMOS-IU",26
50,"50279",74,49,49,0,0,"PODEMOS-IU",5
40,"40191",198,143,138,0,5,"PODEMOS-IU",19
16,"16185",36,31,31,0,0,"PODEMOS-IU",1
26,"26062",85,62,62,1,0,"PODEMOS-IU",4
42,"42189",57,43,43,0,0,"PODEMOS-IU",2
44,"44240",151,119,117,0,2,"PODEMOS-IU",4
9,"9074",844,610,609,12,1,"PODEMOS-IU",66
47,"47032",147,102,102,0,0,"PODEMOS-IU",7
10,"10016",329,242,232,2,10,"PODEMOS-IU",15
24,"24178",60,54,54,1,0,"PODEMOS-IU",0
19,"19119",76,65,65,0,0,"PODEMOS-IU",6
37,"37377",215,174,173,0,1,"PODEMOS-IU",5
45,"45116",666,492,489,4,3,"PODEMOS-IU",29
37,"37376",2130,1446,1423,18,23,"PODEMOS-IU",53
10,"10057",126,90,89,1,1,"PODEMOS-IU",8
39,"39017",550,378,372,1,6,"PODEMOS-IU",11
9,"9183",42,32,32,0,0,"PODEMOS-IU",3
47,"47222",85,70,70,1,0,"PODEMOS-IU",3
19,"19015",82,74,73,1,1,"PODEMOS-IU",3
6,"6105",592,367,363,1,4,"PODEMOS-IU",19
50,"50281",68,52,50,0,2,"PODEMOS-IU",2
24,"24179",287,207,207,2,0,"PODEMOS-IU",10
9,"9456",130,86,86,1,0,"PODEMOS-IU",5
42,"42053",21,17,17,0,0,"PODEMOS-IU",0
39,"39018",4284,3211,3177,22,34,"PODEMOS-IU",356
37,"37283",116,83,83,0,0,"PODEMOS-IU",3
6,"6152",1273,888,867,7,21,"PODEMOS-IU",81
50,"50207",87,58,58,1,0,"PODEMOS-IU",5
9,"9077",26,21,21,0,0,"PODEMOS-IU",0
44,"44243",25,19,19,0,0,"PODEMOS-IU",1
38,"38045",3542,1825,1801,7,24,"PODEMOS-IU",239
19,"19120",107,86,86,1,0,"PODEMOS-IU",5
50,"50105",277,203,198,4,5,"PODEMOS-IU",32
49,"49003",860,534,530,5,4,"PODEMOS-IU",18
24,"24180",1086,767,759,9,8,"PODEMOS-IU",37
47,"47129",855,660,648,7,12,"PODEMOS-IU",48
10,"10018",1605,974,948,16,26,"PODEMOS-IU",55
28,"28130",28569,22050,21799,187,251,"PODEMOS-IU",3517
9,"9354",34,31,31,2,0,"PODEMOS-IU",2
39,"39019",2232,1628,1603,10,25,"PODEMOS-IU",144
28,"28097",126,87,87,2,0,"PODEMOS-IU",18
45,"45119",3499,2217,2190,3,27,"PODEMOS-IU",307
47,"47097",305,239,237,0,2,"PODEMOS-IU",21
19,"19247",140,103,102,1,1,"PODEMOS-IU",13
9,"9301",658,497,488,5,9,"PODEMOS-IU",56
26,"26066",263,201,194,5,7,"PODEMOS-IU",15
40,"40195",776,573,565,4,8,"PODEMOS-IU",31
35,"35008",6214,4193,4143,33,50,"PODEMOS-IU",605
45,"45010",383,258,257,3,1,"PODEMOS-IU",21
49,"49026",199,134,134,0,0,"PODEMOS-IU",2
28,"28099",1950,1409,1404,16,5,"PODEMOS-IU",111
47,"47225",73,61,59,1,2,"PODEMOS-IU",1
42,"42056",28,25,24,0,1,"PODEMOS-IU",1
37,"37255",43,33,31,1,2,"PODEMOS-IU",0
24,"24182",410,273,270,7,3,"PODEMOS-IU",18
49,"49027",125,82,81,0,1,"PODEMOS-IU",3
5,"5024",193,127,125,2,2,"PODEMOS-IU",9
26,"26067",22,18,18,3,0,"PODEMOS-IU",1
24,"24074",97,70,70,1,0,"PODEMOS-IU",3
47,"47098",567,452,446,4,6,"PODEMOS-IU",49
45,"45011",279,235,233,4,2,"PODEMOS-IU",4
16,"16110",90,70,70,1,0,"PODEMOS-IU",0
49,"49137",167,123,121,0,2,"PODEMOS-IU",4
13,"13090",1005,754,733,4,21,"PODEMOS-IU",19
19,"19220",2608,1673,1653,10,20,"PODEMOS-IU",287
19,"19065",109,86,85,1,1,"PODEMOS-IU",12
9,"9213",264,182,182,1,0,"PODEMOS-IU",26
19,"19104",19,15,14,0,1,"PODEMOS-IU",0
2,"2023",504,419,412,0,7,"PODEMOS-IU",18
10,"10104",5123,3470,3396,21,74,"PODEMOS-IU",240
30,"30014",1587,1150,1134,4,16,"PODEMOS-IU",85
37,"37099",63,46,46,1,0,"PODEMOS-IU",0
24,"24076",1283,926,913,10,13,"PODEMOS-IU",117
49,"49029",609,435,419,6,16,"PODEMOS-IU",16
5,"5256",110,88,86,1,2,"PODEMOS-IU",5
10,"10023",842,597,589,2,8,"PODEMOS-IU",26
44,"44159",37,27,27,1,0,"PODEMOS-IU",5
24,"24151",433,307,304,1,3,"PODEMOS-IU",20
9,"9248",80,62,61,1,1,"PODEMOS-IU",2
45,"45013",1679,1266,1248,5,18,"PODEMOS-IU",53
19,"19160",883,535,530,11,5,"PODEMOS-IU",84
47,"47008",22,13,13,0,0,"PODEMOS-IU",3
5,"5025",78,65,65,0,0,"PODEMOS-IU",0
42,"42021",65,46,45,2,1,"PODEMOS-IU",2
45,"45014",4039,2606,2552,35,54,"PODEMOS-IU",315
19,"19161",212,158,157,3,1,"PODEMOS-IU",22
10,"10106",126,102,102,0,0,"PODEMOS-IU",8
16,"16242",300,245,243,2,2,"PODEMOS-IU",9
13,"13094",294,216,215,1,1,"PODEMOS-IU",7
37,"37288",281,220,218,4,2,"PODEMOS-IU",6
49,"49252",312,240,236,7,4,"PODEMOS-IU",18
35,"35033",6393,4147,4072,38,75,"PODEMOS-IU",507
45,"45052",3132,2433,2416,29,17,"PODEMOS-IU",292
37,"37165",31,22,22,0,0,"PODEMOS-IU",0
10,"10108",203,116,116,1,0,"PODEMOS-IU",4
38,"38050",2417,1288,1273,9,15,"PODEMOS-IU",149
5,"5128",339,258,253,5,5,"PODEMOS-IU",38
37,"37322",2462,1580,1537,14,43,"PODEMOS-IU",166
34,"34079",1729,1296,1275,19,21,"PODEMOS-IU",92
38,"38001",21069,10844,10777,63,67,"PODEMOS-IU",1496
40,"40005",25,23,23,1,0,"PODEMOS-IU",1
45,"45200",4471,3351,3269,25,82,"PODEMOS-IU",203
24,"24165",317,202,199,1,3,"PODEMOS-IU",8
49,"49096",155,113,112,2,1,"PODEMOS-IU",4
49,"49042",229,166,164,2,2,"PODEMOS-IU",16
13,"13020",4701,3114,3069,42,45,"PODEMOS-IU",290
35,"35019",32830,18390,18243,87,147,"PODEMOS-IU",2322
34,"34004",5517,3819,3769,36,50,"PODEMOS-IU",361
6,"6116",1500,1015,998,7,17,"PODEMOS-IU",76
44,"44193",73,60,60,1,0,"PODEMOS-IU",7
40,"40105",43,35,35,0,0,"PODEMOS-IU",6
45,"45127",775,510,502,1,8,"PODEMOS-IU",62
49,"49033",655,440,434,4,6,"PODEMOS-IU",16
42,"42158",97,73,73,1,0,"PODEMOS-IU",7
9,"9310",15,14,11,0,3,"PODEMOS-IU",4
28,"28032",5090,3716,3675,22,41,"PODEMOS-IU",391
9,"9311",59,45,45,0,0,"PODEMOS-IU",4
13,"13097",2186,1592,1574,5,18,"PODEMOS-IU",86
5,"5096",76,62,62,0,0,"PODEMOS-IU",10
50,"50036",100,76,76,1,0,"PODEMOS-IU",12
40,"40234",375,278,269,3,9,"PODEMOS-IU",10
24,"24008",8931,6291,6214,79,77,"PODEMOS-IU",563
37,"37103",409,295,294,2,1,"PODEMOS-IU",17
9,"9144",44,31,31,0,0,"PODEMOS-IU",1
5,"5227",341,230,228,1,2,"PODEMOS-IU",30
28,"28107",442,316,310,5,6,"PODEMOS-IU",32
13,"13901",875,628,619,1,9,"PODEMOS-IU",27
35,"35013",6593,4596,4516,47,80,"PODEMOS-IU",518
42,"42113",510,370,366,2,4,"PODEMOS-IU",16
47,"47043",306,241,240,4,1,"PODEMOS-IU",8
34,"34179",25,18,16,0,2,"PODEMOS-IU",0
6,"6027",645,523,513,0,10,"PODEMOS-IU",52
37,"37068",337,240,236,1,4,"PODEMOS-IU",3
39,"39054",4541,3271,3252,30,19,"PODEMOS-IU",293
26,"26002",821,611,597,1,14,"PODEMOS-IU",41
42,"42027",72,48,47,1,1,"PODEMOS-IU",3
9,"9372",204,175,169,2,6,"PODEMOS-IU",12
19,"19130",61556,45926,45388,408,538,"PODEMOS-IU",4327
24,"24118",101,72,72,0,0,"PODEMOS-IU",6
49,"49035",220,180,180,4,0,"PODEMOS-IU",8
44,"44109",99,64,64,0,0,"PODEMOS-IU",4
49,"49076",330,230,226,9,4,"PODEMOS-IU",8
5,"5065",452,339,337,2,2,"PODEMOS-IU",13
6,"6121",3276,2301,2256,30,45,"PODEMOS-IU",184
19,"19166",154,110,108,0,2,"PODEMOS-IU",10
40,"40107",90,67,67,0,0,"PODEMOS-IU",3
47,"47105",169,138,137,2,1,"PODEMOS-IU",6
13,"13903",498,395,394,0,1,"PODEMOS-IU",15
37,"37138",222,163,159,3,4,"PODEMOS-IU",6
16,"16910",75,44,44,1,0,"PODEMOS-IU",6
50,"50215",20,14,14,0,0,"PODEMOS-IU",6
44,"44045",360,271,271,0,0,"PODEMOS-IU",12
47,"47181",165,136,135,1,1,"PODEMOS-IU",12
39,"39056",2262,1683,1671,14,12,"PODEMOS-IU",92
47,"47044",323,273,270,4,3,"PODEMOS-IU",41
50,"50216",236,169,167,0,2,"PODEMOS-IU",6
10,"10032",1588,1114,1099,6,15,"PODEMOS-IU",87
9,"9316",104,80,80,0,0,"PODEMOS-IU",1
24,"24084",153,105,102,2,3,"PODEMOS-IU",3
44,"44018",16,16,16,0,0,"PODEMOS-IU",0
9,"9100",55,33,33,0,0,"PODEMOS-IU",1
5,"5263",162,117,115,1,2,"PODEMOS-IU",1
49,"49183",90,67,65,2,2,"PODEMOS-IU",2
2,"2054",375,288,283,0,5,"PODEMOS-IU",21
34,"34133",101,75,73,0,2,"PODEMOS-IU",5
37,"37296",297,215,210,0,5,"PODEMOS-IU",4
44,"44224",21,14,14,2,0,"PODEMOS-IU",0
38,"38006",41593,20823,20624,127,199,"PODEMOS-IU",2783
47,"47015",177,129,129,0,0,"PODEMOS-IU",12
24,"24087",582,431,427,3,4,"PODEMOS-IU",23
37,"37036",55,36,34,0,2,"PODEMOS-IU",1
34,"34182",746,558,553,9,5,"PODEMOS-IU",24
37,"37108",98,75,75,3,0,"PODEMOS-IU",3
37,"37202",1004,773,763,12,10,"PODEMOS-IU",82
19,"19259",28,22,22,0,0,"PODEMOS-IU",5
44,"44019",70,42,42,0,0,"PODEMOS-IU",1
34,"34184",49,37,35,0,2,"PODEMOS-IU",5
37,"37360",206,135,135,1,0,"PODEMOS-IU",3
10,"10116",3737,2579,2507,34,72,"PODEMOS-IU",349
39,"39030",1874,1199,1187,6,12,"PODEMOS-IU",138
5,"5198",70,53,51,0,2,"PODEMOS-IU",0
42,"42031",25,17,17,1,0,"PODEMOS-IU",0
50,"50291",95,76,76,0,0,"PODEMOS-IU",1
42,"42165",414,246,237,4,9,"PODEMOS-IU",17
6,"6140",612,456,451,1,5,"PODEMOS-IU",7
45,"45146",101,79,79,0,0,"PODEMOS-IU",5
49,"49092",115,72,72,0,0,"PODEMOS-IU",0
30,"30022",17108,11041,10851,100,190,"PODEMOS-IU",936
37,"37330",314,227,223,2,4,"PODEMOS-IU",7
28,"28017",1280,975,963,10,12,"PODEMOS-IU",179
5,"5179",199,176,172,1,4,"PODEMOS-IU",2
44,"44226",123,85,84,0,1,"PODEMOS-IU",2
9,"9003",182,134,132,1,2,"PODEMOS-IU",23
44,"44199",39,37,37,2,0,"PODEMOS-IU",0
24,"24198",541,346,344,6,2,"PODEMOS-IU",22
35,"35017",27498,15513,15240,121,273,"PODEMOS-IU",2500
5,"5136",83,55,55,0,0,"PODEMOS-IU",2
16,"16011",20,14,14,0,0,"PODEMOS-IU",1
10,"10200",336,243,242,0,1,"PODEMOS-IU",7
9,"9326",156,111,110,1,1,"PODEMOS-IU",9
47,"47112",2561,1960,1933,13,27,"PODEMOS-IU",77
44,"44227",72,58,58,0,0,"PODEMOS-IU",2
13,"13016",656,463,454,3,9,"PODEMOS-IU",17
26,"26009",394,282,278,1,4,"PODEMOS-IU",42
37,"37331",186,115,114,2,1,"PODEMOS-IU",1
5,"5039",47,43,43,0,0,"PODEMOS-IU",5
50,"50219",4283,3034,2990,30,44,"PODEMOS-IU",347
49,"49152",474,289,282,2,7,"PODEMOS-IU",18
10,"10038",83,59,59,0,0,"PODEMOS-IU",4
50,"50170",357,245,242,6,3,"PODEMOS-IU",9
16,"16255",132,99,99,0,0,"PODEMOS-IU",1
19,"19262",125,98,98,0,0,"PODEMOS-IU",8
6,"6129",577,438,416,1,22,"PODEMOS-IU",29
19,"19106",77,57,57,0,0,"PODEMOS-IU",8
16,"16048",404,300,298,2,2,"PODEMOS-IU",8
9,"9216",370,245,241,3,4,"PODEMOS-IU",32
9,"9906",1185,883,877,16,6,"PODEMOS-IU",80
24,"24055",674,484,482,8,2,"PODEMOS-IU",37
47,"47177",104,78,78,0,0,"PODEMOS-IU",8
9,"9108",433,315,311,3,4,"PODEMOS-IU",43
10,"10081",176,121,119,0,2,"PODEMOS-IU",10
28,"28116",748,576,569,2,7,"PODEMOS-IU",74
37,"37249",37,28,28,0,0,"PODEMOS-IU",2
13,"13050",475,348,345,1,3,"PODEMOS-IU",7
16,"16062",25,20,20,0,0,"PODEMOS-IU",5
2,"2038",262,197,193,0,4,"PODEMOS-IU",7
37,"37312",244,191,189,1,2,"PODEMOS-IU",6
37,"37052",287,192,191,2,1,"PODEMOS-IU",11
49,"49266",66,46,45,1,1,"PODEMOS-IU",1
34,"34243",323,243,239,1,4,"PODEMOS-IU",19
40,"40049",37,27,27,0,0,"PODEMOS-IU",4
9,"9434",1279,966,956,11,10,"PODEMOS-IU",130
9,"9386",55,43,43,0,0,"PODEMOS-IU",2
2,"2027",274,209,203,1,6,"PODEMOS-IU",6
50,"50068",1943,1299,1287,10,12,"PODEMOS-IU",91
50,"50172",174,125,123,2,2,"PODEMOS-IU",5
26,"26012",37,28,28,1,0,"PODEMOS-IU",0
47,"47115",276,212,211,1,1,"PODEMOS-IU",4
19,"19174",90,65,64,0,1,"PODEMOS-IU",12
45,"45140",1075,788,772,10,16,"PODEMOS-IU",49
44,"44116",75,58,58,0,0,"PODEMOS-IU",0
16,"16263",967,724,721,3,3,"PODEMOS-IU",39
50,"50222",1574,1024,1008,12,16,"PODEMOS-IU",55
47,"47211",48,37,37,1,0,"PODEMOS-IU",0
28,"28042",1261,918,908,9,10,"PODEMOS-IU",122
42,"42038",33,22,22,1,0,"PODEMOS-IU",1
34,"34143",161,115,112,2,3,"PODEMOS-IU",3
24,"24205",990,678,667,6,11,"PODEMOS-IU",72
6,"6088",12527,8326,8198,89,128,"PODEMOS-IU",1003
16,"16015",349,242,239,6,3,"PODEMOS-IU",14
39,"39091",1881,1297,1291,8,6,"PODEMOS-IU",91
24,"24167",703,436,430,3,6,"PODEMOS-IU",40
49,"49192",123,93,90,2,3,"PODEMOS-IU",2
47,"47116",396,304,302,2,2,"PODEMOS-IU",19
34,"34006",79,73,69,2,4,"PODEMOS-IU",3
50,"50148",304,213,211,2,2,"PODEMOS-IU",12
19,"19175",29,18,17,1,1,"PODEMOS-IU",3
5,"5142",88,76,75,0,1,"PODEMOS-IU",0
9,"9332",137,93,91,2,2,"PODEMOS-IU",11
28,"28013",41661,29431,29168,241,263,"PODEMOS-IU",3723
9,"9114",77,60,59,0,1,"PODEMOS-IU",2
38,"38036",6857,4170,4090,37,80,"PODEMOS-IU",499
40,"40083",73,52,52,1,0,"PODEMOS-IU",1
37,"37211",208,148,148,0,0,"PODEMOS-IU",5
6,"6136",1489,1086,1060,11,26,"PODEMOS-IU",85
13,"13071",37945,24340,24091,227,249,"PODEMOS-IU",2815
37,"37273",85,58,58,2,0,"PODEMOS-IU",1
28,"28119",2294,1760,1738,12,22,"PODEMOS-IU",177
5,"5238",728,529,525,1,4,"PODEMOS-IU",48
42,"42175",22,16,16,0,0,"PODEMOS-IU",0
49,"49270",139,93,92,0,1,"PODEMOS-IU",8
49,"49193",428,261,253,3,8,"PODEMOS-IU",13
44,"44053",103,87,85,1,2,"PODEMOS-IU",0
49,"49260",693,480,473,3,7,"PODEMOS-IU",18
24,"24024",636,407,403,6,4,"PODEMOS-IU",41
49,"49158",206,159,155,0,4,"PODEMOS-IU",10
37,"37305",219,177,175,2,2,"PODEMOS-IU",15
42,"42084",20,15,15,0,0,"PODEMOS-IU",0
49,"49048",113,88,88,0,0,"PODEMOS-IU",4
49,"49088",80,51,51,0,0,"PODEMOS-IU",2
37,"37149",60,50,50,0,0,"PODEMOS-IU",0
44,"44266",102,81,79,0,2,"PODEMOS-IU",3
44,"44148",74,56,54,0,2,"PODEMOS-IU",0
49,"49159",269,182,182,2,0,"PODEMOS-IU",18
34,"34152",124,99,94,0,5,"PODEMOS-IU",5
37,"37181",265,158,158,0,0,"PODEMOS-IU",3
24,"24061",1753,1234,1223,10,11,"PODEMOS-IU",121
40,"40184",245,196,194,0,2,"PODEMOS-IU",9
16,"16056",442,275,270,4,5,"PODEMOS-IU",7
30,"30021",9498,6251,6193,36,58,"PODEMOS-IU",300
37,"37083",181,155,153,1,2,"PODEMOS-IU",7
9,"9338",225,174,172,3,2,"PODEMOS-IU",8
45,"45145",2631,1746,1707,12,39,"PODEMOS-IU",157
40,"40216",785,633,621,9,12,"PODEMOS-IU",38
30,"30902",8294,5235,5174,29,61,"PODEMOS-IU",477
26,"26054",291,225,223,3,2,"PODEMOS-IU",10
9,"9227",112,89,89,1,0,"PODEMOS-IU",2
42,"42134",2651,1875,1836,21,39,"PODEMOS-IU",187
19,"19147",42,32,32,0,0,"PODEMOS-IU",5
9,"9444",63,40,40,1,0,"PODEMOS-IU",0
24,"24172",389,208,202,1,6,"PODEMOS-IU",12
49,"49016",230,155,155,0,0,"PODEMOS-IU",9
34,"34015",37,24,24,0,0,"PODEMOS-IU",5
16,"16057",62,45,45,0,0,"PODEMOS-IU",8
44,"44010",185,144,143,0,1,"PODEMOS-IU",8
49,"49103",392,319,316,5,3,"PODEMOS-IU",14
24,"24150",226,163,162,0,1,"PODEMOS-IU",8
26,"26132",106,73,70,2,3,"PODEMOS-IU",7
50,"50074",6156,4100,4022,33,78,"PODEMOS-IU",328
37,"37319",88,68,64,2,4,"PODEMOS-IU",3
28,"28165",1917,1339,1321,2,18,"PODEMOS-IU",87
10,"10132",360,251,243,1,8,"PODEMOS-IU",4
26,"26095",93,71,68,0,3,"PODEMOS-IU",9
9,"9229",178,127,127,1,0,"PODEMOS-IU",10
39,"39068",642,442,438,1,4,"PODEMOS-IU",40
9,"9021",50,30,30,3,0,"PODEMOS-IU",6
37,"37215",133,93,90,1,3,"PODEMOS-IU",2
37,"37341",47,29,29,0,0,"PODEMOS-IU",5
40,"40219",573,382,366,5,16,"PODEMOS-IU",33
2,"2002",427,340,337,2,3,"PODEMOS-IU",9
44,"44002",47,41,41,0,0,"PODEMOS-IU",6
42,"42059",20,14,14,0,0,"PODEMOS-IU",0
10,"10147",1277,873,837,6,36,"PODEMOS-IU",103
9,"9022",58,46,46,1,0,"PODEMOS-IU",3
49,"49201",283,232,228,3,4,"PODEMOS-IU",17
10,"10214",216,170,170,2,0,"PODEMOS-IU",9
50,"50001",89,68,68,0,0,"PODEMOS-IU",0
10,"10024",672,492,480,6,12,"PODEMOS-IU",53
47,"47218",981,728,723,4,5,"PODEMOS-IU",122
6,"6099",1156,683,652,5,31,"PODEMOS-IU",46
16,"16024",121,85,84,0,1,"PODEMOS-IU",10
28,"28049",57814,44977,44559,385,418,"PODEMOS-IU",7127
24,"24214",626,438,433,8,5,"PODEMOS-IU",42
45,"45149",517,400,393,2,7,"PODEMOS-IU",33
38,"38017",30964,16228,16102,108,126,"PODEMOS-IU",2238
49,"49055",91,72,72,3,0,"PODEMOS-IU",4
16,"16140",18,14,14,1,0,"PODEMOS-IU",1
24,"24066",439,274,273,3,1,"PODEMOS-IU",13
9,"9071",39,29,29,1,0,"PODEMOS-IU",2
45,"45077",546,413,409,0,4,"PODEMOS-IU",46
13,"13035",947,704,690,6,14,"PODEMOS-IU",52
13,"13034",58768,42473,42028,359,445,"PODEMOS-IU",4109
9,"9472",52,40,38,0,2,"PODEMOS-IU",2
40,"40016",55,44,43,1,1,"PODEMOS-IU",4
44,"44022",464,330,325,1,5,"PODEMOS-IU",15
39,"39061",3470,2605,2591,14,14,"PODEMOS-IU",221
39,"39005",1419,1039,1030,9,9,"PODEMOS-IU",78
50,"50246",37,24,24,0,0,"PODEMOS-IU",1
34,"34066",54,47,47,1,0,"PODEMOS-IU",2
24,"24030",4158,2746,2696,18,50,"PODEMOS-IU",454
50,"50164",381,245,243,3,2,"PODEMOS-IU",28
47,"47031",191,141,140,0,1,"PODEMOS-IU",2
30,"30001",4507,3357,3331,17,26,"PODEMOS-IU",135
40,"40221",50,38,35,0,3,"PODEMOS-IU",4
44,"44211",33,22,22,0,0,"PODEMOS-IU",3
16,"16026",91,69,68,0,1,"PODEMOS-IU",0
9,"9025",110,61,58,0,3,"PODEMOS-IU",5
26,"26024",204,157,156,1,1,"PODEMOS-IU",10
24,"24143",497,344,343,3,1,"PODEMOS-IU",38
49,"49022",282,230,229,2,1,"PODEMOS-IU",12
5,"5246",48,35,35,0,0,"PODEMOS-IU",0
39,"39100",849,567,565,5,2,"PODEMOS-IU",28
5,"5086",76,58,58,1,0,"PODEMOS-IU",0
16,"16064",651,556,550,4,6,"PODEMOS-IU",13
42,"42094",596,448,436,9,12,"PODEMOS-IU",37
50,"50028",78,53,53,0,0,"PODEMOS-IU",2
19,"19216",127,88,88,0,0,"PODEMOS-IU",23
13,"13038",1589,1162,1136,21,26,"PODEMOS-IU",53
50,"50231",253,199,195,4,4,"PODEMOS-IU",24
9,"9027",47,38,34,1,4,"PODEMOS-IU",8
2,"2074",5890,4054,4010,39,44,"PODEMOS-IU",331
16,"16276",20,17,17,1,0,"PODEMOS-IU",0
16,"16143",15,10,10,1,0,"PODEMOS-IU",1
5,"5216",209,149,149,0,0,"PODEMOS-IU",10
5,"5054",1192,871,856,6,15,"PODEMOS-IU",134
28,"28161",52164,38607,38193,306,414,"PODEMOS-IU",4821
26,"26142",789,572,564,6,8,"PODEMOS-IU",50
10,"10901",1161,758,753,1,5,"PODEMOS-IU",63
47,"47063",86,68,68,0,0,"PODEMOS-IU",5
40,"40224",18,15,15,0,0,"PODEMOS-IU",1
10,"10017",775,554,545,1,9,"PODEMOS-IU",17
45,"45045",1338,926,915,9,11,"PODEMOS-IU",67
6,"6015",118127,79482,78553,855,929,"PODEMOS-IU",7662
16,"16145",413,333,326,6,7,"PODEMOS-IU",25
50,"50157",289,199,196,1,3,"PODEMOS-IU",12
10,"10902",744,514,498,4,16,"PODEMOS-IU",3
9,"9241",244,171,169,6,2,"PODEMOS-IU",23
37,"37159",74,59,59,0,0,"PODEMOS-IU",2
34,"34116",54,35,35,0,0,"PODEMOS-IU",1
34,"34069",2184,1555,1517,17,38,"PODEMOS-IU",143
5,"5066",435,344,341,2,3,"PODEMOS-IU",57
16,"16198",1281,938,928,6,10,"PODEMOS-IU",53
19,"19167",129,104,103,1,1,"PODEMOS-IU",5
9,"9189",123,83,78,0,5,"PODEMOS-IU",3
6,"6106",407,261,258,4,3,"PODEMOS-IU",27
9,"9208",176,121,120,4,1,"PODEMOS-IU",2
16,"16236",857,615,608,1,7,"PODEMOS-IU",14
5,"5122",118,91,89,1,2,"PODEMOS-IU",3
45,"45046",2369,1679,1651,11,28,"PODEMOS-IU",121
42,"42192",36,22,22,2,0,"PODEMOS-IU",2
16,"16147",54,34,33,0,1,"PODEMOS-IU",2
40,"40225",1085,822,809,5,13,"PODEMOS-IU",42
49,"49063",303,228,227,3,1,"PODEMOS-IU",19
34,"34072",145,125,123,1,2,"PODEMOS-IU",11
37,"37129",248,181,181,1,0,"PODEMOS-IU",20
9,"9191",33,23,23,1,0,"PODEMOS-IU",2
35,"35030",10046,5584,5505,44,79,"PODEMOS-IU",729
10,"10020",1571,1135,1117,2,18,"PODEMOS-IU",94
50,"50007",51,34,34,1,0,"PODEMOS-IU",11
13,"13043",205,163,162,1,1,"PODEMOS-IU",4
34,"34073",180,123,120,3,3,"PODEMOS-IU",6
50,"50258",53,25,25,1,0,"PODEMOS-IU",1
9,"9413",405,267,263,0,4,"PODEMOS-IU",26
5,"5253",75,54,54,0,0,"PODEMOS-IU",3
24,"24109",857,534,528,8,6,"PODEMOS-IU",64
6,"6110",138,105,102,0,3,"PODEMOS-IU",3
50,"50161",98,75,74,2,1,"PODEMOS-IU",7
47,"47226",148,115,115,1,0,"PODEMOS-IU",9
45,"45049",419,303,295,1,8,"PODEMOS-IU",17
28,"28132",12197,8622,8537,75,85,"PODEMOS-IU",1244
9,"9192",54,46,45,1,1,"PODEMOS-IU",11
45,"45158",2545,1805,1786,9,19,"PODEMOS-IU",148
5,"5265",83,59,58,1,1,"PODEMOS-IU",3
16,"16046",213,142,142,0,0,"PODEMOS-IU",6
24,"24161",294,208,204,3,4,"PODEMOS-IU",30
45,"45061",2490,1690,1669,9,21,"PODEMOS-IU",154
49,"49185",156,120,116,0,4,"PODEMOS-IU",6
5,"5037",210,135,135,0,0,"PODEMOS-IU",2
34,"34185",69,36,35,0,1,"PODEMOS-IU",9
37,"37131",175,125,125,0,0,"PODEMOS-IU",0
19,"19221",31,22,22,1,0,"PODEMOS-IU",1
24,"24224",564,381,375,5,6,"PODEMOS-IU",31
26,"26148",154,125,122,3,3,"PODEMOS-IU",15
6,"6157",389,277,271,1,6,"PODEMOS-IU",6
47,"47133",2776,2096,2073,28,23,"PODEMOS-IU",271
50,"50210",37,26,26,0,0,"PODEMOS-IU",2
9,"9306",94,69,69,1,0,"PODEMOS-IU",2
44,"44067",106,75,71,0,4,"PODEMOS-IU",16
30,"30007",6474,4354,4317,26,37,"PODEMOS-IU",287
49,"49187",1197,839,819,12,20,"PODEMOS-IU",37
49,"49040",109,89,87,2,2,"PODEMOS-IU",6
9,"9196",133,95,95,2,0,"PODEMOS-IU",3
24,"24225",979,678,668,5,10,"PODEMOS-IU",59
40,"40035",135,110,110,2,0,"PODEMOS-IU",15
40,"40231",100,79,76,0,3,"PODEMOS-IU",3
44,"44143",388,298,298,2,0,"PODEMOS-IU",7
42,"42197",68,54,53,0,1,"PODEMOS-IU",2
19,"19283",29,26,26,0,0,"PODEMOS-IU",1
2,"2014",354,254,252,3,2,"PODEMOS-IU",37
2,"2048",1173,912,901,9,11,"PODEMOS-IU",41
9,"9417",42,31,31,1,0,"PODEMOS-IU",1
47,"47229",221,150,149,0,1,"PODEMOS-IU",7
40,"40135",277,212,210,3,2,"PODEMOS-IU",2
50,"50010",67,52,52,1,0,"PODEMOS-IU",0
37,"37229",138,103,101,0,2,"PODEMOS-IU",1
42,"42061",270,188,186,5,2,"PODEMOS-IU",12
30,"30032",2864,2154,2129,18,25,"PODEMOS-IU",107
16,"16002",192,160,158,2,2,"PODEMOS-IU",5
19,"19317",124,83,82,0,1,"PODEMOS-IU",10
28,"28040",16741,10717,10604,79,113,"PODEMOS-IU",1635
28,"28179",1451,1043,1033,6,10,"PODEMOS-IU",114
13,"13080",316,226,225,0,1,"PODEMOS-IU",8
37,"37186",94,68,68,0,0,"PODEMOS-IU",2
50,"50052",81,61,61,0,0,"PODEMOS-IU",1
50,"50278",175,133,131,2,2,"PODEMOS-IU",6
19,"19117",1632,1187,1167,12,20,"PODEMOS-IU",130
10,"10163",348,239,238,2,1,"PODEMOS-IU",7
34,"34228",77,59,59,1,0,"PODEMOS-IU",6
45,"45175",603,476,473,1,3,"PODEMOS-IU",6
44,"44042",114,82,81,0,1,"PODEMOS-IU",4
34,"34036",230,159,158,0,1,"PODEMOS-IU",15
49,"49069",337,210,201,0,9,"PODEMOS-IU",4
45,"45054",3798,2612,2587,10,25,"PODEMOS-IU",172
37,"37230",220,169,168,1,1,"PODEMOS-IU",12
10,"10027",77,62,62,0,0,"PODEMOS-IU",3
34,"34037",301,206,204,1,2,"PODEMOS-IU",12
6,"6117",1388,982,958,11,24,"PODEMOS-IU",43
49,"49071",716,432,429,6,3,"PODEMOS-IU",14
24,"24081",121,72,72,0,0,"PODEMOS-IU",3
45,"45164",166,143,142,1,1,"PODEMOS-IU",8
37,"37167",174,147,144,2,3,"PODEMOS-IU",16
5,"5193",179,140,139,2,1,"PODEMOS-IU",3
16,"16908",166,133,132,2,1,"PODEMOS-IU",26
47,"47011",554,466,462,7,4,"PODEMOS-IU",12
26,"26038",76,52,52,0,0,"PODEMOS-IU",5
47,"47169",62,52,52,0,0,"PODEMOS-IU",0
5,"5163",1702,1258,1233,5,25,"PODEMOS-IU",74
34,"34178",119,94,91,0,3,"PODEMOS-IU",14
37,"37002",125,64,63,0,1,"PODEMOS-IU",1
19,"19225",851,618,611,2,7,"PODEMOS-IU",61
45,"45202",3963,2806,2771,10,35,"PODEMOS-IU",204
50,"50062",1885,1332,1308,15,24,"PODEMOS-IU",162
39,"39026",1702,1160,1151,11,9,"PODEMOS-IU",54
9,"9256",330,221,219,0,2,"PODEMOS-IU",27
37,"37262",69,51,51,0,0,"PODEMOS-IU",0
24,"24117",410,302,301,1,1,"PODEMOS-IU",12
30,"30035",19432,13174,13013,114,161,"PODEMOS-IU",1196
6,"6074",4720,3355,3271,24,84,"PODEMOS-IU",423
45,"45093",147,115,114,0,1,"PODEMOS-IU",3
16,"16909",655,493,488,4,5,"PODEMOS-IU",27
6,"6120",3370,2507,2460,11,47,"PODEMOS-IU",176
10,"10112",1495,1071,1049,7,22,"PODEMOS-IU",47
37,"37044",431,309,308,3,1,"PODEMOS-IU",23
47,"47139",997,728,719,4,9,"PODEMOS-IU",45
37,"37327",179,148,147,2,1,"PODEMOS-IU",8
34,"34180",68,54,54,1,0,"PODEMOS-IU",2
38,"38029",1475,752,744,10,8,"PODEMOS-IU",94
28,"28065",131232,100864,99883,846,981,"PODEMOS-IU",16732
19,"19027",129,97,95,1,2,"PODEMOS-IU",13
42,"42116",37,30,29,2,1,"PODEMOS-IU",1
26,"26169",66,51,50,0,1,"PODEMOS-IU",1
9,"9334",51,36,34,1,2,"PODEMOS-IU",1
13,"13056",11706,8399,8288,88,111,"PODEMOS-IU",1213
47,"47171",375,295,290,9,5,"PODEMOS-IU",8
30,"30036",15432,10030,9879,64,151,"PODEMOS-IU",812
50,"50096",34,22,22,0,0,"PODEMOS-IU",0
26,"26041",109,67,65,0,2,"PODEMOS-IU",2
9,"9485",55,41,41,0,0,"PODEMOS-IU",1
9,"9374",93,75,72,2,3,"PODEMOS-IU",5
37,"37035",162,115,115,1,0,"PODEMOS-IU",5
10,"10114",964,644,637,6,7,"PODEMOS-IU",110
44,"44256",36,30,30,2,0,"PODEMOS-IU",0
5,"5196",57,43,43,0,0,"PODEMOS-IU",0
26,"26078",86,63,63,0,0,"PODEMOS-IU",9
19,"19324",164,122,120,4,2,"PODEMOS-IU",4
24,"24902",331,239,239,0,0,"PODEMOS-IU",14
26,"26005",2483,1589,1570,13,19,"PODEMOS-IU",137
49,"49078",138,113,109,4,4,"PODEMOS-IU",5
10,"10155",1073,735,717,6,18,"PODEMOS-IU",75
19,"19196",89,70,67,1,3,"PODEMOS-IU",5
26,"26042",795,578,572,8,6,"PODEMOS-IU",66
9,"9261",446,279,271,2,8,"PODEMOS-IU",33
47,"47142",121,85,85,0,0,"PODEMOS-IU",2
5,"5069",73,59,59,0,0,"PODEMOS-IU",2
40,"40044",134,101,101,3,0,"PODEMOS-IU",2
49,"49079",104,79,76,0,3,"PODEMOS-IU",2
40,"40176",372,288,287,2,1,"PODEMOS-IU",22
35,"35016",300581,181532,179831,1458,1701,"PODEMOS-IU",29396
2,"2022",341,243,243,2,0,"PODEMOS-IU",7
39,"39001",2063,1474,1467,5,7,"PODEMOS-IU",110
34,"34236",147,104,104,0,0,"PODEMOS-IU",3
26,"26161",8,8,8,0,0,"PODEMOS-IU",0
9,"9378",31,20,19,0,1,"PODEMOS-IU",6
19,"19901",35,27,27,0,0,"PODEMOS-IU",3
45,"45073",288,214,210,2,4,"PODEMOS-IU",18
47,"47057",272,200,199,0,1,"PODEMOS-IU",19
39,"39067",753,476,474,1,2,"PODEMOS-IU",22
16,"16160",58,41,41,1,0,"PODEMOS-IU",1
19,"19198",17,14,14,0,0,"PODEMOS-IU",1
34,"34046",43,29,29,0,0,"PODEMOS-IU",0
24,"24173",896,590,583,2,7,"PODEMOS-IU",27
26,"26020",449,319,313,1,6,"PODEMOS-IU",22
19,"19034",25,22,21,0,1,"PODEMOS-IU",4
37,"37267",177,130,129,0,1,"PODEMOS-IU",10
5,"5199",37,31,31,0,0,"PODEMOS-IU",4
49,"49081",1321,972,953,6,19,"PODEMOS-IU",52
47,"47144",72,54,53,2,1,"PODEMOS-IU",2
9,"9380",71,42,41,0,1,"PODEMOS-IU",3
50,"50041",16,10,10,0,0,"PODEMOS-IU",0
47,"47079",55,44,43,1,1,"PODEMOS-IU",1
9,"9415",275,178,178,3,0,"PODEMOS-IU",7
5,"5093",362,251,249,0,2,"PODEMOS-IU",22
19,"19067",68,46,44,0,2,"PODEMOS-IU",6
9,"9325",177,103,101,2,2,"PODEMOS-IU",7
38,"38008",5699,3719,3669,26,50,"PODEMOS-IU",352
5,"5267",103,67,67,1,0,"PODEMOS-IU",9
42,"42046",46,32,32,0,0,"PODEMOS-IU",11
37,"37143",384,273,273,2,0,"PODEMOS-IU",11
50,"50194",80,51,51,0,0,"PODEMOS-IU",1
39,"39004",1479,1050,1031,5,19,"PODEMOS-IU",50
49,"49188",111,75,73,0,2,"PODEMOS-IU",4
28,"28070",105,80,80,3,0,"PODEMOS-IU",9
26,"26082",101,79,79,0,0,"PODEMOS-IU",2
50,"50026",418,292,288,4,4,"PODEMOS-IU",21
16,"16254",199,159,159,0,0,"PODEMOS-IU",11
50,"50101",833,557,550,5,7,"PODEMOS-IU",68
16,"16176",29,20,20,0,0,"PODEMOS-IU",5
45,"45026",219,166,164,1,2,"PODEMOS-IU",13
45,"45137",1541,1007,998,8,9,"PODEMOS-IU",106
26,"26165",336,248,242,3,6,"PODEMOS-IU",21
49,"49242",439,342,336,2,6,"PODEMOS-IU",15
45,"45003",554,398,393,2,5,"PODEMOS-IU",26
49,"49154",111,63,59,0,4,"PODEMOS-IU",5
50,"50034",767,516,511,10,5,"PODEMOS-IU",47
37,"37144",327,233,233,2,0,"PODEMOS-IU",5
42,"42124",56,27,27,0,0,"PODEMOS-IU",1
42,"42172",28,26,26,0,0,"PODEMOS-IU",0
49,"49020",253,189,187,0,2,"PODEMOS-IU",12
34,"34192",76,59,59,0,0,"PODEMOS-IU",2
5,"5002",1905,1361,1329,11,32,"PODEMOS-IU",143
16,"16091",63,43,42,1,1,"PODEMOS-IU",5
49,"49010",350,260,256,8,4,"PODEMOS-IU",14
9,"9348",131,103,101,0,2,"PODEMOS-IU",11
37,"37301",84,64,64,1,0,"PODEMOS-IU",0
5,"5215",156,120,113,0,7,"PODEMOS-IU",9
40,"40148",231,165,163,4,2,"PODEMOS-IU",11
34,"34196",87,67,67,3,0,"PODEMOS-IU",4
37,"37145",236,173,170,3,3,"PODEMOS-IU",3
10,"10123",575,450,438,1,12,"PODEMOS-IU",27
26,"26126",29,27,27,0,0,"PODEMOS-IU",0
37,"37146",106,82,76,0,6,"PODEMOS-IU",2
50,"50173",156,114,114,0,0,"PODEMOS-IU",4
34,"34199",1150,767,754,14,13,"PODEMOS-IU",65
40,"40149",479,345,338,3,7,"PODEMOS-IU",31
26,"26013",330,243,242,2,1,"PODEMOS-IU",29
28,"28073",12707,9198,9080,94,118,"PODEMOS-IU",1236
5,"5903",137,84,83,0,1,"PODEMOS-IU",2
10,"10042",85,58,58,0,0,"PODEMOS-IU",5
40,"40051",34,25,25,0,0,"PODEMOS-IU",4
26,"26168",5584,3757,3696,35,61,"PODEMOS-IU",501
26,"26087",180,123,123,3,0,"PODEMOS-IU",16
28,"28012",929,707,698,7,9,"PODEMOS-IU",58
19,"19332",85,59,57,4,2,"PODEMOS-IU",9
10,"10043",746,525,520,4,5,"PODEMOS-IU",27
42,"42082",8,8,8,0,0,"PODEMOS-IU",1
13,"13069",613,438,419,2,19,"PODEMOS-IU",18
10,"10125",859,561,546,3,15,"PODEMOS-IU",32
19,"19204",150,105,104,3,1,"PODEMOS-IU",3
45,"45179",493,362,357,5,5,"PODEMOS-IU",17
6,"6135",1101,860,849,2,11,"PODEMOS-IU",46
26,"26128",94,71,71,1,0,"PODEMOS-IU",3
10,"10207",455,298,291,0,7,"PODEMOS-IU",16
6,"6045",467,347,346,6,1,"PODEMOS-IU",7
24,"24034",3466,2382,2359,25,23,"PODEMOS-IU",379
44,"44265",175,138,136,1,2,"PODEMOS-IU",3
19,"19266",229,184,182,1,2,"PODEMOS-IU",6
49,"49047",98,74,72,1,2,"PODEMOS-IU",2
49,"49122",761,517,505,7,12,"PODEMOS-IU",33
16,"16169",49,28,28,0,0,"PODEMOS-IU",1
19,"19208",39,32,32,0,0,"PODEMOS-IU",4
42,"42001",250,172,172,3,0,"PODEMOS-IU",9
42,"42162",2298,1493,1462,18,31,"PODEMOS-IU",87
50,"50903",2268,1685,1670,16,15,"PODEMOS-IU",248
19,"19288",21,20,20,2,0,"PODEMOS-IU",0
6,"6122",6535,4204,4110,47,94,"PODEMOS-IU",362
13,"13026",413,333,331,2,2,"PODEMOS-IU",60
16,"16157",183,150,148,0,2,"PODEMOS-IU",0
45,"45180",2850,2044,2023,15,21,"PODEMOS-IU",149
37,"37337",137,104,103,0,1,"PODEMOS-IU",0
28,"28055",944,636,627,4,9,"PODEMOS-IU",28
10,"10209",259,151,149,0,2,"PODEMOS-IU",13
10,"10168",320,210,206,1,4,"PODEMOS-IU",7
13,"13072",727,518,510,3,8,"PODEMOS-IU",10
50,"50250",54,44,44,2,0,"PODEMOS-IU",11
28,"28076",432,330,327,4,3,"PODEMOS-IU",36
5,"5177",136,117,116,0,1,"PODEMOS-IU",7
44,"44054",95,82,81,0,1,"PODEMOS-IU",5
6,"6139",498,402,395,4,7,"PODEMOS-IU",43
16,"16096",278,219,217,1,2,"PODEMOS-IU",19
42,"42043",3816,2602,2540,23,62,"PODEMOS-IU",183
10,"10006",1224,907,893,7,14,"PODEMOS-IU",31
24,"24171",337,136,134,4,2,"PODEMOS-IU",14
34,"34904",300,188,186,0,2,"PODEMOS-IU",18
42,"42132",140,102,101,2,1,"PODEMOS-IU",7
45,"45109",2791,2123,2072,20,51,"PODEMOS-IU",101
49,"49125",1392,883,871,11,12,"PODEMOS-IU",74
10,"10184",734,520,511,4,9,"PODEMOS-IU",44
26,"26094",67,51,51,0,0,"PODEMOS-IU",1
44,"44207",125,98,97,2,1,"PODEMOS-IU",11
26,"26055",39,30,30,0,0,"PODEMOS-IU",1
40,"40218",80,56,55,0,1,"PODEMOS-IU",2
37,"37307",146,94,91,1,3,"PODEMOS-IU",4
50,"50151",607,450,449,12,1,"PODEMOS-IU",13
9,"9395",121,74,74,1,0,"PODEMOS-IU",5
34,"34074",690,502,490,13,12,"PODEMOS-IU",12
34,"34031",26,26,26,1,0,"PODEMOS-IU",1
40,"40229",26,22,22,0,0,"PODEMOS-IU",1
13,"13015",5220,3665,3629,25,36,"PODEMOS-IU",202
34,"34135",398,267,264,4,3,"PODEMOS-IU",19
49,"49227",317,245,244,4,1,"PODEMOS-IU",21
6,"6003",768,579,557,4,22,"PODEMOS-IU",31
50,"50176",220,142,142,3,0,"PODEMOS-IU",7
50,"50032",243,167,164,3,3,"PODEMOS-IU",32
2,"2035",1946,1494,1473,5,21,"PODEMOS-IU",91
42,"42045",273,175,174,4,1,"PODEMOS-IU",7
37,"37247",171,129,128,0,1,"PODEMOS-IU",6
40,"40057",1397,1081,1067,15,14,"PODEMOS-IU",153
24,"24137",1043,700,691,8,9,"PODEMOS-IU",71
19,"19148",42,29,28,1,1,"PODEMOS-IU",3
45,"45037",1520,1072,1055,5,17,"PODEMOS-IU",103
9,"9283",39,25,24,1,1,"PODEMOS-IU",1
37,"37112",158,110,109,2,1,"PODEMOS-IU",4
6,"6037",1656,1033,1018,8,15,"PODEMOS-IU",45
44,"44103",122,96,96,3,0,"PODEMOS-IU",3
45,"45075",120,77,74,0,3,"PODEMOS-IU",5
37,"37184",289,178,177,1,1,"PODEMOS-IU",5
19,"19181",50,34,34,0,0,"PODEMOS-IU",3
5,"5094",133,105,105,0,0,"PODEMOS-IU",0
34,"34225",5016,3708,3650,41,58,"PODEMOS-IU",528
44,"44237",367,267,262,0,5,"PODEMOS-IU",8
5,"5180",76,55,53,0,2,"PODEMOS-IU",1
26,"26136",90,65,64,2,1,"PODEMOS-IU",12
50,"50179",255,197,197,0,0,"PODEMOS-IU",15
19,"19213",67,53,52,1,1,"PODEMOS-IU",1
42,"42156",29,21,21,0,0,"PODEMOS-IU",0
37,"37154",129,97,94,1,3,"PODEMOS-IU",0
45,"45088",2366,1526,1501,8,25,"PODEMOS-IU",140
37,"37062",78,59,59,0,0,"PODEMOS-IU",0
19,"19271",41,22,21,1,1,"PODEMOS-IU",0
19,"19242",74,53,53,1,0,"PODEMOS-IU",2
50,"50051",802,551,550,2,1,"PODEMOS-IU",27
2,"2082",98,80,80,0,0,"PODEMOS-IU",12
5,"5106",27,14,14,0,0,"PODEMOS-IU",0
26,"26023",433,316,314,3,2,"PODEMOS-IU",15
24,"24056",2726,1803,1772,21,31,"PODEMOS-IU",126
26,"26047",1852,1449,1434,6,15,"PODEMOS-IU",63
19,"19010",9,9,9,0,0,"PODEMOS-IU",0
26,"26048",21,21,21,0,0,"PODEMOS-IU",0
19,"19305",139,104,103,1,1,"PODEMOS-IU",4
50,"50102",815,594,584,7,10,"PODEMOS-IU",63
45,"45126",234,146,144,2,2,"PODEMOS-IU",15
16,"16115",49,32,32,0,0,"PODEMOS-IU",0
10,"10190",513,334,325,10,9,"PODEMOS-IU",31
42,"42050",27,17,17,0,0,"PODEMOS-IU",0
34,"34081",60,45,44,0,1,"PODEMOS-IU",0
19,"19244",74,55,55,3,0,"PODEMOS-IU",2
47,"47093",795,585,573,7,12,"PODEMOS-IU",77
37,"37187",548,407,399,0,8,"PODEMOS-IU",4
34,"34112",39,31,31,0,0,"PODEMOS-IU",1
49,"49204",58,44,43,1,1,"PODEMOS-IU",0
24,"24032",99,70,66,1,4,"PODEMOS-IU",3
19,"19048",19,14,13,1,1,"PODEMOS-IU",2
5,"5063",31,26,26,0,0,"PODEMOS-IU",0
37,"37281",39,28,27,0,1,"PODEMOS-IU",2
47,"47001",52,43,42,1,1,"PODEMOS-IU",2
39,"39016",23850,17235,17106,70,129,"PODEMOS-IU",1430
37,"37345",150,117,113,0,4,"PODEMOS-IU",10
37,"37251",108,75,75,0,0,"PODEMOS-IU",1
39,"39072",325,184,182,0,2,"PODEMOS-IU",18
34,"34068",29,25,24,0,1,"PODEMOS-IU",4
44,"44006",220,152,151,1,1,"PODEMOS-IU",5
37,"37282",193,132,131,3,1,"PODEMOS-IU",2
49,"49098",200,139,138,3,1,"PODEMOS-IU",6
16,"16065",370,287,287,3,0,"PODEMOS-IU",11
5,"5184",238,163,160,2,3,"PODEMOS-IU",14
19,"19086",1371,1003,996,9,7,"PODEMOS-IU",81
47,"47159",825,672,661,0,11,"PODEMOS-IU",48
19,"19185",26,15,15,1,0,"PODEMOS-IU",3
42,"42095",1909,1345,1326,32,19,"PODEMOS-IU",131
9,"9239",47,31,31,0,0,"PODEMOS-IU",0
26,"26143",260,197,192,1,5,"PODEMOS-IU",18
44,"44241",500,361,357,0,4,"PODEMOS-IU",23
24,"24033",209,149,149,0,0,"PODEMOS-IU",7
45,"45166",1575,1231,1210,5,21,"PODEMOS-IU",78
19,"19246",42,27,27,1,0,"PODEMOS-IU",1
35,"35006",31373,20764,20476,189,288,"PODEMOS-IU",3356
37,"37253",135,109,109,1,0,"PODEMOS-IU",6
39,"39074",7050,5074,5029,26,45,"PODEMOS-IU",394
13,"13085",2265,1768,1735,5,33,"PODEMOS-IU",83
45,"45007",656,502,497,0,5,"PODEMOS-IU",39
16,"16066",2280,1765,1734,18,31,"PODEMOS-IU",139
5,"5044",244,170,170,1,0,"PODEMOS-IU",6
37,"37304",156,97,96,1,1,"PODEMOS-IU",1
26,"26003",379,311,306,1,5,"PODEMOS-IU",10
26,"26117",2105,1537,1500,17,37,"PODEMOS-IU",110
5,"5165",361,266,261,4,5,"PODEMOS-IU",29
6,"6137",934,696,693,3,3,"PODEMOS-IU",41
49,"49225",122,68,68,0,0,"PODEMOS-IU",3
42,"42055",158,113,113,1,0,"PODEMOS-IU",2
26,"26040",64,47,47,1,0,"PODEMOS-IU",0
6,"6061",1074,829,819,5,10,"PODEMOS-IU",39
38,"38046",9267,6652,6594,55,58,"PODEMOS-IU",1295
50,"50183",316,227,223,1,4,"PODEMOS-IU",10
50,"50208",1761,1267,1250,16,17,"PODEMOS-IU",82
19,"19309",20,15,14,0,1,"PODEMOS-IU",5
37,"37024",89,60,60,0,0,"PODEMOS-IU",2
37,"37058",56,38,38,1,0,"PODEMOS-IU",3
49,"49102",182,130,130,2,0,"PODEMOS-IU",3
37,"37059",117,95,95,3,0,"PODEMOS-IU",2
24,"24037",330,189,189,1,0,"PODEMOS-IU",23
44,"44244",67,40,40,0,0,"PODEMOS-IU",4
42,"42152",67,47,44,1,3,"PODEMOS-IU",0
37,"37285",360,271,270,0,1,"PODEMOS-IU",17
30,"30029",12122,8231,8125,54,106,"PODEMOS-IU",676
26,"26146",84,56,55,0,1,"PODEMOS-IU",7
37,"37286",204,140,137,2,3,"PODEMOS-IU",23
44,"44168",181,119,117,1,2,"PODEMOS-IU",1
42,"42100",30,24,24,1,0,"PODEMOS-IU",0
37,"37350",403,281,274,1,7,"PODEMOS-IU",10
45,"45195",2064,1519,1481,9,38,"PODEMOS-IU",127
37,"37162",212,139,137,3,2,"PODEMOS-IU",3
26,"26031",95,83,83,0,0,"PODEMOS-IU",5
2,"2045",3609,2797,2752,38,45,"PODEMOS-IU",700
45,"45122",5605,4321,4288,33,33,"PODEMOS-IU",441
9,"9429",53,34,34,1,0,"PODEMOS-IU",1
9,"9902",439,334,326,10,8,"PODEMOS-IU",36
16,"16172",325,233,228,1,5,"PODEMOS-IU",3
30,"30038",15752,10987,10904,39,83,"PODEMOS-IU",818
49,"49273",165,90,90,0,0,"PODEMOS-IU",5
6,"6131",1057,809,800,6,9,"PODEMOS-IU",127
49,"49231",288,208,203,0,5,"PODEMOS-IU",10
50,"50043",241,155,154,1,1,"PODEMOS-IU",15
37,"37027",239,182,179,2,3,"PODEMOS-IU",10
49,"49214",666,486,477,6,9,"PODEMOS-IU",20
16,"16240",98,71,69,0,2,"PODEMOS-IU",8
50,"50185",140,93,92,1,1,"PODEMOS-IU",25
26,"26032",43,36,35,0,1,"PODEMOS-IU",3
34,"34076",532,443,438,1,5,"PODEMOS-IU",14
45,"45197",1888,1446,1426,5,20,"PODEMOS-IU",46
39,"39022",970,673,668,2,5,"PODEMOS-IU",30
6,"6142",257,203,194,1,9,"PODEMOS-IU",11
44,"44190",63,45,45,0,0,"PODEMOS-IU",0
9,"9215",359,217,216,2,1,"PODEMOS-IU",22
47,"47038",100,61,61,0,0,"PODEMOS-IU",6
38,"38049",2690,1406,1389,27,17,"PODEMOS-IU",164
50,"50260",35,31,31,0,0,"PODEMOS-IU",2
9,"9162",130,102,100,1,2,"PODEMOS-IU",25
30,"30040",686,564,560,1,4,"PODEMOS-IU",33
44,"44247",291,207,206,4,1,"PODEMOS-IU",15
37,"37258",134,92,92,1,0,"PODEMOS-IU",0
50,"50187",55,42,42,0,0,"PODEMOS-IU",5
40,"40004",436,330,319,2,11,"PODEMOS-IU",14
37,"37321",150,118,115,0,3,"PODEMOS-IU",7
26,"26176",56,43,43,0,0,"PODEMOS-IU",2
13,"13049",742,509,500,4,9,"PODEMOS-IU",26
50,"50092",290,218,214,0,4,"PODEMOS-IU",8
5,"5015",68,45,44,1,1,"PODEMOS-IU",0
26,"26150",97,77,77,1,0,"PODEMOS-IU",5
47,"47101",1634,1278,1262,7,16,"PODEMOS-IU",108
45,"45162",630,448,438,1,10,"PODEMOS-IU",26
37,"37269",424,280,277,2,3,"PODEMOS-IU",17
44,"44238",2278,1630,1620,3,10,"PODEMOS-IU",100
16,"16206",184,126,125,4,1,"PODEMOS-IU",3
44,"44060",32,25,25,0,0,"PODEMOS-IU",1
45,"45015",656,449,438,2,11,"PODEMOS-IU",33
9,"9288",87,64,64,0,0,"PODEMOS-IU",8
9,"9384",292,199,193,3,6,"PODEMOS-IU",11
9,"9405",122,94,91,0,3,"PODEMOS-IU",3
28,"28082",6110,4622,4581,41,41,"PODEMOS-IU",883
37,"37357",248,193,192,1,1,"PODEMOS-IU",8
19,"19099",286,179,175,1,4,"PODEMOS-IU",24
6,"6151",1049,746,741,5,5,"PODEMOS-IU",58
37,"37239",203,175,174,2,1,"PODEMOS-IU",28
49,"49221",233,122,120,2,2,"PODEMOS-IU",5
24,"24127",263,183,181,1,2,"PODEMOS-IU",6
47,"47167",245,198,198,1,0,"PODEMOS-IU",4
6,"6026",804,578,562,5,16,"PODEMOS-IU",42
28,"28001",70,48,47,1,1,"PODEMOS-IU",13
9,"9421",240,180,180,3,0,"PODEMOS-IU",19
42,"42111",274,183,181,0,2,"PODEMOS-IU",19
50,"50085",182,121,121,0,0,"PODEMOS-IU",4
9,"9253",101,77,76,0,1,"PODEMOS-IU",6
2,"2061",605,464,458,3,6,"PODEMOS-IU",18
19,"19097",14,14,13,0,1,"PODEMOS-IU",1
10,"10069",786,566,554,3,12,"PODEMOS-IU",19
26,"26167",50,34,33,1,1,"PODEMOS-IU",2
42,"42025",1125,741,732,12,9,"PODEMOS-IU",34
49,"49145",208,113,113,1,0,"PODEMOS-IU",3
30,"30034",1067,818,801,8,17,"PODEMOS-IU",57
34,"34082",78,59,58,0,1,"PODEMOS-IU",1
24,"24156",220,135,133,0,2,"PODEMOS-IU",11
47,"47199",71,57,57,2,0,"PODEMOS-IU",4
6,"6073",703,451,441,6,10,"PODEMOS-IU",120
16,"16155",490,389,388,7,1,"PODEMOS-IU",8
9,"9369",419,288,284,3,4,"PODEMOS-IU",27
26,"26114",72,61,61,0,0,"PODEMOS-IU",1
28,"28063",252,188,187,1,1,"PODEMOS-IU",33
6,"6903",2011,1443,1416,18,27,"PODEMOS-IU",158
24,"24230",403,268,265,3,3,"PODEMOS-IU",16
16,"16041",334,244,243,2,1,"PODEMOS-IU",14
26,"26075",315,234,229,1,5,"PODEMOS-IU",10
49,"49223",701,498,494,7,4,"PODEMOS-IU",11
44,"44195",82,58,57,0,1,"PODEMOS-IU",0
16,"16264",385,311,305,1,6,"PODEMOS-IU",3
10,"10085",310,219,219,1,0,"PODEMOS-IU",6
5,"5261",32,25,25,0,0,"PODEMOS-IU",0
45,"45019",7560,5216,5135,50,81,"PODEMOS-IU",656
40,"40203",987,753,740,13,13,"PODEMOS-IU",86
37,"37069",981,669,657,3,12,"PODEMOS-IU",46
37,"37047",215,89,89,0,0,"PODEMOS-IU",2
42,"42092",61,40,39,0,1,"PODEMOS-IU",2
19,"19263",21,15,15,0,0,"PODEMOS-IU",1
9,"9076",24,19,19,1,0,"PODEMOS-IU",1
9,"9455",45,34,33,0,1,"PODEMOS-IU",2
30,"30012",9085,6704,6599,46,105,"PODEMOS-IU",864
10,"10073",733,513,499,8,14,"PODEMOS-IU",34
10,"10072",837,545,539,5,6,"PODEMOS-IU",24
40,"40075",152,116,116,0,0,"PODEMOS-IU",5
6,"6077",319,234,229,2,5,"PODEMOS-IU",35
9,"9063",215,184,181,2,3,"PODEMOS-IU",8
50,"50141",104,80,78,0,2,"PODEMOS-IU",6
47,"47076",17787,13484,13306,179,178,"PODEMOS-IU",1889
28,"28141",6284,4617,4570,42,47,"PODEMOS-IU",510
16,"16119",175,117,115,0,2,"PODEMOS-IU",15
50,"50290",360,260,255,5,5,"PODEMOS-IU",12
19,"19102",88,75,73,0,2,"PODEMOS-IU",7
24,"24194",267,178,177,1,1,"PODEMOS-IU",14
19,"19258",84,63,62,0,1,"PODEMOS-IU",4
47,"47014",48,39,39,1,0,"PODEMOS-IU",0
40,"40043",1773,1376,1345,21,31,"PODEMOS-IU",55
49,"49160",42,27,27,0,0,"PODEMOS-IU",1
50,"50150",624,387,384,2,3,"PODEMOS-IU",20
45,"45133",2798,1957,1922,11,35,"PODEMOS-IU",152
6,"6124",1635,1158,1119,10,39,"PODEMOS-IU",94
49,"49005",125,80,80,1,0,"PODEMOS-IU",0
42,"42118",21,11,11,0,0,"PODEMOS-IU",0
19,"19122",81,62,60,2,2,"PODEMOS-IU",11
45,"45097",1037,834,819,7,15,"PODEMOS-IU",23
49,"49184",172,110,107,2,3,"PODEMOS-IU",1
28,"28144",6525,5032,4987,39,45,"PODEMOS-IU",512
37,"37172",846,530,524,6,6,"PODEMOS-IU",41
26,"26119",178,132,132,0,0,"PODEMOS-IU",18
10,"10156",97,71,69,0,2,"PODEMOS-IU",10
19,"19033",47,38,37,1,1,"PODEMOS-IU",2
6,"6004",1561,1130,1111,7,19,"PODEMOS-IU",68
47,"47153",101,69,69,1,0,"PODEMOS-IU",9
28,"28154",5570,3999,3961,29,38,"PODEMOS-IU",478
9,"9035",284,191,190,2,1,"PODEMOS-IU",25
44,"44149",99,74,73,4,1,"PODEMOS-IU",3
50,"50076",70,56,56,0,0,"PODEMOS-IU",8
34,"34100",132,96,95,1,1,"PODEMOS-IU",2
10,"10208",122,85,83,0,2,"PODEMOS-IU",3
34,"34176",127,95,90,3,5,"PODEMOS-IU",1
34,"34017",889,676,665,7,11,"PODEMOS-IU",34
5,"5048",107,89,88,2,1,"PODEMOS-IU",2
16,"16253",308,230,228,2,2,"PODEMOS-IU",4
34,"34137",24,19,19,2,0,"PODEMOS-IU",0
10,"10078",365,271,263,7,8,"PODEMOS-IU",24
40,"40078",150,123,123,6,0,"PODEMOS-IU",4
50,"50268",41,32,32,1,0,"PODEMOS-IU",5
10,"10119",574,417,414,2,3,"PODEMOS-IU",26
10,"10063",159,130,130,0,0,"PODEMOS-IU",11
16,"16087",238,184,184,6,0,"PODEMOS-IU",5
13,"13092",1703,1327,1307,4,20,"PODEMOS-IU",31
38,"38032",13579,8941,8880,92,61,"PODEMOS-IU",1323
28,"28069",58,44,42,1,2,"PODEMOS-IU",12
16,"16047",214,154,148,3,6,"PODEMOS-IU",15
26,"26021",2742,1967,1932,14,35,"PODEMOS-IU",111
49,"49117",431,294,289,0,5,"PODEMOS-IU",13
16,"16125",1607,1166,1150,11,16,"PODEMOS-IU",52
9,"9178",39,24,24,0,0,"PODEMOS-IU",3
37,"37332",65,49,49,0,0,"PODEMOS-IU",2
42,"42034",41,25,25,0,0,"PODEMOS-IU",3
16,"16224",72,60,58,0,2,"PODEMOS-IU",4
37,"37279",713,488,480,4,8,"PODEMOS-IU",13
38,"38025",7065,4657,4590,34,67,"PODEMOS-IU",419
42,"42140",15,11,11,1,0,"PODEMOS-IU",0
49,"49095",282,202,201,6,1,"PODEMOS-IU",10
34,"34213",53,46,46,0,0,"PODEMOS-IU",9
49,"49176",605,360,353,0,7,"PODEMOS-IU",10
9,"9403",103,79,78,1,1,"PODEMOS-IU",0
13,"13065",2777,1766,1728,10,38,"PODEMOS-IU",88
26,"26084",7264,5130,5059,61,71,"PODEMOS-IU",458
16,"16089",381,292,289,8,3,"PODEMOS-IU",10
9,"9269",29,24,23,0,1,"PODEMOS-IU",2
10,"10040",426,301,289,2,12,"PODEMOS-IU",21
26,"26089",111981,80365,79216,893,1149,"PODEMOS-IU",8686
19,"19280",3669,2622,2597,24,25,"PODEMOS-IU",378
9,"9010",33,25,25,2,0,"PODEMOS-IU",0
26,"26155",145,120,119,0,1,"PODEMOS-IU",7
40,"40037",30,17,17,0,0,"PODEMOS-IU",1
19,"19163",60,49,49,0,0,"PODEMOS-IU",6
10,"10013",265,184,182,0,2,"PODEMOS-IU",6
5,"5052",85,70,69,0,1,"PODEMOS-IU",0
6,"6101",437,355,346,1,9,"PODEMOS-IU",15
19,"19082",100,72,71,1,1,"PODEMOS-IU",9
44,"44005",48,36,36,0,0,"PODEMOS-IU",0
44,"44182",203,160,158,0,2,"PODEMOS-IU",0
49,"49155",81,60,59,0,1,"PODEMOS-IU",0
42,"42037",28,13,13,2,0,"PODEMOS-IU",0
26,"26073",92,68,66,1,2,"PODEMOS-IU",11
16,"16129",88,72,72,0,0,"PODEMOS-IU",0
44,"44203",9,9,9,0,0,"PODEMOS-IU",0
6,"6148",957,682,665,1,17,"PODEMOS-IU",103
50,"50197",95,69,68,2,1,"PODEMOS-IU",3
5,"5108",39,21,21,0,0,"PODEMOS-IU",1
5,"5205",81,59,58,2,1,"PODEMOS-IU",1
9,"9273",48,40,39,0,1,"PODEMOS-IU",2
6,"6089",610,470,463,2,7,"PODEMOS-IU",34
24,"24058",189,115,114,1,1,"PODEMOS-IU",4
45,"45104",419,328,324,1,4,"PODEMOS-IU",38
37,"37080",221,164,163,1,1,"PODEMOS-IU",7
40,"40018",73,50,50,0,0,"PODEMOS-IU",4
16,"16093",54,45,45,0,0,"PODEMOS-IU",3
9,"9013",42,32,32,0,0,"PODEMOS-IU",3
50,"50296",385,240,235,3,5,"PODEMOS-IU",35
30,"30043",25449,18839,18477,180,362,"PODEMOS-IU",2047
40,"40182",169,112,112,1,0,"PODEMOS-IU",17
42,"42128",45,40,39,2,1,"PODEMOS-IU",2
6,"6044",29258,19865,19594,205,271,"PODEMOS-IU",1860
24,"24206",1594,1104,1093,11,11,"PODEMOS-IU",83
49,"49024",626,432,426,3,6,"PODEMOS-IU",26
45,"45118",2124,1403,1380,8,23,"PODEMOS-IU",151
38,"38013",3011,1850,1829,14,21,"PODEMOS-IU",145
40,"40183",117,105,99,1,6,"PODEMOS-IU",1
5,"5008",202,158,155,0,3,"PODEMOS-IU",4
49,"49210",447,350,348,3,2,"PODEMOS-IU",38
37,"37333",203,125,124,2,1,"PODEMOS-IU",5
37,"37057",208,151,149,0,2,"PODEMOS-IU",5
10,"10162",519,401,394,4,7,"PODEMOS-IU",20
16,"16042",1091,832,823,4,9,"PODEMOS-IU",38
39,"39036",965,707,703,4,4,"PODEMOS-IU",66
44,"44087",67,52,50,0,2,"PODEMOS-IU",4
9,"9047",52,42,41,1,1,"PODEMOS-IU",4
35,"35014",11962,5994,5888,60,106,"PODEMOS-IU",1044
45,"45167",1370,1078,1065,1,13,"PODEMOS-IU",72
5,"5078",95,78,78,2,0,"PODEMOS-IU",1
37,"37128",235,169,168,0,1,"PODEMOS-IU",9
40,"40194",39173,28641,28260,353,381,"PODEMOS-IU",2774
37,"37148",399,295,291,0,4,"PODEMOS-IU",10
34,"34028",132,95,92,2,3,"PODEMOS-IU",5
9,"9442",368,265,262,1,3,"PODEMOS-IU",20
50,"50175",907,638,632,11,6,"PODEMOS-IU",81
34,"34903",179,129,129,1,0,"PODEMOS-IU",4
19,"19335",51,39,38,0,1,"PODEMOS-IU",2
42,"42004",2290,1595,1565,30,30,"PODEMOS-IU",62
5,"5079",66,53,52,0,1,"PODEMOS-IU",1
9,"9460",162,141,140,0,1,"PODEMOS-IU",8
2,"2077",52,41,41,0,0,"PODEMOS-IU",6
9,"9173",123,96,93,2,3,"PODEMOS-IU",5
50,"50073",2122,1559,1540,14,19,"PODEMOS-IU",125
45,"45034",1290,968,948,7,20,"PODEMOS-IU",97
42,"42178",99,71,71,0,0,"PODEMOS-IU",2
44,"44046",44,33,33,0,0,"PODEMOS-IU",0
44,"44009",798,593,589,4,4,"PODEMOS-IU",20
19,"19078",47,37,36,0,1,"PODEMOS-IU",6
42,"42181",384,281,278,3,3,"PODEMOS-IU",13
24,"24211",259,199,198,3,1,"PODEMOS-IU",3
40,"40185",800,560,553,4,7,"PODEMOS-IU",30
16,"16173",175,128,127,0,1,"PODEMOS-IU",8
10,"10171",347,238,219,1,19,"PODEMOS-IU",7
26,"26068",78,61,61,0,0,"PODEMOS-IU",5
49,"49249",61,45,45,1,0,"PODEMOS-IU",1
44,"44047",225,103,103,0,0,"PODEMOS-IU",12
44,"44172",296,216,216,1,0,"PODEMOS-IU",5
5,"5217",54,42,41,0,1,"PODEMOS-IU",2
6,"6146",1039,764,752,7,12,"PODEMOS-IU",72
30,"30027",50067,36417,36074,242,343,"PODEMOS-IU",3370
50,"50294",65,45,45,0,0,"PODEMOS-IU",0
24,"24110",1158,784,773,1,11,"PODEMOS-IU",143
47,"47184",537,411,402,1,9,"PODEMOS-IU",20
34,"34208",48,40,40,1,0,"PODEMOS-IU",1
45,"45184",204,123,122,0,1,"PODEMOS-IU",19
16,"16219",81,58,58,0,0,"PODEMOS-IU",10
50,"50126",2240,1528,1509,24,19,"PODEMOS-IU",60
49,"49054",847,576,569,8,7,"PODEMOS-IU",26
19,"19114",30,22,21,1,1,"PODEMOS-IU",0
50,"50118",2101,1484,1477,17,7,"PODEMOS-IU",118
39,"39031",1237,870,865,1,5,"PODEMOS-IU",52
9,"9904",464,344,339,3,5,"PODEMOS-IU",26
49,"49104",326,218,216,0,2,"PODEMOS-IU",4
10,"10092",260,201,200,1,1,"PODEMOS-IU",16
34,"34210",98,82,82,1,0,"PODEMOS-IU",1
19,"19054",161,136,135,3,1,"PODEMOS-IU",1
49,"49251",159,116,109,2,7,"PODEMOS-IU",5
28,"28102",880,639,621,7,18,"PODEMOS-IU",82
6,"6053",592,441,428,7,13,"PODEMOS-IU",34
2,"2080",498,358,352,0,6,"PODEMOS-IU",22
26,"26058",149,114,114,2,0,"PODEMOS-IU",18
13,"13079",12233,8274,8138,93,136,"PODEMOS-IU",542
24,"24124",338,196,195,2,1,"PODEMOS-IU",5
19,"19191",13,12,12,0,0,"PODEMOS-IU",2
47,"47039",162,119,117,0,2,"PODEMOS-IU",5
42,"42184",55,36,33,0,3,"PODEMOS-IU",1
47,"47134",150,120,116,2,4,"PODEMOS-IU",2
44,"44192",341,274,272,2,2,"PODEMOS-IU",8
24,"24006",488,356,347,4,9,"PODEMOS-IU",18
19,"19021",978,678,662,3,16,"PODEMOS-IU",39
44,"44003",17,15,15,0,0,"PODEMOS-IU",1
19,"19055",44,32,31,2,1,"PODEMOS-IU",2
9,"9127",52,36,35,0,1,"PODEMOS-IU",2
2,"2037",22963,14737,14588,68,149,"PODEMOS-IU",1082
16,"16225",55,30,30,0,0,"PODEMOS-IU",0
10,"10121",7882,5294,5183,42,111,"PODEMOS-IU",484
6,"6060",5696,4006,3900,37,106,"PODEMOS-IU",464
19,"19169",30,27,27,0,0,"PODEMOS-IU",7
10,"10031",162,128,124,0,4,"PODEMOS-IU",6
5,"5171",67,49,47,0,2,"PODEMOS-IU",2
45,"45031",2861,1894,1858,13,36,"PODEMOS-IU",186
9,"9328",70,37,37,3,0,"PODEMOS-IU",5
44,"44144",319,225,223,0,2,"PODEMOS-IU",8
42,"42159",39,34,33,0,1,"PODEMOS-IU",1
5,"5129",111,70,69,0,1,"PODEMOS-IU",0
9,"9473",85,68,64,0,4,"PODEMOS-IU",1
6,"6071",238,192,187,2,5,"PODEMOS-IU",3
49,"49256",236,183,179,0,4,"PODEMOS-IU",10
24,"24116",387,227,226,3,1,"PODEMOS-IU",23
9,"9129",91,74,74,0,0,"PODEMOS-IU",3
2,"2072",1528,981,958,7,23,"PODEMOS-IU",86
9,"9167",53,36,36,0,0,"PODEMOS-IU",1
19,"19127",88,60,60,1,0,"PODEMOS-IU",1
10,"10096",3311,2248,2201,15,47,"PODEMOS-IU",343
37,"37031",329,241,238,3,3,"PODEMOS-IU",9
9,"9407",25,19,17,0,2,"PODEMOS-IU",3
45,"45189",633,462,459,7,3,"PODEMOS-IU",40
49,"49205",359,252,251,7,1,"PODEMOS-IU",9
47,"47062",155,128,128,0,0,"PODEMOS-IU",3
19,"19118",11,10,9,0,1,"PODEMOS-IU",0
19,"19277",15,10,10,0,0,"PODEMOS-IU",2
10,"10138",527,386,379,2,7,"PODEMOS-IU",48
40,"40094",353,265,263,3,2,"PODEMOS-IU",18
5,"5120",33,26,26,0,0,"PODEMOS-IU",1
28,"28023",5159,4052,4019,27,33,"PODEMOS-IU",598
44,"44183",61,47,47,1,0,"PODEMOS-IU",0
45,"45190",462,361,353,3,8,"PODEMOS-IU",23
9,"9408",40,29,29,0,0,"PODEMOS-IU",2
10,"10056",533,377,371,2,6,"PODEMOS-IU",42
49,"49169",38,33,32,0,1,"PODEMOS-IU",4
37,"37127",205,139,139,1,0,"PODEMOS-IU",18
40,"40192",134,106,105,1,1,"PODEMOS-IU",2
10,"10153",281,183,181,0,2,"PODEMOS-IU",16
37,"37003",104,75,75,2,0,"PODEMOS-IU",1
19,"19087",17,16,16,0,0,"PODEMOS-IU",1
39,"39045",352,238,234,0,4,"PODEMOS-IU",10
9,"9279",166,116,114,1,2,"PODEMOS-IU",5
16,"16013",26,24,24,0,0,"PODEMOS-IU",1
10,"10049",3752,2949,2864,25,85,"PODEMOS-IU",179
37,"37293",102,68,68,1,0,"PODEMOS-IU",1
39,"39071",410,251,250,1,1,"PODEMOS-IU",8
44,"44088",24,23,23,0,0,"PODEMOS-IU",0
49,"49206",776,515,504,7,11,"PODEMOS-IU",17
39,"39073",10260,7537,7482,42,55,"PODEMOS-IU",620
13,"13010",872,615,601,3,14,"PODEMOS-IU",27
50,"50087",28,19,19,0,0,"PODEMOS-IU",0
40,"40173",140,120,118,2,2,"PODEMOS-IU",12
45,"45205",7438,4772,4701,27,71,"PODEMOS-IU",580
42,"42206",8,5,5,2,0,"PODEMOS-IU",0
28,"28110",2029,1498,1478,9,20,"PODEMOS-IU",127
10,"10141",284,207,205,1,2,"PODEMOS-IU",1
42,"42029",131,94,94,4,0,"PODEMOS-IU",0
37,"37294",11750,8395,8280,88,115,"PODEMOS-IU",702
6,"6108",2238,1524,1478,15,46,"PODEMOS-IU",145
5,"5022",1580,1202,1193,6,9,"PODEMOS-IU",39
44,"44127",57,43,43,0,0,"PODEMOS-IU",0
9,"9411",153,105,104,0,1,"PODEMOS-IU",19
2,"2010",1784,1374,1349,12,25,"PODEMOS-IU",82
45,"45047",2694,1733,1706,24,27,"PODEMOS-IU",192
39,"39010",610,457,453,1,4,"PODEMOS-IU",36
9,"9064",305,225,219,6,6,"PODEMOS-IU",6
45,"45157",2288,1490,1472,5,18,"PODEMOS-IU",175
9,"9079",47,38,38,0,0,"PODEMOS-IU",0
34,"34121",187,150,150,3,0,"PODEMOS-IU",5
50,"50015",81,57,56,0,1,"PODEMOS-IU",3
28,"28121",209,156,152,1,4,"PODEMOS-IU",6
42,"42030",91,69,69,2,0,"PODEMOS-IU",3
9,"9135",41,28,28,0,0,"PODEMOS-IU",1
5,"5124",87,67,67,2,0,"PODEMOS-IU",0
19,"19052",21,16,16,0,0,"PODEMOS-IU",0
47,"47193",1625,1251,1236,10,15,"PODEMOS-IU",174
47,"47006",182,149,145,1,4,"PODEMOS-IU",30
40,"40002",32,22,21,0,1,"PODEMOS-IU",4
37,"37109",178,127,126,0,1,"PODEMOS-IU",0
44,"44198",182,138,135,0,3,"PODEMOS-IU",1
38,"38007",1619,1053,1043,3,10,"PODEMOS-IU",70
10,"10174",171,112,110,0,2,"PODEMOS-IU",7
28,"28140",3156,2359,2331,16,28,"PODEMOS-IU",257
50,"50120",55,42,42,1,0,"PODEMOS-IU",3
19,"19294",26,18,18,0,0,"PODEMOS-IU",3
10,"10113",2231,1534,1508,14,26,"PODEMOS-IU",195
10,"10039",400,256,217,0,39,"PODEMOS-IU",25
30,"30016",153034,101232,100202,776,1030,"PODEMOS-IU",9528
47,"47050",3908,2713,2673,39,40,"PODEMOS-IU",320
24,"24040",416,293,292,2,1,"PODEMOS-IU",24
9,"9036",31,24,24,4,0,"PODEMOS-IU",2
39,"39087",41241,29341,29084,152,257,"PODEMOS-IU",2802
19,"19189",114,87,84,0,3,"PODEMOS-IU",7
5,"5158",346,263,261,0,2,"PODEMOS-IU",9
16,"16071",20,16,16,0,0,"PODEMOS-IU",2
47,"47185",82,62,61,1,1,"PODEMOS-IU",6
5,"5082",491,379,369,2,10,"PODEMOS-IU",17
45,"45087",8180,5737,5628,41,109,"PODEMOS-IU",407
49,"49229",109,80,77,1,3,"PODEMOS-IU",1
40,"40165",73,53,52,0,1,"PODEMOS-IU",2
35,"35010",3853,2224,2194,18,30,"PODEMOS-IU",355
19,"19241",35,26,25,2,1,"PODEMOS-IU",1
28,"28059",4516,3343,3299,30,44,"PODEMOS-IU",313
10,"10120",153,97,97,0,0,"PODEMOS-IU",3
9,"9307",102,76,74,1,2,"PODEMOS-IU",1
28,"28080",49866,39769,39583,346,186,"PODEMOS-IU",2484
16,"16035",224,177,174,2,3,"PODEMOS-IU",17
26,"26033",162,133,132,3,1,"PODEMOS-IU",12
9,"9346",90,61,60,1,1,"PODEMOS-IU",6
16,"16273",300,214,211,3,3,"PODEMOS-IU",4
42,"42185",24,20,20,0,0,"PODEMOS-IU",0
37,"37029",186,125,124,1,1,"PODEMOS-IU",3
40,"40220",64,46,45,0,1,"PODEMOS-IU",3
49,"49056",285,191,190,3,1,"PODEMOS-IU",3
10,"10215",438,266,262,2,4,"PODEMOS-IU",29
19,"19125",45,23,23,0,0,"PODEMOS-IU",2
50,"50137",958,740,731,8,9,"PODEMOS-IU",48
34,"34175",87,67,66,1,1,"PODEMOS-IU",2
26,"26164",50,36,35,0,1,"PODEMOS-IU",2
6,"6039",1802,1375,1343,9,32,"PODEMOS-IU",105
19,"19329",58,46,46,0,0,"PODEMOS-IU",0
28,"28044",6266,4693,4642,36,51,"PODEMOS-IU",695
28,"28100",4482,3146,3113,21,33,"PODEMOS-IU",517
45,"45032",445,290,286,2,4,"PODEMOS-IU",18
37,"37013",104,72,70,2,2,"PODEMOS-IU",1
19,"19138",215,158,154,4,4,"PODEMOS-IU",23
9,"9297",310,233,233,6,0,"PODEMOS-IU",15
45,"45191",524,437,432,2,5,"PODEMOS-IU",17
37,"37081",879,680,674,2,6,"PODEMOS-IU",10
2,"2016",528,353,352,4,1,"PODEMOS-IU",14
38,"38027",5581,3577,3533,22,44,"PODEMOS-IU",300
44,"44033",243,165,165,3,0,"PODEMOS-IU",11
47,"47220",151,106,105,1,1,"PODEMOS-IU",5
49,"49032",282,196,196,0,0,"PODEMOS-IU",6
37,"37125",231,154,148,1,6,"PODEMOS-IU",8
16,"16245",396,304,298,1,6,"PODEMOS-IU",29
37,"37261",213,153,149,0,4,"PODEMOS-IU",14
49,"49131",231,149,145,1,4,"PODEMOS-IU",5
9,"9011",70,42,40,0,2,"PODEMOS-IU",4
26,"26037",125,98,98,3,0,"PODEMOS-IU",8
10,"10164",707,391,382,4,9,"PODEMOS-IU",28
5,"5236",105,69,69,1,0,"PODEMOS-IU",20
16,"16116",76,59,58,1,1,"PODEMOS-IU",2
47,"47022",59,52,48,1,4,"PODEMOS-IU",1
10,"10111",1297,888,872,11,16,"PODEMOS-IU",73
49,"49257",305,186,184,0,2,"PODEMOS-IU",16
42,"42160",246,177,175,3,2,"PODEMOS-IU",21
44,"44135",99,73,73,1,0,"PODEMOS-IU",0
38,"38028",22144,14312,14174,89,138,"PODEMOS-IU",1710
10,"10192",777,567,563,3,4,"PODEMOS-IU",18
24,"24010",8251,5357,5275,40,82,"PODEMOS-IU",399
13,"13054",4870,3630,3575,26,55,"PODEMOS-IU",163
16,"16081",50,37,36,0,1,"PODEMOS-IU",3
45,"45165",62598,43750,43259,329,491,"PODEMOS-IU",4020
19,"19129",25,21,21,0,0,"PODEMOS-IU",0
50,"50264",151,111,110,0,1,"PODEMOS-IU",12
38,"38052",1283,806,794,3,12,"PODEMOS-IU",82
50,"50190",669,532,518,10,14,"PODEMOS-IU",32
9,"9061",147,119,119,0,0,"PODEMOS-IU",3
34,"34201",171,131,130,1,1,"PODEMOS-IU",8
34,"34147",164,120,120,1,0,"PODEMOS-IU",6
19,"19301",37,26,26,0,0,"PODEMOS-IU",0
44,"44160",438,287,285,4,2,"PODEMOS-IU",12
19,"19229",58,53,53,0,0,"PODEMOS-IU",4
19,"19113",454,327,322,4,5,"PODEMOS-IU",34
37,"37179",197,167,165,0,2,"PODEMOS-IU",8
26,"26011",7251,4807,4711,47,96,"PODEMOS-IU",404
42,"42171",111,72,71,1,1,"PODEMOS-IU",2
49,"49083",47,37,37,1,0,"PODEMOS-IU",0
42,"42176",27,21,21,0,0,"PODEMOS-IU",0
34,"34009",30,26,26,0,0,"PODEMOS-IU",3
35,"35021",15072,9791,9696,80,95,"PODEMOS-IU",1361
24,"24039",1949,1420,1412,33,8,"PODEMOS-IU",82
5,"5262",318,238,235,1,3,"PODEMOS-IU",6
10,"10154",177,117,116,0,1,"PODEMOS-IU",11
26,"26016",28,20,18,0,2,"PODEMOS-IU",0
40,"40204",145,102,101,0,1,"PODEMOS-IU",5
44,"44185",88,69,69,2,0,"PODEMOS-IU",3
26,"26065",63,46,43,0,3,"PODEMOS-IU",7
39,"39028",3892,2905,2878,20,27,"PODEMOS-IU",256
5,"5166",155,108,104,1,4,"PODEMOS-IU",4
16,"16083",44,24,24,0,0,"PODEMOS-IU",0
45,"45071",1779,1374,1342,7,32,"PODEMOS-IU",181
40,"40215",79,66,66,2,0,"PODEMOS-IU",1
37,"37119",99,78,78,1,0,"PODEMOS-IU",11
5,"5187",1714,1247,1221,9,26,"PODEMOS-IU",129
37,"37223",106,75,74,0,1,"PODEMOS-IU",2
16,"16019",187,141,141,1,0,"PODEMOS-IU",1
34,"34012",342,237,232,3,5,"PODEMOS-IU",17
10,"10210",489,314,313,2,1,"PODEMOS-IU",14
34,"34103",96,79,76,0,3,"PODEMOS-IU",0
26,"26092",104,82,81,3,1,"PODEMOS-IU",1
45,"45194",64,45,44,1,1,"PODEMOS-IU",1
9,"9318",56,33,33,0,0,"PODEMOS-IU",3
16,"16202",733,533,526,4,7,"PODEMOS-IU",17
34,"34088",265,195,191,1,4,"PODEMOS-IU",31
26,"26006",1833,1358,1335,7,23,"PODEMOS-IU",144
45,"45096",987,748,725,9,23,"PODEMOS-IU",168
28,"28088",296,196,191,1,5,"PODEMOS-IU",38
10,"10211",446,303,300,0,3,"PODEMOS-IU",14
39,"39095",2266,1637,1619,8,18,"PODEMOS-IU",156
50,"50298",5439,4053,4007,41,46,"PODEMOS-IU",390
42,"42096",244,132,129,2,3,"PODEMOS-IU",12
5,"5190",53,44,43,0,1,"PODEMOS-IU",1
2,"2041",316,238,236,0,2,"PODEMOS-IU",10
5,"5902",286,214,211,1,3,"PODEMOS-IU",8
9,"9014",182,101,101,0,0,"PODEMOS-IU",6
42,"42068",77,58,57,0,1,"PODEMOS-IU",1
49,"49259",79,59,59,0,0,"PODEMOS-IU",1
9,"9057",147,110,108,0,2,"PODEMOS-IU",21
49,"49065",1048,747,725,6,22,"PODEMOS-IU",21
9,"9199",91,68,68,0,0,"PODEMOS-IU",0
28,"28113",36951,27912,27604,241,308,"PODEMOS-IU",4189
45,"45135",4152,3118,3066,21,52,"PODEMOS-IU",513
42,"42167",235,163,161,4,2,"PODEMOS-IU",10
39,"39059",7518,5327,5287,23,40,"PODEMOS-IU",394
9,"9103",200,168,166,1,2,"PODEMOS-IU",15
9,"9160",83,63,63,1,0,"PODEMOS-IU",2
49,"49216",147,115,109,0,6,"PODEMOS-IU",14
19,"19260",38,27,27,1,0,"PODEMOS-IU",4
5,"5233",223,174,173,0,1,"PODEMOS-IU",6
13,"13002",1415,966,950,3,16,"PODEMOS-IU",32
9,"9195",57,40,40,0,0,"PODEMOS-IU",3
28,"28134",63936,48022,47631,421,391,"PODEMOS-IU",6192
37,"37299",230,148,147,0,1,"PODEMOS-IU",9
37,"37028",131,96,93,2,3,"PODEMOS-IU",2
6,"6007",1418,984,968,13,16,"PODEMOS-IU",69
34,"34049",329,229,227,1,2,"PODEMOS-IU",22
45,"45051",1678,1238,1209,13,29,"PODEMOS-IU",84
40,"40145",1098,824,820,4,4,"PODEMOS-IU",88
49,"49107",115,70,70,0,0,"PODEMOS-IU",4
13,"13033",1544,1231,1196,5,35,"PODEMOS-IU",37
10,"10188",483,354,340,0,14,"PODEMOS-IU",15
6,"6160",3005,2083,2056,9,27,"PODEMOS-IU",173
5,"5161",545,395,395,0,0,"PODEMOS-IU",21
44,"44210",750,577,572,2,5,"PODEMOS-IU",41
40,"40199",101,76,72,2,4,"PODEMOS-IU",5
44,"44040",189,153,150,1,3,"PODEMOS-IU",8
9,"9363",906,660,655,5,5,"PODEMOS-IU",34
6,"6145",900,683,669,7,14,"PODEMOS-IU",23
10,"10139",92,66,65,1,1,"PODEMOS-IU",4
26,"26107",86,65,64,1,1,"PODEMOS-IU",4
10,"10003",543,350,335,0,15,"PODEMOS-IU",44
37,"37213",83,64,64,0,0,"PODEMOS-IU",8
50,"50029",594,432,431,3,1,"PODEMOS-IU",27
40,"40080",51,31,31,0,0,"PODEMOS-IU",0
28,"28148",89174,65500,64784,566,716,"PODEMOS-IU",9006
42,"42078",1000,653,640,5,13,"PODEMOS-IU",35
37,"37347",463,349,345,9,4,"PODEMOS-IU",40
5,"5074",668,540,537,5,3,"PODEMOS-IU",8
37,"37290",130,106,106,0,0,"PODEMOS-IU",7
13,"13019",5101,3502,3468,33,34,"PODEMOS-IU",578
26,"26036",16989,11463,11260,101,203,"PODEMOS-IU",917
5,"5226",63,43,42,0,1,"PODEMOS-IU",1
10,"10068",707,532,521,4,11,"PODEMOS-IU",69
6,"6056",447,351,340,2,11,"PODEMOS-IU",19
24,"24093",342,214,212,2,2,"PODEMOS-IU",23
37,"37197",88,53,53,1,0,"PODEMOS-IU",4
49,"49043",256,191,189,1,2,"PODEMOS-IU",13
19,"19142",263,179,179,1,0,"PODEMOS-IU",30
37,"37323",474,335,325,5,10,"PODEMOS-IU",9
37,"37042",36,27,27,1,0,"PODEMOS-IU",0
9,"9438",562,447,437,6,10,"PODEMOS-IU",40
9,"9330",1481,1050,1037,17,13,"PODEMOS-IU",109
9,"9059",136870,99937,98641,1416,1296,"PODEMOS-IU",10422
6,"6133",1795,1308,1294,11,14,"PODEMOS-IU",44
50,"50094",1500,1041,1022,12,19,"PODEMOS-IU",69
45,"45006",1334,866,858,1,8,"PODEMOS-IU",48
6,"6043",677,493,488,5,5,"PODEMOS-IU",33
49,"49086",111,89,89,1,0,"PODEMOS-IU",6
50,"50070",50,30,29,0,1,"PODEMOS-IU",1
9,"9060",126,104,104,2,0,"PODEMOS-IU",9
10,"10219",1184,698,686,9,12,"PODEMOS-IU",44
10,"10070",667,493,489,1,4,"PODEMOS-IU",23
5,"5141",95,79,78,1,1,"PODEMOS-IU",5
16,"16016",217,157,157,1,0,"PODEMOS-IU",3
47,"47023",3057,2369,2359,20,10,"PODEMOS-IU",266
44,"44126",314,222,221,0,1,"PODEMOS-IU",13
5,"5055",532,417,413,3,4,"PODEMOS-IU",11
50,"50108",50,37,37,0,0,"PODEMOS-IU",1
37,"37133",101,73,69,1,4,"PODEMOS-IU",5
42,"42209",134,86,84,4,2,"PODEMOS-IU",8
44,"44063",63,52,52,0,0,"PODEMOS-IU",0
9,"9303",73,58,58,0,0,"PODEMOS-IU",1
9,"9409",117,80,80,0,0,"PODEMOS-IU",19
19,"19050",15,13,13,0,0,"PODEMOS-IU",1
34,"34901",1053,762,759,10,3,"PODEMOS-IU",38
42,"42215",723,468,452,10,16,"PODEMOS-IU",11
50,"50245",74,51,51,0,0,"PODEMOS-IU",7
9,"9170",207,151,150,1,1,"PODEMOS-IU",12
49,"49084",266,197,195,11,2,"PODEMOS-IU",23
9,"9143",28,17,17,0,0,"PODEMOS-IU",1
24,"24901",853,517,513,4,4,"PODEMOS-IU",58
10,"10194",524,408,404,2,4,"PODEMOS-IU",26
16,"16082",272,194,192,1,2,"PODEMOS-IU",24
40,"40032",368,247,244,5,3,"PODEMOS-IU",9
9,"9258",165,128,127,0,1,"PODEMOS-IU",1
37,"37328",159,112,110,1,2,"PODEMOS-IU",21
9,"9458",490,388,385,6,3,"PODEMOS-IU",52
49,"49194",331,198,197,0,1,"PODEMOS-IU",3
34,"34204",50,35,35,0,0,"PODEMOS-IU",0
45,"45156",3334,2561,2502,23,59,"PODEMOS-IU",290
5,"5155",46,33,31,1,2,"PODEMOS-IU",3
19,"19218",43,31,31,0,0,"PODEMOS-IU",4
37,"37046",10648,7396,7241,62,155,"PODEMOS-IU",623
19,"19177",60,45,45,0,0,"PODEMOS-IU",3
37,"37317",287,211,209,1,2,"PODEMOS-IU",3
45,"45084",2103,1533,1508,7,25,"PODEMOS-IU",131
10,"10060",921,615,596,4,19,"PODEMOS-IU",31
9,"9412",750,484,482,4,2,"PODEMOS-IU",74
49,"49090",190,135,134,3,1,"PODEMOS-IU",5
13,"13059",193,150,150,0,0,"PODEMOS-IU",16
37,"37161",123,86,86,0,0,"PODEMOS-IU",0
49,"49091",246,168,167,1,1,"PODEMOS-IU",5
45,"45183",2378,1555,1525,16,30,"PODEMOS-IU",246
37,"37085",5060,3732,3689,52,43,"PODEMOS-IU",283
45,"45035",286,206,204,2,2,"PODEMOS-IU",35
24,"24223",2533,1727,1705,40,22,"PODEMOS-IU",163
24,"24003",603,374,372,0,2,"PODEMOS-IU",12
5,"5160",289,220,213,0,7,"PODEMOS-IU",6
37,"37325",88,63,63,0,0,"PODEMOS-IU",4
37,"37367",179,147,143,2,4,"PODEMOS-IU",0
26,"26134",81,67,67,3,0,"PODEMOS-IU",4
24,"24095",317,228,228,3,0,"PODEMOS-IU",14
9,"9218",350,254,252,5,2,"PODEMOS-IU",26
9,"9046",23,17,17,0,0,"PODEMOS-IU",5
16,"16049",137,98,98,2,0,"PODEMOS-IU",2
10,"10004",692,482,473,8,9,"PODEMOS-IU",20
42,"42204",53,37,35,1,2,"PODEMOS-IU",5
5,"5901",247,154,152,3,2,"PODEMOS-IU",14
50,"50232",160,93,92,1,1,"PODEMOS-IU",20
50,"50171",99,69,69,2,0,"PODEMOS-IU",0
19,"19008",36,30,30,0,0,"PODEMOS-IU",12
10,"10172",696,447,443,5,4,"PODEMOS-IU",49
24,"24028",367,275,273,5,2,"PODEMOS-IU",20
5,"5014",5263,3699,3648,35,51,"PODEMOS-IU",413
19,"19302",52,42,42,1,0,"PODEMOS-IU",3
30,"30039",20442,13299,13167,84,132,"PODEMOS-IU",1283
9,"9266",97,71,68,1,3,"PODEMOS-IU",3
26,"26162",108,90,89,1,1,"PODEMOS-IU",4
24,"24053",398,250,248,1,2,"PODEMOS-IU",8
42,"42120",131,87,86,1,1,"PODEMOS-IU",4
13,"13037",776,573,563,2,10,"PODEMOS-IU",17
49,"49030",79,56,56,0,0,"PODEMOS-IU",1
49,"49067",329,200,198,4,2,"PODEMOS-IU",5
49,"49082",341,273,270,12,3,"PODEMOS-IU",12
45,"45160",1097,838,824,4,14,"PODEMOS-IU",60
6,"6098",530,379,376,4,3,"PODEMOS-IU",18
28,"28157",690,471,467,1,4,"PODEMOS-IU",54
37,"37342",250,190,189,3,1,"PODEMOS-IU",10
45,"45076",574,361,357,1,4,"PODEMOS-IU",18
42,"42060",28,16,14,0,2,"PODEMOS-IU",0
37,"37343",66,44,43,1,1,"PODEMOS-IU",6
9,"9070",33,28,27,0,1,"PODEMOS-IU",5
47,"47124",383,302,300,3,2,"PODEMOS-IU",31
50,"50110",340,248,238,1,10,"PODEMOS-IU",12
16,"16036",120,94,93,0,1,"PODEMOS-IU",11
6,"6023",4138,2811,2749,12,62,"PODEMOS-IU",191
16,"16243",376,316,309,4,7,"PODEMOS-IU",27
37,"37356",84,58,58,0,0,"PODEMOS-IU",1
37,"37071",76,64,62,1,2,"PODEMOS-IU",2
37,"37049",125,76,76,0,0,"PODEMOS-IU",2
6,"6014",6503,4235,4181,35,54,"PODEMOS-IU",266
16,"16109",41,30,30,0,0,"PODEMOS-IU",3
30,"30011",4702,3390,3324,8,66,"PODEMOS-IU",241
19,"19232",56,40,40,0,0,"PODEMOS-IU",1
49,"49181",333,197,195,2,2,"PODEMOS-IU",7
16,"16186",403,309,305,3,4,"PODEMOS-IU",11
49,"49189",186,104,104,1,0,"PODEMOS-IU",2
6,"6090",827,570,553,3,17,"PODEMOS-IU",51
40,"40214",198,160,154,0,6,"PODEMOS-IU",15
37,"37315",89,65,64,0,1,"PODEMOS-IU",4
39,"39080",3477,2404,2388,4,16,"PODEMOS-IU",140
16,"16003",134,108,105,0,3,"PODEMOS-IU",14
44,"44163",115,79,78,0,1,"PODEMOS-IU",3
6,"6162",2885,2067,2032,19,35,"PODEMOS-IU",88
13,"13082",25917,16834,16670,137,164,"PODEMOS-IU",1216
16,"16102",1159,815,767,9,48,"PODEMOS-IU",14
24,"24177",467,265,263,2,2,"PODEMOS-IU",10
49,"49178",748,520,505,7,15,"PODEMOS-IU",52
24,"24203",88,62,62,1,0,"PODEMOS-IU",4
13,"13006",552,411,406,0,5,"PODEMOS-IU",12
28,"28035",1404,981,966,4,15,"PODEMOS-IU",118
16,"16051",128,96,96,3,0,"PODEMOS-IU",1
28,"28072",6176,4716,4673,44,43,"PODEMOS-IU",554
9,"9255",83,58,58,0,0,"PODEMOS-IU",5
10,"10178",724,499,494,3,5,"PODEMOS-IU",30
26,"26025",84,69,65,2,4,"PODEMOS-IU",6
9,"9422",19,13,13,0,0,"PODEMOS-IU",1
37,"37126",30,25,25,0,0,"PODEMOS-IU",0
34,"34024",25,14,14,0,0,"PODEMOS-IU",1
50,"50156",212,156,151,2,5,"PODEMOS-IU",23
37,"37022",242,191,190,0,1,"PODEMOS-IU",8
42,"42064",83,65,65,1,0,"PODEMOS-IU",4
45,"45056",2341,1315,1295,11,20,"PODEMOS-IU",170
40,"40040",2489,1766,1744,26,22,"PODEMOS-IU",72
37,"37346",251,208,207,1,1,"PODEMOS-IU",5
37,"37056",39,28,28,0,0,"PODEMOS-IU",0
9,"9094",53,42,42,0,0,"PODEMOS-IU",8
47,"47026",50,37,37,1,0,"PODEMOS-IU",0
40,"40036",496,395,380,8,15,"PODEMOS-IU",7
40,"40166",251,201,201,0,0,"PODEMOS-IU",9
45,"45085",1535,1061,1052,11,9,"PODEMOS-IU",86
26,"26088",39,35,34,0,1,"PODEMOS-IU",0
2,"2034",1323,1024,1018,6,6,"PODEMOS-IU",101
50,"50272",13226,9250,9153,97,97,"PODEMOS-IU",1154
24,"24169",2777,1908,1880,10,28,"PODEMOS-IU",350
38,"38012",2286,1520,1510,8,10,"PODEMOS-IU",259
42,"42148",9,9,9,0,0,"PODEMOS-IU",0
40,"40041",966,729,716,8,13,"PODEMOS-IU",49
34,"34218",437,313,309,3,4,"PODEMOS-IU",13
19,"19307",25,23,23,0,0,"PODEMOS-IU",2
50,"50011",117,90,89,3,1,"PODEMOS-IU",7
50,"50166",235,186,186,0,0,"PODEMOS-IU",26
9,"9206",52,43,43,0,0,"PODEMOS-IU",1
37,"37358",159,124,124,0,0,"PODEMOS-IU",11
19,"19227",68,42,41,1,1,"PODEMOS-IU",6
37,"37169",177,122,122,0,0,"PODEMOS-IU",4
44,"44036",22,20,20,0,0,"PODEMOS-IU",3
10,"10019",1412,948,934,2,14,"PODEMOS-IU",90
30,"30028",6390,4054,3973,25,81,"PODEMOS-IU",528
24,"24108",348,247,246,4,1,"PODEMOS-IU",8
24,"24166",1346,929,916,14,13,"PODEMOS-IU",66
13,"13027",3185,2112,2055,12,57,"PODEMOS-IU",95
40,"40054",108,79,78,3,1,"PODEMOS-IU",10
40,"40063",6913,4948,4838,57,110,"PODEMOS-IU",533
16,"16279",173,109,108,0,1,"PODEMOS-IU",6
6,"6002",4313,2914,2804,37,110,"PODEMOS-IU",301
10,"10046",184,144,140,0,4,"PODEMOS-IU",8
16,"16133",4399,3317,3256,34,61,"PODEMOS-IU",590
24,"24098",1149,753,741,8,12,"PODEMOS-IU",100
9,"9302",96,66,66,0,0,"PODEMOS-IU",5
44,"44119",116,80,79,1,1,"PODEMOS-IU",5
40,"40905",130,95,95,0,0,"PODEMOS-IU",0
44,"44065",55,33,32,0,1,"PODEMOS-IU",1
9,"9244",45,31,31,2,0,"PODEMOS-IU",4
37,"37224",189,156,153,2,3,"PODEMOS-IU",2
50,"50081",487,355,349,5,6,"PODEMOS-IU",32
19,"19133",78,64,64,2,0,"PODEMOS-IU",3
2,"2015",1432,1163,1148,8,15,"PODEMOS-IU",68
19,"19143",1781,1278,1266,18,12,"PODEMOS-IU",105
37,"37158",230,149,149,1,0,"PODEMOS-IU",24
24,"24153",228,171,171,3,0,"PODEMOS-IU",9
5,"5220",364,277,274,0,3,"PODEMOS-IU",14
44,"44184",44,37,37,0,0,"PODEMOS-IU",1
39,"39008",13900,9814,9734,63,80,"PODEMOS-IU",990
44,"44099",644,422,421,2,1,"PODEMOS-IU",25
26,"26063",118,88,88,2,0,"PODEMOS-IU",8
50,"50063",64,49,49,0,0,"PODEMOS-IU",0
49,"49123",519,384,383,4,1,"PODEMOS-IU",30
24,"24207",276,215,215,2,0,"PODEMOS-IU",15
49,"49061",143,98,97,1,1,"PODEMOS-IU",7
10,"10026",647,464,452,6,12,"PODEMOS-IU",53
5,"5189",397,293,291,3,2,"PODEMOS-IU",17
44,"44130",28,23,23,0,0,"PODEMOS-IU",1
45,"45086",483,339,332,0,7,"PODEMOS-IU",16
34,"34224",39,25,25,0,0,"PODEMOS-IU",0
28,"28038",5213,3801,3753,24,48,"PODEMOS-IU",593
28,"28079",2384271,1765443,1753633,13854,11810,"PODEMOS-IU",228721
42,"42032",138,96,96,0,0,"PODEMOS-IU",2
44,"44020",22,21,21,0,0,"PODEMOS-IU",1
24,"24221",738,492,485,9,7,"PODEMOS-IU",26
42,"42217",33,25,25,0,0,"PODEMOS-IU",2
34,"34229",58,47,47,1,0,"PODEMOS-IU",2
37,"37008",4213,3092,3046,21,46,"PODEMOS-IU",177
26,"26034",606,457,440,5,17,"PODEMOS-IU",42
39,"39032",1420,1032,1027,7,5,"PODEMOS-IU",46
42,"42106",13,11,11,0,0,"PODEMOS-IU",0
24,"24113",346,240,240,2,0,"PODEMOS-IU",7
10,"10187",431,288,281,0,7,"PODEMOS-IU",49
6,"6144",504,391,382,6,9,"PODEMOS-IU",46
35,"35003",5644,2987,2943,20,44,"PODEMOS-IU",418
5,"5212",197,117,117,0,0,"PODEMOS-IU",1
42,"42198",19,9,9,1,0,"PODEMOS-IU",1
5,"5257",132,98,95,4,3,"PODEMOS-IU",7
5,"5244",39,29,29,0,0,"PODEMOS-IU",5
40,"40025",129,109,107,1,2,"PODEMOS-IU",10
37,"37353",122,82,80,0,2,"PODEMOS-IU",0
44,"44231",35,30,30,0,0,"PODEMOS-IU",8
10,"10061",1591,1010,992,9,18,"PODEMOS-IU",62
13,"13075",196,147,146,2,1,"PODEMOS-IU",5
10,"10180",4206,2609,2574,13,35,"PODEMOS-IU",154
47,"47212",356,289,287,4,2,"PODEMOS-IU",6
9,"9394",668,432,429,6,3,"PODEMOS-IU",35
9,"9358",247,165,161,3,4,"PODEMOS-IU",6
16,"16106",2701,2029,2001,6,28,"PODEMOS-IU",80
47,"47128",53,45,43,0,2,"PODEMOS-IU",1
26,"26181",15,14,14,0,0,"PODEMOS-IU",0
2,"2019",2352,1806,1766,9,40,"PODEMOS-IU",139
9,"9029",151,111,108,2,3,"PODEMOS-IU",14
19,"19088",91,67,66,0,1,"PODEMOS-IU",4
24,"24070",3886,2677,2625,18,52,"PODEMOS-IU",514
45,"45153",1568,1168,1162,8,6,"PODEMOS-IU",83
10,"10109",1714,1030,1006,4,24,"PODEMOS-IU",70
9,"9043",172,112,111,1,1,"PODEMOS-IU",11
49,"49142",244,163,160,0,3,"PODEMOS-IU",14
19,"19193",22,21,21,1,0,"PODEMOS-IU",0
49,"49109",561,419,415,6,4,"PODEMOS-IU",5
45,"45163",8326,5835,5693,48,142,"PODEMOS-IU",574
28,"28149",6298,4751,4699,35,52,"PODEMOS-IU",542
39,"39081",440,330,327,1,3,"PODEMOS-IU",17
49,"49044",78,56,53,0,3,"PODEMOS-IU",1
10,"10142",833,555,539,0,16,"PODEMOS-IU",76
9,"9048",1373,937,911,10,26,"PODEMOS-IU",99
38,"38011",21655,13974,13831,106,143,"PODEMOS-IU",2108
6,"6134",526,306,301,1,5,"PODEMOS-IU",21
19,"19255",74,37,37,0,0,"PODEMOS-IU",3
44,"44014",2506,1828,1818,8,10,"PODEMOS-IU",152
34,"34245",307,212,212,0,0,"PODEMOS-IU",4
28,"28170",2495,1714,1695,13,19,"PODEMOS-IU",212
2,"2084",298,197,191,2,6,"PODEMOS-IU",10
40,"40171",40,32,32,1,0,"PODEMOS-IU",1
9,"9202",22,16,16,2,0,"PODEMOS-IU",0
28,"28094",988,711,707,5,4,"PODEMOS-IU",132
44,"44074",440,314,308,2,6,"PODEMOS-IU",5
13,"13008",422,280,272,2,8,"PODEMOS-IU",8
10,"10029",380,284,276,0,8,"PODEMOS-IU",17
9,"9148",77,58,58,3,0,"PODEMOS-IU",5
19,"19007",433,316,310,1,6,"PODEMOS-IU",20
10,"10025",377,308,299,3,9,"PODEMOS-IU",41
28,"28003",167,133,131,4,2,"PODEMOS-IU",10
50,"50209",2785,1893,1865,24,28,"PODEMOS-IU",189
19,"19239",93,70,70,1,0,"PODEMOS-IU",2
47,"47002",18,18,18,0,0,"PODEMOS-IU",0
37,"37336",56,45,43,2,2,"PODEMOS-IU",0
10,"10048",202,141,139,0,2,"PODEMOS-IU",2
10,"10206",196,135,133,0,2,"PODEMOS-IU",10
10,"10030",455,311,305,2,6,"PODEMOS-IU",14
40,"40019",29,23,23,1,0,"PODEMOS-IU",1
49,"49099",96,67,67,0,0,"PODEMOS-IU",1
44,"44096",155,115,114,1,1,"PODEMOS-IU",5
5,"5087",147,108,107,3,1,"PODEMOS-IU",3
37,"37252",99,65,65,1,0,"PODEMOS-IU",0
42,"42131",50,39,39,2,0,"PODEMOS-IU",1
24,"24052",139,94,93,0,1,"PODEMOS-IU",5
24,"24119",695,464,458,7,6,"PODEMOS-IU",50
50,"50191",446,327,326,1,1,"PODEMOS-IU",26
19,"19254",43,34,34,0,0,"PODEMOS-IU",4
9,"9251",362,258,256,3,2,"PODEMOS-IU",38
45,"45021",2639,1798,1755,22,43,"PODEMOS-IU",180
6,"6107",1555,980,969,8,11,"PODEMOS-IU",57
2,"2901",2196,1441,1419,10,22,"PODEMOS-IU",61
16,"16079",28,16,16,0,0,"PODEMOS-IU",0
50,"50168",29,20,20,0,0,"PODEMOS-IU",1
16,"16031",35,26,26,0,0,"PODEMOS-IU",3
6,"6159",2329,1297,1273,22,24,"PODEMOS-IU",183
24,"24105",1512,1054,1047,10,7,"PODEMOS-IU",104
24,"24148",1602,1152,1140,11,12,"PODEMOS-IU",97
19,"19121",265,205,204,0,1,"PODEMOS-IU",15
44,"44187",193,147,146,0,1,"PODEMOS-IU",3
19,"19076",29,23,23,0,0,"PODEMOS-IU",2
50,"50284",129,98,98,0,0,"PODEMOS-IU",11
5,"5046",38,35,35,0,0,"PODEMOS-IU",0
9,"9017",89,61,60,3,1,"PODEMOS-IU",1
37,"37140",630,395,393,0,2,"PODEMOS-IU",8
44,"44197",51,35,35,1,0,"PODEMOS-IU",3
16,"16228",173,147,145,2,2,"PODEMOS-IU",4
49,"49004",110,74,71,3,3,"PODEMOS-IU",7
16,"16272",201,149,147,2,2,"PODEMOS-IU",7
50,"50069",66,33,33,1,0,"PODEMOS-IU",2
10,"10075",238,150,148,0,2,"PODEMOS-IU",15
49,"49157",188,136,133,2,3,"PODEMOS-IU",11
37,"37235",214,163,159,2,4,"PODEMOS-IU",8
42,"42044",53,37,35,1,2,"PODEMOS-IU",1
2,"2078",891,650,642,4,8,"PODEMOS-IU",106
49,"49168",89,68,68,0,0,"PODEMOS-IU",2
47,"47005",506,358,348,3,10,"PODEMOS-IU",12
16,"16277",105,74,74,0,0,"PODEMOS-IU",2
16,"16131",123,84,84,0,0,"PODEMOS-IU",3
39,"39097",666,342,335,2,7,"PODEMOS-IU",8
9,"9220",69,52,52,3,0,"PODEMOS-IU",2
30,"30003",25200,16249,16120,159,129,"PODEMOS-IU",1449
28,"28074",141137,106626,105602,885,1024,"PODEMOS-IU",16420
34,"34124",60,45,45,0,0,"PODEMOS-IU",2
37,"37100",74,59,58,1,1,"PODEMOS-IU",1
19,"19230",558,409,406,1,3,"PODEMOS-IU",61
19,"19066",51,42,42,0,0,"PODEMOS-IU",4
34,"34233",128,104,104,0,0,"PODEMOS-IU",0
9,"9141",617,463,456,5,7,"PODEMOS-IU",36
45,"45025",1218,849,844,9,5,"PODEMOS-IU",83
9,"9159",62,49,47,0,2,"PODEMOS-IU",4
9,"9448",203,159,157,0,2,"PODEMOS-IU",6
38,"38047",1755,1132,1110,9,22,"PODEMOS-IU",75
19,"19222",95,70,70,2,0,"PODEMOS-IU",4
5,"5162",76,47,45,1,2,"PODEMOS-IU",5
16,"16259",28,22,22,0,0,"PODEMOS-IU",0
9,"9082",36,32,32,0,0,"PODEMOS-IU",1
10,"10152",444,312,309,2,3,"PODEMOS-IU",17
16,"16073",190,153,153,1,0,"PODEMOS-IU",5
6,"6068",427,298,294,5,4,"PODEMOS-IU",9
34,"34062",148,94,93,0,1,"PODEMOS-IU",0
37,"37178",98,70,70,0,0,"PODEMOS-IU",0
10,"10084",1266,755,717,7,38,"PODEMOS-IU",56
50,"50075",70,55,55,1,0,"PODEMOS-IU",0
38,"38020",16057,9921,9809,66,112,"PODEMOS-IU",1419
34,"34038",259,183,178,0,5,"PODEMOS-IU",7
40,"40181",4182,3102,3038,35,64,"PODEMOS-IU",394
6,"6114",127,105,105,0,0,"PODEMOS-IU",5
37,"37168",397,271,266,3,5,"PODEMOS-IU",8
47,"47021",73,57,55,0,2,"PODEMOS-IU",5
45,"45067",2267,1722,1675,14,47,"PODEMOS-IU",86
5,"5047",4105,3004,2936,23,68,"PODEMOS-IU",168
5,"5194",132,105,104,1,1,"PODEMOS-IU",2
13,"13039",14195,10104,9933,122,171,"PODEMOS-IU",916
50,"50251",8209,5732,5658,66,74,"PODEMOS-IU",704
9,"9175",120,78,76,1,2,"PODEMOS-IU",7
9,"9356",43,31,30,0,1,"PODEMOS-IU",1
19,"19047",55,47,47,1,0,"PODEMOS-IU",8
49,"49209",451,274,269,7,5,"PODEMOS-IU",12
28,"28095",1719,1236,1226,5,10,"PODEMOS-IU",166
50,"50239",63,46,45,1,1,"PODEMOS-IU",1
37,"37191",102,57,57,1,0,"PODEMOS-IU",0
9,"9339",128,106,105,0,1,"PODEMOS-IU",15
34,"34232",725,505,492,13,13,"PODEMOS-IU",12
42,"42127",37,26,26,1,0,"PODEMOS-IU",3
50,"50238",84,65,65,0,0,"PODEMOS-IU",9
37,"37102",375,260,260,4,0,"PODEMOS-IU",6
37,"37166",196,134,133,1,1,"PODEMOS-IU",2
34,"34127",80,62,62,0,0,"PODEMOS-IU",2
28,"28106",78872,54111,53443,412,668,"PODEMOS-IU",8753
10,"10165",252,204,201,3,3,"PODEMOS-IU",8
9,"9032",103,62,62,3,0,"PODEMOS-IU",4
49,"49114",40,31,27,0,4,"PODEMOS-IU",3
19,"19248",73,54,54,0,0,"PODEMOS-IU",8
10,"10011",518,385,370,2,15,"PODEMOS-IU",12
16,"16238",461,380,378,1,2,"PODEMOS-IU",20
42,"42090",83,65,64,1,1,"PODEMOS-IU",0
10,"10076",791,537,525,10,12,"PODEMOS-IU",29
34,"34129",168,118,118,1,0,"PODEMOS-IU",4
19,"19109",33,26,26,2,0,"PODEMOS-IU",1
16,"16142",119,90,90,0,0,"PODEMOS-IU",9
50,"50031",134,78,75,0,3,"PODEMOS-IU",7
13,"13084",841,652,644,6,8,"PODEMOS-IU",25
16,"16189",264,196,194,4,2,"PODEMOS-IU",3
40,"40065",467,338,329,1,9,"PODEMOS-IU",29
40,"40111",50,39,39,0,0,"PODEMOS-IU",1
19,"19286",772,585,575,3,10,"PODEMOS-IU",76
16,"16181",54,40,40,0,0,"PODEMOS-IU",2
42,"42107",70,48,47,1,1,"PODEMOS-IU",3
42,"42048",60,52,52,0,0,"PODEMOS-IU",2
6,"6113",2649,1889,1862,16,27,"PODEMOS-IU",256
26,"26030",18,18,17,1,1,"PODEMOS-IU",2
50,"50057",1331,933,922,10,11,"PODEMOS-IU",46
39,"39020",23993,15944,15792,89,152,"PODEMOS-IU",2901
16,"16068",125,88,88,3,0,"PODEMOS-IU",5
10,"10905",636,443,433,7,10,"PODEMOS-IU",15
24,"24115",53159,35203,34784,410,419,"PODEMOS-IU",4968
44,"44041",60,48,48,0,0,"PODEMOS-IU",6
16,"16231",45,38,38,0,0,"PODEMOS-IU",2
44,"44013",11232,7872,7801,64,71,"PODEMOS-IU",578
6,"6138",1021,677,658,5,19,"PODEMOS-IU",47
49,"49191",265,192,188,2,4,"PODEMOS-IU",7
49,"49245",251,174,171,1,3,"PODEMOS-IU",13
19,"19219",9,8,7,0,1,"PODEMOS-IU",1
13,"13022",348,244,239,1,5,"PODEMOS-IU",7
47,"47154",146,115,111,6,4,"PODEMOS-IU",12
9,"9067",399,232,230,3,2,"PODEMOS-IU",10
6,"6020",1752,1330,1296,6,34,"PODEMOS-IU",139
24,"24185",447,303,295,1,8,"PODEMOS-IU",19
19,"19310",7,7,7,0,0,"PODEMOS-IU",1
19,"19190",2284,1632,1613,16,19,"PODEMOS-IU",172
40,"40021",18,15,15,0,0,"PODEMOS-IU",1
44,"44108",306,209,205,1,4,"PODEMOS-IU",24
9,"9037",105,94,93,0,1,"PODEMOS-IU",12
34,"34174",172,142,136,0,6,"PODEMOS-IU",2
37,"37324",333,247,242,3,5,"PODEMOS-IU",1
44,"44043",86,60,60,0,0,"PODEMOS-IU",5
26,"26101",31,18,17,0,1,"PODEMOS-IU",0
47,"47152",67,59,59,0,0,"PODEMOS-IU",4
44,"44089",49,41,41,0,0,"PODEMOS-IU",2
38,"38014",1342,943,930,6,13,"PODEMOS-IU",92
5,"5090",73,63,62,0,1,"PODEMOS-IU",1
40,"40904",344,286,284,8,2,"PODEMOS-IU",42
37,"37171",396,272,270,2,2,"PODEMOS-IU",6
13,"13093",3901,2617,2569,16,48,"PODEMOS-IU",170
38,"38038",165135,101564,100807,709,757,"PODEMOS-IU",15761
26,"26109",73,68,68,0,0,"PODEMOS-IU",6
35,"35020",5941,3740,3702,27,38,"PODEMOS-IU",254
16,"16171",1728,1334,1313,10,21,"PODEMOS-IU",50
26,"26001",199,145,141,3,4,"PODEMOS-IU",9
9,"9200",48,29,29,0,0,"PODEMOS-IU",3
37,"37115",108,67,65,0,2,"PODEMOS-IU",0
42,"42071",159,92,92,2,0,"PODEMOS-IU",2
44,"44055",75,52,50,0,2,"PODEMOS-IU",0
5,"5222",140,118,118,0,0,"PODEMOS-IU",7
37,"37292",91,65,65,0,0,"PODEMOS-IU",3
13,"13088",585,413,409,3,4,"PODEMOS-IU",22
49,"49268",364,266,263,3,3,"PODEMOS-IU",5
28,"28045",35523,26213,25966,212,247,"PODEMOS-IU",3287
16,"16040",91,76,76,2,0,"PODEMOS-IU",5
24,"24121",599,422,418,3,4,"PODEMOS-IU",62
42,"42168",108,73,73,0,0,"PODEMOS-IU",10
28,"28174",1858,1284,1273,1,11,"PODEMOS-IU",126
49,"49075",130,100,97,1,3,"PODEMOS-IU",1
19,"19032",145,94,93,2,1,"PODEMOS-IU",7
16,"16903",992,750,732,8,18,"PODEMOS-IU",21
9,"9006",57,30,29,0,1,"PODEMOS-IU",3
42,"42042",53,42,41,1,1,"PODEMOS-IU",3
5,"5264",54,32,31,4,1,"PODEMOS-IU",3
47,"47066",1482,1096,1086,14,10,"PODEMOS-IU",129
13,"13068",1023,737,722,2,15,"PODEMOS-IU",49
40,"40030",419,317,314,3,3,"PODEMOS-IU",37
45,"45177",1998,1557,1525,10,32,"PODEMOS-IU",130
34,"34221",168,129,127,2,2,"PODEMOS-IU",7
34,"34019",111,87,86,1,1,"PODEMOS-IU",2
40,"40008",42,36,36,1,0,"PODEMOS-IU",0
5,"5083",137,92,91,0,1,"PODEMOS-IU",2
47,"47172",135,114,113,0,1,"PODEMOS-IU",17
37,"37349",100,61,58,0,3,"PODEMOS-IU",0
49,"49059",84,61,58,0,3,"PODEMOS-IU",0
40,"40128",123,88,87,1,1,"PODEMOS-IU",11
19,"19194",91,69,69,0,0,"PODEMOS-IU",5
30,"30008",14560,9974,9840,79,134,"PODEMOS-IU",1172
5,"5126",60,47,45,0,2,"PODEMOS-IU",1
50,"50214",18,18,14,1,4,"PODEMOS-IU",1
10,"10183",950,696,684,3,12,"PODEMOS-IU",51
9,"9211",1369,938,921,14,17,"PODEMOS-IU",43
5,"5149",101,72,71,2,1,"PODEMOS-IU",3
6,"6104",648,470,459,2,11,"PODEMOS-IU",20
40,"40082",104,84,84,2,0,"PODEMOS-IU",2
19,"19115",29,23,23,0,0,"PODEMOS-IU",1
9,"9243",73,50,49,1,1,"PODEMOS-IU",2
9,"9130",64,39,39,2,0,"PODEMOS-IU",2
5,"5049",403,261,253,1,8,"PODEMOS-IU",19
37,"37314",81,65,65,0,0,"PODEMOS-IU",4
35,"35012",10862,5617,5568,40,49,"PODEMOS-IU",620
9,"9201",27,17,17,0,0,"PODEMOS-IU",2
22,"22027",311,210,209,1,1,"PODEMOS-IU-",23
22,"22195",238,190,186,0,4,"PODEMOS-IU-",20
22,"22189",175,142,142,1,0,"PODEMOS-IU-",11
22,"22019",176,128,126,1,2,"PODEMOS-IU-",17
22,"22102",180,137,136,3,1,"PODEMOS-IU-",13
22,"22905",287,217,217,1,0,"PODEMOS-IU-",12
22,"22252",118,95,91,1,4,"PODEMOS-IU-",8
22,"22199",6884,4438,4384,71,54,"PODEMOS-IU-",636
22,"22184",167,132,130,4,2,"PODEMOS-IU-",4
22,"22080",263,188,184,3,4,"PODEMOS-IU-",14
22,"22235",88,69,68,1,1,"PODEMOS-IU-",4
22,"22150",459,325,321,8,4,"PODEMOS-IU-",49
22,"22103",664,489,489,4,0,"PODEMOS-IU-",48
22,"22003",135,107,107,0,0,"PODEMOS-IU-",14
22,"22182",227,132,131,3,1,"PODEMOS-IU-",23
22,"22205",448,294,292,0,2,"PODEMOS-IU-",38
22,"22165",449,305,300,3,5,"PODEMOS-IU-",22
22,"22036",84,71,71,1,0,"PODEMOS-IU-",9
22,"22158",11994,8115,8049,79,66,"PODEMOS-IU-",960
22,"22225",2606,1638,1612,20,26,"PODEMOS-IU-",207
22,"22072",197,127,126,1,1,"PODEMOS-IU-",27
22,"22081",247,173,171,3,2,"PODEMOS-IU-",7
22,"22029",118,85,83,1,2,"PODEMOS-IU-",3
22,"22136",749,524,518,5,6,"PODEMOS-IU-",53
22,"22061",6567,4446,4410,48,36,"PODEMOS-IU-",559
22,"22015",299,218,215,1,3,"PODEMOS-IU-",23
22,"22113",478,335,333,6,2,"PODEMOS-IU-",56
22,"22007",751,527,520,1,7,"PODEMOS-IU-",44
22,"22207",121,66,65,0,1,"PODEMOS-IU-",7
22,"22083",447,360,355,6,5,"PODEMOS-IU-",22
22,"22050",93,77,77,0,0,"PODEMOS-IU-",4
22,"22119",1267,880,871,4,9,"PODEMOS-IU-",86
22,"22143",190,118,115,1,3,"PODEMOS-IU-",11
22,"22017",826,613,608,2,5,"PODEMOS-IU-",41
22,"22197",436,327,325,3,2,"PODEMOS-IU-",26
22,"22906",177,123,122,6,1,"PODEMOS-IU-",17
22,"22187",288,220,220,2,0,"PODEMOS-IU-",46
22,"22020",115,83,80,3,3,"PODEMOS-IU-",8
22,"22041",145,116,116,2,0,"PODEMOS-IU-",7
22,"22181",86,55,54,2,1,"PODEMOS-IU-",7
22,"22220",147,106,105,1,1,"PODEMOS-IU-",10
22,"22049",73,62,62,0,0,"PODEMOS-IU-",2
22,"22014",227,164,162,5,2,"PODEMOS-IU-",15
22,"22232",88,61,61,2,0,"PODEMOS-IU-",4
22,"22122",69,52,50,2,2,"PODEMOS-IU-",9
22,"22035",225,153,152,1,1,"PODEMOS-IU-",22
22,"22001",212,147,146,0,1,"PODEMOS-IU-",22
22,"22011",98,80,79,0,1,"PODEMOS-IU-",10
22,"22217",370,274,269,4,5,"PODEMOS-IU-",12
22,"22230",291,209,207,4,2,"PODEMOS-IU-",29
22,"22246",63,43,43,0,0,"PODEMOS-IU-",5
22,"22106",20,13,13,2,0,"PODEMOS-IU-",2
22,"22068",64,41,41,1,0,"PODEMOS-IU-",6
22,"22099",490,349,343,2,6,"PODEMOS-IU-",44
22,"22247",28,18,18,0,0,"PODEMOS-IU-",3
22,"22172",520,373,369,5,4,"PODEMOS-IU-",15
22,"22013",271,200,197,3,3,"PODEMOS-IU-",17
22,"22053",783,494,492,6,2,"PODEMOS-IU-",68
22,"22176",171,140,138,2,2,"PODEMOS-IU-",13
22,"22907",1463,1016,1006,21,10,"PODEMOS-IU-",186
22,"22052",874,660,652,7,8,"PODEMOS-IU-",57
22,"22163",426,338,335,0,3,"PODEMOS-IU-",45
22,"22141",115,94,93,0,1,"PODEMOS-IU-",8
22,"22077",362,280,272,5,8,"PODEMOS-IU-",18
22,"22115",348,263,261,3,2,"PODEMOS-IU-",25
22,"22008",144,113,112,2,1,"PODEMOS-IU-",4
22,"22200",239,165,164,2,1,"PODEMOS-IU-",31
22,"22193",272,199,194,4,5,"PODEMOS-IU-",19
22,"22156",289,216,213,1,3,"PODEMOS-IU-",24
22,"22059",1135,765,752,2,13,"PODEMOS-IU-",135
22,"22076",285,207,203,4,4,"PODEMOS-IU-",18
22,"22111",143,96,95,2,1,"PODEMOS-IU-",3
22,"22082",288,217,214,0,3,"PODEMOS-IU-",5
22,"22042",116,91,89,1,2,"PODEMOS-IU-",8
22,"22175",184,129,128,0,1,"PODEMOS-IU-",24
22,"22125",39530,27358,27075,344,283,"PODEMOS-IU-",3447
22,"22234",743,498,491,5,7,"PODEMOS-IU-",47
22,"22023",385,293,283,2,10,"PODEMOS-IU-",9
22,"22213",2918,2084,2062,20,22,"PODEMOS-IU-",165
22,"22116",1342,915,905,11,10,"PODEMOS-IU-",56
22,"22012",102,75,75,2,0,"PODEMOS-IU-",6
22,"22016",558,384,382,5,2,"PODEMOS-IU-",53
22,"22186",189,148,145,3,3,"PODEMOS-IU-",14
22,"22062",154,107,107,1,0,"PODEMOS-IU-",18
22,"22160",207,149,149,1,0,"PODEMOS-IU-",33
22,"22250",346,241,241,0,0,"PODEMOS-IU-",57
22,"22064",155,100,100,2,0,"PODEMOS-IU-",8
22,"22243",43,32,31,0,1,"PODEMOS-IU-",2
22,"22909",307,219,217,0,2,"PODEMOS-IU-",27
22,"22004",123,83,83,0,0,"PODEMOS-IU-",11
22,"22078",431,285,285,4,0,"PODEMOS-IU-",66
22,"22151",85,60,60,0,0,"PODEMOS-IU-",10
22,"22228",532,371,364,4,7,"PODEMOS-IU-",46
22,"22178",105,89,89,1,0,"PODEMOS-IU-",3
22,"22130",10146,6505,6436,57,69,"PODEMOS-IU-",913
22,"22107",102,53,53,0,0,"PODEMOS-IU-",8
22,"22902",206,147,144,1,3,"PODEMOS-IU-",17
22,"22222",516,379,377,6,2,"PODEMOS-IU-",46
22,"22117",2384,1606,1596,18,10,"PODEMOS-IU-",207
22,"22149",301,211,210,1,1,"PODEMOS-IU-",29
22,"22229",107,70,70,2,0,"PODEMOS-IU-",21
22,"22254",1084,744,735,10,9,"PODEMOS-IU-",67
22,"22218",39,34,34,0,0,"PODEMOS-IU-",1
22,"22223",77,60,59,2,1,"PODEMOS-IU-",20
22,"22046",713,555,549,9,6,"PODEMOS-IU-",44
22,"22129",162,110,110,0,0,"PODEMOS-IU-",9
22,"22055",305,242,235,2,7,"PODEMOS-IU-",10
22,"22174",462,352,350,0,2,"PODEMOS-IU-",17
22,"22095",66,52,51,1,1,"PODEMOS-IU-",9
22,"22133",108,71,71,3,0,"PODEMOS-IU-",10
22,"22051",90,72,72,2,0,"PODEMOS-IU-",6
22,"22215",127,81,81,0,0,"PODEMOS-IU-",8
22,"22208",192,150,147,1,3,"PODEMOS-IU-",30
22,"22139",80,57,57,1,0,"PODEMOS-IU-",8
22,"22128",188,145,143,3,2,"PODEMOS-IU-",16
22,"22057",364,253,248,4,5,"PODEMOS-IU-",35
22,"22168",22,20,19,0,1,"PODEMOS-IU-",1
22,"22164",42,28,28,0,0,"PODEMOS-IU-",6
22,"22188",75,50,50,1,0,"PODEMOS-IU-",15
22,"22908",190,135,134,0,1,"PODEMOS-IU-",19
22,"22006",268,167,164,4,3,"PODEMOS-IU-",39
22,"22105",102,65,65,0,0,"PODEMOS-IU-",11
22,"22131",84,62,58,5,4,"PODEMOS-IU-",2
22,"22089",274,195,193,2,2,"PODEMOS-IU-",34
22,"22110",700,476,473,3,3,"PODEMOS-IU-",53
22,"22242",60,41,40,0,1,"PODEMOS-IU-",2
22,"22167",465,358,356,8,2,"PODEMOS-IU-",37
22,"22021",1884,1331,1319,26,12,"PODEMOS-IU-",108
22,"22060",1167,817,808,14,9,"PODEMOS-IU-",93
22,"22047",248,202,201,1,1,"PODEMOS-IU-",22
22,"22901",714,433,423,6,10,"PODEMOS-IU-",77
22,"22069",423,296,294,4,2,"PODEMOS-IU-",40
22,"22079",118,85,84,1,1,"PODEMOS-IU-",7
22,"22202",147,128,128,3,0,"PODEMOS-IU-",20
22,"22109",261,184,183,1,1,"PODEMOS-IU-",24
22,"22063",161,128,126,0,2,"PODEMOS-IU-",11
22,"22206",179,138,137,0,1,"PODEMOS-IU-",21
22,"22142",94,72,70,0,2,"PODEMOS-IU-",11
22,"22040",149,119,119,3,0,"PODEMOS-IU-",21
22,"22245",303,222,213,3,9,"PODEMOS-IU-",16
22,"22124",183,119,119,0,0,"PODEMOS-IU-",12
22,"22112",9525,6317,6245,91,72,"PODEMOS-IU-",781
22,"22173",219,147,141,3,6,"PODEMOS-IU-",32
22,"22114",124,75,72,1,3,"PODEMOS-IU-",4
22,"22155",66,52,52,0,0,"PODEMOS-IU-",4
22,"22009",581,387,386,7,1,"PODEMOS-IU-",91
22,"22025",1022,705,694,14,11,"PODEMOS-IU-",83
22,"22066",755,529,520,8,9,"PODEMOS-IU-",129
22,"22018",303,216,215,3,1,"PODEMOS-IU-",19
22,"22144",255,192,190,2,2,"PODEMOS-IU-",21
22,"22086",194,137,137,1,0,"PODEMOS-IU-",20
22,"22032",102,69,68,1,1,"PODEMOS-IU-",11
22,"22226",761,537,530,13,7,"PODEMOS-IU-",36
22,"22249",125,93,92,1,1,"PODEMOS-IU-",22
22,"22904",751,516,511,3,5,"PODEMOS-IU-",60
22,"22212",69,52,52,1,0,"PODEMOS-IU-",3
22,"22090",86,61,61,1,0,"PODEMOS-IU-",12
22,"22170",672,460,456,5,4,"PODEMOS-IU-",104
22,"22022",542,405,403,2,2,"PODEMOS-IU-",45
22,"22221",92,56,55,0,1,"PODEMOS-IU-",16
22,"22043",93,53,53,0,0,"PODEMOS-IU-",13
22,"22244",42,33,32,1,1,"PODEMOS-IU-",3
22,"22028",358,237,233,1,4,"PODEMOS-IU-",36
22,"22201",264,188,186,3,2,"PODEMOS-IU-",22
22,"22251",327,259,256,0,3,"PODEMOS-IU-",8
22,"22239",85,67,65,0,2,"PODEMOS-IU-",4
22,"22157",181,122,121,2,1,"PODEMOS-IU-",22
22,"22044",234,166,164,1,2,"PODEMOS-IU-",24
22,"22074",303,209,208,5,1,"PODEMOS-IU-",38
22,"22162",125,94,94,0,0,"PODEMOS-IU-",2
22,"22177",96,69,68,0,1,"PODEMOS-IU-",6
22,"22903",618,484,482,5,2,"PODEMOS-IU-",52
22,"22002",99,81,81,0,0,"PODEMOS-IU-",8
22,"22094",102,69,69,3,0,"PODEMOS-IU-",6
22,"22084",571,400,391,5,9,"PODEMOS-IU-",75
22,"22214",117,92,89,0,3,"PODEMOS-IU-",15
22,"22096",332,248,241,10,7,"PODEMOS-IU-",29
22,"22203",77,62,62,2,0,"PODEMOS-IU-",5
22,"22127",521,353,352,5,1,"PODEMOS-IU-",46
22,"22190",123,77,77,1,0,"PODEMOS-IU-",19
22,"22088",143,98,97,1,1,"PODEMOS-IU-",16
22,"22048",12635,8889,8807,98,82,"PODEMOS-IU-",833
22,"22253",56,40,40,1,0,"PODEMOS-IU-",3
22,"22085",94,78,76,0,2,"PODEMOS-IU-",8
22,"22248",103,73,73,0,0,"PODEMOS-IU-",8
22,"22058",193,141,141,0,0,"PODEMOS-IU-",25
22,"22054",1614,1029,1009,19,20,"PODEMOS-IU-",211
22,"22039",813,635,634,4,1,"PODEMOS-IU-",106
22,"22024",220,159,158,1,1,"PODEMOS-IU-",30
22,"22227",200,140,140,2,0,"PODEMOS-IU-",20
22,"22045",65,52,52,0,0,"PODEMOS-IU-",12
22,"22135",173,123,121,0,2,"PODEMOS-IU-",14
22,"22209",161,121,121,3,0,"PODEMOS-IU-",25
22,"22075",116,71,69,1,2,"PODEMOS-IU-",3
22,"22037",112,87,87,2,0,"PODEMOS-IU-",29
22,"22137",1009,671,665,1,6,"PODEMOS-IU-",52
22,"22067",70,52,52,0,0,"PODEMOS-IU-",16
22,"22204",1117,728,723,14,5,"PODEMOS-IU-",98
22,"22087",60,46,46,0,0,"PODEMOS-IU-",1
22,"22233",81,53,53,0,0,"PODEMOS-IU-",3
22,"22126",89,64,64,0,0,"PODEMOS-IU-",6
22,"22236",232,190,188,2,2,"PODEMOS-IU-",13
31,"31075",113,69,69,2,0,"PODEMOS-IU-BATZARRE",14
31,"31189",1125,702,698,6,4,"PODEMOS-IU-BATZARRE",108
31,"31062",1070,778,770,10,8,"PODEMOS-IU-BATZARRE",105
31,"31013",615,371,365,1,6,"PODEMOS-IU-BATZARRE",94
31,"31226",572,347,343,4,4,"PODEMOS-IU-BATZARRE",46
31,"31152",1255,826,817,8,9,"PODEMOS-IU-BATZARRE",156
31,"31078",2418,1752,1729,16,23,"PODEMOS-IU-BATZARRE",261
31,"31249",1798,1235,1227,13,8,"PODEMOS-IU-BATZARRE",127
31,"31092",683,413,413,6,0,"PODEMOS-IU-BATZARRE",64
31,"31905",2992,1994,1984,9,10,"PODEMOS-IU-BATZARRE",450
31,"31012",763,550,542,7,8,"PODEMOS-IU-BATZARRE",92
31,"31079",65,46,46,2,0,"PODEMOS-IU-BATZARRE",5
31,"31237",182,138,135,2,3,"PODEMOS-IU-BATZARRE",19
31,"31187",99,53,52,0,1,"PODEMOS-IU-BATZARRE",7
31,"31128",349,217,215,4,2,"PODEMOS-IU-BATZARRE",42
31,"31074",394,293,292,5,1,"PODEMOS-IU-BATZARRE",58
31,"31116",57,27,27,3,0,"PODEMOS-IU-BATZARRE",1
31,"31063",84,59,59,0,0,"PODEMOS-IU-BATZARRE",2
31,"31210",186,131,130,2,1,"PODEMOS-IU-BATZARRE",8
31,"31159",1097,813,812,2,1,"PODEMOS-IU-BATZARRE",149
31,"31017",375,250,250,10,0,"PODEMOS-IU-BATZARRE",32
31,"31087",179,124,124,3,0,"PODEMOS-IU-BATZARRE",14
31,"31223",953,667,654,4,13,"PODEMOS-IU-BATZARRE",79
31,"31019",1831,1231,1224,17,7,"PODEMOS-IU-BATZARRE",220
31,"31100",256,166,165,0,1,"PODEMOS-IU-BATZARRE",25
31,"31172",370,257,250,6,7,"PODEMOS-IU-BATZARRE",51
31,"31245",76,51,48,2,3,"PODEMOS-IU-BATZARRE",0
31,"31114",388,272,271,3,1,"PODEMOS-IU-BATZARRE",79
31,"31073",298,207,206,1,1,"PODEMOS-IU-BATZARRE",22
31,"31026",130,108,107,0,1,"PODEMOS-IU-BATZARRE",6
31,"31118",156,104,104,3,0,"PODEMOS-IU-BATZARRE",24
31,"31224",884,637,630,7,7,"PODEMOS-IU-BATZARRE",87
31,"31113",130,77,76,0,1,"PODEMOS-IU-BATZARRE",14
31,"31102",135,60,60,1,0,"PODEMOS-IU-BATZARRE",3
31,"31232",25687,17548,17304,243,244,"PODEMOS-IU-BATZARRE",2589
31,"31066",819,577,559,4,18,"PODEMOS-IU-BATZARRE",75
31,"31234",146,101,101,0,0,"PODEMOS-IU-BATZARRE",20
31,"31259",475,313,311,5,2,"PODEMOS-IU-BATZARRE",26
31,"31076",2543,1965,1956,19,9,"PODEMOS-IU-BATZARRE",190
31,"31183",718,536,534,5,2,"PODEMOS-IU-BATZARRE",88
31,"31212",128,91,91,1,0,"PODEMOS-IU-BATZARRE",7
31,"31171",670,466,462,1,4,"PODEMOS-IU-BATZARRE",116
31,"31138",948,629,627,8,2,"PODEMOS-IU-BATZARRE",85
31,"31254",1916,1336,1322,9,14,"PODEMOS-IU-BATZARRE",168
31,"31057",1741,1237,1219,6,18,"PODEMOS-IU-BATZARRE",159
31,"31225",35,29,28,0,1,"PODEMOS-IU-BATZARRE",4
31,"31188",319,197,191,3,6,"PODEMOS-IU-BATZARRE",29
31,"31010",5719,3799,3770,22,29,"PODEMOS-IU-BATZARRE",721
31,"31164",542,410,408,5,2,"PODEMOS-IU-BATZARRE",44
31,"31006",1877,1328,1310,14,18,"PODEMOS-IU-BATZARRE",178
31,"31173",845,642,636,4,6,"PODEMOS-IU-BATZARRE",54
31,"31253",121,100,100,0,0,"PODEMOS-IU-BATZARRE",25
31,"31111",91,52,52,0,0,"PODEMOS-IU-BATZARRE",11
31,"31236",1319,815,808,8,7,"PODEMOS-IU-BATZARRE",115
31,"31160",104,83,82,1,1,"PODEMOS-IU-BATZARRE",15
31,"31208",2568,1855,1835,24,20,"PODEMOS-IU-BATZARRE",325
31,"31112",91,56,56,0,0,"PODEMOS-IU-BATZARRE",18
31,"31107",1671,1204,1182,12,22,"PODEMOS-IU-BATZARRE",87
31,"31031",212,134,132,2,2,"PODEMOS-IU-BATZARRE",15
31,"31084",1946,1367,1362,9,5,"PODEMOS-IU-BATZARRE",139
31,"31165",2772,1946,1930,16,16,"PODEMOS-IU-BATZARRE",330
31,"31093",275,201,198,3,3,"PODEMOS-IU-BATZARRE",20
31,"31150",200,120,119,1,1,"PODEMOS-IU-BATZARRE",28
31,"31200",745,489,483,1,6,"PODEMOS-IU-BATZARRE",88
31,"31201",151450,105649,104976,1004,673,"PODEMOS-IU-BATZARRE",17240
31,"31047",238,163,163,2,0,"PODEMOS-IU-BATZARRE",12
31,"31050",6016,3675,3612,41,63,"PODEMOS-IU-BATZARRE",379
31,"31166",242,172,172,2,0,"PODEMOS-IU-BATZARRE",22
31,"31235",156,112,108,1,4,"PODEMOS-IU-BATZARRE",13
31,"31081",338,229,227,1,2,"PODEMOS-IU-BATZARRE",20
31,"31001",79,56,56,0,0,"PODEMOS-IU-BATZARRE",13
31,"31097",10559,6977,6919,71,58,"PODEMOS-IU-BATZARRE",1055
31,"31142",1389,909,900,9,9,"PODEMOS-IU-BATZARRE",110
31,"31904",1559,989,972,11,17,"PODEMOS-IU-BATZARRE",178
31,"31005",279,183,183,4,0,"PODEMOS-IU-BATZARRE",21
31,"31049",679,461,453,2,8,"PODEMOS-IU-BATZARRE",45
31,"31901",15487,11077,10991,117,86,"PODEMOS-IU-BATZARRE",2091
31,"31065",1843,1311,1300,12,11,"PODEMOS-IU-BATZARRE",175
31,"31025",762,497,490,1,7,"PODEMOS-IU-BATZARRE",74
31,"31055",267,192,191,0,1,"PODEMOS-IU-BATZARRE",21
31,"31123",615,350,347,4,3,"PODEMOS-IU-BATZARRE",47
31,"31182",29,25,25,0,0,"PODEMOS-IU-BATZARRE",5
31,"31204",36,25,25,0,0,"PODEMOS-IU-BATZARRE",2
31,"31233",91,62,60,2,2,"PODEMOS-IU-BATZARRE",3
31,"31030",135,94,94,0,0,"PODEMOS-IU-BATZARRE",25
31,"31018",426,287,283,2,4,"PODEMOS-IU-BATZARRE",58
31,"31906",2707,1800,1781,22,19,"PODEMOS-IU-BATZARRE",402
31,"31196",31,23,23,0,0,"PODEMOS-IU-BATZARRE",5
31,"31095",71,59,59,0,0,"PODEMOS-IU-BATZARRE",3
31,"31156",238,175,174,2,1,"PODEMOS-IU-BATZARRE",30
31,"31099",51,38,38,0,0,"PODEMOS-IU-BATZARRE",4
31,"31902",4661,3228,3201,39,27,"PODEMOS-IU-BATZARRE",623
31,"31091",322,201,201,3,0,"PODEMOS-IU-BATZARRE",17
31,"31184",65,41,40,0,1,"PODEMOS-IU-BATZARRE",2
31,"31131",913,672,664,8,8,"PODEMOS-IU-BATZARRE",100
31,"31064",1398,1035,1031,5,4,"PODEMOS-IU-BATZARRE",130
31,"31209",149,111,110,0,1,"PODEMOS-IU-BATZARRE",34
31,"31077",5416,3840,3794,38,46,"PODEMOS-IU-BATZARRE",463
31,"31186",283,183,182,1,1,"PODEMOS-IU-BATZARRE",34
31,"31007",122,88,82,1,6,"PODEMOS-IU-BATZARRE",9
31,"31011",715,483,481,5,2,"PODEMOS-IU-BATZARRE",92
31,"31072",5324,3733,3684,33,49,"PODEMOS-IU-BATZARRE",418
31,"31231",104,65,65,1,0,"PODEMOS-IU-BATZARRE",5
31,"31089",236,168,167,1,1,"PODEMOS-IU-BATZARRE",18
31,"31053",509,354,350,4,4,"PODEMOS-IU-BATZARRE",56
31,"31199",138,86,84,0,2,"PODEMOS-IU-BATZARRE",10
31,"31120",376,211,209,7,2,"PODEMOS-IU-BATZARRE",30
31,"31125",271,173,171,3,2,"PODEMOS-IU-BATZARRE",37
31,"31162",48,28,27,1,1,"PODEMOS-IU-BATZARRE",3
31,"31061",48,45,45,2,0,"PODEMOS-IU-BATZARRE",2
31,"31252",80,52,52,1,0,"PODEMOS-IU-BATZARRE",7
31,"31141",106,66,61,1,5,"PODEMOS-IU-BATZARRE",6
31,"31028",215,121,121,2,0,"PODEMOS-IU-BATZARRE",15
31,"31090",139,67,67,0,0,"PODEMOS-IU-BATZARRE",9
31,"31179",486,315,312,3,3,"PODEMOS-IU-BATZARRE",40
31,"31002",431,294,290,3,4,"PODEMOS-IU-BATZARRE",59
31,"31167",833,581,573,2,8,"PODEMOS-IU-BATZARRE",95
31,"31261",240,161,158,2,3,"PODEMOS-IU-BATZARRE",27
31,"31082",627,385,385,5,0,"PODEMOS-IU-BATZARRE",58
31,"31038",1343,975,963,16,12,"PODEMOS-IU-BATZARRE",146
31,"31229",39,32,32,0,0,"PODEMOS-IU-BATZARRE",7
31,"31014",268,168,168,2,0,"PODEMOS-IU-BATZARRE",16
31,"31135",111,73,72,3,1,"PODEMOS-IU-BATZARRE",4
31,"31216",3867,2592,2566,37,26,"PODEMOS-IU-BATZARRE",570
31,"31058",199,134,133,2,1,"PODEMOS-IU-BATZARRE",14
31,"31042",2707,1926,1900,11,26,"PODEMOS-IU-BATZARRE",150
31,"31059",182,121,121,1,0,"PODEMOS-IU-BATZARRE",20
31,"31140",112,73,73,1,0,"PODEMOS-IU-BATZARRE",7
31,"31161",350,261,256,1,5,"PODEMOS-IU-BATZARRE",66
31,"31246",130,89,87,2,2,"PODEMOS-IU-BATZARRE",14
31,"31222",57,35,34,3,1,"PODEMOS-IU-BATZARRE",2
31,"31041",1671,1118,1105,15,13,"PODEMOS-IU-BATZARRE",229
31,"31255",103,79,79,0,0,"PODEMOS-IU-BATZARRE",15
31,"31258",7879,5668,5631,50,37,"PODEMOS-IU-BATZARRE",1066
31,"31071",13,11,11,0,0,"PODEMOS-IU-BATZARRE",0
31,"31193",1440,1062,1055,11,7,"PODEMOS-IU-BATZARRE",226
31,"31263",231,137,137,1,0,"PODEMOS-IU-BATZARRE",13
31,"31149",2285,1531,1520,10,11,"PODEMOS-IU-BATZARRE",136
31,"31015",1989,1399,1386,17,13,"PODEMOS-IU-BATZARRE",193
31,"31133",34,27,27,1,0,"PODEMOS-IU-BATZARRE",0
31,"31239",282,196,193,6,3,"PODEMOS-IU-BATZARRE",16
31,"31228",496,356,354,1,2,"PODEMOS-IU-BATZARRE",78
31,"31080",486,362,361,4,1,"PODEMOS-IU-BATZARRE",72
31,"31137",198,83,83,1,0,"PODEMOS-IU-BATZARRE",12
31,"31122",4981,3539,3504,38,35,"PODEMOS-IU-BATZARRE",687
31,"31016",7790,5541,5502,56,39,"PODEMOS-IU-BATZARRE",1332
31,"31119",35,24,24,1,0,"PODEMOS-IU-BATZARRE",6
31,"31244",157,69,69,0,0,"PODEMOS-IU-BATZARRE",3
31,"31069",823,596,595,1,1,"PODEMOS-IU-BATZARRE",99
31,"31190",44,30,30,1,0,"PODEMOS-IU-BATZARRE",1
31,"31214",87,55,54,0,1,"PODEMOS-IU-BATZARRE",5
31,"31215",4670,3270,3219,33,51,"PODEMOS-IU-BATZARRE",345
31,"31033",45,25,25,2,0,"PODEMOS-IU-BATZARRE",1
31,"31908",1076,763,762,5,1,"PODEMOS-IU-BATZARRE",148
31,"31230",90,66,66,0,0,"PODEMOS-IU-BATZARRE",5
31,"31104",1751,1147,1125,8,22,"PODEMOS-IU-BATZARRE",201
31,"31176",2919,1974,1933,27,41,"PODEMOS-IU-BATZARRE",245
31,"31035",50,30,29,0,1,"PODEMOS-IU-BATZARRE",0
31,"31110",83,61,61,1,0,"PODEMOS-IU-BATZARRE",12
31,"31108",1819,1348,1325,13,23,"PODEMOS-IU-BATZARRE",136
31,"31180",202,144,143,1,1,"PODEMOS-IU-BATZARRE",31
31,"31046",53,38,38,0,0,"PODEMOS-IU-BATZARRE",4
31,"31242",258,168,167,2,1,"PODEMOS-IU-BATZARRE",32
31,"31241",126,86,85,2,1,"PODEMOS-IU-BATZARRE",20
31,"31151",53,37,37,0,0,"PODEMOS-IU-BATZARRE",6
31,"31094",105,70,70,1,0,"PODEMOS-IU-BATZARRE",5
31,"31115",159,93,93,2,0,"PODEMOS-IU-BATZARRE",11
31,"31206",2077,1433,1417,15,16,"PODEMOS-IU-BATZARRE",252
31,"31264",179,91,90,2,1,"PODEMOS-IU-BATZARRE",10
31,"31903",6950,4430,4394,39,36,"PODEMOS-IU-BATZARRE",916
31,"31198",36,30,30,0,0,"PODEMOS-IU-BATZARRE",4
31,"31040",186,131,129,1,2,"PODEMOS-IU-BATZARRE",8
31,"31174",100,55,55,0,0,"PODEMOS-IU-BATZARRE",6
31,"31134",172,106,106,1,0,"PODEMOS-IU-BATZARRE",6
31,"31217",327,204,196,1,8,"PODEMOS-IU-BATZARRE",38
31,"31027",811,527,521,1,6,"PODEMOS-IU-BATZARRE",37
31,"31088",5656,3929,3893,56,36,"PODEMOS-IU-BATZARRE",727
31,"31039",92,70,69,1,1,"PODEMOS-IU-BATZARRE",15
31,"31003",121,71,71,0,0,"PODEMOS-IU-BATZARRE",9
31,"31169",2203,1429,1415,15,14,"PODEMOS-IU-BATZARRE",146
31,"31178",476,323,320,7,3,"PODEMOS-IU-BATZARRE",41
31,"31029",913,606,601,14,5,"PODEMOS-IU-BATZARRE",97
31,"31034",31,24,24,0,0,"PODEMOS-IU-BATZARRE",7
31,"31136",461,294,293,3,1,"PODEMOS-IU-BATZARRE",61
31,"31203",30,19,19,2,0,"PODEMOS-IU-BATZARRE",0
31,"31155",246,165,161,3,4,"PODEMOS-IU-BATZARRE",24
31,"31257",915,654,642,9,12,"PODEMOS-IU-BATZARRE",126
31,"31211",17,15,14,3,1,"PODEMOS-IU-BATZARRE",0
31,"31256",95,55,55,1,0,"PODEMOS-IU-BATZARRE",4
31,"31207",280,194,191,3,3,"PODEMOS-IU-BATZARRE",30
31,"31036",879,601,589,5,12,"PODEMOS-IU-BATZARRE",78
31,"31024",100,52,52,0,0,"PODEMOS-IU-BATZARRE",4
31,"31154",217,107,104,0,3,"PODEMOS-IU-BATZARRE",17
31,"31238",119,96,95,4,1,"PODEMOS-IU-BATZARRE",23
31,"31197",67,51,51,2,0,"PODEMOS-IU-BATZARRE",11
31,"31096",99,79,79,3,0,"PODEMOS-IU-BATZARRE",8
31,"31056",186,128,124,2,4,"PODEMOS-IU-BATZARRE",21
31,"31067",1887,1265,1249,6,16,"PODEMOS-IU-BATZARRE",171
31,"31008",61,42,42,0,0,"PODEMOS-IU-BATZARRE",4
31,"31101",1428,986,981,6,5,"PODEMOS-IU-BATZARRE",176
31,"31147",110,79,78,1,1,"PODEMOS-IU-BATZARRE",13
31,"31221",1228,823,815,6,8,"PODEMOS-IU-BATZARRE",94
31,"31163",2011,1422,1404,6,18,"PODEMOS-IU-BATZARRE",192
31,"31054",453,279,276,2,3,"PODEMOS-IU-BATZARRE",30
31,"31052",101,78,75,0,3,"PODEMOS-IU-BATZARRE",19
31,"31124",207,134,134,2,0,"PODEMOS-IU-BATZARRE",16
31,"31145",160,121,120,2,1,"PODEMOS-IU-BATZARRE",11
31,"31243",300,216,213,6,3,"PODEMOS-IU-BATZARRE",33
31,"31192",160,125,123,0,2,"PODEMOS-IU-BATZARRE",34
31,"31213",99,50,50,0,0,"PODEMOS-IU-BATZARRE",6
31,"31044",291,227,227,1,0,"PODEMOS-IU-BATZARRE",16
31,"31106",721,547,545,1,2,"PODEMOS-IU-BATZARRE",64
31,"31194",328,224,222,3,2,"PODEMOS-IU-BATZARRE",44
31,"31004",31,22,22,1,0,"PODEMOS-IU-BATZARRE",1
31,"31220",742,551,539,6,12,"PODEMOS-IU-BATZARRE",61
31,"31023",7778,5977,5948,106,29,"PODEMOS-IU-BATZARRE",1137
31,"31132",147,100,100,2,0,"PODEMOS-IU-BATZARRE",11
31,"31105",1471,1144,1124,10,20,"PODEMOS-IU-BATZARRE",63
31,"31032",1670,1158,1147,18,11,"PODEMOS-IU-BATZARRE",168
31,"31083",49,39,39,1,0,"PODEMOS-IU-BATZARRE",4
31,"31202",4360,2806,2767,30,39,"PODEMOS-IU-BATZARRE",453
31,"31219",80,59,58,2,1,"PODEMOS-IU-BATZARRE",6
31,"31177",245,161,159,1,2,"PODEMOS-IU-BATZARRE",34
31,"31103",40,28,27,0,1,"PODEMOS-IU-BATZARRE",2
31,"31148",92,62,59,2,3,"PODEMOS-IU-BATZARRE",16
31,"31262",234,190,188,0,2,"PODEMOS-IU-BATZARRE",44
31,"31265",76,43,40,0,3,"PODEMOS-IU-BATZARRE",9
31,"31045",510,347,345,8,2,"PODEMOS-IU-BATZARRE",95
31,"31126",352,223,223,3,0,"PODEMOS-IU-BATZARRE",26
31,"31021",59,42,42,1,0,"PODEMOS-IU-BATZARRE",0
31,"31127",131,90,86,0,4,"PODEMOS-IU-BATZARRE",7
31,"31051",241,169,167,3,2,"PODEMOS-IU-BATZARRE",29
31,"31144",760,442,441,4,1,"PODEMOS-IU-BATZARRE",45
31,"31048",166,121,119,1,2,"PODEMOS-IU-BATZARRE",6
31,"31070",2633,1714,1682,16,32,"PODEMOS-IU-BATZARRE",339
31,"31250",2761,1776,1759,13,17,"PODEMOS-IU-BATZARRE",339
31,"31157",3447,2182,2160,29,22,"PODEMOS-IU-BATZARRE",356
31,"31143",91,44,41,1,3,"PODEMOS-IU-BATZARRE",4
31,"31022",477,303,301,2,2,"PODEMOS-IU-BATZARRE",27
31,"31109",1657,1165,1160,12,5,"PODEMOS-IU-BATZARRE",220
31,"31907",11272,8478,8421,97,57,"PODEMOS-IU-BATZARRE",1647
31,"31085",500,365,362,2,3,"PODEMOS-IU-BATZARRE",80
31,"31248",272,142,138,3,4,"PODEMOS-IU-BATZARRE",18
31,"31185",461,291,290,1,1,"PODEMOS-IU-BATZARRE",26
31,"31170",44,31,30,2,1,"PODEMOS-IU-BATZARRE",6
31,"31043",29,23,23,0,0,"PODEMOS-IU-BATZARRE",0
31,"31121",62,42,42,0,0,"PODEMOS-IU-BATZARRE",7
31,"31168",238,176,174,1,2,"PODEMOS-IU-BATZARRE",14
31,"31129",388,239,238,3,1,"PODEMOS-IU-BATZARRE",21
31,"31195",169,108,108,0,0,"PODEMOS-IU-BATZARRE",11
31,"31060",14323,9547,9434,79,113,"PODEMOS-IU-BATZARRE",1993
31,"31181",133,87,84,1,3,"PODEMOS-IU-BATZARRE",6
31,"31146",30,22,22,1,0,"PODEMOS-IU-BATZARRE",1
31,"31205",419,290,289,4,1,"PODEMOS-IU-BATZARRE",32
31,"31247",141,99,96,1,3,"PODEMOS-IU-BATZARRE",5
31,"31037",91,70,70,0,0,"PODEMOS-IU-BATZARRE",7
31,"31130",321,203,203,0,0,"PODEMOS-IU-BATZARRE",26
31,"31191",3024,2156,2133,23,23,"PODEMOS-IU-BATZARRE",426
31,"31240",514,352,352,3,0,"PODEMOS-IU-BATZARRE",39
31,"31227",8118,5691,5636,65,55,"PODEMOS-IU-BATZARRE",1162
31,"31260",1265,817,815,7,2,"PODEMOS-IU-BATZARRE",127
31,"31098",1984,1443,1428,11,15,"PODEMOS-IU-BATZARRE",247
31,"31158",248,156,151,0,5,"PODEMOS-IU-BATZARRE",28
31,"31175",66,46,46,0,0,"PODEMOS-IU-BATZARRE",7
31,"31153",2174,1417,1415,12,2,"PODEMOS-IU-BATZARRE",193
31,"31251",3144,2197,2164,18,33,"PODEMOS-IU-BATZARRE",338
31,"31020",435,224,222,1,2,"PODEMOS-IU-BATZARRE",27
31,"31086",13781,10133,10054,114,79,"PODEMOS-IU-BATZARRE",2095
31,"31117",583,373,372,3,1,"PODEMOS-IU-BATZARRE",16
31,"31139",152,100,100,1,0,"PODEMOS-IU-BATZARRE",19
31,"31068",2816,2028,1989,20,39,"PODEMOS-IU-BATZARRE",234
31,"31009",674,455,451,2,4,"PODEMOS-IU-BATZARRE",90
29,"29047",1082,860,846,0,14,"PODEMOS-IU LV CA",222
41,"41099",3961,2448,2413,14,35,"PODEMOS-IU LV CA",311
23,"23052",1094,920,896,6,24,"PODEMOS-IU LV CA",46
14,"14032",388,302,293,0,9,"PODEMOS-IU LV CA",11
14,"14070",1280,911,902,4,9,"PODEMOS-IU LV CA",38
41,"41029",13520,9849,9663,134,186,"PODEMOS-IU LV CA",1299
29,"29028",1215,803,779,9,24,"PODEMOS-IU LV CA",101
4,"4085",360,291,289,0,2,"PODEMOS-IU LV CA",8
41,"41038",102752,71545,70538,980,1007,"PODEMOS-IU LV CA",10987
29,"29084",27199,18102,17800,268,302,"PODEMOS-IU LV CA",1647
21,"21075",338,243,235,3,8,"PODEMOS-IU LV CA",11
41,"41102",14773,10377,10028,174,349,"PODEMOS-IU LV CA",1470
14,"14004",1963,1465,1437,15,28,"PODEMOS-IU LV CA",99
29,"29044",749,477,473,1,4,"PODEMOS-IU LV CA",16
11,"11009",579,399,390,0,9,"PODEMOS-IU LV CA",28
21,"21024",464,328,312,1,16,"PODEMOS-IU LV CA",53
4,"4103",1432,1003,993,10,10,"PODEMOS-IU LV CA",29
21,"21035",9766,6114,5998,92,116,"PODEMOS-IU LV CA",627
29,"29001",4207,3002,2959,40,43,"PODEMOS-IU LV CA",776
21,"21066",490,394,389,4,5,"PODEMOS-IU LV CA",27
18,"18163",311,206,204,0,2,"PODEMOS-IU LV CA",25
4,"4047",2224,1649,1627,13,22,"PODEMOS-IU LV CA",73
11,"11003",1230,802,787,9,15,"PODEMOS-IU LV CA",39
23,"23074",2984,2271,2236,20,35,"PODEMOS-IU LV CA",253
18,"18138",2470,1597,1573,25,24,"PODEMOS-IU LV CA",334
14,"14057",6157,4773,4707,59,66,"PODEMOS-IU LV CA",998
23,"23051",2736,2066,2021,16,45,"PODEMOS-IU LV CA",112
23,"23082",1850,1292,1279,13,13,"PODEMOS-IU LV CA",87
11,"11039",9957,6134,6043,152,91,"PODEMOS-IU LV CA",577
23,"23075",3222,2513,2475,19,38,"PODEMOS-IU LV CA",170
18,"18021",17929,12165,11949,139,216,"PODEMOS-IU LV CA",1651
18,"18126",1436,1024,1002,9,22,"PODEMOS-IU LV CA",263
14,"14068",517,388,378,3,10,"PODEMOS-IU LV CA",50
18,"18018",542,384,377,2,7,"PODEMOS-IU LV CA",33
41,"41033",4958,3299,3250,38,49,"PODEMOS-IU LV CA",155
4,"4096",285,222,222,0,0,"PODEMOS-IU LV CA",14
11,"11011",1726,1124,1084,8,40,"PODEMOS-IU LV CA",131
4,"4003",17583,11062,10941,77,121,"PODEMOS-IU LV CA",645
18,"18116",2856,2027,1979,13,48,"PODEMOS-IU LV CA",250
14,"14041",3113,2234,2160,43,74,"PODEMOS-IU LV CA",802
41,"41087",10557,7217,7029,67,188,"PODEMOS-IU LV CA",852
11,"11032",54731,31560,31284,492,276,"PODEMOS-IU LV CA",4798
18,"18192",1462,1125,1103,3,22,"PODEMOS-IU LV CA",120
41,"41035",1051,733,722,10,11,"PODEMOS-IU LV CA",37
41,"41062",2151,1619,1589,12,30,"PODEMOS-IU LV CA",639
4,"4010",587,421,409,5,12,"PODEMOS-IU LV CA",23
11,"11029",5442,2826,2765,44,61,"PODEMOS-IU LV CA",579
18,"18062",11226,7969,7777,88,192,"PODEMOS-IU LV CA",936
11,"11022",48785,24758,24422,398,336,"PODEMOS-IU LV CA",2726
23,"23040",1438,1175,1159,3,16,"PODEMOS-IU LV CA",304
21,"21004",1586,994,964,23,30,"PODEMOS-IU LV CA",108
23,"23086",11427,7984,7735,81,249,"PODEMOS-IU LV CA",829
4,"4011",2744,2010,1984,20,26,"PODEMOS-IU LV CA",182
41,"41030",501,376,366,9,10,"PODEMOS-IU LV CA",44
18,"18036",3986,2956,2917,22,39,"PODEMOS-IU LV CA",406
23,"23058",8832,6528,6407,57,121,"PODEMOS-IU LV CA",672
18,"18043",129,74,71,0,3,"PODEMOS-IU LV CA",13
14,"14011",580,444,443,3,1,"PODEMOS-IU LV CA",24
29,"29016",253,196,194,0,2,"PODEMOS-IU LV CA",13
21,"21032",1827,1337,1314,13,23,"PODEMOS-IU LV CA",177
11,"11902",3664,2123,2094,46,29,"PODEMOS-IU LV CA",127
4,"4022",356,237,236,5,1,"PODEMOS-IU LV CA",18
18,"18054",820,573,569,2,4,"PODEMOS-IU LV CA",46
29,"29010",1637,1263,1187,2,76,"PODEMOS-IU LV CA",128
4,"4904",1900,1308,1299,4,9,"PODEMOS-IU LV CA",39
18,"18100",7997,5523,5367,66,156,"PODEMOS-IU LV CA",638
18,"18095",2054,1475,1433,14,42,"PODEMOS-IU LV CA",160
23,"23088",6017,4529,4427,61,102,"PODEMOS-IU LV CA",909
41,"41072",4031,2969,2933,15,36,"PODEMOS-IU LV CA",1099
21,"21047",1878,1144,1112,12,32,"PODEMOS-IU LV CA",168
29,"29070",43686,27672,27323,290,349,"PODEMOS-IU LV CA",3492
14,"14047",1644,1198,1183,14,15,"PODEMOS-IU LV CA",116
41,"41019",4931,3323,3251,39,72,"PODEMOS-IU LV CA",418
21,"21051",222,171,168,3,3,"PODEMOS-IU LV CA",16
23,"23006",4582,3536,3461,43,75,"PODEMOS-IU LV CA",174
18,"18141",382,240,237,0,3,"PODEMOS-IU LV CA",9
29,"29100",2379,1582,1551,22,31,"PODEMOS-IU LV CA",125
41,"41085",4182,3258,3181,43,77,"PODEMOS-IU LV CA",406
11,"11020",166773,111205,109956,1580,1249,"PODEMOS-IU LV CA",15245
4,"4034",169,91,91,1,0,"PODEMOS-IU LV CA",5
18,"18010",527,398,394,5,4,"PODEMOS-IU LV CA",47
4,"4095",687,462,457,4,5,"PODEMOS-IU LV CA",28
18,"18040",237,146,145,0,1,"PODEMOS-IU LV CA",23
29,"29903",485,326,324,2,2,"PODEMOS-IU LV CA",28
29,"29099",969,688,669,11,19,"PODEMOS-IU LV CA",58
18,"18149",5408,3926,3859,42,67,"PODEMOS-IU LV CA",456
4,"4048",1499,964,957,4,7,"PODEMOS-IU LV CA",81
23,"23063",3784,2699,2664,22,35,"PODEMOS-IU LV CA",234
21,"21048",318,234,229,3,5,"PODEMOS-IU LV CA",29
29,"29074",771,561,555,1,6,"PODEMOS-IU LV CA",29
14,"14023",1999,1629,1593,11,36,"PODEMOS-IU LV CA",62
41,"41092",7681,5408,5299,79,109,"PODEMOS-IU LV CA",498
4,"4004",405,282,272,2,10,"PODEMOS-IU LV CA",18
41,"41064",5602,3520,3417,56,103,"PODEMOS-IU LV CA",275
18,"18107",920,643,626,1,17,"PODEMOS-IU LV CA",34
41,"41006",2733,1776,1742,17,34,"PODEMOS-IU LV CA",177
41,"41065",22527,14684,14463,205,221,"PODEMOS-IU LV CA",2307
18,"18059",4265,2960,2886,23,74,"PODEMOS-IU LV CA",470
14,"14016",1273,936,922,5,14,"PODEMOS-IU LV CA",92
21,"21014",4066,3089,3029,30,60,"PODEMOS-IU LV CA",307
14,"14066",5748,4116,4035,59,81,"PODEMOS-IU LV CA",958
18,"18093",2751,1693,1674,18,19,"PODEMOS-IU LV CA",123
18,"18120",266,204,204,4,0,"PODEMOS-IU LV CA",9
18,"18181",194,134,133,0,1,"PODEMOS-IU LV CA",2
18,"18011",4403,3002,2947,24,55,"PODEMOS-IU LV CA",382
18,"18174",435,324,320,3,4,"PODEMOS-IU LV CA",19
21,"21065",259,178,175,0,3,"PODEMOS-IU LV CA",7
29,"29020",3278,2329,2260,22,69,"PODEMOS-IU LV CA",793
14,"14030",7761,5711,5588,84,123,"PODEMOS-IU LV CA",971
18,"18032",247,164,163,1,1,"PODEMOS-IU LV CA",26
23,"23027",711,547,539,5,8,"PODEMOS-IU LV CA",8
41,"41076",2134,1246,1230,11,16,"PODEMOS-IU LV CA",208
41,"41073",1684,1100,1074,7,26,"PODEMOS-IU LV CA",104
41,"41093",19064,14867,14700,151,167,"PODEMOS-IU LV CA",1794
23,"23095",8571,6159,6101,37,58,"PODEMOS-IU LV CA",359
14,"14010",3992,2786,2723,14,63,"PODEMOS-IU LV CA",279
21,"21053",3306,2161,2106,11,55,"PODEMOS-IU LV CA",188
18,"18171",2098,1521,1460,11,61,"PODEMOS-IU LV CA",331
14,"14061",687,536,523,1,13,"PODEMOS-IU LV CA",56
18,"18178",664,474,467,1,7,"PODEMOS-IU LV CA",34
23,"23070",3813,2384,2354,11,30,"PODEMOS-IU LV CA",131
29,"29056",1047,708,696,5,12,"PODEMOS-IU LV CA",36
41,"41055",14791,10197,10000,125,197,"PODEMOS-IU LV CA",1085
23,"23059",5736,4245,4119,51,126,"PODEMOS-IU LV CA",260
4,"4080",196,148,147,2,1,"PODEMOS-IU LV CA",15
29,"29006",679,461,452,4,9,"PODEMOS-IU LV CA",31
29,"29025",41540,27170,26897,271,273,"PODEMOS-IU LV CA",3760
21,"21029",1514,1036,1003,14,33,"PODEMOS-IU LV CA",69
18,"18087",182877,131811,130184,1106,1627,"PODEMOS-IU LV CA",16349
18,"18159",989,765,762,2,3,"PODEMOS-IU LV CA",274
29,"29029",383,256,254,4,2,"PODEMOS-IU LV CA",38
4,"4084",337,238,232,0,6,"PODEMOS-IU LV CA",8
41,"41011",15462,11019,10696,183,323,"PODEMOS-IU LV CA",1673
4,"4070",1529,1088,1076,8,12,"PODEMOS-IU LV CA",40
14,"14042",18695,13788,13514,206,274,"PODEMOS-IU LV CA",2406
41,"41022",4255,2735,2667,32,68,"PODEMOS-IU LV CA",530
4,"4015",113,81,81,0,0,"PODEMOS-IU LV CA",9
41,"41045",5873,3901,3802,53,99,"PODEMOS-IU LV CA",819
4,"4052",12882,8400,8322,93,78,"PODEMOS-IU LV CA",921
29,"29019",853,604,588,2,16,"PODEMOS-IU LV CA",172
18,"18049",588,418,415,4,3,"PODEMOS-IU LV CA",49
29,"29036",614,393,387,1,6,"PODEMOS-IU LV CA",59
18,"18038",1042,782,760,5,22,"PODEMOS-IU LV CA",94
18,"18907",1762,1358,1351,4,7,"PODEMOS-IU LV CA",67
4,"4074",2910,1813,1789,15,24,"PODEMOS-IU LV CA",168
4,"4043",517,398,395,1,3,"PODEMOS-IU LV CA",20
4,"4903",4320,2907,2873,18,34,"PODEMOS-IU LV CA",104
23,"23902",2219,1813,1770,6,43,"PODEMOS-IU LV CA",74
18,"18067",682,442,437,2,5,"PODEMOS-IU LV CA",18
23,"23005",29876,20565,20268,254,297,"PODEMOS-IU LV CA",1738
23,"23021",512,406,399,2,7,"PODEMOS-IU LV CA",23
11,"11010",6327,3998,3928,112,70,"PODEMOS-IU LV CA",664
14,"14022",3881,2888,2853,15,35,"PODEMOS-IU LV CA",947
29,"29057",330,222,218,2,4,"PODEMOS-IU LV CA",10
29,"29037",215,156,153,1,3,"PODEMOS-IU LV CA",10
18,"18112",104,68,66,2,2,"PODEMOS-IU LV CA",4
4,"4027",218,130,130,0,0,"PODEMOS-IU LV CA",3
4,"4063",1058,766,750,6,16,"PODEMOS-IU LV CA",28
23,"23091",675,516,512,1,4,"PODEMOS-IU LV CA",9
21,"21025",3886,2489,2431,31,58,"PODEMOS-IU LV CA",294
14,"14039",2577,1858,1801,29,57,"PODEMOS-IU LV CA",153
11,"11901",5739,3759,3686,99,73,"PODEMOS-IU LV CA",389
21,"21041",113074,73295,72313,1063,982,"PODEMOS-IU LV CA",10362
41,"41023",7999,5500,5435,60,65,"PODEMOS-IU LV CA",617
29,"29026",1021,703,698,15,5,"PODEMOS-IU LV CA",114
18,"18050",1649,1113,1095,5,18,"PODEMOS-IU LV CA",114
29,"29075",12886,8292,8191,63,101,"PODEMOS-IU LV CA",1018
29,"29045",1679,1162,1144,5,18,"PODEMOS-IU LV CA",97
23,"23054",375,280,272,1,8,"PODEMOS-IU LV CA",5
18,"18906",903,641,639,2,2,"PODEMOS-IU LV CA",27
14,"14053",5918,4054,3968,92,86,"PODEMOS-IU LV CA",607
41,"41008",1044,788,766,3,22,"PODEMOS-IU LV CA",86
29,"29053",1717,1133,1116,12,17,"PODEMOS-IU LV CA",134
4,"4065",365,273,271,1,2,"PODEMOS-IU LV CA",7
41,"41016",7820,5523,5407,57,116,"PODEMOS-IU LV CA",790
23,"23067",2405,1765,1724,14,41,"PODEMOS-IU LV CA",321
21,"21015",645,361,356,8,5,"PODEMOS-IU LV CA",44
18,"18909",514,403,403,0,0,"PODEMOS-IU LV CA",12
29,"29077",207,135,134,1,1,"PODEMOS-IU LV CA",8
4,"4055",361,298,290,3,8,"PODEMOS-IU LV CA",15
4,"4037",1212,890,875,17,15,"PODEMOS-IU LV CA",50
4,"4014",152,105,103,1,2,"PODEMOS-IU LV CA",16
21,"21022",187,121,116,0,5,"PODEMOS-IU LV CA",21
18,"18027",2598,1730,1706,12,24,"PODEMOS-IU LV CA",341
14,"14012",6046,4215,4120,56,95,"PODEMOS-IU LV CA",573
21,"21045",231,177,174,4,3,"PODEMOS-IU LV CA",27
29,"29054",42538,28080,27814,225,266,"PODEMOS-IU LV CA",2949
41,"41048",2195,1445,1400,13,45,"PODEMOS-IU LV CA",128
41,"41044",7753,5636,5547,55,89,"PODEMOS-IU LV CA",758
4,"4102",14202,9264,9139,57,125,"PODEMOS-IU LV CA",542
23,"23003",8639,6296,6226,41,70,"PODEMOS-IU LV CA",293
23,"23029",798,595,590,0,5,"PODEMOS-IU LV CA",21
23,"23904",2570,1583,1562,10,21,"PODEMOS-IU LV CA",95
14,"14051",1323,975,951,7,24,"PODEMOS-IU LV CA",44
29,"29027",2325,1543,1516,13,27,"PODEMOS-IU LV CA",171
14,"14002",10895,7599,7479,109,120,"PODEMOS-IU LV CA",1213
18,"18914",1660,1255,1227,11,28,"PODEMOS-IU LV CA",222
14,"14044",1613,1186,1164,10,22,"PODEMOS-IU LV CA",87
14,"14031",556,462,456,5,6,"PODEMOS-IU LV CA",38
23,"23035",1111,877,856,2,21,"PODEMOS-IU LV CA",47
29,"29017",6404,4575,4468,48,107,"PODEMOS-IU LV CA",567
23,"23096",2543,2029,1986,16,43,"PODEMOS-IU LV CA",201
11,"11019",1757,1233,1172,13,61,"PODEMOS-IU LV CA",116
23,"23047",1558,1203,1186,8,17,"PODEMOS-IU LV CA",125
29,"29090",1649,1138,1124,10,14,"PODEMOS-IU LV CA",71
41,"41005",9285,6637,6497,83,140,"PODEMOS-IU LV CA",1005
21,"21058",2567,1806,1766,32,40,"PODEMOS-IU LV CA",167
41,"41075",10320,7159,6972,88,187,"PODEMOS-IU LV CA",819
21,"21077",1739,1266,1235,13,31,"PODEMOS-IU LV CA",71
18,"18037",535,417,410,2,7,"PODEMOS-IU LV CA",25
29,"29066",357,248,246,1,2,"PODEMOS-IU LV CA",36
11,"11040",396,332,324,3,8,"PODEMOS-IU LV CA",14
29,"29038",18908,12122,11931,197,191,"PODEMOS-IU LV CA",1470
23,"23085",2171,1587,1575,7,12,"PODEMOS-IU LV CA",96
11,"11024",6550,4500,4402,67,98,"PODEMOS-IU LV CA",626
4,"4008",466,374,371,3,3,"PODEMOS-IU LV CA",15
4,"4056",165,120,120,0,0,"PODEMOS-IU LV CA",10
21,"21060",12287,7761,7638,134,123,"PODEMOS-IU LV CA",872
18,"18187",510,350,350,2,0,"PODEMOS-IU LV CA",24
21,"21031",1166,773,736,11,37,"PODEMOS-IU LV CA",55
23,"23099",4824,3523,3435,35,88,"PODEMOS-IU LV CA",283
18,"18916",1815,1093,1086,6,7,"PODEMOS-IU LV CA",126
18,"18071",5636,3909,3807,45,102,"PODEMOS-IU LV CA",536
23,"23049",1740,1215,1183,12,32,"PODEMOS-IU LV CA",201
18,"18124",355,232,231,1,1,"PODEMOS-IU LV CA",12
14,"14015",2045,1465,1418,16,47,"PODEMOS-IU LV CA",229
14,"14067",3842,2863,2800,42,63,"PODEMOS-IU LV CA",392
18,"18148",787,618,605,5,13,"PODEMOS-IU LV CA",41
18,"18121",119,79,79,1,0,"PODEMOS-IU LV CA",11
41,"41078",2445,1722,1689,12,33,"PODEMOS-IU LV CA",250
18,"18901",489,323,322,5,1,"PODEMOS-IU LV CA",62
11,"11030",22999,14858,14586,207,272,"PODEMOS-IU LV CA",1957
18,"18913",771,530,514,2,16,"PODEMOS-IU LV CA",10
29,"29058",1542,994,979,5,15,"PODEMOS-IU LV CA",53
21,"21005",15754,9502,9340,84,162,"PODEMOS-IU LV CA",946
23,"23016",386,313,305,4,8,"PODEMOS-IU LV CA",24
18,"18114",585,425,424,7,1,"PODEMOS-IU LV CA",52
4,"4062",4457,3241,3197,22,44,"PODEMOS-IU LV CA",171
41,"41066",1307,927,898,7,29,"PODEMOS-IU LV CA",89
4,"4002",1013,711,699,1,12,"PODEMOS-IU LV CA",42
41,"41053",21693,15843,15379,171,464,"PODEMOS-IU LV CA",2049
18,"18084",4533,3233,3178,35,55,"PODEMOS-IU LV CA",388
23,"23084",902,627,621,4,6,"PODEMOS-IU LV CA",28
18,"18047",6103,3992,3922,61,70,"PODEMOS-IU LV CA",654
29,"29902",2593,1561,1533,15,28,"PODEMOS-IU LV CA",144
14,"14013",16619,11968,11719,153,249,"PODEMOS-IU LV CA",1209
21,"21055",7326,5395,5309,43,86,"PODEMOS-IU LV CA",379
29,"29095",3285,2313,2224,39,89,"PODEMOS-IU LV CA",312
11,"11002",4218,3176,3149,16,27,"PODEMOS-IU LV CA",1313
4,"4018",245,202,197,2,5,"PODEMOS-IU LV CA",13
41,"41041",9765,7172,6943,63,229,"PODEMOS-IU LV CA",746
18,"18077",471,350,343,1,7,"PODEMOS-IU LV CA",37
41,"41054",719,562,546,3,16,"PODEMOS-IU LV CA",66
21,"21076",2153,1459,1426,31,33,"PODEMOS-IU LV CA",205
18,"18111",2863,2038,2001,29,37,"PODEMOS-IU LV CA",289
14,"14009",2653,1658,1631,24,27,"PODEMOS-IU LV CA",122
18,"18005",363,232,230,3,2,"PODEMOS-IU LV CA",22
14,"14901",932,753,750,6,3,"PODEMOS-IU LV CA",185
41,"41020",13012,8148,7999,135,149,"PODEMOS-IU LV CA",934
4,"4077",296,270,268,3,2,"PODEMOS-IU LV CA",3
29,"29003",916,677,666,4,11,"PODEMOS-IU LV CA",85
29,"29098",1228,902,876,11,26,"PODEMOS-IU LV CA",71
4,"4045",1696,1268,1254,17,14,"PODEMOS-IU LV CA",62
4,"4028",207,175,171,1,4,"PODEMOS-IU LV CA",18
18,"18167",1839,1243,1224,9,19,"PODEMOS-IU LV CA",179
18,"18193",14934,10301,10127,116,174,"PODEMOS-IU LV CA",1475
18,"18146",930,645,629,10,16,"PODEMOS-IU LV CA",56
18,"18188",1646,1224,1202,10,22,"PODEMOS-IU LV CA",107
18,"18132",3101,2418,2382,23,36,"PODEMOS-IU LV CA",368
18,"18145",10909,7925,7780,67,145,"PODEMOS-IU LV CA",963
41,"41903",6776,4616,4494,72,122,"PODEMOS-IU LV CA",478
4,"4019",236,174,172,0,2,"PODEMOS-IU LV CA",11
41,"41089",6621,4650,4549,64,101,"PODEMOS-IU LV CA",807
18,"18035",1179,882,870,7,12,"PODEMOS-IU LV CA",54
4,"4041",344,227,222,4,5,"PODEMOS-IU LV CA",16
18,"18085",690,440,432,1,8,"PODEMOS-IU LV CA",20
21,"21021",12545,7816,7696,104,120,"PODEMOS-IU LV CA",725
41,"41026",4302,3355,3288,26,67,"PODEMOS-IU LV CA",1300
29,"29094",59795,39350,38854,454,496,"PODEMOS-IU LV CA",4110
18,"18082",810,503,500,3,3,"PODEMOS-IU LV CA",31
4,"4035",8439,5822,5768,45,54,"PODEMOS-IU LV CA",362
18,"18015",424,331,330,4,1,"PODEMOS-IU LV CA",28
18,"18161",245,199,196,0,3,"PODEMOS-IU LV CA",12
21,"21008",2604,1663,1626,10,37,"PODEMOS-IU LV CA",140
23,"23077",604,482,477,2,5,"PODEMOS-IU LV CA",21
4,"4099",4930,3526,3462,22,64,"PODEMOS-IU LV CA",208
18,"18115",2635,1766,1738,13,28,"PODEMOS-IU LV CA",284
14,"14069",7340,5100,5000,69,100,"PODEMOS-IU LV CA",414
4,"4033",121,78,77,3,1,"PODEMOS-IU LV CA",3
29,"29055",1892,1425,1394,3,31,"PODEMOS-IU LV CA",146
18,"18079",3466,2391,2333,22,58,"PODEMOS-IU LV CA",373
4,"4071",362,286,281,2,5,"PODEMOS-IU LV CA",18
18,"18020",489,318,310,2,8,"PODEMOS-IU LV CA",14
14,"14060",3715,2714,2641,41,73,"PODEMOS-IU LV CA",289
14,"14037",3161,2233,2158,22,75,"PODEMOS-IU LV CA",153
41,"41039",31538,22078,21717,278,361,"PODEMOS-IU LV CA",2052
23,"23010",14264,9801,9635,120,166,"PODEMOS-IU LV CA",786
21,"21079",678,428,417,2,11,"PODEMOS-IU LV CA",62
41,"41010",4586,3218,3157,42,61,"PODEMOS-IU LV CA",627
29,"29035",1478,1054,1040,3,14,"PODEMOS-IU LV CA",212
14,"14020",336,227,225,0,2,"PODEMOS-IU LV CA",12
4,"4091",318,251,250,0,1,"PODEMOS-IU LV CA",7
4,"4072",311,212,211,0,1,"PODEMOS-IU LV CA",4
23,"23081",1494,1084,1061,9,23,"PODEMOS-IU LV CA",69
21,"21037",462,320,313,1,7,"PODEMOS-IU LV CA",34
18,"18185",545,434,424,5,10,"PODEMOS-IU LV CA",58
4,"4081",351,264,263,0,1,"PODEMOS-IU LV CA",14
41,"41098",5161,3792,3732,33,60,"PODEMOS-IU LV CA",420
23,"23093",3119,2264,2216,24,48,"PODEMOS-IU LV CA",170
4,"4058",342,238,236,3,2,"PODEMOS-IU LV CA",28
14,"14048",1199,883,866,4,17,"PODEMOS-IU LV CA",71
23,"23043",517,360,360,1,0,"PODEMOS-IU LV CA",17
14,"14059",679,527,521,11,6,"PODEMOS-IU LV CA",35
11,"11012",97338,67120,66466,861,654,"PODEMOS-IU LV CA",15436
29,"29093",2150,1543,1520,8,23,"PODEMOS-IU LV CA",179
41,"41013",4836,3174,3124,41,50,"PODEMOS-IU LV CA",604
21,"21052",4403,2688,2631,26,57,"PODEMOS-IU LV CA",525
41,"41057",258,174,170,3,4,"PODEMOS-IU LV CA",14
14,"14001",3423,2563,2515,11,48,"PODEMOS-IU LV CA",327
18,"18915",726,474,467,4,7,"PODEMOS-IU LV CA",38
18,"18164",1790,1135,1108,11,27,"PODEMOS-IU LV CA",69
18,"18086",338,253,247,1,6,"PODEMOS-IU LV CA",34
4,"4029",8830,5546,5482,43,64,"PODEMOS-IU LV CA",319
14,"14063",994,731,719,8,12,"PODEMOS-IU LV CA",34
21,"21068",973,562,556,11,6,"PODEMOS-IU LV CA",38
21,"21038",1082,688,676,4,12,"PODEMOS-IU LV CA",104
23,"23041",489,378,376,1,2,"PODEMOS-IU LV CA",8
18,"18096",340,227,226,0,1,"PODEMOS-IU LV CA",13
41,"41002",1421,938,911,7,27,"PODEMOS-IU LV CA",62
29,"29091",9490,6428,6304,61,124,"PODEMOS-IU LV CA",904
41,"41009",1148,750,732,5,18,"PODEMOS-IU LV CA",49
18,"18070",287,216,216,3,0,"PODEMOS-IU LV CA",18
18,"18123",284,202,200,5,2,"PODEMOS-IU LV CA",8
23,"23009",12849,9722,9572,99,150,"PODEMOS-IU LV CA",684
18,"18088",1526,1000,993,10,7,"PODEMOS-IU LV CA",275
18,"18074",265,205,205,0,0,"PODEMOS-IU LV CA",15
18,"18033",279,179,174,0,5,"PODEMOS-IU LV CA",16
18,"18003",14454,10162,9935,105,227,"PODEMOS-IU LV CA",1369
23,"23101",351,238,238,3,0,"PODEMOS-IU LV CA",10
11,"11005",4508,2978,2900,34,78,"PODEMOS-IU LV CA",322
29,"29018",2009,1421,1362,17,59,"PODEMOS-IU LV CA",207
23,"23050",90664,65260,64519,581,741,"PODEMOS-IU LV CA",6562
4,"4098",1424,890,885,0,5,"PODEMOS-IU LV CA",50
4,"4036",239,178,176,0,2,"PODEMOS-IU LV CA",4
18,"18153",8834,6174,6063,54,111,"PODEMOS-IU LV CA",1025
4,"4001",1002,717,710,3,7,"PODEMOS-IU LV CA",30
11,"11013",2352,1564,1522,13,42,"PODEMOS-IU LV CA",164
21,"21042",15610,8112,8011,164,101,"PODEMOS-IU LV CA",937
4,"4092",2791,2058,2023,4,35,"PODEMOS-IU LV CA",113
41,"41001",1558,1129,1104,6,25,"PODEMOS-IU LV CA",227
41,"41003",2373,1747,1708,18,39,"PODEMOS-IU LV CA",143
23,"23039",2170,1502,1460,10,42,"PODEMOS-IU LV CA",89
21,"21034",1155,768,748,5,20,"PODEMOS-IU LV CA",78
18,"18065",588,464,451,2,13,"PODEMOS-IU LV CA",182
29,"29076",2354,1498,1444,21,54,"PODEMOS-IU LV CA",130
18,"18089",14504,9854,9746,100,108,"PODEMOS-IU LV CA",871
18,"18105",3827,2436,2392,22,44,"PODEMOS-IU LV CA",305
41,"41082",3354,2545,2507,11,38,"PODEMOS-IU LV CA",281
18,"18030",566,382,380,2,2,"PODEMOS-IU LV CA",24
11,"11038",13632,10047,9812,99,235,"PODEMOS-IU LV CA",753
41,"41034",23576,15461,15214,264,247,"PODEMOS-IU LV CA",2063
41,"41032",3842,2800,2704,24,96,"PODEMOS-IU LV CA",322
41,"41101",6025,4299,4213,53,86,"PODEMOS-IU LV CA",579
14,"14056",23477,15826,15470,177,356,"PODEMOS-IU LV CA",1620
18,"18119",1708,1264,1240,7,24,"PODEMOS-IU LV CA",113
18,"18004",669,467,466,6,1,"PODEMOS-IU LV CA",15
41,"41061",2141,1661,1621,7,40,"PODEMOS-IU LV CA",1029
29,"29023",2330,1441,1429,11,12,"PODEMOS-IU LV CA",104
41,"41024",22819,14767,14455,169,312,"PODEMOS-IU LV CA",1515
41,"41091",539590,389351,384943,4676,4408,"PODEMOS-IU LV CA",56349
23,"23056",3052,2279,2207,26,72,"PODEMOS-IU LV CA",332
23,"23028",6103,4369,4286,26,83,"PODEMOS-IU LV CA",414
11,"11017",3198,2054,2004,37,50,"PODEMOS-IU LV CA",270
21,"21001",621,431,418,0,13,"PODEMOS-IU LV CA",87
41,"41025",2031,1409,1349,11,60,"PODEMOS-IU LV CA",169
21,"21009",834,527,508,4,19,"PODEMOS-IU LV CA",83
4,"4078",1127,725,718,8,7,"PODEMOS-IU LV CA",115
29,"29021",155,111,109,1,2,"PODEMOS-IU LV CA",5
14,"14075",552,413,391,5,22,"PODEMOS-IU LV CA",46
23,"23076",774,606,595,6,11,"PODEMOS-IU LV CA",24
29,"29002",1143,777,766,6,11,"PODEMOS-IU LV CA",63
29,"29080",6940,4676,4617,36,59,"PODEMOS-IU LV CA",578
18,"18150",6964,4717,4622,51,95,"PODEMOS-IU LV CA",672
4,"4902",45571,29423,29169,272,254,"PODEMOS-IU LV CA",1928
18,"18012",2114,1519,1492,9,27,"PODEMOS-IU LV CA",77
11,"11903",1769,1116,1101,22,15,"PODEMOS-IU LV CA",134
18,"18184",2193,1542,1511,16,31,"PODEMOS-IU LV CA",212
23,"23087",11169,8193,8045,79,148,"PODEMOS-IU LV CA",1600
29,"29050",392,229,227,3,2,"PODEMOS-IU LV CA",21
23,"23014",2535,1890,1861,28,29,"PODEMOS-IU LV CA",243
14,"14024",1849,1417,1391,5,26,"PODEMOS-IU LV CA",165
18,"18044",161,91,91,0,0,"PODEMOS-IU LV CA",6
21,"21018",1719,1048,1029,12,19,"PODEMOS-IU LV CA",121
4,"4051",404,323,319,2,4,"PODEMOS-IU LV CA",19
29,"29096",2757,1847,1790,19,57,"PODEMOS-IU LV CA",287
14,"14038",32742,23345,22974,242,371,"PODEMOS-IU LV CA",2103
18,"18083",232,181,179,1,2,"PODEMOS-IU LV CA",9
23,"23024",12215,8702,8447,69,255,"PODEMOS-IU LV CA",835
23,"23071",1704,1278,1258,10,20,"PODEMOS-IU LV CA",62
11,"11018",1434,1001,977,8,24,"PODEMOS-IU LV CA",44
4,"4006",7192,4389,4335,39,54,"PODEMOS-IU LV CA",247
29,"29043",2463,1508,1460,20,48,"PODEMOS-IU LV CA",152
21,"21061",5083,3325,3255,36,70,"PODEMOS-IU LV CA",151
4,"4059",1000,676,666,3,10,"PODEMOS-IU LV CA",22
18,"18006",4062,2765,2711,25,54,"PODEMOS-IU LV CA",193
21,"21072",10233,7374,7183,116,191,"PODEMOS-IU LV CA",1112
23,"23080",1720,1313,1294,6,19,"PODEMOS-IU LV CA",40
18,"18102",8233,5424,5266,46,158,"PODEMOS-IU LV CA",685
21,"21033",569,410,405,3,5,"PODEMOS-IU LV CA",114
41,"41904",1789,1125,1109,31,16,"PODEMOS-IU LV CA",102
29,"29072",3291,2360,2307,19,53,"PODEMOS-IU LV CA",257
21,"21064",6674,4503,4426,68,77,"PODEMOS-IU LV CA",459
41,"41007",12488,7657,7421,126,236,"PODEMOS-IU LV CA",1168
4,"4068",170,129,128,0,1,"PODEMOS-IU LV CA",9
29,"29051",42179,27231,26724,282,507,"PODEMOS-IU LV CA",2968
41,"41063",2735,1855,1797,30,58,"PODEMOS-IU LV CA",368
29,"29086",770,479,476,5,3,"PODEMOS-IU LV CA",43
18,"18135",4385,2882,2798,24,84,"PODEMOS-IU LV CA",199
11,"11042",1158,806,793,6,13,"PODEMOS-IU LV CA",35
18,"18134",6104,4049,3972,39,77,"PODEMOS-IU LV CA",672
21,"21011",3500,2371,2314,23,57,"PODEMOS-IU LV CA",232
41,"41083",1145,821,814,6,7,"PODEMOS-IU LV CA",85
18,"18177",375,235,231,5,4,"PODEMOS-IU LV CA",12
41,"41068",13963,9596,9407,96,189,"PODEMOS-IU LV CA",1182
18,"18046",1738,1042,1023,7,19,"PODEMOS-IU LV CA",58
14,"14065",1820,1374,1352,13,22,"PODEMOS-IU LV CA",193
21,"21002",16070,11301,11137,132,164,"PODEMOS-IU LV CA",1722
23,"23002",17427,12837,12542,126,295,"PODEMOS-IU LV CA",967
4,"4073",327,224,223,0,1,"PODEMOS-IU LV CA",8
14,"14028",302,241,240,3,1,"PODEMOS-IU LV CA",9
41,"41049",9515,6961,6843,115,118,"PODEMOS-IU LV CA",1339
41,"41095",40187,27090,26680,512,410,"PODEMOS-IU LV CA",2715
41,"41050",5173,3954,3878,36,76,"PODEMOS-IU LV CA",417
21,"21028",370,265,259,2,6,"PODEMOS-IU LV CA",10
23,"23062",1410,1094,1076,0,18,"PODEMOS-IU LV CA",32
4,"4066",13438,8615,8519,78,96,"PODEMOS-IU LV CA",488
18,"18057",5584,4042,3958,51,84,"PODEMOS-IU LV CA",505
29,"29097",4160,2872,2800,56,72,"PODEMOS-IU LV CA",289
29,"29048",1364,1053,1039,8,14,"PODEMOS-IU LV CA",361
11,"11041",9869,6438,6295,100,143,"PODEMOS-IU LV CA",576
18,"18911",7933,5464,5348,53,116,"PODEMOS-IU LV CA",665
41,"41081",30061,21488,21059,331,429,"PODEMOS-IU LV CA",3873
41,"41042",5872,4477,4424,42,53,"PODEMOS-IU LV CA",900
23,"23019",1466,1117,1090,5,27,"PODEMOS-IU LV CA",100
14,"14064",296,211,208,6,3,"PODEMOS-IU LV CA",4
18,"18152",928,663,660,3,3,"PODEMOS-IU LV CA",27
11,"11007",18032,9872,9745,213,127,"PODEMOS-IU LV CA",1319
11,"11023",9386,6363,6248,116,115,"PODEMOS-IU LV CA",927
18,"18127",17005,11790,11583,150,207,"PODEMOS-IU LV CA",1766
23,"23011",2138,1536,1507,17,29,"PODEMOS-IU LV CA",213
29,"29014",218,122,121,3,1,"PODEMOS-IU LV CA",17
11,"11037",5656,4374,4273,24,101,"PODEMOS-IU LV CA",2253
11,"11033",21804,13361,13133,213,228,"PODEMOS-IU LV CA",1538
41,"41088",515,368,358,2,10,"PODEMOS-IU LV CA",42
29,"29071",980,580,564,11,16,"PODEMOS-IU LV CA",55
23,"23018",2243,1606,1584,17,22,"PODEMOS-IU LV CA",177
18,"18180",636,410,401,2,9,"PODEMOS-IU LV CA",41
41,"41056",3687,2836,2779,37,57,"PODEMOS-IU LV CA",284
21,"21007",6379,4268,4178,66,90,"PODEMOS-IU LV CA",791
11,"11031",76427,49773,49248,654,525,"PODEMOS-IU LV CA",6849
4,"4060",416,286,282,2,4,"PODEMOS-IU LV CA",16
41,"41040",11183,8351,8253,71,98,"PODEMOS-IU LV CA",944
21,"21054",8175,6014,5887,41,127,"PODEMOS-IU LV CA",348
4,"4009",140,109,106,2,3,"PODEMOS-IU LV CA",6
21,"21067",406,274,271,3,3,"PODEMOS-IU LV CA",51
41,"41012",3375,2259,2214,26,45,"PODEMOS-IU LV CA",224
21,"21030",1887,1493,1458,12,35,"PODEMOS-IU LV CA",67
41,"41084",2799,2029,1937,9,92,"PODEMOS-IU LV CA",209
4,"4101",4356,2818,2768,32,50,"PODEMOS-IU LV CA",154
14,"14071",874,551,540,5,11,"PODEMOS-IU LV CA",42
18,"18173",8999,5958,5871,50,87,"PODEMOS-IU LV CA",942
14,"14052",9039,5579,5478,79,101,"PODEMOS-IU LV CA",551
11,"11036",683,401,395,15,6,"PODEMOS-IU LV CA",36
18,"18097",947,633,631,0,2,"PODEMOS-IU LV CA",59
23,"23065",1530,1068,1054,7,14,"PODEMOS-IU LV CA",58
29,"29034",461,333,332,2,1,"PODEMOS-IU LV CA",14
4,"4026",57,38,37,0,1,"PODEMOS-IU LV CA",0
14,"14029",4001,2855,2821,30,34,"PODEMOS-IU LV CA",231
14,"14008",2758,1880,1836,21,44,"PODEMOS-IU LV CA",121
4,"4089",687,484,479,2,5,"PODEMOS-IU LV CA",27
29,"29089",3138,2262,2186,13,76,"PODEMOS-IU LV CA",850
41,"41014",2476,1852,1799,10,53,"PODEMOS-IU LV CA",769
18,"18157",1148,843,827,7,16,"PODEMOS-IU LV CA",89
29,"29081",250,185,182,2,3,"PODEMOS-IU LV CA",3
18,"18099",1582,1184,1156,13,28,"PODEMOS-IU LV CA",161
18,"18904",741,500,498,1,2,"PODEMOS-IU LV CA",50
41,"41069",29669,20316,19848,381,468,"PODEMOS-IU LV CA",2774
41,"41096",6178,4739,4655,60,84,"PODEMOS-IU LV CA",642
23,"23020",1510,1263,1253,16,10,"PODEMOS-IU LV CA",356
14,"14055",18411,13054,12798,192,256,"PODEMOS-IU LV CA",1126
23,"23025",2725,1894,1870,11,24,"PODEMOS-IU LV CA",95
18,"18017",18201,11500,11358,94,142,"PODEMOS-IU LV CA",1155
41,"41018",9432,6463,6368,86,95,"PODEMOS-IU LV CA",1143
18,"18122",15994,11009,10773,109,236,"PODEMOS-IU LV CA",820
41,"41047",10449,7884,7770,119,114,"PODEMOS-IU LV CA",1134
14,"14003",1245,925,907,5,18,"PODEMOS-IU LV CA",44
14,"14034",302,222,215,1,7,"PODEMOS-IU LV CA",14
14,"14006",1319,1088,1057,8,31,"PODEMOS-IU LV CA",101
29,"29092",576,375,366,7,9,"PODEMOS-IU LV CA",63
18,"18064",366,289,286,0,3,"PODEMOS-IU LV CA",16
18,"18051",1092,735,718,8,17,"PODEMOS-IU LV CA",30
4,"4005",534,422,419,3,3,"PODEMOS-IU LV CA",10
18,"18048",2494,1708,1657,18,51,"PODEMOS-IU LV CA",213
4,"4032",5716,3727,3696,43,31,"PODEMOS-IU LV CA",300
18,"18056",3382,2397,2350,30,47,"PODEMOS-IU LV CA",288
4,"4086",1631,1128,1114,3,14,"PODEMOS-IU LV CA",42
29,"29030",770,618,611,4,7,"PODEMOS-IU LV CA",168
11,"11008",17923,11702,11464,192,238,"PODEMOS-IU LV CA",1481
21,"21026",262,172,168,2,4,"PODEMOS-IU LV CA",26
23,"23042",292,219,219,0,0,"PODEMOS-IU LV CA",10
21,"21039",303,211,210,6,1,"PODEMOS-IU LV CA",24
18,"18013",4154,2892,2812,28,80,"PODEMOS-IU LV CA",227
4,"4017",1276,833,818,4,15,"PODEMOS-IU LV CA",33
21,"21012",285,224,221,0,3,"PODEMOS-IU LV CA",38
23,"23032",529,427,419,5,8,"PODEMOS-IU LV CA",40
18,"18154",982,668,668,4,0,"PODEMOS-IU LV CA",27
29,"29007",28907,20371,20129,254,242,"PODEMOS-IU LV CA",2450
23,"23015",1316,979,973,18,6,"PODEMOS-IU LV CA",56
21,"21062",1403,849,838,10,11,"PODEMOS-IU LV CA",41
23,"23092",27717,19749,19490,217,259,"PODEMOS-IU LV CA",2191
29,"29060",665,454,450,1,4,"PODEMOS-IU LV CA",9
21,"21069",1681,1073,1056,9,17,"PODEMOS-IU LV CA",65
41,"41059",35358,26408,26052,346,356,"PODEMOS-IU LV CA",4379
14,"14045",2997,2329,2287,30,42,"PODEMOS-IU LV CA",132
41,"41052",3032,2162,2092,6,70,"PODEMOS-IU LV CA",315
14,"14058",7866,5451,5334,69,117,"PODEMOS-IU LV CA",562
4,"4901",490,343,343,2,0,"PODEMOS-IU LV CA",17
14,"14027",7890,5841,5726,78,115,"PODEMOS-IU LV CA",1486
21,"21049",3262,2028,1977,15,51,"PODEMOS-IU LV CA",331
18,"18158",7978,4861,4771,43,90,"PODEMOS-IU LV CA",717
29,"29083",2063,1471,1444,14,27,"PODEMOS-IU LV CA",89
14,"14050",2350,1774,1720,20,54,"PODEMOS-IU LV CA",394
29,"29073",1657,1082,1069,15,13,"PODEMOS-IU LV CA",210
4,"4094",215,156,156,0,0,"PODEMOS-IU LV CA",1
29,"29065",191,145,143,3,2,"PODEMOS-IU LV CA",5
11,"11016",15079,9353,9192,137,161,"PODEMOS-IU LV CA",1135
29,"29063",305,244,242,2,2,"PODEMOS-IU LV CA",18
29,"29062",658,557,551,2,6,"PODEMOS-IU LV CA",11
4,"4050",742,465,464,0,1,"PODEMOS-IU LV CA",32
21,"21010",15011,8812,8694,174,118,"PODEMOS-IU LV CA",1061
14,"14062",945,700,693,2,7,"PODEMOS-IU LV CA",35
18,"18094",2299,1712,1652,20,60,"PODEMOS-IU LV CA",125
23,"23046",2334,1880,1855,9,25,"PODEMOS-IU LV CA",178
14,"14074",2225,1775,1743,17,32,"PODEMOS-IU LV CA",168
21,"21020",349,230,228,2,2,"PODEMOS-IU LV CA",13
21,"21016",985,703,680,5,23,"PODEMOS-IU LV CA",69
29,"29087",363,249,243,4,6,"PODEMOS-IU LV CA",59
23,"23064",1669,1311,1296,9,15,"PODEMOS-IU LV CA",59
29,"29004",283,222,218,3,4,"PODEMOS-IU LV CA",23
4,"4054",363,279,278,2,1,"PODEMOS-IU LV CA",15
23,"23066",4274,3517,3460,16,57,"PODEMOS-IU LV CA",186
29,"29031",1555,1015,986,6,29,"PODEMOS-IU LV CA",211
18,"18108",822,604,599,2,5,"PODEMOS-IU LV CA",67
18,"18016",297,200,198,3,2,"PODEMOS-IU LV CA",18
29,"29032",6655,4900,4775,36,125,"PODEMOS-IU LV CA",973
11,"11006",24558,15334,15113,231,221,"PODEMOS-IU LV CA",1531
4,"4007",735,514,509,3,5,"PODEMOS-IU LV CA",43
18,"18034",484,345,342,3,3,"PODEMOS-IU LV CA",85
29,"29068",7833,4897,4806,50,91,"PODEMOS-IU LV CA",489
29,"29046",2494,1727,1693,13,34,"PODEMOS-IU LV CA",141
29,"29022",177,137,136,1,1,"PODEMOS-IU LV CA",22
4,"4013",143819,93083,92383,893,700,"PODEMOS-IU LV CA",9699
41,"41051",2317,1715,1688,4,27,"PODEMOS-IU LV CA",196
41,"41028",2108,1652,1632,22,20,"PODEMOS-IU LV CA",288
23,"23079",3624,2661,2630,19,31,"PODEMOS-IU LV CA",125
14,"14036",3677,2619,2555,39,64,"PODEMOS-IU LV CA",387
29,"29901",44757,29291,28960,307,331,"PODEMOS-IU LV CA",3679
18,"18136",1778,1320,1284,14,36,"PODEMOS-IU LV CA",137
14,"14021",260521,185270,183300,2192,1970,"PODEMOS-IU LV CA",29185
4,"4083",1727,1265,1250,8,15,"PODEMOS-IU LV CA",98
18,"18905",15688,10406,10200,122,206,"PODEMOS-IU LV CA",1271
29,"29011",2893,1763,1736,12,27,"PODEMOS-IU LV CA",139
18,"18007",730,490,478,3,12,"PODEMOS-IU LV CA",15
41,"41004",57692,38578,37814,696,764,"PODEMOS-IU LV CA",5830
21,"21043",1853,1354,1325,23,29,"PODEMOS-IU LV CA",109
18,"18183",623,380,376,0,4,"PODEMOS-IU LV CA",26
11,"11015",64414,39635,39220,776,415,"PODEMOS-IU LV CA",5458
21,"21044",18061,11170,11003,123,167,"PODEMOS-IU LV CA",803
4,"4046",849,617,612,6,5,"PODEMOS-IU LV CA",28
18,"18194",2038,1373,1348,12,25,"PODEMOS-IU LV CA",106
4,"4075",5462,3714,3676,19,38,"PODEMOS-IU LV CA",177
23,"23901",1125,905,895,3,10,"PODEMOS-IU LV CA",48
23,"23090",1204,953,938,6,15,"PODEMOS-IU LV CA",44
41,"41058",17956,12890,12553,200,337,"PODEMOS-IU LV CA",1530
41,"41060",15058,10551,10302,122,249,"PODEMOS-IU LV CA",1159
14,"14043",7406,5323,5211,63,112,"PODEMOS-IU LV CA",495
21,"21023",2033,1215,1193,10,22,"PODEMOS-IU LV CA",204
4,"4044",1542,1092,1080,8,12,"PODEMOS-IU LV CA",71
4,"4076",1209,873,850,7,23,"PODEMOS-IU LV CA",63
14,"14017",10953,7929,7791,84,138,"PODEMOS-IU LV CA",769
11,"11027",68774,45571,45137,567,434,"PODEMOS-IU LV CA",7103
18,"18023",15717,10964,10751,132,213,"PODEMOS-IU LV CA",952
11,"11026",4700,3387,3293,17,94,"PODEMOS-IU LV CA",282
4,"4021",179,132,129,2,3,"PODEMOS-IU LV CA",6
4,"4069",4742,3364,3325,46,39,"PODEMOS-IU LV CA",235
18,"18912",1352,926,912,7,14,"PODEMOS-IU LV CA",53
18,"18101",9449,6688,6568,77,120,"PODEMOS-IU LV CA",917
23,"23001",912,723,712,2,11,"PODEMOS-IU LV CA",49
18,"18170",317,212,209,0,3,"PODEMOS-IU LV CA",14
41,"41037",3201,2306,2260,22,46,"PODEMOS-IU LV CA",610
4,"4053",12545,8864,8744,67,120,"PODEMOS-IU LV CA",418
18,"18175",11793,8099,7943,62,156,"PODEMOS-IU LV CA",805
21,"21078",2641,1718,1670,10,48,"PODEMOS-IU LV CA",328
18,"18078",714,546,538,5,8,"PODEMOS-IU LV CA",84
23,"23903",3498,2633,2601,28,32,"PODEMOS-IU LV CA",294
23,"23045",2054,1423,1412,10,11,"PODEMOS-IU LV CA",319
41,"41080",1231,832,815,14,17,"PODEMOS-IU LV CA",83
4,"4082",275,185,182,2,3,"PODEMOS-IU LV CA",14
18,"18024",837,651,639,11,12,"PODEMOS-IU LV CA",110
21,"21074",2736,1826,1790,19,36,"PODEMOS-IU LV CA",113
18,"18045",1065,720,690,11,30,"PODEMOS-IU LV CA",22
14,"14033",1239,875,856,8,19,"PODEMOS-IU LV CA",97
18,"18176",242,164,161,2,3,"PODEMOS-IU LV CA",21
18,"18137",968,733,731,3,2,"PODEMOS-IU LV CA",33
23,"23097",6346,4243,4194,31,49,"PODEMOS-IU LV CA",263
14,"14035",5774,4076,4017,35,59,"PODEMOS-IU LV CA",209
23,"23044",4697,3495,3400,31,95,"PODEMOS-IU LV CA",577
14,"14072",983,692,680,6,12,"PODEMOS-IU LV CA",81
4,"4023",118,84,82,2,2,"PODEMOS-IU LV CA",3
18,"18903",852,544,537,9,7,"PODEMOS-IU LV CA",21
41,"41071",5571,3608,3516,64,92,"PODEMOS-IU LV CA",688
41,"41043",669,447,436,11,11,"PODEMOS-IU LV CA",40
18,"18066",2095,1401,1378,12,23,"PODEMOS-IU LV CA",197
4,"4038",3105,2020,1984,17,36,"PODEMOS-IU LV CA",199
29,"29088",2689,1817,1747,15,70,"PODEMOS-IU LV CA",210
21,"21027",49,32,32,0,0,"PODEMOS-IU LV CA",5
21,"21013",10626,6990,6807,99,183,"PODEMOS-IU LV CA",963
4,"4061",625,489,479,5,10,"PODEMOS-IU LV CA",34
29,"29015",32093,22044,21716,253,328,"PODEMOS-IU LV CA",2098
23,"23069",5240,4153,4065,26,88,"PODEMOS-IU LV CA",262
14,"14054",13775,10464,10165,105,299,"PODEMOS-IU LV CA",955
14,"14025",2834,2352,2299,9,53,"PODEMOS-IU LV CA",746
18,"18002",529,387,384,1,3,"PODEMOS-IU LV CA",10
14,"14073",2768,1934,1880,33,54,"PODEMOS-IU LV CA",259
18,"18076",789,534,532,2,2,"PODEMOS-IU LV CA",31
4,"4088",2444,1587,1574,17,13,"PODEMOS-IU LV CA",108
18,"18069",484,356,356,5,0,"PODEMOS-IU LV CA",26
18,"18182",1926,1222,1204,8,18,"PODEMOS-IU LV CA",69
14,"14902",1113,877,851,15,26,"PODEMOS-IU LV CA",114
4,"4012",184,151,150,3,1,"PODEMOS-IU LV CA",7
4,"4090",298,229,225,1,4,"PODEMOS-IU LV CA",13
18,"18151",261,167,166,4,1,"PODEMOS-IU LV CA",25
18,"18039",3343,2293,2252,22,41,"PODEMOS-IU LV CA",118
4,"4049",5711,3766,3732,25,34,"PODEMOS-IU LV CA",299
18,"18098",5959,3816,3749,33,67,"PODEMOS-IU LV CA",285
23,"23033",1325,1008,989,11,19,"PODEMOS-IU LV CA",43
23,"23048",817,605,599,4,6,"PODEMOS-IU LV CA",40
18,"18910",710,439,434,1,5,"PODEMOS-IU LV CA",42
21,"21073",1902,1073,1043,13,30,"PODEMOS-IU LV CA",91
14,"14049",16185,11561,11323,145,238,"PODEMOS-IU LV CA",1624
18,"18022",13875,8948,8764,98,184,"PODEMOS-IU LV CA",1298
23,"23053",9451,6038,5975,60,63,"PODEMOS-IU LV CA",1667
29,"29042",14586,9793,9649,95,144,"PODEMOS-IU LV CA",955
23,"23098",847,704,700,0,4,"PODEMOS-IU LV CA",35
23,"23905",1828,1320,1302,12,18,"PODEMOS-IU LV CA",53
14,"14007",15016,10248,10043,99,205,"PODEMOS-IU LV CA",1154
18,"18025",277,198,197,0,1,"PODEMOS-IU LV CA",21
41,"41086",16199,10227,10105,137,122,"PODEMOS-IU LV CA",1323
41,"41094",6496,4733,4628,47,105,"PODEMOS-IU LV CA",477
41,"41901",2692,2101,2051,47,50,"PODEMOS-IU LV CA",156
18,"18168",783,566,561,11,5,"PODEMOS-IU LV CA",72
18,"18068",1638,1197,1167,12,30,"PODEMOS-IU LV CA",172
41,"41070",6451,4715,4632,70,83,"PODEMOS-IU LV CA",808
29,"29061",1043,803,773,9,30,"PODEMOS-IU LV CA",230
41,"41097",3131,2197,2140,13,57,"PODEMOS-IU LV CA",120
21,"21006",3321,2197,2125,19,72,"PODEMOS-IU LV CA",280
41,"41074",2994,2154,2105,19,49,"PODEMOS-IU LV CA",510
23,"23038",3786,2934,2900,21,34,"PODEMOS-IU LV CA",270
18,"18103",714,500,498,3,2,"PODEMOS-IU LV CA",15
29,"29041",3697,2406,2361,47,45,"PODEMOS-IU LV CA",505
23,"23055",46314,30950,30506,279,444,"PODEMOS-IU LV CA",3959
41,"41079",9285,6591,6446,101,145,"PODEMOS-IU LV CA",855
14,"14019",6380,4933,4831,71,102,"PODEMOS-IU LV CA",969
21,"21902",1136,744,739,2,5,"PODEMOS-IU LV CA",111
4,"4067",504,340,330,4,10,"PODEMOS-IU LV CA",13
21,"21019",592,397,389,6,8,"PODEMOS-IU LV CA",70
23,"23030",1207,998,977,7,21,"PODEMOS-IU LV CA",25
21,"21046",1729,1212,1187,14,25,"PODEMOS-IU LV CA",65
29,"29064",423,291,285,2,6,"PODEMOS-IU LV CA",19
18,"18189",785,598,592,9,6,"PODEMOS-IU LV CA",126
18,"18109",597,430,422,5,8,"PODEMOS-IU LV CA",22
23,"23031",764,660,640,6,20,"PODEMOS-IU LV CA",88
41,"41902",4599,2906,2868,50,38,"PODEMOS-IU LV CA",328
41,"41027",4007,2628,2546,33,82,"PODEMOS-IU LV CA",437
23,"23057",727,582,572,7,10,"PODEMOS-IU LV CA",139
18,"18063",1232,687,678,9,9,"PODEMOS-IU LV CA",27
29,"29069",87188,54019,53240,633,779,"PODEMOS-IU LV CA",5534
11,"11014",17203,10923,10805,222,118,"PODEMOS-IU LV CA",1930
11,"11034",2319,1520,1487,17,33,"PODEMOS-IU LV CA",108
11,"11004",89919,55211,54544,830,667,"PODEMOS-IU LV CA",5897
29,"29085",138,98,93,1,5,"PODEMOS-IU LV CA",11
41,"41017",15907,11486,11302,158,184,"PODEMOS-IU LV CA",1470
4,"4100",9433,5599,5556,48,43,"PODEMOS-IU LV CA",467
14,"14040",3749,2905,2845,53,60,"PODEMOS-IU LV CA",1160
21,"21059",221,169,163,1,6,"PODEMOS-IU LV CA",17
4,"4030",1052,690,678,6,12,"PODEMOS-IU LV CA",21
18,"18106",413,270,261,3,9,"PODEMOS-IU LV CA",14
4,"4020",302,207,206,2,1,"PODEMOS-IU LV CA",1
11,"11025",4374,2808,2759,30,49,"PODEMOS-IU LV CA",258
23,"23007",3015,2252,2229,14,23,"PODEMOS-IU LV CA",114
18,"18117",497,360,354,1,6,"PODEMOS-IU LV CA",36
41,"41077",8631,5788,5598,51,190,"PODEMOS-IU LV CA",953
18,"18133",2101,1496,1477,6,19,"PODEMOS-IU LV CA",86
23,"23004",407,321,315,2,6,"PODEMOS-IU LV CA",17
41,"41021",21410,14369,14139,195,230,"PODEMOS-IU LV CA",2310
14,"14014",2496,1962,1907,20,55,"PODEMOS-IU LV CA",259
4,"4031",2238,1649,1645,15,4,"PODEMOS-IU LV CA",62
29,"29059",2662,1950,1895,16,55,"PODEMOS-IU LV CA",597
23,"23094",3739,2920,2876,29,44,"PODEMOS-IU LV CA",474
18,"18053",1554,1001,985,9,16,"PODEMOS-IU LV CA",52
29,"29012",9718,6664,6553,85,111,"PODEMOS-IU LV CA",798
14,"14026",2000,1294,1253,20,41,"PODEMOS-IU LV CA",128
21,"21057",995,600,590,8,10,"PODEMOS-IU LV CA",28
29,"29039",2759,1900,1860,23,40,"PODEMOS-IU LV CA",575
29,"29040",1933,1260,1235,11,25,"PODEMOS-IU LV CA",98
21,"21036",204,128,121,1,7,"PODEMOS-IU LV CA",6
18,"18144",816,592,582,3,10,"PODEMOS-IU LV CA",84
29,"29904",418,328,322,1,6,"PODEMOS-IU LV CA",24
4,"4057",1261,886,872,6,14,"PODEMOS-IU LV CA",35
11,"11028",32829,21934,21654,310,280,"PODEMOS-IU LV CA",6108
11,"11021",4914,3187,3069,61,118,"PODEMOS-IU LV CA",398
29,"29005",4507,3012,2965,29,47,"PODEMOS-IU LV CA",211
18,"18908",776,553,528,3,25,"PODEMOS-IU LV CA",74
29,"29013",1613,1191,1154,9,37,"PODEMOS-IU LV CA",228
29,"29024",371,216,204,3,12,"PODEMOS-IU LV CA",15
41,"41100",954,670,635,7,35,"PODEMOS-IU LV CA",57
14,"14005",6298,3905,3828,71,77,"PODEMOS-IU LV CA",926
29,"29079",2326,1609,1582,12,27,"PODEMOS-IU LV CA",222
29,"29049",2890,2069,2034,12,35,"PODEMOS-IU LV CA",372
18,"18072",655,452,445,4,7,"PODEMOS-IU LV CA",32
21,"21056",2914,2148,2046,29,102,"PODEMOS-IU LV CA",301
21,"21040",3193,2219,2123,32,96,"PODEMOS-IU LV CA",193
41,"41036",3903,2708,2645,35,63,"PODEMOS-IU LV CA",942
23,"23061",7711,5357,5231,44,126,"PODEMOS-IU LV CA",268
41,"41031",1204,780,769,5,11,"PODEMOS-IU LV CA",54
4,"4079",54675,35691,35365,328,326,"PODEMOS-IU LV CA",3292
29,"29033",1084,733,722,5,11,"PODEMOS-IU LV CA",43
4,"4016",2136,1486,1467,13,19,"PODEMOS-IU LV CA",84
29,"29052",213,129,128,0,1,"PODEMOS-IU LV CA",8
18,"18042",417,332,330,4,2,"PODEMOS-IU LV CA",38
4,"4087",157,115,113,0,2,"PODEMOS-IU LV CA",10
29,"29009",1435,971,957,17,14,"PODEMOS-IU LV CA",232
21,"21063",2611,1948,1891,23,57,"PODEMOS-IU LV CA",149
18,"18028",898,723,718,3,5,"PODEMOS-IU LV CA",61
23,"23012",4004,2726,2689,21,37,"PODEMOS-IU LV CA",130
23,"23060",19210,13677,13495,145,182,"PODEMOS-IU LV CA",1003
41,"41090",3489,2560,2467,27,93,"PODEMOS-IU LV CA",304
18,"18162",919,664,652,3,12,"PODEMOS-IU LV CA",39
11,"11001",4360,2810,2744,32,66,"PODEMOS-IU LV CA",225
23,"23072",1879,1389,1363,3,26,"PODEMOS-IU LV CA",64
18,"18165",4265,2870,2820,22,50,"PODEMOS-IU LV CA",377
18,"18179",493,315,309,8,6,"PODEMOS-IU LV CA",18
23,"23017",1498,1153,1129,11,24,"PODEMOS-IU LV CA",53
18,"18147",3655,2273,2241,16,32,"PODEMOS-IU LV CA",312
14,"14018",3617,2632,2568,31,64,"PODEMOS-IU LV CA",429
4,"4097",231,173,173,1,0,"PODEMOS-IU LV CA",20
18,"18128",332,263,260,1,3,"PODEMOS-IU LV CA",25
18,"18902",752,589,568,3,21,"PODEMOS-IU LV CA",81
14,"14046",4442,3283,3190,34,93,"PODEMOS-IU LV CA",1169
41,"41015",5426,3778,3639,41,139,"PODEMOS-IU LV CA",378
29,"29008",15249,10396,10234,108,162,"PODEMOS-IU LV CA",725
23,"23034",2480,1923,1882,15,41,"PODEMOS-IU LV CA",66
29,"29067",431757,290824,287855,3289,2969,"PODEMOS-IU LV CA",40503
18,"18014",6938,4864,4742,64,122,"PODEMOS-IU LV CA",520
23,"23026",3431,2430,2375,25,55,"PODEMOS-IU LV CA",103
23,"23073",4363,3214,3176,24,38,"PODEMOS-IU LV CA",184
23,"23008",1422,1042,1020,9,22,"PODEMOS-IU LV CA",105
18,"18029",1812,1104,1065,7,39,"PODEMOS-IU LV CA",83
23,"23037",518,403,398,10,5,"PODEMOS-IU LV CA",31
18,"18061",999,781,770,5,11,"PODEMOS-IU LV CA",134
21,"21071",206,148,144,4,4,"PODEMOS-IU LV CA",10
41,"41067",7273,5114,5036,59,78,"PODEMOS-IU LV CA",546
4,"4064",2878,1937,1924,16,13,"PODEMOS-IU LV CA",180
11,"11035",13751,8535,8396,125,139,"PODEMOS-IU LV CA",1102
21,"21050",12567,8522,8392,89,130,"PODEMOS-IU LV CA",610
41,"41046",3005,2241,2198,11,43,"PODEMOS-IU LV CA",511
21,"21003",684,476,452,4,24,"PODEMOS-IU LV CA",89
4,"4024",3241,2315,2290,34,25,"PODEMOS-IU LV CA",201
18,"18143",945,661,651,2,10,"PODEMOS-IU LV CA",159
18,"18140",42474,26967,26648,225,319,"PODEMOS-IU LV CA",3416
29,"29082",34683,24751,24495,263,256,"PODEMOS-IU LV CA",3339
18,"18001",222,147,146,0,1,"PODEMOS-IU LV CA",8
21,"21017",2302,1469,1452,18,17,"PODEMOS-IU LV CA",123
21,"21070",6294,4232,4124,64,108,"PODEMOS-IU LV CA",705
4,"4093",1916,1143,1130,5,13,"PODEMOS-IU LV CA",90
33,"33027",752,412,405,11,7,"PODEMOS-IX",49
33,"33077",1097,688,683,4,5,"PODEMOS-IX",31
33,"33038",2218,1501,1477,17,24,"PODEMOS-IX",284
33,"33060",13991,8629,8481,109,148,"PODEMOS-IX",2002
33,"33054",1601,1025,1010,17,15,"PODEMOS-IX",110
33,"33019",2844,1702,1680,11,22,"PODEMOS-IX",164
33,"33040",4556,2837,2784,58,53,"PODEMOS-IX",354
33,"33044",177059,121380,120421,1543,959,"PODEMOS-IX",15933
33,"33036",11281,7240,7153,96,87,"PODEMOS-IX",718
33,"33009",878,545,542,4,3,"PODEMOS-IX",111
33,"33068",1031,518,510,5,8,"PODEMOS-IX",38
33,"33043",656,408,401,2,7,"PODEMOS-IX",45
33,"33065",1077,670,657,11,13,"PODEMOS-IX",105
33,"33021",4304,2643,2610,32,33,"PODEMOS-IX",301
33,"33020",12981,8550,8453,120,97,"PODEMOS-IX",1598
33,"33017",2969,1787,1768,38,19,"PODEMOS-IX",221
33,"33014",8735,5744,5689,67,55,"PODEMOS-IX",1224
33,"33025",8956,5493,5453,81,40,"PODEMOS-IX",806
33,"33005",1357,832,825,11,7,"PODEMOS-IX",80
33,"33045",4359,2819,2787,32,32,"PODEMOS-IX",328
33,"33042",4237,2862,2816,49,46,"PODEMOS-IX",450
33,"33033",9381,5848,5770,88,78,"PODEMOS-IX",1121
33,"33076",12115,7519,7456,76,63,"PODEMOS-IX",920
33,"33052",681,418,416,3,2,"PODEMOS-IX",45
33,"33023",3249,2127,2097,30,30,"PODEMOS-IX",296
33,"33007",1382,804,795,4,9,"PODEMOS-IX",77
33,"33061",344,174,174,1,0,"PODEMOS-IX",12
33,"33011",10563,5646,5578,92,68,"PODEMOS-IX",634
33,"33034",9979,5937,5873,64,64,"PODEMOS-IX",554
33,"33047",1068,771,759,9,12,"PODEMOS-IX",46
33,"33070",3267,2211,2185,27,26,"PODEMOS-IX",318
33,"33032",11056,7052,6905,109,147,"PODEMOS-IX",1294
33,"33063",375,269,267,5,2,"PODEMOS-IX",19
33,"33050",548,316,314,1,2,"PODEMOS-IX",33
33,"33049",5973,3569,3518,48,51,"PODEMOS-IX",437
33,"33006",1476,862,857,9,5,"PODEMOS-IX",212
33,"33028",1143,519,518,7,1,"PODEMOS-IX",52
33,"33031",33775,20484,20184,276,300,"PODEMOS-IX",5089
33,"33067",751,543,538,7,5,"PODEMOS-IX",62
33,"33075",244,125,122,3,3,"PODEMOS-IX",12
33,"33041",7101,4564,4513,58,51,"PODEMOS-IX",692
33,"33037",33074,20693,20412,259,281,"PODEMOS-IX",5211
33,"33018",2804,1830,1806,30,24,"PODEMOS-IX",243
33,"33053",1078,602,599,10,3,"PODEMOS-IX",103
33,"33015",1396,849,842,7,7,"PODEMOS-IX",164
33,"33071",546,385,383,7,2,"PODEMOS-IX",21
33,"33057",1525,1005,988,17,17,"PODEMOS-IX",174
33,"33051",6787,4318,4268,48,50,"PODEMOS-IX",433
33,"33066",42818,27780,27466,425,314,"PODEMOS-IX",4059
33,"33026",8201,5014,4974,74,40,"PODEMOS-IX",763
33,"33072",1443,816,814,8,2,"PODEMOS-IX",146
33,"33046",480,334,329,0,5,"PODEMOS-IX",23
33,"33039",1646,1118,1110,8,8,"PODEMOS-IX",136
33,"33029",315,145,142,1,3,"PODEMOS-IX",19
33,"33069",3379,2249,2231,41,18,"PODEMOS-IX",281
33,"33003",603,322,317,7,5,"PODEMOS-IX",18
33,"33010",1722,1085,1069,15,16,"PODEMOS-IX",142
33,"33024",224741,151660,150461,1597,1199,"PODEMOS-IX",25208
33,"33048",132,86,85,1,1,"PODEMOS-IX",5
33,"33022",802,460,452,4,8,"PODEMOS-IX",85
33,"33058",1668,1050,1035,13,15,"PODEMOS-IX",236
33,"33073",8096,4377,4320,59,57,"PODEMOS-IX",336
33,"33002",9403,5920,5839,69,81,"PODEMOS-IX",1011
33,"33013",430,294,292,1,2,"PODEMOS-IX",30
33,"33016",18848,12845,12737,173,108,"PODEMOS-IX",2091
33,"33074",3366,2042,2011,35,31,"PODEMOS-IX",215
33,"33064",240,151,151,0,0,"PODEMOS-IX",26
33,"33055",1485,992,966,14,26,"PODEMOS-IX",92
33,"33012",5085,3158,3142,27,16,"PODEMOS-IX",350
33,"33056",4850,3068,3044,25,24,"PODEMOS-IX",365
33,"33001",1475,758,753,15,5,"PODEMOS-IX",39
33,"33030",876,632,630,8,2,"PODEMOS-IX",99
33,"33062",385,194,187,4,7,"PODEMOS-IX",12
33,"33078",127,81,81,0,0,"PODEMOS-IX",13
33,"33004",65304,43473,43153,563,320,"PODEMOS-IX",7949
33,"33059",4359,2651,2625,33,26,"PODEMOS-IX",275
33,"33008",1679,1140,1133,10,7,"PODEMOS-IX",89
33,"33035",11214,7359,7303,102,56,"PODEMOS-IX",1054
34,"34182",746,558,553,9,5,"PP",243
46,"46235",21229,15171,15011,126,160,"PP",2681
6,"6017",250,202,198,0,4,"PP",71
19,"19102",88,75,73,0,2,"PP",15
26,"26158",242,184,181,1,3,"PP",87
34,"34178",119,94,91,0,3,"PP",55
16,"16202",733,533,526,4,7,"PP",136
39,"39075",136789,95707,95089,478,618,"PP",28019
23,"23010",14264,9801,9635,120,166,"PP",2178
44,"44089",49,41,41,0,0,"PP",13
26,"26029",34,26,26,1,0,"PP",14
2,"2066",222,165,163,1,2,"PP",52
40,"40076",6576,4700,4607,32,93,"PP",1201
18,"18089",14504,9854,9746,100,108,"PP",2498
16,"16083",44,24,24,0,0,"PP",4
49,"49208",352,223,214,1,9,"PP",122
2,"2043",1165,872,858,6,14,"PP",261
47,"47214",1349,1036,1019,5,17,"PP",509
36,"36037",2538,1650,1625,12,25,"PP",584
26,"26171",155,109,107,2,2,"PP",59
16,"16174",166,130,129,2,1,"PP",40
37,"37097",42,29,29,0,0,"PP",15
47,"47045",732,558,549,3,9,"PP",114
24,"24170",1806,1232,1220,9,12,"PP",256
49,"49197",155,109,104,0,5,"PP",25
28,"28179",1451,1043,1033,6,10,"PP",258
26,"26041",109,67,65,0,2,"PP",37
28,"28159",589,455,447,4,8,"PP",138
50,"50044",224,159,159,2,0,"PP",25
9,"9345",111,87,86,2,1,"PP",26
43,"43077",453,306,304,1,2,"PP",30
37,"37254",174,140,135,0,5,"PP",53
46,"46205",14237,10641,10533,77,108,"PP",2343
4,"4070",1529,1088,1076,8,12,"PP",308
40,"40174",319,229,227,3,2,"PP",116
48,"48043",4591,3337,3325,20,12,"PP",162
7,"7014",7885,3934,3893,43,41,"PP",660
28,"28001",70,48,47,1,1,"PP",17
37,"37152",400,268,261,4,7,"PP",120
40,"40075",152,116,116,0,0,"PP",44
44,"44239",21,19,19,0,0,"PP",7
32,"32092",491,280,275,0,5,"PP",102
44,"44027",144,113,113,2,0,"PP",29
24,"24228",619,370,364,2,6,"PP",165
37,"37058",56,38,38,1,0,"PP",19
12,"12049",415,317,305,4,12,"PP",53
50,"50015",81,57,56,0,1,"PP",10
9,"9162",130,102,100,1,2,"PP",29
26,"26172",25,16,15,0,1,"PP",2
16,"16216",272,207,204,0,3,"PP",58
10,"10174",171,112,110,0,2,"PP",36
4,"4015",113,81,81,0,0,"PP",16
23,"23099",4824,3523,3435,35,88,"PP",926
49,"49175",204,136,135,3,1,"PP",57
5,"5112",95,59,58,0,1,"PP",25
45,"45148",263,184,184,0,0,"PP",77
4,"4051",404,323,319,2,4,"PP",104
10,"10088",198,112,112,1,0,"PP",46
16,"16219",81,58,58,0,0,"PP",6
5,"5122",118,91,89,1,2,"PP",41
10,"10196",294,208,206,3,2,"PP",61
18,"18030",566,382,380,2,2,"PP",90
47,"47077",234,172,170,1,2,"PP",91
41,"41093",19064,14867,14700,151,167,"PP",4106
4,"4047",2224,1649,1627,13,22,"PP",541
12,"12131",97,87,87,0,0,"PP",32
18,"18062",11226,7969,7777,88,192,"PP",1542
11,"11040",396,332,324,3,8,"PP",38
37,"37215",133,93,90,1,3,"PP",33
43,"43147",528,425,420,3,5,"PP",25
37,"37031",329,241,238,3,3,"PP",105
37,"37248",150,116,116,1,0,"PP",59
46,"46169",32403,23890,23698,222,192,"PP",4314
45,"45059",1702,1315,1303,1,12,"PP",407
37,"37191",102,57,57,1,0,"PP",32
36,"36051",14358,9408,9255,86,153,"PP",3404
22,"22206",179,138,137,0,1,"PP",24
39,"39085",7017,5029,4992,23,37,"PP",1234
45,"45060",152,109,109,1,0,"PP",16
37,"37268",106,62,61,1,1,"PP",25
47,"47083",81,63,61,0,2,"PP",25
5,"5244",39,29,29,0,0,"PP",18
37,"37175",412,298,293,4,5,"PP",137
46,"46056",176,142,142,0,0,"PP",28
48,"48078",37858,25959,25819,157,140,"PP",2253
26,"26126",29,27,27,0,0,"PP",20
44,"44145",974,698,697,3,1,"PP",178
26,"26037",125,98,98,3,0,"PP",33
4,"4103",1432,1003,993,10,10,"PP",249
28,"28174",1858,1284,1273,1,11,"PP",329
19,"19133",78,64,64,2,0,"PP",9
44,"44051",2579,1924,1901,10,23,"PP",703
5,"5030",40,32,32,0,0,"PP",5
28,"28901",890,624,618,5,6,"PP",128
49,"49229",109,80,77,1,3,"PP",26
34,"34022",1022,813,798,7,15,"PP",315
40,"40162",380,273,265,1,8,"PP",105
19,"19218",43,31,31,0,0,"PP",7
19,"19265",134,97,97,5,0,"PP",33
28,"28163",429,332,326,0,6,"PP",59
22,"22245",303,222,213,3,9,"PP",89
2,"2032",259,183,178,2,5,"PP",33
50,"50124",394,269,266,0,3,"PP",104
39,"39088",59,40,40,2,0,"PP",6
26,"26042",795,578,572,8,6,"PP",206
5,"5193",179,140,139,2,1,"PP",75
34,"34124",60,45,45,0,0,"PP",19
47,"47015",177,129,129,0,0,"PP",56
5,"5234",45,38,38,0,0,"PP",23
47,"47179",368,256,254,2,2,"PP",94
9,"9219",27097,17874,17629,192,245,"PP",3785
27,"27012",1264,658,650,6,8,"PP",242
6,"6143",3389,2430,2371,24,59,"PP",366
6,"6092",558,438,426,2,12,"PP",86
37,"37122",203,162,161,3,1,"PP",50
45,"45901",779,542,534,5,8,"PP",139
3,"3098",523,382,378,1,4,"PP",49
42,"42098",8,7,7,0,0,"PP",2
44,"44114",233,161,159,0,2,"PP",53
29,"29057",330,222,218,2,4,"PP",54
49,"49097",67,44,44,0,0,"PP",13
46,"46030",810,641,625,7,16,"PP",141
34,"34048",62,51,51,1,0,"PP",19
46,"46094",20805,15353,15211,122,142,"PP",2942
5,"5196",57,43,43,0,0,"PP",5
26,"26058",149,114,114,2,0,"PP",46
28,"28903",35555,28875,28671,341,204,"PP",7190
15,"15017",19866,13497,13344,195,153,"PP",3064
16,"16092",149,108,108,1,0,"PP",35
38,"38041",7025,4729,4684,42,45,"PP",731
14,"14017",10953,7929,7791,84,138,"PP",1298
6,"6148",957,682,665,1,17,"PP",124
23,"23095",8571,6159,6101,37,58,"PP",1584
5,"5113",62,42,42,0,0,"PP",24
44,"44200",39,26,26,0,0,"PP",18
49,"49015",198,156,155,0,1,"PP",69
2,"2014",354,254,252,3,2,"PP",73
50,"50116",169,124,123,0,1,"PP",40
19,"19034",25,22,21,0,1,"PP",4
26,"26168",5584,3757,3696,35,61,"PP",996
5,"5085",31,27,27,0,0,"PP",17
9,"9343",92,66,65,0,1,"PP",40
19,"19005",91,63,62,0,1,"PP",18
26,"26017",364,274,269,2,5,"PP",54
49,"49113",162,131,131,2,0,"PP",62
28,"28083",9836,7278,7206,64,72,"PP",1340
46,"46073",1066,823,817,11,6,"PP",201
9,"9242",66,53,52,3,1,"PP",22
24,"24064",1501,1030,1012,2,18,"PP",233
43,"43019",1332,911,904,8,7,"PP",57
32,"32087",1669,1158,1136,14,22,"PP",578
13,"13033",1544,1231,1196,5,35,"PP",224
26,"26140",239,180,177,1,3,"PP",82
1,"1009",1258,839,833,2,6,"PP",29
4,"4087",157,115,113,0,2,"PP",30
48,"48083",6934,4800,4765,21,35,"PP",181
49,"49120",54,35,35,0,0,"PP",17
37,"37041",71,53,53,0,0,"PP",26
12,"12007",724,622,614,2,8,"PP",222
50,"50153",914,683,675,9,8,"PP",132
21,"21005",15754,9502,9340,84,162,"PP",1261
26,"26180",221,164,162,4,2,"PP",71
45,"45163",8326,5835,5693,48,142,"PP",1298
9,"9070",33,28,27,0,1,"PP",6
19,"19121",265,205,204,0,1,"PP",49
22,"22042",116,91,89,1,2,"PP",27
26,"26144",187,147,143,1,4,"PP",82
9,"9061",147,119,119,0,0,"PP",76
37,"37079",77,59,59,1,0,"PP",24
45,"45067",2267,1722,1675,14,47,"PP",685
24,"24213",158,127,126,1,1,"PP",41
4,"4065",365,273,271,1,2,"PP",62
41,"41050",5173,3954,3878,36,76,"PP",899
32,"32047",1761,1192,1175,10,17,"PP",666
24,"24224",564,381,375,5,6,"PP",138
12,"12121",1043,878,856,5,22,"PP",270
19,"19051",61,52,52,0,0,"PP",22
24,"24108",348,247,246,4,1,"PP",105
19,"19215",135,109,109,0,0,"PP",56
45,"45096",987,748,725,9,23,"PP",181
2,"2054",375,288,283,0,5,"PP",128
28,"28120",1220,910,897,5,13,"PP",220
18,"18915",726,474,467,4,7,"PP",84
40,"40222",161,134,131,1,3,"PP",44
21,"21041",113074,73295,72313,1063,982,"PP",13507
41,"41072",4031,2969,2933,15,36,"PP",185
50,"50113",587,471,461,2,10,"PP",124
40,"40007",68,55,55,1,0,"PP",24
5,"5259",99,80,79,2,1,"PP",38
19,"19334",43,35,35,0,0,"PP",9
5,"5025",78,65,65,0,0,"PP",35
14,"14008",2758,1880,1836,21,44,"PP",423
37,"37348",100,76,76,0,0,"PP",46
50,"50023",199,145,143,2,2,"PP",72
9,"9460",162,141,140,0,1,"PP",67
34,"34221",168,129,127,2,2,"PP",46
20,"20011",1624,1234,1225,3,9,"PP",18
1,"1032",498,363,353,1,10,"PP",60
4,"4073",327,224,223,0,1,"PP",55
4,"4017",1276,833,818,4,15,"PP",175
47,"47035",901,659,653,4,6,"PP",263
28,"28097",126,87,87,2,0,"PP",12
16,"16272",201,149,147,2,2,"PP",69
3,"3097",1014,778,764,5,14,"PP",182
6,"6048",821,666,653,1,13,"PP",193
42,"42059",20,14,14,0,0,"PP",8
3,"3022",140,125,121,1,4,"PP",42
44,"44175",112,76,75,1,1,"PP",30
29,"29059",2662,1950,1895,16,55,"PP",229
44,"44039",204,144,143,1,1,"PP",66
43,"43161",17103,11905,11838,82,67,"PP",668
39,"39041",1753,1285,1269,7,16,"PP",321
43,"43089",279,201,201,1,0,"PP",15
40,"40105",43,35,35,0,0,"PP",17
27,"27056",1218,787,778,6,9,"PP",305
22,"22066",755,529,520,8,9,"PP",94
29,"29020",3278,2329,2260,22,69,"PP",308
42,"42125",71,55,55,0,0,"PP",14
49,"49105",135,94,94,2,0,"PP",46
23,"23040",1438,1175,1159,3,16,"PP",190
9,"9123",42,36,36,0,0,"PP",12
46,"46109",6248,4516,4440,37,76,"PP",934
22,"22109",261,184,183,1,1,"PP",47
12,"12045",333,243,235,2,8,"PP",46
7,"7031",24972,14866,14757,127,109,"PP",3291
19,"19139",26,19,19,2,0,"PP",8
24,"24148",1602,1152,1140,11,12,"PP",440
27,"27062",583,403,400,2,3,"PP",190
14,"14073",2768,1934,1880,33,54,"PP",262
9,"9272",251,166,166,1,0,"PP",70
46,"46043",135,119,118,0,1,"PP",48
34,"34171",928,572,562,2,10,"PP",224
37,"37260",137,110,109,0,1,"PP",25
22,"22137",1009,671,665,1,6,"PP",149
19,"19231",10,6,6,0,0,"PP",5
16,"16240",98,71,69,0,2,"PP",20
23,"23044",4697,3495,3400,31,95,"PP",846
45,"45091",376,270,269,3,1,"PP",51
27,"27008",1326,865,853,5,12,"PP",398
45,"45024",1034,742,733,1,9,"PP",288
9,"9055",47,33,32,0,1,"PP",18
24,"24027",1214,841,828,6,13,"PP",210
14,"14026",2000,1294,1253,20,41,"PP",262
43,"43132",375,295,291,1,4,"PP",12
27,"27035",183,110,110,3,0,"PP",23
12,"12092",123,95,95,0,0,"PP",45
15,"15067",7933,5329,5282,43,47,"PP",1421
40,"40159",130,94,93,2,1,"PP",38
12,"12099",597,444,436,6,8,"PP",108
49,"49046",246,174,169,0,5,"PP",74
27,"27014",3144,2009,1985,24,24,"PP",785
50,"50143",541,373,367,2,6,"PP",87
14,"14032",388,302,293,0,9,"PP",91
16,"16115",49,32,32,0,0,"PP",11
26,"26102",6076,4276,4205,52,71,"PP",1485
16,"16014",558,419,417,6,2,"PP",110
50,"50266",120,77,76,3,1,"PP",31
46,"46037",1120,891,879,7,12,"PP",195
47,"47061",237,185,184,0,1,"PP",55
46,"46260",2685,2072,2053,14,19,"PP",461
47,"47168",30,26,26,1,0,"PP",9
34,"34099",53,44,42,0,2,"PP",13
10,"10082",1793,1333,1305,11,28,"PP",272
45,"45205",7438,4772,4701,27,71,"PP",790
39,"39084",868,608,605,3,3,"PP",212
22,"22165",449,305,300,3,5,"PP",106
9,"9100",55,33,33,0,0,"PP",23
18,"18134",6104,4049,3972,39,77,"PP",771
29,"29044",749,477,473,1,4,"PP",176
47,"47065",820,608,602,2,6,"PP",247
4,"4034",169,91,91,1,0,"PP",36
46,"46114",552,417,412,6,5,"PP",137
28,"28014",34522,25016,24748,229,268,"PP",5189
29,"29051",42179,27231,26724,282,507,"PP",6155
34,"34229",58,47,47,1,0,"PP",32
13,"13087",23255,15400,15127,213,273,"PP",3737
49,"49226",240,200,198,2,2,"PP",70
40,"40019",29,23,23,1,0,"PP",9
24,"24049",1417,983,975,14,8,"PP",287
23,"23065",1530,1068,1054,7,14,"PP",246
24,"24101",370,219,213,4,6,"PP",38
47,"47210",399,278,275,3,3,"PP",98
19,"19181",50,34,34,0,0,"PP",13
40,"40134",692,522,509,10,13,"PP",180
14,"14031",556,462,456,5,6,"PP",86
1,"1008",808,546,536,6,10,"PP",69
50,"50208",1761,1267,1250,16,17,"PP",299
10,"10075",238,150,148,0,2,"PP",34
34,"34136",143,89,89,1,0,"PP",39
9,"9292",72,55,55,3,0,"PP",16
49,"49010",350,260,256,8,4,"PP",52
45,"45075",120,77,74,0,3,"PP",25
14,"14047",1644,1198,1183,14,15,"PP",218
24,"24902",331,239,239,0,0,"PP",77
46,"46007",12333,8890,8803,79,87,"PP",1764
47,"47145",583,430,426,6,4,"PP",166
11,"11901",5739,3759,3686,99,73,"PP",543
28,"28086",5446,3643,3600,19,43,"PP",752
22,"22174",462,352,350,0,2,"PP",142
6,"6063",2924,2141,2108,8,33,"PP",462
42,"42120",131,87,86,1,1,"PP",36
9,"9361",103,64,64,1,0,"PP",35
28,"28008",2008,1333,1323,7,10,"PP",304
12,"12088",57,53,53,0,0,"PP",24
28,"28090",9252,7216,7153,58,63,"PP",1747
45,"45066",7815,5540,5447,25,93,"PP",1720
26,"26081",15,14,14,1,0,"PP",10
36,"36020",2172,1435,1418,19,17,"PP",666
12,"12014",164,111,111,0,0,"PP",29
50,"50003",117,89,89,1,0,"PP",23
21,"21045",231,177,174,4,3,"PP",27
13,"13062",567,450,446,4,4,"PP",119
3,"3059",20710,14788,14685,89,103,"PP",3511
24,"24005",342,218,217,0,1,"PP",112
32,"32085",10584,6687,6611,58,76,"PP",2450
37,"37269",424,280,277,2,3,"PP",88
26,"26047",1852,1449,1434,6,15,"PP",544
12,"12107",350,299,295,3,4,"PP",77
4,"4045",1696,1268,1254,17,14,"PP",151
21,"21048",318,234,229,3,5,"PP",25
42,"42142",42,36,36,1,0,"PP",21
44,"44014",2506,1828,1818,8,10,"PP",389
35,"35013",6593,4596,4516,47,80,"PP",1602
30,"30001",4507,3357,3331,17,26,"PP",1294
40,"40079",229,160,159,2,1,"PP",52
9,"9432",170,125,123,0,2,"PP",40
50,"50269",287,172,167,2,5,"PP",69
26,"26036",16989,11463,11260,101,203,"PP",3859
32,"32051",1369,1062,1058,13,4,"PP",699
5,"5158",346,263,261,0,2,"PP",115
19,"19143",1781,1278,1266,18,12,"PP",328
39,"39053",212,133,133,4,0,"PP",34
46,"46176",2077,1362,1348,14,14,"PP",291
49,"49124",238,170,164,2,6,"PP",53
4,"4094",215,156,156,0,0,"PP",88
49,"49166",1193,835,821,7,14,"PP",254
47,"47221",97,85,84,1,1,"PP",41
42,"42058",103,74,72,1,2,"PP",42
10,"10191",511,374,365,5,9,"PP",94
16,"16211",335,228,227,1,1,"PP",79
5,"5002",1905,1361,1329,11,32,"PP",348
20,"20904",87,56,55,1,1,"PP",0
15,"15077",8103,4893,4818,61,75,"PP",2257
46,"46141",433,340,337,6,3,"PP",126
44,"44177",101,68,68,1,0,"PP",18
2,"2065",441,368,361,0,7,"PP",126
19,"19049",8,8,7,0,1,"PP",0
24,"24060",561,297,296,2,1,"PP",90
12,"12110",222,156,155,3,1,"PP",24
5,"5239",215,163,163,3,0,"PP",52
24,"24217",135,93,93,0,0,"PP",42
45,"45165",62598,43750,43259,329,491,"PP",11038
9,"9110",77,50,50,0,0,"PP",22
49,"49023",899,627,620,3,7,"PP",242
16,"16130",533,407,404,0,3,"PP",98
12,"12100",1273,1069,1052,5,17,"PP",285
3,"3084",501,413,413,1,0,"PP",113
29,"29054",42538,28080,27814,225,266,"PP",7542
28,"28073",12707,9198,9080,94,118,"PP",1548
22,"22106",20,13,13,2,0,"PP",2
43,"43012",3700,2882,2858,20,24,"PP",212
32,"32075",4362,3117,3077,30,40,"PP",1419
46,"46144",628,483,478,4,5,"PP",167
19,"19089",23,17,17,0,0,"PP",1
11,"11036",683,401,395,15,6,"PP",85
9,"9256",330,221,219,0,2,"PP",85
9,"9073",964,713,706,3,7,"PP",174
36,"36060",30431,19909,19673,206,236,"PP",5520
12,"12112",102,79,79,1,0,"PP",22
26,"26018",10443,7664,7538,80,126,"PP",2287
10,"10145",123,90,84,0,6,"PP",29
23,"23086",11427,7984,7735,81,249,"PP",1424
46,"46192",786,534,519,7,15,"PP",95
41,"41075",10320,7159,6972,88,187,"PP",1438
10,"10024",672,492,480,6,12,"PP",170
16,"16187",55,38,38,3,0,"PP",11
6,"6047",829,618,605,1,13,"PP",169
37,"37181",265,158,158,0,0,"PP",61
50,"50106",123,78,78,0,0,"PP",19
10,"10181",676,470,462,2,8,"PP",106
24,"24012",278,182,180,0,2,"PP",46
22,"22044",234,166,164,1,2,"PP",40
10,"10109",1714,1030,1006,4,24,"PP",278
50,"50001",89,68,68,0,0,"PP",42
41,"41066",1307,927,898,7,29,"PP",104
41,"41029",13520,9849,9663,134,186,"PP",1648
37,"37209",415,276,275,2,1,"PP",53
44,"44052",75,54,54,0,0,"PP",12
49,"49093",280,226,223,5,3,"PP",76
50,"50243",307,227,224,2,3,"PP",73
5,"5209",74,58,58,1,0,"PP",31
6,"6003",768,579,557,4,22,"PP",132
45,"45072",653,469,462,1,7,"PP",146
9,"9375",42,35,35,0,0,"PP",11
12,"12079",414,310,305,2,5,"PP",82
48,"48902",18987,12762,12670,88,92,"PP",749
39,"39013",517,359,356,1,3,"PP",157
9,"9180",132,94,91,1,3,"PP",33
45,"45147",592,449,443,2,6,"PP",83
37,"37030",82,60,60,0,0,"PP",29
42,"42166",55,38,37,0,1,"PP",23
32,"32084",878,532,527,8,5,"PP",212
6,"6052",3962,2728,2642,26,86,"PP",791
39,"39093",297,216,214,1,2,"PP",75
1,"1010",2315,1705,1688,6,17,"PP",120
49,"49116",356,239,234,4,5,"PP",90
37,"37135",1146,849,837,5,12,"PP",308
28,"28019",1272,926,914,6,12,"PP",161
16,"16098",521,418,415,2,3,"PP",113
3,"3062",228,173,172,3,1,"PP",26
39,"39015",828,559,556,3,3,"PP",183
22,"22195",238,190,186,0,4,"PP",62
49,"49205",359,252,251,7,1,"PP",122
47,"47052",6781,5213,5156,50,57,"PP",1145
40,"40078",150,123,123,6,0,"PP",38
37,"37230",220,169,168,1,1,"PP",51
18,"18095",2054,1475,1433,14,42,"PP",207
44,"44082",84,66,66,0,0,"PP",10
5,"5014",5263,3699,3648,35,51,"PP",1185
19,"19901",35,27,27,0,0,"PP",9
50,"50041",16,10,10,0,0,"PP",0
1,"1031",1136,844,830,1,14,"PP",201
22,"22228",532,371,364,4,7,"PP",92
18,"18024",837,651,639,11,12,"PP",125
47,"47053",123,101,97,3,4,"PP",38
42,"42174",174,121,118,4,3,"PP",23
27,"27050",2821,1980,1954,11,26,"PP",1078
50,"50086",176,106,102,1,4,"PP",14
18,"18098",5959,3816,3749,33,67,"PP",918
7,"7032",21005,12039,11928,114,111,"PP",2824
48,"48042",1359,1055,1045,7,10,"PP",82
49,"49055",91,72,72,3,0,"PP",20
34,"34107",73,47,46,1,1,"PP",26
44,"44096",155,115,114,1,1,"PP",26
46,"46248",4868,3434,3374,16,60,"PP",784
47,"47062",155,128,128,0,0,"PP",70
37,"37027",239,182,179,2,3,"PP",66
46,"46161",1467,1129,1113,5,16,"PP",240
4,"4054",363,279,278,2,1,"PP",80
19,"19019",14,11,11,1,0,"PP",6
47,"47031",191,141,140,0,1,"PP",54
47,"47178",170,128,124,2,4,"PP",50
24,"24104",243,167,166,0,1,"PP",43
9,"9421",240,180,180,3,0,"PP",57
50,"50246",37,24,24,0,0,"PP",9
5,"5246",48,35,35,0,0,"PP",19
5,"5064",101,77,77,0,0,"PP",51
34,"34037",301,206,204,1,2,"PP",106
9,"9025",110,61,58,0,3,"PP",25
9,"9298",72,52,52,1,0,"PP",37
19,"19146",47,35,35,0,0,"PP",6
50,"50030",197,124,124,1,0,"PP",34
22,"22232",88,61,61,2,0,"PP",19
15,"15091",1097,705,686,17,19,"PP",277
4,"4091",318,251,250,0,1,"PP",34
26,"26053",191,144,140,2,4,"PP",41
9,"9078",32,27,27,0,0,"PP",9
4,"4006",7192,4389,4335,39,54,"PP",1261
9,"9431",116,85,84,2,1,"PP",41
40,"40043",1773,1376,1345,21,31,"PP",548
26,"26091",147,115,114,0,1,"PP",74
48,"48040",1303,933,926,7,7,"PP",27
47,"47097",305,239,237,0,2,"PP",65
28,"28026",6767,5058,5024,27,34,"PP",1421
47,"47142",121,85,85,0,0,"PP",34
2,"2029",3333,2363,2320,13,43,"PP",534
27,"27029",1425,925,910,11,15,"PP",360
45,"45193",586,478,469,0,9,"PP",170
26,"26066",263,201,194,5,7,"PP",87
42,"42216",26,20,20,0,0,"PP",8
40,"40073",387,327,323,1,4,"PP",139
48,"48067",1133,810,805,0,5,"PP",11
27,"27032",3197,1979,1956,30,23,"PP",782
5,"5023",174,148,145,2,3,"PP",60
5,"5135",399,294,292,2,2,"PP",106
34,"34081",60,45,44,0,1,"PP",25
47,"47071",396,321,316,5,5,"PP",87
24,"24063",362,247,245,2,2,"PP",83
2,"2071",1027,800,795,7,5,"PP",247
50,"50218",112,88,88,1,0,"PP",40
4,"4083",1727,1265,1250,8,15,"PP",278
13,"13031",2475,1855,1834,9,21,"PP",461
42,"42016",20,13,13,0,0,"PP",6
42,"42097",14,9,9,1,0,"PP",1
9,"9355",85,67,67,1,0,"PP",50
11,"11005",4508,2978,2900,34,78,"PP",467
40,"40207",802,593,590,11,3,"PP",138
24,"24077",212,166,162,0,4,"PP",63
2,"2079",2807,2000,1978,17,22,"PP",366
5,"5060",108,79,79,2,0,"PP",45
26,"26109",73,68,68,0,0,"PP",30
37,"37226",152,113,113,2,0,"PP",69
10,"10092",260,201,200,1,1,"PP",49
1,"1027",444,273,271,0,2,"PP",24
5,"5222",140,118,118,0,0,"PP",35
48,"48070",527,357,355,0,2,"PP",1
36,"36027",4401,2940,2781,20,159,"PP",1094
16,"16166",240,173,171,0,2,"PP",51
34,"34123",1634,1274,1258,4,16,"PP",554
36,"36030",3921,2516,2484,31,32,"PP",795
46,"46200",1840,1475,1455,5,20,"PP",359
46,"46086",80,66,65,1,1,"PP",5
34,"34125",105,80,80,2,0,"PP",36
37,"37062",78,59,59,0,0,"PP",32
5,"5040",64,47,46,0,1,"PP",20
37,"37265",198,167,163,1,4,"PP",39
22,"22218",39,34,34,0,0,"PP",7
46,"46165",7349,5460,5412,39,48,"PP",1247
22,"22226",761,537,530,13,7,"PP",124
45,"45033",297,205,201,1,4,"PP",53
19,"19091",23,17,17,0,0,"PP",7
3,"3128",4285,2849,2819,18,30,"PP",689
3,"3051",342,288,286,4,2,"PP",87
42,"42201",23,21,21,0,0,"PP",6
9,"9143",28,17,17,0,0,"PP",11
28,"28100",4482,3146,3113,21,33,"PP",591
48,"48088",134,95,95,0,0,"PP",1
46,"46904",812,615,605,2,10,"PP",99
34,"34074",690,502,490,13,12,"PP",163
36,"36902",5028,3453,3396,19,57,"PP",1368
9,"9419",67,52,49,0,3,"PP",30
5,"5118",64,41,41,1,0,"PP",18
10,"10106",126,102,102,0,0,"PP",33
48,"48052",1562,1220,1210,5,10,"PP",20
49,"49178",748,520,505,7,15,"PP",133
19,"19053",1906,1323,1304,12,19,"PP",410
12,"12009",17943,12389,12292,102,97,"PP",2736
19,"19254",43,34,34,0,0,"PP",14
49,"49256",236,183,179,0,4,"PP",75
44,"44013",11232,7872,7801,64,71,"PP",1805
3,"3080",1330,1040,1032,4,8,"PP",308
50,"50287",253,189,188,11,1,"PP",59
34,"34230",16,11,11,0,0,"PP",7
41,"41095",40187,27090,26680,512,410,"PP",4024
18,"18143",945,661,651,2,10,"PP",91
9,"9218",350,254,252,5,2,"PP",81
47,"47132",39,32,32,1,0,"PP",18
28,"28158",694,501,495,2,6,"PP",163
3,"3071",4000,2858,2813,27,45,"PP",738
19,"19048",19,14,13,1,1,"PP",4
46,"46013",17761,13652,13548,144,104,"PP",2779
46,"46218",1043,842,829,6,13,"PP",242
22,"22129",162,110,110,0,0,"PP",47
28,"28160",8709,6507,6460,62,47,"PP",1608
26,"26038",76,52,52,0,0,"PP",11
43,"43017",112,94,94,1,0,"PP",0
3,"3063",27209,18236,18101,164,135,"PP",3664
42,"42128",45,40,39,2,1,"PP",20
41,"41051",2317,1715,1688,4,27,"PP",385
24,"24009",274,136,135,1,1,"PP",52
5,"5153",86,58,56,3,2,"PP",21
36,"36054",11107,7027,6894,57,133,"PP",2038
5,"5024",193,127,125,2,2,"PP",51
22,"22202",147,128,128,3,0,"PP",36
39,"39049",304,198,195,2,3,"PP",48
37,"37374",1138,889,872,2,17,"PP",323
5,"5017",84,70,67,2,3,"PP",31
48,"48901",5160,3705,3684,16,21,"PP",210
45,"45114",549,400,394,1,6,"PP",115
34,"34154",77,48,48,1,0,"PP",24
5,"5013",834,658,653,2,5,"PP",218
50,"50283",69,46,46,0,0,"PP",13
22,"22200",239,165,164,2,1,"PP",49
28,"28093",2177,1681,1658,11,23,"PP",461
37,"37073",613,448,440,4,8,"PP",156
26,"26170",423,303,301,2,2,"PP",137
40,"40097",130,103,102,5,1,"PP",23
12,"12058",59,47,45,1,2,"PP",22
1,"1036",14698,10207,10131,51,76,"PP",781
12,"12126",24374,17741,17553,111,188,"PP",3912
46,"46060",9278,6796,6724,49,72,"PP",1408
19,"19031",8,8,8,0,0,"PP",5
49,"49037",174,139,136,1,3,"PP",61
27,"27011",2341,1387,1362,7,25,"PP",484
9,"9485",55,41,41,0,0,"PP",27
19,"19167",129,104,103,1,1,"PP",34
38,"38006",41593,20823,20624,127,199,"PP",3941
24,"24036",252,146,146,1,0,"PP",34
44,"44257",149,92,91,0,1,"PP",35
48,"48087",437,335,332,0,3,"PP",22
15,"15072",9434,6304,6228,48,76,"PP",1666
11,"11010",6327,3998,3928,112,70,"PP",501
3,"3057",174,138,136,0,2,"PP",31
12,"12102",518,424,417,4,7,"PP",91
15,"15009",10605,7245,7133,101,112,"PP",2159
46,"46228",2426,1819,1802,19,17,"PP",367
5,"5197",100,82,79,1,3,"PP",32
47,"47232",96,67,65,0,2,"PP",23
50,"50122",68,43,42,1,1,"PP",12
47,"47079",55,44,43,1,1,"PP",23
32,"32044",794,547,540,2,7,"PP",224
39,"39059",7518,5327,5287,23,40,"PP",1504
9,"9003",182,134,132,1,2,"PP",33
16,"16110",90,70,70,1,0,"PP",31
42,"42050",27,17,17,0,0,"PP",6
45,"45196",1382,1029,1005,7,24,"PP",231
4,"4036",239,178,176,0,2,"PP",59
45,"45090",370,262,261,2,1,"PP",63
28,"28057",1556,1155,1141,7,14,"PP",231
24,"24080",207,155,154,1,1,"PP",59
20,"20034",3200,2193,2180,8,13,"PP",54
44,"44124",71,57,57,0,0,"PP",9
44,"44189",44,35,35,0,0,"PP",11
28,"28075",6020,4521,4469,37,52,"PP",854
37,"37203",151,114,113,1,1,"PP",52
41,"41056",3687,2836,2779,37,57,"PP",252
16,"16086",872,699,690,7,9,"PP",270
6,"6081",1036,760,745,2,15,"PP",131
16,"16253",308,230,228,2,2,"PP",91
5,"5232",104,86,83,1,3,"PP",25
20,"20901",1399,960,957,3,3,"PP",27
45,"45099",3700,2524,2501,9,23,"PP",452
50,"50118",2101,1484,1477,17,7,"PP",321
47,"47049",91,58,58,0,0,"PP",21
24,"24040",416,293,292,2,1,"PP",79
50,"50017",1773,1283,1265,13,18,"PP",241
37,"37238",105,83,80,0,3,"PP",21
9,"9054",89,65,63,4,2,"PP",29
41,"41102",14773,10377,10028,174,349,"PP",1429
16,"16125",1607,1166,1150,11,16,"PP",311
27,"27015",3995,2518,2460,25,58,"PP",1117
50,"50293",392,257,255,2,2,"PP",43
41,"41057",258,174,170,3,4,"PP",45
22,"22214",117,92,89,0,3,"PP",43
50,"50042",19,17,17,1,0,"PP",10
40,"40112",2813,2126,2087,26,39,"PP",633
18,"18050",1649,1113,1095,5,18,"PP",209
19,"19113",454,327,322,4,5,"PP",68
22,"22117",2384,1606,1596,18,10,"PP",494
19,"19332",85,59,57,4,2,"PP",16
18,"18020",489,318,310,2,8,"PP",63
27,"27024",1447,1048,1032,6,16,"PP",523
47,"47068",29,21,21,0,0,"PP",12
26,"26068",78,61,61,0,0,"PP",17
19,"19159",87,73,72,1,1,"PP",29
9,"9181",276,194,191,7,3,"PP",91
12,"12139",299,202,200,3,2,"PP",60
5,"5115",509,350,344,0,6,"PP",161
28,"28126",50,36,36,0,0,"PP",9
2,"2068",323,239,239,3,0,"PP",42
11,"11001",4360,2810,2744,32,66,"PP",393
32,"32070",495,247,238,4,9,"PP",107
46,"46133",462,359,352,1,7,"PP",86
19,"19291",1143,803,794,2,9,"PP",206
13,"13096",7526,5212,5131,25,81,"PP",1478
21,"21078",2641,1718,1670,10,48,"PP",219
16,"16194",219,169,161,0,8,"PP",19
44,"44193",73,60,60,1,0,"PP",17
26,"26048",21,21,21,0,0,"PP",11
26,"26049",156,120,115,0,5,"PP",52
37,"37011",100,78,78,3,0,"PP",29
16,"16128",50,38,38,0,0,"PP",22
26,"26086",15,15,15,0,0,"PP",12
9,"9167",53,36,36,0,0,"PP",18
18,"18053",1554,1001,985,9,16,"PP",163
36,"36034",3299,2155,2132,15,23,"PP",753
22,"22051",90,72,72,2,0,"PP",25
47,"47127",138,89,88,2,1,"PP",34
3,"3053",7568,5551,5468,40,83,"PP",1415
28,"28107",442,316,310,5,6,"PP",58
49,"49257",305,186,184,0,2,"PP",58
24,"24190",146,103,103,2,0,"PP",46
50,"50214",18,18,14,1,4,"PP",7
9,"9012",93,70,68,0,2,"PP",24
2,"2051",1654,1115,1101,13,14,"PP",432
22,"22074",303,209,208,5,1,"PP",62
19,"19003",36,30,30,0,0,"PP",4
45,"45068",179,129,127,0,2,"PP",19
28,"28118",61,52,50,0,2,"PP",15
10,"10901",1161,758,753,1,5,"PP",190
10,"10118",278,232,231,1,1,"PP",55
49,"49259",79,59,59,0,0,"PP",32
9,"9194",1970,1376,1359,15,17,"PP",456
41,"41097",3131,2197,2140,13,57,"PP",300
45,"45049",419,303,295,1,8,"PP",96
24,"24110",1158,784,773,1,11,"PP",169
16,"16123",66,42,41,0,1,"PP",8
26,"26112",218,152,148,1,4,"PP",68
24,"24076",1283,926,913,10,13,"PP",193
28,"28030",1832,1319,1297,13,22,"PP",268
22,"22105",102,65,65,0,0,"PP",13
37,"37102",375,260,260,4,0,"PP",82
24,"24016",488,244,243,0,1,"PP",83
24,"24067",602,327,324,6,3,"PP",126
12,"12142",142,113,113,0,0,"PP",44
44,"44176",152,114,113,1,1,"PP",30
5,"5089",455,342,324,0,18,"PP",132
19,"19208",39,32,32,0,0,"PP",8
43,"43115",128,106,106,0,0,"PP",2
47,"47141",112,90,89,0,1,"PP",54
18,"18154",982,668,668,4,0,"PP",198
44,"44206",100,73,73,3,0,"PP",12
15,"15019",25981,15866,15672,207,194,"PP",4411
49,"49272",73,49,46,2,3,"PP",23
37,"37014",1140,747,737,7,10,"PP",245
40,"40121",249,188,178,1,10,"PP",85
14,"14010",3992,2786,2723,14,63,"PP",557
9,"9337",113,80,77,2,3,"PP",18
16,"16133",4399,3317,3256,34,61,"PP",845
29,"29099",969,688,669,11,19,"PP",119
6,"6093",4325,3176,3073,26,103,"PP",745
3,"3010",332,275,268,1,7,"PP",69
38,"38014",1342,943,930,6,13,"PP",154
24,"24171",337,136,134,4,2,"PP",35
34,"34103",96,79,76,0,3,"PP",35
19,"19210",18,16,16,0,0,"PP",11
44,"44149",99,74,73,4,1,"PP",13
19,"19007",433,316,310,1,6,"PP",120
45,"45133",2798,1957,1922,11,35,"PP",499
1,"1061",155,116,116,1,0,"PP",1
22,"22019",176,128,126,1,2,"PP",39
28,"28181",20801,16353,16243,97,110,"PP",5560
37,"37273",85,58,58,2,0,"PP",41
40,"40100",262,208,204,4,4,"PP",81
18,"18103",714,500,498,3,2,"PP",114
45,"45122",5605,4321,4288,33,33,"PP",1167
28,"28136",693,538,533,2,5,"PP",117
19,"19148",42,29,28,1,1,"PP",10
16,"16074",30,25,25,0,0,"PP",11
44,"44092",70,53,52,0,1,"PP",17
5,"5188",39,33,33,0,0,"PP",11
40,"40206",162,126,123,0,3,"PP",47
43,"43067",526,426,424,3,2,"PP",8
34,"34071",158,128,128,2,0,"PP",63
39,"39096",669,451,450,1,1,"PP",146
15,"15084",3039,2002,1981,12,21,"PP",1109
9,"9281",136,97,97,2,0,"PP",27
10,"10131",12803,8477,8347,77,130,"PP",2339
19,"19044",275,186,182,0,4,"PP",101
50,"50227",107,62,62,1,0,"PP",21
24,"24100",737,506,502,9,4,"PP",162
22,"22225",2606,1638,1612,20,26,"PP",523
29,"29073",1657,1082,1069,15,13,"PP",152
36,"36050",7645,5137,5049,48,88,"PP",1384
9,"9283",39,25,24,1,1,"PP",12
20,"20031",185,113,112,3,1,"PP",0
28,"28048",514,386,384,4,2,"PP",66
10,"10010",2206,1308,1281,8,27,"PP",224
5,"5049",403,261,253,1,8,"PP",70
46,"46101",819,670,663,8,7,"PP",150
16,"16023",513,367,367,3,0,"PP",81
7,"7018",389,238,236,1,2,"PP",49
19,"19270",14,13,13,0,0,"PP",7
37,"37310",166,116,115,3,1,"PP",31
44,"44180",74,56,56,0,0,"PP",23
45,"45186",2943,2142,2121,12,21,"PP",536
50,"50219",4283,3034,2990,30,44,"PP",515
41,"41901",2692,2101,2051,47,50,"PP",133
34,"34169",371,263,259,5,4,"PP",126
22,"22142",94,72,70,0,2,"PP",36
5,"5033",169,135,134,0,1,"PP",76
24,"24070",3886,2677,2625,18,52,"PP",535
16,"16234",23,17,17,0,0,"PP",2
40,"40119",166,133,132,2,1,"PP",54
42,"42195",86,51,51,2,0,"PP",22
14,"14050",2350,1774,1720,20,54,"PP",381
26,"26060",78,51,50,2,1,"PP",26
4,"4101",4356,2818,2768,32,50,"PP",539
39,"39098",1381,1088,1080,5,8,"PP",337
40,"40210",97,69,69,1,0,"PP",30
47,"47187",71,49,49,0,0,"PP",23
47,"47047",199,136,135,4,1,"PP",60
28,"28122",578,404,401,1,3,"PP",75
15,"15035",11189,7256,7165,104,91,"PP",1607
10,"10135",1240,834,826,3,8,"PP",320
39,"39033",536,375,372,1,3,"PP",74
34,"34141",176,149,146,0,3,"PP",62
2,"2061",605,464,458,3,6,"PP",182
14,"14072",983,692,680,6,12,"PP",98
26,"26100",54,43,43,0,0,"PP",8
2,"2005",554,426,419,8,7,"PP",142
28,"28051",1644,1231,1220,9,11,"PP",277
44,"44033",243,165,165,3,0,"PP",46
9,"9350",421,316,311,5,5,"PP",143
12,"12091",171,110,108,4,2,"PP",45
37,"37365",162,125,121,0,4,"PP",68
43,"43076",454,336,335,1,1,"PP",4
45,"45128",2569,1676,1652,6,24,"PP",394
47,"47022",59,52,48,1,4,"PP",26
21,"21008",2604,1663,1626,10,37,"PP",208
38,"38019",13884,7888,7809,49,79,"PP",1414
37,"37219",169,88,85,1,3,"PP",30
10,"10015",630,429,424,1,5,"PP",113
24,"24178",60,54,54,1,0,"PP",28
16,"16103",235,183,181,2,2,"PP",73
18,"18065",588,464,451,2,13,"PP",34
36,"36024",16335,11431,11256,99,175,"PP",5223
10,"10056",533,377,371,2,6,"PP",102
19,"19087",17,16,16,0,0,"PP",2
46,"46031",10574,7233,7158,58,75,"PP",1234
42,"42031",25,17,17,1,0,"PP",11
11,"11011",1726,1124,1084,8,40,"PP",210
22,"22125",39530,27358,27075,344,283,"PP",6676
16,"16902",124,86,86,1,0,"PP",21
24,"24015",2193,1532,1500,12,32,"PP",542
22,"22164",42,28,28,0,0,"PP",14
28,"28902",521,394,389,3,5,"PP",115
21,"21013",10626,6990,6807,99,183,"PP",1188
26,"26155",145,120,119,0,1,"PP",46
48,"48057",5730,4126,4115,14,11,"PP",49
3,"3027",167,142,138,1,4,"PP",36
43,"43163",26162,17276,17128,98,148,"PP",1420
29,"29031",1555,1015,986,6,29,"PP",99
6,"6016",2937,2042,1978,12,64,"PP",456
1,"1020",323,228,224,1,4,"PP",23
28,"28055",944,636,627,4,9,"PP",166
50,"50233",96,78,78,0,0,"PP",30
49,"49123",519,384,383,4,1,"PP",126
22,"22221",92,56,55,0,1,"PP",14
16,"16031",35,26,26,0,0,"PP",7
46,"46242",326,260,257,3,3,"PP",115
4,"4021",179,132,129,2,3,"PP",49
22,"22122",69,52,50,2,2,"PP",8
49,"49100",281,164,157,2,7,"PP",61
3,"3134",139,107,107,0,0,"PP",31
45,"45009",455,277,274,2,3,"PP",105
37,"37129",248,181,181,1,0,"PP",53
49,"49171",603,433,427,4,6,"PP",166
18,"18101",9449,6688,6568,77,120,"PP",1424
14,"14020",336,227,225,0,2,"PP",42
42,"42193",14,7,7,0,0,"PP",6
46,"46038",302,221,220,1,1,"PP",66
39,"39047",1998,1408,1392,8,16,"PP",346
44,"44187",193,147,146,0,1,"PP",60
28,"28056",946,664,660,2,4,"PP",144
37,"37130",173,135,134,2,1,"PP",77
40,"40228",493,362,361,3,1,"PP",174
2,"2033",1864,1352,1315,12,37,"PP",421
7,"7055",8062,4546,4492,40,54,"PP",1339
47,"47032",147,102,102,0,0,"PP",31
5,"5043",73,58,58,0,0,"PP",23
27,"27019",8188,5478,5395,88,83,"PP",1660
16,"16016",217,157,157,1,0,"PP",40
26,"26103",814,617,603,10,14,"PP",242
18,"18173",8999,5958,5871,50,87,"PP",1002
2,"2046",1125,892,870,12,22,"PP",311
21,"21007",6379,4268,4178,66,90,"PP",640
43,"43134",281,217,215,5,2,"PP",6
5,"5254",184,149,147,1,2,"PP",69
40,"40177",139,106,105,0,1,"PP",50
15,"15083",1029,627,614,5,13,"PP",344
46,"46191",1956,1439,1414,8,25,"PP",375
18,"18102",8233,5424,5266,46,158,"PP",895
34,"34032",38,30,30,0,0,"PP",13
50,"50161",98,75,74,2,1,"PP",29
19,"19123",37,30,28,0,2,"PP",7
10,"10063",159,130,130,0,0,"PP",42
6,"6111",487,318,314,2,4,"PP",56
10,"10105",2442,1541,1515,11,26,"PP",446
3,"3106",559,469,465,3,4,"PP",165
29,"29083",2063,1471,1444,14,27,"PP",379
44,"44103",122,96,96,3,0,"PP",24
9,"9195",57,40,40,0,0,"PP",11
30,"30007",6474,4354,4317,26,37,"PP",1130
5,"5256",110,88,86,1,2,"PP",24
46,"46154",795,619,608,5,11,"PP",173
9,"9037",105,94,93,0,1,"PP",15
39,"39050",260,164,164,1,0,"PP",67
19,"19251",39,30,30,0,0,"PP",16
9,"9139",98,79,79,2,0,"PP",23
7,"7029",4393,2888,2855,37,33,"PP",581
9,"9307",102,76,74,1,2,"PP",23
11,"11003",1230,802,787,9,15,"PP",202
28,"28059",4516,3343,3299,30,44,"PP",819
46,"46177",4832,3592,3539,20,53,"PP",635
29,"29010",1637,1263,1187,2,76,"PP",189
22,"22103",664,489,489,4,0,"PP",96
19,"19138",215,158,154,4,4,"PP",29
21,"21032",1827,1337,1314,13,23,"PP",229
45,"45035",286,206,204,2,2,"PP",42
16,"16020",9,5,5,1,0,"PP",3
21,"21053",3306,2161,2106,11,55,"PP",435
46,"46092",262,176,174,2,2,"PP",63
3,"3116",1155,819,805,5,14,"PP",235
44,"44102",26,19,19,0,0,"PP",8
26,"26111",250,191,187,3,4,"PP",37
44,"44075",321,255,252,1,3,"PP",87
35,"35034",8392,3946,3908,27,38,"PP",705
40,"40006",22,19,19,0,0,"PP",7
9,"9024",150,100,99,1,1,"PP",41
45,"45053",7820,5814,5712,56,102,"PP",1465
9,"9198",100,75,74,2,1,"PP",18
46,"46179",2136,1624,1596,17,28,"PP",404
49,"49130",155,116,112,1,4,"PP",45
24,"24043",116,54,52,0,2,"PP",8
44,"44211",33,22,22,0,0,"PP",2
34,"34110",75,64,64,0,0,"PP",19
47,"47220",151,106,105,1,1,"PP",57
47,"47041",147,105,103,3,2,"PP",41
39,"39052",19005,13859,13748,83,111,"PP",3592
47,"47137",29,25,25,0,0,"PP",12
50,"50164",381,245,243,3,2,"PP",48
9,"9199",91,68,68,0,0,"PP",28
44,"44042",114,82,81,0,1,"PP",26
12,"12074",756,611,601,3,10,"PP",174
37,"37001",165,120,120,0,0,"PP",53
50,"50263",171,110,108,1,2,"PP",20
24,"24177",467,265,263,2,2,"PP",98
4,"4055",361,298,290,3,8,"PP",73
13,"13098",1946,1404,1361,13,43,"PP",433
46,"46111",11367,7995,7908,66,87,"PP",1613
37,"37231",236,185,183,5,2,"PP",64
40,"40040",2489,1766,1744,26,22,"PP",649
11,"11037",5656,4374,4273,24,101,"PP",298
42,"42064",83,65,65,1,0,"PP",19
50,"50190",669,532,518,10,14,"PP",124
10,"10111",1297,888,872,11,16,"PP",254
3,"3082",12941,8399,8304,51,95,"PP",1975
34,"34130",195,154,153,5,1,"PP",61
28,"28033",4177,2972,2936,20,36,"PP",698
44,"44043",86,60,60,0,0,"PP",21
22,"22158",11994,8115,8049,79,66,"PP",2084
9,"9455",45,34,33,0,1,"PP",8
43,"43034",465,365,365,5,0,"PP",15
46,"46263",235,182,180,2,2,"PP",34
48,"48032",5762,4287,4262,14,25,"PP",214
13,"13077",3383,2050,1997,20,53,"PP",476
47,"47013",91,77,77,1,0,"PP",26
47,"47105",169,138,137,2,1,"PP",52
50,"50289",53,42,42,1,0,"PP",14
26,"26115",23,22,21,3,1,"PP",10
2,"2009",19495,13877,13663,134,214,"PP",3579
44,"44088",24,23,23,0,0,"PP",11
3,"3094",9795,6528,6481,37,47,"PP",1733
18,"18903",852,544,537,9,7,"PP",100
46,"46075",144,125,122,2,3,"PP",25
2,"2075",1700,1357,1347,6,10,"PP",468
37,"37200",190,132,131,0,1,"PP",41
26,"26104",10,9,9,1,0,"PP",3
9,"9032",103,62,62,3,0,"PP",10
9,"9483",189,156,155,2,1,"PP",49
28,"28141",6284,4617,4570,42,47,"PP",1105
22,"22133",108,71,71,3,0,"PP",15
46,"46022",15392,10624,10546,69,78,"PP",2132
28,"28035",1404,981,966,4,15,"PP",217
19,"19289",23,16,16,0,0,"PP",4
39,"39056",2262,1683,1671,14,12,"PP",396
37,"37234",314,194,192,3,2,"PP",69
16,"16158",513,371,366,5,5,"PP",126
37,"37035",162,115,115,1,0,"PP",49
26,"26118",71,54,53,1,1,"PP",20
37,"37359",165,105,103,0,2,"PP",57
22,"22035",225,153,152,1,1,"PP",24
48,"48003",14518,10375,10310,49,65,"PP",348
3,"3115",255,213,213,3,0,"PP",58
13,"13013",7056,5041,4945,52,96,"PP",1495
10,"10033",397,269,268,0,1,"PP",102
18,"18913",771,530,514,2,16,"PP",182
2,"2022",341,243,243,2,0,"PP",104
26,"26106",79,67,67,0,0,"PP",23
12,"12119",139,97,94,3,3,"PP",42
49,"49016",230,155,155,0,0,"PP",53
16,"16134",4368,3143,3102,22,41,"PP",819
19,"19065",109,86,85,1,1,"PP",27
26,"26039",40,31,31,0,0,"PP",9
32,"32078",1099,715,707,4,8,"PP",424
23,"23064",1669,1311,1296,9,15,"PP",337
18,"18170",317,212,209,0,3,"PP",30
40,"40003",116,82,79,3,3,"PP",51
49,"49162",170,117,116,1,1,"PP",48
47,"47153",101,69,69,1,0,"PP",34
50,"50008",5187,3334,3288,37,46,"PP",496
24,"24004",495,387,384,10,3,"PP",157
47,"47017",190,146,146,0,0,"PP",81
19,"19260",38,27,27,1,0,"PP",6
48,"48060",3625,2429,2418,12,11,"PP",43
34,"34047",1711,1275,1248,18,27,"PP",604
44,"44047",225,103,103,0,0,"PP",29
50,"50292",130,108,107,0,1,"PP",39
42,"42211",84,67,67,0,0,"PP",25
40,"40144",16,15,15,0,0,"PP",7
47,"47144",72,54,53,2,1,"PP",16
34,"34186",49,44,44,0,0,"PP",19
47,"47174",271,215,213,4,2,"PP",61
26,"26122",115,81,80,4,1,"PP",24
22,"22177",96,69,68,0,1,"PP",20
6,"6128",4457,2996,2934,28,62,"PP",685
34,"34189",53,33,33,0,0,"PP",23
2,"2058",300,186,177,1,9,"PP",48
46,"46139",4520,3486,3457,18,29,"PP",953
18,"18083",232,181,179,1,2,"PP",47
48,"48005",116,80,79,0,1,"PP",0
46,"46048",3504,2609,2576,17,33,"PP",526
24,"24124",338,196,195,2,1,"PP",68
27,"27046",1444,945,921,7,24,"PP",334
19,"19171",5380,3964,3919,22,45,"PP",570
46,"46162",1168,839,832,3,7,"PP",185
26,"26010",85,66,63,1,3,"PP",28
24,"24201",1029,683,676,9,7,"PP",187
49,"49041",409,287,282,1,5,"PP",73
50,"50195",53,42,38,0,4,"PP",16
3,"3119",17253,12346,12258,81,88,"PP",3100
16,"16049",137,98,98,2,0,"PP",32
49,"49083",47,37,37,1,0,"PP",26
18,"18914",1660,1255,1227,11,28,"PP",150
38,"38007",1619,1053,1043,3,10,"PP",348
37,"37199",128,92,92,2,0,"PP",20
23,"23076",774,606,595,6,11,"PP",129
18,"18002",529,387,384,1,3,"PP",66
50,"50294",65,45,45,0,0,"PP",23
48,"48081",1903,1455,1447,7,8,"PP",46
16,"16089",381,292,289,8,3,"PP",81
9,"9269",29,24,23,0,1,"PP",15
49,"49267",96,67,63,2,4,"PP",34
5,"5128",339,258,253,5,5,"PP",46
48,"48064",608,461,461,0,0,"PP",3
18,"18107",920,643,626,1,17,"PP",115
3,"3110",312,258,258,0,0,"PP",59
9,"9365",26,17,17,0,0,"PP",4
18,"18183",623,380,376,0,4,"PP",76
23,"23091",675,516,512,1,4,"PP",159
20,"20054",461,294,294,1,0,"PP",0
19,"19108",95,78,78,0,0,"PP",17
2,"2028",111,81,81,0,0,"PP",22
12,"12001",1028,783,768,6,15,"PP",223
47,"47148",419,332,324,3,8,"PP",122
42,"42080",153,108,108,1,0,"PP",45
9,"9059",136870,99937,98641,1416,1296,"PP",30504
5,"5260",95,73,73,0,0,"PP",32
42,"42063",45,31,30,1,1,"PP",12
34,"34005",786,601,593,3,8,"PP",212
46,"46096",263,204,202,0,2,"PP",31
49,"49268",364,266,263,3,3,"PP",142
44,"44116",75,58,58,0,0,"PP",13
37,"37208",71,49,49,0,0,"PP",26
34,"34199",1150,767,754,14,13,"PP",232
39,"39035",9142,6574,6517,24,57,"PP",1691
36,"36014",1867,1265,1243,16,22,"PP",615
12,"12002",114,96,94,1,2,"PP",10
47,"47211",48,37,37,1,0,"PP",18
34,"34055",254,185,184,3,1,"PP",80
50,"50020",795,548,545,4,3,"PP",110
9,"9060",126,104,104,2,0,"PP",56
5,"5261",32,25,25,0,0,"PP",17
24,"24130",415,291,289,2,2,"PP",100
49,"49087",476,246,244,0,2,"PP",137
50,"50291",95,76,76,0,0,"PP",35
42,"42115",89,68,66,0,2,"PP",32
6,"6030",168,131,128,1,3,"PP",47
23,"23046",2334,1880,1855,9,25,"PP",291
37,"37069",981,669,657,3,12,"PP",218
40,"40074",246,193,189,2,4,"PP",82
47,"47170",43,36,30,0,6,"PP",7
5,"5056",91,71,70,0,1,"PP",27
9,"9441",94,76,76,0,0,"PP",38
32,"32054",86117,56997,56376,581,621,"PP",17723
21,"21040",3193,2219,2123,32,96,"PP",415
29,"29089",3138,2262,2186,13,76,"PP",199
45,"45106",7418,5380,5306,34,74,"PP",1623
4,"4010",587,421,409,5,12,"PP",95
47,"47044",323,273,270,4,3,"PP",73
9,"9016",85,54,54,0,0,"PP",17
24,"24207",276,215,215,2,0,"PP",69
50,"50199",318,206,201,1,5,"PP",32
16,"16132",33,25,25,1,0,"PP",4
40,"40086",656,513,496,7,17,"PP",162
3,"3065",169894,121210,120342,1045,868,"PP",29394
45,"45071",1779,1374,1342,7,32,"PP",322
19,"19300",782,591,588,5,3,"PP",138
40,"40054",108,79,78,3,1,"PP",25
41,"41007",12488,7657,7421,126,236,"PP",857
9,"9225",80,55,55,0,0,"PP",22
50,"50098",162,119,118,1,1,"PP",36
36,"36017",17364,11771,11598,123,173,"PP",4481
4,"4081",351,264,263,0,1,"PP",29
34,"34904",300,188,186,0,2,"PP",58
26,"26131",34,33,33,0,0,"PP",22
12,"12135",36287,25912,25655,184,257,"PP",5465
26,"26006",1833,1358,1335,7,23,"PP",485
49,"49091",246,168,167,1,1,"PP",61
9,"9065",136,112,111,0,1,"PP",47
49,"49064",478,297,296,6,1,"PP",111
21,"21023",2033,1215,1193,10,22,"PP",193
37,"37140",630,395,393,0,2,"PP",161
10,"10043",746,525,520,4,5,"PP",108
49,"49273",165,90,90,0,0,"PP",48
37,"37257",51,36,36,1,0,"PP",19
42,"42154",103,76,76,1,0,"PP",25
44,"44158",1153,879,872,6,7,"PP",167
49,"49028",108,90,89,1,1,"PP",53
1,"1055",839,557,552,11,5,"PP",74
26,"26121",30,19,19,0,0,"PP",5
44,"44028",171,136,136,0,0,"PP",53
43,"43160",1324,967,956,6,11,"PP",53
50,"50177",288,196,193,0,3,"PP",72
24,"24136",495,347,344,1,3,"PP",144
34,"34155",122,95,95,0,0,"PP",31
45,"45074",397,300,293,2,7,"PP",121
36,"36019",1462,916,908,8,8,"PP",225
47,"47058",199,126,125,3,1,"PP",41
4,"4084",337,238,232,0,6,"PP",81
24,"24212",983,693,684,10,9,"PP",224
12,"12061",374,263,261,4,2,"PP",54
34,"34156",51,42,42,0,0,"PP",31
7,"7050",3513,2036,2013,25,23,"PP",907
16,"16060",715,519,513,3,6,"PP",173
44,"44150",28,17,17,0,0,"PP",6
49,"49201",283,232,228,3,4,"PP",46
20,"20062",941,688,683,1,5,"PP",15
5,"5082",491,379,369,2,10,"PP",140
44,"44059",562,411,407,2,4,"PP",146
9,"9177",1140,790,780,7,10,"PP",250
47,"47059",94,64,64,0,0,"PP",20
18,"18126",1436,1024,1002,9,22,"PP",103
48,"48015",33077,22441,22295,145,146,"PP",1810
12,"12034",1389,1022,1002,5,20,"PP",218
24,"24175",1821,1316,1305,15,11,"PP",354
9,"9326",156,111,110,1,1,"PP",22
29,"29048",1364,1053,1039,8,14,"PP",86
39,"39004",1479,1050,1031,5,19,"PP",237
6,"6085",3429,2439,2382,21,57,"PP",393
3,"3033",101,82,78,0,4,"PP",19
46,"46117",493,386,380,2,6,"PP",99
45,"45023",2300,1700,1685,19,15,"PP",351
19,"19284",10,10,10,0,0,"PP",0
26,"26099",1220,956,931,7,25,"PP",339
24,"24042",60,47,47,2,0,"PP",21
50,"50278",175,133,131,2,2,"PP",37
28,"28040",16741,10717,10604,79,113,"PP",1818
36,"36052",7266,4772,4685,43,87,"PP",1821
29,"29904",418,328,322,1,6,"PP",17
37,"37186",94,68,68,0,0,"PP",32
34,"34214",176,121,120,1,1,"PP",34
34,"34159",375,221,214,4,7,"PP",64
46,"46080",979,720,712,2,8,"PP",199
23,"23017",1498,1153,1129,11,24,"PP",263
44,"44050",3113,2173,2154,14,19,"PP",489
27,"27058",3283,2275,2241,12,34,"PP",1158
9,"9348",131,103,101,0,2,"PP",46
18,"18033",279,179,174,0,5,"PP",34
24,"24143",497,344,343,3,1,"PP",78
9,"9406",239,165,162,2,3,"PP",42
30,"30025",5016,3663,3623,22,40,"PP",760
16,"16063",112,81,81,1,0,"PP",32
19,"19118",11,10,9,0,1,"PP",0
13,"13037",776,573,563,2,10,"PP",201
43,"43024",1545,1019,1014,14,5,"PP",78
32,"32015",817,454,452,2,2,"PP",259
50,"50053",643,476,466,3,10,"PP",158
3,"3016",88,66,66,0,0,"PP",24
41,"41042",5872,4477,4424,42,53,"PP",554
24,"24068",430,289,281,0,8,"PP",56
15,"15088",3396,2047,2022,22,25,"PP",907
46,"46104",1906,1422,1409,5,13,"PP",349
49,"49168",89,68,68,0,0,"PP",30
44,"44154",240,164,161,1,3,"PP",53
34,"34068",29,25,24,0,1,"PP",10
18,"18035",1179,882,870,7,12,"PP",294
37,"37158",230,149,149,1,0,"PP",50
21,"21069",1681,1073,1056,9,17,"PP",201
40,"40223",235,177,174,1,3,"PP",48
26,"26128",94,71,71,1,0,"PP",17
21,"21039",303,211,210,6,1,"PP",26
43,"43139",2007,1432,1419,9,13,"PP",61
40,"40094",353,265,263,3,2,"PP",84
49,"49133",287,206,203,1,3,"PP",74
12,"12117",3532,2512,2479,12,33,"PP",522
5,"5034",15,14,13,0,1,"PP",6
34,"34039",58,48,47,0,1,"PP",34
37,"37003",104,75,75,2,0,"PP",40
49,"49111",119,84,84,3,0,"PP",40
41,"41052",3032,2162,2092,6,70,"PP",224
42,"42192",36,22,22,2,0,"PP",6
49,"49062",103,58,58,0,0,"PP",26
32,"32091",1695,1163,1156,2,7,"PP",524
42,"42176",27,21,21,0,0,"PP",12
14,"14019",6380,4933,4831,71,102,"PP",781
48,"48076",288,211,211,1,0,"PP",4
48,"48011",9640,6753,6722,41,31,"PP",359
40,"40062",56,43,42,0,1,"PP",19
48,"48020",272771,184893,183922,1227,971,"PP",22104
32,"32030",945,642,641,8,1,"PP",161
3,"3046",1636,1073,1061,7,12,"PP",295
44,"44064",62,46,46,0,0,"PP",17
50,"50281",68,52,50,0,2,"PP",26
47,"47004",1135,878,872,5,6,"PP",220
5,"5156",242,145,145,1,0,"PP",49
46,"46061",351,276,272,6,4,"PP",60
5,"5186",1564,1140,1125,5,15,"PP",469
10,"10182",122,81,81,0,0,"PP",20
32,"32031",997,684,680,5,4,"PP",378
30,"30029",12122,8231,8125,54,106,"PP",1997
19,"19156",917,686,679,2,7,"PP",199
3,"3019",15501,11261,11106,86,155,"PP",2704
47,"47066",1482,1096,1086,14,10,"PP",298
21,"21072",10233,7374,7183,116,191,"PP",1493
34,"34121",187,150,150,3,0,"PP",71
47,"47215",48,43,43,0,0,"PP",25
5,"5157",227,146,146,3,0,"PP",49
40,"40131",51,45,45,0,0,"PP",16
42,"42043",3816,2602,2540,23,62,"PP",915
49,"49150",123,95,92,3,3,"PP",42
16,"16217",91,72,72,0,0,"PP",24
45,"45109",2791,2123,2072,20,51,"PP",692
16,"16159",198,135,135,2,0,"PP",59
42,"42119",141,78,78,1,0,"PP",47
3,"3030",559,442,433,2,9,"PP",76
23,"23038",3786,2934,2900,21,34,"PP",725
19,"19033",47,38,37,1,1,"PP",11
40,"40229",26,22,22,0,0,"PP",8
42,"42045",273,175,174,4,1,"PP",64
47,"47163",277,208,205,3,3,"PP",49
27,"27065",12055,7566,7379,119,187,"PP",2976
49,"49210",447,350,348,3,2,"PP",84
50,"50185",140,93,92,1,1,"PP",15
5,"5059",92,49,48,0,1,"PP",11
3,"3021",5573,4423,4343,23,80,"PP",1206
18,"18039",3343,2293,2252,22,41,"PP",434
30,"30006",833,699,695,1,4,"PP",281
3,"3049",12103,8872,8785,57,87,"PP",2489
47,"47133",2776,2096,2073,28,23,"PP",456
13,"13001",1188,865,858,4,7,"PP",237
37,"37163",34,24,24,0,0,"PP",7
19,"19221",31,22,22,1,0,"PP",10
12,"12071",1272,936,925,3,11,"PP",314
23,"23002",17427,12837,12542,126,295,"PP",2964
22,"22203",77,62,62,2,0,"PP",23
40,"40035",135,110,110,2,0,"PP",32
37,"37382",162,127,124,0,3,"PP",58
34,"34174",172,142,136,0,6,"PP",86
19,"19161",212,158,157,3,1,"PP",30
16,"16035",224,177,174,2,3,"PP",34
44,"44131",26,22,22,0,0,"PP",4
16,"16073",190,153,153,1,0,"PP",37
50,"50110",340,248,238,1,10,"PP",70
9,"9416",52,30,30,0,0,"PP",6
26,"26034",606,457,440,5,17,"PP",147
13,"13079",12233,8274,8138,93,136,"PP",2083
29,"29075",12886,8292,8191,63,101,"PP",2243
21,"21015",645,361,356,8,5,"PP",38
5,"5027",258,209,203,5,6,"PP",79
37,"37239",203,175,174,2,1,"PP",65
46,"46102",19696,14700,14579,125,121,"PP",2497
4,"4064",2878,1937,1924,16,13,"PP",602
6,"6070",7668,5404,5228,59,176,"PP",1121
36,"36901",4154,3094,3029,21,65,"PP",658
50,"50229",65,46,46,1,0,"PP",8
47,"47010",14718,11521,11392,137,129,"PP",2843
40,"40028",103,88,87,2,1,"PP",45
27,"27902",7122,4472,4385,43,87,"PP",1474
41,"41094",6496,4733,4628,47,105,"PP",777
37,"37259",39,28,28,1,0,"PP",17
6,"6116",1500,1015,998,7,17,"PP",242
40,"40233",399,279,273,0,6,"PP",103
9,"9141",617,463,456,5,7,"PP",143
10,"10095",317,245,239,0,6,"PP",43
49,"49057",107,74,71,0,3,"PP",35
19,"19319",4609,3303,3273,22,30,"PP",541
9,"9253",101,77,76,0,1,"PP",25
2,"2049",778,506,496,1,10,"PP",113
46,"46065",1584,1199,1183,11,16,"PP",227
38,"38051",7328,5017,4969,32,48,"PP",1024
42,"42110",54,43,43,0,0,"PP",19
39,"39081",440,330,327,1,3,"PP",158
44,"44071",585,419,418,6,1,"PP",96
19,"19127",88,60,60,1,0,"PP",38
23,"23043",517,360,360,1,0,"PP",113
30,"30002",9701,6794,6717,27,77,"PP",1775
32,"32039",1154,801,790,11,11,"PP",337
36,"36001",2397,1674,1651,6,23,"PP",722
21,"21079",678,428,417,2,11,"PP",85
10,"10069",786,566,554,3,12,"PP",159
37,"37067",3278,2568,2529,30,39,"PP",725
30,"30034",1067,818,801,8,17,"PP",260
34,"34082",78,59,58,0,1,"PP",17
26,"26114",72,61,61,0,0,"PP",26
45,"45202",3963,2806,2771,10,35,"PP",794
22,"22207",121,66,65,0,1,"PP",11
47,"47169",62,52,52,0,0,"PP",35
40,"40106",179,140,139,2,1,"PP",55
6,"6074",4720,3355,3271,24,84,"PP",906
26,"26026",1268,986,970,4,16,"PP",402
22,"22029",118,85,83,1,2,"PP",23
42,"42204",53,37,35,1,2,"PP",11
5,"5164",18,12,12,0,0,"PP",9
10,"10070",667,493,489,1,4,"PP",193
1,"1004",1357,952,945,5,7,"PP",84
10,"10099",563,369,358,3,11,"PP",86
5,"5100",260,193,192,3,1,"PP",59
36,"36015",4079,2653,2606,29,47,"PP",823
9,"9149",36,29,29,0,0,"PP",12
49,"49146",265,183,181,4,2,"PP",74
7,"7013",7353,4725,4639,43,86,"PP",1702
9,"9372",204,175,169,2,6,"PP",52
40,"40129",159,119,117,2,2,"PP",47
47,"47191",111,81,81,0,0,"PP",26
46,"46181",16967,11951,11835,98,116,"PP",2572
49,"49147",250,164,162,1,2,"PP",51
9,"9133",38,33,33,0,0,"PP",5
5,"5229",75,61,61,1,0,"PP",24
40,"40204",145,102,101,0,1,"PP",49
19,"19257",3279,2233,2206,21,27,"PP",807
49,"49077",157,80,80,0,0,"PP",44
13,"13011",4439,2762,2694,16,68,"PP",620
41,"41081",30061,21488,21059,331,429,"PP",2029
28,"28173",523,384,381,1,3,"PP",82
15,"15071",7780,4937,4848,34,89,"PP",1587
19,"19323",36,26,26,0,0,"PP",4
49,"49225",122,68,68,0,0,"PP",33
5,"5101",266,206,205,1,1,"PP",109
23,"23047",1558,1203,1186,8,17,"PP",248
42,"42070",31,23,23,1,0,"PP",5
24,"24014",7152,4494,4448,47,46,"PP",1233
28,"28005",136518,101397,100485,871,912,"PP",21374
44,"44076",2089,1577,1565,8,12,"PP",397
9,"9261",446,279,271,2,8,"PP",69
34,"34236",147,104,104,0,0,"PP",64
13,"13058",4026,2822,2766,29,56,"PP",840
19,"19032",145,94,93,2,1,"PP",17
5,"5102",1681,1252,1228,8,24,"PP",487
24,"24160",633,404,403,2,1,"PP",143
44,"44217",32,25,25,0,0,"PP",2
20,"20059",8892,6505,6490,18,15,"PP",140
43,"43072",90,69,67,1,2,"PP",7
9,"9155",25,23,23,0,0,"PP",11
32,"32057",505,334,328,3,6,"PP",94
3,"3086",169,140,140,2,0,"PP",25
40,"40110",316,237,234,4,3,"PP",72
44,"44080",281,202,199,0,3,"PP",45
23,"23073",4363,3214,3176,24,38,"PP",634
19,"19134",23,14,14,0,0,"PP",2
46,"46062",4552,3402,3362,27,40,"PP",900
50,"50267",565,380,375,4,5,"PP",93
4,"4902",45571,29423,29169,272,254,"PP",7982
50,"50040",82,66,66,1,0,"PP",25
15,"15042",2928,1879,1853,11,26,"PP",765
22,"22102",180,137,136,3,1,"PP",37
22,"22004",123,83,83,0,0,"PP",15
10,"10198",1053,897,889,4,8,"PP",417
10,"10077",626,444,441,5,3,"PP",107
24,"24162",1753,1259,1245,12,14,"PP",291
24,"24053",398,250,248,1,2,"PP",124
19,"19230",558,409,406,1,3,"PP",65
5,"5169",218,171,171,1,0,"PP",80
16,"16087",238,184,184,6,0,"PP",64
15,"15074",3902,2629,2589,23,40,"PP",1161
46,"46116",13606,10262,10200,87,62,"PP",2458
43,"43074",1818,1341,1336,2,5,"PP",58
37,"37038",756,531,517,4,14,"PP",204
9,"9325",177,103,101,2,2,"PP",50
42,"42075",78,50,50,1,0,"PP",29
16,"16204",237,179,177,1,2,"PP",40
5,"5200",41,26,26,0,0,"PP",18
26,"26163",126,104,104,1,0,"PP",35
49,"49008",423,263,259,1,4,"PP",76
19,"19136",11,10,10,0,0,"PP",4
19,"19200",66,53,52,0,1,"PP",8
4,"4004",405,282,272,2,10,"PP",56
6,"6038",785,561,550,5,11,"PP",119
47,"47081",39,32,32,0,0,"PP",8
1,"1013",710,469,465,2,4,"PP",33
30,"30040",686,564,560,1,4,"PP",229
24,"24187",834,559,549,11,10,"PP",211
43,"43902",2751,1794,1776,21,18,"PP",80
45,"45137",1541,1007,998,8,9,"PP",167
19,"19252",56,44,44,0,0,"PP",20
16,"16152",32,26,26,3,0,"PP",13
22,"22027",311,210,209,1,1,"PP",68
47,"47209",32,23,23,0,0,"PP",6
13,"13004",976,698,694,6,4,"PP",197
38,"38010",3969,2463,2418,11,45,"PP",471
22,"22139",80,57,57,1,0,"PP",30
50,"50068",1943,1299,1287,10,12,"PP",335
16,"16209",110,95,94,2,1,"PP",32
39,"39034",255,133,128,2,5,"PP",43
19,"19263",21,15,15,0,0,"PP",5
23,"23042",292,219,219,0,0,"PP",72
19,"19126",1701,1223,1207,6,16,"PP",253
47,"47177",104,78,78,0,0,"PP",29
48,"48092",872,614,608,3,6,"PP",16
45,"45175",603,476,473,1,3,"PP",190
28,"28010",10649,8167,8098,76,69,"PP",2122
41,"41031",1204,780,769,5,11,"PP",84
40,"40081",117,80,76,1,4,"PP",33
1,"1016",428,194,192,4,2,"PP",26
23,"23054",375,280,272,1,8,"PP",49
12,"12027",17506,11776,11649,84,127,"PP",2500
14,"14063",994,731,719,8,12,"PP",203
27,"27039",4467,3179,3121,47,58,"PP",1403
10,"10164",707,391,382,4,9,"PP",85
19,"19002",55,45,45,0,0,"PP",18
36,"36013",2216,1298,1290,18,8,"PP",549
15,"15016",4558,2747,2705,16,42,"PP",797
29,"29097",4160,2872,2800,56,72,"PP",419
39,"39007",386,265,264,0,1,"PP",59
20,"20905",160,123,123,2,0,"PP",0
34,"34201",171,131,130,1,1,"PP",63
10,"10165",252,204,201,3,3,"PP",85
37,"37116",70,50,50,0,0,"PP",25
46,"46120",1179,903,880,5,23,"PP",198
18,"18054",820,573,569,2,4,"PP",151
23,"23056",3052,2279,2207,26,72,"PP",364
49,"49234",394,282,277,0,5,"PP",108
18,"18152",928,663,660,3,3,"PP",71
10,"10085",310,219,219,1,0,"PP",60
43,"43905",15100,9689,9630,43,59,"PP",1209
4,"4008",466,374,371,3,3,"PP",125
2,"2063",1358,987,973,3,14,"PP",207
9,"9440",80,61,61,0,0,"PP",25
50,"50021",25,21,21,0,0,"PP",11
43,"43174",144,118,114,0,4,"PP",2
24,"24047",708,462,459,1,3,"PP",166
19,"19226",37,22,22,0,0,"PP",6
10,"10140",1109,778,769,7,9,"PP",207
38,"38021",1609,900,876,2,24,"PP",200
13,"13055",616,445,444,3,1,"PP",111
18,"18078",714,546,538,5,8,"PP",86
40,"40084",52,41,41,2,0,"PP",19
9,"9335",86,66,66,3,0,"PP",20
14,"14009",2653,1658,1631,24,27,"PP",350
18,"18056",3382,2397,2350,30,47,"PP",442
42,"42003",65,49,47,0,2,"PP",17
40,"40183",117,105,99,1,6,"PP",73
12,"12134",135,95,95,1,0,"PP",16
13,"13072",727,518,510,3,8,"PP",143
12,"12031",3960,2913,2869,13,44,"PP",593
16,"16171",1728,1334,1313,10,21,"PP",450
36,"36047",2248,1379,1363,11,16,"PP",622
5,"5010",142,102,100,2,2,"PP",41
29,"29070",43686,27672,27323,290,349,"PP",4867
19,"19238",43,30,28,0,2,"PP",9
47,"47181",165,136,135,1,1,"PP",42
15,"15081",976,713,695,4,18,"PP",430
28,"28087",3301,2539,2519,20,20,"PP",712
18,"18057",5584,4042,3958,51,84,"PP",714
28,"28183",1162,823,813,9,10,"PP",170
42,"42131",50,39,39,2,0,"PP",18
46,"46122",2726,1957,1934,13,23,"PP",384
3,"3038",330,260,254,3,6,"PP",69
42,"42086",33,19,19,1,0,"PP",12
37,"37339",295,219,219,5,0,"PP",98
7,"7048",18455,9929,9858,116,71,"PP",2049
37,"37120",98,78,76,0,2,"PP",31
36,"36059",4641,2844,2796,29,48,"PP",1259
50,"50201",449,345,344,4,1,"PP",77
28,"28046",4824,3726,3707,33,19,"PP",997
10,"10034",337,244,240,0,4,"PP",79
50,"50275",111,50,50,0,0,"PP",25
40,"40077",966,718,704,10,14,"PP",166
38,"38031",29301,20926,20701,157,225,"PP",5748
5,"5070",30,29,29,0,0,"PP",12
34,"34060",133,109,107,0,2,"PP",47
9,"9213",264,182,182,1,0,"PP",73
26,"26132",106,73,70,2,3,"PP",31
5,"5081",37,21,21,3,0,"PP",16
21,"21003",684,476,452,4,24,"PP",24
22,"22223",77,60,59,2,1,"PP",3
46,"46214",16637,12113,12014,84,99,"PP",2512
6,"6005",1694,1167,1139,9,28,"PP",172
19,"19240",49,36,36,0,0,"PP",7
35,"35002",24229,15311,15133,101,178,"PP",2698
18,"18158",7978,4861,4771,43,90,"PP",543
14,"14069",7340,5100,5000,69,100,"PP",1298
37,"37371",252,156,155,0,1,"PP",62
24,"24028",367,275,273,5,2,"PP",77
5,"5211",425,336,330,2,6,"PP",161
50,"50202",124,76,74,0,2,"PP",21
50,"50276",118,91,91,0,0,"PP",25
46,"46078",28484,19694,19520,173,174,"PP",3253
50,"50050",87,62,62,1,0,"PP",11
3,"3069",3329,2102,2077,11,25,"PP",592
24,"24174",457,294,289,3,5,"PP",101
46,"46010",943,691,681,7,10,"PP",131
9,"9124",1405,946,928,6,18,"PP",293
19,"19303",41,32,32,0,0,"PP",18
26,"26175",47,40,38,1,2,"PP",16
19,"19045",122,97,96,0,1,"PP",42
18,"18159",989,765,762,2,3,"PP",81
37,"37051",79,58,58,0,0,"PP",26
16,"16061",939,746,727,16,19,"PP",199
40,"40091",109,87,85,0,2,"PP",34
45,"45002",2619,1676,1663,14,13,"PP",387
28,"28091",5491,3709,3650,20,59,"PP",959
3,"3060",105,78,77,0,1,"PP",10
5,"5171",67,49,47,0,2,"PP",26
23,"23901",1125,905,895,3,10,"PP",169
48,"48006",307,242,240,3,2,"PP",1
36,"36010",2825,1983,1947,19,36,"PP",487
37,"37217",59,43,43,3,0,"PP",13
41,"41068",13963,9596,9407,96,189,"PP",1415
18,"18085",690,440,432,1,8,"PP",97
40,"40126",67,44,42,0,2,"PP",26
37,"37312",244,191,189,1,2,"PP",81
16,"16101",137,111,109,1,2,"PP",26
5,"5151",83,60,60,0,0,"PP",32
40,"40092",105,75,75,2,0,"PP",40
28,"28092",153631,112460,111341,913,1119,"PP",22814
29,"29030",770,618,611,4,7,"PP",18
49,"49119",217,158,156,2,2,"PP",29
47,"47157",490,398,397,2,1,"PP",117
18,"18162",919,664,652,3,12,"PP",188
40,"40190",43,37,35,0,2,"PP",16
44,"44182",203,160,158,0,2,"PP",35
46,"46171",16446,11616,11499,94,117,"PP",2250
36,"36053",5783,3955,3899,39,56,"PP",1140
12,"12115",205,161,161,1,0,"PP",56
48,"48045",5207,3851,3817,9,34,"PP",142
16,"16102",1159,815,767,9,48,"PP",330
4,"4088",2444,1587,1574,17,13,"PP",325
29,"29050",392,229,227,3,2,"PP",45
6,"6103",4756,3285,3224,38,61,"PP",662
29,"29032",6655,4900,4775,36,125,"PP",717
44,"44183",61,47,47,1,0,"PP",9
23,"23903",3498,2633,2601,28,32,"PP",626
16,"16142",119,90,90,0,0,"PP",33
28,"28052",3961,2700,2659,14,41,"PP",692
10,"10138",527,386,379,2,7,"PP",60
29,"29060",665,454,450,1,4,"PP",157
29,"29004",283,222,218,3,4,"PP",37
45,"45006",1334,866,858,1,8,"PP",175
29,"29077",207,135,134,1,1,"PP",24
44,"44062",31,20,20,0,0,"PP",9
49,"49059",84,61,58,0,3,"PP",16
37,"37252",99,65,65,1,0,"PP",28
50,"50206",457,349,345,5,4,"PP",108
5,"5216",209,149,149,0,0,"PP",70
18,"18066",2095,1401,1378,12,23,"PP",156
2,"2008",1103,737,722,8,15,"PP",171
23,"23904",2570,1583,1562,10,21,"PP",342
49,"49024",626,432,426,3,6,"PP",167
15,"15058",28761,20250,20098,261,152,"PP",5875
39,"39064",1352,1007,990,3,17,"PP",324
16,"16169",49,28,28,0,0,"PP",3
24,"24131",684,416,415,2,1,"PP",147
19,"19195",36,26,25,2,1,"PP",4
36,"36036",2546,1763,1742,14,21,"PP",631
50,"50257",159,128,125,2,3,"PP",24
10,"10208",122,85,83,0,2,"PP",25
41,"41071",5571,3608,3516,64,92,"PP",425
34,"34116",54,35,35,0,0,"PP",15
40,"40095",453,341,329,2,12,"PP",115
24,"24107",206,147,147,1,0,"PP",54
6,"6061",1074,829,819,5,10,"PP",196
10,"10100",783,494,447,5,47,"PP",100
37,"37378",92,54,54,0,0,"PP",20
14,"14075",552,413,391,5,22,"PP",70
10,"10903",806,555,545,8,10,"PP",113
29,"29062",658,557,551,2,6,"PP",175
18,"18135",4385,2882,2798,24,84,"PP",514
46,"46083",15372,10939,10815,78,124,"PP",2258
49,"49025",157,121,118,0,3,"PP",38
50,"50056",399,296,296,3,0,"PP",67
29,"29081",250,185,182,2,3,"PP",45
13,"13088",585,413,409,3,4,"PP",94
5,"5219",33,23,23,0,0,"PP",10
14,"14901",932,753,750,6,3,"PP",56
24,"24222",14499,10219,10076,99,143,"PP",2158
12,"12069",50,38,38,0,0,"PP",11
2,"2077",52,41,41,0,0,"PP",9
43,"43036",869,565,557,7,8,"PP",28
40,"40195",776,573,565,4,8,"PP",234
19,"19280",3669,2622,2597,24,25,"PP",389
9,"9302",96,66,66,0,0,"PP",28
7,"7026",31129,17489,17342,178,147,"PP",3975
9,"9394",668,432,429,6,3,"PP",114
49,"49136",313,218,217,5,1,"PP",98
46,"46244",59910,42120,41826,338,294,"PP",9366
40,"40185",800,560,553,4,7,"PP",247
37,"37266",68,44,44,0,0,"PP",24
29,"29045",1679,1162,1144,5,18,"PP",283
49,"49185",156,120,116,0,4,"PP",61
4,"4001",1002,717,710,3,7,"PP",193
48,"48051",220,151,150,0,1,"PP",9
21,"21074",2736,1826,1790,19,36,"PP",534
1,"1041",150,103,102,1,1,"PP",39
7,"7027",22101,13161,13028,140,133,"PP",2643
50,"50057",1331,933,922,10,11,"PP",232
12,"12120",149,125,121,3,4,"PP",47
49,"49249",61,45,45,1,0,"PP",25
9,"9083",26,21,21,0,0,"PP",14
6,"6020",1752,1330,1296,6,34,"PP",320
9,"9035",284,191,190,2,1,"PP",44
16,"16239",118,88,87,0,1,"PP",14
40,"40101",918,672,665,11,7,"PP",124
19,"19160",883,535,530,11,5,"PP",102
49,"49250",1191,844,824,8,20,"PP",270
46,"46017",33041,23469,23277,173,192,"PP",5008
29,"29009",1435,971,957,17,14,"PP",102
28,"28133",6146,4245,4180,25,65,"PP",1043
32,"32072",3664,2387,2355,24,32,"PP",845
23,"23074",2984,2271,2236,20,35,"PP",491
40,"40004",436,330,319,2,11,"PP",95
20,"20042",3180,2056,2053,7,3,"PP",62
45,"45013",1679,1266,1248,5,18,"PP",473
40,"40135",277,212,210,3,2,"PP",85
34,"34077",395,282,278,7,4,"PP",68
16,"16192",42,28,28,0,0,"PP",0
42,"42021",65,46,45,2,1,"PP",25
43,"43118",422,338,338,0,0,"PP",11
13,"13094",294,216,215,1,1,"PP",66
1,"1043",2340,1487,1468,11,19,"PP",248
5,"5026",183,149,147,1,2,"PP",62
40,"40231",100,79,76,0,3,"PP",38
3,"3023",1377,1138,1122,9,16,"PP",311
34,"34175",87,67,66,1,1,"PP",36
13,"13064",1845,1314,1298,10,16,"PP",271
37,"37300",540,355,352,7,3,"PP",111
21,"21036",204,128,121,1,7,"PP",26
18,"18194",2038,1373,1348,12,25,"PP",186
5,"5225",355,276,273,6,3,"PP",136
45,"45162",630,448,438,1,10,"PP",148
39,"39070",126,91,89,0,2,"PP",18
12,"12098",529,417,413,3,4,"PP",117
39,"39024",1802,1325,1314,7,11,"PP",321
22,"22239",85,67,65,0,2,"PP",32
49,"49255",387,304,298,3,6,"PP",149
32,"32074",977,642,631,2,11,"PP",293
45,"45016",4486,3288,3251,19,37,"PP",821
2,"2016",528,353,352,4,1,"PP",101
11,"11025",4374,2808,2759,30,49,"PP",418
9,"9473",85,68,64,0,4,"PP",22
18,"18074",265,205,205,0,0,"PP",40
19,"19163",60,49,49,0,0,"PP",17
50,"50213",92,70,70,2,0,"PP",43
12,"12123",40,32,32,0,0,"PP",11
15,"15004",4924,3333,3292,38,41,"PP",918
19,"19058",7458,5705,5663,40,42,"PP",1136
45,"45127",775,510,502,1,8,"PP",114
38,"38002",971,577,570,8,7,"PP",94
9,"9476",60,46,46,0,0,"PP",21
16,"16003",134,108,105,0,3,"PP",28
37,"37355",159,121,120,1,1,"PP",61
23,"23006",4582,3536,3461,43,75,"PP",633
46,"46066",1274,972,970,4,2,"PP",223
39,"39025",8637,6256,6179,33,77,"PP",1287
6,"6073",703,451,441,6,10,"PP",79
10,"10110",2226,1431,1400,7,31,"PP",357
4,"4030",1052,690,678,6,12,"PP",177
18,"18175",11793,8099,7943,62,156,"PP",1543
12,"12124",1842,1343,1328,13,15,"PP",540
19,"19255",74,37,37,0,0,"PP",15
45,"45018",550,385,380,1,5,"PP",48
42,"42160",246,177,175,3,2,"PP",40
20,"20076",7013,5011,4991,16,20,"PP",208
22,"22130",10146,6505,6436,57,69,"PP",1500
18,"18077",471,350,343,1,7,"PP",43
15,"15038",2126,1312,1296,12,16,"PP",544
9,"9148",77,58,58,3,0,"PP",20
4,"4031",2238,1649,1645,15,4,"PP",351
9,"9480",105,84,84,0,0,"PP",40
26,"26075",315,234,229,1,5,"PP",104
49,"49224",166,102,100,0,2,"PP",36
46,"46253",112,84,84,0,0,"PP",21
45,"45130",294,222,222,1,0,"PP",87
37,"37293",102,68,68,1,0,"PP",31
36,"36003",10023,6877,6789,66,88,"PP",2275
44,"44036",22,20,20,0,0,"PP",7
22,"22032",102,69,68,1,1,"PP",10
15,"15029",5354,3082,3050,46,32,"PP",1166
3,"3055",5265,3741,3697,16,44,"PP",995
9,"9315",384,245,242,3,3,"PP",60
45,"45094",365,274,271,3,3,"PP",65
37,"37004",25,18,18,0,0,"PP",12
23,"23082",1850,1292,1279,13,13,"PP",384
50,"50241",582,414,406,2,8,"PP",151
46,"46113",2558,1791,1773,7,18,"PP",476
9,"9151",446,352,346,3,6,"PP",101
37,"37070",523,371,365,4,6,"PP",116
43,"43097",407,331,328,4,3,"PP",13
44,"44018",16,16,16,0,0,"PP",15
21,"21021",12545,7816,7696,104,120,"PP",1308
28,"28110",2029,1498,1478,9,20,"PP",361
45,"45131",259,219,216,1,3,"PP",70
5,"5036",118,91,90,0,1,"PP",51
42,"42029",131,94,94,4,0,"PP",53
3,"3904",1434,1032,1022,8,10,"PP",196
34,"34234",66,48,45,0,3,"PP",17
46,"46091",110,100,100,0,0,"PP",43
14,"14001",3423,2563,2515,11,48,"PP",627
50,"50216",236,169,167,0,2,"PP",74
46,"46023",322,254,252,1,2,"PP",47
18,"18079",3466,2391,2333,22,58,"PP",225
18,"18178",664,474,467,1,7,"PP",139
37,"37005",65,44,44,1,0,"PP",31
40,"40205",228,159,157,1,2,"PP",63
7,"7059",3074,1973,1948,17,25,"PP",650
9,"9318",56,33,33,0,0,"PP",15
46,"46160",1922,1395,1381,4,14,"PP",184
47,"47078",157,114,107,0,7,"PP",44
46,"46145",22215,15688,15538,127,150,"PP",3212
23,"23097",6346,4243,4194,31,49,"PP",788
50,"50125",340,230,229,2,1,"PP",80
1,"1042",911,680,671,8,9,"PP",27
22,"22036",84,71,71,1,0,"PP",30
4,"4035",8439,5822,5768,45,54,"PP",1347
43,"43178",1435,1071,1066,2,5,"PP",80
27,"27013",3690,2811,2766,30,45,"PP",919
22,"22247",28,18,18,0,0,"PP",2
47,"47206",79,66,66,0,0,"PP",26
19,"19326",2463,1671,1650,13,21,"PP",241
22,"22136",749,524,518,5,6,"PP",149
49,"49263",44,32,32,1,0,"PP",24
18,"18082",810,503,500,3,3,"PP",117
22,"22037",112,87,87,2,0,"PP",17
24,"24198",541,346,344,6,2,"PP",61
9,"9159",62,49,47,0,2,"PP",18
42,"42032",138,96,96,0,0,"PP",45
34,"34238",294,238,236,1,2,"PP",86
16,"16010",134,92,88,0,4,"PP",46
48,"48033",217,162,162,1,0,"PP",2
49,"49187",1197,839,819,12,20,"PP",259
9,"9104",49,35,34,0,1,"PP",18
29,"29047",1082,860,846,0,14,"PP",89
16,"16047",214,154,148,3,6,"PP",61
42,"42121",54,39,39,0,0,"PP",9
19,"19261",33,23,23,0,0,"PP",13
18,"18181",194,134,133,0,1,"PP",58
28,"28114",141,97,97,0,0,"PP",36
38,"38008",5699,3719,3669,26,50,"PP",879
50,"50144",31,24,24,0,0,"PP",10
49,"49230",84,69,69,0,0,"PP",25
10,"10120",153,97,97,0,0,"PP",30
45,"45026",219,166,164,1,2,"PP",33
9,"9163",573,436,432,7,4,"PP",170
9,"9906",1185,883,877,16,6,"PP",302
1,"1057",235,196,194,0,2,"PP",19
12,"12072",1083,852,827,10,25,"PP",265
40,"40113",404,308,304,2,4,"PP",61
15,"15045",3610,2057,2044,15,13,"PP",922
1,"1014",366,271,266,2,5,"PP",52
49,"49108",446,312,309,2,3,"PP",126
10,"10039",400,256,217,0,39,"PP",97
50,"50262",1161,849,832,11,17,"PP",142
34,"34140",93,57,57,1,0,"PP",26
5,"5204",578,445,442,3,3,"PP",168
32,"32050",2254,1630,1612,15,18,"PP",897
9,"9109",1072,575,558,0,17,"PP",95
10,"10122",219,159,157,2,2,"PP",40
46,"46095",580,445,438,5,7,"PP",116
18,"18051",1092,735,718,8,17,"PP",164
35,"35011",24859,15025,14833,149,192,"PP",2902
4,"4041",344,227,222,4,5,"PP",79
5,"5235",141,97,97,2,0,"PP",38
11,"11015",64414,39635,39220,776,415,"PP",6928
16,"16091",63,43,42,1,1,"PP",8
49,"49043",256,191,189,1,2,"PP",60
46,"46027",924,746,737,2,9,"PP",179
22,"22250",346,241,241,0,0,"PP",39
16,"16259",28,22,22,0,0,"PP",9
10,"10123",575,450,438,1,12,"PP",92
5,"5042",141,111,111,0,0,"PP",56
22,"22041",145,116,116,2,0,"PP",36
9,"9437",266,207,203,4,4,"PP",90
50,"50121",270,209,208,3,1,"PP",46
5,"5205",81,59,58,2,1,"PP",19
43,"43130",169,131,130,2,1,"PP",10
5,"5173",60,54,54,0,0,"PP",13
49,"49233",85,51,51,0,0,"PP",26
28,"28042",1261,918,908,9,10,"PP",228
19,"19264",33,25,25,0,0,"PP",4
26,"26087",180,123,123,3,0,"PP",55
6,"6088",12527,8326,8198,89,128,"PP",1787
42,"42081",126,88,88,0,0,"PP",40
40,"40118",46,32,32,1,0,"PP",11
9,"9013",42,32,32,0,0,"PP",18
34,"34146",53,43,43,0,0,"PP",19
37,"37303",179,118,117,1,1,"PP",39
9,"9168",270,211,210,5,1,"PP",53
34,"34006",79,73,69,2,4,"PP",35
38,"38012",2286,1520,1510,8,10,"PP",238
47,"47116",396,304,302,2,2,"PP",120
18,"18087",182877,131811,130184,1106,1627,"PP",36252
29,"29098",1228,902,876,11,26,"PP",144
44,"44264",254,170,170,0,0,"PP",22
26,"26169",66,51,50,0,1,"PP",22
40,"40052",72,55,55,0,0,"PP",17
22,"22244",42,33,32,1,1,"PP",12
10,"10194",524,408,404,2,4,"PP",121
47,"47150",253,193,187,3,6,"PP",73
1,"1051",3569,2259,2244,3,15,"PP",114
37,"37045",27,19,19,0,0,"PP",5
1,"1063",1852,1316,1303,6,13,"PP",124
19,"19237",39,34,34,0,0,"PP",6
7,"7012",1908,1301,1282,12,19,"PP",255
34,"34149",23,20,20,0,0,"PP",8
47,"47024",223,170,168,1,2,"PP",60
23,"23094",3739,2920,2876,29,44,"PP",349
19,"19333",96,68,67,0,1,"PP",16
11,"11019",1757,1233,1172,13,61,"PP",273
50,"50046",162,125,125,6,0,"PP",49
9,"9276",390,256,244,4,12,"PP",43
47,"47025",114,85,85,3,0,"PP",34
37,"37306",238,140,136,3,4,"PP",55
10,"10005",527,325,301,1,24,"PP",90
16,"16266",356,269,265,4,4,"PP",128
28,"28045",35523,26213,25966,212,247,"PP",6328
44,"44026",100,73,72,0,1,"PP",16
42,"42177",61,42,41,0,1,"PP",18
24,"24097",200,138,137,1,1,"PP",62
1,"1901",2473,1633,1612,9,21,"PP",223
43,"43133",5627,3794,3773,31,21,"PP",223
13,"13073",501,392,385,2,7,"PP",112
22,"22111",143,96,95,2,1,"PP",27
15,"15051",4545,2978,2945,47,33,"PP",752
9,"9018",24624,17232,16983,192,249,"PP",4785
38,"38039",11149,7375,7326,68,49,"PP",1692
50,"50250",54,44,44,2,0,"PP",7
47,"47183",135,100,100,1,0,"PP",37
5,"5241",3062,2011,1977,21,34,"PP",538
24,"24098",1149,753,741,8,12,"PP",122
2,"2056",1640,1204,1179,11,25,"PP",338
39,"39029",629,476,469,1,7,"PP",145
49,"49262",367,263,261,1,2,"PP",112
16,"16009",54,44,44,2,0,"PP",21
49,"49126",260,153,150,1,3,"PP",54
4,"4012",184,151,150,3,1,"PP",38
5,"5242",679,571,562,9,9,"PP",409
24,"24172",389,208,202,1,6,"PP",78
40,"40088",272,192,192,0,0,"PP",92
21,"21033",569,410,405,3,5,"PP",49
24,"24099",153,111,110,1,1,"PP",40
7,"7049",1479,935,918,5,17,"PP",252
40,"40186",35,29,29,0,0,"PP",15
16,"16135",115,76,76,0,0,"PP",32
4,"4050",742,465,464,0,1,"PP",101
6,"6096",206,158,153,0,5,"PP",58
43,"43056",803,566,558,6,8,"PP",39
49,"49275",51064,34471,34017,475,454,"PP",10139
23,"23061",7711,5357,5231,44,126,"PP",1106
49,"49163",203,139,138,3,1,"PP",51
40,"40124",234,169,164,0,5,"PP",41
34,"34018",199,151,149,4,2,"PP",58
37,"37018",106,75,75,0,0,"PP",28
47,"47028",30,17,17,0,0,"PP",9
22,"22902",206,147,144,1,3,"PP",52
47,"47217",1984,1460,1437,11,23,"PP",344
43,"43135",339,255,255,0,0,"PP",12
5,"5148",22,19,19,0,0,"PP",6
3,"3013",1063,809,794,3,15,"PP",278
20,"20032",8654,6000,5972,21,28,"PP",280
9,"9022",58,46,46,1,0,"PP",18
42,"42046",46,32,32,0,0,"PP",3
6,"6053",592,441,428,7,13,"PP",71
22,"22016",558,384,382,5,2,"PP",91
23,"23063",3784,2699,2664,22,35,"PP",440
37,"37216",294,234,227,5,7,"PP",98
9,"9125",555,386,382,4,4,"PP",162
5,"5105",330,247,242,2,5,"PP",64
41,"41030",501,376,366,9,10,"PP",64
5,"5127",600,472,469,7,3,"PP",191
26,"26138",4504,2982,2930,32,52,"PP",1152
45,"45173",9756,6811,6720,49,91,"PP",1979
10,"10148",33054,21731,21379,231,352,"PP",6123
12,"12053",2040,1587,1579,8,8,"PP",468
28,"28050",4406,3202,3167,29,35,"PP",720
3,"3129",1224,934,923,4,11,"PP",243
49,"49020",253,189,187,0,2,"PP",69
18,"18001",222,147,146,0,1,"PP",19
26,"26177",306,233,229,2,4,"PP",113
19,"19272",66,55,55,2,0,"PP",26
37,"37124",195,137,137,2,0,"PP",36
9,"9289",1353,873,861,4,12,"PP",310
20,"20003",549,360,355,1,5,"PP",0
10,"10217",506,378,377,3,1,"PP",145
3,"3100",499,384,378,0,6,"PP",95
23,"23902",2219,1813,1770,6,43,"PP",299
37,"37020",431,320,314,3,6,"PP",116
43,"43007",631,479,474,1,5,"PP",20
18,"18097",947,633,631,0,2,"PP",140
27,"27027",1791,1198,1167,17,31,"PP",418
24,"24103",274,134,134,0,0,"PP",66
3,"3015",12818,9127,9017,46,110,"PP",2386
18,"18128",332,263,260,1,3,"PP",109
44,"44061",77,60,58,1,2,"PP",17
23,"23031",764,660,640,6,20,"PP",60
26,"26025",84,69,65,2,4,"PP",20
47,"47126",42,35,35,1,0,"PP",26
49,"49244",46,23,23,0,0,"PP",15
23,"23066",4274,3517,3460,16,57,"PP",992
42,"42013",34,22,22,2,0,"PP",6
14,"14045",2997,2329,2287,30,42,"PP",385
26,"26179",39,27,27,0,0,"PP",6
19,"19277",15,10,10,0,0,"PP",1
11,"11027",68774,45571,45137,567,434,"PP",9564
48,"48074",3275,2308,2295,11,13,"PP",128
4,"4018",245,202,197,2,5,"PP",44
39,"39073",10260,7537,7482,42,55,"PP",1993
12,"12140",1147,849,841,5,8,"PP",194
34,"34163",46,37,37,0,0,"PP",19
9,"9183",42,32,32,0,0,"PP",16
35,"35028",10156,5483,5425,56,58,"PP",1308
1,"1033",654,476,476,0,0,"PP",75
4,"4019",236,174,172,0,2,"PP",34
40,"40160",93,65,62,0,3,"PP",41
19,"19154",58,45,45,0,0,"PP",28
9,"9297",310,233,233,6,0,"PP",90
23,"23905",1828,1320,1302,12,18,"PP",315
49,"49192",123,93,90,2,3,"PP",29
44,"44147",401,264,256,7,8,"PP",55
9,"9189",123,83,78,0,5,"PP",40
36,"36056",4932,3368,3310,24,58,"PP",1404
44,"44035",102,82,80,1,2,"PP",32
22,"22907",1463,1016,1006,21,10,"PP",237
18,"18100",7997,5523,5367,66,156,"PP",859
16,"16278",61,45,45,0,0,"PP",12
18,"18067",682,442,437,2,5,"PP",93
30,"30004",1129,838,833,1,5,"PP",222
9,"9030",116,81,81,1,0,"PP",31
46,"46174",942,746,736,1,10,"PP",138
26,"26143",260,197,192,1,5,"PP",72
42,"42054",18,12,12,0,0,"PP",4
40,"40194",39173,28641,28260,353,381,"PP",9213
20,"20007",337,223,221,2,2,"PP",2
2,"2042",810,581,577,1,4,"PP",150
43,"43141",109,85,84,0,1,"PP",4
2,"2010",1784,1374,1349,12,25,"PP",391
37,"37223",106,75,74,0,1,"PP",34
47,"47224",93,75,75,1,0,"PP",17
15,"15030",199701,137611,136590,1540,1021,"PP",37484
40,"40130",127,95,87,1,8,"PP",42
48,"48077",3366,2483,2467,9,16,"PP",131
37,"37285",360,271,270,0,1,"PP",101
34,"34168",45,39,39,1,0,"PP",17
24,"24002",224,165,162,1,3,"PP",47
6,"6109",3821,2943,2813,16,130,"PP",613
35,"35031",7456,4938,4868,39,70,"PP",1243
11,"11030",22999,14858,14586,207,272,"PP",2986
18,"18904",741,500,498,1,2,"PP",98
4,"4022",356,237,236,5,1,"PP",37
22,"22909",307,219,217,0,2,"PP",59
14,"14902",1113,877,851,15,26,"PP",99
22,"22045",65,52,52,0,0,"PP",14
5,"5145",43,28,28,0,0,"PP",12
37,"37182",75,47,47,1,0,"PP",19
50,"50225",1532,983,971,12,12,"PP",244
5,"5221",322,231,231,0,0,"PP",70
15,"15093",4012,2413,2386,24,27,"PP",989
13,"13091",537,466,464,3,2,"PP",206
34,"34031",26,26,26,1,0,"PP",8
24,"24223",2533,1727,1705,40,22,"PP",552
2,"2012",1835,1462,1420,9,42,"PP",379
47,"47037",161,128,125,1,3,"PP",57
37,"37131",175,125,125,0,0,"PP",57
40,"40196",30,24,24,0,0,"PP",16
16,"16034",155,116,113,0,3,"PP",42
16,"16190",4930,3747,3688,26,59,"PP",1165
43,"43143",50,40,39,0,1,"PP",0
42,"42196",7,7,7,1,0,"PP",5
16,"16149",147,105,105,2,0,"PP",19
47,"47227",53,36,35,0,1,"PP",11
43,"43064",2027,1456,1445,19,11,"PP",111
47,"47038",100,61,61,0,0,"PP",12
11,"11032",54731,31560,31284,492,276,"PP",4785
24,"24112",288,188,186,2,2,"PP",28
2,"2013",125,90,88,0,2,"PP",26
24,"24225",979,678,668,5,10,"PP",223
46,"46245",527,407,404,2,3,"PP",105
45,"45159",83,71,69,0,2,"PP",26
40,"40230",93,66,64,0,2,"PP",13
44,"44011",47,34,34,0,0,"PP",8
18,"18071",5636,3909,3807,45,102,"PP",609
50,"50297",503800,365284,362768,3385,2516,"PP",84006
45,"45160",1097,838,824,4,14,"PP",236
37,"37028",131,96,93,2,3,"PP",56
42,"42060",28,16,14,0,2,"PP",8
5,"5160",289,220,213,0,7,"PP",115
50,"50261",201,154,151,0,3,"PP",18
43,"43040",325,268,267,1,1,"PP",11
6,"6023",4138,2811,2749,12,62,"PP",652
20,"20012",149,104,104,1,0,"PP",1
27,"27047",1517,955,940,12,15,"PP",331
3,"3090",18095,12539,12412,75,127,"PP",2949
24,"24215",149,116,115,0,1,"PP",50
7,"7041",2090,1454,1434,17,20,"PP",395
40,"40125",76,48,46,0,2,"PP",17
50,"50237",100,75,75,2,0,"PP",24
48,"48054",25063,17705,17597,122,108,"PP",1660
48,"48082",37358,25328,25167,125,161,"PP",1759
24,"24007",735,500,496,8,4,"PP",87
49,"49068",422,263,261,4,2,"PP",134
18,"18908",776,553,528,3,25,"PP",66
22,"22059",1135,765,752,2,13,"PP",177
1,"1046",639,433,432,2,1,"PP",64
40,"40037",30,17,17,0,0,"PP",9
44,"44132",54,49,49,0,0,"PP",17
13,"13005",23256,16610,16367,132,243,"PP",3932
16,"16905",1302,951,934,10,17,"PP",215
19,"19285",20,16,16,0,0,"PP",4
10,"10150",339,279,275,3,4,"PP",57
5,"5162",76,47,45,1,2,"PP",20
11,"11035",13751,8535,8396,125,139,"PP",1506
28,"28137",1770,1300,1289,6,11,"PP",220
38,"38027",5581,3577,3533,22,44,"PP",859
2,"2017",760,498,493,1,5,"PP",134
29,"29040",1933,1260,1235,11,25,"PP",274
6,"6901",2125,1549,1520,28,29,"PP",341
37,"37167",174,147,144,2,3,"PP",29
4,"4066",13438,8615,8519,78,96,"PP",2225
32,"32003",863,632,619,3,13,"PP",336
3,"3025",1304,944,934,4,10,"PP",268
44,"44222",125,92,92,0,0,"PP",36
47,"47231",4439,3359,3323,36,36,"PP",772
41,"41079",9285,6591,6446,101,145,"PP",683
22,"22060",1167,817,808,14,9,"PP",227
29,"29041",3697,2406,2361,47,45,"PP",343
5,"5163",1702,1258,1233,5,25,"PP",532
46,"46180",659,509,500,7,9,"PP",81
42,"42026",28,25,25,0,0,"PP",9
6,"6028",4098,3457,3350,22,107,"PP",946
32,"32004",1608,835,824,5,11,"PP",591
28,"28108",3736,2681,2652,21,29,"PP",552
34,"34179",25,18,16,0,2,"PP",12
45,"45056",2341,1315,1295,11,20,"PP",209
13,"13008",422,280,272,2,8,"PP",101
24,"24010",8251,5357,5275,40,82,"PP",1742
37,"37033",94,67,67,0,0,"PP",18
12,"12048",243,159,155,4,4,"PP",55
28,"28064",125,98,95,3,3,"PP",23
3,"3113",4339,2978,2935,23,43,"PP",704
45,"45166",1575,1231,1210,5,21,"PP",340
5,"5228",168,99,98,0,1,"PP",73
13,"13010",872,615,601,3,14,"PP",204
16,"16156",84,64,64,0,0,"PP",21
42,"42068",77,58,57,0,1,"PP",24
12,"12076",72,54,54,0,0,"PP",19
34,"34132",106,73,72,0,1,"PP",25
5,"5131",96,64,64,1,0,"PP",29
16,"16910",75,44,44,1,0,"PP",14
45,"45020",1240,905,900,5,5,"PP",301
10,"10114",964,644,637,6,7,"PP",64
37,"37034",77,63,62,0,1,"PP",22
15,"15008",5646,3859,3836,52,23,"PP",1289
37,"37294",11750,8395,8280,88,115,"PP",2473
44,"44137",187,139,139,0,0,"PP",66
14,"14028",302,241,240,3,1,"PP",59
42,"42069",1483,896,878,2,18,"PP",285
26,"26005",2483,1589,1570,13,19,"PP",610
2,"2021",1013,806,798,6,8,"PP",227
37,"37139",189,150,148,1,2,"PP",42
34,"34042",294,224,221,1,3,"PP",92
3,"3028",959,780,767,7,13,"PP",190
43,"43150",1233,954,941,6,13,"PP",58
9,"9374",93,75,72,2,3,"PP",31
40,"40044",134,101,101,3,0,"PP",41
14,"14029",4001,2855,2821,30,34,"PP",675
52,"52001",54293,31015,30776,185,239,"PP",9105
26,"26119",178,132,132,0,0,"PP",31
9,"9211",1369,938,921,14,17,"PP",395
28,"28143",77,58,58,0,0,"PP",27
23,"23011",2138,1536,1507,17,29,"PP",228
24,"24087",582,431,427,3,4,"PP",180
14,"14058",7866,5451,5334,69,117,"PP",1207
50,"50242",99,74,74,0,0,"PP",24
26,"26079",633,503,499,2,4,"PP",248
37,"37329",38,29,28,1,1,"PP",14
45,"45012",623,482,472,0,10,"PP",177
19,"19259",28,22,22,0,0,"PP",3
23,"23012",4004,2726,2689,21,37,"PP",537
2,"2023",504,419,412,0,7,"PP",152
18,"18114",585,425,424,7,1,"PP",69
50,"50016",44,31,31,0,0,"PP",8
42,"42209",134,86,84,4,2,"PP",30
40,"40906",2149,1701,1662,18,39,"PP",410
44,"44020",22,21,21,0,0,"PP",9
40,"40045",119,93,93,1,0,"PP",27
41,"41084",2799,2029,1937,9,92,"PP",350
20,"20051",6736,4829,4804,22,25,"PP",222
48,"48004",326,245,245,1,0,"PP",0
9,"9380",71,42,41,0,1,"PP",23
16,"16161",51,44,44,1,0,"PP",21
38,"38032",13579,8941,8880,92,61,"PP",1789
6,"6127",2809,2105,2074,9,31,"PP",654
40,"40046",83,67,67,1,0,"PP",18
50,"50244",192,131,130,1,1,"PP",37
37,"37173",1412,951,937,15,14,"PP",326
5,"5266",100,79,79,1,0,"PP",53
44,"44260",137,93,93,1,0,"PP",20
49,"49152",474,289,282,2,7,"PP",114
24,"24089",101036,71905,71305,744,600,"PP",21339
36,"36008",21845,14553,14373,138,180,"PP",3433
2,"2025",7345,5388,5278,51,110,"PP",1475
9,"9381",28,19,19,0,0,"PP",11
40,"40047",37,23,23,0,0,"PP",12
45,"45172",640,475,462,6,13,"PP",169
47,"47018",36,31,31,0,0,"PP",15
42,"42076",200,149,143,2,6,"PP",59
44,"44048",52,47,47,0,0,"PP",12
19,"19106",77,57,57,0,0,"PP",12
41,"41085",4182,3258,3181,43,77,"PP",600
44,"44143",388,298,298,2,0,"PP",74
47,"47019",92,68,68,1,0,"PP",28
32,"32073",1273,863,857,6,6,"PP",348
45,"45015",656,449,438,2,11,"PP",97
16,"16012",76,66,66,0,0,"PP",21
50,"50002",125,91,86,0,5,"PP",43
46,"46250",582242,437146,434438,3315,2708,"PP",106207
42,"42078",1000,653,640,5,13,"PP",288
23,"23016",386,313,305,4,8,"PP",53
37,"37009",197,145,144,1,1,"PP",69
9,"9010",33,25,25,2,0,"PP",5
49,"49154",111,63,59,0,4,"PP",9
5,"5201",497,404,401,0,3,"PP",156
22,"22007",751,527,520,1,7,"PP",170
40,"40016",55,44,43,1,1,"PP",20
9,"9328",70,37,37,3,0,"PP",13
22,"22069",423,296,294,4,2,"PP",80
16,"16165",56,45,45,0,0,"PP",15
19,"19296",29,24,24,0,0,"PP",9
46,"46232",853,661,648,7,13,"PP",147
46,"46118",3649,2730,2701,20,29,"PP",743
37,"37240",928,648,637,2,11,"PP",182
41,"41087",10557,7217,7029,67,188,"PP",1207
4,"4076",1209,873,850,7,23,"PP",174
26,"26125",2665,1885,1853,21,32,"PP",663
48,"48008",609,415,407,4,8,"PP",7
39,"39062",1864,1395,1376,3,19,"PP",440
9,"9387",107,89,88,0,1,"PP",23
45,"45176",3859,2694,2662,24,32,"PP",485
28,"28149",6298,4751,4699,35,52,"PP",881
3,"3120",2433,1688,1652,13,36,"PP",420
50,"50172",174,125,123,2,2,"PP",41
5,"5237",153,125,123,0,2,"PP",66
14,"14007",15016,10248,10043,99,205,"PP",1975
13,"13023",8944,6251,6165,50,86,"PP",2324
19,"19203",29,25,25,0,0,"PP",5
16,"16051",128,96,96,3,0,"PP",37
46,"46119",761,587,580,6,7,"PP",111
28,"28150",3191,2423,2401,13,22,"PP",526
9,"9221",498,380,377,8,3,"PP",86
48,"48093",891,669,666,5,3,"PP",24
45,"45177",1998,1557,1525,10,32,"PP",399
12,"12083",88,69,67,9,2,"PP",16
37,"37042",36,27,27,1,0,"PP",18
4,"4078",1127,725,718,8,7,"PP",133
32,"32016",714,494,493,12,1,"PP",129
41,"41005",9285,6637,6497,83,140,"PP",956
50,"50174",80,58,57,0,1,"PP",27
19,"19004",59,44,44,0,0,"PP",24
13,"13025",290,233,231,0,2,"PP",90
48,"48010",476,343,343,1,0,"PP",2
14,"14036",3677,2619,2555,39,64,"PP",354
34,"34202",28,23,23,2,0,"PP",12
43,"43906",2113,1490,1480,12,10,"PP",91
47,"47054",599,465,460,1,5,"PP",188
37,"37180",68,45,44,1,1,"PP",19
24,"24132",610,330,329,5,1,"PP",105
12,"12133",59,46,45,0,1,"PP",13
42,"42041",31,23,23,0,0,"PP",10
13,"13026",413,333,331,2,2,"PP",78
50,"50249",283,202,200,0,2,"PP",70
16,"16055",669,429,426,0,3,"PP",135
45,"45032",445,290,286,2,4,"PP",52
26,"26130",205,153,150,1,3,"PP",85
20,"20028",2254,1442,1441,6,1,"PP",46
34,"34010",550,407,399,7,8,"PP",157
23,"23024",12215,8702,8447,69,255,"PP",2029
48,"48095",2324,1568,1555,13,13,"PP",113
29,"29053",1717,1133,1116,12,17,"PP",220
28,"28153",816,547,544,3,3,"PP",78
34,"34057",464,308,302,4,6,"PP",119
10,"10169",497,370,366,0,4,"PP",139
10,"10168",320,210,206,1,4,"PP",58
37,"37046",10648,7396,7241,62,155,"PP",2315
45,"45181",2330,1693,1661,10,32,"PP",459
37,"37244",129,97,97,1,0,"PP",37
49,"49090",190,135,134,3,1,"PP",47
9,"9392",49,28,28,0,0,"PP",7
12,"12004",4149,2945,2910,25,35,"PP",678
44,"44054",95,82,81,0,1,"PP",33
43,"43054",2807,1972,1957,14,15,"PP",65
37,"37307",146,94,91,1,3,"PP",39
1,"1902",723,485,478,8,7,"PP",108
48,"48096",6516,4862,4816,33,46,"PP",192
6,"6140",612,456,451,1,5,"PP",223
24,"24134",3287,2278,2226,18,52,"PP",394
50,"50176",220,142,142,3,0,"PP",35
6,"6125",1644,1251,1222,7,29,"PP",340
23,"23060",19210,13677,13495,145,182,"PP",2721
37,"37213",83,64,64,0,0,"PP",28
50,"50024",543,400,397,3,3,"PP",79
42,"42087",51,45,42,1,3,"PP",3
5,"5047",4105,3004,2936,23,68,"PP",856
45,"45036",638,455,449,1,6,"PP",155
32,"32021",872,555,550,6,5,"PP",178
37,"37340",141,97,97,1,0,"PP",50
45,"45073",288,214,210,2,4,"PP",91
22,"22077",362,280,272,5,8,"PP",66
43,"43003",349,257,255,3,2,"PP",9
48,"48014",1229,845,843,8,2,"PP",51
34,"34210",98,82,82,1,0,"PP",45
37,"37247",171,129,128,0,1,"PP",54
14,"14013",16619,11968,11719,153,249,"PP",2802
26,"26020",449,319,313,1,6,"PP",136
26,"26135",152,115,114,0,1,"PP",39
34,"34061",91,70,69,1,1,"PP",28
29,"29056",1047,708,696,5,12,"PP",176
3,"3040",264,227,221,1,6,"PP",66
2,"2036",93,66,66,0,0,"PP",29
41,"41010",4586,3218,3157,42,61,"PP",432
5,"5179",199,176,172,1,4,"PP",98
13,"13032",1076,772,765,0,7,"PP",181
37,"37154",129,97,94,1,3,"PP",57
3,"3041",6132,4204,4167,22,37,"PP",1070
19,"19009",263,186,184,0,2,"PP",53
46,"46124",786,638,625,1,13,"PP",170
40,"40057",1397,1081,1067,15,14,"PP",265
42,"42184",55,36,33,0,3,"PP",6
23,"23029",798,595,590,0,5,"PP",178
18,"18063",1232,687,678,9,9,"PP",135
37,"37113",404,286,285,13,1,"PP",97
26,"26124",768,603,590,4,13,"PP",285
28,"28125",3208,2275,2252,5,23,"PP",518
16,"16163",64,51,51,0,0,"PP",21
22,"22178",105,89,89,1,0,"PP",21
34,"34158",283,170,167,0,3,"PP",40
24,"24030",4158,2746,2696,18,50,"PP",698
47,"47218",981,728,723,4,5,"PP",173
39,"39042",5910,4354,4315,14,39,"PP",1206
45,"45077",546,413,409,0,4,"PP",96
44,"44032",17,13,13,0,0,"PP",2
5,"5182",721,457,436,3,21,"PP",149
9,"9405",122,94,91,0,3,"PP",44
5,"5245",353,262,256,0,6,"PP",77
7,"7053",1209,870,864,10,6,"PP",189
6,"6101",437,355,346,1,9,"PP",159
49,"49204",58,44,43,1,1,"PP",23
40,"40059",109,92,91,2,1,"PP",45
6,"6010",1063,760,732,2,28,"PP",142
49,"49243",107,74,74,0,0,"PP",35
10,"10177",1702,1241,1186,10,55,"PP",224
3,"3043",2906,2360,2334,27,26,"PP",604
22,"22081",247,173,171,3,2,"PP",86
45,"45188",2770,1925,1886,12,39,"PP",375
37,"37156",4261,2928,2869,23,59,"PP",1056
37,"37021",66,45,44,0,1,"PP",21
3,"3072",352,281,277,3,4,"PP",35
9,"9182",74,54,54,0,0,"PP",35
36,"36023",8258,5504,5384,44,120,"PP",1717
40,"40029",25,21,19,0,2,"PP",9
41,"41069",29669,20316,19848,381,468,"PP",2971
19,"19086",1371,1003,996,9,7,"PP",259
26,"26062",85,62,62,1,0,"PP",40
20,"20035",480,361,361,0,0,"PP",6
42,"42094",596,448,436,9,12,"PP",122
19,"19216",127,88,88,0,0,"PP",16
37,"37055",117,97,93,0,4,"PP",45
50,"50029",594,432,431,3,1,"PP",88
48,"48018",854,563,560,5,3,"PP",3
45,"45190",462,361,353,3,8,"PP",74
9,"9238",931,473,461,1,12,"PP",157
19,"19015",82,74,73,1,1,"PP",23
44,"44034",124,90,90,0,0,"PP",32
40,"40030",419,317,314,3,3,"PP",90
32,"32065",633,422,419,8,3,"PP",158
5,"5087",147,108,107,3,1,"PP",43
5,"5184",238,163,160,2,3,"PP",71
9,"9076",24,19,19,1,0,"PP",5
6,"6014",6503,4235,4181,35,54,"PP",1450
34,"34027",1049,677,665,15,12,"PP",189
48,"48048",527,381,380,3,1,"PP",3
28,"28162",2784,2143,2131,20,12,"PP",562
19,"19308",57,49,49,0,0,"PP",12
24,"24106",218,139,139,1,0,"PP",66
23,"23069",5240,4153,4065,26,88,"PP",757
42,"42149",386,273,270,2,3,"PP",83
47,"47129",855,660,648,7,12,"PP",174
24,"24071",947,618,611,6,7,"PP",208
46,"46128",1569,1216,1179,7,37,"PP",300
47,"47064",37,30,29,1,1,"PP",11
26,"26065",63,46,43,0,3,"PP",16
26,"26028",135,111,110,3,1,"PP",48
10,"10059",329,202,201,1,1,"PP",52
12,"12011",4583,3228,3177,24,51,"PP",605
2,"2076",313,233,230,2,3,"PP",66
42,"42151",38,27,27,0,0,"PP",9
9,"9411",153,105,104,0,1,"PP",25
16,"16188",74,57,57,1,0,"PP",16
19,"19017",56,47,47,0,0,"PP",21
26,"26145",239,194,187,3,7,"PP",87
6,"6153",20252,14183,13924,154,259,"PP",3502
18,"18037",535,417,410,2,7,"PP",108
16,"16147",54,34,33,0,1,"PP",7
50,"50258",53,25,25,1,0,"PP",9
29,"29063",305,244,242,2,2,"PP",80
45,"45194",64,45,44,1,1,"PP",11
45,"45010",383,258,257,3,1,"PP",44
40,"40065",467,338,329,1,9,"PP",134
47,"47162",70,57,57,2,0,"PP",22
47,"47225",73,61,59,1,2,"PP",30
42,"42100",30,24,24,1,0,"PP",15
50,"50160",2140,1421,1394,14,27,"PP",270
45,"45048",360,276,271,2,5,"PP",105
22,"22163",426,338,335,0,3,"PP",86
2,"2001",687,513,505,1,8,"PP",189
9,"9244",45,31,31,2,0,"PP",10
43,"43090",1199,689,686,5,3,"PP",48
18,"18070",287,216,216,3,0,"PP",43
40,"40164",186,131,130,0,1,"PP",80
9,"9246",599,381,372,2,9,"PP",134
48,"48910",2811,1952,1942,11,10,"PP",140
32,"32033",667,439,436,4,3,"PP",231
42,"42103",543,383,374,2,9,"PP",159
37,"37060",283,205,202,1,3,"PP",60
18,"18905",15688,10406,10200,122,206,"PP",1940
16,"16033",1633,1199,1174,8,25,"PP",365
36,"36029",16126,10936,10771,96,165,"PP",2727
44,"44067",106,75,71,0,4,"PP",14
48,"48023",579,451,448,0,3,"PP",8
6,"6021",898,628,617,16,11,"PP",245
10,"10186",951,756,735,6,21,"PP",218
16,"16072",132,84,84,1,0,"PP",17
40,"40165",73,53,52,0,1,"PP",10
21,"21075",338,243,235,3,8,"PP",60
22,"22087",60,46,46,0,0,"PP",23
47,"47164",349,283,281,1,2,"PP",102
29,"29066",357,248,246,1,2,"PP",52
50,"50109",95,65,62,2,3,"PP",21
2,"2047",110,83,81,0,2,"PP",45
3,"3107",2785,1766,1746,13,20,"PP",382
42,"42197",68,54,53,0,1,"PP",24
39,"39078",1410,1004,997,5,7,"PP",265
26,"26149",42,34,34,0,0,"PP",9
5,"5190",53,44,43,0,1,"PP",13
27,"27066",12588,8116,7954,109,162,"PP",2402
24,"24041",513,312,305,4,7,"PP",107
20,"20073",4707,3272,3260,14,12,"PP",98
19,"19222",95,70,70,2,0,"PP",19
22,"22025",1022,705,694,14,11,"PP",199
24,"24006",488,356,347,4,9,"PP",122
35,"35033",6393,4147,4072,38,75,"PP",958
40,"40146",260,206,204,0,2,"PP",66
12,"12089",4555,3070,3045,22,25,"PP",954
13,"13034",58768,42473,42028,359,445,"PP",12852
46,"46064",532,395,387,3,8,"PP",92
30,"30032",2864,2154,2129,18,25,"PP",665
22,"22168",22,20,19,0,1,"PP",4
6,"6024",1123,876,849,3,27,"PP",223
37,"37353",122,82,80,0,2,"PP",34
26,"26151",412,317,317,4,0,"PP",118
24,"24154",952,625,618,5,7,"PP",168
10,"10189",2499,1747,1700,15,47,"PP",414
47,"47135",82,65,65,3,0,"PP",27
36,"36033",12305,8759,8597,67,162,"PP",2487
22,"22089",274,195,193,2,2,"PP",54
45,"45089",1432,1076,1064,10,12,"PP",196
40,"40071",39,32,26,0,6,"PP",16
39,"39080",3477,2404,2388,4,16,"PP",736
13,"13051",336,253,249,1,4,"PP",70
41,"41022",4255,2735,2667,32,68,"PP",309
43,"43015",115,92,91,1,1,"PP",0
4,"4098",1424,890,885,0,5,"PP",215
5,"5096",76,62,62,0,0,"PP",19
24,"24155",441,340,334,2,6,"PP",120
19,"19224",106,83,83,1,0,"PP",41
50,"50036",100,76,76,1,0,"PP",22
15,"15037",4026,2375,2349,10,26,"PP",766
19,"19023",119,87,85,0,2,"PP",23
46,"46252",125,89,86,1,3,"PP",38
3,"3140",26036,18637,18267,237,370,"PP",4228
49,"49222",369,250,247,2,3,"PP",53
16,"16195",458,343,338,0,5,"PP",90
6,"6027",645,523,513,0,10,"PP",172
49,"49110",344,196,195,2,1,"PP",62
6,"6902",1651,1198,1174,19,24,"PP",248
32,"32040",1400,1001,990,10,11,"PP",551
42,"42113",510,370,366,2,4,"PP",182
40,"40171",40,32,32,1,0,"PP",14
5,"5130",94,77,77,1,0,"PP",23
21,"21019",592,397,389,6,8,"PP",48
40,"40140",76,54,54,0,0,"PP",25
43,"43043",3317,2457,2445,12,12,"PP",149
49,"49223",701,498,494,7,4,"PP",280
32,"32041",752,462,458,4,4,"PP",263
18,"18144",816,592,582,3,10,"PP",132
30,"30035",19432,13174,13013,114,161,"PP",3523
34,"34232",725,505,492,13,13,"PP",180
38,"38053",3768,2275,2244,16,31,"PP",529
2,"2052",466,371,370,6,1,"PP",98
19,"19130",61556,45926,45388,408,538,"PP",11577
6,"6029",1174,873,865,5,8,"PP",154
24,"24157",2542,1846,1809,16,37,"PP",576
9,"9095",103,54,53,3,1,"PP",30
39,"39083",1063,619,611,2,8,"PP",131
16,"16197",67,44,43,0,1,"PP",13
9,"9206",52,43,43,0,0,"PP",26
34,"34084",158,125,125,1,0,"PP",43
14,"14056",23477,15826,15470,177,356,"PP",2846
50,"50115",3279,2170,2131,27,39,"PP",498
37,"37233",53,39,39,1,0,"PP",8
16,"16119",175,117,115,0,2,"PP",35
24,"24901",853,517,513,4,4,"PP",123
9,"9373",399,254,251,5,3,"PP",138
9,"9425",472,311,309,3,2,"PP",97
10,"10072",837,545,539,5,6,"PP",125
10,"10195",7514,5243,5148,47,95,"PP",1573
37,"37170",1361,909,884,9,25,"PP",344
13,"13057",1099,858,849,2,9,"PP",303
19,"19227",68,42,41,1,1,"PP",11
47,"47076",17787,13484,13306,179,178,"PP",3180
9,"9427",1363,854,842,7,12,"PP",376
19,"19324",164,122,120,4,2,"PP",36
49,"49004",110,74,71,3,3,"PP",34
24,"24159",1716,1238,1216,6,22,"PP",514
6,"6033",1276,986,972,5,14,"PP",317
6,"6032",80,68,68,1,0,"PP",16
12,"12021",4398,3314,3277,32,37,"PP",615
50,"50192",227,182,181,0,1,"PP",27
16,"16084",48,34,30,1,4,"PP",5
18,"18146",930,645,629,10,16,"PP",131
46,"46137",248,201,197,3,4,"PP",59
22,"22246",63,43,43,0,0,"PP",16
47,"47173",879,627,622,9,5,"PP",129
18,"18112",104,68,66,2,2,"PP",17
6,"6034",171,114,114,2,0,"PP",37
4,"4901",490,343,343,2,0,"PP",77
44,"44225",105,82,81,2,1,"PP",16
9,"9265",38,31,31,1,0,"PP",15
19,"19229",58,53,53,0,0,"PP",18
22,"22003",135,107,107,0,0,"PP",39
46,"46001",771,562,560,3,2,"PP",175
30,"30038",15752,10987,10904,39,83,"PP",2715
50,"50193",664,487,475,4,12,"PP",102
40,"40176",372,288,287,2,1,"PP",96
13,"13061",5616,3679,3634,51,45,"PP",939
34,"34089",141,102,101,4,1,"PP",45
16,"16203",10221,6960,6883,42,77,"PP",1687
39,"39086",358,236,235,2,1,"PP",73
12,"12104",6843,5181,5111,32,70,"PP",1607
41,"41028",2108,1652,1632,22,20,"PP",253
4,"4002",1013,711,699,1,12,"PP",111
2,"2057",1947,1358,1333,15,25,"PP",237
12,"12024",138,107,107,1,0,"PP",11
36,"36040",2505,1597,1563,15,34,"PP",605
24,"24123",709,461,457,2,4,"PP",137
28,"28176",13980,10765,10701,72,64,"PP",3697
49,"49081",1321,972,953,6,19,"PP",256
37,"37331",186,115,114,2,1,"PP",43
24,"24017",532,375,374,1,1,"PP",149
43,"43022",1436,1028,1024,13,4,"PP",107
10,"10079",848,641,632,2,9,"PP",182
43,"43101",146,112,112,2,0,"PP",3
47,"47080",33,25,24,0,1,"PP",12
50,"50194",80,51,51,0,0,"PP",22
46,"46071",471,355,349,1,6,"PP",98
36,"36041",13691,9022,8916,85,106,"PP",2996
47,"47175",6755,4950,4870,49,80,"PP",1055
9,"9268",89,62,62,0,0,"PP",18
9,"9105",95,65,64,1,1,"PP",21
14,"14061",687,536,523,1,13,"PP",96
26,"26164",50,36,35,0,1,"PP",12
22,"22006",268,167,164,4,3,"PP",28
47,"47039",162,119,117,0,2,"PP",39
42,"42023",57,48,48,0,0,"PP",27
44,"44261",713,553,549,3,4,"PP",151
19,"19036",242,202,200,1,2,"PP",72
10,"10080",353,243,238,1,5,"PP",77
26,"26011",7251,4807,4711,47,96,"PP",1544
24,"24019",338,259,256,4,3,"PP",59
3,"3061",1060,793,787,5,6,"PP",212
12,"12026",828,577,566,11,11,"PP",202
50,"50146",189,149,149,3,0,"PP",48
44,"44115",102,91,91,0,0,"PP",21
42,"42124",56,27,27,0,0,"PP",11
48,"48063",354,256,252,1,4,"PP",3
43,"43023",211,171,169,2,2,"PP",1
50,"50043",241,155,154,1,1,"PP",28
39,"39090",773,557,553,2,4,"PP",127
13,"13021",412,325,320,1,5,"PP",120
28,"28011",417,295,292,6,3,"PP",58
40,"40180",276,215,210,2,5,"PP",100
41,"41902",4599,2906,2868,50,38,"PP",368
49,"49232",85,64,64,0,0,"PP",27
37,"37271",349,262,258,2,4,"PP",94
24,"24056",2726,1803,1772,21,31,"PP",430
37,"37115",108,67,65,0,2,"PP",26
37,"37078",781,626,603,9,23,"PP",194
5,"5107",54,36,35,2,1,"PP",16
34,"34096",48,39,38,0,1,"PP",10
19,"19331",2677,1892,1841,18,51,"PP",413
44,"44174",402,289,288,1,1,"PP",94
50,"50247",852,600,594,8,6,"PP",152
10,"10083",96,76,74,0,2,"PP",13
1,"1017",817,537,532,3,5,"PP",53
23,"23055",46314,30950,30506,279,444,"PP",6285
15,"15078",78810,55693,55183,569,510,"PP",17121
30,"30042",2218,1645,1625,10,20,"PP",420
45,"45104",419,328,324,1,4,"PP",59
43,"43025",591,448,443,4,5,"PP",27
46,"46142",778,536,524,3,12,"PP",193
2,"2062",382,261,256,2,5,"PP",70
9,"9113",453,321,315,8,6,"PP",88
6,"6043",677,493,488,5,5,"PP",112
48,"48037",696,497,485,0,12,"PP",4
49,"49121",372,239,233,1,6,"PP",97
46,"46074",2687,2033,2020,18,13,"PP",372
20,"20906",128,87,87,0,0,"PP",0
6,"6044",29258,19865,19594,205,271,"PP",5163
50,"50045",1217,891,878,10,13,"PP",291
46,"46211",1862,1395,1381,12,14,"PP",289
16,"16213",34,27,26,0,1,"PP",9
50,"50095",12149,8322,8239,91,83,"PP",1556
34,"34056",1926,1335,1311,10,24,"PP",498
44,"44265",175,138,136,1,2,"PP",68
27,"27051",7986,5324,5241,58,83,"PP",1769
39,"39008",13900,9814,9734,63,80,"PP",2032
16,"16053",388,306,303,3,3,"PP",67
28,"28182",203,167,163,1,4,"PP",24
16,"16094",121,86,84,0,2,"PP",33
9,"9275",167,114,114,1,0,"PP",47
30,"30901",10556,7862,7775,58,87,"PP",2043
50,"50123",430,304,297,3,7,"PP",54
5,"5110",696,469,464,2,5,"PP",174
44,"44118",154,109,106,1,3,"PP",33
19,"19145",40,32,32,0,0,"PP",23
6,"6046",1250,983,959,6,24,"PP",253
47,"47086",3818,2835,2784,36,51,"PP",796
21,"21001",621,431,418,0,13,"PP",54
49,"49014",116,83,83,1,0,"PP",36
9,"9442",368,265,262,1,3,"PP",94
24,"24061",1753,1234,1223,10,11,"PP",305
9,"9277",103,84,82,1,2,"PP",17
9,"9117",71,58,58,0,0,"PP",33
30,"30902",8294,5235,5174,29,61,"PP",1119
28,"28015",20885,16237,16104,134,133,"PP",3592
47,"47087",362,272,268,1,4,"PP",81
9,"9443",151,113,112,0,1,"PP",40
3,"3066",41762,28723,28388,358,335,"PP",6275
9,"9226",54,45,45,2,0,"PP",25
34,"34058",182,152,152,0,0,"PP",66
27,"27053",497,342,334,2,8,"PP",106
12,"12085",5081,3271,3235,17,36,"PP",690
18,"18157",1148,843,827,7,16,"PP",193
5,"5012",117,88,88,1,0,"PP",34
28,"28016",79,55,55,0,0,"PP",11
36,"36048",5248,3429,3378,25,51,"PP",1028
19,"19335",51,39,38,0,1,"PP",9
46,"46100",281,190,187,1,3,"PP",48
35,"35001",4566,3148,3105,18,43,"PP",1019
34,"34104",231,164,162,2,2,"PP",96
40,"40218",80,56,55,0,1,"PP",39
41,"41009",1148,750,732,5,18,"PP",104
38,"38040",5482,3094,3060,14,34,"PP",971
41,"41037",3201,2306,2260,22,46,"PP",176
49,"49238",273,205,200,4,5,"PP",67
47,"47089",133,111,111,2,0,"PP",60
22,"22112",9525,6317,6245,91,72,"PP",1691
12,"12033",1953,1391,1368,6,23,"PP",401
10,"10212",1658,1113,1068,19,45,"PP",193
9,"9122",86,55,55,0,0,"PP",29
44,"44179",324,201,201,2,0,"PP",57
44,"44268",32,30,30,0,0,"PP",10
6,"6051",1523,1147,1137,5,10,"PP",316
26,"26174",134,100,99,3,1,"PP",46
46,"46146",1647,1241,1229,12,12,"PP",241
45,"45111",56,47,47,1,0,"PP",17
49,"49127",2402,1640,1604,18,36,"PP",491
42,"42008",54,41,41,0,0,"PP",23
46,"46902",352,283,283,0,0,"PP",42
22,"22113",478,335,333,6,2,"PP",82
49,"49128",520,384,378,7,6,"PP",130
49,"49018",277,197,190,2,7,"PP",70
4,"4014",152,105,103,1,2,"PP",10
49,"49240",185,125,123,3,2,"PP",50
32,"32060",753,520,515,5,5,"PP",152
40,"40089",209,155,148,2,7,"PP",70
2,"2069",11401,8055,7975,30,80,"PP",2568
14,"14070",1280,911,902,4,9,"PP",336
4,"4085",360,291,289,0,2,"PP",74
20,"20002",359,234,231,7,3,"PP",2
26,"26176",56,43,43,0,0,"PP",22
50,"50253",379,294,290,1,4,"PP",114
37,"37185",539,372,363,2,9,"PP",121
10,"10201",178,142,141,2,1,"PP",39
4,"4904",1900,1308,1299,4,9,"PP",378
2,"2070",373,306,301,6,5,"PP",36
34,"34108",499,391,384,3,7,"PP",141
6,"6009",221,166,166,2,0,"PP",38
10,"10012",553,427,421,1,6,"PP",98
22,"22193",272,199,194,4,5,"PP",80
48,"48903",1800,1358,1353,4,5,"PP",120
42,"42141",101,59,59,0,0,"PP",15
6,"6055",1976,1343,1313,11,30,"PP",399
21,"21006",3321,2197,2125,19,72,"PP",220
29,"29002",1143,777,766,6,11,"PP",160
48,"48044",61957,45253,45063,299,190,"PP",8513
47,"47092",101,81,79,0,2,"PP",31
14,"14071",874,551,540,5,11,"PP",105
50,"50052",81,61,61,0,0,"PP",32
14,"14015",2045,1465,1418,16,47,"PP",304
32,"32062",784,557,550,1,7,"PP",338
42,"42187",58,44,39,1,5,"PP",12
47,"47219",39,31,28,1,3,"PP",8
16,"16274",97,76,75,1,1,"PP",17
9,"9450",23,18,18,1,0,"PP",7
49,"49131",231,149,145,1,4,"PP",60
22,"22116",1342,915,905,11,10,"PP",304
15,"15056",5615,3697,3646,31,51,"PP",1354
3,"3101",4933,3502,3462,16,40,"PP",573
16,"16181",54,40,40,0,0,"PP",23
34,"34112",39,31,31,0,0,"PP",16
49,"49022",282,230,229,2,1,"PP",66
39,"39100",849,567,565,5,2,"PP",189
37,"37376",2130,1446,1423,18,23,"PP",613
40,"40127",36,25,23,0,2,"PP",11
9,"9074",844,610,609,12,1,"PP",155
46,"46149",350,252,249,3,3,"PP",89
50,"50131",212,152,147,4,5,"PP",52
12,"12116",61,49,49,0,0,"PP",18
28,"28094",988,711,707,5,4,"PP",146
12,"12038",157,101,100,3,1,"PP",43
23,"23067",2405,1765,1724,14,41,"PP",349
5,"5019",44865,32917,32586,282,331,"PP",9260
45,"45116",666,492,489,4,3,"PP",134
9,"9131",485,390,388,7,2,"PP",85
35,"35005",1009,680,668,2,12,"PP",228
47,"47094",120,100,100,0,0,"PP",42
24,"24218",451,310,308,3,2,"PP",93
15,"15090",1115,711,701,19,10,"PP",348
37,"37377",215,174,173,0,1,"PP",73
50,"50054",55,37,37,2,0,"PP",11
44,"44184",44,37,37,0,0,"PP",7
39,"39046",1342,910,902,3,8,"PP",130
3,"3103",238,196,194,2,2,"PP",36
12,"12039",792,665,659,2,6,"PP",247
19,"19050",15,13,13,0,0,"PP",4
18,"18165",4265,2870,2820,22,50,"PP",361
50,"50005",228,185,184,2,1,"PP",84
5,"5251",56,35,34,0,1,"PP",11
7,"7024",7283,3574,3538,36,36,"PP",807
42,"42191",183,116,114,5,2,"PP",39
44,"44185",88,69,69,2,0,"PP",17
16,"16107",94,56,56,0,0,"PP",21
45,"45045",1338,926,915,9,11,"PP",230
21,"21010",15011,8812,8694,174,118,"PP",1830
22,"22020",115,83,80,3,3,"PP",20
9,"9354",34,31,31,2,0,"PP",11
28,"28130",28569,22050,21799,187,251,"PP",3547
50,"50133",98,76,76,0,0,"PP",16
7,"7025",443,313,310,5,3,"PP",103
9,"9301",658,497,488,5,9,"PP",143
16,"16237",98,82,82,1,0,"PP",31
41,"41044",7753,5636,5547,55,89,"PP",1019
50,"50282",55,38,38,1,0,"PP",15
9,"9412",750,484,482,4,2,"PP",162
19,"19157",53,37,37,0,0,"PP",6
47,"47192",89,78,76,3,2,"PP",30
39,"39019",2232,1628,1603,10,25,"PP",380
10,"10904",714,487,473,8,14,"PP",91
24,"24182",410,273,270,7,3,"PP",99
40,"40099",54,44,42,0,2,"PP",20
29,"29007",28907,20371,20129,254,242,"PP",4276
15,"15092",6220,3810,3756,30,54,"PP",1299
10,"10102",496,378,377,1,1,"PP",95
24,"24109",857,534,528,8,6,"PP",101
10,"10021",4987,3574,3475,31,99,"PP",632
2,"2078",891,650,642,4,8,"PP",123
19,"19249",29,26,26,0,0,"PP",14
29,"29008",15249,10396,10234,108,162,"PP",2515
19,"19220",2608,1673,1653,10,20,"PP",181
46,"46130",862,633,625,6,8,"PP",128
28,"28027",1215,836,826,8,10,"PP",232
42,"42153",12,10,10,0,0,"PP",6
47,"47006",182,149,145,1,4,"PP",34
37,"37192",361,200,198,3,2,"PP",51
22,"22023",385,293,283,2,10,"PP",75
43,"43169",445,388,388,3,0,"PP",3
12,"12070",505,407,398,2,9,"PP",119
34,"34223",203,147,143,1,4,"PP",83
38,"38023",126137,79423,78706,605,717,"PP",13911
10,"10104",5123,3470,3396,21,74,"PP",982
15,"15901",3334,1948,1928,27,20,"PP",634
3,"3077",1391,1052,1032,10,20,"PP",312
15,"15001",4697,3069,3022,45,47,"PP",1121
47,"47099",154,123,118,0,5,"PP",44
6,"6066",1708,1180,1171,6,9,"PP",269
50,"50058",63,45,43,0,2,"PP",16
41,"41047",10449,7884,7770,119,114,"PP",1659
6,"6067",1897,1268,1242,14,26,"PP",334
37,"37099",63,46,46,1,0,"PP",16
27,"27004",1143,640,625,2,15,"PP",307
4,"4026",57,38,37,0,1,"PP",20
3,"3078",468,340,336,0,4,"PP",122
14,"14051",1323,975,951,7,24,"PP",266
35,"35010",3853,2224,2194,18,30,"PP",369
50,"50211",236,174,173,0,1,"PP",58
18,"18171",2098,1521,1460,11,61,"PP",172
22,"22127",521,353,352,5,1,"PP",66
47,"47100",118,93,87,2,6,"PP",32
24,"24078",324,228,225,0,3,"PP",74
10,"10188",483,354,340,0,14,"PP",86
34,"34034",112,82,82,1,0,"PP",25
24,"24153",228,171,171,3,0,"PP",54
37,"37101",138,101,100,1,1,"PP",54
16,"16001",62,45,45,0,0,"PP",19
38,"38001",21069,10844,10777,63,67,"PP",1875
46,"46110",21364,15132,15019,120,113,"PP",2914
47,"47196",29,21,21,0,0,"PP",13
12,"12122",754,608,600,3,8,"PP",228
26,"26150",97,77,77,1,0,"PP",31
40,"40104",283,203,200,0,3,"PP",50
40,"40005",25,23,23,1,0,"PP",12
9,"9309",293,198,193,5,5,"PP",53
20,"20013",5433,3906,3893,24,13,"PP",106
29,"29011",2893,1763,1736,12,27,"PP",279
9,"9472",52,40,38,0,2,"PP",14
22,"22128",188,145,143,3,2,"PP",47
50,"50060",171,126,125,1,1,"PP",31
16,"16002",192,160,158,2,2,"PP",49
47,"47102",257,212,210,2,2,"PP",48
18,"18174",435,324,320,3,4,"PP",62
37,"37196",70,50,50,0,0,"PP",26
26,"26073",92,68,66,1,2,"PP",22
28,"28031",2129,1501,1486,8,15,"PP",403
49,"49142",244,163,160,0,3,"PP",49
29,"29012",9718,6664,6553,85,111,"PP",1267
50,"50061",190,157,155,2,2,"PP",54
44,"44107",212,135,135,0,0,"PP",34
9,"9311",59,45,45,0,0,"PP",6
24,"24044",150,91,89,2,2,"PP",31
46,"46157",2959,2145,2126,11,19,"PP",589
48,"48055",2603,1833,1820,14,13,"PP",60
26,"26074",107,87,86,2,1,"PP",34
22,"22242",60,41,40,0,1,"PP",21
5,"5226",63,43,42,0,1,"PP",26
46,"46225",351,267,262,1,5,"PP",69
49,"49033",655,440,434,4,6,"PP",187
32,"32076",1935,1320,1306,15,14,"PP",726
43,"43042",2215,1723,1710,18,13,"PP",116
12,"12046",188,135,135,4,0,"PP",32
44,"44108",306,209,205,1,4,"PP",56
39,"39082",1611,1108,1102,8,6,"PP",373
16,"16005",234,163,160,1,3,"PP",56
5,"5099",451,350,344,3,6,"PP",121
3,"3112",650,503,497,3,6,"PP",197
40,"40202",56,33,33,0,0,"PP",22
16,"16247",63,51,50,1,1,"PP",15
43,"43122",112,91,91,1,0,"PP",1
45,"45129",98,77,77,1,0,"PP",17
40,"40009",41,35,34,0,1,"PP",14
15,"15007",3164,2081,2060,24,21,"PP",856
6,"6075",470,363,360,7,3,"PP",70
46,"46158",1047,771,763,7,8,"PP",198
4,"4032",5716,3727,3696,43,31,"PP",774
20,"20016",1529,887,883,3,4,"PP",7
50,"50063",64,49,49,0,0,"PP",20
44,"44109",99,64,64,0,0,"PP",16
19,"19256",46,36,36,0,0,"PP",20
49,"49035",220,180,180,4,0,"PP",49
3,"3083",5479,3736,3674,39,62,"PP",727
40,"40107",90,67,67,0,0,"PP",31
7,"7035",1595,1095,1078,13,17,"PP",272
27,"27010",4378,2719,2670,49,49,"PP",1137
27,"27042",1639,1120,1107,8,13,"PP",670
12,"12020",118,104,103,1,1,"PP",42
43,"43176",746,564,561,2,3,"PP",18
29,"29090",1649,1138,1124,10,14,"PP",286
24,"24084",153,105,102,2,3,"PP",36
42,"42163",50,27,27,1,0,"PP",8
16,"16249",1938,1422,1406,6,16,"PP",452
44,"44110",37,30,30,0,0,"PP",13
7,"7036",28132,18650,18510,222,140,"PP",3897
40,"40108",109,85,85,2,0,"PP",32
23,"23084",902,627,621,4,6,"PP",87
45,"45022",395,292,292,2,0,"PP",93
2,"2901",2196,1441,1419,10,22,"PP",396
47,"47109",161,120,120,1,0,"PP",36
35,"35015",10752,5289,5222,39,67,"PP",783
16,"16121",227,160,152,0,8,"PP",45
40,"40012",241,160,156,7,4,"PP",59
19,"19064",64,56,56,0,0,"PP",27
12,"12127",63,45,44,1,1,"PP",8
45,"45132",2387,1765,1754,13,11,"PP",604
47,"47205",355,248,244,2,4,"PP",101
40,"40109",69,51,50,3,1,"PP",25
42,"42030",91,69,69,2,0,"PP",37
46,"46069",152,112,111,1,1,"PP",24
43,"43125",884,658,645,12,13,"PP",50
34,"34135",398,267,264,4,3,"PP",107
22,"22135",173,123,121,0,2,"PP",35
20,"20020",114,64,64,0,0,"PP",0
29,"29017",6404,4575,4468,48,107,"PP",798
49,"49038",88,63,58,1,5,"PP",15
28,"28037",1570,1135,1123,4,12,"PP",220
37,"37110",104,81,79,1,2,"PP",22
44,"44112",400,265,265,2,0,"PP",49
3,"3002",3649,2568,2542,11,26,"PP",601
50,"50217",426,333,333,1,0,"PP",82
46,"46093",2151,1652,1640,10,12,"PP",445
40,"40013",57,47,47,0,0,"PP",38
18,"18180",636,410,401,2,9,"PP",46
37,"37007",391,289,281,7,8,"PP",91
9,"9903",3112,2087,2058,24,29,"PP",642
29,"29018",2009,1421,1362,17,59,"PP",235
37,"37237",296,212,204,1,8,"PP",45
3,"3088",5895,4030,3961,29,69,"PP",830
45,"45135",4152,3118,3066,21,52,"PP",795
37,"37267",177,130,129,0,1,"PP",42
15,"15011",15501,9988,9846,78,142,"PP",2919
46,"46207",6761,4966,4909,46,57,"PP",1071
5,"5199",37,31,31,0,0,"PP",17
12,"12052",537,409,398,5,11,"PP",122
9,"9006",57,30,29,0,1,"PP",7
22,"22039",813,635,634,4,1,"PP",179
37,"37112",158,110,109,2,1,"PP",50
49,"49264",529,334,329,2,5,"PP",151
24,"24199",398,263,256,4,7,"PP",83
23,"23087",11169,8193,8045,79,148,"PP",1802
9,"9007",54,37,35,0,2,"PP",25
48,"48062",295,236,236,0,0,"PP",0
29,"29094",59795,39350,38854,454,496,"PP",8567
4,"4038",3105,2020,1984,17,36,"PP",490
34,"34139",160,117,115,2,2,"PP",47
50,"50067",13928,9831,9699,92,132,"PP",2789
16,"16255",132,99,99,0,0,"PP",36
46,"46003",948,770,757,8,13,"PP",185
46,"46026",1220,974,965,7,9,"PP",255
49,"49153",150,110,107,2,3,"PP",42
6,"6084",1061,780,769,11,11,"PP",238
49,"49266",66,46,45,1,1,"PP",19
34,"34001",39,27,27,1,0,"PP",7
47,"47176",199,110,110,0,0,"PP",54
14,"14005",6298,3905,3828,71,77,"PP",517
43,"43049",727,557,555,3,2,"PP",11
23,"23053",9451,6038,5975,60,63,"PP",774
26,"26165",336,248,242,3,6,"PP",66
3,"3005",7937,5907,5869,40,38,"PP",1629
28,"28082",6110,4622,4581,41,41,"PP",913
47,"47114",3900,2549,2514,18,35,"PP",787
24,"24092",731,506,504,1,2,"PP",171
9,"9907",1526,1140,1119,18,21,"PP",218
42,"42172",28,26,26,0,0,"PP",15
19,"19173",47,40,40,0,0,"PP",11
5,"5139",71,59,58,1,1,"PP",35
34,"34004",5517,3819,3769,36,50,"PP",1278
45,"45029",186,154,154,2,0,"PP",37
5,"5236",105,69,69,1,0,"PP",14
40,"40211",66,54,54,1,0,"PP",21
23,"23018",2243,1606,1584,17,22,"PP",190
50,"50295",48,41,41,0,0,"PP",11
29,"29022",177,137,136,1,1,"PP",19
10,"10001",287,207,203,2,4,"PP",31
6,"6087",1999,1472,1455,13,17,"PP",341
27,"27017",952,568,562,3,6,"PP",276
27,"27018",3211,1830,1800,17,30,"PP",573
44,"44203",9,9,9,0,0,"PP",1
34,"34143",161,115,112,2,3,"PP",55
43,"43051",9194,6133,6048,44,85,"PP",583
45,"45140",1075,788,772,10,16,"PP",188
42,"42037",28,13,13,2,0,"PP",8
12,"12132",477,391,385,3,6,"PP",76
24,"24205",990,678,667,6,11,"PP",241
3,"3092",6712,4924,4858,35,66,"PP",966
18,"18184",2193,1542,1511,16,31,"PP",281
44,"44204",27,18,18,0,0,"PP",1
9,"9332",137,93,91,2,2,"PP",33
26,"26088",39,35,34,0,1,"PP",15
44,"44117",327,258,258,0,0,"PP",42
42,"42218",68,44,43,0,1,"PP",18
42,"42039",216,144,141,1,3,"PP",37
28,"28043",6190,4031,3969,33,62,"PP",789
47,"47212",356,289,287,4,2,"PP",115
24,"24206",1594,1104,1093,11,11,"PP",258
22,"22252",118,95,91,1,4,"PP",19
37,"37117",1572,1103,1092,12,11,"PP",248
48,"48094",3121,2201,2188,7,13,"PP",46
2,"2030",2949,2158,2122,16,36,"PP",440
12,"12029",670,524,514,5,10,"PP",115
37,"37243",89,66,66,0,0,"PP",40
5,"5207",645,485,478,4,7,"PP",145
32,"32090",734,448,441,2,7,"PP",140
16,"16131",123,84,84,0,0,"PP",19
28,"28044",6266,4693,4642,36,51,"PP",1070
5,"5045",81,58,58,0,0,"PP",29
47,"47118",147,97,97,2,0,"PP",38
50,"50072",183,131,129,0,2,"PP",30
12,"12003",954,710,702,6,8,"PP",219
5,"5143",59,52,51,1,1,"PP",28
37,"37118",117,86,86,3,0,"PP",22
47,"47119",89,59,58,2,1,"PP",26
9,"9172",131,88,88,1,0,"PP",42
42,"42042",53,42,41,1,1,"PP",16
10,"10128",5618,3799,3630,37,169,"PP",885
39,"39037",2033,1431,1420,3,11,"PP",477
50,"50224",61,44,44,2,0,"PP",20
19,"19006",755,506,494,4,12,"PP",100
37,"37119",99,78,78,1,0,"PP",10
5,"5046",38,35,35,0,0,"PP",17
22,"22149",301,211,210,1,1,"PP",50
45,"45144",736,562,557,1,5,"PP",160
9,"9173",123,96,93,2,3,"PP",29
34,"34903",179,129,129,1,0,"PP",58
44,"44207",125,98,97,2,1,"PP",21
9,"9174",768,536,522,6,14,"PP",184
37,"37015",198,127,125,2,2,"PP",45
46,"46168",2004,1463,1447,12,16,"PP",291
3,"3011",8014,5278,5212,50,66,"PP",1086
23,"23096",2543,2029,1986,16,43,"PP",282
41,"41064",5602,3520,3417,56,103,"PP",438
50,"50151",607,450,449,12,1,"PP",94
37,"37276",125,92,92,0,0,"PP",44
26,"26094",67,51,51,0,0,"PP",34
14,"14012",6046,4215,4120,56,95,"PP",905
18,"18061",999,781,770,5,11,"PP",149
50,"50048",33,25,25,0,0,"PP",4
26,"26055",39,30,30,0,0,"PP",15
6,"6095",9506,6616,6425,109,191,"PP",1283
34,"34015",37,24,24,0,0,"PP",13
19,"19179",74,64,64,3,0,"PP",19
9,"9175",120,78,76,1,2,"PP",48
22,"22150",459,325,321,8,4,"PP",82
10,"10009",255,165,162,1,3,"PP",82
19,"19079",7,6,6,0,0,"PP",5
42,"42182",49,39,39,1,0,"PP",28
37,"37017",226,169,168,4,1,"PP",84
50,"50152",1351,942,932,14,10,"PP",321
15,"15021",5254,3473,3422,58,51,"PP",1035
40,"40024",823,582,575,8,7,"PP",217
34,"34017",889,676,665,7,11,"PP",286
12,"12137",40,28,28,0,0,"PP",4
21,"21034",1155,768,748,5,20,"PP",116
47,"47123",461,360,358,2,2,"PP",130
16,"16137",37,27,25,0,2,"PP",8
22,"22047",248,202,201,1,1,"PP",78
35,"35025",1752,1113,1095,5,18,"PP",363
42,"42183",102,74,74,1,0,"PP",49
48,"48071",6013,4240,4205,23,35,"PP",132
49,"49164",141,95,92,1,3,"PP",29
7,"7051",5484,3133,3094,43,39,"PP",766
22,"22190",123,77,77,1,0,"PP",14
11,"11023",9386,6363,6248,116,115,"PP",852
45,"45112",1844,1121,1086,8,35,"PP",277
34,"34157",2353,1697,1669,18,28,"PP",617
4,"4052",12882,8400,8322,93,78,"PP",1543
10,"10215",438,266,262,2,4,"PP",69
16,"16100",642,518,514,2,4,"PP",183
9,"9287",191,144,143,2,1,"PP",26
22,"22079",118,85,84,1,1,"PP",21
22,"22049",73,62,62,0,0,"PP",28
34,"34019",111,87,86,1,1,"PP",30
18,"18193",14934,10301,10127,116,174,"PP",2026
19,"19305",139,104,103,1,1,"PP",32
49,"49165",55,52,52,1,0,"PP",25
50,"50076",70,56,56,0,0,"PP",10
7,"7052",4853,2765,2743,33,22,"PP",610
6,"6100",845,626,624,2,2,"PP",208
19,"19081",27,21,21,0,0,"PP",16
27,"27026",2299,1385,1368,9,17,"PP",542
16,"16140",18,14,14,1,0,"PP",1
4,"4053",12545,8864,8744,67,120,"PP",2648
35,"35027",10502,6831,6750,67,81,"PP",1742
19,"19183",70,59,58,0,1,"PP",14
37,"37250",325,212,211,0,1,"PP",51
5,"5152",644,498,496,3,2,"PP",221
37,"37344",229,157,147,2,10,"PP",49
46,"46194",15852,11124,11009,86,115,"PP",2272
27,"27059",2035,1356,1322,7,34,"PP",677
12,"12064",80,71,69,0,2,"PP",28
45,"45151",544,413,409,0,4,"PP",119
34,"34160",133,107,106,0,1,"PP",24
39,"39072",325,184,182,0,2,"PP",90
44,"44153",1733,1131,1125,0,6,"PP",290
13,"13083",2382,1623,1587,12,36,"PP",538
9,"9026",377,288,288,1,0,"PP",91
46,"46035",6828,5155,5089,33,66,"PP",844
49,"49058",301,222,221,1,1,"PP",67
15,"15025",986,529,517,6,12,"PP",211
32,"32064",453,304,302,0,2,"PP",162
47,"47093",795,585,573,7,12,"PP",190
42,"42051",15,9,9,0,0,"PP",8
44,"44125",63,41,41,0,0,"PP",10
26,"26101",31,18,17,0,1,"PP",6
18,"18901",489,323,322,5,1,"PP",80
24,"24105",1512,1054,1047,10,7,"PP",236
46,"46173",1309,1029,1010,13,19,"PP",266
9,"9351",61,46,45,1,1,"PP",21
20,"20036",13208,9102,9056,59,46,"PP",514
48,"48075",2066,1524,1508,9,16,"PP",51
37,"37126",30,25,25,0,0,"PP",16
44,"44126",314,222,221,0,1,"PP",51
47,"47002",18,18,18,0,0,"PP",10
18,"18902",752,589,568,3,21,"PP",126
28,"28128",453,334,331,1,3,"PP",102
40,"40224",18,15,15,0,0,"PP",12
22,"22052",874,660,652,7,8,"PP",182
9,"9184",6,6,6,0,0,"PP",1
39,"39102",2229,1524,1514,10,10,"PP",441
10,"10017",775,554,545,1,9,"PP",196
9,"9353",74,56,54,1,2,"PP",9
40,"40031",546,410,406,3,4,"PP",102
19,"19246",42,27,27,1,0,"PP",10
39,"39018",4284,3211,3177,22,34,"PP",455
43,"43061",40,27,27,3,0,"PP",1
42,"42015",30,20,20,0,0,"PP",8
10,"10018",1605,974,948,16,26,"PP",178
28,"28129",8589,6397,6338,46,59,"PP",1678
20,"20068",179,119,119,2,0,"PP",0
19,"19120",107,86,86,1,0,"PP",30
19,"19186",76,60,60,0,0,"PP",16
22,"22084",571,400,391,5,9,"PP",86
6,"6152",1273,888,867,7,21,"PP",181
34,"34167",110,84,83,0,1,"PP",31
44,"44127",57,43,43,0,0,"PP",14
27,"27031",15107,9759,9593,87,166,"PP",3180
16,"16279",173,109,108,0,1,"PP",38
44,"44216",27003,19997,19909,80,88,"PP",4247
50,"50080",34,27,27,0,0,"PP",2
11,"11029",5442,2826,2765,44,61,"PP",290
3,"3104",27072,19732,19477,218,255,"PP",3967
40,"40032",368,247,244,5,3,"PP",84
5,"5057",2418,1785,1748,9,37,"PP",591
45,"45156",3334,2561,2502,23,59,"PP",611
21,"21042",15610,8112,8011,164,101,"PP",1543
37,"37224",189,156,153,2,3,"PP",75
9,"9034",291,227,224,1,3,"PP",106
5,"5253",75,54,54,0,0,"PP",28
37,"37318",196,132,132,0,0,"PP",69
21,"21012",285,224,221,0,3,"PP",62
49,"49172",474,278,271,1,7,"PP",167
50,"50007",51,34,34,1,0,"PP",10
50,"50081",487,355,349,5,6,"PP",88
23,"23001",912,723,712,2,11,"PP",157
28,"28164",3230,2371,2345,28,26,"PP",518
34,"34170",50,30,30,1,0,"PP",16
27,"27064",1505,972,951,9,21,"PP",482
9,"9358",247,165,161,3,4,"PP",96
42,"42194",144,101,100,2,1,"PP",37
44,"44038",101,85,83,1,2,"PP",24
18,"18007",730,490,478,3,12,"PP",91
9,"9464",33,24,24,0,0,"PP",8
9,"9414",180,137,135,1,2,"PP",55
24,"24003",603,374,372,0,2,"PP",134
18,"18137",968,733,731,3,2,"PP",217
10,"10022",409,301,291,1,10,"PP",112
29,"29037",215,156,153,1,3,"PP",60
40,"40034",74,59,58,0,1,"PP",25
50,"50235",2421,1721,1702,18,19,"PP",365
21,"21044",18061,11170,11003,123,167,"PP",3174
44,"44130",28,23,23,0,0,"PP",9
37,"37320",85,65,64,1,1,"PP",24
9,"9360",26,19,19,0,0,"PP",6
45,"45050",505,338,332,2,6,"PP",80
16,"16150",98,66,66,2,0,"PP",26
50,"50083",81,64,64,2,0,"PP",13
6,"6112",379,295,293,0,2,"PP",77
27,"27034",1010,565,558,3,7,"PP",201
28,"28029",576,443,443,4,0,"PP",113
10,"10146",1494,924,903,1,21,"PP",216
5,"5159",224,133,132,3,1,"PP",83
50,"50009",97,61,61,1,0,"PP",27
9,"9196",133,95,95,2,0,"PP",29
14,"14023",1999,1629,1593,11,36,"PP",643
9,"9038",109,87,86,1,1,"PP",28
41,"41076",2134,1246,1230,11,16,"PP",201
43,"43013",4406,3004,2975,19,29,"PP",160
49,"49030",79,56,56,0,0,"PP",34
22,"22167",465,358,356,8,2,"PP",115
19,"19095",11,7,6,0,1,"PP",1
50,"50084",67,47,47,1,0,"PP",11
3,"3109",3003,2186,2151,14,35,"PP",606
22,"22058",193,141,141,0,0,"PP",32
16,"16038",27,20,20,0,0,"PP",9
34,"34035",97,76,75,3,1,"PP",34
40,"40136",102,79,77,3,2,"PP",26
6,"6115",1243,808,798,8,10,"PP",169
20,"20043",1718,1189,1183,2,6,"PP",31
5,"5161",545,395,395,0,0,"PP",133
37,"37322",2462,1580,1537,14,43,"PP",382
50,"50298",5439,4053,4007,41,46,"PP",1019
18,"18106",413,270,261,3,9,"PP",56
24,"24227",1527,1036,1032,13,4,"PP",315
49,"49177",255,145,144,1,1,"PP",36
9,"9041",25,21,21,2,0,"PP",6
30,"30009",12728,9487,9365,46,122,"PP",2828
46,"46042",3335,2655,2620,12,35,"PP",765
45,"45054",3798,2612,2587,10,25,"PP",727
18,"18909",514,403,403,0,0,"PP",90
34,"34036",230,159,158,0,1,"PP",32
50,"50085",182,121,121,0,0,"PP",40
40,"40039",180,133,133,0,0,"PP",66
41,"41078",2445,1722,1689,12,33,"PP",263
14,"14025",2834,2352,2299,9,53,"PP",318
42,"42159",39,34,33,0,1,"PP",15
16,"16040",91,76,76,2,0,"PP",31
44,"44133",15,12,12,0,0,"PP",3
49,"49071",716,432,429,6,3,"PP",193
7,"7065",2319,1429,1411,15,18,"PP",335
6,"6118",155,114,112,0,2,"PP",26
49,"49179",337,210,209,3,1,"PP",89
19,"19194",91,69,69,0,0,"PP",15
24,"24116",387,227,226,3,1,"PP",69
7,"7901",598,410,402,6,8,"PP",152
9,"9368",29,19,19,1,0,"PP",11
19,"19286",772,585,575,3,10,"PP",102
44,"44194",103,67,64,0,3,"PP",13
45,"45092",223,193,190,1,3,"PP",72
20,"20015",1245,880,876,5,4,"PP",0
27,"27009",2005,1324,1303,11,21,"PP",750
47,"47042",51,39,39,0,0,"PP",16
10,"10152",444,312,309,2,3,"PP",67
43,"43148",91182,65076,64756,441,320,"PP",6775
39,"39054",4541,3271,3252,30,19,"PP",591
46,"46112",533,435,432,7,3,"PP",149
6,"6120",3370,2507,2460,11,47,"PP",567
40,"40902",113,78,76,1,2,"PP",45
4,"4068",170,129,128,0,1,"PP",47
34,"34180",68,54,54,1,0,"PP",27
27,"27041",2216,1463,1445,19,18,"PP",665
50,"50240",943,693,683,12,10,"PP",149
6,"6121",3276,2301,2256,30,45,"PP",574
49,"49181",333,197,195,2,2,"PP",106
10,"10031",162,128,124,0,4,"PP",45
46,"46045",1245,984,961,3,23,"PP",214
44,"44044",82,65,65,2,0,"PP",26
44,"44136",48,43,43,1,0,"PP",23
10,"10032",1588,1114,1099,6,15,"PP",396
18,"18177",375,235,231,5,4,"PP",75
13,"13903",498,395,394,0,1,"PP",176
42,"42028",75,57,56,0,1,"PP",14
5,"5066",435,344,341,2,3,"PP",64
32,"32006",1418,986,970,14,16,"PP",591
34,"34041",82,64,64,3,0,"PP",34
19,"19196",89,70,67,1,3,"PP",20
5,"5263",162,117,115,1,2,"PP",36
40,"40141",822,584,568,9,16,"PP",192
42,"42206",8,5,5,2,0,"PP",3
16,"16043",88,60,60,3,0,"PP",25
18,"18111",2863,2038,2001,29,37,"PP",302
37,"37328",159,112,110,1,2,"PP",36
3,"3029",236,174,172,2,2,"PP",41
30,"30013",7421,5171,5094,32,77,"PP",1001
15,"15040",2647,1779,1762,15,17,"PP",753
9,"9209",4404,2997,2950,31,47,"PP",994
44,"44045",360,271,271,0,0,"PP",66
22,"22063",161,128,126,0,2,"PP",30
34,"34045",72,62,62,0,0,"PP",35
44,"44138",120,92,92,0,0,"PP",22
19,"19103",247,205,202,1,3,"PP",70
16,"16085",131,106,106,0,0,"PP",34
28,"28111",629,479,475,2,4,"PP",104
37,"37036",55,36,34,0,2,"PP",24
28,"28067",4416,3359,3311,18,48,"PP",707
46,"46115",330,219,213,0,6,"PP",90
5,"5264",54,32,31,4,1,"PP",9
42,"42071",159,92,92,2,0,"PP",44
5,"5069",73,59,59,0,0,"PP",36
11,"11041",9869,6438,6295,100,143,"PP",1201
22,"22175",184,129,128,0,1,"PP",30
41,"41083",1145,821,814,6,7,"PP",103
37,"37236",123,85,82,1,3,"PP",27
22,"22064",155,100,100,2,0,"PP",27
13,"13015",5220,3665,3629,25,36,"PP",1231
10,"10158",344,247,246,7,1,"PP",46
4,"4072",311,212,211,0,1,"PP",64
5,"5265",83,59,58,1,1,"PP",22
11,"11042",1158,806,793,6,13,"PP",162
45,"45062",1075,816,808,11,8,"PP",308
4,"4903",4320,2907,2873,18,34,"PP",860
9,"9214",632,409,407,2,2,"PP",127
26,"26008",1821,1310,1290,15,20,"PP",487
10,"10036",304,194,192,4,2,"PP",40
13,"13016",656,463,454,3,9,"PP",143
5,"5072",92,74,72,1,2,"PP",33
9,"9215",359,217,216,2,1,"PP",76
9,"9266",97,71,68,1,3,"PP",17
50,"50091",39,32,32,0,0,"PP",16
44,"44142",29,21,21,0,0,"PP",6
26,"26009",394,282,278,1,4,"PP",122
49,"49082",341,273,270,12,3,"PP",89
41,"41001",1558,1129,1104,6,25,"PP",194
37,"37143",384,273,273,2,0,"PP",98
12,"12080",1883,1472,1438,8,34,"PP",319
26,"26123",128,110,110,0,0,"PP",52
42,"42212",57,45,45,2,0,"PP",18
28,"28070",105,80,80,3,0,"PP",26
5,"5170",47,34,34,1,0,"PP",12
6,"6129",577,438,416,1,22,"PP",111
18,"18021",17929,12165,11949,139,216,"PP",2150
46,"46163",1883,1471,1460,8,11,"PP",277
47,"47050",3908,2713,2673,39,40,"PP",611
50,"50245",74,51,51,0,0,"PP",9
40,"40048",35,27,27,0,0,"PP",13
13,"13019",5101,3502,3468,33,34,"PP",962
19,"19107",306,245,244,0,1,"PP",74
10,"10161",81,50,50,0,0,"PP",10
9,"9217",342,240,237,1,3,"PP",86
6,"6130",185,152,149,0,3,"PP",31
19,"19070",65,45,45,0,0,"PP",15
26,"26084",7264,5130,5059,61,71,"PP",1855
9,"9434",1279,966,956,11,10,"PP",217
9,"9164",147,112,111,0,1,"PP",44
2,"2027",274,209,203,1,6,"PP",75
28,"28071",63,46,45,0,1,"PP",12
26,"26012",37,28,28,1,0,"PP",15
34,"34192",76,59,59,0,0,"PP",35
24,"24020",436,230,228,0,2,"PP",66
14,"14034",302,222,215,1,7,"PP",72
47,"47147",103,86,82,0,4,"PP",45
48,"48007",389,243,243,0,0,"PP",1
5,"5075",96,76,76,0,0,"PP",38
21,"21058",2567,1806,1766,32,40,"PP",196
34,"34243",323,243,239,1,4,"PP",117
34,"34052",164,127,125,1,2,"PP",64
46,"46187",1292,924,920,4,4,"PP",214
18,"18119",1708,1264,1240,7,24,"PP",311
12,"12082",9602,7323,7248,53,75,"PP",1805
15,"15046",6157,3965,3865,23,100,"PP",1595
13,"13067",334,279,271,2,8,"PP",63
43,"43155",22586,15295,15204,120,91,"PP",966
49,"49086",111,89,89,1,0,"PP",33
49,"49191",265,192,188,2,4,"PP",41
9,"9388",31,26,25,0,1,"PP",9
50,"50173",156,114,114,0,0,"PP",43
5,"5903",137,84,83,0,1,"PP",29
40,"40051",34,25,25,0,0,"PP",11
34,"34053",194,156,154,3,2,"PP",68
19,"19109",33,26,26,2,0,"PP",13
3,"3121",21997,14689,14572,103,117,"PP",3929
30,"30018",8399,6226,6148,28,78,"PP",1545
47,"47149",46,33,32,1,1,"PP",8
5,"5077",154,113,110,0,3,"PP",46
42,"42082",8,8,8,0,0,"PP",5
37,"37044",431,309,308,3,1,"PP",126
45,"45179",493,362,357,5,5,"PP",146
15,"15048",5087,3426,3383,40,43,"PP",1050
4,"4079",54675,35691,35365,328,326,"PP",8810
24,"24022",304,198,195,2,3,"PP",70
6,"6136",1489,1086,1060,11,26,"PP",246
5,"5008",202,158,155,0,3,"PP",67
5,"5174",62,51,51,1,0,"PP",25
10,"10044",1405,968,955,11,13,"PP",152
13,"13071",37945,24340,24091,227,249,"PP",5170
37,"37305",219,177,175,2,2,"PP",62
37,"37148",399,295,291,0,4,"PP",129
5,"5078",95,78,78,2,0,"PP",43
10,"10167",301,198,198,0,0,"PP",77
21,"21061",5083,3325,3255,36,70,"PP",659
34,"34204",50,35,35,0,0,"PP",25
6,"6001",664,474,460,3,14,"PP",100
41,"41034",23576,15461,15214,264,247,"PP",1874
16,"16170",646,451,449,5,2,"PP",133
26,"26016",28,20,18,0,2,"PP",7
22,"22075",116,71,69,1,2,"PP",11
42,"42084",20,15,15,0,0,"PP",9
24,"24024",636,407,403,6,4,"PP",152
43,"43079",364,290,289,2,1,"PP",9
9,"9391",347,247,246,2,1,"PP",98
28,"28152",16986,13444,13366,111,78,"PP",4302
37,"37275",98,67,67,0,0,"PP",27
32,"32019",11469,7336,7225,98,111,"PP",3054
6,"6139",498,402,395,4,7,"PP",78
43,"43080",230,192,192,2,0,"PP",7
37,"37149",60,50,50,0,0,"PP",37
24,"24133",357,256,256,1,0,"PP",96
28,"28076",432,330,327,4,3,"PP",87
22,"22076",285,207,203,4,4,"PP",61
42,"42085",179,107,106,2,1,"PP",56
43,"43002",1890,1233,1210,12,23,"PP",72
30,"30021",9498,6251,6193,36,58,"PP",1891
39,"39066",866,616,606,6,10,"PP",137
41,"41008",1044,788,766,3,22,"PP",66
10,"10047",938,710,694,1,16,"PP",120
10,"10130",1754,1199,1189,10,10,"PP",265
47,"47088",101,79,79,0,0,"PP",27
3,"3067",91,78,78,0,0,"PP",20
6,"6004",1561,1130,1111,7,19,"PP",289
22,"22046",713,555,549,9,6,"PP",151
18,"18189",785,598,592,9,6,"PP",116
20,"20060",87,75,75,0,0,"PP",0
13,"13030",115,81,81,0,0,"PP",24
9,"9228",155,129,129,0,0,"PP",67
10,"10171",347,238,219,1,19,"PP",70
37,"37049",125,76,76,0,0,"PP",38
10,"10049",3752,2949,2864,25,85,"PP",786
32,"32022",1238,840,835,10,5,"PP",314
22,"22078",431,285,285,4,0,"PP",44
46,"46123",1926,1392,1368,11,24,"PP",286
28,"28155",487,374,369,0,5,"PP",109
2,"2035",1946,1494,1473,5,21,"PP",388
50,"50025",4541,3110,3083,39,27,"PP",835
37,"37050",66,52,52,1,0,"PP",18
22,"22189",175,142,142,1,0,"PP",34
3,"3127",350,260,255,1,5,"PP",72
32,"32023",1130,787,782,2,5,"PP",345
21,"21065",259,178,175,0,3,"PP",64
10,"10172",696,447,443,5,4,"PP",124
19,"19008",36,30,30,0,0,"PP",7
26,"26021",2742,1967,1932,14,35,"PP",738
23,"23028",6103,4369,4286,26,83,"PP",948
15,"15054",31805,19579,19321,335,258,"PP",4885
44,"44237",367,267,262,0,5,"PP",104
41,"41038",102752,71545,70538,980,1007,"PP",9641
50,"50100",304,215,212,1,3,"PP",63
42,"42089",57,44,43,0,1,"PP",18
47,"47155",3454,2445,2405,26,40,"PP",507
24,"24139",2071,1371,1346,15,25,"PP",473
18,"18032",247,164,163,1,1,"PP",40
37,"37342",250,190,189,3,1,"PP",67
43,"43005",3677,2505,2493,17,12,"PP",149
15,"15055",4446,2829,2762,50,67,"PP",705
49,"49095",282,202,201,6,1,"PP",59
14,"14042",18695,13788,13514,206,274,"PP",2632
36,"36021",12180,8188,8058,115,130,"PP",2263
42,"42185",24,20,20,0,0,"PP",10
3,"3042",1475,1053,1043,7,10,"PP",282
50,"50179",255,197,197,0,0,"PP",68
24,"24141",96,74,74,0,0,"PP",16
9,"9403",103,79,78,1,1,"PP",42
12,"12008",228,195,194,1,1,"PP",73
5,"5181",46,34,34,0,0,"PP",10
37,"37052",287,192,191,2,1,"PP",81
9,"9232",139,100,97,1,3,"PP",36
19,"19117",1632,1187,1167,12,20,"PP",151
10,"10054",523,389,380,1,9,"PP",97
46,"46148",1515,1131,1113,5,18,"PP",248
19,"19214",74,51,51,0,0,"PP",18
43,"43111",2129,1412,1401,8,11,"PP",107
45,"45004",546,400,398,2,2,"PP",113
2,"2038",262,197,193,0,4,"PP",73
42,"42093",36,28,28,1,0,"PP",12
43,"43085",237,190,185,1,5,"PP",4
50,"50180",107,85,85,1,0,"PP",28
26,"26024",204,157,156,1,1,"PP",68
34,"34067",129,80,78,1,2,"PP",17
19,"19184",59,47,47,0,0,"PP",26
9,"9236",34,25,25,1,0,"PP",18
10,"10055",697,488,473,3,15,"PP",160
19,"19306",24,18,18,0,0,"PP",13
40,"40060",67,40,40,1,0,"PP",30
45,"45042",172,122,121,0,1,"PP",46
50,"50230",1140,771,767,11,4,"PP",203
2,"2040",548,476,474,1,2,"PP",163
24,"24144",621,419,412,4,7,"PP",141
15,"15057",12077,8109,8018,83,91,"PP",2835
23,"23032",529,427,419,5,8,"PP",58
5,"5086",76,58,58,1,0,"PP",30
12,"12010",232,191,187,3,4,"PP",45
27,"27060",2434,1458,1434,17,24,"PP",609
9,"9407",25,19,17,0,2,"PP",5
43,"43008",305,171,171,7,0,"PP",27
44,"44155",1063,779,778,3,1,"PP",97
34,"34217",1269,999,983,14,16,"PP",262
45,"45153",1568,1168,1162,8,6,"PP",319
49,"49099",96,67,67,0,0,"PP",20
3,"3045",216,176,172,1,4,"PP",65
19,"19119",76,65,65,0,0,"PP",13
44,"44241",500,361,357,0,4,"PP",89
36,"36025",2127,1235,1221,5,14,"PP",584
9,"9409",117,80,80,0,0,"PP",16
39,"39074",7050,5074,5029,26,45,"PP",1475
48,"48907",343,274,273,0,1,"PP",0
5,"5055",532,417,413,3,4,"PP",184
50,"50079",226,162,160,1,2,"PP",48
26,"26064",2335,1617,1584,28,33,"PP",520
44,"44215",167,113,113,2,0,"PP",15
44,"44156",47,31,31,0,0,"PP",10
36,"36026",19890,13041,12891,169,150,"PP",4659
5,"5121",263,194,189,1,5,"PP",74
44,"44100",177,136,135,1,1,"PP",22
47,"47161",3970,3111,3089,24,22,"PP",1140
16,"16236",857,615,608,1,7,"PP",224
49,"49170",99,68,68,1,0,"PP",25
12,"12068",41,22,21,0,1,"PP",8
46,"46151",757,560,552,2,8,"PP",105
23,"23035",1111,877,856,2,21,"PP",215
40,"40063",6913,4948,4838,57,110,"PP",1398
49,"49101",144,88,82,1,6,"PP",41
43,"43010",334,262,262,2,0,"PP",11
45,"45083",568,433,429,2,4,"PP",138
13,"13042",880,638,626,2,12,"PP",157
9,"9079",47,38,38,0,0,"PP",32
12,"12094",871,671,661,1,10,"PP",90
44,"44065",55,33,32,0,1,"PP",17
50,"50031",134,78,75,0,3,"PP",22
23,"23037",518,403,398,10,5,"PP",64
27,"27063",1699,1131,1109,7,22,"PP",437
37,"37059",117,95,95,3,0,"PP",29
48,"48909",201,158,157,0,1,"PP",0
49,"49102",182,130,130,2,0,"PP",55
9,"9356",43,31,30,0,1,"PP",13
19,"19018",142,112,112,1,0,"PP",36
22,"22124",183,119,119,0,0,"PP",28
21,"21073",1902,1073,1043,13,30,"PP",291
36,"36028",4049,2783,2739,22,44,"PP",1036
37,"37162",212,139,137,3,2,"PP",49
3,"3048",4993,3549,3502,13,47,"PP",1049
23,"23072",1879,1389,1363,3,26,"PP",351
26,"26031",95,83,83,0,0,"PP",36
5,"5092",145,111,107,1,4,"PP",36
41,"41091",539590,389351,384943,4676,4408,"PP",84000
6,"6156",1170,829,814,12,15,"PP",234
26,"26107",86,65,64,1,1,"PP",26
18,"18069",484,356,356,5,0,"PP",108
50,"50032",243,167,164,3,3,"PP",37
43,"43091",125,90,90,1,0,"PP",2
50,"50108",50,37,37,0,0,"PP",15
29,"29065",191,145,143,3,2,"PP",27
28,"28165",1917,1339,1321,2,18,"PP",371
40,"40068",22,21,21,0,0,"PP",15
24,"24039",1949,1420,1412,33,8,"PP",477
12,"12096",732,526,519,4,7,"PP",102
45,"45086",483,339,332,0,7,"PP",97
50,"50260",35,31,31,0,0,"PP",16
9,"9248",80,62,61,1,1,"PP",24
45,"45197",1888,1446,1426,5,20,"PP",422
41,"41019",4931,3323,3251,39,72,"PP",543
9,"9084",165,116,111,1,5,"PP",50
40,"40069",68,59,59,0,0,"PP",30
29,"29038",18908,12122,11931,197,191,"PP",1836
18,"18040",237,146,145,0,1,"PP",32
47,"47165",6823,4999,4906,48,93,"PP",1515
4,"4096",285,222,222,0,0,"PP",76
37,"37164",232,176,175,3,1,"PP",41
13,"13048",495,392,391,4,1,"PP",138
42,"42106",13,11,11,0,0,"PP",5
9,"9249",47,35,35,3,0,"PP",10
23,"23041",489,378,376,1,2,"PP",97
23,"23004",407,321,315,2,6,"PP",53
9,"9086",652,479,471,3,8,"PP",148
9,"9417",42,31,31,1,0,"PP",19
22,"22204",1117,728,723,14,5,"PP",232
48,"48053",926,704,702,6,2,"PP",97
42,"42107",70,48,47,1,1,"PP",18
43,"43014",14386,9542,9464,74,78,"PP",511
28,"28167",8640,6564,6504,51,60,"PP",1065
50,"50187",55,42,42,0,0,"PP",14
44,"44161",428,294,292,2,2,"PP",97
12,"12016",1549,1244,1234,9,10,"PP",355
9,"9088",63,31,30,0,1,"PP",9
14,"14052",9039,5579,5478,79,101,"PP",1160
34,"34080",5231,3207,3161,35,46,"PP",1081
28,"28168",1347,933,918,6,15,"PP",225
10,"10067",10210,7090,6946,62,144,"PP",2029
47,"47167",245,198,198,1,0,"PP",81
50,"50111",181,130,130,1,0,"PP",30
3,"3052",959,747,735,4,12,"PP",272
6,"6025",5083,3543,3469,28,74,"PP",950
46,"46251",2465,1938,1903,19,35,"PP",463
49,"49109",561,419,415,6,4,"PP",180
44,"44163",115,79,78,0,1,"PP",17
18,"18043",129,74,71,0,3,"PP",22
45,"45201",3692,2198,2175,15,23,"PP",344
26,"26152",27,20,20,1,0,"PP",7
40,"40072",224,175,171,1,4,"PP",33
9,"9090",49,41,39,2,2,"PP",21
43,"43095",2583,1864,1854,12,10,"PP",131
28,"28169",1577,1214,1209,7,5,"PP",304
40,"40170",1302,962,948,6,14,"PP",344
47,"47073",116,80,79,2,1,"PP",42
15,"15068",4824,2976,2937,54,39,"PP",897
46,"46202",17801,13010,12906,87,104,"PP",2685
5,"5097",464,309,305,0,4,"PP",133
1,"1002",8014,5838,5786,24,52,"PP",338
10,"10192",777,567,563,3,4,"PP",203
24,"24156",220,135,133,0,2,"PP",58
24,"24046",893,595,583,6,12,"PP",174
2,"2084",298,197,191,2,6,"PP",47
44,"44251",239,187,183,1,4,"PP",77
50,"50239",63,46,45,1,1,"PP",21
23,"23045",2054,1423,1412,10,11,"PP",206
13,"13054",4870,3630,3575,26,55,"PP",1404
50,"50264",151,111,110,0,1,"PP",20
48,"48028",682,551,548,3,3,"PP",2
36,"36035",14615,10011,9880,103,131,"PP",3003
14,"14055",18411,13054,12798,192,256,"PP",2913
46,"46067",1753,1356,1341,8,15,"PP",335
44,"44252",73,56,55,0,1,"PP",18
9,"9257",85,67,67,2,0,"PP",31
48,"48915",339,245,243,0,2,"PP",5
19,"19024",8561,6015,5942,44,73,"PP",1069
26,"26154",10,10,9,1,1,"PP",5
43,"43018",384,297,297,2,0,"PP",3
19,"19322",26,20,19,1,1,"PP",6
2,"2053",2888,2086,2042,14,44,"PP",474
9,"9258",165,128,127,0,1,"PP",61
37,"37263",339,215,210,0,5,"PP",74
47,"47075",4772,3557,3512,34,45,"PP",1270
9,"9208",176,121,120,4,1,"PP",59
26,"26117",2105,1537,1500,17,37,"PP",585
18,"18912",1352,926,912,7,14,"PP",142
12,"12101",354,274,270,5,4,"PP",78
4,"4102",14202,9264,9139,57,125,"PP",2020
22,"22209",161,121,121,3,0,"PP",18
19,"19132",86,65,63,0,2,"PP",25
34,"34086",102,81,81,2,0,"PP",29
6,"6031",462,285,280,2,5,"PP",83
20,"20079",18151,13106,13054,58,52,"PP",606
37,"37358",159,124,124,0,0,"PP",58
46,"46068",345,283,279,2,4,"PP",60
41,"41026",4302,3355,3288,26,67,"PP",179
34,"34087",125,99,99,2,0,"PP",53
48,"48030",591,449,447,2,2,"PP",2
22,"22002",99,81,81,0,0,"PP",28
19,"19228",27,17,17,1,0,"PP",1
43,"43098",362,274,274,1,0,"PP",10
10,"10115",3460,2584,2503,15,81,"PP",736
48,"48059",402,299,297,0,2,"PP",6
12,"12050",1226,904,891,3,13,"PP",219
14,"14057",6157,4773,4707,59,66,"PP",1007
37,"37297",394,298,297,0,1,"PP",128
36,"36038",66807,46235,45781,493,454,"PP",13097
45,"45097",1037,834,819,7,15,"PP",216
12,"12103",87,61,60,0,1,"PP",25
9,"9428",102,73,73,1,0,"PP",34
19,"19325",154,86,86,1,0,"PP",51
22,"22212",69,52,52,1,0,"PP",8
5,"5103",63,44,44,1,0,"PP",24
41,"41027",4007,2628,2546,33,82,"PP",379
18,"18147",3655,2273,2241,16,32,"PP",510
28,"28175",940,740,730,2,10,"PP",174
24,"24052",139,94,93,0,1,"PP",23
9,"9429",53,34,34,1,0,"PP",16
46,"46138",361,289,287,1,2,"PP",67
6,"6035",851,630,620,0,10,"PP",236
50,"50117",123,93,93,4,0,"PP",33
28,"28007",127491,96937,96102,810,835,"PP",21861
37,"37172",846,530,524,6,6,"PP",192
46,"46070",17824,12888,12802,106,86,"PP",3026
3,"3031",42046,25035,24819,168,216,"PP",6735
34,"34091",118,82,82,1,0,"PP",42
19,"19135",90,71,69,1,2,"PP",31
9,"9103",200,168,166,1,2,"PP",70
5,"5104",33,21,19,0,2,"PP",12
46,"46002",1253,946,940,4,6,"PP",185
37,"37361",84,55,54,1,1,"PP",32
46,"46025",2445,1875,1853,16,22,"PP",371
34,"34240",84,67,66,1,1,"PP",25
18,"18049",588,418,415,4,3,"PP",113
50,"50268",41,32,32,1,0,"PP",5
43,"43021",349,245,243,2,2,"PP",9
9,"9267",117,95,93,1,2,"PP",53
49,"49007",361,241,233,7,8,"PP",64
6,"6037",1656,1033,1018,8,15,"PP",311
44,"44171",176,115,115,0,0,"PP",21
16,"16088",100,86,86,0,0,"PP",24
12,"12025",116,82,79,1,3,"PP",23
23,"23052",1094,920,896,6,24,"PP",226
24,"24054",410,275,271,0,4,"PP",104
15,"15075",12871,8751,8637,129,114,"PP",2502
28,"28177",10851,8550,8485,89,65,"PP",2324
37,"37174",975,716,705,2,11,"PP",275
7,"7007",416,277,275,4,2,"PP",53
49,"49009",382,251,251,0,0,"PP",119
20,"20902",14282,9670,9618,52,52,"PP",742
37,"37077",251,206,204,1,2,"PP",66
16,"16206",184,126,125,4,1,"PP",45
2,"2059",320,225,217,0,8,"PP",45
22,"22215",127,81,81,0,0,"PP",22
2,"2060",1268,953,939,7,14,"PP",362
42,"42171",111,72,71,1,1,"PP",39
45,"45102",3613,2495,2464,27,31,"PP",694
19,"19037",131,109,108,0,1,"PP",34
44,"44173",103,81,79,0,2,"PP",22
39,"39005",1419,1039,1030,9,9,"PP",326
46,"46209",1903,1406,1383,5,23,"PP",282
37,"37364",760,502,500,0,2,"PP",208
39,"39006",1729,1207,1192,1,15,"PP",424
24,"24165",317,202,199,1,3,"PP",56
9,"9270",157,112,109,2,3,"PP",50
19,"19038",19,16,15,0,1,"PP",4
46,"46004",1932,1530,1512,10,18,"PP",318
4,"4043",517,398,395,1,3,"PP",79
50,"50069",66,33,33,1,0,"PP",7
45,"45103",363,286,283,0,3,"PP",113
5,"5140",99,83,81,0,2,"PP",36
24,"24166",1346,929,916,14,13,"PP",263
29,"29067",431757,290824,287855,3289,2969,"PP",62818
18,"18086",338,253,247,1,6,"PP",22
28,"28180",5317,4011,3959,35,52,"PP",766
9,"9438",562,447,437,6,10,"PP",154
34,"34098",790,562,558,3,4,"PP",174
46,"46005",23129,16610,16437,148,173,"PP",2923
37,"37177",259,198,197,3,1,"PP",82
14,"14064",296,211,208,6,3,"PP",56
49,"49012",70,34,34,0,0,"PP",10
37,"37272",132,97,95,0,2,"PP",37
9,"9439",1061,801,790,2,11,"PP",206
37,"37080",221,164,163,1,1,"PP",50
26,"26050",125,92,91,1,1,"PP",49
1,"1018",1399,953,947,1,6,"PP",92
24,"24058",189,115,114,1,1,"PP",54
37,"37178",98,70,70,0,0,"PP",34
38,"38036",6857,4170,4090,37,80,"PP",591
10,"10206",196,135,133,0,2,"PP",40
14,"14065",1820,1374,1352,13,22,"PP",313
37,"37367",179,147,143,2,4,"PP",77
44,"44087",67,52,50,0,2,"PP",20
28,"28013",41661,29431,29168,241,263,"PP",6344
18,"18120",266,204,204,4,0,"PP",28
49,"49122",761,517,505,7,12,"PP",133
19,"19040",53,43,42,1,1,"PP",9
20,"20057",198,148,147,1,1,"PP",1
9,"9062",40,34,33,0,1,"PP",13
24,"24169",2777,1908,1880,10,28,"PP",389
10,"10086",304,228,225,4,3,"PP",69
22,"22110",700,476,473,3,3,"PP",145
6,"6045",467,347,346,6,1,"PP",91
9,"9115",90,65,63,3,2,"PP",33
36,"36046",4073,2887,2818,31,69,"PP",979
19,"19176",227,172,172,0,0,"PP",66
46,"46166",8214,6093,6031,38,62,"PP",1277
48,"48039",254,221,220,2,1,"PP",5
34,"34101",48,36,36,1,0,"PP",17
20,"20907",118,82,82,0,0,"PP",1
14,"14066",5748,4116,4035,59,81,"PP",737
43,"43106",784,605,598,3,7,"PP",35
1,"1021",471,321,319,3,2,"PP",48
22,"22012",102,75,75,2,0,"PP",27
19,"19266",229,184,182,1,2,"PP",74
49,"49236",71,54,54,0,0,"PP",24
43,"43907",4386,3083,3067,24,16,"PP",239
32,"32056",1490,1009,1003,10,6,"PP",588
46,"46262",206,136,134,1,2,"PP",46
42,"42004",2290,1595,1565,30,30,"PP",534
46,"46076",610,500,494,1,6,"PP",196
23,"23059",5736,4245,4119,51,126,"PP",752
45,"45108",465,343,341,0,2,"PP",113
12,"12111",327,259,255,8,4,"PP",79
18,"18059",4265,2960,2886,23,74,"PP",397
41,"41036",3903,2708,2645,35,63,"PP",257
46,"46008",2617,1954,1931,17,23,"PP",328
12,"12032",23728,16870,16726,121,144,"PP",4009
37,"37083",181,155,153,1,2,"PP",41
29,"29072",3291,2360,2307,19,53,"PP",406
4,"4049",5711,3766,3732,25,34,"PP",916
9,"9339",128,106,105,0,1,"PP",43
46,"46077",7338,5447,5356,44,91,"PP",818
22,"22188",75,50,50,1,0,"PP",10
3,"3039",89,65,65,0,0,"PP",16
36,"36049",6990,4877,4787,40,90,"PP",1643
10,"10090",489,307,302,1,5,"PP",82
26,"26173",8,8,8,1,0,"PP",5
5,"5210",81,56,56,0,0,"PP",29
26,"26056",404,312,301,2,11,"PP",117
1,"1023",262,193,190,1,3,"PP",44
43,"43029",312,241,240,1,1,"PP",2
49,"49239",599,393,384,6,9,"PP",107
37,"37183",377,267,267,5,0,"PP",99
37,"37086",107,86,85,2,1,"PP",36
7,"7017",899,604,596,10,8,"PP",138
10,"10091",351,275,271,2,4,"PP",101
43,"43109",2706,1751,1738,17,13,"PP",122
24,"24173",896,590,583,2,7,"PP",217
20,"20001",253,163,163,1,0,"PP",0
42,"42135",69,40,40,1,0,"PP",17
50,"50126",2240,1528,1509,24,19,"PP",459
23,"23062",1410,1094,1076,0,18,"PP",299
42,"42139",21,16,16,2,0,"PP",10
50,"50128",26,23,23,0,0,"PP",10
46,"46147",17186,11507,11399,72,108,"PP",2711
19,"19241",35,26,25,2,1,"PP",13
5,"5116",96,68,68,0,0,"PP",38
19,"19080",67,47,47,0,0,"PP",22
19,"19150",116,89,89,0,0,"PP",28
42,"42009",77,58,58,0,0,"PP",30
47,"47185",82,62,61,1,1,"PP",23
40,"40188",83,63,60,0,3,"PP",26
29,"29074",771,561,555,1,6,"PP",110
43,"43110",247,178,178,2,0,"PP",6
50,"50203",1065,817,804,5,13,"PP",139
42,"42140",15,11,11,1,0,"PP",6
46,"46903",6306,4762,4743,44,19,"PP",1091
22,"22227",200,140,140,2,0,"PP",26
5,"5213",94,72,70,0,2,"PP",38
43,"43083",146,110,109,0,1,"PP",20
47,"47091",76,60,59,2,1,"PP",17
19,"19046",22204,16001,15752,156,249,"PP",2713
41,"41040",11183,8351,8253,71,98,"PP",1986
16,"16227",109,78,76,0,2,"PP",31
34,"34109",60,34,34,0,0,"PP",20
50,"50204",2396,1723,1712,17,11,"PP",255
22,"22115",348,263,261,3,2,"PP",92
44,"44094",127,103,103,0,0,"PP",43
42,"42011",16,11,11,0,0,"PP",4
15,"15087",5710,3436,3392,31,44,"PP",1021
9,"9347",140,111,107,1,4,"PP",37
44,"44123",95,68,68,0,0,"PP",25
34,"34020",49,37,37,1,0,"PP",10
21,"21037",462,320,313,1,7,"PP",40
50,"50129",212,129,127,0,2,"PP",29
48,"48073",6827,4614,4591,38,23,"PP",100
19,"19243",34,32,31,1,1,"PP",11
6,"6056",447,351,340,2,11,"PP",86
18,"18064",366,289,286,0,3,"PP",55
29,"29003",916,677,666,4,11,"PP",104
13,"13036",752,552,546,1,6,"PP",180
29,"29076",2354,1498,1444,21,54,"PP",212
37,"37090",68,47,47,0,0,"PP",26
50,"50130",354,225,222,1,3,"PP",50
19,"19153",22,20,20,2,0,"PP",0
37,"37187",548,407,399,0,8,"PP",145
26,"26141",98,70,70,0,0,"PP",45
10,"10097",107,84,80,0,4,"PP",18
7,"7021",229,154,150,3,4,"PP",52
42,"42144",419,302,298,6,4,"PP",87
19,"19244",74,55,55,3,0,"PP",23
9,"9130",64,39,39,2,0,"PP",19
44,"44006",220,152,151,1,1,"PP",52
48,"48046",12626,9300,9250,31,50,"PP",265
3,"3073",222,178,178,0,0,"PP",47
28,"28023",5159,4052,4019,27,33,"PP",935
9,"9295",52,36,35,1,1,"PP",19
15,"15089",4299,2924,2887,41,37,"PP",1207
37,"37091",161,104,104,0,0,"PP",62
16,"16104",53,42,42,0,0,"PP",8
24,"24179",287,207,207,2,0,"PP",112
7,"7023",3776,2425,2386,34,39,"PP",587
49,"49246",214,183,180,3,3,"PP",110
21,"21009",834,527,508,4,19,"PP",85
13,"13085",2265,1768,1735,5,33,"PP",525
9,"9132",170,121,120,0,1,"PP",54
37,"37092",1933,1342,1327,13,15,"PP",325
50,"50132",780,549,538,7,11,"PP",109
5,"5217",54,42,41,0,1,"PP",12
44,"44007",149,112,111,1,1,"PP",46
20,"20037",101,69,69,0,0,"PP",0
5,"5021",1861,1323,1304,22,19,"PP",498
45,"45008",144,112,110,1,2,"PP",31
46,"46014",3156,2324,2294,13,30,"PP",526
19,"19278",24,20,20,0,0,"PP",15
3,"3133",41333,24527,24340,146,187,"PP",6487
32,"32067",1189,696,692,4,4,"PP",340
34,"34220",152,133,132,1,1,"PP",45
12,"12093",161,111,109,2,2,"PP",29
37,"37253",135,109,109,1,0,"PP",36
5,"5155",46,33,31,1,2,"PP",10
44,"44008",1556,1109,1100,7,9,"PP",264
5,"5218",104,81,79,0,2,"PP",35
36,"36057",238417,165843,164264,1641,1579,"PP",36865
24,"24181",1404,944,925,7,19,"PP",298
21,"21011",3500,2371,2314,23,57,"PP",420
19,"19247",140,103,102,1,1,"PP",20
24,"24073",437,285,282,1,3,"PP",92
36,"36058",4957,3043,2994,55,49,"PP",885
45,"45120",113,86,86,0,0,"PP",17
49,"49135",576,368,366,3,2,"PP",128
18,"18167",1839,1243,1224,9,19,"PP",215
42,"42152",67,47,44,1,3,"PP",17
28,"28099",1950,1409,1404,16,5,"PP",388
42,"42017",131,99,96,1,3,"PP",23
46,"46084",1487,1136,1123,4,13,"PP",305
1,"1039",188,150,147,2,3,"PP",17
23,"23071",1704,1278,1258,10,20,"PP",285
37,"37161",123,86,86,0,0,"PP",36
19,"19052",21,16,16,0,0,"PP",1
27,"27002",1535,990,968,13,22,"PP",357
49,"49137",167,123,121,0,2,"PP",59
41,"41046",3005,2241,2198,11,43,"PP",206
37,"37350",403,281,274,1,7,"PP",126
29,"29082",34683,24751,24495,263,256,"PP",5815
24,"24183",748,464,460,9,4,"PP",124
47,"47098",567,452,446,4,6,"PP",147
46,"46153",443,353,349,2,4,"PP",51
50,"50259",82,55,55,2,0,"PP",27
6,"6110",138,105,102,0,3,"PP",29
37,"37026",180,148,147,5,1,"PP",38
42,"42057",145,70,70,0,0,"PP",39
26,"26147",34,26,25,0,1,"PP",7
39,"39077",237,151,148,1,3,"PP",56
6,"6065",293,230,228,2,2,"PP",101
28,"28028",1836,1374,1363,3,11,"PP",283
43,"43117",147,119,119,0,0,"PP",13
50,"50135",85,59,59,0,0,"PP",20
5,"5125",56,47,46,0,1,"PP",17
37,"37287",297,204,202,2,2,"PP",82
46,"46222",402,329,326,0,3,"PP",38
37,"37194",229,161,160,0,1,"PP",53
16,"16111",168,114,111,2,3,"PP",33
22,"22024",220,159,158,1,1,"PP",28
21,"21014",4066,3089,3029,30,60,"PP",658
13,"13093",3901,2617,2569,16,48,"PP",819
40,"40198",24,20,19,0,1,"PP",11
50,"50285",657,448,442,4,6,"PP",109
49,"49139",149,112,112,0,0,"PP",39
50,"50136",532,366,361,3,5,"PP",124
16,"16112",1466,972,957,12,15,"PP",354
49,"49252",312,240,236,7,4,"PP",83
37,"37100",74,59,58,1,1,"PP",31
37,"37289",210,147,144,0,3,"PP",64
24,"24152",433,269,267,4,2,"PP",112
29,"29085",138,98,93,1,5,"PP",14
46,"46087",109,94,94,2,0,"PP",24
16,"16242",300,245,243,2,2,"PP",126
22,"22236",232,190,188,2,2,"PP",53
46,"46018",562,442,436,2,6,"PP",138
3,"3079",18422,13560,13378,152,182,"PP",3236
47,"47197",875,659,656,9,3,"PP",203
19,"19057",69,51,51,0,0,"PP",5
45,"45126",234,146,144,2,2,"PP",32
34,"34126",248,177,176,3,1,"PP",88
24,"24079",861,601,595,9,6,"PP",236
7,"7030",1598,1127,1098,14,29,"PP",240
9,"9308",58,34,34,1,0,"PP",9
26,"26071",8644,5668,5591,53,77,"PP",1579
28,"28104",15528,12342,12234,103,108,"PP",2886
43,"43120",421,256,254,1,2,"PP",25
42,"42158",97,73,73,1,0,"PP",25
50,"50212",32,26,26,0,0,"PP",2
24,"24188",3795,2877,2825,40,52,"PP",918
20,"20014",1161,699,693,0,6,"PP",15
42,"42024",84,64,62,1,2,"PP",26
23,"23077",604,482,477,2,5,"PP",108
43,"43041",216,156,156,2,0,"PP",17
50,"50286",75,54,53,0,1,"PP",12
6,"6071",238,192,187,2,5,"PP",43
46,"46156",2017,1538,1524,9,14,"PP",442
37,"37291",269,186,185,1,1,"PP",57
6,"6072",2211,1610,1586,11,24,"PP",401
49,"49143",201,119,118,1,1,"PP",57
47,"47103",252,195,192,1,3,"PP",50
24,"24081",121,72,72,0,0,"PP",45
35,"35012",10862,5617,5568,40,49,"PP",1200
15,"15005",25347,15441,15211,226,230,"PP",3813
37,"37103",409,295,294,2,1,"PP",108
49,"49145",208,113,113,1,0,"PP",52
50,"50062",1885,1332,1308,15,24,"PP",275
47,"47199",71,57,57,2,0,"PP",22
9,"9312",89,68,68,1,0,"PP",29
22,"22243",43,32,31,0,1,"PP",7
44,"44164",19,16,16,1,0,"PP",8
28,"28032",5090,3716,3675,22,41,"PP",687
1,"1003",1166,843,837,6,6,"PP",3
5,"5227",341,230,228,1,2,"PP",82
15,"15006",5159,3008,2960,44,48,"PP",1151
50,"50902",77,65,62,0,3,"PP",29
16,"16117",1018,723,715,9,8,"PP",210
39,"39026",1702,1160,1151,11,9,"PP",339
7,"7033",28539,15238,15070,187,168,"PP",3249
2,"2085",306,232,226,2,6,"PP",84
26,"26076",115,83,83,0,0,"PP",33
39,"39027",3045,2231,2199,23,32,"PP",590
9,"9482",34,22,22,0,0,"PP",10
12,"12125",215,179,179,2,0,"PP",62
24,"24191",106,70,69,2,1,"PP",29
7,"7034",1074,796,779,9,17,"PP",225
16,"16248",862,710,700,6,10,"PP",212
16,"16006",113,100,100,1,0,"PP",18
24,"24193",363,264,264,1,0,"PP",77
42,"42162",2298,1493,1462,18,31,"PP",662
11,"11008",17923,11702,11464,192,238,"PP",1707
32,"32079",1280,880,869,13,11,"PP",336
44,"44017",269,217,216,0,1,"PP",41
13,"13904",496,353,342,5,11,"PP",102
2,"2086",2389,1567,1554,10,13,"PP",421
43,"43123",71435,49166,48873,318,293,"PP",4146
38,"38005",5646,3302,3283,24,19,"PP",427
46,"46227",893,687,675,6,12,"PP",81
9,"9316",104,80,80,0,0,"PP",33
1,"1052",272,189,186,2,3,"PP",11
37,"37296",297,215,210,0,5,"PP",85
44,"44196",121,88,88,0,0,"PP",16
50,"50290",360,260,255,5,5,"PP",63
48,"48058",947,682,679,2,3,"PP",14
3,"3085",271,229,227,5,2,"PP",78
5,"5133",61,44,43,0,1,"PP",21
47,"47204",235,159,157,3,2,"PP",56
29,"29091",9490,6428,6304,61,124,"PP",1546
43,"43071",896,652,647,3,5,"PP",66
15,"15041",9569,6362,6269,104,93,"PP",2394
32,"32007",1413,873,862,2,11,"PP",344
6,"6079",649,451,445,3,6,"PP",99
3,"3001",337,260,258,0,2,"PP",82
7,"7037",3448,1875,1856,18,19,"PP",413
50,"50065",56,37,37,0,0,"PP",8
14,"14002",10895,7599,7479,109,120,"PP",1129
24,"24196",1907,1322,1299,4,23,"PP",359
37,"37109",178,127,126,0,1,"PP",65
19,"19169",30,27,27,0,0,"PP",3
5,"5134",47,40,40,0,0,"PP",30
47,"47016",65,55,55,0,0,"PP",25
35,"35016",300581,181532,179831,1458,1701,"PP",41608
12,"12128",1365,990,972,16,18,"PP",176
46,"46024",454,343,339,1,4,"PP",86
29,"29092",576,375,366,7,9,"PP",41
46,"46229",903,715,708,5,7,"PP",152
43,"43047",4234,2590,2564,19,26,"PP",222
24,"24088",996,750,745,9,5,"PP",279
47,"47111",1001,738,732,5,6,"PP",207
9,"9323",57,37,36,0,1,"PP",19
3,"3117",377,306,302,2,4,"PP",75
22,"22213",2918,2084,2062,20,22,"PP",475
44,"44141",122,88,85,0,3,"PP",25
15,"15043",4944,3184,3117,27,67,"PP",1049
40,"40014",56,39,38,0,1,"PP",13
9,"9904",464,344,339,3,5,"PP",112
29,"29093",2150,1543,1520,8,23,"PP",296
5,"5038",114,83,82,0,1,"PP",33
10,"10159",314,207,207,2,0,"PP",41
28,"28038",5213,3801,3753,24,48,"PP",789
40,"40111",50,39,39,0,0,"PP",17
3,"3003",449,368,367,1,1,"PP",119
14,"14004",1963,1465,1437,15,28,"PP",345
3,"3089",9496,6617,6484,51,133,"PP",1543
45,"45025",1218,849,844,9,5,"PP",129
7,"7040",289448,169300,167908,1594,1392,"PP",35146
21,"21025",3886,2489,2431,31,58,"PP",561
22,"22248",103,73,73,0,0,"PP",15
42,"42033",50,48,48,2,0,"PP",26
16,"16011",20,14,14,0,0,"PP",3
23,"23015",1316,979,973,18,6,"PP",221
11,"11013",2352,1564,1522,13,42,"PP",219
47,"47208",53,35,35,1,0,"PP",15
16,"16254",199,159,159,0,0,"PP",56
18,"18084",4533,3233,3178,35,55,"PP",640
40,"40015",23,19,19,0,0,"PP",15
43,"43128",910,665,658,6,7,"PP",12
49,"49042",229,166,164,2,2,"PP",80
28,"28115",62612,50619,50431,399,188,"PP",20227
9,"9009",158,127,124,5,3,"PP",34
24,"24091",575,368,362,5,6,"PP",124
22,"22249",125,93,92,1,1,"PP",14
19,"19172",51,38,38,0,0,"PP",9
40,"40080",51,31,31,0,0,"PP",15
18,"18182",1926,1222,1204,8,18,"PP",256
41,"41058",17956,12890,12553,200,337,"PP",2643
1,"1059",189597,128849,127910,688,939,"PP",21259
43,"43129",4607,3284,3261,21,23,"PP",163
16,"16013",26,24,24,0,0,"PP",12
45,"45028",3613,2675,2647,22,28,"PP",695
50,"50093",87,66,64,1,2,"PP",21
15,"15015",2877,1845,1821,26,24,"PP",553
21,"21027",49,32,32,0,0,"PP",7
7,"7042",10846,6354,6299,77,55,"PP",1267
9,"9011",70,42,40,0,2,"PP",15
16,"16050",218,172,169,2,3,"PP",59
38,"38035",10518,5870,5819,37,51,"PP",1027
46,"46164",12145,8373,8248,44,125,"PP",1740
44,"44230",149,111,110,2,1,"PP",25
22,"22251",327,259,256,0,3,"PP",97
47,"47115",276,212,211,1,1,"PP",95
19,"19202",16,13,13,1,0,"PP",1
38,"38011",21655,13974,13831,106,143,"PP",2620
16,"16129",88,72,72,0,0,"PP",24
32,"32088",1636,955,944,17,11,"PP",357
4,"4044",1542,1092,1080,8,12,"PP",349
11,"11016",15079,9353,9192,137,161,"PP",1593
45,"45030",471,346,334,4,12,"PP",77
49,"49044",78,56,53,0,3,"PP",20
32,"32089",1206,740,726,8,14,"PP",335
48,"48065",3285,2341,2326,8,15,"PP",100
16,"16263",967,724,721,3,3,"PP",191
50,"50222",1574,1024,1008,12,16,"PP",198
3,"3007",173,141,139,0,2,"PP",24
37,"37012",144,111,111,0,0,"PP",49
50,"50296",385,240,235,3,5,"PP",21
44,"44146",164,133,133,2,0,"PP",34
20,"20026",207,172,171,4,1,"PP",0
23,"23093",3119,2264,2216,24,48,"PP",315
19,"19175",29,18,17,1,1,"PP",11
5,"5142",88,76,75,0,1,"PP",32
47,"47117",287,199,197,6,2,"PP",66
3,"3093",19702,13903,13728,113,175,"PP",2929
18,"18088",1526,1000,993,10,7,"PP",125
49,"49047",98,74,72,1,2,"PP",27
37,"37081",879,680,674,2,6,"PP",193
47,"47085",16330,11556,11419,121,137,"PP",3325
35,"35021",15072,9791,9696,80,95,"PP",2735
47,"47213",104,78,78,0,0,"PP",34
50,"50149",34,25,25,0,0,"PP",15
40,"40020",149,112,111,1,1,"PP",37
26,"26129",939,657,644,2,13,"PP",260
44,"44205",619,420,415,5,5,"PP",132
41,"41006",2733,1776,1742,17,34,"PP",263
45,"45070",1412,1158,1136,7,22,"PP",347
19,"19299",100,72,71,1,1,"PP",14
37,"37338",77,58,58,0,0,"PP",30
9,"9017",89,61,60,3,1,"PP",23
29,"29025",41540,27170,26897,271,273,"PP",5669
16,"16265",22,18,18,0,0,"PP",5
37,"37212",104,76,76,0,0,"PP",25
15,"15050",1732,931,917,15,14,"PP",320
5,"5176",221,163,159,0,4,"PP",37
5,"5079",66,53,52,0,1,"PP",27
34,"34152",124,99,94,0,5,"PP",41
7,"7047",2399,1504,1477,20,27,"PP",315
29,"29100",2379,1582,1551,22,31,"PP",248
16,"16019",187,141,141,1,0,"PP",67
35,"35023",11742,7787,7651,95,136,"PP",1800
40,"40021",18,15,15,0,0,"PP",7
42,"42178",99,71,71,0,0,"PP",33
3,"3095",4807,3453,3410,31,43,"PP",745
24,"24210",524,353,353,1,0,"PP",97
22,"22254",1084,744,735,10,9,"PP",218
16,"16269",378,287,285,2,2,"PP",115
47,"47026",50,37,37,1,0,"PP",20
11,"11020",166773,111205,109956,1580,1249,"PP",20318
2,"2067",1137,808,794,2,14,"PP",203
37,"37085",5060,3732,3689,52,43,"PP",1020
40,"40216",785,633,621,9,12,"PP",216
40,"40087",85,70,70,0,0,"PP",46
43,"43108",1787,1293,1282,6,11,"PP",83
41,"41065",22527,14684,14463,205,221,"PP",1784
16,"16270",154,123,122,1,1,"PP",52
47,"47216",111,94,91,0,3,"PP",31
20,"20030",21147,14598,14521,92,77,"PP",900
44,"44120",219,147,145,3,2,"PP",34
45,"45146",101,79,79,0,0,"PP",37
40,"40123",141,98,94,4,4,"PP",30
9,"9020",233,170,166,3,4,"PP",68
37,"37214",120,70,68,2,2,"PP",26
47,"47122",2007,1520,1492,8,28,"PP",479
26,"26095",93,71,68,0,3,"PP",11
37,"37121",536,413,403,4,10,"PP",124
44,"44208",27,17,17,0,0,"PP",3
29,"29902",2593,1561,1533,15,28,"PP",243
16,"16022",76,63,63,0,0,"PP",20
39,"39040",4271,3103,3080,18,23,"PP",822
19,"19269",86,61,61,0,0,"PP",7
16,"16271",612,482,481,3,1,"PP",163
45,"45037",1520,1072,1055,5,17,"PP",302
28,"28123",62178,49883,49515,397,368,"PP",7444
49,"49054",847,576,569,8,7,"PP",189
10,"10133",1159,914,893,4,21,"PP",98
15,"15022",5580,3508,3472,47,36,"PP",1031
6,"6007",1418,984,968,13,16,"PP",148
10,"10173",558,389,385,5,4,"PP",77
50,"50075",70,55,55,1,0,"PP",41
45,"45038",3528,2556,2521,26,35,"PP",486
2,"2003",134196,96374,95521,913,853,"PP",26588
18,"18096",340,227,226,0,1,"PP",36
22,"22048",12635,8889,8807,98,82,"PP",2581
10,"10011",518,385,370,2,15,"PP",70
37,"37088",199,135,133,0,2,"PP",51
9,"9023",1190,891,879,17,12,"PP",210
9,"9178",39,24,24,0,0,"PP",11
24,"24102",587,403,399,7,4,"PP",129
11,"11024",6550,4500,4402,67,98,"PP",857
24,"24214",626,438,433,8,5,"PP",135
45,"45039",201,157,157,0,0,"PP",47
22,"22904",751,516,511,3,5,"PP",165
5,"5149",101,72,71,2,1,"PP",37
48,"48016",5471,3964,3935,31,29,"PP",385
49,"49056",285,191,190,3,1,"PP",55
46,"46034",1826,1345,1335,3,10,"PP",227
38,"38018",4466,2867,2821,21,46,"PP",658
43,"43137",1890,1373,1353,8,20,"PP",83
19,"19082",100,72,71,1,1,"PP",6
26,"26139",58,43,43,2,0,"PP",25
14,"14043",7406,5323,5211,63,112,"PP",870
50,"50254",179,115,113,0,2,"PP",31
45,"45078",1333,1084,1077,6,7,"PP",329
45,"45040",1247,727,715,3,12,"PP",246
19,"19011",237,165,162,3,3,"PP",48
5,"5052",85,70,69,0,1,"PP",37
3,"3130",28,19,19,0,0,"PP",9
16,"16275",12,12,12,1,0,"PP",6
14,"14016",1273,936,922,5,14,"PP",210
49,"49021",14204,9429,9295,87,134,"PP",2717
21,"21038",1082,688,676,4,12,"PP",181
44,"44212",41,29,29,0,0,"PP",11
45,"45041",3967,2723,2689,18,34,"PP",524
37,"37313",535,395,394,1,1,"PP",154
50,"50231",253,199,195,4,4,"PP",48
44,"44097",126,76,73,0,3,"PP",13
39,"39044",3921,2805,2783,18,22,"PP",723
49,"49098",200,139,138,3,1,"PP",72
34,"34161",22,12,12,0,0,"PP",4
10,"10137",394,297,296,3,1,"PP",89
46,"46172",5488,3724,3674,26,50,"PP",725
27,"27028",78725,52642,51965,642,677,"PP",17097
16,"16027",691,500,495,1,5,"PP",122
18,"18099",1582,1184,1156,13,28,"PP",242
5,"5054",1192,871,856,6,15,"PP",273
16,"16276",20,17,17,1,0,"PP",7
2,"2007",1017,757,746,5,11,"PP",160
16,"16143",15,10,10,1,0,"PP",2
42,"42189",57,43,43,0,0,"PP",11
47,"47222",85,70,70,1,0,"PP",19
12,"12141",92,72,72,0,0,"PP",40
7,"7056",5271,3429,3386,44,43,"PP",738
40,"40128",123,88,87,1,1,"PP",24
4,"4057",1261,886,872,6,14,"PP",231
15,"15028",1392,944,936,4,8,"PP",201
34,"34165",57,45,44,1,1,"PP",33
49,"49061",143,98,97,1,1,"PP",31
35,"35029",4415,2498,2472,29,26,"PP",359
50,"50232",160,93,92,1,1,"PP",24
26,"26183",66,48,48,0,0,"PP",19
24,"24219",489,334,329,7,5,"PP",125
46,"46105",16126,10958,10847,76,111,"PP",2328
22,"22160",207,149,149,1,0,"PP",33
24,"24146",254,202,201,1,1,"PP",84
32,"32066",547,396,396,0,0,"PP",308
5,"5185",96,63,61,1,2,"PP",30
37,"37284",317,229,222,2,7,"PP",83
50,"50055",3635,2298,2244,36,54,"PP",530
43,"43062",269,229,226,5,3,"PP",20
50,"50006",913,670,654,13,16,"PP",140
10,"10141",284,207,205,1,2,"PP",56
5,"5252",56,46,45,0,1,"PP",24
7,"7058",2866,2013,1996,24,17,"PP",543
26,"26105",2188,1564,1536,24,28,"PP",509
19,"19187",42,32,32,0,0,"PP",9
18,"18006",4062,2765,2711,25,54,"PP",552
46,"46106",1471,1033,1028,8,5,"PP",249
42,"42055",158,113,113,1,0,"PP",45
12,"12901",3339,2583,2561,25,22,"PP",573
6,"6108",2238,1524,1478,15,46,"PP",313
47,"47131",167,122,120,2,2,"PP",33
46,"46243",124,93,90,1,3,"PP",30
9,"9191",33,23,23,1,0,"PP",13
10,"10020",1571,1135,1117,2,18,"PP",274
43,"43142",1069,783,774,3,9,"PP",24
19,"19188",36,31,31,0,0,"PP",10
32,"32069",4223,3064,3023,31,41,"PP",1023
41,"41017",15907,11486,11302,158,184,"PP",2189
16,"16189",264,196,194,4,2,"PP",75
43,"43063",544,376,374,2,2,"PP",30
49,"49173",335,165,163,4,2,"PP",85
9,"9192",54,46,45,1,1,"PP",15
37,"37225",97,78,74,0,4,"PP",35
3,"3020",94,84,84,1,0,"PP",22
7,"7060",2713,1796,1772,17,24,"PP",504
44,"44129",35,29,29,1,0,"PP",6
10,"10103",422,290,286,1,4,"PP",92
9,"9413",405,267,263,0,4,"PP",86
18,"18038",1042,782,760,5,22,"PP",116
12,"12013",135,106,106,1,0,"PP",28
13,"13090",1005,754,733,4,21,"PP",183
38,"38048",3952,2543,2519,22,24,"PP",473
49,"49065",1048,747,725,6,22,"PP",313
18,"18906",903,641,639,2,2,"PP",202
4,"4061",625,489,479,5,10,"PP",50
35,"35032",3331,2293,2252,23,41,"PP",832
18,"18010",527,398,394,5,4,"PP",49
44,"44218",28,24,24,3,0,"PP",12
49,"49174",127,86,85,1,1,"PP",36
46,"46108",420,328,324,1,4,"PP",110
28,"28058",141836,104142,103011,896,1131,"PP",15715
7,"7061",9451,5735,5666,60,69,"PP",1528
34,"34225",5016,3708,3650,41,58,"PP",926
50,"50082",82,57,57,0,0,"PP",17
43,"43065",379,281,277,4,4,"PP",5
45,"45051",1678,1238,1209,13,29,"PP",280
22,"22057",364,253,248,4,5,"PP",35
24,"24113",346,240,240,2,0,"PP",106
16,"16151",61,51,51,1,0,"PP",26
34,"34033",18,14,14,0,0,"PP",9
11,"11033",21804,13361,13133,213,228,"PP",2451
38,"38025",7065,4657,4590,34,67,"PP",816
44,"44105",68,53,53,0,0,"PP",13
50,"50236",95,77,75,0,2,"PP",36
37,"37133",101,73,69,1,4,"PP",23
49,"49176",605,360,353,0,7,"PP",214
47,"47228",432,324,320,2,4,"PP",97
2,"2015",1432,1163,1148,8,15,"PP",331
44,"44040",189,153,150,1,3,"PP",38
45,"45052",3132,2433,2416,29,17,"PP",533
28,"28060",1585,1160,1146,5,14,"PP",164
13,"13003",448,329,319,1,10,"PP",115
27,"27037",1001,714,707,11,7,"PP",379
43,"43146",40,32,32,0,0,"PP",1
7,"7063",1434,1025,1016,10,9,"PP",302
47,"47229",221,150,149,0,1,"PP",51
21,"21046",1729,1212,1187,14,25,"PP",299
5,"5258",107,80,80,1,0,"PP",34
10,"10026",647,464,452,6,12,"PP",105
28,"28061",22757,17091,16965,115,126,"PP",4184
23,"23005",29876,20565,20268,254,297,"PP",4714
34,"34176",127,95,90,3,5,"PP",45
50,"50011",117,90,89,3,1,"PP",16
7,"7064",5566,3232,3204,18,28,"PP",618
16,"16153",924,751,741,4,10,"PP",293
28,"28062",306,232,227,0,5,"PP",54
13,"13006",552,411,406,0,5,"PP",142
32,"32002",2028,1349,1340,4,9,"PP",483
3,"3024",3937,2992,2952,19,40,"PP",911
16,"16906",70,44,44,1,0,"PP",18
50,"50901",133,96,96,0,0,"PP",18
24,"24008",8931,6291,6214,79,77,"PP",2407
13,"13007",1219,871,852,4,19,"PP",248
40,"40138",2102,1585,1565,13,20,"PP",477
45,"45055",1004,768,755,4,13,"PP",237
40,"40901",413,320,315,7,5,"PP",97
16,"16154",4739,3416,3379,33,37,"PP",1168
22,"22170",672,460,456,5,4,"PP",125
37,"37324",333,247,242,3,5,"PP",110
20,"20045",47031,30933,30787,172,146,"PP",2789
24,"24229",376,275,269,2,6,"PP",119
26,"26001",199,145,141,3,4,"PP",49
1,"1049",130,94,94,1,0,"PP",6
47,"47043",306,241,240,4,1,"PP",88
29,"29088",2689,1817,1747,15,70,"PP",296
23,"23007",3015,2252,2229,14,23,"PP",428
40,"40139",255,194,192,2,2,"PP",78
28,"28171",4410,2921,2889,8,32,"PP",845
49,"49075",130,100,97,1,3,"PP",41
24,"24230",403,268,265,3,3,"PP",113
9,"9202",22,16,16,2,0,"PP",11
42,"42065",23,18,18,1,0,"PP",12
40,"40041",966,729,716,8,13,"PP",256
9,"9046",23,17,17,0,0,"PP",7
24,"24118",101,72,72,0,0,"PP",18
22,"22173",219,147,141,3,6,"PP",29
49,"49076",330,230,226,9,4,"PP",64
28,"28140",3156,2359,2331,16,28,"PP",479
24,"24011",182,104,102,3,2,"PP",7
26,"26003",379,311,306,1,5,"PP",162
18,"18109",597,430,422,5,8,"PP",130
50,"50903",2268,1685,1670,16,15,"PP",323
16,"16042",1091,832,823,4,9,"PP",235
15,"15039",1224,802,785,9,17,"PP",378
9,"9047",52,42,41,1,1,"PP",23
29,"29015",32093,22044,21716,253,328,"PP",5201
28,"28065",131232,100864,99883,846,981,"PP",18139
22,"22062",154,107,107,1,0,"PP",38
43,"43070",243,194,193,0,1,"PP",5
24,"24119",695,464,458,7,6,"PP",129
13,"13056",11706,8399,8288,88,111,"PP",1825
34,"34181",422,289,285,0,4,"PP",69
4,"4069",4742,3364,3325,46,39,"PP",892
11,"11039",9957,6134,6043,152,91,"PP",1561
45,"45168",62836,46917,46353,424,564,"PP",13063
50,"50014",119,81,81,0,0,"PP",25
48,"48002",7791,5510,5471,42,39,"PP",166
38,"38030",1962,1332,1318,9,14,"PP",220
50,"50088",274,195,191,2,4,"PP",69
10,"10155",1073,735,717,6,18,"PP",179
44,"44167",34,26,26,0,0,"PP",5
30,"30037",19407,13252,13120,99,132,"PP",3218
41,"41054",719,562,546,3,16,"PP",89
24,"24086",258,197,196,1,1,"PP",101
16,"16044",43,29,28,0,1,"PP",16
12,"12077",4828,3395,3357,28,38,"PP",785
19,"19290",851,551,550,4,1,"PP",106
14,"14030",7761,5711,5588,84,123,"PP",884
34,"34184",49,37,35,0,2,"PP",24
47,"47046",124,99,99,1,0,"PP",37
9,"9051",164,125,125,0,0,"PP",61
26,"26120",1441,1027,1011,11,16,"PP",404
46,"46183",6036,4276,4213,21,63,"PP",1115
48,"48031",303,221,221,0,0,"PP",1
40,"40905",130,95,95,0,0,"PP",58
9,"9377",626,468,460,6,8,"PP",179
44,"44046",44,33,33,0,0,"PP",5
13,"13014",472,361,352,4,9,"PP",106
16,"16160",58,41,41,1,0,"PP",23
28,"28144",6525,5032,4987,39,45,"PP",1301
27,"27044",2703,1495,1463,15,32,"PP",624
9,"9052",28,21,20,0,1,"PP",11
36,"36007",1610,1047,1016,5,31,"PP",442
7,"7005",6956,4042,3996,35,46,"PP",772
5,"5168",3503,2536,2511,29,25,"PP",1005
20,"20081",7690,5382,5363,31,19,"PP",114
10,"10199",154,99,99,2,0,"PP",25
37,"37037",108,72,72,0,0,"PP",26
32,"32010",364,271,267,2,4,"PP",125
48,"48089",3540,2561,2555,7,6,"PP",109
21,"21054",8175,6014,5887,41,127,"PP",2138
49,"49228",53,36,36,0,0,"PP",20
41,"41101",6025,4299,4213,53,86,"PP",787
23,"23014",2535,1890,1861,28,29,"PP",414
10,"10160",240,179,177,2,2,"PP",38
28,"28146",1806,1232,1218,3,14,"PP",295
40,"40145",1098,824,820,4,4,"PP",255
18,"18115",2635,1766,1738,13,28,"PP",262
28,"28069",58,44,42,1,2,"PP",11
15,"15044",1194,806,788,7,18,"PP",365
20,"20052",1050,746,743,4,3,"PP",22
21,"21055",7326,5395,5309,43,86,"PP",2240
16,"16162",39,31,31,0,0,"PP",11
16,"16205",106,73,73,1,0,"PP",30
32,"32012",708,448,440,2,8,"PP",184
36,"36009",4401,2712,2649,33,63,"PP",1042
20,"20053",4856,3169,3153,15,16,"PP",108
34,"34050",187,136,136,1,0,"PP",66
34,"34049",329,229,227,1,2,"PP",90
49,"49188",111,75,73,0,2,"PP",26
11,"11902",3664,2123,2094,46,29,"PP",445
34,"34190",50,33,33,1,0,"PP",21
18,"18116",2856,2027,1979,13,48,"PP",582
43,"43102",458,331,324,2,7,"PP",4
30,"30016",153034,101232,100202,776,1030,"PP",23235
38,"38034",3997,2687,2648,19,39,"PP",479
15,"15014",3836,2191,2158,27,33,"PP",836
7,"7008",6113,4003,3961,26,42,"PP",847
19,"19294",26,18,18,0,0,"PP",5
40,"40148",231,165,163,4,2,"PP",61
45,"45065",264,211,206,1,5,"PP",62
19,"19001",43,32,32,0,0,"PP",23
9,"9057",147,110,108,0,2,"PP",39
26,"26166",144,125,124,0,1,"PP",71
29,"29049",2890,2069,2034,12,35,"PP",294
5,"5902",286,214,211,1,3,"PP",102
22,"22181",86,55,54,2,1,"PP",16
37,"37334",71,30,30,0,0,"PP",15
43,"43903",2332,1502,1487,18,15,"PP",92
3,"3006",493,365,360,2,5,"PP",82
30,"30017",11428,8196,8113,44,83,"PP",2304
29,"29021",155,111,109,1,2,"PP",34
46,"46050",185,141,141,1,0,"PP",22
13,"13022",348,244,239,1,5,"PP",54
46,"46028",383,305,299,8,6,"PP",68
40,"40017",83,71,68,2,3,"PP",35
34,"34245",307,212,212,0,0,"PP",99
40,"40149",479,345,338,3,7,"PP",153
26,"26013",330,243,242,2,1,"PP",77
18,"18023",15717,10964,10751,132,213,"PP",2303
41,"41004",57692,38578,37814,696,764,"PP",5672
37,"37241",167,121,119,3,2,"PP",61
22,"22072",197,127,126,1,1,"PP",21
21,"21059",221,169,163,1,6,"PP",12
37,"37335",384,282,279,1,3,"PP",127
39,"39063",936,618,616,4,2,"PP",150
15,"15047",2256,1429,1405,25,24,"PP",536
10,"10205",1934,1071,1042,4,29,"PP",218
9,"9273",48,40,39,0,1,"PP",14
13,"13024",875,587,577,7,10,"PP",175
43,"43157",339,279,279,1,0,"PP",11
10,"10166",307,197,195,0,2,"PP",93
28,"28151",3274,2344,2310,16,34,"PP",493
37,"37147",184,126,124,1,2,"PP",48
16,"16052",539,422,419,3,3,"PP",111
41,"41089",6621,4650,4549,64,101,"PP",581
19,"19204",150,105,104,3,1,"PP",19
50,"50272",13226,9250,9153,97,97,"PP",1590
21,"21060",12287,7761,7638,134,123,"PP",1303
3,"3122",43774,30060,29834,230,226,"PP",5507
50,"50248",501,344,328,3,16,"PP",77
41,"41090",3489,2560,2467,27,93,"PP",443
16,"16215",237,162,158,1,4,"PP",22
30,"30019",25911,17485,17264,157,221,"PP",4606
50,"50273",33,24,24,1,0,"PP",10
35,"35022",51765,29309,29034,184,275,"PP",5273
14,"14037",3161,2233,2158,22,75,"PP",483
46,"46261",1708,1259,1237,12,22,"PP",302
9,"9063",215,184,181,2,3,"PP",79
4,"4080",196,148,147,2,1,"PP",50
9,"9224",147,113,112,0,1,"PP",57
13,"13027",3185,2112,2055,12,57,"PP",566
27,"27052",860,564,558,7,6,"PP",203
37,"37368",17,12,11,0,1,"PP",6
43,"43027",168,129,129,3,0,"PP",4
45,"45107",3463,2621,2585,23,36,"PP",569
19,"19112",53,35,34,0,1,"PP",15
48,"48012",2057,1610,1600,1,10,"PP",45
24,"24025",283,190,185,3,5,"PP",81
10,"10046",184,144,140,0,4,"PP",33
6,"6002",4313,2914,2804,37,110,"PP",728
44,"44148",74,56,54,0,2,"PP",10
46,"46190",50042,35290,35066,284,224,"PP",6770
22,"22187",288,220,220,2,0,"PP",48
32,"32020",2428,1728,1714,10,14,"PP",940
19,"19209",40,30,29,0,1,"PP",8
26,"26054",291,225,223,3,2,"PP",99
45,"45182",996,760,754,5,6,"PP",222
23,"23025",2725,1894,1870,11,24,"PP",432
39,"39039",540,355,355,1,0,"PP",105
45,"45145",2631,1746,1707,12,39,"PP",441
9,"9280",26,18,18,0,0,"PP",9
29,"29901",44757,29291,28960,307,331,"PP",6992
12,"12060",434,366,360,1,6,"PP",105
18,"18124",355,232,231,1,1,"PP",84
5,"5178",340,261,255,3,6,"PP",131
48,"48013",79353,53591,53205,331,386,"PP",4653
48,"48097",1314,886,882,6,4,"PP",40
26,"26019",346,260,251,2,9,"PP",82
6,"6050",4031,3005,2934,38,71,"PP",1014
23,"23026",3431,2430,2375,25,55,"PP",688
39,"39068",642,442,438,1,4,"PP",91
50,"50251",8209,5732,5658,66,74,"PP",1645
19,"19211",350,272,269,0,3,"PP",108
16,"16173",175,128,127,0,1,"PP",51
44,"44056",446,327,325,1,2,"PP",96
40,"40056",31,21,20,0,1,"PP",16
12,"12006",177,133,133,2,0,"PP",27
30,"30023",3874,2831,2788,18,43,"PP",663
40,"40156",272,194,190,4,4,"PP",72
45,"45185",7573,5422,5320,31,102,"PP",1426
10,"10050",987,707,704,4,3,"PP",273
14,"14041",3113,2234,2160,43,74,"PP",242
50,"50252",5019,3486,3456,53,30,"PP",1091
45,"45001",1846,1213,1181,10,32,"PP",287
9,"9229",178,127,127,1,0,"PP",53
37,"37184",289,178,177,1,1,"PP",85
15,"15085",3176,2073,2047,29,26,"PP",946
16,"16175",5071,3807,3732,43,75,"PP",916
50,"50178",269,165,163,6,2,"PP",23
19,"19213",67,53,52,1,1,"PP",17
43,"43162",4436,3191,3163,24,28,"PP",295
41,"41011",15462,11019,10696,183,323,"PP",1370
26,"26136",90,65,64,2,1,"PP",19
5,"5180",76,55,53,0,2,"PP",37
19,"19116",12,10,10,0,0,"PP",6
49,"49094",210,111,111,0,0,"PP",42
6,"6145",900,683,669,7,14,"PP",175
45,"45187",3967,3133,3074,16,59,"PP",877
37,"37155",68,48,48,0,0,"PP",9
42,"42090",83,65,64,1,1,"PP",32
27,"27057",11047,7078,6941,64,137,"PP",2488
44,"44238",2278,1630,1620,3,10,"PP",100
24,"24176",302,232,226,0,6,"PP",107
46,"46125",852,660,650,5,10,"PP",150
43,"43006",676,462,462,3,0,"PP",33
16,"16062",25,20,20,0,0,"PP",3
40,"40158",15,11,11,0,0,"PP",8
23,"23030",1207,998,977,7,21,"PP",232
10,"10216",1518,1082,1056,11,26,"PP",360
7,"7020",3707,2522,2493,40,29,"PP",469
16,"16025",24,20,20,0,0,"PP",11
13,"13081",584,412,405,0,7,"PP",102
13,"13035",947,704,690,6,14,"PP",146
41,"41012",3375,2259,2214,26,45,"PP",327
37,"37054",233,190,186,2,4,"PP",66
32,"32026",2655,1762,1731,17,31,"PP",532
34,"34215",161,126,125,6,1,"PP",45
6,"6147",329,234,234,1,0,"PP",32
43,"43164",310,235,231,3,4,"PP",18
5,"5119",24,17,17,1,0,"PP",9
45,"45189",633,462,459,7,3,"PP",109
38,"38043",19365,12355,12212,126,143,"PP",2398
41,"41013",4836,3174,3124,41,50,"PP",284
6,"6102",1027,834,815,3,19,"PP",221
32,"32027",989,670,660,5,10,"PP",360
9,"9294",99,81,78,0,3,"PP",18
50,"50104",320,251,251,1,0,"PP",95
13,"13038",1589,1162,1136,21,26,"PP",263
18,"18034",484,345,342,3,3,"PP",41
46,"46195",2000,1540,1532,3,8,"PP",319
45,"45079",355,250,250,0,0,"PP",91
37,"37346",251,208,207,1,1,"PP",108
32,"32028",1537,1012,1004,5,8,"PP",653
38,"38044",2215,1270,1257,5,13,"PP",271
48,"48906",736,550,548,2,2,"PP",12
44,"44063",63,52,52,0,0,"PP",18
50,"50105",277,203,198,4,5,"PP",67
48,"48019",3429,2424,2411,14,13,"PP",109
10,"10057",126,90,89,1,1,"PP",12
30,"30027",50067,36417,36074,242,343,"PP",9194
2,"2041",316,238,236,0,2,"PP",121
50,"50256",70,43,43,0,0,"PP",26
16,"16066",2280,1765,1734,18,31,"PP",545
43,"43009",1384,966,959,5,7,"PP",29
37,"37128",235,169,168,0,1,"PP",55
49,"49207",215,144,143,1,1,"PP",63
24,"24034",3466,2382,2359,25,23,"PP",427
13,"13041",236,155,155,3,0,"PP",38
24,"24180",1086,767,759,9,8,"PP",286
6,"6015",118127,79482,78553,855,929,"PP",22257
29,"29080",6940,4676,4617,36,59,"PP",1008
37,"37159",74,59,59,0,0,"PP",23
38,"38045",3542,1825,1801,7,24,"PP",317
23,"23034",2480,1923,1882,15,41,"PP",404
19,"19016",57,40,40,0,0,"PP",7
5,"5022",1580,1202,1193,6,9,"PP",550
45,"45119",3499,2217,2190,3,27,"PP",401
44,"44243",25,19,19,0,0,"PP",4
50,"50183",316,227,223,1,4,"PP",77
43,"43167",391,307,307,2,0,"PP",12
6,"6062",564,394,391,0,3,"PP",110
41,"41016",7820,5523,5407,57,116,"PP",1011
46,"46197",1930,1430,1411,11,19,"PP",186
14,"14048",1199,883,866,4,17,"PP",132
20,"20069",147446,102068,101696,564,372,"PP",10907
10,"10060",921,615,596,4,19,"PP",143
12,"12012",2622,2084,2056,12,28,"PP",542
19,"19310",7,7,7,0,0,"PP",2
38,"38047",1755,1132,1110,9,22,"PP",286
44,"44157",61,37,37,0,0,"PP",8
5,"5187",1714,1247,1221,9,26,"PP",383
18,"18136",1778,1320,1284,14,36,"PP",240
46,"46039",2111,1657,1640,16,17,"PP",476
43,"43116",465,356,352,0,4,"PP",6
24,"24074",97,70,70,1,0,"PP",28
3,"3135",195,134,131,1,3,"PP",19
5,"5090",73,63,62,0,1,"PP",26
30,"30030",321454,235061,233183,1744,1878,"PP",63840
44,"44245",240,177,174,0,3,"PP",57
22,"22085",94,78,76,0,2,"PP",21
24,"24150",226,163,162,0,1,"PP",61
13,"13045",622,459,451,0,8,"PP",148
19,"19189",114,87,84,0,3,"PP",20
5,"5220",364,277,274,0,3,"PP",128
44,"44010",185,144,143,0,1,"PP",30
6,"6019",2010,1367,1330,23,37,"PP",262
15,"15031",23868,16113,15954,207,159,"PP",3429
30,"30005",30268,20979,20778,148,201,"PP",6055
6,"6157",389,277,271,1,6,"PP",69
44,"44159",37,27,27,1,0,"PP",10
42,"42105",47,40,40,2,0,"PP",26
5,"5189",397,293,291,3,2,"PP",100
16,"16071",20,16,16,0,0,"PP",6
26,"26032",43,36,35,0,1,"PP",9
13,"13046",686,524,521,6,3,"PP",140
3,"3137",654,449,443,7,6,"PP",108
5,"5093",362,251,249,0,2,"PP",95
37,"37061",195,136,136,1,0,"PP",61
39,"39021",464,370,364,1,6,"PP",108
49,"49216",147,115,109,0,6,"PP",26
45,"45087",8180,5737,5628,41,109,"PP",1837
10,"10187",431,288,281,0,7,"PP",67
37,"37258",134,92,92,1,0,"PP",34
50,"50186",37,26,26,1,0,"PP",7
28,"28166",357,281,276,1,5,"PP",54
12,"12097",62,53,51,0,2,"PP",19
50,"50034",767,516,511,10,5,"PP",109
37,"37288",281,220,218,4,2,"PP",70
47,"47069",115,87,87,0,0,"PP",33
19,"19317",124,83,82,0,1,"PP",28
21,"21076",2153,1459,1426,31,33,"PP",193
47,"47166",251,183,181,2,2,"PP",71
3,"3138",3190,2244,2207,9,37,"PP",496
9,"9250",264,195,193,3,2,"PP",75
45,"45199",3188,2077,2055,20,22,"PP",333
37,"37165",31,22,22,0,0,"PP",14
46,"46201",62,40,40,0,0,"PP",5
48,"48912",2321,1684,1670,8,14,"PP",57
19,"19021",978,678,662,3,16,"PP",168
5,"5095",236,181,177,1,4,"PP",56
42,"42108",10,7,7,0,0,"PP",7
37,"37063",58,47,47,0,0,"PP",17
50,"50035",74,57,57,0,0,"PP",2
44,"44249",40,30,30,0,0,"PP",10
19,"19318",26,18,18,0,0,"PP",3
21,"21077",1739,1266,1235,13,31,"PP",345
38,"38050",2417,1288,1273,9,15,"PP",239
18,"18042",417,332,330,4,2,"PP",63
37,"37354",5479,3969,3905,37,64,"PP",1084
43,"43094",2143,1558,1541,6,17,"PP",78
5,"5192",92,75,72,1,3,"PP",30
30,"30033",10377,7330,7215,59,115,"PP",2180
1,"1001",2020,1385,1372,5,13,"PP",114
45,"45200",4471,3351,3269,25,82,"PP",792
5,"5029",100,73,73,1,0,"PP",43
2,"2050",85,66,66,1,0,"PP",16
16,"16078",41384,28809,28500,322,309,"PP",8584
44,"44250",20,15,15,0,0,"PP",6
13,"13052",6288,4360,4278,36,82,"PP",1333
47,"47198",64,43,43,0,0,"PP",15
40,"40201",42,37,37,0,0,"PP",25
50,"50138",45,37,37,3,0,"PP",10
20,"20075",4312,2848,2845,8,3,"PP",101
1,"1047",982,653,642,6,11,"PP",136
26,"26153",10,10,10,1,0,"PP",1
41,"41023",7999,5500,5435,60,65,"PP",1058
42,"42111",274,183,181,0,2,"PP",68
19,"19129",25,21,21,0,0,"PP",12
50,"50189",678,494,487,6,7,"PP",142
46,"46135",9817,7596,7558,58,38,"PP",1972
22,"22094",102,69,69,3,0,"PP",16
44,"44074",440,314,308,2,6,"PP",103
44,"44016",424,299,297,1,2,"PP",74
10,"10193",1392,1045,1025,6,20,"PP",328
16,"16196",589,490,476,3,14,"PP",143
37,"37356",84,58,58,0,0,"PP",30
16,"16081",50,37,36,0,1,"PP",11
44,"44165",168,125,125,2,0,"PP",33
45,"45093",147,115,114,0,1,"PP",54
28,"28003",167,133,131,4,2,"PP",28
28,"28109",1651,1131,1116,8,15,"PP",317
20,"20077",5269,3845,3830,9,15,"PP",132
35,"35014",11962,5994,5888,60,106,"PP",1203
49,"49112",118,72,72,2,0,"PP",24
7,"7001",3647,2430,2383,26,47,"PP",596
41,"41098",5161,3792,3732,33,60,"PP",899
15,"15070",8778,5802,5656,131,146,"PP",1398
50,"50265",74,54,54,1,0,"PP",19
21,"21051",222,171,168,3,3,"PP",24
3,"3056",8588,6219,6135,29,84,"PP",1259
1,"1006",174,124,122,1,2,"PP",21
3,"3903",2612,1838,1814,7,24,"PP",429
47,"47171",375,295,290,9,5,"PP",120
11,"11009",579,399,390,0,9,"PP",118
40,"40010",108,83,82,0,1,"PP",36
16,"16198",1281,938,928,6,10,"PP",251
44,"44256",36,30,30,2,0,"PP",5
37,"37264",56,39,39,0,0,"PP",16
45,"45095",663,496,492,2,4,"PP",156
46,"46254",944,673,661,6,12,"PP",212
32,"32043",2497,1607,1582,14,25,"PP",629
24,"24050",105,77,77,2,0,"PP",33
50,"50039",462,339,333,1,6,"PP",75
9,"9317",20,18,18,0,0,"PP",7
6,"6078",500,363,359,1,4,"PP",138
22,"22096",332,248,241,10,7,"PP",73
42,"42117",129,98,95,1,3,"PP",37
42,"42164",1580,1043,1029,8,14,"PP",343
9,"9101",72,52,52,0,0,"PP",31
26,"26043",346,243,235,2,8,"PP",82
39,"39001",2063,1474,1467,5,7,"PP",326
32,"32045",2346,1604,1579,20,25,"PP",681
23,"23048",817,605,599,4,6,"PP",179
44,"44077",68,52,51,0,1,"PP",5
12,"12022",323,257,254,5,3,"PP",78
47,"47110",445,335,327,1,8,"PP",85
49,"49115",167,121,121,2,0,"PP",42
46,"46206",555,417,408,0,9,"PP",77
37,"37360",206,135,135,1,0,"PP",50
26,"26161",8,8,8,0,0,"PP",6
5,"5198",70,53,51,0,2,"PP",30
44,"44169",298,216,216,0,0,"PP",47
23,"23049",1740,1215,1183,12,32,"PP",143
15,"15073",21725,13008,12820,126,188,"PP",4241
32,"32046",1089,679,670,4,9,"PP",296
45,"45134",1622,1187,1177,8,10,"PP",283
46,"46047",540,428,420,1,8,"PP",85
28,"28068",11740,8615,8543,72,72,"PP",2180
9,"9378",31,20,19,0,1,"PP",6
46,"46256",7280,4996,4940,32,56,"PP",1282
23,"23050",90664,65260,64519,581,741,"PP",17207
30,"30039",20442,13299,13167,84,132,"PP",3420
18,"18148",787,618,605,5,13,"PP",187
9,"9160",83,63,63,1,0,"PP",29
5,"5233",223,174,173,0,1,"PP",82
10,"10200",336,243,242,0,1,"PP",83
19,"19327",385,313,308,2,5,"PP",106
26,"26162",108,90,89,1,1,"PP",34
19,"19170",189,115,115,1,0,"PP",42
7,"7006",5393,3257,3220,34,37,"PP",493
1,"1011",213,162,160,3,2,"PP",44
37,"37362",4783,3469,3420,44,49,"PP",1013
46,"46257",5436,3972,3933,28,39,"PP",705
23,"23051",2736,2066,2021,16,45,"PP",383
48,"48034",12623,8789,8711,76,78,"PP",1208
15,"15012",3603,2484,2422,20,62,"PP",1076
24,"24163",4076,2979,2954,35,25,"PP",850
34,"34241",17,17,16,3,1,"PP",9
49,"49117",431,294,289,0,5,"PP",115
42,"42123",157,103,102,6,1,"PP",45
26,"26046",1552,1056,1027,11,29,"PP",377
45,"45100",178,141,138,0,3,"PP",38
10,"10202",583,457,453,1,4,"PP",90
27,"27016",6958,4697,4616,50,81,"PP",1749
46,"46140",383,321,321,2,0,"PP",52
37,"37205",212,157,155,1,2,"PP",37
15,"15076",2490,1539,1517,25,22,"PP",498
12,"12106",1151,928,908,9,20,"PP",175
49,"49118",193,151,151,2,0,"PP",73
45,"45138",1058,813,802,5,11,"PP",290
46,"46258",2617,1925,1914,5,11,"PP",592
18,"18150",6964,4717,4622,51,95,"PP",834
50,"50196",101,73,73,0,0,"PP",9
50,"50120",55,42,42,1,0,"PP",7
30,"30041",14040,8999,8876,94,123,"PP",1987
16,"16126",720,552,545,3,7,"PP",165
22,"22217",370,274,269,4,5,"PP",97
19,"19233",79,65,65,2,0,"PP",13
6,"6041",456,329,321,2,8,"PP",80
22,"22008",144,113,112,2,1,"PP",38
37,"37010",925,645,638,5,7,"PP",183
36,"36043",4696,3038,3003,21,35,"PP",959
37,"37302",262,161,161,2,0,"PP",59
9,"9058",394,286,284,6,2,"PP",67
47,"47051",324,261,258,6,3,"PP",77
49,"49155",81,60,59,0,1,"PP",30
10,"10041",1022,720,706,2,14,"PP",223
24,"24093",342,214,212,2,2,"PP",77
3,"3091",244,194,193,2,1,"PP",90
22,"22009",581,387,386,7,1,"PP",70
7,"7010",5078,3353,3318,30,35,"PP",766
19,"19234",44,30,30,0,0,"PP",10
47,"47084",1077,794,784,11,10,"PP",308
44,"44086",410,302,298,3,4,"PP",84
49,"49011",214,147,146,5,1,"PP",58
5,"5007",109,73,72,0,1,"PP",51
5,"5005",165,127,119,0,8,"PP",45
39,"39091",1881,1297,1291,8,6,"PP",317
36,"36044",2527,1535,1499,12,36,"PP",511
28,"28012",929,707,698,7,9,"PP",171
24,"24094",1320,866,852,11,14,"PP",263
29,"29023",2330,1441,1429,11,12,"PP",388
20,"20056",4077,2796,2781,12,15,"PP",66
13,"13069",613,438,419,2,19,"PP",77
36,"36045",24459,16966,16735,124,231,"PP",4181
16,"16093",54,45,45,0,0,"PP",11
5,"5206",26,17,17,0,0,"PP",3
37,"37179",197,167,165,0,2,"PP",57
34,"34100",132,96,95,1,1,"PP",29
40,"40083",73,52,52,1,0,"PP",21
10,"10003",543,350,335,0,15,"PP",121
49,"49235",415,300,290,4,10,"PP",90
26,"26052",146,106,105,0,1,"PP",55
42,"42129",678,485,480,6,5,"PP",166
48,"48038",1151,829,829,1,0,"PP",17
2,"2064",371,288,283,2,5,"PP",91
46,"46234",317,247,245,1,2,"PP",64
49,"49013",219,160,159,0,1,"PP",50
41,"41062",2151,1619,1589,12,30,"PP",56
23,"23021",512,406,399,2,7,"PP",69
16,"16017",336,276,270,1,6,"PP",71
36,"36016",1069,639,633,5,6,"PP",400
42,"42130",51,42,40,1,2,"PP",26
34,"34902",123,91,91,0,0,"PP",49
16,"16095",82,70,70,1,0,"PP",33
5,"5208",39,32,32,0,0,"PP",10
19,"19041",163,118,117,1,1,"PP",22
45,"45143",1192,877,865,9,12,"PP",273
5,"5240",3346,2259,2232,11,27,"PP",816
3,"3037",340,261,255,3,6,"PP",46
50,"50175",907,638,632,11,6,"PP",147
32,"32055",1216,781,764,10,17,"PP",396
19,"19042",22,18,17,0,1,"PP",0
39,"39010",610,457,453,1,4,"PP",82
41,"41035",1051,733,722,10,11,"PP",163
22,"22013",271,200,197,3,3,"PP",59
34,"34102",197,158,156,1,2,"PP",76
49,"49237",142,78,78,0,0,"PP",37
22,"22222",516,379,377,6,2,"PP",89
29,"29071",980,580,564,11,16,"PP",124
46,"46099",744,539,535,2,4,"PP",131
28,"28088",296,196,191,1,5,"PP",38
1,"1022",755,532,523,4,9,"PP",113
10,"10211",446,303,300,0,3,"PP",68
19,"19239",93,70,70,1,0,"PP",27
34,"34012",342,237,232,3,5,"PP",97
12,"12005",8049,5643,5552,71,91,"PP",1141
49,"49199",236,159,157,3,2,"PP",54
16,"16097",139,117,116,0,1,"PP",35
28,"28017",1280,975,963,10,12,"PP",210
48,"48041",687,548,547,4,1,"PP",9
19,"19078",47,37,36,0,1,"PP",3
45,"45110",1685,1288,1274,5,14,"PP",328
18,"18094",2299,1712,1652,20,60,"PP",565
16,"16218",184,134,133,1,1,"PP",57
49,"49017",247,176,176,1,0,"PP",104
39,"39011",1587,1178,1178,6,0,"PP",356
5,"5114",1257,989,968,5,21,"PP",313
28,"28089",3856,2866,2829,21,37,"PP",599
42,"42007",108,80,80,1,0,"PP",40
14,"14068",517,388,378,3,10,"PP",62
4,"4013",143819,93083,92383,893,700,"PP",24495
26,"26057",50,45,45,2,0,"PP",18
34,"34106",110,92,92,3,0,"PP",49
37,"37277",74,55,55,0,0,"PP",26
28,"28018",4121,3174,3151,22,23,"PP",800
10,"10213",533,397,385,0,12,"PP",125
44,"44121",52,42,42,1,0,"PP",11
21,"21004",1586,994,964,23,30,"PP",135
9,"9446",10,7,7,0,0,"PP",4
38,"38016",1174,595,589,2,6,"PP",117
40,"40025",129,109,107,1,2,"PP",59
16,"16224",72,60,58,0,2,"PP",18
46,"46215",1407,1088,1068,10,20,"PP",124
29,"29001",4207,3002,2959,40,43,"PP",380
9,"9447",43,37,36,0,1,"PP",13
18,"18161",245,199,196,0,3,"PP",65
39,"39097",666,342,335,2,7,"PP",123
50,"50277",45,34,34,0,0,"PP",12
49,"49241",235,178,177,1,1,"PP",66
41,"41039",31538,22078,21717,278,361,"PP",4496
44,"44003",17,15,15,0,0,"PP",6
9,"9448",203,159,157,0,2,"PP",90
5,"5117",191,155,153,1,2,"PP",78
15,"15086",2760,1829,1810,26,19,"PP",893
46,"46011",7523,5154,5077,34,77,"PP",1074
5,"5214",28,18,18,0,0,"PP",8
19,"19182",37,32,32,0,0,"PP",2
32,"32061",1078,777,770,5,7,"PP",368
12,"12036",541,401,395,6,6,"PP",122
28,"28020",193,96,93,0,3,"PP",33
44,"44181",65,57,57,0,0,"PP",31
49,"49242",439,342,336,2,6,"PP",132
48,"48072",965,730,724,3,6,"PP",14
10,"10013",265,184,182,0,2,"PP",61
20,"20064",12395,7959,7916,42,43,"PP",413
16,"16141",131,98,96,1,2,"PP",23
45,"45150",428,322,319,3,3,"PP",64
19,"19010",9,9,9,0,0,"PP",3
24,"24031",207,160,158,0,2,"PP",60
9,"9235",144,107,105,0,2,"PP",40
48,"48017",13121,8929,8886,45,43,"PP",119
42,"42012",29,22,22,0,0,"PP",5
13,"13082",25917,16834,16670,137,164,"PP",4978
50,"50155",95,65,65,0,0,"PP",25
46,"46081",9999,7486,7412,47,74,"PP",1646
28,"28021",571,365,364,1,1,"PP",96
45,"45005",225,170,167,3,3,"PP",64
43,"43033",766,555,555,4,0,"PP",33
18,"18163",311,206,204,0,2,"PP",62
28,"28022",37338,30620,30455,229,165,"PP",11320
37,"37218",51,25,23,0,2,"PP",15
2,"2073",4825,3433,3394,35,39,"PP",800
5,"5018",23,17,17,2,0,"PP",7
16,"16231",45,38,38,0,0,"PP",19
37,"37345",150,117,113,0,4,"PP",41
18,"18132",3101,2418,2382,23,36,"PP",286
15,"15027",1563,1159,1140,23,19,"PP",449
13,"13084",841,652,644,6,8,"PP",178
28,"28095",1719,1236,1226,5,10,"PP",285
36,"36055",13585,9177,8986,115,191,"PP",2796
37,"37188",158,107,105,3,2,"PP",35
49,"49245",251,174,171,1,3,"PP",68
50,"50280",290,220,216,1,4,"PP",41
46,"46082",4981,3547,3523,29,24,"PP",669
4,"4056",165,120,120,0,0,"PP",62
47,"47190",95,75,75,1,0,"PP",34
19,"19245",1138,798,778,6,20,"PP",228
44,"44099",644,422,421,2,1,"PP",45
26,"26063",118,88,88,2,0,"PP",33
9,"9456",130,86,86,1,0,"PP",31
45,"45117",718,552,548,0,4,"PP",131
37,"37283",116,83,83,0,0,"PP",33
43,"43035",233,182,182,5,0,"PP",5
47,"47003",206,167,166,5,1,"PP",67
6,"6060",5696,4006,3900,37,106,"PP",905
47,"47095",41,29,28,0,1,"PP",11
16,"16145",413,333,326,6,7,"PP",80
16,"16106",2701,2029,2001,6,28,"PP",678
9,"9410",3019,1924,1898,21,26,"PP",355
49,"49247",412,255,252,2,3,"PP",104
22,"22083",447,360,355,6,5,"PP",123
49,"49134",158,100,99,1,1,"PP",40
10,"10180",4206,2609,2574,13,35,"PP",532
29,"29034",461,333,332,2,1,"PP",97
7,"7057",7471,4430,4392,41,38,"PP",1537
12,"12040",119116,85613,84993,620,620,"PP",19473
18,"18068",1638,1197,1167,12,30,"PP",294
37,"37096",203,144,144,2,0,"PP",75
38,"38022",18630,11420,11284,87,136,"PP",2547
27,"27001",2187,1111,1102,17,9,"PP",526
46,"46015",7519,5575,5532,34,43,"PP",1108
5,"5123",106,78,78,0,0,"PP",36
3,"3075",154,117,115,1,2,"PP",25
16,"16108",44,35,34,1,1,"PP",8
46,"46220",49112,33766,33424,312,342,"PP",5771
48,"48049",543,415,414,1,1,"PP",1
35,"35007",517,347,345,2,2,"PP",45
32,"32068",1401,882,878,4,4,"PP",383
19,"19248",73,54,54,0,0,"PP",12
44,"44101",55,41,40,1,1,"PP",5
6,"6155",1810,1172,1140,23,32,"PP",209
34,"34073",180,123,120,3,3,"PP",56
43,"43011",1086,862,860,5,2,"PP",57
3,"3076",8846,6105,6029,40,76,"PP",1582
45,"45121",7345,4949,4899,24,50,"PP",1058
22,"22233",81,53,53,0,0,"PP",19
47,"47193",1625,1251,1236,10,15,"PP",299
9,"9136",169,129,125,2,4,"PP",34
9,"9304",198,152,149,1,3,"PP",64
42,"42019",519,345,341,3,4,"PP",97
2,"2045",3609,2797,2752,38,45,"PP",577
16,"16148",544,452,451,2,1,"PP",220
29,"29036",614,393,387,1,6,"PP",68
37,"37286",204,140,137,2,3,"PP",37
19,"19090",90,69,68,1,1,"PP",19
9,"9001",32,25,25,0,0,"PP",9
10,"10185",558,376,374,2,2,"PP",124
16,"16901",624,443,438,5,5,"PP",160
13,"13092",1703,1327,1307,4,20,"PP",461
32,"32071",1351,821,814,6,7,"PP",361
9,"9306",94,69,69,1,0,"PP",28
7,"7028",944,635,628,2,7,"PP",132
24,"24184",177,106,105,0,1,"PP",37
10,"10023",842,597,589,2,8,"PP",143
28,"28101",226,174,172,1,2,"PP",42
15,"15033",2421,1673,1655,6,18,"PP",567
42,"42020",4170,2732,2686,35,46,"PP",761
22,"22235",88,69,68,1,1,"PP",30
5,"5126",60,47,45,0,2,"PP",25
24,"24185",447,303,295,1,8,"PP",88
41,"41048",2195,1445,1400,13,45,"PP",250
28,"28102",880,639,621,7,18,"PP",142
45,"45124",2080,1628,1595,15,33,"PP",505
2,"2080",498,358,352,0,6,"PP",93
18,"18907",1762,1358,1351,4,7,"PP",315
43,"43039",101,77,77,0,0,"PP",1
40,"40199",101,76,72,2,4,"PP",31
2,"2081",18287,12910,12675,130,235,"PP",3675
6,"6068",427,298,294,5,4,"PP",51
46,"46223",7776,5848,5798,36,50,"PP",1264
6,"6114",127,105,105,0,0,"PP",19
37,"37195",39,31,31,0,0,"PP",6
47,"47009",98,84,84,0,0,"PP",27
9,"9140",117,78,77,1,1,"PP",31
18,"18072",655,452,445,4,7,"PP",78
49,"49141",290,191,191,1,0,"PP",57
44,"44106",151,107,106,0,1,"PP",28
42,"42157",10,9,9,0,0,"PP",7
26,"26072",287,239,235,3,4,"PP",89
39,"39023",6563,4788,4753,14,35,"PP",1044
9,"9363",906,660,655,5,5,"PP",319
41,"41049",9515,6961,6843,115,118,"PP",958
37,"37290",130,106,106,0,0,"PP",41
27,"27006",2441,1479,1460,11,19,"PP",560
10,"10108",203,116,116,1,0,"PP",36
4,"4028",207,175,171,1,4,"PP",32
9,"9310",15,14,11,0,3,"PP",0
2,"2083",209,181,181,0,0,"PP",53
16,"16244",698,598,585,7,13,"PP",195
19,"19097",14,14,13,0,1,"PP",8
19,"19096",105,72,70,0,2,"PP",18
9,"9366",76,55,55,2,0,"PP",19
16,"16245",396,304,298,1,6,"PP",108
34,"34129",168,118,118,1,0,"PP",63
24,"24189",5872,3915,3873,42,42,"PP",964
4,"4029",8830,5546,5482,43,64,"PP",1459
10,"10028",83,62,61,1,1,"PP",14
26,"26113",29,28,28,0,0,"PP",22
42,"42025",1125,741,732,12,9,"PP",238
47,"47230",285,209,206,1,3,"PP",68
22,"22028",358,237,233,1,4,"PP",61
41,"41096",6178,4739,4655,60,84,"PP",1078
23,"23079",3624,2661,2630,19,31,"PP",848
19,"19165",45,39,39,0,0,"PP",8
29,"29087",363,249,243,4,6,"PP",36
13,"13901",875,628,619,1,9,"PP",155
37,"37002",125,64,63,0,1,"PP",19
32,"32077",1104,703,700,9,3,"PP",253
24,"24082",847,615,608,16,7,"PP",128
9,"9478",45,34,34,1,0,"PP",11
22,"22061",6567,4446,4410,48,36,"PP",1189
26,"26002",821,611,597,1,14,"PP",212
37,"37198",202,147,144,2,3,"PP",41
19,"19059",73,47,47,0,0,"PP",24
40,"40203",987,753,740,13,13,"PP",179
46,"46021",24053,17331,17194,159,137,"PP",2873
19,"19060",157,123,122,0,1,"PP",22
23,"23080",1720,1313,1294,6,19,"PP",260
47,"47200",70,60,60,0,0,"PP",30
9,"9314",90,75,75,2,0,"PP",19
48,"48085",10716,7707,7679,51,28,"PP",335
42,"42161",136,99,99,0,0,"PP",51
20,"20047",455,314,314,1,0,"PP",4
10,"10113",2231,1534,1508,14,26,"PP",297
34,"34131",56,46,46,0,0,"PP",35
24,"24083",997,659,647,9,12,"PP",146
50,"50140",153,96,95,1,1,"PP",21
46,"46090",1631,1360,1339,6,21,"PP",320
20,"20017",8462,5944,5917,11,27,"PP",150
6,"6076",825,573,562,1,11,"PP",123
43,"43044",3962,2751,2719,33,32,"PP",302
23,"23081",1494,1084,1061,9,23,"PP",165
5,"5035",92,68,68,0,0,"PP",21
47,"47140",106,83,83,0,0,"PP",54
24,"24158",296,197,192,0,5,"PP",58
47,"47106",44,30,30,0,0,"PP",13
47,"47014",48,39,39,1,0,"PP",17
5,"5132",857,548,539,7,9,"PP",167
24,"24194",267,178,177,1,1,"PP",23
49,"49148",259,119,115,1,4,"PP",43
50,"50064",439,348,346,1,2,"PP",101
5,"5230",65,57,56,1,1,"PP",35
49,"49261",1504,1044,1026,7,18,"PP",290
20,"20048",183,112,112,0,0,"PP",1
45,"45021",2639,1798,1755,22,43,"PP",344
26,"26078",86,63,63,0,0,"PP",23
37,"37201",238,170,168,0,2,"PP",55
41,"41082",3354,2545,2507,11,38,"PP",328
9,"9901",334,228,226,4,2,"PP",86
37,"37108",98,75,75,3,0,"PP",34
19,"19258",84,63,62,0,1,"PP",27
9,"9154",123,90,90,7,0,"PP",38
16,"16008",80,63,63,1,0,"PP",20
16,"16045",180,128,127,0,1,"PP",42
43,"43151",107,88,88,0,0,"PP",7
32,"32081",2057,1466,1445,17,21,"PP",630
19,"19198",17,14,14,0,0,"PP",5
9,"9902",439,334,326,10,8,"PP",98
18,"18179",493,315,309,8,6,"PP",77
37,"37202",1004,773,763,12,10,"PP",185
41,"41055",14791,10197,10000,125,197,"PP",1970
9,"9321",1576,1151,1135,10,16,"PP",342
5,"5037",210,135,135,0,0,"PP",73
42,"42165",414,246,237,4,9,"PP",81
44,"44019",70,42,42,0,0,"PP",12
3,"3012",1138,863,846,4,17,"PP",216
37,"37330",314,227,223,2,4,"PP",75
19,"19104",19,15,14,0,1,"PP",12
24,"24122",1292,818,810,7,8,"PP",278
42,"42073",73,56,55,0,1,"PP",23
43,"43152",435,348,342,2,6,"PP",10
49,"49151",591,389,388,3,1,"PP",118
28,"28113",36951,27912,27604,241,308,"PP",4896
16,"16046",213,142,142,0,0,"PP",58
37,"37008",4213,3092,3046,21,46,"PP",1141
19,"19066",51,42,42,0,0,"PP",23
4,"4037",1212,890,875,17,15,"PP",194
13,"13017",240,178,176,0,2,"PP",50
49,"49040",109,89,87,2,2,"PP",27
34,"34137",24,19,19,2,0,"PP",7
24,"24090",323,200,200,2,0,"PP",82
35,"35017",27498,15513,15240,121,273,"PP",2925
26,"26082",101,79,79,0,0,"PP",31
20,"20022",849,574,571,8,3,"PP",10
3,"3032",97,82,82,0,0,"PP",23
48,"48090",6004,4305,4254,28,51,"PP",243
45,"45136",5827,3908,3864,22,44,"PP",1112
42,"42168",108,73,73,0,0,"PP",20
26,"26083",337,255,250,3,5,"PP",113
39,"39032",1420,1032,1027,7,5,"PP",313
42,"42034",41,25,25,0,0,"PP",7
45,"45027",315,249,246,2,3,"PP",77
9,"9056",4833,3191,3156,37,35,"PP",1003
49,"49265",110,79,78,2,1,"PP",26
37,"37363",104,81,80,0,1,"PP",34
35,"35019",32830,18390,18243,87,147,"PP",3954
32,"32086",2531,1348,1332,11,16,"PP",563
50,"50220",45,38,38,0,0,"PP",3
32,"32049",683,375,372,3,3,"PP",175
44,"44201",477,399,395,1,4,"PP",52
22,"22040",149,119,119,3,0,"PP",37
20,"20023",441,254,251,1,3,"PP",4
44,"44023",18,15,14,0,1,"PP",8
47,"47020",270,212,207,5,5,"PP",78
34,"34051",91,72,70,0,2,"PP",41
18,"18117",497,360,354,1,6,"PP",70
28,"28041",4805,3666,3634,38,32,"PP",888
6,"6086",1174,767,750,6,17,"PP",201
43,"43050",2695,1742,1730,10,12,"PP",179
37,"37145",236,173,170,3,3,"PP",57
16,"16258",172,124,119,0,5,"PP",43
21,"21057",995,600,590,8,10,"PP",77
22,"22141",115,94,93,0,1,"PP",37
10,"10163",348,239,238,2,1,"PP",69
6,"6132",823,543,533,4,10,"PP",89
12,"12056",257,205,199,1,6,"PP",49
34,"34196",87,67,67,3,0,"PP",31
46,"46233",3766,2688,2650,14,38,"PP",650
9,"9329",113,76,75,5,1,"PP",14
42,"42173",29860,19581,19206,337,375,"PP",5355
50,"50221",29,18,18,0,0,"PP",3
23,"23092",27717,19749,19490,217,259,"PP",4545
37,"37207",336,244,240,4,4,"PP",68
9,"9330",1481,1050,1037,17,13,"PP",356
19,"19174",90,65,64,0,1,"PP",24
10,"10125",859,561,546,3,15,"PP",155
10,"10124",867,622,612,1,10,"PP",136
40,"40018",73,50,50,0,0,"PP",25
10,"10002",360,239,236,1,3,"PP",58
4,"4007",735,514,509,3,5,"PP",92
41,"41903",6776,4616,4494,72,122,"PP",714
37,"37146",106,82,76,0,6,"PP",42
23,"23020",1510,1263,1253,16,10,"PP",237
9,"9169",97,72,70,1,2,"PP",24
6,"6089",610,470,463,2,7,"PP",104
10,"10126",1455,966,948,9,18,"PP",348
43,"43131",4827,3134,3116,32,18,"PP",336
11,"11018",1434,1001,977,8,24,"PP",234
49,"49157",188,136,133,2,3,"PP",46
43,"43078",835,610,605,7,5,"PP",32
6,"6091",3669,2581,2525,20,56,"PP",729
49,"49270",139,93,92,0,1,"PP",23
37,"37304",156,97,96,1,1,"PP",49
22,"22043",93,53,53,0,0,"PP",13
10,"10127",4691,3044,2974,34,70,"PP",677
49,"49193",428,261,253,3,8,"PP",77
45,"45180",2850,2044,2023,15,21,"PP",654
5,"5905",214,148,142,1,6,"PP",78
3,"3009",46125,33613,33319,315,294,"PP",6057
38,"38037",12817,7582,7494,55,88,"PP",2017
50,"50071",126,84,84,0,0,"PP",47
6,"6137",934,696,693,3,3,"PP",151
19,"19075",58,38,37,3,1,"PP",16
22,"22253",56,40,40,1,0,"PP",16
7,"7046",16884,9184,9097,97,87,"PP",2223
49,"49271",176,128,127,3,1,"PP",41
46,"46121",106,91,90,1,1,"PP",32
44,"44234",71,49,49,0,0,"PP",11
43,"43158",74,52,50,0,2,"PP",1
40,"40184",245,196,194,0,2,"PP",104
49,"49159",269,182,182,2,0,"PP",67
18,"18187",510,350,350,2,0,"PP",44
26,"26092",104,82,81,3,1,"PP",42
48,"48068",1534,1154,1149,1,5,"PP",15
41,"41063",2735,1855,1797,30,58,"PP",244
45,"45034",1290,968,948,7,20,"PP",279
49,"49160",42,27,27,0,0,"PP",6
9,"9338",225,174,172,3,2,"PP",30
26,"26093",48,34,33,0,1,"PP",11
44,"44267",70,47,46,0,1,"PP",20
50,"50047",38,24,24,0,0,"PP",5
50,"50073",2122,1559,1540,14,19,"PP",454
37,"37016",563,419,411,4,8,"PP",150
15,"15020",3568,2226,2217,19,9,"PP",714
42,"42132",140,102,101,2,1,"PP",46
49,"49125",1392,883,871,11,12,"PP",200
42,"42134",2651,1875,1836,21,39,"PP",621
19,"19268",50,37,35,0,2,"PP",12
12,"12136",2603,2151,2119,20,32,"PP",698
24,"24211",259,199,198,3,1,"PP",72
34,"34059",411,304,292,6,12,"PP",126
42,"42044",53,37,35,1,2,"PP",25
19,"19302",52,42,42,1,0,"PP",15
28,"28047",42984,30772,30486,270,286,"PP",6616
18,"18168",783,566,561,11,5,"PP",89
14,"14040",3749,2905,2845,53,60,"PP",441
27,"27023",2453,1674,1644,25,30,"PP",942
9,"9396",149,121,121,4,0,"PP",57
29,"29027",2325,1543,1516,13,27,"PP",304
9,"9340",74,49,49,1,0,"PP",23
44,"44029",585,454,451,2,3,"PP",67
47,"47027",2799,2059,2025,12,34,"PP",474
11,"11022",48785,24758,24422,398,336,"PP",4334
9,"9021",50,30,30,3,0,"PP",11
19,"19212",678,501,491,1,10,"PP",158
18,"18192",1462,1125,1103,3,22,"PP",180
5,"5243",80,57,56,1,1,"PP",19
5,"5048",107,89,88,2,1,"PP",41
44,"44209",799,584,573,2,11,"PP",162
39,"39012",6772,4807,4755,31,52,"PP",941
16,"16099",179,108,105,0,3,"PP",38
19,"19115",29,23,23,0,0,"PP",11
28,"28156",1082,788,784,3,4,"PP",150
37,"37372",133,99,98,0,1,"PP",34
50,"50228",249,207,207,3,0,"PP",81
28,"28049",57814,44977,44559,385,418,"PP",8276
15,"15023",6277,4021,3968,34,53,"PP",1133
12,"12138",19207,13018,12891,87,127,"PP",2560
42,"42048",60,52,52,0,0,"PP",25
43,"43057",38,32,32,1,0,"PP",1
35,"35026",83172,48751,48109,449,642,"PP",9853
26,"26098",92,63,63,1,0,"PP",22
23,"23101",351,238,238,3,0,"PP",42
40,"40026",112,101,99,0,2,"PP",22
10,"10134",550,361,354,1,7,"PP",147
41,"41067",7273,5114,5036,59,78,"PP",979
2,"2004",597,459,455,3,4,"PP",119
5,"5084",66,44,44,0,0,"PP",15
40,"40058",306,244,240,1,4,"PP",129
37,"37019",138,111,109,0,2,"PP",67
15,"15024",4314,2859,2790,44,69,"PP",986
22,"22156",289,216,213,1,3,"PP",44
39,"39071",410,251,250,1,1,"PP",122
9,"9072",331,261,260,4,1,"PP",60
50,"50154",114,92,92,1,0,"PP",35
26,"26023",433,316,314,3,2,"PP",130
4,"4086",1631,1128,1114,3,14,"PP",422
46,"46239",446,357,352,1,5,"PP",112
50,"50102",815,594,584,7,10,"PP",139
50,"50077",201,140,140,1,0,"PP",44
24,"24216",666,453,445,4,8,"PP",198
9,"9128",76,56,56,0,0,"PP",20
2,"2006",573,425,424,1,1,"PP",160
5,"5053",76,48,48,0,0,"PP",24
28,"28127",66793,53258,53009,458,249,"PP",18471
43,"43059",250,193,192,1,1,"PP",1
22,"22050",93,77,77,0,0,"PP",27
19,"19013",111,89,89,0,0,"PP",19
24,"24032",99,70,66,1,4,"PP",25
7,"7054",23257,12613,12464,111,149,"PP",3805
11,"11026",4700,3387,3293,17,94,"PP",890
5,"5183",123,103,100,0,3,"PP",57
30,"30026",16345,10049,9914,84,135,"PP",2385
37,"37157",76,64,63,1,1,"PP",12
50,"50004",475,360,356,2,4,"PP",96
3,"3102",7181,5126,5073,36,53,"PP",1032
50,"50156",212,156,151,2,5,"PP",28
28,"28053",6956,5475,5414,44,61,"PP",1142
5,"5247",231,132,131,1,1,"PP",43
37,"37056",39,28,28,0,0,"PP",19
37,"37315",89,65,64,0,1,"PP",36
28,"28161",52164,38607,38193,306,414,"PP",7037
46,"46241",388,288,283,5,5,"PP",48
34,"34025",52,34,34,1,0,"PP",18
27,"27030",3117,1945,1898,19,47,"PP",802
37,"37127",205,139,139,1,0,"PP",42
14,"14018",3617,2632,2568,31,64,"PP",563
10,"10139",92,66,65,1,1,"PP",22
49,"49169",38,33,32,0,1,"PP",14
45,"45154",1491,1033,1024,11,9,"PP",239
18,"18005",363,232,230,3,2,"PP",21
6,"6106",407,261,258,4,3,"PP",55
16,"16030",24,18,18,1,0,"PP",2
18,"18036",3986,2956,2917,22,39,"PP",771
21,"21071",206,148,144,4,4,"PP",26
22,"22119",1267,880,871,4,9,"PP",295
9,"9077",26,21,21,0,0,"PP",8
43,"43114",370,281,278,1,3,"PP",5
45,"45082",1145,904,893,7,11,"PP",281
46,"46196",134,111,110,0,1,"PP",37
20,"20038",387,294,293,2,1,"PP",1
40,"40225",1085,822,809,5,13,"PP",300
37,"37317",287,211,209,1,2,"PP",92
37,"37024",89,60,60,0,0,"PP",20
29,"29006",679,461,452,4,9,"PP",93
19,"19279",54,42,42,0,0,"PP",15
24,"24221",738,492,485,9,7,"PP",147
22,"22053",783,494,492,6,2,"PP",130
10,"10101",178,129,125,0,4,"PP",38
10,"10019",1412,948,934,2,14,"PP",211
29,"29035",1478,1054,1040,3,14,"PP",145
42,"42056",28,25,24,0,1,"PP",16
4,"4059",1000,676,666,3,10,"PP",130
44,"44037",447,288,288,1,0,"PP",98
22,"22054",1614,1029,1009,19,20,"PP",235
28,"28131",13510,9647,9544,89,103,"PP",2455
49,"49248",171,128,128,1,0,"PP",47
20,"20009",11369,7402,7355,32,47,"PP",379
44,"44009",798,593,589,4,4,"PP",106
15,"15062",5597,3406,3360,16,46,"PP",1350
47,"47036",204,159,156,1,3,"PP",49
19,"19281",19,18,18,0,0,"PP",6
45,"45158",2545,1805,1786,9,19,"PP",604
40,"40132",45,26,25,0,1,"PP",16
50,"50234",242,159,154,4,5,"PP",57
4,"4023",118,84,82,2,2,"PP",25
20,"20070",1084,798,795,7,3,"PP",1
12,"12095",950,723,712,5,11,"PP",196
2,"2011",556,429,427,1,2,"PP",178
34,"34185",69,36,35,0,1,"PP",12
10,"10035",1798,1201,1171,8,30,"PP",275
44,"44066",85,62,62,0,0,"PP",6
45,"45085",1535,1061,1052,11,9,"PP",260
49,"49214",666,486,477,6,9,"PP",184
9,"9036",31,24,24,4,0,"PP",12
49,"49066",437,276,272,2,4,"PP",118
22,"22055",305,242,235,2,7,"PP",81
48,"48079",397,289,287,1,2,"PP",5
19,"19282",138,107,106,0,1,"PP",63
4,"4095",687,462,457,4,5,"PP",109
26,"26108",309,240,231,2,9,"PP",104
19,"19124",378,230,229,2,1,"PP",50
26,"26148",154,125,122,3,3,"PP",35
24,"24151",433,307,304,1,3,"PP",108
19,"19020",46,31,31,0,0,"PP",10
46,"46040",993,745,733,3,12,"PP",162
37,"37132",317,211,207,0,4,"PP",79
19,"19190",2284,1632,1613,16,19,"PP",415
47,"47134",150,120,116,2,4,"PP",46
19,"19092",395,286,279,2,7,"PP",83
5,"5094",133,105,105,0,0,"PP",69
4,"4063",1058,766,750,6,16,"PP",192
18,"18011",4403,3002,2947,24,55,"PP",547
46,"46178",5001,3513,3477,26,36,"PP",699
37,"37228",324,262,262,1,0,"PP",93
26,"26110",149,116,114,0,2,"PP",55
45,"45088",2366,1526,1501,8,25,"PP",331
9,"9197",144,105,103,2,2,"PP",44
44,"44220",113,82,82,1,0,"PP",29
11,"11034",2319,1520,1487,17,33,"PP",244
39,"39051",73,64,64,1,0,"PP",17
41,"41077",8631,5788,5598,51,190,"PP",782
18,"18012",2114,1519,1492,9,27,"PP",401
47,"47040",56,42,41,0,1,"PP",24
42,"42198",19,9,9,1,0,"PP",4
5,"5062",163,121,119,3,2,"PP",66
18,"18140",42474,26967,26648,225,319,"PP",5806
44,"44070",55,49,49,0,0,"PP",23
50,"50163",3846,2863,2840,25,23,"PP",618
14,"14053",5918,4054,3968,92,86,"PP",777
32,"32001",5100,3377,3333,32,44,"PP",840
3,"3139",23126,14650,14522,127,128,"PP",3097
10,"10149",432,284,280,2,4,"PP",87
44,"44041",60,48,48,0,0,"PP",7
44,"44221",386,307,304,1,3,"PP",94
10,"10190",513,334,325,10,9,"PP",92
46,"46247",972,649,646,3,3,"PP",224
37,"37166",196,134,133,1,1,"PP",52
27,"27038",923,624,619,8,5,"PP",226
42,"42062",20,10,10,0,0,"PP",4
37,"37323",474,335,325,5,10,"PP",134
5,"5063",31,26,26,0,0,"PP",18
10,"10068",707,532,521,4,11,"PP",154
46,"46088",152,114,110,1,4,"PP",26
3,"3111",5579,3777,3737,23,40,"PP",1094
43,"43121",593,404,403,1,1,"PP",6
34,"34177",178,149,149,1,0,"PP",61
50,"50165",1768,1255,1222,20,33,"PP",192
18,"18014",6938,4864,4742,64,122,"PP",982
37,"37032",553,388,388,2,0,"PP",121
37,"37261",213,153,149,0,4,"PP",47
13,"13053",14031,9930,9796,97,134,"PP",2554
6,"6119",674,516,511,1,5,"PP",93
36,"36002",3049,1994,1968,22,26,"PP",771
16,"16155",490,389,388,7,1,"PP",132
34,"34083",1647,1089,1080,2,9,"PP",385
9,"9422",19,13,13,0,0,"PP",3
9,"9369",419,288,284,3,4,"PP",82
16,"16041",334,244,243,2,1,"PP",71
19,"19098",20,17,17,0,0,"PP",2
10,"10029",380,284,276,0,8,"PP",54
23,"23008",1422,1042,1020,9,22,"PP",142
49,"49180",135,82,81,5,1,"PP",25
38,"38028",22144,14312,14174,89,138,"PP",3106
37,"37137",98,60,59,2,1,"PP",41
9,"9094",53,42,42,0,0,"PP",19
16,"16909",655,493,488,4,5,"PP",120
46,"46226",29,20,19,0,1,"PP",1
23,"23009",12849,9722,9572,99,150,"PP",2464
44,"44223",73,48,48,0,0,"PP",11
10,"10153",281,183,181,0,2,"PP",85
39,"39055",1065,747,736,4,11,"PP",292
45,"45057",224,177,173,0,4,"PP",61
38,"38029",1475,752,744,10,8,"PP",159
45,"45167",1370,1078,1065,1,13,"PP",394
2,"2020",425,336,332,4,4,"PP",101
51,"51001",59820,33614,33265,323,349,"PP",7407
19,"19288",21,20,20,2,0,"PP",4
40,"40173",140,120,118,2,2,"PP",36
49,"49036",503,319,316,5,3,"PP",121
49,"49183",90,67,65,2,2,"PP",33
6,"6123",4502,2989,2894,29,95,"PP",567
6,"6122",6535,4204,4110,47,94,"PP",1012
48,"48086",2024,1371,1358,5,13,"PP",47
36,"36004",10109,6611,6502,79,109,"PP",2102
9,"9048",1373,937,911,10,26,"PP",298
5,"5067",73,56,54,0,2,"PP",11
49,"49078",138,113,109,4,4,"PP",43
7,"7003",12521,6457,6381,60,76,"PP",1385
46,"46182",1312,908,904,5,4,"PP",144
24,"24120",305,182,181,1,1,"PP",73
13,"13028",10230,7682,7559,65,123,"PP",2333
20,"20049",4195,2918,2901,12,17,"PP",71
19,"19197",28,22,22,1,0,"PP",3
9,"9050",57,38,38,1,0,"PP",13
5,"5167",223,177,172,0,5,"PP",31
36,"36005",8105,5258,5152,54,106,"PP",1725
26,"26160",731,539,533,4,6,"PP",225
41,"41100",954,670,635,7,35,"PP",133
24,"24121",599,422,418,3,4,"PP",91
28,"28006",80903,60936,60508,482,428,"PP",17119
20,"20080",7705,5276,5244,21,32,"PP",250
34,"34046",43,29,29,0,0,"PP",12
29,"29046",2494,1727,1693,13,34,"PP",318
20,"20050",275,174,174,2,0,"PP",1
6,"6126",2121,1443,1429,14,14,"PP",338
45,"45170",194,146,140,0,6,"PP",63
22,"22176",171,140,138,2,2,"PP",59
38,"38015",4055,2635,2601,16,34,"PP",463
32,"32058",5247,3547,3489,30,58,"PP",1480
37,"37072",144,121,118,5,3,"PP",50
26,"26080",451,347,344,0,3,"PP",183
49,"49080",622,440,437,4,3,"PP",147
32,"32009",10558,6621,6549,50,72,"PP",2309
6,"6036",4930,3492,3394,20,98,"PP",903
45,"45098",2090,1488,1469,7,19,"PP",600
45,"45171",1329,958,940,4,18,"PP",267
49,"49186",230,172,170,0,2,"PP",88
43,"43100",3557,2666,2649,22,17,"PP",177
43,"43126",1230,937,933,3,4,"PP",47
10,"10078",365,271,263,7,8,"PP",71
10,"10037",76966,54717,53914,546,803,"PP",16154
45,"45063",375,268,264,0,4,"PP",83
37,"37299",230,148,147,0,1,"PP",58
47,"47048",175,124,122,0,2,"PP",55
19,"19293",1945,1402,1388,19,14,"PP",230
2,"2024",3361,2444,2411,24,33,"PP",549
50,"50170",357,245,242,6,3,"PP",68
5,"5267",103,67,67,1,0,"PP",27
28,"28080",49866,39769,39583,346,186,"PP",14847
34,"34092",257,189,189,1,0,"PP",111
32,"32011",916,512,507,3,5,"PP",405
46,"46185",361,301,299,5,2,"PP",26
24,"24018",172,129,128,0,1,"PP",67
19,"19201",60,44,44,0,0,"PP",17
16,"16048",404,300,298,2,2,"PP",92
28,"28147",991,702,698,4,4,"PP",127
9,"9108",433,315,311,3,4,"PP",68
39,"39060",6704,4959,4887,23,72,"PP",973
28,"28039",134,93,93,1,0,"PP",21
34,"34242",91,65,62,2,3,"PP",28
50,"50018",883,622,616,5,6,"PP",163
2,"2026",834,644,633,4,11,"PP",143
37,"37114",74,58,55,1,3,"PP",28
27,"27048",1992,1317,1285,21,32,"PP",469
39,"39061",3470,2605,2591,14,14,"PP",800
28,"28148",89174,65500,64784,566,716,"PP",14170
42,"42079",21,17,17,1,0,"PP",14
13,"13020",4701,3114,3069,42,45,"PP",669
24,"24055",674,484,482,8,2,"PP",169
47,"47082",805,641,630,3,11,"PP",277
49,"49190",50,42,42,3,0,"PP",15
40,"40049",37,27,27,0,0,"PP",16
9,"9386",55,43,43,0,0,"PP",25
39,"39089",131,82,82,0,0,"PP",26
6,"6131",1057,809,800,6,9,"PP",80
45,"45139",144,111,111,0,0,"PP",31
9,"9908",423,254,253,4,1,"PP",87
41,"41059",35358,26408,26052,346,356,"PP",4554
49,"49085",904,583,579,5,4,"PP",209
5,"5172",111,83,83,1,0,"PP",20
14,"14044",1613,1186,1164,10,22,"PP",158
42,"42036",40,33,32,1,1,"PP",2
43,"43103",908,705,701,9,4,"PP",49
24,"24021",1595,1037,1025,7,12,"PP",305
14,"14035",5774,4076,4017,35,59,"PP",1230
23,"23019",1466,1117,1090,5,27,"PP",218
41,"41088",515,368,358,2,10,"PP",67
22,"22182",227,132,131,3,1,"PP",28
50,"50094",1500,1041,1022,12,19,"PP",286
10,"10042",85,58,58,0,0,"PP",17
3,"3035",627,485,485,2,0,"PP",121
6,"6134",526,306,301,1,5,"PP",87
24,"24167",703,436,430,3,6,"PP",123
19,"19073",16,15,15,1,0,"PP",4
29,"29068",7833,4897,4806,50,91,"PP",846
7,"7011",28971,17082,16964,164,118,"PP",3753
6,"6059",1724,1084,1067,6,17,"PP",331
37,"37242",82,59,59,1,0,"PP",21
9,"9389",63,45,45,0,0,"PP",21
19,"19110",51,39,39,0,0,"PP",11
42,"42219",40,34,34,1,0,"PP",13
9,"9223",42,36,36,0,0,"PP",20
19,"19298",53,43,41,0,2,"PP",9
46,"46006",4454,3527,3486,27,41,"PP",953
24,"24168",430,325,322,6,3,"PP",126
45,"45105",376,277,268,5,9,"PP",82
18,"18025",277,198,197,0,1,"PP",20
28,"28074",141137,106626,105602,885,1024,"PP",19301
44,"44053",103,87,85,1,2,"PP",21
42,"42001",250,172,172,3,0,"PP",51
38,"38013",3011,1850,1829,14,21,"PP",420
46,"46052",515,423,419,4,4,"PP",112
5,"5175",144,109,109,0,0,"PP",37
24,"24023",264,188,185,1,3,"PP",67
39,"39065",222,166,163,0,3,"PP",42
20,"20058",740,523,522,3,1,"PP",32
15,"15049",1068,752,747,7,5,"PP",340
18,"18027",2598,1730,1706,12,24,"PP",185
47,"47055",188,147,147,2,0,"PP",53
32,"32018",1181,883,871,5,12,"PP",260
44,"44266",102,81,79,0,2,"PP",33
15,"15018",1087,680,670,13,10,"PP",169
44,"44232",364,255,255,3,0,"PP",64
46,"46053",525,433,428,2,5,"PP",68
18,"18122",15994,11009,10773,109,236,"PP",2474
9,"9064",305,225,219,6,6,"PP",75
16,"16056",442,275,270,4,5,"PP",60
43,"43159",76,60,60,0,0,"PP",0
40,"40152",732,575,565,10,10,"PP",176
37,"37349",100,61,58,0,3,"PP",30
21,"21062",1403,849,838,10,11,"PP",166
34,"34205",55,38,38,0,0,"PP",20
44,"44119",116,80,79,1,1,"PP",10
6,"6094",1457,868,858,5,10,"PP",159
4,"4048",1499,964,957,4,7,"PP",200
14,"14039",2577,1858,1801,29,57,"PP",416
6,"6049",956,625,604,8,21,"PP",158
10,"10170",231,164,162,2,2,"PP",66
46,"46236",929,723,716,2,7,"PP",134
27,"27022",4654,2760,2696,20,64,"PP",1050
11,"11021",4914,3187,3069,61,118,"PP",465
4,"4082",275,185,182,2,3,"PP",78
37,"37246",5146,3791,3737,42,54,"PP",1198
9,"9395",121,74,74,1,0,"PP",39
19,"19043",99,80,79,0,1,"PP",22
34,"34208",48,40,40,1,0,"PP",20
13,"13075",196,147,146,2,1,"PP",56
9,"9303",73,58,58,0,0,"PP",28
11,"11031",76427,49773,49248,654,525,"PP",8702
37,"37309",36,21,21,0,0,"PP",10
50,"50099",3036,2137,2113,17,24,"PP",471
13,"13076",455,359,356,0,3,"PP",141
20,"20061",4427,3073,3053,13,20,"PP",72
43,"43004",6288,4314,4262,36,52,"PP",291
18,"18029",1812,1104,1065,7,39,"PP",164
42,"42088",62,45,44,0,1,"PP",27
43,"43082",350,276,271,5,5,"PP",8
19,"19114",30,22,21,1,1,"PP",7
47,"47184",537,411,402,1,9,"PP",177
37,"37341",47,29,29,0,0,"PP",12
6,"6006",4479,2991,2934,27,57,"PP",585
47,"47154",146,115,111,6,4,"PP",53
44,"44002",47,41,41,0,0,"PP",12
9,"9138",84,67,66,1,1,"PP",26
6,"6022",2635,1920,1862,15,58,"PP",460
13,"13078",8946,6166,6103,49,63,"PP",1670
22,"22015",299,218,215,1,3,"PP",79
1,"1028",1091,735,728,5,7,"PP",187
9,"9398",73,52,52,0,0,"PP",17
10,"10051",421,316,308,0,8,"PP",161
6,"6144",504,391,382,6,9,"PP",88
44,"44151",180,134,134,1,0,"PP",34
10,"10093",387,278,253,4,25,"PP",42
24,"24029",686,430,428,6,2,"PP",103
9,"9400",307,225,224,4,1,"PP",65
19,"19304",224,169,166,3,3,"PP",17
26,"26022",177,130,128,0,2,"PP",67
6,"6008",615,522,507,2,15,"PP",96
16,"16176",29,20,20,0,0,"PP",2
28,"28157",690,471,467,1,4,"PP",135
2,"2037",22963,14737,14588,68,149,"PP",3732
12,"12114",200,144,140,0,4,"PP",33
22,"22017",826,613,608,2,5,"PP",163
32,"32025",1014,731,718,5,13,"PP",377
38,"38042",3778,2410,2386,11,24,"PP",521
50,"50027",223,166,161,2,5,"PP",40
44,"44152",70,46,46,0,0,"PP",18
37,"37280",70,47,46,0,1,"PP",29
35,"35004",41975,20773,20602,156,171,"PP",3331
40,"40221",50,38,35,0,3,"PP",14
20,"20033",858,644,638,1,6,"PP",10
10,"10053",279,171,169,1,2,"PP",76
10,"10176",344,223,213,2,10,"PP",39
24,"24142",24715,16839,16616,159,223,"PP",3690
44,"44060",32,25,25,0,0,"PP",6
19,"19193",22,21,21,1,0,"PP",3
49,"49203",280,218,212,1,6,"PP",99
12,"12073",133,97,97,0,0,"PP",36
44,"44005",48,36,36,0,0,"PP",13
9,"9451",237,196,189,1,7,"PP",47
45,"45017",264,199,196,4,3,"PP",59
50,"50028",78,53,53,0,0,"PP",4
48,"48905",2496,1778,1766,12,12,"PP",60
47,"47158",859,618,608,4,10,"PP",127
26,"26061",1542,1104,1079,12,25,"PP",367
41,"41041",9765,7172,6943,63,229,"PP",1327
2,"2039",945,745,734,8,11,"PP",251
34,"34216",61,41,41,0,0,"PP",24
48,"48914",332,276,275,0,1,"PP",0
9,"9144",44,31,31,0,0,"PP",13
6,"6012",3231,2306,2278,25,28,"PP",444
3,"3044",4608,3437,3391,13,46,"PP",1074
37,"37251",108,75,75,0,0,"PP",24
20,"20005",1274,822,822,1,0,"PP",20
50,"50181",999,748,732,3,16,"PP",198
9,"9075",104,82,82,0,0,"PP",20
50,"50037",125,85,80,0,5,"PP",26
18,"18133",2101,1496,1477,6,19,"PP",450
10,"10016",329,242,232,2,10,"PP",51
34,"34069",2184,1555,1517,17,38,"PP",390
3,"3132",512,376,373,2,3,"PP",63
24,"24145",612,338,337,1,1,"PP",64
45,"45191",524,437,432,2,5,"PP",131
16,"16065",370,287,287,3,0,"PP",99
34,"34218",437,313,309,3,4,"PP",114
5,"5088",29,22,22,0,0,"PP",6
41,"41015",5426,3778,3639,41,139,"PP",511
16,"16186",403,309,305,3,4,"PP",73
22,"22199",6884,4438,4384,71,54,"PP",942
34,"34070",131,98,96,0,2,"PP",46
22,"22230",291,209,207,4,2,"PP",53
37,"37189",114,75,74,1,1,"PP",22
30,"30028",6390,4054,3973,25,81,"PP",812
46,"46219",125,107,104,0,3,"PP",41
9,"9241",244,171,169,6,2,"PP",30
19,"19155",64,49,49,0,0,"PP",9
7,"7002",6678,4149,4108,31,41,"PP",1274
21,"21020",349,230,228,2,2,"PP",46
10,"10058",979,628,599,6,29,"PP",116
12,"12118",78,64,63,0,1,"PP",21
16,"16067",123,91,90,1,1,"PP",42
48,"48908",250,212,210,1,2,"PP",0
35,"35030",10046,5584,5505,44,79,"PP",993
37,"37025",245,198,196,5,2,"PP",81
40,"40001",708,544,536,3,8,"PP",215
47,"47096",127,94,93,1,1,"PP",37
9,"9190",86,58,54,2,4,"PP",21
19,"19309",20,15,14,0,1,"PP",2
46,"46129",511,389,379,9,10,"PP",71
41,"41099",3961,2448,2413,14,35,"PP",199
48,"48021",1325,891,888,3,3,"PP",28
2,"2044",1040,665,656,5,9,"PP",164
50,"50184",87,70,70,0,0,"PP",26
50,"50107",988,758,755,8,3,"PP",233
34,"34029",665,524,518,1,6,"PP",295
16,"16032",284,220,220,1,0,"PP",68
19,"19219",9,8,7,0,1,"PP",0
37,"37098",290,197,197,1,0,"PP",38
16,"16238",461,380,378,1,2,"PP",136
10,"10184",734,520,511,4,9,"PP",162
39,"39076",3512,2517,2491,13,26,"PP",558
37,"37256",191,123,123,1,0,"PP",33
26,"26146",84,56,55,0,1,"PP",27
48,"48022",2305,1434,1425,11,9,"PP",48
5,"5058",71,45,43,0,2,"PP",20
50,"50209",2785,1893,1865,24,28,"PP",406
20,"20010",1524,1057,1053,5,4,"PP",40
10,"10117",238,133,130,0,3,"PP",32
9,"9102",33,22,22,0,0,"PP",9
34,"34237",579,408,400,1,8,"PP",191
28,"28132",12197,8622,8537,75,85,"PP",1322
46,"46131",49805,35527,35231,298,296,"PP",8606
47,"47067",153,112,112,3,0,"PP",58
50,"50033",61,44,44,1,0,"PP",12
22,"22086",194,137,137,1,0,"PP",38
19,"19314",44,33,33,0,0,"PP",12
41,"41092",7681,5408,5299,79,109,"PP",622
37,"37351",268,229,226,0,3,"PP",90
46,"46085",11089,7581,7503,60,78,"PP",1788
14,"14022",3881,2888,2853,15,35,"PP",313
47,"47007",4051,2987,2954,27,33,"PP",674
20,"20072",4762,3175,3153,21,22,"PP",170
42,"42155",146,83,80,2,3,"PP",40
37,"37142",554,396,394,5,2,"PP",103
40,"40208",724,546,543,5,3,"PP",237
32,"32035",1352,782,768,6,14,"PP",445
9,"9085",481,349,342,2,7,"PP",81
48,"48024",1000,761,752,1,9,"PP",10
38,"38049",2690,1406,1389,27,17,"PP",252
49,"49251",159,116,109,2,7,"PP",40
9,"9471",140,108,107,1,1,"PP",45
18,"18138",2470,1597,1573,25,24,"PP",199
12,"12015",115,94,94,0,0,"PP",18
44,"44068",634,497,493,2,4,"PP",155
42,"42022",206,147,146,6,1,"PP",61
44,"44247",291,207,206,4,1,"PP",45
5,"5191",121,99,99,0,0,"PP",20
41,"41021",21410,14369,14139,195,230,"PP",1867
34,"34227",70,56,52,1,4,"PP",30
36,"36031",563,426,420,7,6,"PP",163
27,"27901",2249,1373,1360,22,13,"PP",702
9,"9418",73,54,51,0,3,"PP",25
39,"39079",8850,6247,6175,28,72,"PP",1878
19,"19022",592,423,420,6,3,"PP",140
19,"19192",1762,1251,1240,5,11,"PP",355
37,"37134",209,143,141,3,2,"PP",31
9,"9251",362,258,256,3,2,"PP",78
49,"49220",146,102,98,3,4,"PP",28
36,"36032",3527,2407,2369,24,38,"PP",985
11,"11004",89919,55211,54544,830,667,"PP",10197
6,"6161",289,199,197,1,2,"PP",50
37,"37065",276,167,167,2,0,"PP",82
6,"6162",2885,2067,2032,19,35,"PP",507
21,"21017",2302,1469,1452,18,17,"PP",323
50,"50188",26,23,23,0,0,"PP",12
37,"37301",84,64,64,1,0,"PP",27
10,"10027",77,62,62,0,0,"PP",16
18,"18013",4154,2892,2812,28,80,"PP",623
6,"6026",804,578,562,5,16,"PP",202
9,"9091",686,479,467,4,12,"PP",214
9,"9200",48,29,29,0,0,"PP",8
27,"27007",2723,1822,1776,23,46,"PP",911
28,"28106",78872,54111,53443,412,668,"PP",7378
49,"49221",233,122,120,2,2,"PP",37
18,"18151",261,167,166,4,1,"PP",20
3,"3081",1492,1070,1044,12,26,"PP",216
18,"18044",161,91,91,0,0,"PP",19
46,"46210",338,256,251,0,5,"PP",73
24,"24057",1295,909,891,7,18,"PP",254
47,"47012",100,72,71,0,1,"PP",35
28,"28170",2495,1714,1695,13,19,"PP",311
47,"47074",141,110,109,0,1,"PP",31
22,"22090",86,61,61,1,0,"PP",11
46,"46089",2182,1590,1576,9,14,"PP",335
16,"16246",451,327,322,1,5,"PP",135
50,"50197",95,69,68,2,1,"PP",17
46,"46203",3546,2717,2689,28,28,"PP",448
37,"37168",397,271,266,3,5,"PP",82
4,"4100",9433,5599,5556,48,43,"PP",1433
34,"34231",211,157,153,3,4,"PP",76
50,"50114",132,108,108,0,0,"PP",30
18,"18045",1065,720,690,11,30,"PP",124
5,"5194",132,105,104,1,1,"PP",35
42,"42027",72,48,47,1,1,"PP",20
19,"19166",154,110,108,0,2,"PP",32
18,"18911",7933,5464,5348,53,116,"PP",870
50,"50215",20,14,14,0,0,"PP",1
45,"45019",7560,5216,5135,50,81,"PP",1078
40,"40172",47,33,32,0,1,"PP",14
50,"50038",1404,1024,1007,15,17,"PP",242
41,"41025",2031,1409,1349,11,60,"PP",309
18,"18046",1738,1042,1023,7,19,"PP",166
26,"26157",283,222,217,0,5,"PP",92
42,"42116",37,30,29,2,1,"PP",12
9,"9098",470,318,309,3,9,"PP",93
20,"20027",2761,1866,1861,10,5,"PP",20
10,"10045",971,686,682,4,4,"PP",144
19,"19099",286,179,175,1,4,"PP",49
50,"50191",446,327,326,1,1,"PP",111
18,"18145",10909,7925,7780,67,145,"PP",1715
42,"42207",48,42,41,0,1,"PP",11
34,"34133",101,75,73,0,2,"PP",45
29,"29016",253,196,194,0,2,"PP",51
1,"1053",596,364,362,1,2,"PP",20
49,"49003",860,534,530,5,4,"PP",231
10,"10073",733,513,499,8,14,"PP",151
4,"4033",121,78,77,3,1,"PP",15
9,"9259",230,178,176,2,2,"PP",52
50,"50200",479,389,383,5,6,"PP",63
24,"24209",2597,1651,1636,12,15,"PP",561
12,"12059",220,183,183,2,0,"PP",45
47,"47182",1328,940,934,8,6,"PP",217
39,"39038",1512,992,983,5,9,"PP",223
44,"44197",51,35,35,1,0,"PP",13
47,"47172",135,114,113,0,1,"PP",32
49,"49005",125,80,80,1,0,"PP",24
21,"21022",187,121,116,0,5,"PP",17
49,"49079",104,79,76,0,3,"PP",30
44,"44168",181,119,117,1,2,"PP",46
37,"37006",116,71,70,3,1,"PP",30
46,"46046",901,623,609,2,14,"PP",146
49,"49227",317,245,244,4,1,"PP",69
9,"9262",160,122,120,2,2,"PP",56
18,"18048",2494,1708,1657,18,51,"PP",179
43,"43177",276,229,227,2,2,"PP",2
22,"22099",490,349,343,2,6,"PP",88
40,"40122",524,398,392,2,6,"PP",126
10,"10048",202,141,139,0,2,"PP",55
22,"22901",714,433,423,6,10,"PP",72
23,"23085",2171,1587,1575,7,12,"PP",238
16,"16122",244,184,182,1,2,"PP",51
37,"37141",149,101,100,0,1,"PP",33
26,"26007",482,360,348,0,12,"PP",87
19,"19105",2550,1913,1889,10,24,"PP",358
27,"27045",926,588,583,6,5,"PP",140
14,"14059",679,527,521,11,6,"PP",136
49,"49006",139,98,95,3,3,"PP",33
37,"37298",170,109,109,0,0,"PP",46
28,"28145",2671,1927,1895,21,32,"PP",328
21,"21024",464,328,312,1,16,"PP",43
47,"47112",2561,1960,1933,13,27,"PP",753
5,"5136",83,55,55,0,0,"PP",21
34,"34076",532,443,438,1,5,"PP",231
44,"44246",1599,1012,1001,11,11,"PP",262
26,"26045",11,10,10,1,0,"PP",3
44,"44113",74,51,51,0,0,"PP",2
13,"13063",3648,2464,2406,28,58,"PP",671
14,"14060",3715,2714,2641,41,73,"PP",454
9,"9905",373,239,238,2,1,"PP",72
3,"3004",603,425,423,2,2,"PP",79
13,"13018",774,625,622,0,3,"PP",130
37,"37074",136,93,90,1,3,"PP",35
32,"32048",846,460,458,1,2,"PP",145
40,"40178",85,61,60,0,1,"PP",42
18,"18916",1815,1093,1086,6,7,"PP",197
18,"18149",5408,3926,3859,42,67,"PP",918
46,"46208",1071,854,845,2,9,"PP",177
38,"38009",4315,2846,2817,27,29,"PP",796
5,"5138",283,218,217,1,1,"PP",105
22,"22067",70,52,52,0,0,"PP",6
44,"44022",464,330,325,1,5,"PP",49
36,"36042",18125,11975,11775,126,200,"PP",3056
34,"34093",83,61,60,0,1,"PP",39
44,"44262",141,104,103,0,1,"PP",24
28,"28178",1149,869,853,4,16,"PP",172
50,"50270",38,26,25,0,1,"PP",5
7,"7009",737,495,488,3,7,"PP",116
37,"37176",128,99,98,1,1,"PP",48
23,"23090",1204,953,938,6,15,"PP",284
37,"37040",376,291,288,0,3,"PP",93
19,"19330",69,62,62,0,0,"PP",16
44,"44085",49,29,29,0,0,"PP",18
37,"37270",184,139,136,2,3,"PP",55
5,"5041",984,743,732,5,11,"PP",309
2,"2082",98,80,80,0,0,"PP",16
42,"42035",730,464,460,3,4,"PP",175
40,"40115",142,100,100,0,0,"PP",27
37,"37229",138,103,101,0,2,"PP",44
32,"32014",1028,719,708,6,11,"PP",380
49,"49167",180,131,131,2,0,"PP",50
32,"32063",1795,1135,1119,16,16,"PP",411
2,"2072",1528,981,958,7,23,"PP",219
50,"50147",744,508,506,5,2,"PP",92
5,"5108",39,21,21,0,0,"PP",6
10,"10014",1816,1285,1254,13,31,"PP",320
19,"19039",56,48,48,2,0,"PP",22
43,"43104",1767,1285,1271,4,14,"PP",25
50,"50255",199,152,147,3,5,"PP",17
11,"11006",24558,15334,15113,231,221,"PP",2570
9,"9112",102,73,73,0,0,"PP",33
50,"50198",47,32,32,0,0,"PP",10
12,"12028",13004,9801,9732,74,69,"PP",2598
21,"21028",370,265,259,2,6,"PP",48
28,"28084",16243,11562,11408,90,154,"PP",1923
19,"19142",263,179,179,1,0,"PP",22
5,"5120",33,26,26,0,0,"PP",13
43,"43165",571,469,467,2,2,"PP",12
46,"46051",8469,6120,6070,40,50,"PP",1713
34,"34246",68,52,52,0,0,"PP",26
43,"43105",155,126,123,4,3,"PP",6
39,"39092",863,534,533,3,1,"PP",167
43,"43026",756,576,574,1,2,"PP",20
41,"41904",1789,1125,1109,31,16,"PP",46
5,"5044",244,170,170,1,0,"PP",94
50,"50223",906,702,693,9,9,"PP",139
7,"7045",1317,931,928,8,3,"PP",172
29,"29069",87188,54019,53240,633,779,"PP",12106
24,"24059",804,466,463,5,3,"PP",111
3,"3064",5015,3514,3461,15,53,"PP",894
16,"16264",385,311,305,1,6,"PP",116
2,"2031",535,406,401,4,5,"PP",98
46,"46097",948,670,663,1,7,"PP",139
9,"9390",554,455,450,6,5,"PP",173
46,"46098",2405,1778,1751,7,27,"PP",409
29,"29052",213,129,128,0,1,"PP",25
32,"32029",441,286,283,2,3,"PP",183
37,"37138",222,163,159,3,4,"PP",72
12,"12084",17785,12557,12422,108,135,"PP",3322
37,"37274",118296,84144,83280,880,864,"PP",28993
10,"10087",1588,1105,1093,10,12,"PP",293
27,"27021",1632,962,935,23,27,"PP",407
30,"30020",6503,4521,4484,35,37,"PP",1464
46,"46189",469,374,367,2,7,"PP",58
37,"37337",137,104,103,0,1,"PP",54
49,"49194",331,198,197,0,1,"PP",62
23,"23058",8832,6528,6407,57,121,"PP",1505
39,"39009",3325,2306,2293,7,13,"PP",596
14,"14067",3842,2863,2800,42,63,"PP",691
49,"49026",199,134,134,0,0,"PP",58
22,"22021",1884,1331,1319,26,12,"PP",299
20,"20039",2126,1623,1618,9,5,"PP",9
45,"45157",2288,1490,1472,5,18,"PP",377
9,"9134",217,142,138,1,4,"PP",29
10,"10129",340,234,227,2,7,"PP",47
10,"10089",1334,864,837,8,27,"PP",141
46,"46213",15499,10610,10482,173,128,"PP",2391
10,"10210",489,314,313,2,1,"PP",68
43,"43028",2770,1784,1770,7,14,"PP",92
15,"15082",15446,10821,10687,130,134,"PP",3269
9,"9120",41,34,33,3,1,"PP",12
13,"13029",89,67,65,0,2,"PP",19
42,"42006",154,105,103,0,2,"PP",36
9,"9444",63,40,40,1,0,"PP",23
9,"9019",146,105,103,4,2,"PP",45
9,"9066",54,37,37,0,0,"PP",10
3,"3096",5786,4355,4281,38,74,"PP",945
21,"21043",1853,1354,1325,23,29,"PP",158
4,"4060",416,286,282,2,4,"PP",126
49,"49039",324,249,239,3,10,"PP",60
44,"44090",66,49,49,0,0,"PP",21
22,"22014",227,164,162,5,2,"PP",50
20,"20040",15771,10549,10481,54,68,"PP",371
27,"27055",1191,773,764,7,9,"PP",319
21,"21064",6674,4503,4426,68,77,"PP",747
46,"46009",3144,2473,2449,22,24,"PP",509
9,"9445",41,28,27,1,1,"PP",11
7,"7016",2970,1891,1865,22,26,"PP",377
50,"50074",6156,4100,4022,33,78,"PP",771
10,"10132",360,251,243,1,8,"PP",51
40,"40219",573,382,366,5,16,"PP",160
6,"6097",2258,1631,1602,10,29,"PP",421
44,"44236",60,38,38,0,0,"PP",20
48,"48061",789,602,601,2,1,"PP",22
16,"16124",1807,1367,1347,14,20,"PP",392
29,"29084",27199,18102,17800,268,302,"PP",4070
19,"19054",161,136,135,3,1,"PP",51
34,"34211",171,154,153,2,1,"PP",80
9,"9467",59,46,46,2,0,"PP",17
32,"32059",1686,1099,1082,20,17,"PP",530
10,"10214",216,170,170,2,0,"PP",72
5,"5015",68,45,44,1,1,"PP",15
47,"47090",2447,1823,1784,15,39,"PP",531
37,"37123",159,124,123,2,1,"PP",63
12,"12113",90,59,59,1,0,"PP",17
37,"37279",713,488,480,4,8,"PP",204
22,"22114",124,75,72,1,3,"PP",23
50,"50051",802,551,550,2,1,"PP",164
49,"49129",810,541,527,4,14,"PP",138
46,"46079",314,244,240,0,4,"PP",61
9,"9449",91,78,76,1,2,"PP",31
45,"45113",1770,1189,1171,5,18,"PP",365
3,"3099",43101,30222,29885,196,337,"PP",9147
30,"30024",60389,42200,41831,281,369,"PP",11480
47,"47186",244314,182449,180833,1818,1616,"PP",54025
13,"13080",316,226,225,0,1,"PP",64
44,"44004",379,275,275,2,0,"PP",73
43,"43032",462,354,350,2,4,"PP",12
42,"42092",61,40,39,0,1,"PP",12
47,"47125",49,42,42,0,0,"PP",22
5,"5016",6355,4677,4584,28,93,"PP",1697
46,"46057",463,308,304,1,4,"PP",105
36,"36022",9046,5834,5720,37,114,"PP",1286
34,"34066",54,47,47,1,0,"PP",29
16,"16177",83,65,65,1,0,"PP",21
42,"42200",74,49,46,0,3,"PP",20
24,"24127",263,183,181,1,2,"PP",82
50,"50238",84,65,65,0,0,"PP",15
19,"19223",99,66,65,1,1,"PP",24
10,"10081",176,121,119,0,2,"PP",46
19,"19274",953,693,676,9,17,"PP",132
47,"47011",554,466,462,7,4,"PP",206
9,"9043",172,112,111,1,1,"PP",42
13,"13097",2186,1592,1574,5,18,"PP",443
22,"22018",303,216,215,3,1,"PP",54
20,"20004",230,133,133,2,0,"PP",0
30,"30010",6852,5161,5106,25,55,"PP",1425
20,"20065",2921,1983,1970,16,13,"PP",125
50,"50205",72,51,49,0,2,"PP",5
16,"16004",228,175,174,0,1,"PP",77
9,"9220",69,52,52,3,0,"PP",21
43,"43156",3956,2812,2784,22,28,"PP",254
22,"22906",177,123,122,6,1,"PP",27
24,"24069",37,26,25,0,1,"PP",23
37,"37022",242,191,190,0,1,"PP",97
10,"10098",387,272,267,0,5,"PP",90
47,"47138",224,169,166,0,3,"PP",61
2,"2018",789,611,606,3,5,"PP",234
7,"7022",11659,7045,6965,84,80,"PP",1772
45,"45080",3,3,3,0,0,"PP",2
46,"46036",558,339,331,6,8,"PP",88
22,"22229",107,70,70,2,0,"PP",12
40,"40192",134,106,105,1,1,"PP",40
39,"39017",550,378,372,1,6,"PP",120
26,"26181",15,14,14,0,0,"PP",10
41,"41043",669,447,436,11,11,"PP",56
29,"29079",2326,1609,1582,12,27,"PP",261
14,"14074",2225,1775,1743,17,32,"PP",400
10,"10902",744,514,498,4,16,"PP",152
40,"40193",219,156,155,3,1,"PP",39
34,"34114",200,134,134,0,0,"PP",84
37,"37316",711,546,541,7,5,"PP",218
45,"45192",2380,1890,1854,8,36,"PP",635
28,"28024",168,137,136,2,1,"PP",55
47,"47160",395,296,294,3,2,"PP",116
45,"45118",2124,1403,1380,8,23,"PP",356
43,"43149",690,512,509,3,3,"PP",31
50,"50022",504,373,369,12,4,"PP",106
18,"18016",297,200,198,3,2,"PP",53
28,"28004",6618,4502,4457,28,45,"PP",1046
3,"3018",12433,8582,8502,54,80,"PP",2162
9,"9458",490,388,385,6,3,"PP",74
1,"1037",589,378,374,1,4,"PP",34
15,"15060",5871,4044,3978,58,66,"PP",1320
37,"37222",78,55,55,2,0,"PP",27
9,"9033",80,64,63,1,1,"PP",28
50,"50159",640,493,486,3,7,"PP",138
46,"46152",90,63,63,0,0,"PP",23
20,"20008",713,424,424,5,0,"PP",10
6,"6077",319,234,229,2,5,"PP",37
16,"16007",1153,857,847,3,10,"PP",338
39,"39094",840,611,611,2,0,"PP",131
28,"28121",209,156,152,1,4,"PP",36
49,"49050",498,305,305,2,0,"PP",110
41,"41073",1684,1100,1074,7,26,"PP",190
16,"16068",125,88,88,3,0,"PP",33
43,"43168",83,55,55,1,0,"PP",0
6,"6018",727,483,476,0,7,"PP",74
37,"37255",43,33,31,1,2,"PP",14
24,"24038",3024,2121,2071,25,50,"PP",567
48,"48050",188,141,141,0,0,"PP",1
9,"9463",246,174,174,4,0,"PP",54
5,"5124",87,67,67,2,0,"PP",41
46,"46016",1070,827,814,10,13,"PP",133
40,"40002",32,22,21,0,1,"PP",8
4,"4093",1916,1143,1130,5,13,"PP",234
47,"47226",148,115,115,1,0,"PP",32
12,"12051",437,297,295,3,2,"PP",176
12,"12078",334,224,221,2,3,"PP",94
39,"39095",2266,1637,1619,8,18,"PP",388
7,"7038",2046,1416,1406,12,10,"PP",405
40,"40143",82,68,67,2,1,"PP",31
43,"43081",629,500,499,2,1,"PP",13
44,"44055",75,52,50,0,2,"PP",19
19,"19311",85,60,59,0,1,"PP",29
9,"9137",187,129,127,0,2,"PP",42
43,"43038",22070,15127,15018,113,109,"PP",1535
45,"45123",3196,2252,2218,11,34,"PP",303
27,"27003",1743,1161,1134,18,27,"PP",553
43,"43092",7308,4703,4679,33,24,"PP",456
20,"20071",15062,10442,10407,47,35,"PP",334
19,"19250",16,12,12,0,0,"PP",2
32,"32083",805,498,494,3,4,"PP",270
15,"15052",4070,2512,2488,18,24,"PP",863
47,"47207",256,198,195,3,3,"PP",93
7,"7039",5019,3066,3017,23,49,"PP",860
10,"10119",574,417,414,2,3,"PP",99
36,"36061",8613,5822,5718,56,104,"PP",2610
44,"44199",39,37,37,2,0,"PP",7
47,"47008",22,13,13,0,0,"PP",6
50,"50162",135,100,99,3,1,"PP",26
40,"40166",251,201,201,0,0,"PP",104
44,"44191",714,509,500,5,9,"PP",116
45,"45161",15469,10281,10167,68,114,"PP",1666
43,"43119",849,591,588,8,3,"PP",18
40,"40103",139,113,113,0,0,"PP",29
37,"37321",150,118,115,0,3,"PP",45
44,"44219",173,118,115,1,3,"PP",46
45,"45198",1808,1442,1428,6,14,"PP",457
45,"45014",4039,2606,2552,35,54,"PP",433
44,"44192",341,274,272,2,2,"PP",65
19,"19162",67,41,41,0,0,"PP",5
49,"49031",148,107,105,2,2,"PP",53
44,"44012",303,215,215,2,0,"PP",69
45,"45125",2256,1711,1689,16,22,"PP",519
19,"19055",44,32,31,2,1,"PP",10
20,"20074",11520,8379,8357,19,22,"PP",191
26,"26035",16,12,11,0,1,"PP",4
40,"40168",27,20,20,0,0,"PP",7
16,"16113",3065,2142,2108,13,34,"PP",722
34,"34127",80,62,62,0,0,"PP",32
22,"22205",448,294,292,0,2,"PP",55
49,"49032",282,196,196,0,0,"PP",92
50,"50137",958,740,731,8,9,"PP",220
24,"24115",53159,35203,34784,410,419,"PP",8657
29,"29096",2757,1847,1790,19,57,"PP",290
48,"48026",1132,834,832,2,2,"PP",5
3,"3034",1404,1028,1010,5,18,"PP",308
41,"41003",2373,1747,1708,18,39,"PP",389
10,"10040",426,301,289,2,12,"PP",74
6,"6117",1388,982,958,11,24,"PP",291
19,"19152",540,377,374,2,3,"PP",107
40,"40093",74,62,62,1,0,"PP",29
34,"34023",5103,3585,3543,45,42,"PP",918
16,"16039",365,241,238,3,3,"PP",66
9,"9044",55,46,44,1,2,"PP",11
46,"46259",457,374,371,2,3,"PP",85
7,"7043",3431,2196,2166,21,30,"PP",603
1,"1060",204,159,151,0,8,"PP",47
5,"5076",468,376,367,1,9,"PP",128
47,"47001",52,43,42,1,1,"PP",26
43,"43068",484,322,317,2,5,"PP",45
9,"9255",83,58,58,0,0,"PP",28
38,"38003",1517,899,890,5,9,"PP",182
40,"40008",42,36,36,1,0,"PP",15
37,"37104",24,16,16,0,0,"PP",9
34,"34038",259,183,178,0,5,"PP",92
41,"41060",15058,10551,10302,122,249,"PP",1907
12,"12108",443,354,352,4,2,"PP",117
12,"12018",279,233,231,3,2,"PP",62
11,"11007",18032,9872,9745,213,127,"PP",1744
29,"29014",218,122,121,3,1,"PP",23
37,"37325",88,63,63,0,0,"PP",32
37,"37106",248,161,160,4,1,"PP",73
50,"50139",318,237,237,1,0,"PP",69
49,"49258",111,93,93,2,0,"PP",36
43,"43069",183,148,147,2,1,"PP",10
47,"47139",997,728,719,4,9,"PP",172
38,"38004",4536,2914,2887,28,27,"PP",498
50,"50013",199,158,158,0,0,"PP",30
19,"19287",134,100,98,2,2,"PP",36
18,"18176",242,164,161,2,3,"PP",12
28,"28034",368,258,255,0,3,"PP",85
44,"44195",82,58,57,0,1,"PP",9
41,"41053",21693,15843,15379,171,464,"PP",2282
16,"16118",1351,1022,1009,13,13,"PP",426
5,"5262",318,238,235,1,3,"PP",91
3,"3008",158,120,118,1,2,"PP",36
42,"42096",244,132,129,2,3,"PP",68
26,"26015",185,140,138,2,2,"PP",64
26,"26040",64,47,47,1,0,"PP",27
47,"47203",54,40,40,0,0,"PP",20
50,"50167",208,166,163,1,3,"PP",47
45,"45204",630,453,449,1,4,"PP",128
26,"26004",69,47,46,0,1,"PP",35
40,"40903",75,61,59,0,2,"PP",32
26,"26077",16,16,16,0,0,"PP",8
43,"43124",468,343,339,3,4,"PP",20
20,"20018",11231,7640,7611,33,29,"PP",161
3,"3114",1593,1158,1142,4,16,"PP",304
34,"34151",148,98,96,1,2,"PP",54
46,"46167",342,240,239,0,1,"PP",51
24,"24037",330,189,189,1,0,"PP",75
44,"44128",58,39,37,0,2,"PP",12
21,"21031",1166,773,736,11,37,"PP",156
45,"45169",179,114,111,1,3,"PP",48
43,"43046",88,69,68,1,1,"PP",0
20,"20019",9892,6740,6717,40,23,"PP",281
18,"18017",18201,11500,11358,94,142,"PP",2726
18,"18047",6103,3992,3922,61,70,"PP",642
42,"42208",20,12,12,1,0,"PP",8
50,"50089",8616,6420,6364,50,56,"PP",1353
13,"13059",193,150,150,0,0,"PP",46
10,"10197",106,74,74,0,0,"PP",30
16,"16250",67,52,52,1,0,"PP",21
39,"39058",806,556,554,2,2,"PP",112
24,"24197",717,500,499,2,1,"PP",139
18,"18123",284,202,200,5,2,"PP",48
27,"27054",1135,807,782,5,25,"PP",391
46,"46221",348,292,290,1,2,"PP",75
19,"19178",27,17,16,0,1,"PP",0
5,"5177",136,117,116,0,1,"PP",29
3,"3058",4976,3733,3669,20,64,"PP",1212
32,"32082",1164,736,728,11,8,"PP",353
50,"50090",134,96,96,0,0,"PP",49
6,"6080",1898,1336,1307,6,29,"PP",323
44,"44258",53,46,46,0,0,"PP",26
50,"50066",2903,2095,2078,19,17,"PP",424
43,"43073",80,67,65,0,2,"PP",0
14,"14003",1245,925,907,5,18,"PP",241
11,"11012",97338,67120,66466,861,654,"PP",13583
40,"40155",3897,2920,2880,56,40,"PP",698
22,"22151",85,60,60,0,0,"PP",21
46,"46055",1298,992,977,9,15,"PP",175
50,"50210",37,26,26,0,0,"PP",12
49,"49104",326,218,216,0,2,"PP",110
43,"43153",11197,7685,7649,53,36,"PP",584
48,"48080",9916,6849,6793,44,56,"PP",296
6,"6083",46577,31113,30748,338,365,"PP",6789
39,"39003",261,189,187,2,2,"PP",36
3,"3118",2446,1617,1598,8,19,"PP",405
28,"28079",2384271,1765443,1753633,13854,11810,"PP",479448
9,"9216",370,245,241,3,4,"PP",68
38,"38033",3593,2277,2242,15,35,"PP",522
44,"44021",104,77,77,1,0,"PP",18
5,"5039",47,43,43,0,0,"PP",24
45,"45064",3987,2918,2880,33,38,"PP",625
23,"23088",6017,4529,4427,61,102,"PP",674
37,"37039",279,202,197,2,5,"PP",83
42,"42213",25,17,16,1,1,"PP",11
14,"14014",2496,1962,1907,20,55,"PP",448
42,"42049",108,71,71,1,0,"PP",44
47,"47113",134,110,110,0,0,"PP",40
15,"15013",6324,4132,4083,35,49,"PP",1313
34,"34003",147,104,103,0,1,"PP",56
18,"18022",13875,8948,8764,98,184,"PP",1200
1,"1058",1414,893,884,1,9,"PP",42
10,"10121",7882,5294,5183,42,111,"PP",1445
37,"37206",87,65,54,0,11,"PP",18
19,"19071",8277,5838,5763,53,75,"PP",1212
4,"4075",5462,3714,3676,19,38,"PP",1059
5,"5106",27,14,14,0,0,"PP",8
43,"43075",86,65,63,0,2,"PP",1
29,"29095",3285,2313,2224,39,89,"PP",366
18,"18141",382,240,237,0,3,"PP",93
44,"44229",141,99,98,1,1,"PP",11
40,"40234",375,278,269,3,9,"PP",79
13,"13066",2621,2029,1998,12,31,"PP",642
43,"43154",126,104,104,0,0,"PP",5
6,"6040",993,679,668,3,11,"PP",92
22,"22144",255,192,190,2,2,"PP",63
15,"15036",56053,36487,36175,501,312,"PP",10274
43,"43173",98,70,68,0,2,"PP",4
39,"39043",1517,1167,1154,3,13,"PP",463
47,"47021",73,57,55,0,2,"PP",14
18,"18003",14454,10162,9935,105,227,"PP",1935
6,"6011",24731,16786,16538,167,248,"PP",4234
5,"5215",156,120,113,0,7,"PP",62
6,"6149",10177,7582,7455,64,127,"PP",1750
45,"45164",166,143,142,1,1,"PP",59
40,"40181",4182,3102,3038,35,64,"PP",750
16,"16015",349,242,239,6,3,"PP",100
50,"50070",50,30,29,0,1,"PP",3
40,"40212",26,19,19,1,0,"PP",5
40,"40082",104,84,84,2,0,"PP",38
20,"20025",1110,791,788,4,3,"PP",1
43,"43060",2672,2032,2015,7,17,"PP",81
3,"3017",379,320,314,4,6,"PP",31
10,"10219",1184,698,686,9,12,"PP",171
19,"19307",25,23,23,0,0,"PP",8
42,"42038",33,22,22,1,0,"PP",17
21,"21029",1514,1036,1003,14,33,"PP",223
34,"34147",164,120,120,1,0,"PP",60
37,"37013",104,72,70,2,2,"PP",27
41,"41061",2141,1661,1621,7,40,"PP",103
37,"37336",56,45,43,2,2,"PP",15
6,"6135",1101,860,849,2,11,"PP",225
12,"12109",646,489,482,4,7,"PP",111
40,"40120",195,169,163,0,6,"PP",43
46,"46029",20448,14673,14556,99,117,"PP",2873
45,"45142",7792,5717,5624,62,93,"PP",1746
18,"18121",119,79,79,1,0,"PP",11
49,"49158",206,159,155,0,4,"PP",51
32,"32017",1193,735,724,3,11,"PP",380
28,"28119",2294,1760,1738,12,22,"PP",505
18,"18185",545,434,424,5,10,"PP",68
37,"37347",463,349,345,9,4,"PP",90
37,"37169",177,122,122,0,0,"PP",29
30,"30036",15432,10030,9879,64,151,"PP",2730
48,"48001",5899,4094,4074,19,20,"PP",259
19,"19267",20,15,14,0,1,"PP",7
43,"43001",708,510,507,0,3,"PP",26
46,"46212",1620,1130,1112,12,18,"PP",246
49,"49088",80,51,51,0,0,"PP",27
38,"38046",9267,6652,6594,55,58,"PP",1308
45,"45155",311,240,240,0,0,"PP",59
3,"3123",7579,5491,5416,50,75,"PP",1286
16,"16018",376,290,290,2,0,"PP",64
37,"37190",189,141,139,1,2,"PP",82
22,"22162",125,94,94,0,0,"PP",36
49,"49260",693,480,473,3,7,"PP",181
50,"50150",624,387,384,2,3,"PP",93
19,"19177",60,45,45,0,0,"PP",13
46,"46175",429,362,355,3,7,"PP",85
10,"10061",1591,1010,992,9,18,"PP",175
40,"40215",79,66,66,2,0,"PP",34
24,"24062",126,79,79,0,0,"PP",21
37,"37369",126,83,81,0,2,"PP",28
4,"4011",2744,2010,1984,20,26,"PP",402
47,"47121",517,410,398,2,12,"PP",108
43,"43055",1970,1548,1535,12,13,"PP",44
44,"44178",52,34,34,0,0,"PP",12
42,"42181",384,281,278,3,3,"PP",63
29,"29055",1892,1425,1394,3,31,"PP",197
12,"12087",26,16,16,0,0,"PP",14
44,"44235",87,65,64,1,1,"PP",22
45,"45011",279,235,233,4,2,"PP",99
10,"10062",389,303,299,2,4,"PP",34
13,"13060",274,205,202,3,3,"PP",40
50,"50169",333,231,230,0,1,"PP",76
18,"18018",542,384,377,2,7,"PP",55
50,"50142",23,16,16,1,0,"PP",0
16,"16251",1805,1318,1302,9,16,"PP",506
16,"16172",325,233,228,1,5,"PP",104
47,"47057",272,200,199,0,1,"PP",64
5,"5147",144,101,99,0,2,"PP",44
29,"29028",1215,803,779,9,24,"PP",111
16,"16058",94,71,71,1,0,"PP",17
44,"44049",784,539,532,3,7,"PP",180
9,"9068",23,16,16,0,0,"PP",3
37,"37381",138,98,93,0,5,"PP",47
15,"15053",7469,4622,4579,44,43,"PP",1407
49,"49053",919,676,661,8,15,"PP",184
49,"49200",936,679,670,9,9,"PP",230
10,"10064",1400,998,972,3,26,"PP",326
13,"13047",5782,4232,4160,27,72,"PP",1141
39,"39087",41241,29341,29084,152,257,"PP",6106
18,"18105",3827,2436,2392,22,44,"PP",302
5,"5212",197,117,117,0,0,"PP",57
15,"15002",24040,16302,16117,183,185,"PP",4200
26,"26096",257,198,193,2,5,"PP",90
46,"46033",196,155,153,0,2,"PP",56
32,"32024",4817,3064,3014,34,50,"PP",1286
22,"22155",66,52,52,0,0,"PP",21
40,"40220",64,46,45,0,1,"PP",15
12,"12063",41,31,31,1,0,"PP",3
9,"9179",39,30,30,1,0,"PP",14
5,"5051",157,117,115,1,2,"PP",50
6,"6099",1156,683,652,5,31,"PP",102
15,"15034",2712,1605,1585,15,20,"PP",367
37,"37029",186,125,124,1,1,"PP",48
47,"47156",150,117,117,0,0,"PP",44
46,"46216",5277,4146,4111,42,35,"PP",1239
50,"50101",833,557,550,5,7,"PP",101
9,"9071",39,29,29,1,0,"PP",11
47,"47060",224,171,168,1,3,"PP",59
12,"12090",102,79,78,1,1,"PP",42
26,"26059",1109,801,791,6,10,"PP",287
21,"21067",406,274,271,3,3,"PP",20
10,"10175",1351,918,901,8,17,"PP",238
43,"43058",95,78,78,0,0,"PP",4
6,"6146",1039,764,752,7,12,"PP",150
21,"21016",985,703,680,5,23,"PP",65
42,"42215",723,468,452,10,16,"PP",166
46,"46224",156,125,124,0,1,"PP",34
9,"9166",96,77,77,0,0,"PP",43
9,"9384",292,199,193,3,6,"PP",69
42,"42083",26,20,20,0,0,"PP",10
46,"46204",6625,4946,4882,52,64,"PP",1037
22,"22208",192,150,147,1,3,"PP",27
22,"22908",190,135,134,0,1,"PP",33
12,"12065",167,142,141,0,1,"PP",57
20,"20044",355,261,261,1,0,"PP",4
22,"22157",181,122,121,2,1,"PP",24
37,"37197",88,53,53,1,0,"PP",22
20,"20024",395,245,245,4,0,"PP",2
10,"10204",423,289,287,1,2,"PP",88
27,"27049",1324,847,829,8,18,"PP",419
32,"32052",1817,1278,1268,12,10,"PP",708
46,"46126",5580,4361,4328,36,33,"PP",815
13,"13068",1023,737,722,2,15,"PP",159
19,"19297",32,28,28,0,0,"PP",14
16,"16064",651,556,550,4,6,"PP",189
34,"34024",25,14,14,0,0,"PP",9
41,"41070",6451,4715,4632,70,83,"PP",713
49,"49034",408,282,281,2,1,"PP",124
37,"37262",69,51,51,0,0,"PP",32
10,"10151",189,145,142,2,3,"PP",36
42,"42202",19,11,10,0,1,"PP",6
43,"43086",5252,3811,3790,28,21,"PP",135
47,"47159",825,672,661,0,11,"PP",193
6,"6104",648,470,459,2,11,"PP",76
30,"30003",25200,16249,16120,159,129,"PP",4090
19,"19185",26,15,15,1,0,"PP",6
9,"9352",102,74,74,0,0,"PP",34
19,"19088",91,67,66,0,1,"PP",20
16,"16029",104,76,74,0,2,"PP",19
42,"42190",94,61,61,1,0,"PP",17
42,"42053",21,17,17,0,0,"PP",13
43,"43140",2433,1685,1674,11,11,"PP",114
50,"50157",289,199,196,1,3,"PP",58
19,"19217",43,36,36,0,0,"PP",15
45,"45007",656,502,497,0,5,"PP",97
15,"15059",10229,6900,6734,85,166,"PP",2673
3,"3074",1766,1347,1336,4,11,"PP",386
9,"9424",31,24,23,0,1,"PP",14
26,"26089",111981,80365,79216,893,1149,"PP",25907
37,"37319",88,68,64,2,4,"PP",16
20,"20041",241,143,142,2,1,"PP",4
37,"37193",362,253,252,4,1,"PP",63
12,"12042",574,459,446,9,13,"PP",211
34,"34028",132,95,92,2,3,"PP",45
16,"16146",85,49,49,0,0,"PP",23
34,"34120",63790,46117,45597,464,520,"PP",15399
6,"6107",1555,980,969,8,11,"PP",162
47,"47034",75,58,58,2,0,"PP",28
4,"4058",342,238,236,3,2,"PP",47
13,"13012",381,265,261,1,4,"PP",66
16,"16199",27,18,18,0,0,"PP",8
44,"44224",21,14,14,2,0,"PP",4
16,"16096",278,219,217,1,2,"PP",52
28,"28025",405,294,291,5,3,"PP",104
49,"49209",451,274,269,7,5,"PP",115
3,"3124",459,360,358,0,2,"PP",75
4,"4092",2791,2058,2023,4,35,"PP",550
40,"40163",42,35,35,1,0,"PP",21
34,"34072",145,125,123,1,2,"PP",58
39,"39057",2366,1636,1607,10,29,"PP",438
9,"9243",73,50,49,1,1,"PP",18
6,"6064",847,616,601,3,15,"PP",80
13,"13044",2582,1838,1804,13,34,"PP",468
45,"45195",2064,1519,1481,9,38,"PP",336
27,"27033",591,334,328,0,6,"PP",132
12,"12902",2250,1557,1532,16,25,"PP",404
14,"14021",260521,185270,183300,2192,1970,"PP",46641
34,"34122",83,56,56,0,0,"PP",17
4,"4071",362,286,281,2,5,"PP",63
24,"24051",389,275,269,1,6,"PP",115
49,"49052",183,120,117,2,3,"PP",40
10,"10008",1274,921,908,1,13,"PP",339
18,"18093",2751,1693,1674,18,19,"PP",356
24,"24161",294,208,204,3,4,"PP",81
21,"21063",2611,1948,1891,23,57,"PP",217
45,"45061",2490,1690,1669,9,21,"PP",422
36,"36018",3033,1951,1926,9,25,"PP",814
15,"15064",2103,1458,1447,20,11,"PP",518
49,"49103",392,319,316,5,3,"PP",140
24,"24125",416,233,231,3,2,"PP",96
50,"50166",235,186,186,0,0,"PP",67
22,"22095",66,52,51,1,1,"PP",10
10,"10154",177,117,116,0,1,"PP",37
2,"2002",427,340,337,2,3,"PP",104
23,"23098",847,704,700,0,4,"PP",210
24,"24137",1043,700,691,8,9,"PP",142
46,"46237",7172,5199,5146,53,53,"PP",991
9,"9176",58,46,45,2,1,"PP",23
43,"43048",768,564,554,7,10,"PP",79
49,"49029",609,435,419,6,16,"PP",193
44,"44227",72,58,58,0,0,"PP",30
4,"4062",4457,3241,3197,22,44,"PP",949
43,"43127",775,607,606,3,1,"PP",24
22,"22126",89,64,64,0,0,"PP",33
28,"28134",63936,48022,47631,421,391,"PP",11006
4,"4003",17583,11062,10941,77,121,"PP",3126
6,"6113",2649,1889,1862,16,27,"PP",377
16,"16036",120,94,93,0,1,"PP",18
10,"10065",199,135,135,0,0,"PP",25
44,"44160",438,287,285,4,2,"PP",92
13,"13049",742,509,500,4,9,"PP",113
14,"14024",1849,1417,1391,5,26,"PP",255
19,"19329",58,46,46,0,0,"PP",15
20,"20063",8023,5611,5597,19,14,"PP",117
28,"28135",998,712,703,2,9,"PP",183
9,"9039",54,38,37,0,1,"PP",24
43,"43066",158,108,108,1,0,"PP",3
40,"40036",496,395,380,8,15,"PP",154
5,"5224",102,85,84,2,1,"PP",30
6,"6069",2985,1921,1874,17,47,"PP",378
38,"38026",33585,24091,23889,170,202,"PP",4231
37,"37144",327,233,233,2,0,"PP",92
43,"43172",334,248,243,4,5,"PP",6
29,"29086",770,479,476,5,3,"PP",100
34,"34228",77,59,59,1,0,"PP",25
19,"19232",56,40,40,0,0,"PP",16
4,"4097",231,173,173,1,0,"PP",40
20,"20903",5033,3355,3341,18,14,"PP",108
32,"32038",387,253,251,4,2,"PP",99
20,"20067",30609,20017,19927,111,90,"PP",1086
44,"44226",123,85,84,0,1,"PP",13
46,"46184",26514,19610,19399,180,211,"PP",3952
9,"9430",25,21,21,0,0,"PP",7
48,"48029",8681,6057,6027,41,30,"PP",439
48,"48913",1236,899,890,8,9,"PP",28
9,"9129",91,74,74,0,0,"PP",16
37,"37375",678,539,523,8,16,"PP",158
28,"28117",99,87,86,0,1,"PP",35
37,"37281",39,28,27,0,1,"PP",12
50,"50279",74,49,49,0,0,"PP",6
46,"46217",900,672,667,7,5,"PP",128
39,"39016",23850,17235,17106,70,129,"PP",4188
18,"18076",789,534,532,2,2,"PP",62
21,"21018",1719,1048,1029,12,19,"PP",133
26,"26127",182,149,149,1,0,"PP",67
14,"14054",13775,10464,10165,105,299,"PP",3229
46,"46044",4159,3062,2997,26,65,"PP",807
9,"9201",27,17,17,0,0,"PP",6
48,"48027",22745,16240,16158,74,82,"PP",1075
43,"43113",387,305,303,1,2,"PP",9
18,"18164",1790,1135,1108,11,27,"PP",388
37,"37282",193,132,131,3,1,"PP",43
24,"24117",410,302,301,1,1,"PP",168
21,"21049",3262,2028,1977,15,51,"PP",300
3,"3054",334,248,245,2,3,"PP",69
50,"50087",28,19,19,0,0,"PP",9
14,"14027",7890,5841,5726,78,115,"PP",905
42,"42205",77,59,57,3,2,"PP",24
49,"49002",58,43,40,0,3,"PP",10
9,"9423",27,24,24,1,0,"PP",13
21,"21050",12567,8522,8392,89,130,"PP",1851
13,"13902",449,329,326,4,3,"PP",63
10,"10112",1495,1071,1049,7,22,"PP",384
4,"4067",504,340,330,4,10,"PP",87
32,"32005",810,576,568,9,8,"PP",329
5,"5065",452,339,337,2,2,"PP",150
18,"18015",424,331,330,4,1,"PP",74
30,"30012",9085,6704,6599,46,105,"PP",1474
42,"42175",22,16,16,0,0,"PP",16
19,"19199",19,15,15,0,0,"PP",3
11,"11038",13632,10047,9812,99,235,"PP",2395
10,"10071",126,78,71,0,7,"PP",21
35,"35024",14323,8360,8289,81,71,"PP",1380
22,"22131",84,62,58,5,4,"PP",13
24,"24096",105,56,54,1,2,"PP",17
38,"38038",165135,101564,100807,709,757,"PP",20916
49,"49048",113,88,88,0,0,"PP",45
22,"22186",189,148,145,3,3,"PP",31
16,"16157",183,150,148,0,2,"PP",52
24,"24001",165,93,93,0,0,"PP",35
47,"47151",26,22,22,0,0,"PP",13
14,"14038",32742,23345,22974,242,371,"PP",4915
3,"3047",9768,6220,6144,41,76,"PP",1471
32,"32080",284,209,209,1,0,"PP",126
50,"50274",64,46,43,1,3,"PP",16
6,"6154",2799,1851,1782,20,69,"PP",465
19,"19076",29,23,23,0,0,"PP",6
23,"23070",3813,2384,2354,11,30,"PP",588
9,"9119",42,24,24,0,0,"PP",7
43,"43099",284,214,214,4,0,"PP",2
34,"34134",44,25,25,0,0,"PP",13
46,"46255",3220,2361,2340,20,21,"PP",492
7,"7004",4069,2652,2624,27,28,"PP",539
32,"32008",8647,5570,5495,56,75,"PP",1729
43,"43020",2291,1712,1688,19,24,"PP",100
37,"37071",76,64,62,1,2,"PP",17
37,"37370",316,238,237,2,1,"PP",119
24,"24026",1085,724,712,14,12,"PP",368
9,"9227",112,89,89,1,0,"PP",23
43,"43037",18216,11749,11672,70,77,"PP",1025
39,"39030",1874,1199,1187,6,12,"PP",277
34,"34206",810,608,602,5,6,"PP",213
37,"37151",142,109,109,1,0,"PP",67
47,"47056",81,57,57,0,0,"PP",29
32,"32013",1985,1242,1230,16,12,"PP",707
15,"15010",1805,1047,1031,19,16,"PP",460
14,"14062",945,700,693,2,7,"PP",215
26,"26134",81,67,67,3,0,"PP",28
23,"23027",711,547,539,5,8,"PP",117
45,"45184",204,123,122,0,1,"PP",15
43,"43175",534,363,359,5,4,"PP",43
9,"9466",113,84,83,1,1,"PP",47
4,"4024",3241,2315,2290,34,25,"PP",483
32,"32034",1062,763,753,6,10,"PP",330
12,"12017",145,111,110,2,1,"PP",49
40,"40191",198,143,138,0,5,"PP",47
35,"35009",20229,13378,13201,95,177,"PP",2510
20,"20021",185,104,104,2,0,"PP",0
15,"15065",7134,4869,4785,53,84,"PP",1590
29,"29019",853,604,588,2,16,"PP",145
47,"47195",426,314,310,2,4,"PP",67
43,"43901",8796,5431,5390,41,41,"PP",258
38,"38024",15316,9131,9005,60,126,"PP",2655
21,"21066",490,394,389,4,5,"PP",55
30,"30015",19344,13502,13347,107,155,"PP",4096
10,"10038",83,59,59,0,0,"PP",18
34,"34062",148,94,93,0,1,"PP",48
37,"37332",65,49,49,0,0,"PP",27
9,"9382",27,22,22,0,0,"PP",12
19,"19067",68,46,44,0,2,"PP",8
34,"34063",84,74,74,1,0,"PP",40
6,"6160",3005,2083,2056,9,27,"PP",631
46,"46193",8959,6880,6824,66,56,"PP",1237
45,"45101",3671,2842,2808,13,34,"PP",1044
44,"44172",296,216,216,1,0,"PP",78
37,"37333",203,125,124,2,1,"PP",46
6,"6039",1802,1375,1343,9,32,"PP",232
50,"50171",99,69,69,2,0,"PP",22
45,"45174",300,218,217,2,1,"PP",78
37,"37249",37,28,28,0,0,"PP",13
49,"49189",186,104,104,1,0,"PP",54
28,"28116",748,576,569,2,7,"PP",103
14,"14006",1319,1088,1057,8,31,"PP",400
46,"46019",8932,6721,6647,40,74,"PP",1301
1,"1062",318,221,219,2,2,"PP",41
10,"10203",4421,2810,2764,15,46,"PP",782
40,"40161",32,24,23,1,1,"PP",9
28,"28096",20022,14440,14238,115,202,"PP",2856
27,"27061",1018,704,683,12,21,"PP",285
46,"46032",5719,4297,4262,35,35,"PP",892
50,"50096",34,22,22,0,0,"PP",4
19,"19111",160,128,125,0,3,"PP",44
5,"5129",111,70,69,0,1,"PP",39
45,"45046",2369,1679,1651,11,28,"PP",370
40,"40053",79,56,56,1,0,"PP",16
37,"37125",231,154,148,1,6,"PP",55
12,"12055",103,77,76,2,1,"PP",22
24,"24203",88,62,62,1,0,"PP",30
26,"26167",50,34,33,1,1,"PP",21
28,"28072",6176,4716,4673,44,43,"PP",1247
44,"44024",31,26,25,0,1,"PP",14
46,"46012",965,689,675,4,14,"PP",180
42,"42217",33,25,25,0,0,"PP",7
41,"41032",3842,2800,2704,24,96,"PP",430
49,"49156",218,149,144,0,5,"PP",63
10,"10084",1266,755,717,7,38,"PP",177
18,"18910",710,439,434,1,5,"PP",124
50,"50288",3440,2513,2486,26,27,"PP",545
37,"37292",91,65,65,0,0,"PP",30
49,"49132",310,220,215,2,5,"PP",89
26,"26014",443,278,273,3,5,"PP",88
44,"44231",35,30,30,0,0,"PP",6
46,"46188",693,565,560,2,5,"PP",101
3,"3036",82,73,71,1,2,"PP",21
45,"45069",1820,1370,1355,1,15,"PP",351
34,"34901",1053,762,759,10,3,"PP",352
9,"9274",1035,774,762,8,12,"PP",238
12,"12057",572,456,437,1,19,"PP",112
47,"47180",57,41,41,1,0,"PP",14
10,"10207",455,298,291,0,7,"PP",86
15,"15080",1637,1009,992,11,17,"PP",419
4,"4009",140,109,106,2,3,"PP",47
13,"13070",747,575,556,7,19,"PP",179
40,"40154",22,18,18,1,0,"PP",10
43,"43052",927,680,674,7,6,"PP",20
22,"22068",64,41,41,1,0,"PP",15
28,"28172",9915,7715,7652,60,63,"PP",1717
41,"41018",9432,6463,6368,86,95,"PP",654
34,"34224",39,25,25,0,0,"PP",15
9,"9029",151,111,108,2,3,"PP",32
15,"15032",3430,2243,2197,12,46,"PP",1033
6,"6142",257,203,194,1,9,"PP",39
32,"32042",1487,1010,1001,12,9,"PP",530
22,"22905",287,217,217,1,0,"PP",73
42,"42188",46,35,35,1,0,"PP",11
45,"45115",2602,2013,1969,12,44,"PP",571
19,"19061",56,42,41,0,1,"PP",14
39,"39028",3892,2905,2878,20,27,"PP",834
45,"45047",2694,1733,1706,24,27,"PP",391
37,"37107",10444,6997,6884,76,113,"PP",2699
5,"5144",65,47,46,1,1,"PP",22
44,"44244",67,40,40,0,0,"PP",15
37,"37160",597,380,370,3,10,"PP",135
10,"10142",833,555,539,0,16,"PP",103
18,"18188",1646,1224,1202,10,22,"PP",239
18,"18127",17005,11790,11583,150,207,"PP",1824
34,"34011",379,290,284,2,6,"PP",122
26,"26030",18,18,17,1,1,"PP",10
43,"43107",387,285,285,3,0,"PP",5
45,"45183",2378,1555,1525,16,30,"PP",256
48,"48069",13131,9211,9162,55,49,"PP",586
2,"2034",1323,1024,1018,6,6,"PP",238
44,"44001",65,43,43,1,0,"PP",12
26,"26067",22,18,18,3,0,"PP",4
10,"10144",915,618,614,0,4,"PP",175
46,"46107",1857,1421,1402,4,19,"PP",345
47,"47143",104,67,67,0,0,"PP",41
44,"44198",182,138,135,0,3,"PP",37
37,"37150",34,31,31,0,0,"PP",24
28,"28112",160,129,129,0,0,"PP",32
16,"16057",62,45,45,0,0,"PP",9
49,"49084",266,197,195,11,2,"PP",58
13,"13050",475,348,345,1,3,"PP",101
4,"4020",302,207,206,2,1,"PP",80
11,"11903",1769,1116,1101,22,15,"PP",167
46,"46186",19689,14688,14576,118,112,"PP",2797
9,"9247",21,18,18,0,0,"PP",12
37,"37327",179,148,147,2,1,"PP",46
34,"34233",128,104,104,0,0,"PP",68
22,"22234",743,498,491,5,7,"PP",123
21,"21047",1878,1144,1112,12,32,"PP",263
40,"40151",43,31,31,0,0,"PP",19
49,"49069",337,210,201,0,9,"PP",110
10,"10096",3311,2248,2201,15,47,"PP",520
9,"9415",275,178,178,3,0,"PP",81
1,"1056",202,107,107,0,0,"PP",11
46,"46230",14116,10038,9946,63,92,"PP",1875
49,"49067",329,200,198,4,2,"PP",69
12,"12043",570,405,397,1,8,"PP",102
50,"50271",246,179,173,4,6,"PP",71
49,"49019",232,162,152,2,10,"PP",61
44,"44093",78,62,61,0,1,"PP",21
6,"6159",2329,1297,1273,22,24,"PP",263
47,"47104",2816,2153,2099,20,54,"PP",774
5,"5083",137,92,91,0,1,"PP",43
10,"10052",172,114,113,3,1,"PP",48
40,"40070",143,94,92,1,2,"PP",23
19,"19262",125,98,98,0,0,"PP",36
41,"41020",13012,8148,7999,135,149,"PP",1054
40,"40189",471,344,329,1,15,"PP",94
47,"47029",50,37,35,1,2,"PP",17
6,"6054",5452,3773,3657,34,116,"PP",1066
4,"4016",2136,1486,1467,13,19,"PP",360
10,"10094",220,167,165,0,2,"PP",26
39,"39014",882,538,536,0,2,"PP",111
1,"1044",232,151,148,2,3,"PP",21
24,"24066",439,274,273,3,1,"PP",127
46,"46072",3522,2792,2741,25,51,"PP",657
48,"48904",3547,2563,2541,18,22,"PP",180
35,"35006",31373,20764,20476,189,288,"PP",3860
6,"6151",1049,746,741,5,5,"PP",175
5,"5074",668,540,537,5,3,"PP",229
37,"37357",248,193,192,1,1,"PP",76
6,"6090",827,570,553,3,17,"PP",121
10,"10162",519,401,394,4,7,"PP",82
5,"5195",199,125,125,1,0,"PP",43
16,"16191",850,664,653,11,11,"PP",216
30,"30014",1587,1150,1134,4,16,"PP",207
38,"38901",1466,908,894,4,14,"PP",150
37,"37082",733,468,456,7,12,"PP",154
46,"46136",2598,1875,1851,14,24,"PP",417
43,"43053",186,135,134,0,1,"PP",2
14,"14049",16185,11561,11323,145,238,"PP",2188
46,"46103",1354,993,978,8,15,"PP",236
26,"26178",72,56,56,1,0,"PP",21
12,"12037",17,13,13,1,0,"PP",3
21,"21068",973,562,556,11,6,"PP",84
16,"16228",173,147,145,2,2,"PP",75
37,"37089",60,44,43,0,1,"PP",19
6,"6138",1021,677,658,5,19,"PP",121
10,"10178",724,499,494,3,5,"PP",176
37,"37314",81,65,65,0,0,"PP",36
44,"44240",151,119,117,0,2,"PP",29
49,"49063",303,228,227,3,1,"PP",85
45,"45152",545,402,393,1,9,"PP",99
42,"42052",16,14,14,0,0,"PP",8
48,"48084",21780,14368,14271,79,97,"PP",960
47,"47189",151,128,122,1,6,"PP",56
46,"46127",2748,2035,2009,6,26,"PP",467
6,"6150",777,592,588,0,4,"PP",104
47,"47063",86,68,68,0,0,"PP",29
49,"49206",776,515,504,7,11,"PP",209
22,"22082",288,217,214,0,3,"PP",75
45,"45081",19268,13690,13516,104,174,"PP",2761
42,"42095",1909,1345,1326,32,19,"PP",339
23,"23033",1325,1008,989,11,19,"PP",240
13,"13040",839,639,623,7,16,"PP",190
29,"29061",1043,803,773,9,30,"PP",115
37,"37057",208,151,149,0,2,"PP",90
32,"32037",679,454,446,6,8,"PP",226
49,"49096",155,113,112,2,1,"PP",44
3,"3902",10640,7024,6952,36,72,"PP",1908
47,"47146",275,215,214,1,1,"PP",31
41,"41086",16199,10227,10105,137,122,"PP",1511
21,"21070",6294,4232,4124,64,108,"PP",601
5,"5238",728,529,525,1,4,"PP",206
6,"6141",1678,1183,1158,15,25,"PP",332
26,"26044",51,38,36,0,2,"PP",9
23,"23039",2170,1502,1460,10,42,"PP",396
22,"22001",212,147,146,0,1,"PP",60
43,"43030",483,356,351,2,5,"PP",15
16,"16082",272,194,192,1,2,"PP",43
3,"3136",399,302,301,3,1,"PP",78
19,"19168",265,182,175,4,7,"PP",38
10,"10218",1074,685,672,0,13,"PP",175
43,"43170",877,664,661,4,3,"PP",16
46,"46159",23038,16719,16596,127,123,"PP",3275
10,"10209",259,151,149,0,2,"PP",33
37,"37379",169,133,132,0,1,"PP",40
26,"26033",162,133,132,3,1,"PP",33
48,"48911",381,303,302,1,1,"PP",4
4,"4074",2910,1813,1789,15,24,"PP",346
19,"19191",13,12,12,0,0,"PP",3
12,"12105",825,602,598,6,4,"PP",234
42,"42156",29,21,21,0,0,"PP",8
49,"49149",368,270,266,1,4,"PP",114
47,"47023",3057,2369,2359,20,10,"PP",613
16,"16070",29,27,27,0,0,"PP",5
37,"37380",55,41,40,2,1,"PP",5
49,"49027",125,82,81,0,1,"PP",43
22,"22201",264,188,186,3,2,"PP",42
46,"46198",862,670,660,3,10,"PP",108
10,"10076",791,537,525,10,12,"PP",126
30,"30022",17108,11041,10851,100,190,"PP",3127
42,"42118",21,11,11,0,0,"PP",8
19,"19301",37,26,26,0,0,"PP",11
40,"40055",31,26,26,0,0,"PP",11
16,"16280",163,122,119,2,3,"PP",56
46,"46054",11389,8266,8190,54,76,"PP",1600
29,"29033",1084,733,722,5,11,"PP",159
21,"21030",1887,1493,1458,12,35,"PP",304
5,"5001",182,139,138,1,1,"PP",59
40,"40214",198,160,154,0,6,"PP",59
9,"9014",182,101,101,0,0,"PP",44
5,"5165",361,266,261,4,5,"PP",94
50,"50092",290,218,214,0,4,"PP",55
6,"6105",592,367,363,1,4,"PP",102
47,"47033",205,151,150,2,1,"PP",57
20,"20078",1143,819,816,1,3,"PP",9
39,"39002",3408,2360,2323,7,37,"PP",529
36,"36039",15609,10562,10341,102,221,"PP",2943
46,"46199",5878,4217,4182,21,35,"PP",958
4,"4027",218,130,130,0,0,"PP",47
5,"5257",132,98,95,4,3,"PP",38
47,"47124",383,302,300,3,2,"PP",103
6,"6057",530,409,400,0,9,"PP",144
42,"42167",235,163,161,4,2,"PP",62
23,"23003",8639,6296,6226,41,70,"PP",1426
13,"13002",1415,966,950,3,16,"PP",310
50,"50141",104,80,78,0,2,"PP",48
6,"6042",984,644,629,5,15,"PP",143
46,"46020",3757,2834,2783,16,51,"PP",725
9,"9093",162,131,131,1,0,"PP",36
16,"16116",76,59,58,1,1,"PP",18
3,"3131",176,129,126,1,3,"PP",49
37,"37343",66,44,43,1,1,"PP",12
18,"18028",898,723,718,3,5,"PP",212
5,"5901",247,154,152,3,2,"PP",57
37,"37278",793,570,567,6,3,"PP",130
38,"38017",30964,16228,16102,108,126,"PP",2725
43,"43093",3863,2728,2716,22,12,"PP",132
46,"46155",972,731,716,3,15,"PP",137
49,"49107",115,70,70,0,0,"PP",24
2,"2048",1173,912,901,9,11,"PP",298
29,"29039",2759,1900,1860,23,40,"PP",259
48,"48035",406,314,314,0,0,"PP",7
49,"49231",288,208,203,0,5,"PP",86
34,"34094",61,45,45,2,0,"PP",13
4,"4090",298,229,225,1,4,"PP",62
46,"46249",9136,6538,6439,73,99,"PP",1463
13,"13086",158,122,120,0,2,"PP",39
40,"40179",620,500,490,3,10,"PP",194
12,"12081",606,454,446,2,8,"PP",149
13,"13065",2777,1766,1728,10,38,"PP",558
29,"29043",2463,1508,1460,20,48,"PP",269
1,"1034",152,107,107,1,0,"PP",4
11,"11017",3198,2054,2004,37,50,"PP",330
9,"9067",399,232,230,3,2,"PP",98
19,"19027",129,97,95,1,2,"PP",31
40,"40182",169,112,112,1,0,"PP",43
47,"47130",94,64,63,0,1,"PP",21
16,"16079",28,16,16,0,0,"PP",4
11,"11014",17203,10923,10805,222,118,"PP",1785
9,"9027",47,38,34,1,4,"PP",5
37,"37068",337,240,236,1,4,"PP",96
46,"46240",200,167,155,1,12,"PP",36
35,"35020",5941,3740,3702,27,38,"PP",550
47,"47188",98,73,70,0,3,"PP",32
46,"46063",1786,1270,1255,8,15,"PP",260
50,"50284",129,98,98,0,0,"PP",34
30,"30031",497,387,382,1,5,"PP",171
28,"28124",73,51,50,0,1,"PP",18
16,"16139",317,226,222,1,4,"PP",101
12,"12075",110,85,83,3,2,"PP",20
41,"41080",1231,832,815,14,17,"PP",152
37,"37087",911,675,665,5,10,"PP",178
42,"42148",9,9,9,0,0,"PP",2
41,"41002",1421,938,911,7,27,"PP",225
19,"19225",851,618,611,2,7,"PP",86
20,"20046",1243,822,816,1,6,"PP",23
48,"48056",980,731,728,3,3,"PP",11
3,"3026",1331,987,975,7,12,"PP",195
22,"22172",520,373,369,5,4,"PP",115
2,"2019",2352,1806,1766,9,40,"PP",398
9,"9045",269,159,158,0,1,"PP",71
9,"9334",51,36,34,1,2,"PP",9
46,"46150",1794,1276,1272,8,4,"PP",338
49,"49092",115,72,72,0,0,"PP",34
10,"10006",1224,907,893,7,14,"PP",248
14,"14011",580,444,443,3,1,"PP",123
46,"46143",4274,3027,2995,19,32,"PP",782
47,"47223",148,105,102,4,3,"PP",31
18,"18153",8834,6174,6063,54,111,"PP",1074
23,"23057",727,582,572,7,10,"PP",72
48,"48091",1078,758,757,5,1,"PP",16
9,"9170",207,151,150,1,1,"PP",49
3,"3068",41,38,37,0,1,"PP",25
44,"44190",63,45,45,0,0,"PP",13
6,"6133",1795,1308,1294,11,14,"PP",321
44,"44122",1277,939,934,5,5,"PP",241
14,"14046",4442,3283,3190,34,93,"PP",290
37,"37211",208,148,148,0,0,"PP",63
40,"40033",70,55,52,1,3,"PP",11
10,"10157",246,163,161,0,2,"PP",54
10,"10136",274,205,202,1,3,"PP",52
45,"45058",344,245,236,1,9,"PP",76
5,"5166",155,108,104,1,4,"PP",42
16,"16026",91,69,68,0,1,"PP",26
43,"43045",143,114,113,0,1,"PP",1
11,"11002",4218,3176,3149,16,27,"PP",134
16,"16212",233,186,184,0,2,"PP",70
41,"41074",2994,2154,2105,19,49,"PP",327
39,"39048",1772,1311,1295,8,16,"PP",381
44,"44263",373,267,267,2,0,"PP",35
38,"38052",1283,806,794,3,12,"PP",189
46,"46170",3417,2618,2577,11,41,"PP",578
41,"41033",4958,3299,3250,38,49,"PP",569
10,"10156",97,71,69,0,2,"PP",17
6,"6124",1635,1158,1119,10,39,"PP",270
40,"40142",52,39,37,0,2,"PP",17
49,"49184",172,110,107,2,3,"PP",62
40,"40022",195,144,141,2,3,"PP",49
3,"3105",5510,3879,3792,27,87,"PP",964
39,"39067",753,476,474,1,2,"PP",122
47,"47194",295,228,227,1,1,"PP",46
45,"45043",776,608,598,3,10,"PP",244
22,"22080",263,188,184,3,4,"PP",68
1,"1030",141,102,102,0,0,"PP",26
9,"9135",41,28,28,0,0,"PP",13
5,"5073",282,210,207,1,3,"PP",93
37,"37373",692,451,442,4,9,"PP",118
35,"35003",5644,2987,2943,20,44,"PP",692
46,"46049",268,221,217,2,4,"PP",77
28,"28009",14593,11026,10913,73,113,"PP",2814
19,"19074",67,57,57,1,0,"PP",8
10,"10004",692,482,473,8,9,"PP",126
29,"29024",371,216,204,3,12,"PP",36
21,"21056",2914,2148,2046,29,102,"PP",366
50,"50059",757,556,551,5,5,"PP",130
49,"49269",218,126,124,1,2,"PP",61
13,"13043",205,163,162,1,1,"PP",70
42,"42010",21,15,14,0,1,"PP",9
26,"26070",152,125,122,1,3,"PP",60
49,"49219",7196,4613,4528,64,85,"PP",1265
49,"49138",205,141,140,2,1,"PP",62
39,"39031",1237,870,865,1,5,"PP",261
9,"9152",244,161,161,0,0,"PP",64
6,"6082",399,295,291,6,4,"PP",73
4,"4005",534,422,419,3,3,"PP",155
4,"4046",849,617,612,6,5,"PP",147
3,"3070",2115,1399,1376,9,23,"PP",377
4,"4077",296,270,268,3,2,"PP",150
43,"43144",1245,975,966,1,9,"PP",54
44,"44025",5804,4024,3991,11,33,"PP",618
50,"50012",94,76,72,0,4,"PP",15
44,"44144",319,225,223,0,2,"PP",41
38,"38020",16057,9921,9809,66,112,"PP",1692
43,"43145",4209,3193,3170,17,23,"PP",143
7,"7019",161,104,102,0,2,"PP",62
47,"47030",935,680,669,5,11,"PP",214
46,"46231",2403,1670,1652,11,18,"PP",251
43,"43088",2013,1429,1420,11,9,"PP",65
22,"22220",147,106,105,1,1,"PP",21
11,"11028",32829,21934,21654,310,280,"PP",2044
48,"48066",344,246,246,2,0,"PP",1
16,"16167",288,225,217,0,8,"PP",56
18,"18004",669,467,466,6,1,"PP",129
24,"24202",7504,4607,4538,51,69,"PP",811
43,"43016",3470,2547,2508,15,39,"PP",132
37,"37136",625,388,387,7,1,"PP",107
37,"37221",391,259,257,2,2,"PP",86
22,"22143",190,118,115,1,3,"PP",46
28,"28054",11943,8800,8731,72,69,"PP",2125
26,"26027",139,99,97,0,2,"PP",43
12,"12129",1783,1207,1184,16,23,"PP",202
30,"30043",25449,18839,18477,180,362,"PP",5865
40,"40213",93,78,78,1,0,"PP",20
20,"20006",261,154,153,1,1,"PP",1
6,"6013",261,209,204,4,5,"PP",19
46,"46058",1734,1245,1230,8,15,"PP",249
42,"42127",37,26,26,1,0,"PP",12
29,"29005",4507,3012,2965,29,47,"PP",607
37,"37232",377,303,303,2,0,"PP",156
9,"9454",41,34,33,1,1,"PP",10
43,"43138",2636,1761,1745,11,16,"PP",178
19,"19047",55,47,47,1,0,"PP",9
6,"6158",13367,9319,9131,90,188,"PP",2176
32,"32053",1362,1001,989,10,12,"PP",576
21,"21002",16070,11301,11137,132,164,"PP",2121
50,"50182",3657,2499,2485,23,14,"PP",472
49,"49114",40,31,27,0,4,"PP",12
41,"41045",5873,3901,3802,53,99,"PP",435
3,"3125",332,226,226,2,0,"PP",55
37,"37047",215,89,89,0,0,"PP",63
39,"39022",970,673,668,2,5,"PP",253
50,"50010",67,52,52,1,0,"PP",20
19,"19242",74,53,53,1,0,"PP",27
46,"46134",2419,1697,1678,14,19,"PP",278
42,"42145",129,105,104,1,1,"PP",42
28,"28085",4194,3126,3091,24,35,"PP",790
27,"27020",3365,2544,2500,42,44,"PP",1550
30,"30011",4702,3390,3324,8,66,"PP",953
16,"16109",41,30,30,0,0,"PP",12
15,"15079",1437,887,868,8,19,"PP",396
19,"19235",98,77,76,1,1,"PP",12
19,"19151",1077,703,693,8,10,"PP",150
26,"26069",230,166,166,0,0,"PP",76
50,"50207",87,58,58,1,0,"PP",18
37,"37245",331,221,220,4,1,"PP",96
27,"27043",1222,746,737,12,9,"PP",298
50,"50019",63,46,46,0,0,"PP",20
45,"45003",554,398,393,2,5,"PP",106
14,"14033",1239,875,856,8,19,"PP",123
39,"39099",3193,2363,2346,10,17,"PP",512
3,"3050",19420,13210,13116,70,94,"PP",3269
43,"43166",1646,1183,1176,4,7,"PP",77
9,"9231",57,35,35,2,0,"PP",11
43,"43084",514,388,383,2,5,"PP",8
39,"39101",231,134,132,2,2,"PP",15
10,"10066",161,121,120,1,1,"PP",42
19,"19321",34,28,28,0,0,"PP",5
48,"48009",774,585,578,0,7,"PP",12
24,"24164",351,175,174,0,1,"PP",46
28,"28066",7575,5771,5718,58,53,"PP",1502
34,"34088",265,195,191,1,4,"PP",56
37,"37204",253,176,173,2,3,"PP",81
13,"13074",943,759,749,5,10,"PP",213
27,"27005",2560,1691,1662,19,29,"PP",611
10,"10107",1019,766,755,12,11,"PP",213
29,"29042",14586,9793,9649,95,144,"PP",2032
39,"39045",352,238,234,0,4,"PP",71
42,"42014",57,35,35,0,0,"PP",17
34,"34113",40,38,38,0,0,"PP",17
13,"13089",1609,1248,1228,10,20,"PP",334
9,"9230",33,26,26,0,0,"PP",21
1,"1019",148,112,112,0,0,"PP",11
10,"10030",455,311,305,2,6,"PP",93
9,"9279",166,116,114,1,2,"PP",62
46,"46059",1244,1007,995,5,12,"PP",162
44,"44084",54,46,46,1,0,"PP",21
47,"47128",53,45,43,0,2,"PP",31
26,"26142",789,572,564,6,8,"PP",230
9,"9239",47,31,31,0,0,"PP",18
40,"40061",63,47,44,0,3,"PP",22
4,"4089",687,484,479,2,5,"PP",155
48,"48047",147,105,105,2,0,"PP",0
2,"2074",5890,4054,4010,39,44,"PP",1016
9,"9288",87,64,64,0,0,"PP",25
44,"44210",750,577,572,2,5,"PP",114
29,"29903",485,326,324,2,2,"PP",57
24,"24095",317,228,228,3,0,"PP",73
43,"43112",245,179,179,3,0,"PP",3
1,"1054",998,701,700,4,1,"PP",27
28,"28138",60,43,42,0,1,"PP",16
24,"24033",209,149,149,0,0,"PP",72
44,"44213",68,47,47,0,0,"PP",17
22,"22022",542,405,403,2,2,"PP",89
21,"21052",4403,2688,2631,26,57,"PP",319
47,"47152",67,59,59,0,0,"PP",11
19,"19147",42,32,32,0,0,"PP",10
20,"20055",17300,11784,11725,43,59,"PP",484
5,"5109",445,334,329,4,5,"PP",136
15,"15003",1675,1029,1020,9,9,"PP",479
44,"44228",96,75,74,0,1,"PP",27
19,"19125",45,23,23,0,0,"PP",8
41,"41014",2476,1852,1799,10,53,"PP",127
45,"45084",2103,1533,1508,7,25,"PP",345
9,"9082",36,32,32,0,0,"PP",29
16,"16273",300,214,211,3,3,"PP",91
50,"50078",227,168,166,0,2,"PP",44
26,"26051",213,165,165,1,0,"PP",65
16,"16243",376,316,309,4,7,"PP",99
9,"9127",52,36,35,0,1,"PP",23
43,"43904",2864,1881,1851,20,30,"PP",130
22,"22903",618,484,482,5,2,"PP",144
5,"5249",96,63,63,0,0,"PP",13
27,"27040",3008,2071,2046,21,25,"PP",1091
37,"37352",209,157,155,3,2,"PP",45
6,"6098",530,379,376,4,3,"PP",75
34,"34009",30,26,26,0,0,"PP",17
45,"45031",2861,1894,1858,13,36,"PP",444
15,"15902",4507,2885,2837,34,48,"PP",1155
27,"27025",2731,2047,2006,18,41,"PP",918
10,"10025",377,308,299,3,9,"PP",79
44,"44135",99,73,73,1,0,"PP",24
39,"39020",23993,15944,15792,89,152,"PP",2683
45,"45203",2777,1986,1961,18,25,"PP",343
16,"16193",55,50,49,0,1,"PP",12
6,"6058",1984,1372,1331,13,41,"PP",296
18,"18108",822,604,599,2,5,"PP",119
7,"7902",1091,663,645,13,18,"PP",206
45,"45141",848,626,615,0,11,"PP",191
28,"28063",252,188,187,1,1,"PP",44
43,"43136",10489,7029,6996,47,33,"PP",351
16,"16185",36,31,31,0,0,"PP",12
37,"37171",396,272,270,2,2,"PP",151
5,"5141",95,79,78,1,1,"PP",28
13,"13095",66,56,56,3,0,"PP",16
24,"24129",114,79,78,2,1,"PP",26
22,"22107",102,53,53,0,0,"PP",11
5,"5154",31,23,23,0,0,"PP",11
23,"23075",3222,2513,2475,19,38,"PP",567
7,"7062",7972,3946,3896,42,50,"PP",870
29,"29013",1613,1191,1154,9,37,"PP",169
24,"24226",194,118,118,1,0,"PP",53
10,"10179",272,209,209,2,0,"PP",50
4,"4099",4930,3526,3462,22,64,"PP",898
24,"24065",2164,1524,1492,12,32,"PP",366
43,"43096",97,76,76,0,0,"PP",2
10,"10147",1277,873,837,6,36,"PP",155
16,"16908",166,133,132,2,1,"PP",25
41,"41024",22819,14767,14455,169,312,"PP",2617
15,"15061",5149,3221,3168,44,53,"PP",1278
48,"48036",24015,16501,16425,83,76,"PP",957
20,"20029",4264,3116,3104,14,12,"PP",60
22,"22011",98,80,79,0,1,"PP",28
46,"46246",1049,808,793,3,15,"PP",246
45,"45076",574,361,357,1,4,"PP",116
21,"21035",9766,6114,5998,92,116,"PP",1490
34,"34079",1729,1296,1275,19,21,"PP",402
48,"48025",874,667,662,2,5,"PP",3
46,"46132",2176,1725,1708,5,17,"PP",473
37,"37311",201,157,156,1,1,"PP",69
37,"37235",214,163,159,2,4,"PP",42
35,"35018",13153,7742,7674,80,68,"PP",1224
28,"28154",5570,3999,3961,29,38,"PP",812
16,"16277",105,74,74,0,0,"PP",37
9,"9327",26,20,20,0,0,"PP",8
50,"50026",418,292,288,4,4,"PP",68
9,"9362",198,156,156,4,0,"PP",45
9,"9408",40,29,29,0,0,"PP",17
37,"37366",40,34,33,2,1,"PP",17
28,"28002",3250,2261,2243,14,18,"PP",551
22,"22088",143,98,97,1,1,"PP",26
46,"46238",13117,9172,9088,50,84,"PP",1858
3,"3014",238937,161861,160809,1308,1052,"PP",40748
43,"43171",14849,10140,10081,76,59,"PP",937
3,"3901",1137,783,776,9,7,"PP",143
13,"13009",1383,1081,1070,3,11,"PP",351
40,"40200",38,28,28,0,0,"PP",6
32,"32032",7900,5186,5091,48,95,"PP",2014
50,"50134",120,85,82,4,3,"PP",35
46,"46041",313,229,228,1,1,"PP",45
13,"13039",14195,10104,9933,122,171,"PP",2952
47,"47070",29,24,24,0,0,"PP",14
16,"16904",453,348,345,11,3,"PP",90
16,"16024",121,85,84,0,1,"PP",25
19,"19283",29,26,26,0,0,"PP",8
2,"2055",1055,672,668,2,4,"PP",121
10,"10007",627,457,447,3,10,"PP",185
10,"10143",141,109,105,0,4,"PP",31
24,"24114",2866,1753,1742,15,11,"PP",366
9,"9114",77,60,59,0,1,"PP",26
29,"29026",1021,703,698,15,5,"PP",133
5,"5904",108,70,69,5,1,"PP",31
7,"7015",22248,12375,12286,202,89,"PP",3197
47,"47005",506,358,348,3,10,"PP",102
40,"40150",60,42,42,0,0,"PP",21
10,"10116",3737,2579,2507,34,72,"PP",476
15,"15066",3995,2746,2695,29,51,"PP",1272
29,"29029",383,256,254,4,2,"PP",96
24,"24149",149,123,123,0,0,"PP",53
30,"30008",14560,9974,9840,79,134,"PP",2397
40,"40157",39,30,30,0,0,"PP",10
12,"12041",92,69,69,2,0,"PP",27
22,"22184",167,132,130,4,2,"PP",48
50,"50148",304,213,211,2,2,"PP",61
50,"50119",876,633,625,11,8,"PP",155
12,"12067",514,381,373,3,8,"PP",101
29,"29058",1542,994,979,5,15,"PP",139
47,"47101",1634,1278,1262,7,16,"PP",372
44,"44031",83,50,50,0,0,"PP",18
10,"10183",950,696,684,3,12,"PP",207
9,"9433",52,40,40,0,0,"PP",13
21,"21026",262,172,168,2,4,"PP",17
5,"5231",150,123,122,2,1,"PP",54
15,"15069",6604,4587,4520,55,67,"PP",1212
37,"37023",1624,1233,1211,15,22,"PP",306
29,"29064",423,291,285,2,6,"PP",62
34,"34222",107,71,68,1,3,"PP",42
43,"43031",1447,1085,1072,13,13,"PP",49
19,"19122",81,62,60,2,2,"PP",19
7,"7044",8812,5679,5569,67,110,"PP",1621
12,"12044",442,371,368,1,3,"PP",105
36,"36006",11502,8057,7927,53,130,"PP",2961
19,"19271",41,22,21,1,1,"PP",12
16,"16225",55,30,30,0,0,"PP",10
39,"39036",965,707,703,4,4,"PP",191
45,"45149",517,400,393,2,7,"PP",151
5,"5080",42,30,30,0,0,"PP",15
50,"50168",29,20,20,0,0,"PP",3
42,"42018",127,94,94,1,0,"PP",42
39,"39069",1934,1475,1458,2,17,"PP",231
6,"6903",2011,1443,1416,18,27,"PP",305
44,"44111",78,61,61,0,0,"PP",12
35,"35008",6214,4193,4143,33,50,"PP",989
28,"28078",40,38,38,0,0,"PP",13
32,"32036",1242,856,838,14,18,"PP",468
42,"42061",270,188,186,5,2,"PP",65
20,"20066",437,288,286,1,2,"PP",0
5,"5061",257,193,189,1,4,"PP",30
21,"21902",1136,744,739,2,5,"PP",61
16,"16903",992,750,732,8,18,"PP",323
22,"22197",436,327,325,3,2,"PP",83
9,"9346",90,61,60,1,1,"PP",24
40,"40904",344,286,284,8,2,"PP",115
49,"49202",173,103,101,0,2,"PP",32
12,"12130",414,329,327,0,2,"PP",201
34,"34213",53,46,46,0,0,"PP",19
28,"28036",2699,1977,1957,20,20,"PP",304
10,"10905",636,443,433,7,10,"PP",100
17,"17136",196,150,150,0,0,"PP",7
17,"17153",189,150,149,1,1,"PP",2
17,"17216",158,122,121,0,1,"PP",7
17,"17160",14756,9892,9852,58,40,"PP",485
17,"17064",324,249,247,2,2,"PP",7
17,"17074",536,403,401,1,2,"PP",28
17,"17901",987,733,725,5,8,"PP",18
17,"17133",1262,976,964,7,12,"PP",17
17,"17077",565,395,394,2,1,"PP",22
17,"17181",3458,2454,2443,18,11,"PP",131
17,"17163",2868,2281,2268,13,13,"PP",48
17,"17228",285,218,217,0,1,"PP",10
17,"17146",3150,2243,2224,8,19,"PP",113
17,"17006",1178,826,818,9,8,"PP",10
17,"17039",1726,1306,1297,7,9,"PP",47
17,"17203",165,126,126,0,0,"PP",3
17,"17065",321,264,263,3,1,"PP",7
17,"17192",143,107,104,0,3,"PP",3
17,"17086",1769,1116,1109,6,7,"PP",102
17,"17204",609,429,428,6,1,"PP",23
17,"17174",164,130,130,4,0,"PP",3
17,"17015",12829,9612,9580,51,32,"PP",261
17,"17170",173,140,140,2,0,"PP",1
17,"17115",276,208,208,4,0,"PP",7
17,"17225",205,150,150,1,0,"PP",12
17,"17233",2347,1853,1840,11,13,"PP",75
17,"17058",176,128,128,0,0,"PP",3
17,"17118",12934,8723,8665,38,58,"PP",390
17,"17109",704,542,539,2,3,"PP",5
17,"17173",181,143,143,1,0,"PP",6
17,"17024",281,203,201,4,2,"PP",14
17,"17105",248,187,186,2,1,"PP",5
17,"17078",335,245,245,0,0,"PP",11
17,"17147",7916,5672,5641,41,31,"PP",247
17,"17232",146,111,111,0,0,"PP",5
17,"17187",625,496,492,3,4,"PP",12
17,"17165",645,502,502,2,0,"PP",13
17,"17003",103,85,85,0,0,"PP",2
17,"17048",6284,4077,4048,34,29,"PP",343
17,"17132",1344,1019,1009,12,10,"PP",43
17,"17018",494,377,372,4,5,"PP",8
17,"17033",5647,3879,3852,25,27,"PP",209
17,"17210",572,414,411,2,3,"PP",19
17,"17067",704,551,549,6,2,"PP",12
17,"17022",7043,4940,4903,34,37,"PP",161
17,"17016",737,570,563,2,7,"PP",20
17,"17085",293,239,238,0,1,"PP",5
17,"17201",137,103,103,0,0,"PP",2
17,"17126",316,269,269,1,0,"PP",6
17,"17198",437,307,306,0,1,"PP",16
17,"17189",1481,1228,1223,5,5,"PP",20
17,"17092",3462,2414,2389,14,25,"PP",89
17,"17100",193,147,141,0,6,"PP",2
17,"17098",308,232,230,4,2,"PP",6
17,"17062",5982,4025,4001,19,24,"PP",199
17,"17207",2420,1920,1901,9,19,"PP",43
17,"17111",984,728,728,7,0,"PP",24
17,"17184",1261,1016,1010,7,6,"PP",21
17,"17071",1134,943,940,1,3,"PP",21
17,"17180",8508,5977,5953,38,24,"PP",210
17,"17218",576,456,451,3,5,"PP",15
17,"17107",267,207,205,2,2,"PP",9
17,"17002",578,477,474,2,3,"PP",16
17,"17159",622,459,459,1,0,"PP",15
17,"17030",654,460,459,1,1,"PP",32
17,"17141",6019,3855,3833,43,22,"PP",333
17,"17129",143,108,108,2,0,"PP",7
17,"17042",410,299,297,5,2,"PP",17
17,"17084",228,163,162,1,1,"PP",7
17,"17161",1023,844,843,5,1,"PP",27
17,"17041",217,150,146,1,4,"PP",9
17,"17197",128,97,97,0,0,"PP",1
17,"17188",171,134,134,1,0,"PP",3
17,"17214",714,516,511,6,5,"PP",19
17,"17001",575,428,426,4,2,"PP",8
17,"17123",343,286,284,2,2,"PP",9
17,"17005",457,322,320,3,2,"PP",8
17,"17026",549,421,415,3,6,"PP",15
17,"17020",3677,2851,2835,14,16,"PP",60
17,"17215",2286,1855,1844,13,11,"PP",75
17,"17046",709,537,531,2,6,"PP",13
17,"17212",145,111,109,0,2,"PP",1
17,"17080",144,113,113,1,0,"PP",6
17,"17168",373,309,308,3,1,"PP",3
17,"17125",136,100,100,3,0,"PP",4
17,"17038",377,303,301,0,2,"PP",5
17,"17055",142,124,124,0,0,"PP",2
17,"17068",253,191,191,0,0,"PP",3
17,"17057",968,770,769,7,1,"PP",24
17,"17186",3834,2980,2954,17,26,"PP",116
17,"17195",338,274,272,1,2,"PP",7
17,"17120",823,560,558,5,2,"PP",30
17,"17079",65572,47740,47502,279,238,"PP",2679
17,"17209",615,472,471,5,1,"PP",18
17,"17037",112,86,86,1,0,"PP",0
17,"17234",181,129,129,1,0,"PP",3
17,"17178",1065,774,771,9,3,"PP",23
17,"17224",299,226,222,2,4,"PP",4
17,"17205",209,167,166,0,1,"PP",0
17,"17028",297,216,214,2,2,"PP",6
17,"17010",332,252,251,2,1,"PP",0
17,"17142",2713,2166,2159,18,7,"PP",127
17,"17043",165,133,133,0,0,"PP",3
17,"17167",2585,2015,1998,11,17,"PP",59
17,"17194",73,56,56,0,0,"PP",1
17,"17008",3605,2595,2577,8,18,"PP",73
17,"17035",544,447,447,2,0,"PP",12
17,"17227",147,104,104,0,0,"PP",1
17,"17206",158,111,109,0,2,"PP",11
17,"17117",14497,9438,9382,66,56,"PP",569
17,"17011",645,518,514,10,4,"PP",10
17,"17044",6938,5245,5212,33,33,"PP",192
17,"17128",321,239,238,1,1,"PP",5
17,"17029",207,154,154,1,0,"PP",8
17,"17138",836,591,584,7,7,"PP",41
17,"17158",565,296,295,2,1,"PP",15
17,"17031",178,117,117,0,0,"PP",7
17,"17903",883,681,676,3,5,"PP",24
17,"17176",128,111,111,0,0,"PP",9
17,"17177",562,426,423,1,3,"PP",12
17,"17021",119,89,87,0,2,"PP",1
17,"17095",20044,12638,12576,88,62,"PP",919
17,"17102",556,398,396,1,2,"PP",7
17,"17112",198,148,147,3,1,"PP",8
17,"17093",913,637,634,5,3,"PP",32
17,"17124",1593,1163,1160,8,3,"PP",37
17,"17070",110,87,87,0,0,"PP",3
17,"17169",2511,1901,1890,8,11,"PP",77
17,"17090",539,440,440,2,0,"PP",18
17,"17121",225,166,163,2,3,"PP",5
17,"17221",4138,2999,2988,23,11,"PP",239
17,"17154",101,76,76,0,0,"PP",1
17,"17171",177,138,137,0,1,"PP",2
17,"17023",27314,18677,18546,117,131,"PP",1253
17,"17099",78,55,55,0,0,"PP",8
17,"17012",1175,845,842,4,3,"PP",40
17,"17014",66,51,49,0,2,"PP",2
17,"17032",1745,1139,1133,6,6,"PP",27
17,"17223",808,566,563,1,3,"PP",21
17,"17902",1294,992,990,9,2,"PP",38
17,"17034",7289,4880,4862,23,18,"PP",283
17,"17208",978,723,719,6,4,"PP",17
17,"17196",252,200,200,1,0,"PP",10
17,"17081",252,186,185,2,1,"PP",4
17,"17222",104,87,87,1,0,"PP",1
17,"17091",391,296,290,3,6,"PP",8
17,"17051",202,161,160,0,1,"PP",6
17,"17164",3918,2856,2838,17,18,"PP",54
17,"17103",5057,3196,3174,21,22,"PP",191
17,"17183",253,197,197,2,0,"PP",8
17,"17152",11065,6959,6927,68,32,"PP",627
17,"17013",2765,1999,1985,15,14,"PP",127
17,"17143",145,104,104,0,0,"PP",3
17,"17193",4351,2945,2927,21,18,"PP",140
17,"17097",200,170,167,2,3,"PP",5
17,"17076",119,95,94,2,1,"PP",1
17,"17075",340,257,256,2,1,"PP",9
17,"17211",837,677,674,6,3,"PP",11
17,"17110",1332,990,981,3,9,"PP",67
17,"17082",435,308,307,1,1,"PP",23
17,"17199",6984,4919,4894,39,25,"PP",202
17,"17025",1182,943,938,5,5,"PP",24
17,"17172",452,336,335,5,1,"PP",5
17,"17096",159,116,116,3,0,"PP",4
17,"17155",14957,9519,9410,71,109,"PP",493
17,"17088",599,467,465,3,2,"PP",11
17,"17119",71,53,52,3,1,"PP",1
17,"17150",1444,1177,1163,13,14,"PP",25
17,"17060",409,300,298,1,2,"PP",26
17,"17089",5749,3973,3949,17,24,"PP",165
17,"17019",1780,1403,1393,5,10,"PP",31
17,"17130",325,270,270,1,0,"PP",5
17,"17106",142,114,114,0,0,"PP",6
17,"17149",370,302,300,1,2,"PP",2
17,"17200",624,469,467,6,2,"PP",8
17,"17061",180,141,139,1,2,"PP",11
17,"17050",664,554,550,10,4,"PP",14
17,"17027",2857,2236,2229,9,7,"PP",74
17,"17151",179,131,130,0,1,"PP",8
17,"17162",153,106,105,1,1,"PP",5
17,"17063",179,153,149,0,4,"PP",1
17,"17073",1939,1649,1640,11,9,"PP",75
17,"17185",2260,1657,1652,8,5,"PP",34
17,"17066",27378,16755,16644,122,111,"PP",1346
17,"17049",3246,2527,2502,12,25,"PP",54
17,"17094",1058,757,747,3,10,"PP",49
17,"17191",163,140,140,1,0,"PP",5
17,"17054",342,250,250,2,0,"PP",9
17,"17144",211,162,159,3,3,"PP",5
17,"17135",393,307,303,0,4,"PP",16
17,"17004",529,411,410,3,1,"PP",4
17,"17052",135,93,92,0,1,"PP",2
17,"17139",1407,1128,1119,8,9,"PP",31
17,"17101",566,389,382,1,7,"PP",9
17,"17116",351,261,261,2,0,"PP",5
17,"17157",122,104,103,0,1,"PP",0
17,"17009",4068,3061,3050,16,11,"PP",78
17,"17230",504,383,382,3,1,"PP",20
17,"17083",2971,2164,2154,13,10,"PP",88
17,"17114",23268,16423,16333,111,90,"PP",547
17,"17087",219,179,177,0,2,"PP",8
17,"17040",551,440,439,5,1,"PP",8
17,"17007",1763,1367,1359,9,8,"PP",33
17,"17220",801,649,647,2,2,"PP",18
17,"17226",884,603,600,4,3,"PP",81
17,"17217",350,287,284,0,3,"PP",5
17,"17137",3486,2812,2808,15,4,"PP",72
17,"17145",1410,1040,1032,6,8,"PP",25
17,"17140",635,506,505,2,1,"PP",22
17,"17134",220,175,174,1,1,"PP",1
17,"17190",834,624,619,1,5,"PP",17
17,"17148",1550,1121,1114,15,7,"PP",46
17,"17175",559,348,343,5,5,"PP",17
17,"17166",547,442,440,0,2,"PP",5
17,"17036",2639,1944,1934,21,10,"PP",68
17,"17056",1780,1379,1374,13,5,"PP",48
17,"17069",359,270,267,2,3,"PP",20
17,"17202",3848,2632,2615,16,17,"PP",160
17,"17182",269,195,195,0,0,"PP",12
17,"17213",5567,3654,3630,19,24,"PP",170
17,"17047",5016,3087,3068,22,19,"PP",215
8,"8261",2405,1726,1718,11,8,"PP",130
25,"25078",995,746,743,7,3,"PP",36
8,"8277",168,148,146,1,2,"PP",6
8,"8115",3826,2777,2770,31,7,"PP",143
25,"25251",708,526,524,1,2,"PP",38
25,"25145",75,59,59,0,0,"PP",0
8,"8161",11826,8001,7951,58,50,"PP",532
25,"25011",5271,3529,3505,21,24,"PP",247
8,"8077",34690,25896,25767,164,129,"PP",2852
8,"8256",693,542,542,3,0,"PP",22
8,"8268",975,729,723,6,6,"PP",25
25,"25061",80,51,51,0,0,"PP",0
8,"8022",12213,8594,8558,42,36,"PP",300
8,"8286",2943,2051,2042,12,9,"PP",127
25,"25194",410,292,289,3,3,"PP",17
25,"25208",337,242,241,2,1,"PP",3
8,"8049",1309,910,903,3,7,"PP",40
25,"25157",159,127,126,1,1,"PP",8
25,"25124",160,102,101,1,1,"PP",12
25,"25182",1043,763,760,8,3,"PP",41
8,"8137",272,208,207,2,1,"PP",6
8,"8269",2729,2114,2105,9,9,"PP",73
8,"8046",13541,10510,10455,73,55,"PP",527
8,"8138",4461,3286,3259,27,27,"PP",96
25,"25102",647,484,482,5,2,"PP",34
8,"8299",380,301,300,4,1,"PP",4
8,"8092",3713,2758,2745,9,13,"PP",95
25,"25171",2117,1539,1534,5,5,"PP",40
25,"25163",230,162,161,0,1,"PP",6
8,"8208",5793,4267,4244,21,23,"PP",284
8,"8109",207,176,174,0,2,"PP",4
25,"25142",359,283,283,2,0,"PP",8
8,"8116",557,449,449,1,0,"PP",13
25,"25062",691,498,491,4,7,"PP",14
25,"25118",326,223,218,0,5,"PP",18
8,"8232",1773,1368,1362,9,6,"PP",44
25,"25126",281,211,210,1,1,"PP",4
25,"25153",190,139,136,0,3,"PP",21
25,"25125",383,265,265,3,0,"PP",17
8,"8097",1103,845,840,4,5,"PP",13
25,"25056",209,145,145,0,0,"PP",3
25,"25215",339,249,249,5,0,"PP",14
8,"8087",144,120,120,0,0,"PP",8
8,"8206",744,604,599,5,5,"PP",13
25,"25101",536,412,411,5,1,"PP",8
8,"8146",1384,1030,1027,8,3,"PP",52
25,"25910",91,63,63,0,0,"PP",1
8,"8211",33934,26136,26000,198,136,"PP",2038
8,"8025",1573,1170,1160,9,10,"PP",60
8,"8178",444,363,361,2,2,"PP",6
25,"25185",680,452,451,0,1,"PP",14
8,"8284",12597,8244,8183,60,61,"PP",443
8,"8253",132,103,102,0,1,"PP",0
8,"8124",37157,27139,26994,179,145,"PP",1808
8,"8110",13671,9362,9311,60,51,"PP",558
25,"25027",978,695,690,3,5,"PP",28
25,"25008",1081,803,799,4,4,"PP",73
8,"8153",573,457,452,3,5,"PP",9
8,"8054",9215,6994,6943,38,51,"PP",425
8,"8217",25466,19864,19773,129,91,"PP",1545
25,"25901",289,214,211,4,3,"PP",15
25,"25049",156,110,109,1,1,"PP",7
25,"25057",208,151,149,4,2,"PP",9
8,"8276",241,179,179,3,0,"PP",3
8,"8152",117,94,94,0,0,"PP",0
8,"8235",3875,3004,2996,19,8,"PP",101
8,"8160",317,234,234,0,0,"PP",4
8,"8008",175,136,136,2,0,"PP",3
25,"25212",219,176,176,1,0,"PP",13
8,"8107",11965,8604,8554,67,50,"PP",630
8,"8218",8091,5899,5869,50,30,"PP",311
8,"8078",216,154,154,2,0,"PP",3
8,"8070",269,215,211,1,4,"PP",3
8,"8293",227,177,177,0,0,"PP",4
8,"8183",4573,3406,3398,14,8,"PP",77
8,"8233",1872,1428,1420,15,8,"PP",20
25,"25021",2513,1668,1662,17,6,"PP",83
8,"8255",133,100,100,2,0,"PP",0
8,"8209",6925,4976,4948,39,28,"PP",457
8,"8105",9741,6946,6896,62,50,"PP",574
25,"25004",582,437,432,3,5,"PP",6
8,"8145",2712,2060,2049,8,11,"PP",86
25,"25253",147,118,117,0,1,"PP",6
8,"8264",4608,3459,3444,30,15,"PP",309
25,"25242",688,494,488,5,6,"PP",32
8,"8307",49499,35471,35312,199,159,"PP",1942
25,"25152",148,106,106,0,0,"PP",4
25,"25913",88,72,72,1,0,"PP",1
8,"8200",62225,45235,44991,306,244,"PP",3360
25,"25161",339,221,221,0,0,"PP",7
8,"8216",25,17,17,0,0,"PP",0
8,"8291",4972,3531,3519,23,12,"PP",180
8,"8030",5208,4045,4033,25,12,"PP",276
25,"25089",93,70,68,1,2,"PP",0
25,"25009",596,448,442,1,6,"PP",34
25,"25058",4345,3058,3045,13,13,"PP",127
25,"25234",4139,2786,2772,13,14,"PP",161
8,"8003",7213,5425,5409,41,16,"PP",474
25,"25179",169,132,132,0,0,"PP",4
8,"8063",469,390,390,4,0,"PP",6
25,"25032",65,53,52,0,1,"PP",0
25,"25073",559,377,377,2,0,"PP",8
25,"25245",427,312,308,4,4,"PP",17
8,"8905",2329,1872,1863,7,9,"PP",88
25,"25121",632,380,374,3,6,"PP",34
8,"8259",6979,5362,5341,27,21,"PP",219
25,"25903",226,169,169,1,0,"PP",2
8,"8248",5687,4187,4165,21,22,"PP",197
25,"25129",161,113,112,0,1,"PP",2
8,"8251",5130,3719,3698,20,21,"PP",212
8,"8273",2390,1871,1855,14,16,"PP",70
25,"25216",244,186,186,0,0,"PP",17
25,"25071",41,31,30,0,1,"PP",1
25,"25183",520,372,370,4,2,"PP",11
8,"8062",1009,778,776,9,2,"PP",26
8,"8051",18570,14112,14054,86,58,"PP",730
8,"8093",25,22,22,0,0,"PP",0
8,"8278",4925,3820,3804,22,16,"PP",72
8,"8296",1869,1412,1408,10,4,"PP",108
8,"8095",66,49,49,0,0,"PP",0
25,"25043",800,584,581,2,3,"PP",15
8,"8266",43422,32827,32696,241,131,"PP",2559
8,"8246",1692,1345,1340,7,5,"PP",30
8,"8082",1164,796,780,5,16,"PP",58
25,"25036",180,124,124,1,0,"PP",13
8,"8205",61957,49325,49196,441,129,"PP",4469
8,"8304",822,655,655,5,0,"PP",15
8,"8069",3323,2555,2540,21,15,"PP",146
8,"8148",2344,1655,1646,13,9,"PP",105
25,"25907",500,366,364,5,2,"PP",6
25,"25193",768,567,563,4,4,"PP",17
8,"8032",2100,1472,1465,12,7,"PP",80
25,"25133",671,481,479,1,2,"PP",24
25,"25232",1357,1012,1007,6,5,"PP",64
8,"8190",255,184,182,1,2,"PP",5
8,"8176",158,119,119,0,0,"PP",12
25,"25022",105,80,79,0,1,"PP",4
8,"8028",1125,744,743,7,1,"PP",55
25,"25196",108,75,75,1,0,"PP",3
8,"8231",21269,14655,14573,111,82,"PP",943
8,"8111",216,195,194,2,1,"PP",7
8,"8207",2026,1667,1659,12,8,"PP",38
25,"25030",117,76,76,0,0,"PP",0
8,"8099",753,529,529,4,0,"PP",8
8,"8129",486,399,398,0,1,"PP",9
8,"8147",17389,12679,12601,102,78,"PP",674
8,"8012",1726,1323,1309,17,14,"PP",29
8,"8258",815,636,632,5,4,"PP",13
8,"8212",491,393,386,6,7,"PP",10
25,"25120",92888,62740,62389,450,351,"PP",6440
25,"25045",57,26,26,2,0,"PP",4
8,"8086",14137,9971,9912,77,59,"PP",565
8,"8029",3586,2868,2862,20,6,"PP",195
25,"25151",731,555,549,1,6,"PP",28
25,"25040",10651,7041,6987,57,54,"PP",469
25,"25113",1114,873,863,3,10,"PP",30
8,"8174",388,322,318,2,4,"PP",10
8,"8193",988,739,737,10,2,"PP",45
8,"8143",2727,1989,1977,19,12,"PP",96
25,"25221",115,82,81,1,1,"PP",4
25,"25172",1762,1332,1323,8,9,"PP",90
8,"8064",1956,1439,1423,7,16,"PP",45
8,"8179",636,466,465,2,1,"PP",13
8,"8210",4640,3226,3200,24,26,"PP",120
25,"25086",525,410,407,3,3,"PP",4
8,"8027",724,584,582,1,2,"PP",19
8,"8019",1122912,824423,821037,5287,3386,"PP",77980
8,"8241",70,52,52,0,0,"PP",2
8,"8305",27661,20346,20221,118,125,"PP",1005
8,"8090",142,116,116,0,0,"PP",4
8,"8113",52589,36864,36690,244,174,"PP",1981
25,"25067",702,500,494,8,6,"PP",41
8,"8166",964,700,697,7,3,"PP",24
25,"25206",247,188,188,2,0,"PP",2
25,"25173",1646,1180,1169,6,11,"PP",72
25,"25908",217,136,136,0,0,"PP",4
25,"25218",88,76,75,2,1,"PP",1
8,"8154",697,541,539,3,2,"PP",26
8,"8224",885,653,652,6,1,"PP",22
25,"25905",366,281,276,4,5,"PP",19
8,"8139",172,148,147,2,1,"PP",0
8,"8005",6425,4830,4816,28,14,"PP",319
25,"25060",71,42,42,0,0,"PP",2
25,"25093",629,455,443,5,12,"PP",25
25,"25134",605,457,456,5,1,"PP",19
8,"8162",2118,1581,1576,13,5,"PP",94
25,"25909",138,99,98,2,1,"PP",0
25,"25906",205,133,131,2,2,"PP",3
8,"8281",4858,3783,3762,19,21,"PP",249
8,"8120",7129,5649,5621,51,28,"PP",468
25,"25168",496,399,399,6,0,"PP",42
8,"8074",11190,7698,7651,51,47,"PP",591
8,"8112",12926,9268,9230,61,38,"PP",339
8,"8130",110,81,81,2,0,"PP",2
25,"25046",410,331,326,4,5,"PP",21
25,"25138",558,427,424,2,3,"PP",28
25,"25247",142,89,89,2,0,"PP",9
8,"8234",3443,2561,2550,15,11,"PP",156
25,"25002",465,324,323,4,1,"PP",10
8,"8084",1172,902,894,9,8,"PP",35
25,"25127",217,145,145,1,0,"PP",1
25,"25177",356,252,250,1,2,"PP",14
8,"8172",20543,15191,15140,85,51,"PP",978
25,"25135",997,675,671,3,4,"PP",29
25,"25186",207,162,161,0,1,"PP",9
8,"8254",1766,1433,1427,16,6,"PP",15
25,"25240",1366,1030,1021,4,9,"PP",84
25,"25035",364,257,256,0,1,"PP",9
25,"25238",212,161,160,0,1,"PP",4
25,"25082",292,197,197,2,0,"PP",4
25,"25114",96,83,82,1,1,"PP",0
25,"25092",125,93,92,0,1,"PP",1
25,"25017",228,175,174,0,1,"PP",4
25,"25047",956,745,736,14,9,"PP",36
25,"25079",276,202,202,0,0,"PP",8
25,"25070",817,619,617,11,2,"PP",24
8,"8169",48478,35283,35114,278,169,"PP",2644
25,"25217",10891,7651,7610,63,41,"PP",362
8,"8202",12943,9408,9358,58,50,"PP",405
8,"8171",2046,1520,1510,13,10,"PP",38
8,"8303",257,207,205,1,2,"PP",3
8,"8229",521,418,417,3,1,"PP",20
25,"25255",390,301,301,0,0,"PP",16
8,"8106",7500,5442,5410,43,32,"PP",339
8,"8002",217,172,172,2,0,"PP",4
25,"25016",2083,1404,1399,3,5,"PP",65
25,"25088",96,73,73,0,0,"PP",2
8,"8150",258,207,207,1,0,"PP",4
8,"8061",1628,1154,1151,15,3,"PP",82
8,"8194",25680,16465,16376,131,89,"PP",1436
25,"25109",211,155,154,1,1,"PP",12
8,"8157",8574,6514,6472,47,42,"PP",443
8,"8165",1680,1177,1171,7,6,"PP",53
25,"25224",122,94,94,0,0,"PP",3
8,"8184",55053,38519,38323,298,196,"PP",2822
8,"8213",6600,4925,4906,30,19,"PP",244
8,"8182",2922,2041,2031,10,10,"PP",112
25,"25034",2271,1616,1600,12,16,"PP",68
8,"8026",195,148,146,0,2,"PP",4
25,"25202",108,72,72,2,0,"PP",2
25,"25123",189,135,133,0,2,"PP",3
8,"8155",7056,5050,5011,38,39,"PP",226
25,"25243",3729,2370,2349,33,21,"PP",280
8,"8094",1588,1258,1252,7,6,"PP",45
8,"8135",6770,5187,5158,42,29,"PP",399
8,"8168",388,280,279,3,1,"PP",39
8,"8274",4640,3385,3363,24,22,"PP",148
8,"8057",61,47,47,1,0,"PP",1
25,"25205",563,412,407,3,5,"PP",26
25,"25006",319,229,229,2,0,"PP",19
8,"8047",3751,2600,2578,26,22,"PP",181
25,"25158",1605,1193,1180,8,13,"PP",35
8,"8121",87515,62961,62574,429,387,"PP",4802
25,"25203",8809,5813,5770,40,43,"PP",420
8,"8098",2438,1781,1778,21,3,"PP",104
8,"8270",19014,13635,13594,74,41,"PP",1368
8,"8285",10349,7630,7599,48,31,"PP",217
25,"25192",727,527,524,4,3,"PP",29
8,"8045",65,44,43,0,1,"PP",0
25,"25226",236,156,155,0,1,"PP",0
8,"8252",24885,18507,18383,162,124,"PP",1559
25,"25165",271,210,208,0,2,"PP",10
8,"8187",153822,113081,112470,758,611,"PP",7149
8,"8159",14343,10656,10603,87,53,"PP",694
25,"25012",2349,1563,1556,17,7,"PP",88
8,"8050",139,118,115,4,3,"PP",1
8,"8127",2254,1548,1544,10,4,"PP",82
25,"25063",84,52,51,0,1,"PP",7
25,"25189",2181,1468,1461,11,7,"PP",76
8,"8015",156540,109145,108440,957,705,"PP",10142
25,"25137",8684,5802,5757,48,45,"PP",339
8,"8158",3094,2261,2251,11,10,"PP",116
25,"25231",483,387,385,0,2,"PP",24
8,"8250",7235,4917,4876,41,41,"PP",312
8,"8024",357,282,282,2,0,"PP",8
8,"8091",5428,4048,4024,20,24,"PP",182
8,"8289",4473,3379,3371,25,8,"PP",142
8,"8036",163,122,122,0,0,"PP",4
8,"8203",2466,1678,1675,7,3,"PP",93
8,"8132",356,265,265,1,0,"PP",13
25,"25169",170,117,117,5,0,"PP",5
8,"8301",49348,36261,36045,292,216,"PP",2860
8,"8294",2093,1546,1534,11,12,"PP",57
25,"25033",1120,838,831,5,7,"PP",19
25,"25099",1285,908,904,6,4,"PP",41
8,"8085",986,769,767,6,2,"PP",28
8,"8014",2013,1526,1521,4,5,"PP",65
8,"8188",115,89,89,0,0,"PP",3
25,"25222",69,58,58,0,0,"PP",11
8,"8100",2083,1707,1699,13,8,"PP",64
25,"25130",181,130,128,0,2,"PP",4
8,"8236",1564,1145,1133,4,12,"PP",62
8,"8308",139,109,109,1,0,"PP",0
25,"25902",536,406,403,1,3,"PP",31
8,"8262",6945,4649,4599,38,50,"PP",226
25,"25150",167,132,130,2,2,"PP",7
8,"8237",1644,1263,1254,9,9,"PP",36
25,"25050",3256,2260,2249,20,11,"PP",91
25,"25098",227,160,158,1,2,"PP",1
25,"25252",553,380,379,2,1,"PP",23
8,"8201",455,319,318,12,1,"PP",10
25,"25019",4606,2860,2829,19,31,"PP",270
25,"25039",259,197,196,7,1,"PP",8
25,"25013",2099,1430,1414,13,16,"PP",116
25,"25136",95,74,74,2,0,"PP",8
8,"8242",223,159,159,0,0,"PP",9
25,"25007",1378,1010,999,12,11,"PP",35
8,"8214",7007,5390,5371,25,19,"PP",311
8,"8243",154,125,125,2,0,"PP",2
8,"8238",14946,11911,11873,85,38,"PP",773
8,"8215",2617,1954,1946,22,8,"PP",76
25,"25103",133,88,87,0,1,"PP",2
25,"25141",154,105,104,3,1,"PP",5
25,"25248",870,676,675,5,1,"PP",22
25,"25244",374,275,270,1,5,"PP",17
8,"8181",8133,5949,5924,31,25,"PP",371
25,"25010",194,138,136,0,2,"PP",1
25,"25068",515,359,358,0,1,"PP",9
8,"8059",340,255,250,1,5,"PP",8
8,"8198",4679,3491,3469,12,22,"PP",185
25,"25005",269,193,193,3,0,"PP",9
8,"8071",249,209,208,0,1,"PP",3
8,"8079",333,260,258,2,2,"PP",3
25,"25154",117,86,85,0,1,"PP",3
8,"8180",27198,19822,19704,160,118,"PP",1478
25,"25201",110,81,81,0,0,"PP",2
25,"25175",173,119,119,2,0,"PP",10
25,"25024",352,248,247,0,1,"PP",1
8,"8125",25583,18334,18225,122,109,"PP",1251
8,"8060",139,110,108,1,2,"PP",11
8,"8016",1803,1371,1363,11,8,"PP",52
25,"25225",531,395,393,0,2,"PP",21
8,"8001",9097,6860,6818,39,42,"PP",490
8,"8048",580,427,426,1,1,"PP",17
8,"8052",140,102,102,1,0,"PP",8
8,"8040",11116,7923,7891,49,32,"PP",461
8,"8191",5302,3872,3860,21,12,"PP",171
8,"8020",5243,4117,4100,29,17,"PP",207
25,"25190",262,202,202,2,0,"PP",2
25,"25111",114,86,86,2,0,"PP",1
8,"8196",19542,14264,14185,123,79,"PP",1093
8,"8010",4224,3109,3090,22,19,"PP",84
8,"8275",247,218,218,3,0,"PP",3
25,"25176",307,241,238,3,3,"PP",18
8,"8272",164,128,128,1,0,"PP",4
25,"25146",223,158,155,3,3,"PP",12
8,"8035",13006,8957,8918,50,39,"PP",565
8,"8073",62934,45699,45407,281,292,"PP",3818
8,"8199",648,509,508,3,1,"PP",22
25,"25230",1541,1105,1099,9,6,"PP",76
25,"25912",841,620,619,5,1,"PP",169
8,"8163",19672,13421,13364,70,57,"PP",1091
8,"8066",1466,1109,1104,7,5,"PP",90
25,"25132",141,106,105,0,1,"PP",4
25,"25069",426,296,294,0,2,"PP",10
8,"8053",2896,1939,1929,13,10,"PP",91
25,"25081",281,195,193,3,2,"PP",9
25,"25181",172,137,137,1,0,"PP",11
25,"25207",6443,4525,4492,31,33,"PP",177
25,"25227",656,476,476,2,0,"PP",6
25,"25072",5881,4059,4031,30,28,"PP",249
8,"8033",13262,9887,9833,64,54,"PP",568
8,"8108",5181,3880,3861,30,19,"PP",335
8,"8076",16526,11988,11893,90,95,"PP",748
25,"25170",262,210,210,1,0,"PP",6
8,"8228",292,234,233,0,1,"PP",7
25,"25191",321,227,222,2,5,"PP",17
25,"25254",704,511,508,2,3,"PP",40
8,"8118",17634,13450,13402,80,48,"PP",868
25,"25064",96,78,78,0,0,"PP",3
8,"8128",579,428,423,4,5,"PP",9
8,"8221",12793,10123,10079,73,44,"PP",965
8,"8300",5927,4609,4589,41,20,"PP",294
8,"8292",1074,796,790,2,6,"PP",34
8,"8239",467,362,361,3,1,"PP",19
8,"8038",1541,1129,1120,6,9,"PP",35
8,"8204",3141,2395,2383,16,12,"PP",95
25,"25911",419,298,297,3,1,"PP",9
25,"25249",176,129,127,2,2,"PP",10
25,"25003",3717,2577,2561,15,16,"PP",117
8,"8075",4144,2951,2943,20,8,"PP",170
25,"25100",184,137,136,1,1,"PP",1
8,"8083",1672,1433,1430,6,3,"PP",14
8,"8068",6863,5064,5041,40,23,"PP",344
8,"8096",43926,32120,31960,217,160,"PP",2219
8,"8142",136,117,117,3,0,"PP",0
25,"25128",125,85,85,0,0,"PP",0
25,"25042",204,149,149,5,0,"PP",10
8,"8195",75,62,62,0,0,"PP",3
25,"25115",803,601,593,4,8,"PP",25
8,"8122",1733,1179,1175,4,4,"PP",46
25,"25031",57,32,32,0,0,"PP",7
8,"8072",10769,7632,7600,56,32,"PP",523
25,"25140",779,540,539,2,1,"PP",22
25,"25197",140,109,109,0,0,"PP",0
25,"25148",224,158,158,0,0,"PP",8
8,"8006",11774,8375,8329,53,46,"PP",514
8,"8140",4816,3541,3520,25,21,"PP",161
25,"25094",138,96,93,2,3,"PP",10
8,"8041",10698,7324,7258,57,66,"PP",590
8,"8185",197,162,162,1,0,"PP",7
8,"8141",4578,3369,3357,28,12,"PP",142
8,"8189",119,96,96,1,0,"PP",5
25,"25015",336,234,233,3,1,"PP",13
8,"8265",1597,1262,1260,4,2,"PP",21
8,"8136",11692,8527,8456,98,71,"PP",744
25,"25087",54,45,45,0,0,"PP",0
8,"8044",4156,2991,2976,16,15,"PP",155
8,"8034",820,644,640,0,4,"PP",24
8,"8037",1947,1547,1543,11,4,"PP",28
25,"25029",1590,1190,1185,4,5,"PP",63
25,"25025",1362,909,898,15,11,"PP",131
8,"8123",19570,15378,15316,91,62,"PP",752
8,"8134",848,618,609,4,9,"PP",38
8,"8167",6056,4520,4500,38,20,"PP",257
8,"8220",2411,2010,2001,8,9,"PP",38
8,"8192",5701,4366,4349,15,17,"PP",160
25,"25210",1073,791,780,3,11,"PP",36
8,"8902",3941,2974,2962,16,12,"PP",180
8,"8227",2420,1775,1769,11,6,"PP",68
8,"8249",274,238,237,0,1,"PP",6
25,"25122",1929,1408,1398,21,10,"PP",64
8,"8267",6789,4975,4935,41,40,"PP",216
8,"8133",123,96,94,5,2,"PP",3
8,"8117",2489,1954,1941,21,13,"PP",67
8,"8288",1696,1103,1096,9,7,"PP",58
8,"8240",9469,7351,7327,39,24,"PP",296
8,"8164",936,750,747,6,3,"PP",20
8,"8901",240,200,195,2,5,"PP",2
8,"8126",8906,6673,6646,41,27,"PP",387
8,"8080",40,27,27,3,0,"PP",3
25,"25233",289,219,218,6,1,"PP",17
25,"25048",1641,1207,1194,13,13,"PP",53
25,"25904",160,134,133,2,1,"PP",8
8,"8039",413,322,321,1,1,"PP",9
8,"8230",7648,5797,5774,40,23,"PP",452
25,"25110",2745,1943,1927,13,16,"PP",69
8,"8151",450,351,346,5,5,"PP",11
8,"8114",18838,13519,13442,81,77,"PP",934
25,"25164",353,259,255,0,4,"PP",12
8,"8104",657,496,493,4,3,"PP",22
25,"25041",525,375,370,4,5,"PP",15
8,"8223",1897,1345,1341,10,4,"PP",58
8,"8119",6897,5096,5052,31,44,"PP",289
8,"8222",1821,1439,1424,7,15,"PP",62
25,"25076",131,91,91,0,0,"PP",2
25,"25038",1478,1057,1048,10,9,"PP",137
8,"8282",6731,5333,5317,40,16,"PP",335
8,"8175",3369,2388,2372,18,16,"PP",133
8,"8013",1287,982,972,6,10,"PP",35
25,"25077",435,312,312,1,0,"PP",9
8,"8244",6099,4733,4706,39,27,"PP",266
8,"8056",42897,30873,30757,259,116,"PP",3747
25,"25219",146,111,111,1,0,"PP",7
25,"25074",179,155,151,2,4,"PP",8
25,"25014",246,184,178,0,6,"PP",2
8,"8287",1067,853,844,4,9,"PP",14
25,"25204",1187,858,849,13,9,"PP",37
8,"8290",1549,1254,1248,6,6,"PP",39
25,"25223",890,673,666,7,7,"PP",12
25,"25139",477,348,346,3,2,"PP",7
8,"8017",2808,2033,2016,16,17,"PP",66
8,"8021",60,44,44,1,0,"PP",2
25,"25052",1541,1183,1176,7,7,"PP",43
8,"8023",7029,5027,5000,39,27,"PP",296
25,"25055",163,114,114,0,0,"PP",12
8,"8225",94,83,82,1,1,"PP",1
25,"25228",3143,2261,2250,18,11,"PP",134
8,"8197",7986,5829,5805,37,24,"PP",553
8,"8007",6795,5099,5081,29,18,"PP",200
8,"8156",11254,8440,8411,58,29,"PP",544
25,"25119",2258,1701,1686,11,15,"PP",85
8,"8279",156327,112605,112030,952,575,"PP",7446
25,"25112",269,205,200,2,5,"PP",11
25,"25023",4560,3350,3334,24,16,"PP",245
8,"8149",980,702,694,6,8,"PP",17
8,"8283",6165,4546,4524,33,22,"PP",159
25,"25149",1377,1034,1028,9,6,"PP",57
25,"25174",390,312,312,1,0,"PP",13
8,"8170",442,322,320,0,2,"PP",11
8,"8219",15755,12235,12206,72,29,"PP",757
8,"8904",10516,7068,7025,54,43,"PP",528
8,"8004",208,177,177,1,0,"PP",0
8,"8245",77841,53719,53443,430,276,"PP",4728
8,"8043",3414,2429,2422,15,7,"PP",174
8,"8247",982,799,798,4,1,"PP",13
25,"25059",800,546,534,5,12,"PP",94
25,"25037",361,270,269,4,1,"PP",23
25,"25131",394,281,279,3,2,"PP",14
8,"8067",5746,4299,4270,24,29,"PP",152
25,"25051",1522,1066,1059,6,7,"PP",32
8,"8009",9531,7200,7171,47,29,"PP",493
25,"25239",582,330,330,3,0,"PP",14
25,"25166",170,131,130,2,1,"PP",15
25,"25220",991,768,762,1,6,"PP",40
25,"25085",141,109,108,2,1,"PP",13
8,"8131",745,552,550,3,2,"PP",10
8,"8302",9359,6483,6430,78,53,"PP",408
25,"25143",82,63,62,0,1,"PP",2
8,"8260",18515,13563,13487,84,76,"PP",965
8,"8177",36,27,27,1,0,"PP",0
8,"8089",34190,24548,24404,194,144,"PP",2081
25,"25250",327,269,265,1,4,"PP",13
25,"25075",132,101,101,0,0,"PP",2
8,"8011",1739,1360,1353,10,7,"PP",23
8,"8031",2339,1760,1750,15,10,"PP",81
8,"8081",349,274,270,0,4,"PP",5
25,"25096",885,597,591,2,6,"PP",34
8,"8280",93,76,75,1,1,"PP",1
25,"25053",1100,819,811,7,8,"PP",48
25,"25044",178,144,142,0,2,"PP",16
8,"8144",722,551,545,3,6,"PP",26
8,"8263",21208,15014,14890,111,124,"PP",1004
25,"25104",120,88,88,0,0,"PP",5
25,"25209",1586,1115,1102,6,13,"PP",50
8,"8271",66,48,47,2,1,"PP",1
8,"8257",103,82,82,0,0,"PP",1
25,"25211",680,470,470,3,0,"PP",25
8,"8042",2390,1772,1764,12,8,"PP",135
8,"8065",1183,920,913,8,7,"PP",33
8,"8306",535,368,368,5,0,"PP",24
25,"25001",143,102,102,1,0,"PP",4
8,"8101",175048,121359,120620,830,739,"PP",11491
8,"8018",2540,1862,1855,7,7,"PP",58
8,"8055",542,426,424,3,2,"PP",11
8,"8297",138,99,99,0,0,"PP",5
25,"25200",318,245,245,0,0,"PP",6
25,"25020",270,202,201,2,1,"PP",13
25,"25167",223,165,164,3,1,"PP",16
8,"8903",201,181,181,1,0,"PP",3
8,"8298",27148,19655,19568,102,87,"PP",725
8,"8102",28940,21108,21014,157,94,"PP",1223
25,"25180",227,158,155,1,3,"PP",3
8,"8103",652,476,474,1,2,"PP",22
25,"25155",616,446,443,2,3,"PP",22
25,"25097",89,71,71,2,0,"PP",7
8,"8088",12347,9316,9270,75,46,"PP",449
25,"25156",765,571,567,3,4,"PP",35
8,"8226",929,748,747,10,1,"PP",21
25,"25105",105,88,87,4,1,"PP",2
8,"8295",11290,8091,8054,72,37,"PP",588
8,"8058",1808,1280,1262,6,18,"PP",57
33,"33021",4304,2643,2610,32,33,"PP-FORO",633
33,"33012",5085,3158,3142,27,16,"PP-FORO",1035
33,"33077",1097,688,683,4,5,"PP-FORO",324
33,"33071",546,385,383,7,2,"PP-FORO",77
33,"33016",18848,12845,12737,173,108,"PP-FORO",3240
33,"33063",375,269,267,5,2,"PP-FORO",90
33,"33018",2804,1830,1806,30,24,"PP-FORO",561
33,"33058",1668,1050,1035,13,15,"PP-FORO",113
33,"33048",132,86,85,1,1,"PP-FORO",23
33,"33051",6787,4318,4268,48,50,"PP-FORO",1035
33,"33024",224741,151660,150461,1597,1199,"PP-FORO",32423
33,"33049",5973,3569,3518,48,51,"PP-FORO",827
33,"33039",1646,1118,1110,8,8,"PP-FORO",234
33,"33045",4359,2819,2787,32,32,"PP-FORO",619
33,"33020",12981,8550,8453,120,97,"PP-FORO",1485
33,"33033",9381,5848,5770,88,78,"PP-FORO",997
33,"33014",8735,5744,5689,67,55,"PP-FORO",1200
33,"33009",878,545,542,4,3,"PP-FORO",130
33,"33025",8956,5493,5453,81,40,"PP-FORO",1273
33,"33052",681,418,416,3,2,"PP-FORO",86
33,"33067",751,543,538,7,5,"PP-FORO",90
33,"33023",3249,2127,2097,30,30,"PP-FORO",505
33,"33038",2218,1501,1477,17,24,"PP-FORO",259
33,"33073",8096,4377,4320,59,57,"PP-FORO",1230
33,"33015",1396,849,842,7,7,"PP-FORO",184
33,"33006",1476,862,857,9,5,"PP-FORO",121
33,"33005",1357,832,825,11,7,"PP-FORO",176
33,"33034",9979,5937,5873,64,64,"PP-FORO",1662
33,"33003",603,322,317,7,5,"PP-FORO",86
33,"33070",3267,2211,2185,27,26,"PP-FORO",605
33,"33078",127,81,81,0,0,"PP-FORO",17
33,"33072",1443,816,814,8,2,"PP-FORO",163
33,"33007",1382,804,795,4,9,"PP-FORO",222
33,"33055",1485,992,966,14,26,"PP-FORO",259
33,"33043",656,408,401,2,7,"PP-FORO",90
33,"33061",344,174,174,1,0,"PP-FORO",43
33,"33010",1722,1085,1069,15,16,"PP-FORO",212
33,"33022",802,460,452,4,8,"PP-FORO",58
33,"33066",42818,27780,27466,425,314,"PP-FORO",6208
33,"33054",1601,1025,1010,17,15,"PP-FORO",269
33,"33037",33074,20693,20412,259,281,"PP-FORO",3371
33,"33056",4850,3068,3044,25,24,"PP-FORO",818
33,"33044",177059,121380,120421,1543,959,"PP-FORO",33399
33,"33050",548,316,314,1,2,"PP-FORO",68
33,"33053",1078,602,599,10,3,"PP-FORO",103
33,"33060",13991,8629,8481,109,148,"PP-FORO",1290
33,"33065",1077,670,657,11,13,"PP-FORO",172
33,"33013",430,294,292,1,2,"PP-FORO",106
33,"33059",4359,2651,2625,33,26,"PP-FORO",870
33,"33002",9403,5920,5839,69,81,"PP-FORO",1265
33,"33074",3366,2042,2011,35,31,"PP-FORO",559
33,"33001",1475,758,753,15,5,"PP-FORO",226
33,"33036",11281,7240,7153,96,87,"PP-FORO",1859
33,"33069",3379,2249,2231,41,18,"PP-FORO",491
33,"33004",65304,43473,43153,563,320,"PP-FORO",9196
33,"33042",4237,2862,2816,49,46,"PP-FORO",669
33,"33062",385,194,187,4,7,"PP-FORO",30
33,"33076",12115,7519,7456,76,63,"PP-FORO",2127
33,"33031",33775,20484,20184,276,300,"PP-FORO",3330
33,"33027",752,412,405,11,7,"PP-FORO",89
33,"33075",244,125,122,3,3,"PP-FORO",28
33,"33046",480,334,329,0,5,"PP-FORO",125
33,"33019",2844,1702,1680,11,22,"PP-FORO",514
33,"33035",11214,7359,7303,102,56,"PP-FORO",1680
33,"33068",1031,518,510,5,8,"PP-FORO",97
33,"33057",1525,1005,988,17,17,"PP-FORO",165
33,"33040",4556,2837,2784,58,53,"PP-FORO",664
33,"33047",1068,771,759,9,12,"PP-FORO",275
33,"33026",8201,5014,4974,74,40,"PP-FORO",1143
33,"33064",240,151,151,0,0,"PP-FORO",26
33,"33032",11056,7052,6905,109,147,"PP-FORO",1053
33,"33029",315,145,142,1,3,"PP-FORO",31
33,"33017",2969,1787,1768,38,19,"PP-FORO",455
33,"33011",10563,5646,5578,92,68,"PP-FORO",1739
33,"33008",1679,1140,1133,10,7,"PP-FORO",318
33,"33028",1143,519,518,7,1,"PP-FORO",122
33,"33030",876,632,630,8,2,"PP-FORO",196
33,"33041",7101,4564,4513,58,51,"PP-FORO",1180
42,"42172",28,26,26,0,0,"PPSO",3
42,"42050",27,17,17,0,0,"PPSO",8
42,"42018",127,94,94,1,0,"PPSO",9
42,"42001",250,172,172,3,0,"PPSO",7
42,"42218",68,44,43,0,1,"PPSO",2
42,"42215",723,468,452,10,16,"PPSO",3
42,"42014",57,35,35,0,0,"PPSO",0
42,"42125",71,55,55,0,0,"PPSO",0
42,"42043",3816,2602,2540,23,62,"PPSO",186
42,"42166",55,38,37,0,1,"PPSO",0
42,"42213",25,17,16,1,1,"PPSO",0
42,"42153",12,10,10,0,0,"PPSO",0
42,"42086",33,19,19,1,0,"PPSO",0
42,"42173",29860,19581,19206,337,375,"PPSO",385
42,"42195",86,51,51,2,0,"PPSO",0
42,"42041",31,23,23,0,0,"PPSO",2
42,"42081",126,88,88,0,0,"PPSO",1
42,"42019",519,345,341,3,4,"PPSO",54
42,"42078",1000,653,640,5,13,"PPSO",22
42,"42162",2298,1493,1462,18,31,"PPSO",60
42,"42167",235,163,161,4,2,"PPSO",2
42,"42079",21,17,17,1,0,"PPSO",1
42,"42202",19,11,10,0,1,"PPSO",0
42,"42128",45,40,39,2,1,"PPSO",0
42,"42158",97,73,73,1,0,"PPSO",3
42,"42181",384,281,278,3,3,"PPSO",11
42,"42115",89,68,66,0,2,"PPSO",9
42,"42182",49,39,39,1,0,"PPSO",3
42,"42030",91,69,69,2,0,"PPSO",6
42,"42110",54,43,43,0,0,"PPSO",0
42,"42037",28,13,13,2,0,"PPSO",0
42,"42141",101,59,59,0,0,"PPSO",5
42,"42009",77,58,58,0,0,"PPSO",1
42,"42149",386,273,270,2,3,"PPSO",10
42,"42092",61,40,39,0,1,"PPSO",0
42,"42132",140,102,101,2,1,"PPSO",6
42,"42095",1909,1345,1326,32,19,"PPSO",23
42,"42035",730,464,460,3,4,"PPSO",10
42,"42090",83,65,64,1,1,"PPSO",5
42,"42103",543,383,374,2,9,"PPSO",13
42,"42069",1483,896,878,2,18,"PPSO",21
42,"42144",419,302,298,6,4,"PPSO",3
42,"42204",53,37,35,1,2,"PPSO",2
42,"42100",30,24,24,1,0,"PPSO",0
42,"42096",244,132,129,2,3,"PPSO",1
42,"42011",16,11,11,0,0,"PPSO",0
42,"42061",270,188,186,5,2,"PPSO",9
42,"42029",131,94,94,4,0,"PPSO",8
42,"42016",20,13,13,0,0,"PPSO",0
42,"42038",33,22,22,1,0,"PPSO",1
42,"42033",50,48,48,2,0,"PPSO",1
42,"42188",46,35,35,1,0,"PPSO",1
42,"42097",14,9,9,1,0,"PPSO",1
42,"42209",134,86,84,4,2,"PPSO",2
42,"42027",72,48,47,1,1,"PPSO",0
42,"42073",73,56,55,0,1,"PPSO",2
42,"42187",58,44,39,1,5,"PPSO",0
42,"42010",21,15,14,0,1,"PPSO",0
42,"42022",206,147,146,6,1,"PPSO",10
42,"42164",1580,1043,1029,8,14,"PPSO",24
42,"42207",48,42,41,0,1,"PPSO",1
42,"42208",20,12,12,1,0,"PPSO",0
42,"42083",26,20,20,0,0,"PPSO",1
42,"42008",54,41,41,0,0,"PPSO",0
42,"42124",56,27,27,0,0,"PPSO",0
42,"42058",103,74,72,1,2,"PPSO",2
42,"42012",29,22,22,0,0,"PPSO",2
42,"42129",678,485,480,6,5,"PPSO",11
42,"42023",57,48,48,0,0,"PPSO",1
42,"42049",108,71,71,1,0,"PPSO",2
42,"42200",74,49,46,0,3,"PPSO",3
42,"42108",10,7,7,0,0,"PPSO",0
42,"42171",111,72,71,1,1,"PPSO",0
42,"42063",45,31,30,1,1,"PPSO",0
42,"42107",70,48,47,1,1,"PPSO",0
42,"42021",65,46,45,2,1,"PPSO",0
42,"42025",1125,741,732,12,9,"PPSO",17
42,"42163",50,27,27,1,0,"PPSO",0
42,"42160",246,177,175,3,2,"PPSO",1
42,"42130",51,42,40,1,2,"PPSO",1
42,"42119",141,78,78,1,0,"PPSO",1
42,"42194",144,101,100,2,1,"PPSO",5
42,"42134",2651,1875,1836,21,39,"PPSO",39
42,"42185",24,20,20,0,0,"PPSO",2
42,"42127",37,26,26,1,0,"PPSO",1
42,"42201",23,21,21,0,0,"PPSO",0
42,"42094",596,448,436,9,12,"PPSO",6
42,"42075",78,50,50,1,0,"PPSO",2
42,"42117",129,98,95,1,3,"PPSO",6
42,"42062",20,10,10,0,0,"PPSO",0
42,"42032",138,96,96,0,0,"PPSO",3
42,"42042",53,42,41,1,1,"PPSO",1
42,"42015",30,20,20,0,0,"PPSO",3
42,"42135",69,40,40,1,0,"PPSO",1
42,"42142",42,36,36,1,0,"PPSO",0
42,"42176",27,21,21,0,0,"PPSO",0
42,"42007",108,80,80,1,0,"PPSO",4
42,"42118",21,11,11,0,0,"PPSO",1
42,"42156",29,21,21,0,0,"PPSO",1
42,"42192",36,22,22,2,0,"PPSO",0
42,"42111",274,183,181,0,2,"PPSO",5
42,"42020",4170,2732,2686,35,46,"PPSO",212
42,"42159",39,34,33,0,1,"PPSO",2
42,"42064",83,65,65,1,0,"PPSO",0
42,"42211",84,67,67,0,0,"PPSO",4
42,"42046",46,32,32,0,0,"PPSO",1
42,"42154",103,76,76,1,0,"PPSO",1
42,"42026",28,25,25,0,0,"PPSO",2
42,"42120",131,87,86,1,1,"PPSO",2
42,"42161",136,99,99,0,0,"PPSO",3
42,"42006",154,105,103,0,2,"PPSO",2
42,"42082",8,8,8,0,0,"PPSO",0
42,"42189",57,43,43,0,0,"PPSO",1
42,"42212",57,45,45,2,0,"PPSO",2
42,"42217",33,25,25,0,0,"PPSO",0
42,"42174",174,121,118,4,3,"PPSO",1
42,"42054",18,12,12,0,0,"PPSO",0
42,"42003",65,49,47,0,2,"PPSO",5
42,"42093",36,28,28,1,0,"PPSO",0
42,"42113",510,370,366,2,4,"PPSO",6
42,"42065",23,18,18,1,0,"PPSO",0
42,"42219",40,34,34,1,0,"PPSO",3
42,"42039",216,144,141,1,3,"PPSO",3
42,"42044",53,37,35,1,2,"PPSO",1
42,"42088",62,45,44,0,1,"PPSO",0
42,"42190",94,61,61,1,0,"PPSO",0
42,"42048",60,52,52,0,0,"PPSO",1
42,"42036",40,33,32,1,1,"PPSO",0
42,"42121",54,39,39,0,0,"PPSO",4
42,"42116",37,30,29,2,1,"PPSO",0
42,"42068",77,58,57,0,1,"PPSO",9
42,"42216",26,20,20,0,0,"PPSO",0
42,"42051",15,9,9,0,0,"PPSO",0
42,"42139",21,16,16,2,0,"PPSO",0
42,"42152",67,47,44,1,3,"PPSO",1
42,"42168",108,73,73,0,0,"PPSO",5
42,"42045",273,175,174,4,1,"PPSO",5
42,"42034",41,25,25,0,0,"PPSO",0
42,"42024",84,64,62,1,2,"PPSO",3
42,"42205",77,59,57,3,2,"PPSO",0
42,"42060",28,16,14,0,2,"PPSO",1
42,"42084",20,15,15,0,0,"PPSO",1
42,"42017",131,99,96,1,3,"PPSO",2
42,"42071",159,92,92,2,0,"PPSO",2
42,"42105",47,40,40,2,0,"PPSO",0
42,"42155",146,83,80,2,3,"PPSO",5
42,"42080",153,108,108,1,0,"PPSO",6
42,"42196",7,7,7,1,0,"PPSO",0
42,"42175",22,16,16,0,0,"PPSO",0
42,"42106",13,11,11,0,0,"PPSO",1
42,"42148",9,9,9,0,0,"PPSO",1
42,"42056",28,25,24,0,1,"PPSO",1
42,"42178",99,71,71,0,0,"PPSO",7
42,"42184",55,36,33,0,3,"PPSO",1
42,"42140",15,11,11,1,0,"PPSO",0
42,"42157",10,9,9,0,0,"PPSO",0
42,"42059",20,14,14,0,0,"PPSO",0
42,"42057",145,70,70,0,0,"PPSO",2
42,"42206",8,5,5,2,0,"PPSO",0
42,"42028",75,57,56,0,1,"PPSO",0
42,"42087",51,45,42,1,3,"PPSO",2
42,"42089",57,44,43,0,1,"PPSO",1
42,"42076",200,149,143,2,6,"PPSO",5
42,"42197",68,54,53,0,1,"PPSO",4
42,"42151",38,27,27,0,0,"PPSO",0
42,"42131",50,39,39,2,0,"PPSO",3
42,"42053",21,17,17,0,0,"PPSO",3
42,"42165",414,246,237,4,9,"PPSO",7
42,"42183",102,74,74,1,0,"PPSO",0
42,"42013",34,22,22,2,0,"PPSO",0
42,"42191",183,116,114,5,2,"PPSO",3
42,"42145",129,105,104,1,1,"PPSO",10
42,"42198",19,9,9,1,0,"PPSO",0
42,"42070",31,23,23,1,0,"PPSO",1
42,"42052",16,14,14,0,0,"PPSO",0
42,"42098",8,7,7,0,0,"PPSO",1
42,"42177",61,42,41,0,1,"PPSO",4
42,"42055",158,113,113,1,0,"PPSO",2
42,"42123",157,103,102,6,1,"PPSO",3
42,"42085",179,107,106,2,1,"PPSO",7
42,"42004",2290,1595,1565,30,30,"PPSO",27
42,"42193",14,7,7,0,0,"PPSO",0
42,"42031",25,17,17,1,0,"PPSO",0
39,"39089",131,82,82,0,0,"PRC",31
39,"39046",1342,910,902,3,8,"PRC",350
39,"39024",1802,1325,1314,7,11,"PRC",420
39,"39036",965,707,703,4,4,"PRC",157
39,"39035",9142,6574,6517,24,57,"PRC",1760
39,"39027",3045,2231,2199,23,32,"PRC",493
39,"39091",1881,1297,1291,8,6,"PRC",345
39,"39010",610,457,453,1,4,"PRC",149
39,"39093",297,216,214,1,2,"PRC",51
39,"39031",1237,870,865,1,5,"PRC",198
39,"39014",882,538,536,0,2,"PRC",138
39,"39085",7017,5029,4992,23,37,"PRC",1064
39,"39074",7050,5074,5029,26,45,"PRC",1182
39,"39002",3408,2360,2323,7,37,"PRC",527
39,"39070",126,91,89,0,2,"PRC",30
39,"39021",464,370,364,1,6,"PRC",25
39,"39048",1772,1311,1295,8,16,"PRC",326
39,"39096",669,451,450,1,1,"PRC",83
39,"39095",2266,1637,1619,8,18,"PRC",233
39,"39040",4271,3103,3080,18,23,"PRC",616
39,"39037",2033,1431,1420,3,11,"PRC",255
39,"39056",2262,1683,1671,14,12,"PRC",520
39,"39069",1934,1475,1458,2,17,"PRC",582
39,"39084",868,608,605,3,3,"PRC",144
39,"39044",3921,2805,2783,18,22,"PRC",583
39,"39083",1063,619,611,2,8,"PRC",261
39,"39022",970,673,668,2,5,"PRC",123
39,"39013",517,359,356,1,3,"PRC",68
39,"39065",222,166,163,0,3,"PRC",40
39,"39067",753,476,474,1,2,"PRC",161
39,"39006",1729,1207,1192,1,15,"PRC",241
39,"39028",3892,2905,2878,20,27,"PRC",585
39,"39098",1381,1088,1080,5,8,"PRC",387
39,"39042",5910,4354,4315,14,39,"PRC",983
39,"39049",304,198,195,2,3,"PRC",34
39,"39079",8850,6247,6175,28,72,"PRC",995
39,"39100",849,567,565,5,2,"PRC",148
39,"39012",6772,4807,4755,31,52,"PRC",1122
39,"39099",3193,2363,2346,10,17,"PRC",704
39,"39075",136789,95707,95089,478,618,"PRC",17071
39,"39029",629,476,469,1,7,"PRC",142
39,"39050",260,164,164,1,0,"PRC",23
39,"39062",1864,1395,1376,3,19,"PRC",328
39,"39094",840,611,611,2,0,"PRC",265
39,"39097",666,342,335,2,7,"PRC",64
39,"39101",231,134,132,2,2,"PRC",52
39,"39005",1419,1039,1030,9,9,"PRC",166
39,"39039",540,355,355,1,0,"PRC",89
39,"39080",3477,2404,2388,4,16,"PRC",453
39,"39017",550,378,372,1,6,"PRC",103
39,"39026",1702,1160,1151,11,9,"PRC",259
39,"39063",936,618,616,4,2,"PRC",145
39,"39003",261,189,187,2,2,"PRC",65
39,"39033",536,375,372,1,3,"PRC",110
39,"39020",23993,15944,15792,89,152,"PRC",2335
39,"39001",2063,1474,1467,5,7,"PRC",393
39,"39081",440,330,327,1,3,"PRC",62
39,"39088",59,40,40,2,0,"PRC",9
39,"39058",806,556,554,2,2,"PRC",154
39,"39073",10260,7537,7482,42,55,"PRC",1340
39,"39066",866,616,606,6,10,"PRC",130
39,"39086",358,236,235,2,1,"PRC",46
39,"39061",3470,2605,2591,14,14,"PRC",513
39,"39043",1517,1167,1154,3,13,"PRC",236
39,"39034",255,133,128,2,5,"PRC",22
39,"39057",2366,1636,1607,10,29,"PRC",333
39,"39102",2229,1524,1514,10,10,"PRC",340
39,"39018",4284,3211,3177,22,34,"PRC",742
39,"39068",642,442,438,1,4,"PRC",138
39,"39087",41241,29341,29084,152,257,"PRC",6835
39,"39076",3512,2517,2491,13,26,"PRC",617
39,"39060",6704,4959,4887,23,72,"PRC",1269
39,"39019",2232,1628,1603,10,25,"PRC",401
39,"39077",237,151,148,1,3,"PRC",28
39,"39054",4541,3271,3252,30,19,"PRC",844
39,"39053",212,133,133,4,0,"PRC",50
39,"39023",6563,4788,4753,14,35,"PRC",1222
39,"39008",13900,9814,9734,63,80,"PRC",1966
39,"39071",410,251,250,1,1,"PRC",75
39,"39009",3325,2306,2293,7,13,"PRC",571
39,"39011",1587,1178,1178,6,0,"PRC",294
39,"39090",773,557,553,2,4,"PRC",149
39,"39052",19005,13859,13748,83,111,"PRC",2783
39,"39047",1998,1408,1392,8,16,"PRC",433
39,"39051",73,64,64,1,0,"PRC",18
39,"39059",7518,5327,5287,23,40,"PRC",1217
39,"39004",1479,1050,1031,5,19,"PRC",302
39,"39072",325,184,182,0,2,"PRC",27
39,"39015",828,559,556,3,3,"PRC",136
39,"39078",1410,1004,997,5,7,"PRC",255
39,"39007",386,265,264,0,1,"PRC",86
39,"39016",23850,17235,17106,70,129,"PRC",3637
39,"39064",1352,1007,990,3,17,"PRC",250
39,"39038",1512,992,983,5,9,"PRC",196
39,"39032",1420,1032,1027,7,5,"PRC",195
39,"39041",1753,1285,1269,7,16,"PRC",288
39,"39092",863,534,533,3,1,"PRC",79
39,"39030",1874,1199,1187,6,12,"PRC",289
39,"39045",352,238,234,0,4,"PRC",66
39,"39055",1065,747,736,4,11,"PRC",100
39,"39025",8637,6256,6179,33,77,"PRC",1414
39,"39082",1611,1108,1102,8,6,"PRC",246
37,"37313",535,395,394,1,1,"PREPAL",1
49,"49043",256,191,189,1,2,"PREPAL",1
37,"37142",554,396,394,5,2,"PREPAL",1
37,"37344",229,157,147,2,10,"PREPAL",1
49,"49029",609,435,419,6,16,"PREPAL",2
49,"49154",111,63,59,0,4,"PREPAL",0
49,"49174",127,86,85,1,1,"PREPAL",0
49,"49228",53,36,36,0,0,"PREPAL",0
49,"49243",107,74,74,0,0,"PREPAL",0
37,"37239",203,175,174,2,1,"PREPAL",0
24,"24173",896,590,583,2,7,"PREPAL",1
24,"24020",436,230,228,0,2,"PREPAL",0
37,"37179",197,167,165,0,2,"PREPAL",1
24,"24155",441,340,334,2,6,"PREPAL",0
49,"49199",236,159,157,3,2,"PREPAL",0
24,"24216",666,453,445,4,8,"PREPAL",2
24,"24015",2193,1532,1500,12,32,"PREPAL",0
49,"49097",67,44,44,0,0,"PREPAL",0
49,"49138",205,141,140,2,1,"PREPAL",0
24,"24143",497,344,343,3,1,"PREPAL",0
37,"37109",178,127,126,0,1,"PREPAL",0
49,"49194",331,198,197,0,1,"PREPAL",2
37,"37348",100,76,76,0,0,"PREPAL",0
37,"37257",51,36,36,1,0,"PREPAL",0
24,"24151",433,307,304,1,3,"PREPAL",1
37,"37005",65,44,44,1,0,"PREPAL",0
24,"24123",709,461,457,2,4,"PREPAL",0
24,"24017",532,375,374,1,1,"PREPAL",1
49,"49258",111,93,93,2,0,"PREPAL",0
24,"24071",947,618,611,6,7,"PREPAL",0
49,"49241",235,178,177,1,1,"PREPAL",0
37,"37047",215,89,89,0,0,"PREPAL",0
37,"37072",144,121,118,5,3,"PREPAL",0
24,"24092",731,506,504,1,2,"PREPAL",1
37,"37333",203,125,124,2,1,"PREPAL",0
24,"24172",389,208,202,1,6,"PREPAL",0
37,"37051",79,58,58,0,0,"PREPAL",0
24,"24224",564,381,375,5,6,"PREPAL",0
37,"37009",197,145,144,1,1,"PREPAL",0
37,"37028",131,96,93,2,3,"PREPAL",0
37,"37319",88,68,64,2,4,"PREPAL",0
37,"37281",39,28,27,0,1,"PREPAL",0
37,"37216",294,234,227,5,7,"PREPAL",0
49,"49189",186,104,104,1,0,"PREPAL",0
37,"37186",94,68,68,0,0,"PREPAL",0
24,"24121",599,422,418,3,4,"PREPAL",0
37,"37266",68,44,44,0,0,"PREPAL",0
24,"24076",1283,926,913,10,13,"PREPAL",1
49,"49083",47,37,37,1,0,"PREPAL",1
37,"37136",625,388,387,7,1,"PREPAL",1
49,"49179",337,210,209,3,1,"PREPAL",1
24,"24056",2726,1803,1772,21,31,"PREPAL",8
24,"24213",158,127,126,1,1,"PREPAL",0
49,"49187",1197,839,819,12,20,"PREPAL",0
49,"49055",91,72,72,3,0,"PREPAL",0
49,"49057",107,74,71,0,3,"PREPAL",0
37,"37331",186,115,114,2,1,"PREPAL",0
24,"24197",717,500,499,2,1,"PREPAL",2
37,"37245",331,221,220,4,1,"PREPAL",0
37,"37292",91,65,65,0,0,"PREPAL",0
24,"24041",513,312,305,4,7,"PREPAL",0
24,"24025",283,190,185,3,5,"PREPAL",0
37,"37370",316,238,237,2,1,"PREPAL",1
24,"24164",351,175,174,0,1,"PREPAL",0
37,"37213",83,64,64,0,0,"PREPAL",0
24,"24168",430,325,322,6,3,"PREPAL",0
37,"37068",337,240,236,1,4,"PREPAL",0
37,"37144",327,233,233,2,0,"PREPAL",0
49,"49005",125,80,80,1,0,"PREPAL",0
49,"49007",361,241,233,7,8,"PREPAL",0
24,"24137",1043,700,691,8,9,"PREPAL",3
49,"49054",847,576,569,8,7,"PREPAL",2
37,"37275",98,67,67,0,0,"PREPAL",0
24,"24003",603,374,372,0,2,"PREPAL",1
37,"37323",474,335,325,5,10,"PREPAL",0
37,"37121",536,413,403,4,10,"PREPAL",0
37,"37060",283,205,202,1,3,"PREPAL",0
37,"37078",781,626,603,9,23,"PREPAL",0
24,"24107",206,147,147,1,0,"PREPAL",0
49,"49247",412,255,252,2,3,"PREPAL",0
24,"24219",489,334,329,7,5,"PREPAL",1
37,"37364",760,502,500,0,2,"PREPAL",0
49,"49099",96,67,67,0,0,"PREPAL",0
37,"37187",548,407,399,0,8,"PREPAL",1
37,"37173",1412,951,937,15,14,"PREPAL",0
49,"49015",198,156,155,0,1,"PREPAL",0
24,"24039",1949,1420,1412,33,8,"PREPAL",0
37,"37050",66,52,52,1,0,"PREPAL",0
24,"24217",135,93,93,0,0,"PREPAL",0
24,"24049",1417,983,975,14,8,"PREPAL",0
37,"37087",911,675,665,5,10,"PREPAL",2
37,"37328",159,112,110,1,2,"PREPAL",0
37,"37018",106,75,75,0,0,"PREPAL",0
49,"49135",576,368,366,3,2,"PREPAL",2
37,"37025",245,198,196,5,2,"PREPAL",0
24,"24212",983,693,684,10,9,"PREPAL",2
37,"37158",230,149,149,1,0,"PREPAL",0
24,"24113",346,240,240,2,0,"PREPAL",4
37,"37351",268,229,226,0,3,"PREPAL",0
37,"37120",98,78,76,0,2,"PREPAL",0
37,"37246",5146,3791,3737,42,54,"PREPAL",3
49,"49117",431,294,289,0,5,"PREPAL",0
37,"37332",65,49,49,0,0,"PREPAL",0
37,"37297",394,298,297,0,1,"PREPAL",0
37,"37363",104,81,80,0,1,"PREPAL",0
37,"37202",1004,773,763,12,10,"PREPAL",1
37,"37329",38,29,28,1,1,"PREPAL",1
24,"24051",389,275,269,1,6,"PREPAL",0
37,"37168",397,271,266,3,5,"PREPAL",0
24,"24103",274,134,134,0,0,"PREPAL",0
49,"49064",478,297,296,6,1,"PREPAL",0
37,"37132",317,211,207,0,4,"PREPAL",1
49,"49157",188,136,133,2,3,"PREPAL",1
37,"37010",925,645,638,5,7,"PREPAL",1
24,"24059",804,466,463,5,3,"PREPAL",0
49,"49137",167,123,121,0,2,"PREPAL",0
24,"24110",1158,784,773,1,11,"PREPAL",0
49,"49134",158,100,99,1,1,"PREPAL",0
49,"49053",919,676,661,8,15,"PREPAL",3
49,"49103",392,319,316,5,3,"PREPAL",0
37,"37027",239,182,179,2,3,"PREPAL",1
37,"37200",190,132,131,0,1,"PREPAL",0
37,"37256",191,123,123,1,0,"PREPAL",0
49,"49151",591,389,388,3,1,"PREPAL",0
37,"37115",108,67,65,0,2,"PREPAL",0
49,"49032",282,196,196,0,0,"PREPAL",0
37,"37197",88,53,53,1,0,"PREPAL",0
37,"37341",47,29,29,0,0,"PREPAL",0
37,"37215",133,93,90,1,3,"PREPAL",0
24,"24028",367,275,273,5,2,"PREPAL",0
49,"49033",655,440,434,4,6,"PREPAL",1
37,"37314",81,65,65,0,0,"PREPAL",0
24,"24190",146,103,103,2,0,"PREPAL",1
49,"49139",149,112,112,0,0,"PREPAL",0
49,"49175",204,136,135,3,1,"PREPAL",0
24,"24031",207,160,158,0,2,"PREPAL",0
37,"37164",232,176,175,3,1,"PREPAL",0
37,"37062",78,59,59,0,0,"PREPAL",0
37,"37039",279,202,197,2,5,"PREPAL",0
37,"37143",384,273,273,2,0,"PREPAL",1
49,"49094",210,111,111,0,0,"PREPAL",0
24,"24210",524,353,353,1,0,"PREPAL",0
24,"24171",337,136,134,4,2,"PREPAL",0
37,"37184",289,178,177,1,1,"PREPAL",0
37,"37108",98,75,75,3,0,"PREPAL",0
37,"37029",186,125,124,1,1,"PREPAL",0
49,"49042",229,166,164,2,2,"PREPAL",0
49,"49265",110,79,78,2,1,"PREPAL",1
49,"49262",367,263,261,1,2,"PREPAL",0
49,"49238",273,205,200,4,5,"PREPAL",1
24,"24034",3466,2382,2359,25,23,"PREPAL",0
37,"37127",205,139,139,1,0,"PREPAL",0
24,"24207",276,215,215,2,0,"PREPAL",0
49,"49259",79,59,59,0,0,"PREPAL",0
49,"49126",260,153,150,1,3,"PREPAL",0
37,"37145",236,173,170,3,3,"PREPAL",0
49,"49142",244,163,160,0,3,"PREPAL",0
24,"24150",226,163,162,0,1,"PREPAL",0
37,"37020",431,320,314,3,6,"PREPAL",2
37,"37207",336,244,240,4,4,"PREPAL",0
49,"49020",253,189,187,0,2,"PREPAL",1
49,"49267",96,67,63,2,4,"PREPAL",0
37,"37374",1138,889,872,2,17,"PREPAL",1
37,"37103",409,295,294,2,1,"PREPAL",1
49,"49127",2402,1640,1604,18,36,"PREPAL",3
37,"37226",152,113,113,2,0,"PREPAL",0
24,"24089",101036,71905,71305,744,600,"PREPAL",92
37,"37288",281,220,218,4,2,"PREPAL",0
24,"24040",416,293,292,2,1,"PREPAL",0
49,"49109",561,419,415,6,4,"PREPAL",1
24,"24209",2597,1651,1636,12,15,"PREPAL",0
24,"24097",200,138,137,1,1,"PREPAL",0
49,"49171",603,433,427,4,6,"PREPAL",0
37,"37219",169,88,85,1,3,"PREPAL",0
24,"24229",376,275,269,2,6,"PREPAL",0
49,"49040",109,89,87,2,2,"PREPAL",0
24,"24078",324,228,225,0,3,"PREPAL",1
37,"37380",55,41,40,2,1,"PREPAL",0
24,"24134",3287,2278,2226,18,52,"PREPAL",6
24,"24062",126,79,79,0,0,"PREPAL",0
24,"24046",893,595,583,6,12,"PREPAL",0
37,"37238",105,83,80,0,3,"PREPAL",0
49,"49219",7196,4613,4528,64,85,"PREPAL",13
37,"37315",89,65,64,0,1,"PREPAL",0
49,"49030",79,56,56,0,0,"PREPAL",0
24,"24118",101,72,72,0,0,"PREPAL",0
37,"37056",39,28,28,0,0,"PREPAL",0
49,"49075",130,100,97,1,3,"PREPAL",0
49,"49129",810,541,527,4,14,"PREPAL",0
49,"49046",246,174,169,0,5,"PREPAL",0
49,"49115",167,121,121,2,0,"PREPAL",1
37,"37140",630,395,393,0,2,"PREPAL",0
49,"49052",183,120,117,2,3,"PREPAL",0
49,"49031",148,107,105,2,2,"PREPAL",1
24,"24188",3795,2877,2825,40,52,"PREPAL",2
37,"37199",128,92,92,2,0,"PREPAL",0
49,"49013",219,160,159,0,1,"PREPAL",1
37,"37124",195,137,137,2,0,"PREPAL",1
37,"37096",203,144,144,2,0,"PREPAL",0
37,"37316",711,546,541,7,5,"PREPAL",3
37,"37092",1933,1342,1327,13,15,"PREPAL",4
49,"49088",80,51,51,0,0,"PREPAL",0
24,"24023",264,188,185,1,3,"PREPAL",1
37,"37014",1140,747,737,7,10,"PREPAL",0
37,"37102",375,260,260,4,0,"PREPAL",0
37,"37250",325,212,211,0,1,"PREPAL",0
24,"24166",1346,929,916,14,13,"PREPAL",5
37,"37007",391,289,281,7,8,"PREPAL",0
49,"49066",437,276,272,2,4,"PREPAL",1
24,"24120",305,182,181,1,1,"PREPAL",0
37,"37382",162,127,124,0,3,"PREPAL",0
49,"49093",280,226,223,5,3,"PREPAL",1
24,"24081",121,72,72,0,0,"PREPAL",0
37,"37139",189,150,148,1,2,"PREPAL",0
49,"49208",352,223,214,1,9,"PREPAL",2
24,"24159",1716,1238,1216,6,22,"PREPAL",0
37,"37046",10648,7396,7241,62,155,"PREPAL",9
37,"37289",210,147,144,0,3,"PREPAL",0
37,"37194",229,161,160,0,1,"PREPAL",0
24,"24139",2071,1371,1346,15,25,"PREPAL",0
49,"49209",451,274,269,7,5,"PREPAL",0
37,"37083",181,155,153,1,2,"PREPAL",0
24,"24179",287,207,207,2,0,"PREPAL",0
37,"37265",198,167,163,1,4,"PREPAL",0
49,"49160",42,27,27,0,0,"PREPAL",0
49,"49197",155,109,104,0,5,"PREPAL",1
24,"24087",582,431,427,3,4,"PREPAL",0
49,"49079",104,79,76,0,3,"PREPAL",0
24,"24088",996,750,745,9,5,"PREPAL",1
49,"49162",170,117,116,1,1,"PREPAL",1
37,"37036",55,36,34,0,2,"PREPAL",0
24,"24095",317,228,228,3,0,"PREPAL",0
24,"24131",684,416,415,2,1,"PREPAL",0
49,"49024",626,432,426,3,6,"PREPAL",0
37,"37243",89,66,66,0,0,"PREPAL",0
49,"49239",599,393,384,6,9,"PREPAL",0
37,"37151",142,109,109,1,0,"PREPAL",0
37,"37277",74,55,55,0,0,"PREPAL",0
49,"49092",115,72,72,0,0,"PREPAL",0
37,"37037",108,72,72,0,0,"PREPAL",0
37,"37141",149,101,100,0,1,"PREPAL",0
37,"37371",252,156,155,0,1,"PREPAL",0
49,"49006",139,98,95,3,3,"PREPAL",0
37,"37086",107,86,85,2,1,"PREPAL",0
24,"24100",737,506,502,9,4,"PREPAL",0
24,"24053",398,250,248,1,2,"PREPAL",0
49,"49263",44,32,32,1,0,"PREPAL",0
37,"37135",1146,849,837,5,12,"PREPAL",1
37,"37193",362,253,252,4,1,"PREPAL",0
49,"49116",356,239,234,4,5,"PREPAL",1
49,"49204",58,44,43,1,1,"PREPAL",0
37,"37302",262,161,161,2,0,"PREPAL",0
24,"24084",153,105,102,2,3,"PREPAL",0
37,"37258",134,92,92,1,0,"PREPAL",0
37,"37352",209,157,155,3,2,"PREPAL",0
37,"37074",136,93,90,1,3,"PREPAL",0
37,"37237",296,212,204,1,8,"PREPAL",1
49,"49128",520,384,378,7,6,"PREPAL",0
24,"24037",330,189,189,1,0,"PREPAL",0
37,"37318",196,132,132,0,0,"PREPAL",0
37,"37100",74,59,58,1,1,"PREPAL",0
49,"49252",312,240,236,7,4,"PREPAL",0
37,"37339",295,219,219,5,0,"PREPAL",1
49,"49165",55,52,52,1,0,"PREPAL",0
49,"49164",141,95,92,1,3,"PREPAL",0
49,"49041",409,287,282,1,5,"PREPAL",0
49,"49188",111,75,73,0,2,"PREPAL",0
24,"24175",1821,1316,1305,15,11,"PREPAL",0
24,"24018",172,129,128,0,1,"PREPAL",0
37,"37269",424,280,277,2,3,"PREPAL",0
37,"37019",138,111,109,0,2,"PREPAL",0
24,"24211",259,199,198,3,1,"PREPAL",0
49,"49016",230,155,155,0,0,"PREPAL",0
37,"37130",173,135,134,2,1,"PREPAL",1
37,"37373",692,451,442,4,9,"PREPAL",0
24,"24114",2866,1753,1742,15,11,"PREPAL",1
49,"49266",66,46,45,1,1,"PREPAL",0
49,"49256",236,183,179,0,4,"PREPAL",1
37,"37165",31,22,22,0,0,"PREPAL",0
24,"24227",1527,1036,1032,13,4,"PREPAL",2
49,"49021",14204,9429,9295,87,134,"PREPAL",18
49,"49096",155,113,112,2,1,"PREPAL",0
37,"37089",60,44,43,0,1,"PREPAL",0
37,"37176",128,99,98,1,1,"PREPAL",0
37,"37030",82,60,60,0,0,"PREPAL",0
37,"37196",70,50,50,0,0,"PREPAL",0
37,"37230",220,169,168,1,1,"PREPAL",0
49,"49201",283,232,228,3,4,"PREPAL",0
49,"49221",233,122,120,2,2,"PREPAL",1
37,"37320",85,65,64,1,1,"PREPAL",0
37,"37294",11750,8395,8280,88,115,"PREPAL",57
24,"24119",695,464,458,7,6,"PREPAL",0
49,"49105",135,94,94,2,0,"PREPAL",0
37,"37218",51,25,23,0,2,"PREPAL",0
37,"37355",159,121,120,1,1,"PREPAL",0
24,"24021",1595,1037,1025,7,12,"PREPAL",4
37,"37346",251,208,207,1,1,"PREPAL",1
24,"24174",457,294,289,3,5,"PREPAL",0
24,"24101",370,219,213,4,6,"PREPAL",1
37,"37204",253,176,173,2,3,"PREPAL",0
37,"37366",40,34,33,2,1,"PREPAL",0
49,"49110",344,196,195,2,1,"PREPAL",0
37,"37268",106,62,61,1,1,"PREPAL",0
49,"49222",369,250,247,2,3,"PREPAL",1
49,"49245",251,174,171,1,3,"PREPAL",0
24,"24069",37,26,25,0,1,"PREPAL",0
37,"37221",391,259,257,2,2,"PREPAL",1
37,"37044",431,309,308,3,1,"PREPAL",1
37,"37336",56,45,43,2,2,"PREPAL",0
37,"37232",377,303,303,2,0,"PREPAL",0
37,"37023",1624,1233,1211,15,22,"PREPAL",0
49,"49230",84,69,69,0,0,"PREPAL",0
49,"49206",776,515,504,7,11,"PREPAL",1
49,"49169",38,33,32,0,1,"PREPAL",1
49,"49235",415,300,290,4,10,"PREPAL",0
37,"37273",85,58,58,2,0,"PREPAL",0
37,"37147",184,126,124,1,2,"PREPAL",0
24,"24011",182,104,102,3,2,"PREPAL",0
37,"37304",156,97,96,1,1,"PREPAL",0
49,"49002",58,43,40,0,3,"PREPAL",0
37,"37159",74,59,59,0,0,"PREPAL",0
37,"37284",317,229,222,2,7,"PREPAL",0
24,"24180",1086,767,759,9,8,"PREPAL",0
37,"37222",78,55,55,2,0,"PREPAL",0
37,"37148",399,295,291,0,4,"PREPAL",0
37,"37378",92,54,54,0,0,"PREPAL",0
49,"49147",250,164,162,1,2,"PREPAL",0
37,"37065",276,167,167,2,0,"PREPAL",0
37,"37223",106,75,74,0,1,"PREPAL",0
37,"37001",165,120,120,0,0,"PREPAL",0
37,"37278",793,570,567,6,3,"PREPAL",1
37,"37310",166,116,115,3,1,"PREPAL",0
24,"24177",467,265,263,2,2,"PREPAL",0
49,"49014",116,83,83,1,0,"PREPAL",0
37,"37082",733,468,456,7,12,"PREPAL",0
37,"37118",117,86,86,3,0,"PREPAL",0
37,"37379",169,133,132,0,1,"PREPAL",0
24,"24133",357,256,256,1,0,"PREPAL",0
24,"24065",2164,1524,1492,12,32,"PREPAL",4
49,"49172",474,278,271,1,7,"PREPAL",0
37,"37235",214,163,159,2,4,"PREPAL",1
37,"37285",360,271,270,0,1,"PREPAL",0
49,"49125",1392,883,871,11,12,"PREPAL",2
24,"24109",857,534,528,8,6,"PREPAL",0
49,"49004",110,74,71,3,3,"PREPAL",0
24,"24196",1907,1322,1299,4,23,"PREPAL",0
49,"49272",73,49,46,2,3,"PREPAL",0
37,"37306",238,140,136,3,4,"PREPAL",0
49,"49114",40,31,27,0,4,"PREPAL",1
49,"49226",240,200,198,2,2,"PREPAL",0
49,"49136",313,218,217,5,1,"PREPAL",4
37,"37016",563,419,411,4,8,"PREPAL",0
37,"37026",180,148,147,5,1,"PREPAL",0
37,"37224",189,156,153,2,3,"PREPAL",1
49,"49038",88,63,58,1,5,"PREPAL",0
24,"24063",362,247,245,2,2,"PREPAL",0
49,"49249",61,45,45,1,0,"PREPAL",0
24,"24004",495,387,384,10,3,"PREPAL",1
37,"37225",97,78,74,0,4,"PREPAL",0
37,"37162",212,139,137,3,2,"PREPAL",0
49,"49017",247,176,176,1,0,"PREPAL",0
49,"49039",324,249,239,3,10,"PREPAL",0
49,"49214",666,486,477,6,9,"PREPAL",0
24,"24198",541,346,344,6,2,"PREPAL",0
37,"37172",846,530,524,6,6,"PREPAL",1
49,"49080",622,440,437,4,3,"PREPAL",0
37,"37247",171,129,128,0,1,"PREPAL",0
49,"49200",936,679,670,9,9,"PREPAL",2
49,"49251",159,116,109,2,7,"PREPAL",0
37,"37073",613,448,440,4,8,"PREPAL",0
49,"49104",326,218,216,0,2,"PREPAL",0
49,"49155",81,60,59,0,1,"PREPAL",0
24,"24024",636,407,403,6,4,"PREPAL",0
37,"37372",133,99,98,0,1,"PREPAL",0
49,"49240",185,125,123,3,2,"PREPAL",0
49,"49081",1321,972,953,6,19,"PREPAL",0
24,"24112",288,188,186,2,2,"PREPAL",0
24,"24005",342,218,217,0,1,"PREPAL",0
37,"37321",150,118,115,0,3,"PREPAL",0
24,"24152",433,269,267,4,2,"PREPAL",0
49,"49229",109,80,77,1,3,"PREPAL",0
24,"24163",4076,2979,2954,35,25,"PREPAL",4
49,"49082",341,273,270,12,3,"PREPAL",2
37,"37154",129,97,94,1,3,"PREPAL",0
37,"37174",975,716,705,2,11,"PREPAL",2
24,"24033",209,149,149,0,0,"PREPAL",0
24,"24090",323,200,200,2,0,"PREPAL",0
37,"37101",138,101,100,1,1,"PREPAL",0
49,"49067",329,200,198,4,2,"PREPAL",0
24,"24141",96,74,74,0,0,"PREPAL",0
24,"24201",1029,683,676,9,7,"PREPAL",0
37,"37300",540,355,352,7,3,"PREPAL",0
37,"37312",244,191,189,1,2,"PREPAL",0
49,"49118",193,151,151,2,0,"PREPAL",0
49,"49153",150,110,107,2,3,"PREPAL",0
24,"24079",861,601,595,9,6,"PREPAL",1
37,"37217",59,43,43,3,0,"PREPAL",0
49,"49166",1193,835,821,7,14,"PREPAL",1
37,"37301",84,64,64,1,0,"PREPAL",0
24,"24127",263,183,181,1,2,"PREPAL",0
49,"49084",266,197,195,11,2,"PREPAL",0
37,"37063",58,47,47,0,0,"PREPAL",0
37,"37229",138,103,101,0,2,"PREPAL",0
37,"37365",162,125,121,0,4,"PREPAL",0
24,"24115",53159,35203,34784,410,419,"PREPAL",27
24,"24142",24715,16839,16616,159,223,"PREPAL",31
24,"24154",952,625,618,5,7,"PREPAL",2
49,"49220",146,102,98,3,4,"PREPAL",1
24,"24203",88,62,62,1,0,"PREPAL",0
24,"24008",8931,6291,6214,79,77,"PREPAL",9
49,"49085",904,583,579,5,4,"PREPAL",0
37,"37317",287,211,209,1,2,"PREPAL",0
24,"24184",177,106,105,0,1,"PREPAL",0
24,"24116",387,227,226,3,1,"PREPAL",1
37,"37177",259,198,197,3,1,"PREPAL",2
49,"49131",231,149,145,1,4,"PREPAL",0
49,"49167",180,131,131,2,0,"PREPAL",0
37,"37261",213,153,149,0,4,"PREPAL",0
37,"37055",117,97,93,0,4,"PREPAL",0
37,"37157",76,64,63,1,1,"PREPAL",0
49,"49145",208,113,113,1,0,"PREPAL",0
37,"37116",70,50,50,0,0,"PREPAL",0
24,"24094",1320,866,852,11,14,"PREPAL",1
24,"24082",847,615,608,16,7,"PREPAL",2
37,"37282",193,132,131,3,1,"PREPAL",0
37,"37307",146,94,91,1,3,"PREPAL",0
24,"24178",60,54,54,1,0,"PREPAL",0
37,"37252",99,65,65,1,0,"PREPAL",0
49,"49168",89,68,68,0,0,"PREPAL",0
24,"24105",1512,1054,1047,10,7,"PREPAL",2
37,"37002",125,64,63,0,1,"PREPAL",0
49,"49121",372,239,233,1,6,"PREPAL",1
37,"37012",144,111,111,0,0,"PREPAL",1
49,"49180",135,82,81,5,1,"PREPAL",1
49,"49034",408,282,281,2,1,"PREPAL",0
37,"37347",463,349,345,9,4,"PREPAL",1
37,"37091",161,104,104,0,0,"PREPAL",1
37,"37003",104,75,75,2,0,"PREPAL",0
37,"37106",248,161,160,4,1,"PREPAL",0
49,"49146",265,183,181,4,2,"PREPAL",0
37,"37293",102,68,68,1,0,"PREPAL",1
37,"37263",339,215,210,0,5,"PREPAL",0
37,"37211",208,148,148,0,0,"PREPAL",1
37,"37253",135,109,109,1,0,"PREPAL",0
37,"37367",179,147,143,2,4,"PREPAL",0
37,"37045",27,19,19,0,0,"PREPAL",0
37,"37368",17,12,11,0,1,"PREPAL",0
37,"37190",189,141,139,1,2,"PREPAL",0
37,"37128",235,169,168,0,1,"PREPAL",0
49,"49025",157,121,118,0,3,"PREPAL",0
49,"49003",860,534,530,5,4,"PREPAL",1
49,"49216",147,115,109,0,6,"PREPAL",0
37,"37291",269,186,185,1,1,"PREPAL",1
24,"24001",165,93,93,0,0,"PREPAL",0
49,"49100",281,164,157,2,7,"PREPAL",0
24,"24221",738,492,485,9,7,"PREPAL",1
49,"49271",176,128,127,3,1,"PREPAL",0
37,"37107",10444,6997,6884,76,113,"PREPAL",11
37,"37191",102,57,57,1,0,"PREPAL",0
37,"37244",129,97,97,1,0,"PREPAL",0
24,"24086",258,197,196,1,1,"PREPAL",0
49,"49037",174,139,136,1,3,"PREPAL",0
37,"37255",43,33,31,1,2,"PREPAL",0
37,"37097",42,29,29,0,0,"PREPAL",0
24,"24222",14499,10219,10076,99,143,"PREPAL",10
37,"37342",250,190,189,3,1,"PREPAL",3
49,"49050",498,305,305,2,0,"PREPAL",1
37,"37248",150,116,116,1,0,"PREPAL",1
37,"37071",76,64,62,1,2,"PREPAL",0
24,"24160",633,404,403,2,1,"PREPAL",2
37,"37205",212,157,155,1,2,"PREPAL",0
24,"24074",97,70,70,1,0,"PREPAL",0
37,"37098",290,197,197,1,0,"PREPAL",1
24,"24026",1085,724,712,14,12,"PREPAL",2
37,"37360",206,135,135,1,0,"PREPAL",0
37,"37182",75,47,47,1,0,"PREPAL",0
49,"49210",447,350,348,3,2,"PREPAL",0
37,"37330",314,227,223,2,4,"PREPAL",0
24,"24136",495,347,344,1,3,"PREPAL",0
37,"37131",175,125,125,0,0,"PREPAL",0
49,"49275",51064,34471,34017,475,454,"PREPAL",113
37,"37006",116,71,70,3,1,"PREPAL",0
49,"49227",317,245,244,4,1,"PREPAL",1
37,"37236",123,85,82,1,3,"PREPAL",1
49,"49185",156,120,116,0,4,"PREPAL",1
37,"37110",104,81,79,1,2,"PREPAL",0
37,"37017",226,169,168,4,1,"PREPAL",0
37,"37298",170,109,109,0,0,"PREPAL",0
37,"37309",36,21,21,0,0,"PREPAL",0
37,"37361",84,55,54,1,1,"PREPAL",0
37,"37183",377,267,267,5,0,"PREPAL",1
37,"37163",34,24,24,0,0,"PREPAL",0
37,"37264",56,39,39,0,0,"PREPAL",0
24,"24199",398,263,256,4,7,"PREPAL",0
37,"37122",203,162,161,3,1,"PREPAL",0
37,"37054",233,190,186,2,4,"PREPAL",1
37,"37251",108,75,75,0,0,"PREPAL",1
49,"49152",474,289,282,2,7,"PREPAL",0
37,"37038",756,531,517,4,14,"PREPAL",0
37,"37362",4783,3469,3420,44,49,"PREPAL",3
49,"49264",529,334,329,2,5,"PREPAL",2
49,"49268",364,266,263,3,3,"PREPAL",1
37,"37008",4213,3092,3046,21,46,"PREPAL",2
24,"24185",447,303,295,1,8,"PREPAL",0
37,"37303",179,118,117,1,1,"PREPAL",0
24,"24032",99,70,66,1,4,"PREPAL",0
37,"37067",3278,2568,2529,30,39,"PREPAL",1
37,"37188",158,107,105,3,2,"PREPAL",0
49,"49008",423,263,259,1,4,"PREPAL",0
37,"37175",412,298,293,4,5,"PREPAL",0
49,"49192",123,93,90,2,3,"PREPAL",1
37,"37228",324,262,262,1,0,"PREPAL",0
49,"49095",282,202,201,6,1,"PREPAL",1
37,"37322",2462,1580,1537,14,43,"PREPAL",2
24,"24153",228,171,171,3,0,"PREPAL",0
37,"37088",199,135,133,0,2,"PREPAL",0
49,"49009",382,251,251,0,0,"PREPAL",0
37,"37134",209,143,141,3,2,"PREPAL",0
37,"37343",66,44,43,1,1,"PREPAL",0
24,"24019",338,259,256,4,3,"PREPAL",0
37,"37166",196,134,133,1,1,"PREPAL",0
37,"37052",287,192,191,2,1,"PREPAL",0
37,"37270",184,139,136,2,3,"PREPAL",0
37,"37334",71,30,30,0,0,"PREPAL",0
24,"24176",302,232,226,0,6,"PREPAL",1
49,"49242",439,342,336,2,6,"PREPAL",0
24,"24052",139,94,93,0,1,"PREPAL",0
24,"24132",610,330,329,5,1,"PREPAL",0
37,"37354",5479,3969,3905,37,64,"PREPAL",10
24,"24080",207,155,154,1,1,"PREPAL",0
24,"24043",116,54,52,0,2,"PREPAL",0
49,"49143",201,119,118,1,1,"PREPAL",0
37,"37152",400,268,261,4,7,"PREPAL",0
49,"49010",350,260,256,8,4,"PREPAL",3
37,"37021",66,45,44,0,1,"PREPAL",0
49,"49159",269,182,182,2,0,"PREPAL",0
37,"37212",104,76,76,0,0,"PREPAL",0
37,"37041",71,53,53,0,0,"PREPAL",0
24,"24009",274,136,135,1,1,"PREPAL",0
37,"37376",2130,1446,1423,18,23,"PREPAL",1
24,"24205",990,678,667,6,11,"PREPAL",1
37,"37369",126,83,81,0,2,"PREPAL",0
49,"49257",305,186,184,0,2,"PREPAL",2
37,"37335",384,282,279,1,3,"PREPAL",0
24,"24149",149,123,123,0,0,"PREPAL",0
49,"49184",172,110,107,2,3,"PREPAL",0
24,"24002",224,165,162,1,3,"PREPAL",1
24,"24170",1806,1232,1220,9,12,"PREPAL",0
24,"24130",415,291,289,2,2,"PREPAL",1
49,"49086",111,89,89,1,0,"PREPAL",0
37,"37015",198,127,125,2,2,"PREPAL",1
49,"49122",761,517,505,7,12,"PREPAL",1
37,"37356",84,58,58,0,0,"PREPAL",0
37,"37104",24,16,16,0,0,"PREPAL",0
49,"49087",476,246,244,0,2,"PREPAL",1
24,"24022",304,198,195,2,3,"PREPAL",0
49,"49012",70,34,34,0,0,"PREPAL",0
49,"49111",119,84,84,3,0,"PREPAL",0
37,"37081",879,680,674,2,6,"PREPAL",0
37,"37337",137,104,103,0,1,"PREPAL",0
49,"49047",98,74,72,1,2,"PREPAL",0
37,"37283",116,83,83,0,0,"PREPAL",0
49,"49246",214,183,180,3,3,"PREPAL",0
37,"37069",981,669,657,3,12,"PREPAL",2
37,"37327",179,148,147,2,1,"PREPAL",0
37,"37057",208,151,149,0,2,"PREPAL",0
37,"37260",137,110,109,0,1,"PREPAL",0
37,"37267",177,130,129,0,1,"PREPAL",1
37,"37138",222,163,159,3,4,"PREPAL",0
37,"37233",53,39,39,1,0,"PREPAL",0
37,"37338",77,58,58,0,0,"PREPAL",0
24,"24181",1404,944,925,7,19,"PREPAL",0
49,"49069",337,210,201,0,9,"PREPAL",0
49,"49236",71,54,54,0,0,"PREPAL",0
24,"24194",267,178,177,1,1,"PREPAL",0
24,"24228",619,370,364,2,6,"PREPAL",0
24,"24189",5872,3915,3873,42,42,"PREPAL",14
49,"49077",157,80,80,0,0,"PREPAL",0
37,"37112",158,110,109,2,1,"PREPAL",0
24,"24148",1602,1152,1140,11,12,"PREPAL",2
49,"49026",199,134,134,0,0,"PREPAL",0
24,"24006",488,356,347,4,9,"PREPAL",1
37,"37181",265,158,158,0,0,"PREPAL",0
37,"37059",117,95,95,3,0,"PREPAL",0
24,"24124",338,196,195,2,1,"PREPAL",0
37,"37272",132,97,95,0,2,"PREPAL",0
37,"37146",106,82,76,0,6,"PREPAL",0
49,"49023",899,627,620,3,7,"PREPAL",3
49,"49205",359,252,251,7,1,"PREPAL",0
49,"49091",246,168,167,1,1,"PREPAL",1
37,"37279",713,488,480,4,8,"PREPAL",0
37,"37185",539,372,363,2,9,"PREPAL",0
24,"24054",410,275,271,0,4,"PREPAL",1
24,"24125",416,233,231,3,2,"PREPAL",0
24,"24182",410,273,270,7,3,"PREPAL",1
37,"37276",125,92,92,0,0,"PREPAL",0
24,"24223",2533,1727,1705,40,22,"PREPAL",5
37,"37161",123,86,86,0,0,"PREPAL",0
24,"24098",1149,753,741,8,12,"PREPAL",0
49,"49065",1048,747,725,6,22,"PREPAL",1
37,"37340",141,97,97,1,0,"PREPAL",0
37,"37286",204,140,137,2,3,"PREPAL",0
24,"24091",575,368,362,5,6,"PREPAL",0
24,"24122",1292,818,810,7,8,"PREPAL",1
49,"49186",230,172,170,0,2,"PREPAL",0
24,"24016",488,244,243,0,1,"PREPAL",0
49,"49108",446,312,309,2,3,"PREPAL",1
49,"49119",217,158,156,2,2,"PREPAL",21
49,"49163",203,139,138,3,1,"PREPAL",0
24,"24077",212,166,162,0,4,"PREPAL",0
24,"24099",153,111,110,1,1,"PREPAL",0
37,"37099",63,46,46,1,0,"PREPAL",0
37,"37024",89,60,60,0,0,"PREPAL",0
37,"37061",195,136,136,1,0,"PREPAL",0
49,"49018",277,197,190,2,7,"PREPAL",0
49,"49124",238,170,164,2,6,"PREPAL",0
37,"37058",56,38,38,1,0,"PREPAL",0
24,"24093",342,214,212,2,2,"PREPAL",0
24,"24067",602,327,324,6,3,"PREPAL",7
37,"37345",150,117,113,0,4,"PREPAL",0
37,"37299",230,148,147,0,1,"PREPAL",0
49,"49022",282,230,229,2,1,"PREPAL",0
24,"24068",430,289,281,0,8,"PREPAL",0
37,"37178",98,70,70,0,0,"PREPAL",0
24,"24144",621,419,412,4,7,"PREPAL",2
24,"24014",7152,4494,4448,47,46,"PREPAL",2
37,"37160",597,380,370,3,10,"PREPAL",0
49,"49078",138,113,109,4,4,"PREPAL",0
49,"49273",165,90,90,0,0,"PREPAL",0
24,"24218",451,310,308,3,2,"PREPAL",0
37,"37126",30,25,25,0,0,"PREPAL",0
37,"37242",82,59,59,1,0,"PREPAL",0
24,"24083",997,659,647,9,12,"PREPAL",0
24,"24010",8251,5357,5275,40,82,"PREPAL",5
24,"24226",194,118,118,1,0,"PREPAL",0
37,"37377",215,174,173,0,1,"PREPAL",0
37,"37353",122,82,80,0,2,"PREPAL",4
24,"24102",587,403,399,7,4,"PREPAL",0
24,"24214",626,438,433,8,5,"PREPAL",0
49,"49176",605,360,353,0,7,"PREPAL",0
49,"49203",280,218,212,1,6,"PREPAL",0
24,"24165",317,202,199,1,3,"PREPAL",0
49,"49270",139,93,92,0,1,"PREPAL",1
24,"24055",674,484,482,8,2,"PREPAL",0
49,"49130",155,116,112,1,4,"PREPAL",0
37,"37156",4261,2928,2869,23,59,"PREPAL",4
37,"37117",1572,1103,1092,12,11,"PREPAL",2
37,"37077",251,206,204,1,2,"PREPAL",0
49,"49133",287,206,203,1,3,"PREPAL",0
37,"37203",151,114,113,1,1,"PREPAL",0
37,"37290",130,106,106,0,0,"PREPAL",0
49,"49112",118,72,72,2,0,"PREPAL",0
37,"37287",297,204,202,2,2,"PREPAL",1
37,"37240",928,648,637,2,11,"PREPAL",2
37,"37375",678,539,523,8,16,"PREPAL",0
24,"24064",1501,1030,1012,2,18,"PREPAL",1
49,"49232",85,64,64,0,0,"PREPAL",0
24,"24902",331,239,239,0,0,"PREPAL",1
49,"49158",206,159,155,0,4,"PREPAL",0
49,"49225",122,68,68,0,0,"PREPAL",0
49,"49178",748,520,505,7,15,"PREPAL",1
37,"37119",99,78,78,1,0,"PREPAL",0
37,"37296",297,215,210,0,5,"PREPAL",0
24,"24073",437,285,282,1,3,"PREPAL",0
49,"49149",368,270,266,1,4,"PREPAL",3
24,"24156",220,135,133,0,2,"PREPAL",0
37,"37198",202,147,144,2,3,"PREPAL",2
49,"49098",200,139,138,3,1,"PREPAL",1
37,"37090",68,47,47,0,0,"PREPAL",0
24,"24057",1295,909,891,7,18,"PREPAL",0
49,"49237",142,78,78,0,0,"PREPAL",0
24,"24167",703,436,430,3,6,"PREPAL",0
37,"37080",221,164,163,1,1,"PREPAL",0
49,"49019",232,162,152,2,10,"PREPAL",0
24,"24157",2542,1846,1809,16,37,"PREPAL",8
24,"24038",3024,2121,2071,25,50,"PREPAL",0
24,"24145",612,338,337,1,1,"PREPAL",0
37,"37209",415,276,275,2,1,"PREPAL",0
49,"49141",290,191,191,1,0,"PREPAL",0
24,"24206",1594,1104,1093,11,11,"PREPAL",0
49,"49076",330,230,226,9,4,"PREPAL",3
37,"37189",114,75,74,1,1,"PREPAL",0
24,"24183",748,464,460,9,4,"PREPAL",2
49,"49224",166,102,100,0,2,"PREPAL",0
49,"49207",215,144,143,1,1,"PREPAL",0
37,"37013",104,72,70,2,2,"PREPAL",1
49,"49061",143,98,97,1,1,"PREPAL",2
49,"49170",99,68,68,1,0,"PREPAL",0
24,"24162",1753,1259,1245,12,14,"PREPAL",1
24,"24104",243,167,166,0,1,"PREPAL",1
49,"49260",693,480,473,3,7,"PREPAL",0
24,"24225",979,678,668,5,10,"PREPAL",1
24,"24012",278,182,180,0,2,"PREPAL",1
49,"49183",90,67,65,2,2,"PREPAL",0
37,"37254",174,140,135,0,5,"PREPAL",0
49,"49190",50,42,42,3,0,"PREPAL",0
49,"49048",113,88,88,0,0,"PREPAL",1
37,"37125",231,154,148,1,6,"PREPAL",0
49,"49244",46,23,23,0,0,"PREPAL",0
49,"49123",519,384,383,4,1,"PREPAL",0
24,"24158",296,197,192,0,5,"PREPAL",0
37,"37311",201,157,156,1,1,"PREPAL",1
24,"24029",686,430,428,6,2,"PREPAL",0
49,"49120",54,35,35,0,0,"PREPAL",0
49,"49191",265,192,188,2,4,"PREPAL",0
37,"37234",314,194,192,3,2,"PREPAL",0
24,"24108",348,247,246,4,1,"PREPAL",0
37,"37201",238,170,168,0,2,"PREPAL",0
24,"24050",105,77,77,2,0,"PREPAL",0
49,"49233",85,51,51,0,0,"PREPAL",0
37,"37167",174,147,144,2,3,"PREPAL",0
37,"37042",36,27,27,1,0,"PREPAL",0
49,"49132",310,220,215,2,5,"PREPAL",0
37,"37208",71,49,49,0,0,"PREPAL",0
49,"49035",220,180,180,4,0,"PREPAL",0
49,"49202",173,103,101,0,2,"PREPAL",0
49,"49102",182,130,130,2,0,"PREPAL",0
37,"37262",69,51,51,0,0,"PREPAL",0
49,"49059",84,61,58,0,3,"PREPAL",1
49,"49173",335,165,163,4,2,"PREPAL",0
24,"24161",294,208,204,3,4,"PREPAL",0
49,"49027",125,82,81,0,1,"PREPAL",1
37,"37280",70,47,46,0,1,"PREPAL",0
24,"24202",7504,4607,4538,51,69,"PREPAL",4
49,"49056",285,191,190,3,1,"PREPAL",0
24,"24215",149,116,115,0,1,"PREPAL",0
24,"24096",105,56,54,1,2,"PREPAL",0
49,"49231",288,208,203,0,5,"PREPAL",1
37,"37357",248,193,192,1,1,"PREPAL",0
49,"49248",171,128,128,1,0,"PREPAL",0
37,"37049",125,76,76,0,0,"PREPAL",0
37,"37359",165,105,103,0,2,"PREPAL",2
24,"24027",1214,841,828,6,13,"PREPAL",0
24,"24193",363,264,264,1,0,"PREPAL",2
37,"37381",138,98,93,0,5,"PREPAL",0
49,"49062",103,58,58,0,0,"PREPAL",0
49,"49028",108,90,89,1,1,"PREPAL",0
37,"37004",25,18,18,0,0,"PREPAL",0
37,"37180",68,45,44,1,1,"PREPAL",0
24,"24106",218,139,139,1,0,"PREPAL",0
37,"37305",219,177,175,2,2,"PREPAL",1
37,"37070",523,371,365,4,6,"PREPAL",1
37,"37114",74,58,55,1,3,"PREPAL",0
24,"24061",1753,1234,1223,10,11,"PREPAL",5
37,"37085",5060,3732,3689,52,43,"PREPAL",3
37,"37324",333,247,242,3,5,"PREPAL",0
37,"37011",100,78,78,3,0,"PREPAL",0
37,"37032",553,388,388,2,0,"PREPAL",0
49,"49156",218,149,144,0,5,"PREPAL",1
49,"49101",144,88,82,1,6,"PREPAL",0
37,"37022",242,191,190,0,1,"PREPAL",0
49,"49071",716,432,429,6,3,"PREPAL",2
24,"24129",114,79,78,2,1,"PREPAL",0
37,"37137",98,60,59,2,1,"PREPAL",0
24,"24030",4158,2746,2696,18,50,"PREPAL",1
49,"49181",333,197,195,2,2,"PREPAL",0
49,"49234",394,282,277,0,5,"PREPAL",0
37,"37214",120,70,68,2,2,"PREPAL",0
49,"49269",218,126,124,1,2,"PREPAL",0
49,"49177",255,145,144,1,1,"PREPAL",1
37,"37123",159,124,123,2,1,"PREPAL",1
37,"37195",39,31,31,0,0,"PREPAL",0
49,"49223",701,498,494,7,4,"PREPAL",1
24,"24191",106,70,69,2,1,"PREPAL",0
24,"24070",3886,2677,2625,18,52,"PREPAL",0
49,"49148",259,119,115,1,4,"PREPAL",0
24,"24047",708,462,459,1,3,"PREPAL",2
24,"24187",834,559,549,11,10,"PREPAL",2
24,"24007",735,500,496,8,4,"PREPAL",1
49,"49107",115,70,70,0,0,"PREPAL",0
37,"37231",236,185,183,5,2,"PREPAL",3
49,"49058",301,222,221,1,1,"PREPAL",0
49,"49090",190,135,134,3,1,"PREPAL",0
49,"49036",503,319,316,5,3,"PREPAL",0
24,"24036",252,146,146,1,0,"PREPAL",0
24,"24169",2777,1908,1880,10,28,"PREPAL",1
37,"37274",118296,84144,83280,880,864,"PREPAL",112
24,"24146",254,202,201,1,1,"PREPAL",0
37,"37249",37,28,28,0,0,"PREPAL",0
37,"37079",77,59,59,1,0,"PREPAL",1
49,"49255",387,304,298,3,6,"PREPAL",4
24,"24042",60,47,47,2,0,"PREPAL",0
37,"37149",60,50,50,0,0,"PREPAL",0
49,"49063",303,228,227,3,1,"PREPAL",1
37,"37325",88,63,63,0,0,"PREPAL",1
37,"37192",361,200,198,3,2,"PREPAL",2
37,"37349",100,61,58,0,3,"PREPAL",1
24,"24060",561,297,296,2,1,"PREPAL",2
37,"37129",248,181,181,1,0,"PREPAL",2
24,"24044",150,91,89,2,2,"PREPAL",0
37,"37150",34,31,31,0,0,"PREPAL",0
37,"37259",39,28,28,1,0,"PREPAL",0
24,"24066",439,274,273,3,1,"PREPAL",1
24,"24901",853,517,513,4,4,"PREPAL",1
49,"49193",428,261,253,3,8,"PREPAL",0
49,"49150",123,95,92,3,3,"PREPAL",0
37,"37033",94,67,67,0,0,"PREPAL",0
49,"49250",1191,844,824,8,20,"PREPAL",0
37,"37241",167,121,119,3,2,"PREPAL",0
37,"37169",177,122,122,0,0,"PREPAL",0
37,"37271",349,262,258,2,4,"PREPAL",0
37,"37040",376,291,288,0,3,"PREPAL",0
37,"37034",77,63,62,0,1,"PREPAL",0
49,"49044",78,56,53,0,3,"PREPAL",0
24,"24117",410,302,301,1,1,"PREPAL",0
37,"37035",162,115,115,1,0,"PREPAL",0
37,"37206",87,65,54,0,11,"PREPAL",1
24,"24230",403,268,265,3,3,"PREPAL",0
37,"37358",159,124,124,0,0,"PREPAL",0
37,"37350",403,281,274,1,7,"PREPAL",0
49,"49261",1504,1044,1026,7,18,"PREPAL",2
49,"49113",162,131,131,2,0,"PREPAL",0
49,"49011",214,147,146,5,1,"PREPAL",0
37,"37170",1361,909,884,9,25,"PREPAL",5
37,"37155",68,48,48,0,0,"PREPAL",0
37,"37171",396,272,270,2,2,"PREPAL",0
37,"37113",404,286,285,13,1,"PREPAL",0
37,"37031",329,241,238,3,3,"PREPAL",0
37,"37133",101,73,69,1,4,"PREPAL",0
24,"24058",189,115,114,1,1,"PREPAL",0
49,"49068",422,263,261,4,2,"PREPAL",0
17,"17217",350,287,284,0,3,"PSC-PSOE",10
25,"25206",247,188,188,2,0,"PSC-PSOE",3
25,"25067",702,500,494,8,6,"PSC-PSOE",55
25,"25122",1929,1408,1398,21,10,"PSC-PSOE",141
8,"8090",142,116,116,0,0,"PSC-PSOE",5
43,"43053",186,135,134,0,1,"PSC-PSOE",12
17,"17123",343,286,284,2,2,"PSC-PSOE",12
25,"25064",96,78,78,0,0,"PSC-PSOE",4
25,"25111",114,86,86,2,0,"PSC-PSOE",5
43,"43159",76,60,60,0,0,"PSC-PSOE",8
8,"8239",467,362,361,3,1,"PSC-PSOE",32
8,"8166",964,700,697,7,3,"PSC-PSOE",90
25,"25254",704,511,508,2,3,"PSC-PSOE",60
43,"43144",1245,975,966,1,9,"PSC-PSOE",112
8,"8261",2405,1726,1718,11,8,"PSC-PSOE",256
17,"17012",1175,845,842,4,3,"PSC-PSOE",94
25,"25149",1377,1034,1028,9,6,"PSC-PSOE",137
8,"8120",7129,5649,5621,51,28,"PSC-PSOE",325
8,"8282",6731,5333,5317,40,16,"PSC-PSOE",652
8,"8040",11116,7923,7891,49,32,"PSC-PSOE",1172
17,"17172",452,336,335,5,1,"PSC-PSOE",24
8,"8037",1947,1547,1543,11,4,"PSC-PSOE",82
8,"8047",3751,2600,2578,26,22,"PSC-PSOE",500
43,"43153",11197,7685,7649,53,36,"PSC-PSOE",1600
17,"17004",529,411,410,3,1,"PSC-PSOE",25
25,"25133",671,481,479,1,2,"PSC-PSOE",40
43,"43109",2706,1751,1738,17,13,"PSC-PSOE",329
43,"43118",422,338,338,0,0,"PSC-PSOE",32
17,"17049",3246,2527,2502,12,25,"PSC-PSOE",289
17,"17234",181,129,129,1,0,"PSC-PSOE",19
43,"43045",143,114,113,0,1,"PSC-PSOE",7
8,"8247",982,799,798,4,1,"PSC-PSOE",32
17,"17095",20044,12638,12576,88,62,"PSC-PSOE",3067
25,"25056",209,145,145,0,0,"PSC-PSOE",9
17,"17022",7043,4940,4903,34,37,"PSC-PSOE",694
8,"8054",9215,6994,6943,38,51,"PSC-PSOE",1372
17,"17106",142,114,114,0,0,"PSC-PSOE",8
17,"17111",984,728,728,7,0,"PSC-PSOE",47
25,"25035",364,257,256,0,1,"PSC-PSOE",25
8,"8182",2922,2041,2031,10,10,"PSC-PSOE",479
25,"25169",170,117,117,5,0,"PSC-PSOE",17
17,"17117",14497,9438,9382,66,56,"PSC-PSOE",1861
8,"8229",521,418,417,3,1,"PSC-PSOE",27
43,"43170",877,664,661,4,3,"PSC-PSOE",97
8,"8275",247,218,218,3,0,"PSC-PSOE",7
17,"17096",159,116,116,3,0,"PSC-PSOE",3
43,"43903",2332,1502,1487,18,15,"PSC-PSOE",184
8,"8083",1672,1433,1430,6,3,"PSC-PSOE",75
17,"17061",180,141,139,1,2,"PSC-PSOE",3
43,"43176",746,564,561,2,3,"PSC-PSOE",46
8,"8904",10516,7068,7025,54,43,"PSC-PSOE",2401
43,"43048",768,564,554,7,10,"PSC-PSOE",60
17,"17145",1410,1040,1032,6,8,"PSC-PSOE",96
17,"17013",2765,1999,1985,15,14,"PSC-PSOE",374
8,"8002",217,172,172,2,0,"PSC-PSOE",8
25,"25203",8809,5813,5770,40,43,"PSC-PSOE",1063
17,"17196",252,200,200,1,0,"PSC-PSOE",6
25,"25911",419,298,297,3,1,"PSC-PSOE",17
17,"17166",547,442,440,0,2,"PSC-PSOE",18
8,"8297",138,99,99,0,0,"PSC-PSOE",5
25,"25105",105,88,87,4,1,"PSC-PSOE",4
8,"8178",444,363,361,2,2,"PSC-PSOE",27
25,"25029",1590,1190,1185,4,5,"PSC-PSOE",119
17,"17066",27378,16755,16644,122,111,"PSC-PSOE",3125
25,"25225",531,395,393,0,2,"PSC-PSOE",18
8,"8175",3369,2388,2372,18,16,"PSC-PSOE",258
8,"8106",7500,5442,5410,43,32,"PSC-PSOE",900
25,"25138",558,427,424,2,3,"PSC-PSOE",41
17,"17005",457,322,320,3,2,"PSC-PSOE",47
17,"17093",913,637,634,5,3,"PSC-PSOE",43
8,"8072",10769,7632,7600,56,32,"PSC-PSOE",1177
43,"43141",109,85,84,0,1,"PSC-PSOE",16
25,"25078",995,746,743,7,3,"PSC-PSOE",45
8,"8027",724,584,582,1,2,"PSC-PSOE",73
17,"17029",207,154,154,1,0,"PSC-PSOE",11
8,"8032",2100,1472,1465,12,7,"PSC-PSOE",214
25,"25153",190,139,136,0,3,"PSC-PSOE",16
17,"17010",332,252,251,2,1,"PSC-PSOE",6
25,"25249",176,129,127,2,2,"PSC-PSOE",10
17,"17136",196,150,150,0,0,"PSC-PSOE",11
25,"25183",520,372,370,4,2,"PSC-PSOE",37
25,"25101",536,412,411,5,1,"PSC-PSOE",24
8,"8115",3826,2777,2770,31,7,"PSC-PSOE",611
8,"8270",19014,13635,13594,74,41,"PSC-PSOE",2480
8,"8171",2046,1520,1510,13,10,"PSC-PSOE",86
17,"17084",228,163,162,1,1,"PSC-PSOE",18
17,"17027",2857,2236,2229,9,7,"PSC-PSOE",240
43,"43128",910,665,658,6,7,"PSC-PSOE",117
25,"25180",227,158,155,1,3,"PSC-PSOE",13
8,"8154",697,541,539,3,2,"PSC-PSOE",62
25,"25088",96,73,73,0,0,"PSC-PSOE",2
8,"8123",19570,15378,15316,91,62,"PSC-PSOE",3077
25,"25017",228,175,174,0,1,"PSC-PSOE",14
8,"8022",12213,8594,8558,42,36,"PSC-PSOE",990
8,"8075",4144,2951,2943,20,8,"PSC-PSOE",493
8,"8011",1739,1360,1353,10,7,"PSC-PSOE",77
17,"17133",1262,976,964,7,12,"PSC-PSOE",63
43,"43167",391,307,307,2,0,"PSC-PSOE",22
25,"25131",394,281,279,3,2,"PSC-PSOE",40
43,"43018",384,297,297,2,0,"PSC-PSOE",22
25,"25245",427,312,308,4,4,"PSC-PSOE",77
8,"8307",49499,35471,35312,199,159,"PSC-PSOE",7835
25,"25211",680,470,470,3,0,"PSC-PSOE",46
43,"43064",2027,1456,1445,19,11,"PSC-PSOE",145
8,"8301",49348,36261,36045,292,216,"PSC-PSOE",11504
43,"43107",387,285,285,3,0,"PSC-PSOE",22
25,"25172",1762,1332,1323,8,9,"PSC-PSOE",126
25,"25024",352,248,247,0,1,"PSC-PSOE",24
17,"17032",1745,1139,1133,6,6,"PSC-PSOE",163
17,"17178",1065,774,771,9,3,"PSC-PSOE",83
43,"43004",6288,4314,4262,36,52,"PSC-PSOE",580
8,"8138",4461,3286,3259,27,27,"PSC-PSOE",366
17,"17151",179,131,130,0,1,"PSC-PSOE",8
25,"25124",160,102,101,1,1,"PSC-PSOE",3
8,"8070",269,215,211,1,4,"PSC-PSOE",12
43,"43024",1545,1019,1014,14,5,"PSC-PSOE",200
43,"43071",896,652,647,3,5,"PSC-PSOE",79
17,"17025",1182,943,938,5,5,"PSC-PSOE",77
43,"43032",462,354,350,2,4,"PSC-PSOE",60
17,"17153",189,150,149,1,1,"PSC-PSOE",2
25,"25050",3256,2260,2249,20,11,"PSC-PSOE",229
8,"8179",636,466,465,2,1,"PSC-PSOE",61
17,"17220",801,649,647,2,2,"PSC-PSOE",32
17,"17078",335,245,245,0,0,"PSC-PSOE",12
25,"25030",117,76,76,0,0,"PSC-PSOE",3
43,"43161",17103,11905,11838,82,67,"PSC-PSOE",1923
8,"8276",241,179,179,3,0,"PSC-PSOE",12
25,"25182",1043,763,760,8,3,"PSC-PSOE",131
8,"8091",5428,4048,4024,20,24,"PSC-PSOE",767
25,"25113",1114,873,863,3,10,"PSC-PSOE",98
25,"25158",1605,1193,1180,8,13,"PSC-PSOE",88
25,"25150",167,132,130,2,2,"PSC-PSOE",2
8,"8121",87515,62961,62574,429,387,"PSC-PSOE",14446
8,"8063",469,390,390,4,0,"PSC-PSOE",27
17,"17079",65572,47740,47502,279,238,"PSC-PSOE",7571
17,"17016",737,570,563,2,7,"PSC-PSOE",30
25,"25020",270,202,201,2,1,"PSC-PSOE",14
25,"25913",88,72,72,1,0,"PSC-PSOE",4
25,"25013",2099,1430,1414,13,16,"PSC-PSOE",342
25,"25006",319,229,229,2,0,"PSC-PSOE",45
17,"17037",112,86,86,1,0,"PSC-PSOE",0
25,"25049",156,110,109,1,1,"PSC-PSOE",13
43,"43132",375,295,291,1,4,"PSC-PSOE",20
8,"8064",1956,1439,1423,7,16,"PSC-PSOE",141
43,"43039",101,77,77,0,0,"PSC-PSOE",5
43,"43082",350,276,271,5,5,"PSC-PSOE",26
43,"43129",4607,3284,3261,21,23,"PSC-PSOE",401
8,"8236",1564,1145,1133,4,12,"PSC-PSOE",121
43,"43027",168,129,129,3,0,"PSC-PSOE",5
25,"25019",4606,2860,2829,19,31,"PSC-PSOE",479
8,"8226",929,748,747,10,1,"PSC-PSOE",51
8,"8109",207,176,174,0,2,"PSC-PSOE",4
8,"8080",40,27,27,3,0,"PSC-PSOE",4
25,"25905",366,281,276,4,5,"PSC-PSOE",26
17,"17193",4351,2945,2927,21,18,"PSC-PSOE",460
17,"17142",2713,2166,2159,18,7,"PSC-PSOE",255
17,"17103",5057,3196,3174,21,22,"PSC-PSOE",603
25,"25038",1478,1057,1048,10,9,"PSC-PSOE",99
8,"8211",33934,26136,26000,198,136,"PSC-PSOE",6896
8,"8199",648,509,508,3,1,"PSC-PSOE",61
8,"8234",3443,2561,2550,15,11,"PSC-PSOE",295
8,"8067",5746,4299,4270,24,29,"PSC-PSOE",522
25,"25219",146,111,111,1,0,"PSC-PSOE",1
8,"8201",455,319,318,12,1,"PSC-PSOE",22
17,"17109",704,542,539,2,3,"PSC-PSOE",28
43,"43028",2770,1784,1770,7,14,"PSC-PSOE",368
17,"17190",834,624,619,1,5,"PSC-PSOE",38
43,"43150",1233,954,941,6,13,"PSC-PSOE",62
8,"8159",14343,10656,10603,87,53,"PSC-PSOE",2436
43,"43079",364,290,289,2,1,"PSC-PSOE",26
25,"25217",10891,7651,7610,63,41,"PSC-PSOE",960
43,"43020",2291,1712,1688,19,24,"PSC-PSOE",402
8,"8202",12943,9408,9358,58,50,"PSC-PSOE",1655
8,"8162",2118,1581,1576,13,5,"PSC-PSOE",230
8,"8267",6789,4975,4935,41,40,"PSC-PSOE",974
17,"17134",220,175,174,1,1,"PSC-PSOE",12
25,"25157",159,127,126,1,1,"PSC-PSOE",13
8,"8905",2329,1872,1863,7,9,"PSC-PSOE",259
17,"17056",1780,1379,1374,13,5,"PSC-PSOE",78
25,"25087",54,45,45,0,0,"PSC-PSOE",6
8,"8151",450,351,346,5,5,"PSC-PSOE",23
43,"43089",279,201,201,1,0,"PSC-PSOE",38
25,"25209",1586,1115,1102,6,13,"PSC-PSOE",101
43,"43152",435,348,342,2,6,"PSC-PSOE",56
43,"43095",2583,1864,1854,12,10,"PSC-PSOE",265
17,"17187",625,496,492,3,4,"PSC-PSOE",58
17,"17902",1294,992,990,9,2,"PSC-PSOE",92
17,"17105",248,187,186,2,1,"PSC-PSOE",10
8,"8193",988,739,737,10,2,"PSC-PSOE",59
8,"8277",168,148,146,1,2,"PSC-PSOE",6
43,"43098",362,274,274,1,0,"PSC-PSOE",11
8,"8222",1821,1439,1424,7,15,"PSC-PSOE",156
17,"17057",968,770,769,7,1,"PSC-PSOE",67
17,"17216",158,122,121,0,1,"PSC-PSOE",6
17,"17139",1407,1128,1119,8,9,"PSC-PSOE",106
8,"8010",4224,3109,3090,22,19,"PSC-PSOE",369
43,"43019",1332,911,904,8,7,"PSC-PSOE",124
43,"43164",310,235,231,3,4,"PSC-PSOE",69
17,"17028",297,216,214,2,2,"PSC-PSOE",8
17,"17137",3486,2812,2808,15,4,"PSC-PSOE",214
8,"8060",139,110,108,1,2,"PSC-PSOE",8
25,"25238",212,161,160,0,1,"PSC-PSOE",9
25,"25179",169,132,132,0,0,"PSC-PSOE",7
8,"8068",6863,5064,5041,40,23,"PSC-PSOE",919
25,"25099",1285,908,904,6,4,"PSC-PSOE",67
17,"17024",281,203,201,4,2,"PSC-PSOE",26
17,"17052",135,93,92,0,1,"PSC-PSOE",4
25,"25125",383,265,265,3,0,"PSC-PSOE",12
25,"25901",289,214,211,4,3,"PSC-PSOE",18
8,"8217",25466,19864,19773,129,91,"PSC-PSOE",5723
17,"17162",153,106,105,1,1,"PSC-PSOE",3
8,"8093",25,22,22,0,0,"PSC-PSOE",0
17,"17197",128,97,97,0,0,"PSC-PSOE",10
17,"17107",267,207,205,2,2,"PSC-PSOE",5
43,"43057",38,32,32,1,0,"PSC-PSOE",2
25,"25079",276,202,202,0,0,"PSC-PSOE",7
43,"43143",50,40,39,0,1,"PSC-PSOE",6
25,"25012",2349,1563,1556,17,7,"PSC-PSOE",230
8,"8300",5927,4609,4589,41,20,"PSC-PSOE",728
43,"43093",3863,2728,2716,22,12,"PSC-PSOE",469
25,"25127",217,145,145,1,0,"PSC-PSOE",5
43,"43001",708,510,507,0,3,"PSC-PSOE",54
25,"25126",281,211,210,1,1,"PSC-PSOE",24
43,"43115",128,106,106,0,0,"PSC-PSOE",10
43,"43092",7308,4703,4679,33,24,"PSC-PSOE",916
43,"43172",334,248,243,4,5,"PSC-PSOE",28
8,"8087",144,120,120,0,0,"PSC-PSOE",8
17,"17165",645,502,502,2,0,"PSC-PSOE",51
25,"25191",321,227,222,2,5,"PSC-PSOE",17
17,"17147",7916,5672,5641,41,31,"PSC-PSOE",890
17,"17228",285,218,217,0,1,"PSC-PSOE",21
8,"8052",140,102,102,1,0,"PSC-PSOE",6
8,"8136",11692,8527,8456,98,71,"PSC-PSOE",2271
25,"25223",890,673,666,7,7,"PSC-PSOE",46
17,"17118",12934,8723,8665,38,58,"PSC-PSOE",1508
8,"8241",70,52,52,0,0,"PSC-PSOE",4
43,"43124",468,343,339,3,4,"PSC-PSOE",54
43,"43101",146,112,112,2,0,"PSC-PSOE",7
43,"43016",3470,2547,2508,15,39,"PSC-PSOE",708
17,"17903",883,681,676,3,5,"PSC-PSOE",60
8,"8141",4578,3369,3357,28,12,"PSC-PSOE",466
17,"17068",253,191,191,0,0,"PSC-PSOE",20
43,"43901",8796,5431,5390,41,41,"PSC-PSOE",848
25,"25170",262,210,210,1,0,"PSC-PSOE",21
43,"43177",276,229,227,2,2,"PSC-PSOE",33
25,"25212",219,176,176,1,0,"PSC-PSOE",20
17,"17163",2868,2281,2268,13,13,"PSC-PSOE",160
8,"8278",4925,3820,3804,22,16,"PSC-PSOE",216
25,"25045",57,26,26,2,0,"PSC-PSOE",6
8,"8134",848,618,609,4,9,"PSC-PSOE",62
43,"43026",756,576,574,1,2,"PSC-PSOE",43
8,"8250",7235,4917,4876,41,41,"PSC-PSOE",1489
25,"25190",262,202,202,2,0,"PSC-PSOE",36
8,"8293",227,177,177,0,0,"PSC-PSOE",16
8,"8057",61,47,47,1,0,"PSC-PSOE",0
8,"8110",13671,9362,9311,60,51,"PSC-PSOE",2130
17,"17112",198,148,147,3,1,"PSC-PSOE",12
8,"8158",3094,2261,2251,11,10,"PSC-PSOE",427
17,"17030",654,460,459,1,1,"PSC-PSOE",44
8,"8044",4156,2991,2976,16,15,"PSC-PSOE",615
25,"25251",708,526,524,1,2,"PSC-PSOE",52
25,"25002",465,324,323,4,1,"PSC-PSOE",32
8,"8216",25,17,17,0,0,"PSC-PSOE",4
43,"43135",339,255,255,0,0,"PSC-PSOE",17
25,"25186",207,162,161,0,1,"PSC-PSOE",10
17,"17009",4068,3061,3050,16,11,"PSC-PSOE",240
43,"43175",534,363,359,5,4,"PSC-PSOE",32
43,"43036",869,565,557,7,8,"PSC-PSOE",96
17,"17199",6984,4919,4894,39,25,"PSC-PSOE",569
17,"17001",575,428,426,4,2,"PSC-PSOE",34
25,"25196",108,75,75,1,0,"PSC-PSOE",10
8,"8296",1869,1412,1408,10,4,"PSC-PSOE",170
8,"8004",208,177,177,1,0,"PSC-PSOE",6
8,"8181",8133,5949,5924,31,25,"PSC-PSOE",1020
8,"8221",12793,10123,10079,73,44,"PSC-PSOE",1726
8,"8205",61957,49325,49196,441,129,"PSC-PSOE",6626
25,"25175",173,119,119,2,0,"PSC-PSOE",7
43,"43106",784,605,598,3,7,"PSC-PSOE",65
8,"8029",3586,2868,2862,20,6,"PSC-PSOE",318
17,"17075",340,257,256,2,1,"PSC-PSOE",10
8,"8244",6099,4733,4706,39,27,"PSC-PSOE",823
8,"8155",7056,5050,5011,38,39,"PSC-PSOE",987
8,"8206",744,604,599,5,5,"PSC-PSOE",68
8,"8266",43422,32827,32696,241,131,"PSC-PSOE",8248
8,"8292",1074,796,790,2,6,"PSC-PSOE",138
25,"25155",616,446,443,2,3,"PSC-PSOE",53
17,"17161",1023,844,843,5,1,"PSC-PSOE",44
17,"17091",391,296,290,3,6,"PSC-PSOE",12
43,"43125",884,658,645,12,13,"PSC-PSOE",157
8,"8045",65,44,43,0,1,"PSC-PSOE",0
43,"43108",1787,1293,1282,6,11,"PSC-PSOE",159
8,"8252",24885,18507,18383,162,124,"PSC-PSOE",5013
17,"17215",2286,1855,1844,13,11,"PSC-PSOE",222
17,"17206",158,111,109,0,2,"PSC-PSOE",7
8,"8098",2438,1781,1778,21,3,"PSC-PSOE",225
8,"8191",5302,3872,3860,21,12,"PSC-PSOE",757
25,"25173",1646,1180,1169,6,11,"PSC-PSOE",317
25,"25129",161,113,112,0,1,"PSC-PSOE",4
17,"17204",609,429,428,6,1,"PSC-PSOE",55
43,"43178",1435,1071,1066,2,5,"PSC-PSOE",167
17,"17181",3458,2454,2443,18,11,"PSC-PSOE",374
43,"43042",2215,1723,1710,18,13,"PSC-PSOE",165
25,"25240",1366,1030,1021,4,9,"PSC-PSOE",117
43,"43155",22586,15295,15204,120,91,"PSC-PSOE",2624
43,"43158",74,52,50,0,2,"PSC-PSOE",2
43,"43056",803,566,558,6,8,"PSC-PSOE",34
8,"8077",34690,25896,25767,164,129,"PSC-PSOE",7541
8,"8208",5793,4267,4244,21,23,"PSC-PSOE",821
8,"8228",292,234,233,0,1,"PSC-PSOE",21
25,"25910",91,63,63,0,0,"PSC-PSOE",4
25,"25009",596,448,442,1,6,"PSC-PSOE",57
43,"43080",230,192,192,2,0,"PSC-PSOE",21
8,"8248",5687,4187,4165,21,22,"PSC-PSOE",592
8,"8082",1164,796,780,5,16,"PSC-PSOE",137
25,"25121",632,380,374,3,6,"PSC-PSOE",125
8,"8274",4640,3385,3363,24,22,"PSC-PSOE",897
8,"8289",4473,3379,3371,25,8,"PSC-PSOE",435
8,"8125",25583,18334,18225,122,109,"PSC-PSOE",4697
17,"17157",122,104,103,0,1,"PSC-PSOE",15
8,"8062",1009,778,776,9,2,"PSC-PSOE",95
43,"43022",1436,1028,1024,13,4,"PSC-PSOE",182
8,"8232",1773,1368,1362,9,6,"PSC-PSOE",175
8,"8169",48478,35283,35114,278,169,"PSC-PSOE",10589
8,"8145",2712,2060,2049,8,11,"PSC-PSOE",315
43,"43126",1230,937,933,3,4,"PSC-PSOE",128
8,"8131",745,552,550,3,2,"PSC-PSOE",43
17,"17208",978,723,719,6,4,"PSC-PSOE",38
43,"43002",1890,1233,1210,12,23,"PSC-PSOE",320
17,"17182",269,195,195,0,0,"PSC-PSOE",53
8,"8012",1726,1323,1309,17,14,"PSC-PSOE",95
17,"17200",624,469,467,6,2,"PSC-PSOE",39
8,"8033",13262,9887,9833,64,54,"PSC-PSOE",1645
8,"8026",195,148,146,0,2,"PSC-PSOE",4
17,"17173",181,143,143,1,0,"PSC-PSOE",15
25,"25033",1120,838,831,5,7,"PSC-PSOE",68
8,"8153",573,457,452,3,5,"PSC-PSOE",26
17,"17076",119,95,94,2,1,"PSC-PSOE",7
8,"8224",885,653,652,6,1,"PSC-PSOE",78
25,"25205",563,412,407,3,5,"PSC-PSOE",46
17,"17210",572,414,411,2,3,"PSC-PSOE",19
25,"25094",138,96,93,2,3,"PSC-PSOE",4
17,"17086",1769,1116,1109,6,7,"PSC-PSOE",229
8,"8130",110,81,81,2,0,"PSC-PSOE",2
43,"43169",445,388,388,3,0,"PSC-PSOE",30
8,"8294",2093,1546,1534,11,12,"PSC-PSOE",133
8,"8071",249,209,208,0,1,"PSC-PSOE",22
8,"8264",4608,3459,3444,30,15,"PSC-PSOE",415
17,"17048",6284,4077,4048,34,29,"PSC-PSOE",797
17,"17033",5647,3879,3852,25,27,"PSC-PSOE",495
25,"25904",160,134,133,2,1,"PSC-PSOE",13
8,"8195",75,62,62,0,0,"PSC-PSOE",2
8,"8198",4679,3491,3469,12,22,"PSC-PSOE",372
8,"8251",5130,3719,3698,20,21,"PSC-PSOE",872
25,"25027",978,695,690,3,5,"PSC-PSOE",31
25,"25120",92888,62740,62389,450,351,"PSC-PSOE",12031
25,"25037",361,270,269,4,1,"PSC-PSOE",17
17,"17175",559,348,343,5,5,"PSC-PSOE",78
17,"17169",2511,1901,1890,8,11,"PSC-PSOE",270
17,"17073",1939,1649,1640,11,9,"PSC-PSOE",117
25,"25228",3143,2261,2250,18,11,"PSC-PSOE",277
17,"17090",539,440,440,2,0,"PSC-PSOE",26
17,"17007",1763,1367,1359,9,8,"PSC-PSOE",88
8,"8177",36,27,27,1,0,"PSC-PSOE",2
17,"17202",3848,2632,2615,16,17,"PSC-PSOE",476
25,"25220",991,768,762,1,6,"PSC-PSOE",41
43,"43130",169,131,130,2,1,"PSC-PSOE",9
25,"25902",536,406,403,1,3,"PSC-PSOE",27
25,"25201",110,81,81,0,0,"PSC-PSOE",8
8,"8295",11290,8091,8054,72,37,"PSC-PSOE",1806
8,"8227",2420,1775,1769,11,6,"PSC-PSOE",203
17,"17203",165,126,126,0,0,"PSC-PSOE",8
17,"17099",78,55,55,0,0,"PSC-PSOE",6
17,"17008",3605,2595,2577,8,18,"PSC-PSOE",242
17,"17209",615,472,471,5,1,"PSC-PSOE",55
8,"8176",158,119,119,0,0,"PSC-PSOE",6
8,"8100",2083,1707,1699,13,8,"PSC-PSOE",92
17,"17144",211,162,159,3,3,"PSC-PSOE",14
25,"25142",359,283,283,2,0,"PSC-PSOE",20
17,"17116",351,261,261,2,0,"PSC-PSOE",9
43,"43021",349,245,243,2,2,"PSC-PSOE",28
17,"17071",1134,943,940,1,3,"PSC-PSOE",51
8,"8233",1872,1428,1420,15,8,"PSC-PSOE",114
43,"43076",454,336,335,1,1,"PSC-PSOE",37
25,"25118",326,223,218,0,5,"PSC-PSOE",15
25,"25234",4139,2786,2772,13,14,"PSC-PSOE",469
8,"8009",9531,7200,7171,47,29,"PSC-PSOE",947
17,"17121",225,166,163,2,3,"PSC-PSOE",10
17,"17174",164,130,130,4,0,"PSC-PSOE",2
25,"25130",181,130,128,0,2,"PSC-PSOE",11
43,"43149",690,512,509,3,3,"PSC-PSOE",137
25,"25222",69,58,58,0,0,"PSC-PSOE",3
8,"8271",66,48,47,2,1,"PSC-PSOE",1
8,"8049",1309,910,903,3,7,"PSC-PSOE",35
8,"8089",34190,24548,24404,194,144,"PSC-PSOE",6859
8,"8059",340,255,250,1,5,"PSC-PSOE",19
25,"25086",525,410,407,3,3,"PSC-PSOE",34
8,"8135",6770,5187,5158,42,29,"PSC-PSOE",1496
43,"43173",98,70,68,0,2,"PSC-PSOE",0
17,"17233",2347,1853,1840,11,13,"PSC-PSOE",127
43,"43074",1818,1341,1336,2,5,"PSC-PSOE",171
25,"25139",477,348,346,3,2,"PSC-PSOE",30
25,"25075",132,101,101,0,0,"PSC-PSOE",9
8,"8128",579,428,423,4,5,"PSC-PSOE",37
43,"43010",334,262,262,2,0,"PSC-PSOE",28
8,"8305",27661,20346,20221,118,125,"PSC-PSOE",3628
8,"8144",722,551,545,3,6,"PSC-PSOE",41
43,"43037",18216,11749,11672,70,77,"PSC-PSOE",2690
17,"17114",23268,16423,16333,111,90,"PSC-PSOE",2207
17,"17205",209,167,166,0,1,"PSC-PSOE",8
8,"8113",52589,36864,36690,244,174,"PSC-PSOE",5833
43,"43133",5627,3794,3773,31,21,"PSC-PSOE",600
8,"8260",18515,13563,13487,84,76,"PSC-PSOE",3266
17,"17102",556,398,396,1,2,"PSC-PSOE",38
25,"25047",956,745,736,14,9,"PSC-PSOE",64
8,"8116",557,449,449,1,0,"PSC-PSOE",29
43,"43075",86,65,63,0,2,"PSC-PSOE",9
17,"17176",128,111,111,0,0,"PSC-PSOE",18
8,"8019",1122912,824423,821037,5287,3386,"PSC-PSOE",163788
8,"8156",11254,8440,8411,58,29,"PSC-PSOE",1455
43,"43103",908,705,701,9,4,"PSC-PSOE",117
43,"43050",2695,1742,1730,10,12,"PSC-PSOE",416
8,"8200",62225,45235,44991,306,244,"PSC-PSOE",13517
25,"25021",2513,1668,1662,17,6,"PSC-PSOE",273
25,"25224",122,94,94,0,0,"PSC-PSOE",2
43,"43112",245,179,179,3,0,"PSC-PSOE",15
25,"25123",189,135,133,0,2,"PSC-PSOE",13
8,"8003",7213,5425,5409,41,16,"PSC-PSOE",672
8,"8081",349,274,270,0,4,"PSC-PSOE",9
8,"8122",1733,1179,1175,4,4,"PSC-PSOE",165
25,"25058",4345,3058,3045,13,13,"PSC-PSOE",262
25,"25215",339,249,249,5,0,"PSC-PSOE",33
17,"17036",2639,1944,1934,21,10,"PSC-PSOE",232
8,"8105",9741,6946,6896,62,50,"PSC-PSOE",2465
25,"25231",483,387,385,0,2,"PSC-PSOE",17
8,"8001",9097,6860,6818,39,42,"PSC-PSOE",1880
43,"43052",927,680,674,7,6,"PSC-PSOE",99
8,"8008",175,136,136,2,0,"PSC-PSOE",6
17,"17132",1344,1019,1009,12,10,"PSC-PSOE",88
25,"25096",885,597,591,2,6,"PSC-PSOE",42
17,"17034",7289,4880,4862,23,18,"PSC-PSOE",765
17,"17031",178,117,117,0,0,"PSC-PSOE",8
17,"17023",27314,18677,18546,117,131,"PSC-PSOE",4570
8,"8254",1766,1433,1427,16,6,"PSC-PSOE",40
25,"25903",226,169,169,1,0,"PSC-PSOE",9
8,"8161",11826,8001,7951,58,50,"PSC-PSOE",1564
25,"25070",817,619,617,11,2,"PSC-PSOE",51
25,"25194",410,292,289,3,3,"PSC-PSOE",19
8,"8303",257,207,205,1,2,"PSC-PSOE",11
8,"8209",6925,4976,4948,39,28,"PSC-PSOE",868
43,"43065",379,281,277,4,4,"PSC-PSOE",19
43,"43162",4436,3191,3163,24,28,"PSC-PSOE",616
8,"8139",172,148,147,2,1,"PSC-PSOE",11
43,"43005",3677,2505,2493,17,12,"PSC-PSOE",415
17,"17014",66,51,49,0,2,"PSC-PSOE",5
8,"8268",975,729,723,6,6,"PSC-PSOE",116
25,"25181",172,137,137,1,0,"PSC-PSOE",11
8,"8061",1628,1154,1151,15,3,"PSC-PSOE",203
43,"43038",22070,15127,15018,113,109,"PSC-PSOE",2824
8,"8024",357,282,282,2,0,"PSC-PSOE",32
43,"43030",483,356,351,2,5,"PSC-PSOE",54
25,"25216",244,186,186,0,0,"PSC-PSOE",7
43,"43007",631,479,474,1,5,"PSC-PSOE",40
8,"8148",2344,1655,1646,13,9,"PSC-PSOE",333
43,"43006",676,462,462,3,0,"PSC-PSOE",62
17,"17039",1726,1306,1297,7,9,"PSC-PSOE",159
8,"8286",2943,2051,2042,12,9,"PSC-PSOE",450
25,"25207",6443,4525,4492,31,33,"PSC-PSOE",515
17,"17077",565,395,394,2,1,"PSC-PSOE",49
25,"25145",75,59,59,0,0,"PSC-PSOE",4
8,"8013",1287,982,972,6,10,"PSC-PSOE",99
25,"25071",41,31,30,0,1,"PSC-PSOE",0
25,"25247",142,89,89,2,0,"PSC-PSOE",23
8,"8023",7029,5027,5000,39,27,"PSC-PSOE",673
25,"25226",236,156,155,0,1,"PSC-PSOE",9
43,"43119",849,591,588,8,3,"PSC-PSOE",81
8,"8036",163,122,122,0,0,"PSC-PSOE",6
43,"43097",407,331,328,4,3,"PSC-PSOE",37
43,"43035",233,182,182,5,0,"PSC-PSOE",22
17,"17185",2260,1657,1652,8,5,"PSC-PSOE",184
8,"8302",9359,6483,6430,78,53,"PSC-PSOE",1972
17,"17119",71,53,52,3,1,"PSC-PSOE",5
43,"43156",3956,2812,2784,22,28,"PSC-PSOE",497
17,"17130",325,270,270,1,0,"PSC-PSOE",9
8,"8280",93,76,75,1,1,"PSC-PSOE",2
17,"17148",1550,1121,1114,15,7,"PSC-PSOE",154
8,"8103",652,476,474,1,2,"PSC-PSOE",37
17,"17226",884,603,600,4,3,"PSC-PSOE",85
8,"8073",62934,45699,45407,281,292,"PSC-PSOE",15326
25,"25044",178,144,142,0,2,"PSC-PSOE",9
8,"8007",6795,5099,5081,29,18,"PSC-PSOE",493
17,"17149",370,302,300,1,2,"PSC-PSOE",9
25,"25156",765,571,567,3,4,"PSC-PSOE",56
17,"17100",193,147,141,0,6,"PSC-PSOE",10
25,"25134",605,457,456,5,1,"PSC-PSOE",43
43,"43014",14386,9542,9464,74,78,"PSC-PSOE",1486
8,"8255",133,100,100,2,0,"PSC-PSOE",0
8,"8157",8574,6514,6472,47,42,"PSC-PSOE",1536
17,"17011",645,518,514,10,4,"PSC-PSOE",30
43,"43091",125,90,90,1,0,"PSC-PSOE",4
17,"17125",136,100,100,3,0,"PSC-PSOE",0
25,"25032",65,53,52,0,1,"PSC-PSOE",3
43,"43073",80,67,65,0,2,"PSC-PSOE",2
17,"17225",205,150,150,1,0,"PSC-PSOE",8
8,"8014",2013,1526,1521,4,5,"PSC-PSOE",148
43,"43070",243,194,193,0,1,"PSC-PSOE",26
43,"43058",95,78,78,0,0,"PSC-PSOE",7
8,"8021",60,44,44,1,0,"PSC-PSOE",4
8,"8165",1680,1177,1171,7,6,"PSC-PSOE",230
8,"8150",258,207,207,1,0,"PSC-PSOE",9
17,"17089",5749,3973,3949,17,24,"PSC-PSOE",512
8,"8140",4816,3541,3520,25,21,"PSC-PSOE",583
8,"8142",136,117,117,3,0,"PSC-PSOE",15
25,"25244",374,275,270,1,5,"PSC-PSOE",28
43,"43131",4827,3134,3116,32,18,"PSC-PSOE",748
25,"25912",841,620,619,5,1,"PSC-PSOE",110
43,"43140",2433,1685,1674,11,11,"PSC-PSOE",407
17,"17150",1444,1177,1163,13,14,"PSC-PSOE",116
43,"43114",370,281,278,1,3,"PSC-PSOE",19
43,"43077",453,306,304,1,2,"PSC-PSOE",107
17,"17230",504,383,382,3,1,"PSC-PSOE",49
25,"25092",125,93,92,0,1,"PSC-PSOE",5
43,"43062",269,229,226,5,3,"PSC-PSOE",30
43,"43145",4209,3193,3170,17,23,"PSC-PSOE",560
8,"8085",986,769,767,6,2,"PSC-PSOE",63
25,"25059",800,546,534,5,12,"PSC-PSOE",158
8,"8042",2390,1772,1764,12,8,"PSC-PSOE",292
8,"8076",16526,11988,11893,90,95,"PSC-PSOE",2641
17,"17180",8508,5977,5953,38,24,"PSC-PSOE",664
25,"25909",138,99,98,2,1,"PSC-PSOE",7
43,"43907",4386,3083,3067,24,16,"PSC-PSOE",1009
43,"43054",2807,1972,1957,14,15,"PSC-PSOE",199
25,"25908",217,136,136,0,0,"PSC-PSOE",20
17,"17085",293,239,238,0,1,"PSC-PSOE",8
17,"17002",578,477,474,2,3,"PSC-PSOE",33
8,"8273",2390,1871,1855,14,16,"PSC-PSOE",138
25,"25053",1100,819,811,7,8,"PSC-PSOE",92
8,"8119",6897,5096,5052,31,44,"PSC-PSOE",966
8,"8018",2540,1862,1855,7,7,"PSC-PSOE",346
25,"25233",289,219,218,6,1,"PSC-PSOE",27
8,"8269",2729,2114,2105,9,9,"PSC-PSOE",118
43,"43138",2636,1761,1745,11,16,"PSC-PSOE",244
25,"25042",204,149,149,5,0,"PSC-PSOE",14
17,"17087",219,179,177,0,2,"PSC-PSOE",8
43,"43146",40,32,32,0,0,"PSC-PSOE",3
25,"25132",141,106,105,0,1,"PSC-PSOE",17
43,"43906",2113,1490,1480,12,10,"PSC-PSOE",178
8,"8084",1172,902,894,9,8,"PSC-PSOE",93
8,"8152",117,94,94,0,0,"PSC-PSOE",6
17,"17171",177,138,137,0,1,"PSC-PSOE",13
8,"8304",822,655,655,5,0,"PSC-PSOE",65
43,"43044",3962,2751,2719,33,32,"PSC-PSOE",569
8,"8263",21208,15014,14890,111,124,"PSC-PSOE",3863
25,"25250",327,269,265,1,4,"PSC-PSOE",25
17,"17088",599,467,465,3,2,"PSC-PSOE",31
17,"17186",3834,2980,2954,17,26,"PSC-PSOE",530
25,"25218",88,76,75,2,1,"PSC-PSOE",3
8,"8035",13006,8957,8918,50,39,"PSC-PSOE",1431
43,"43111",2129,1412,1401,8,11,"PSC-PSOE",273
17,"17080",144,113,113,1,0,"PSC-PSOE",14
25,"25136",95,74,74,2,0,"PSC-PSOE",1
43,"43033",766,555,555,4,0,"PSC-PSOE",66
43,"43127",775,607,606,3,1,"PSC-PSOE",46
8,"8034",820,644,640,0,4,"PSC-PSOE",28
25,"25128",125,85,85,0,0,"PSC-PSOE",14
17,"17110",1332,990,981,3,9,"PSC-PSOE",189
25,"25164",353,259,255,0,4,"PSC-PSOE",16
8,"8249",274,238,237,0,1,"PSC-PSOE",15
43,"43104",1767,1285,1271,4,14,"PSC-PSOE",135
8,"8111",216,195,194,2,1,"PSC-PSOE",7
43,"43066",158,108,108,1,0,"PSC-PSOE",21
8,"8146",1384,1030,1027,8,3,"PSC-PSOE",206
8,"8078",216,154,154,2,0,"PSC-PSOE",3
25,"25022",105,80,79,0,1,"PSC-PSOE",4
8,"8240",9469,7351,7327,39,24,"PSC-PSOE",1320
17,"17115",276,208,208,4,0,"PSC-PSOE",14
17,"17143",145,104,104,0,0,"PSC-PSOE",6
17,"17198",437,307,306,0,1,"PSC-PSOE",35
25,"25010",194,138,136,0,2,"PSC-PSOE",5
25,"25140",779,540,539,2,1,"PSC-PSOE",58
8,"8168",388,280,279,3,1,"PSC-PSOE",21
8,"8231",21269,14655,14573,111,82,"PSC-PSOE",3443
17,"17003",103,85,85,0,0,"PSC-PSOE",0
8,"8133",123,96,94,5,2,"PSC-PSOE",7
25,"25248",870,676,675,5,1,"PSC-PSOE",40
25,"25014",246,184,178,0,6,"PSC-PSOE",8
17,"17189",1481,1228,1223,5,5,"PSC-PSOE",83
43,"43137",1890,1373,1353,8,20,"PSC-PSOE",236
17,"17146",3150,2243,2224,8,19,"PSC-PSOE",364
25,"25072",5881,4059,4031,30,28,"PSC-PSOE",545
25,"25152",148,106,106,0,0,"PSC-PSOE",9
8,"8223",1897,1345,1341,10,4,"PSC-PSOE",147
43,"43166",1646,1183,1176,4,7,"PSC-PSOE",181
8,"8281",4858,3783,3762,19,21,"PSC-PSOE",432
8,"8043",3414,2429,2422,15,7,"PSC-PSOE",519
17,"17232",146,111,111,0,0,"PSC-PSOE",8
25,"25115",803,601,593,4,8,"PSC-PSOE",55
17,"17051",202,161,160,0,1,"PSC-PSOE",8
43,"43041",216,156,156,2,0,"PSC-PSOE",28
17,"17227",147,104,104,0,0,"PSC-PSOE",7
43,"43163",26162,17276,17128,98,148,"PSC-PSOE",3999
8,"8256",693,542,542,3,0,"PSC-PSOE",57
8,"8188",115,89,89,0,0,"PSC-PSOE",3
25,"25041",525,375,370,4,5,"PSC-PSOE",39
8,"8108",5181,3880,3861,30,19,"PSC-PSOE",744
17,"17040",551,440,439,5,1,"PSC-PSOE",18
8,"8088",12347,9316,9270,75,46,"PSC-PSOE",1216
17,"17026",549,421,415,3,6,"PSC-PSOE",24
25,"25015",336,234,233,3,1,"PSC-PSOE",13
17,"17188",171,134,134,1,0,"PSC-PSOE",4
43,"43086",5252,3811,3790,28,21,"PSC-PSOE",515
8,"8028",1125,744,743,7,1,"PSC-PSOE",126
8,"8015",156540,109145,108440,957,705,"PSC-PSOE",27749
8,"8204",3141,2395,2383,16,12,"PSC-PSOE",468
17,"17035",544,447,447,2,0,"PSC-PSOE",19
8,"8005",6425,4830,4816,28,14,"PSC-PSOE",481
43,"43049",727,557,555,3,2,"PSC-PSOE",42
17,"17120",823,560,558,5,2,"PSC-PSOE",66
43,"43096",97,76,76,0,0,"PSC-PSOE",5
43,"43117",147,119,119,0,0,"PSC-PSOE",14
8,"8137",272,208,207,2,1,"PSC-PSOE",18
25,"25151",731,555,549,1,6,"PSC-PSOE",38
25,"25135",997,675,671,3,4,"PSC-PSOE",69
25,"25069",426,296,294,0,2,"PSC-PSOE",13
25,"25043",800,584,581,2,3,"PSC-PSOE",39
25,"25031",57,32,32,0,0,"PSC-PSOE",4
43,"43015",115,92,91,1,1,"PSC-PSOE",2
17,"17044",6938,5245,5212,33,33,"PSC-PSOE",606
25,"25055",163,114,114,0,0,"PSC-PSOE",10
25,"25008",1081,803,799,4,4,"PSC-PSOE",69
25,"25166",170,131,130,2,1,"PSC-PSOE",3
8,"8006",11774,8375,8329,53,46,"PSC-PSOE",1143
25,"25039",259,197,196,7,1,"PSC-PSOE",22
8,"8170",442,322,320,0,2,"PSC-PSOE",29
43,"43040",325,268,267,1,1,"PSC-PSOE",11
8,"8102",28940,21108,21014,157,94,"PSC-PSOE",3359
17,"17138",836,591,584,7,7,"PSC-PSOE",139
17,"17062",5982,4025,4001,19,24,"PSC-PSOE",563
8,"8025",1573,1170,1160,9,10,"PSC-PSOE",133
43,"43142",1069,783,774,3,9,"PSC-PSOE",76
17,"17218",576,456,451,3,5,"PSC-PSOE",16
25,"25051",1522,1066,1059,6,7,"PSC-PSOE",111
8,"8246",1692,1345,1340,7,5,"PSC-PSOE",62
43,"43085",237,190,185,1,5,"PSC-PSOE",22
43,"43059",250,193,192,1,1,"PSC-PSOE",16
8,"8095",66,49,49,0,0,"PSC-PSOE",3
25,"25060",71,42,42,0,0,"PSC-PSOE",0
17,"17060",409,300,298,1,2,"PSC-PSOE",26
43,"43121",593,404,403,1,1,"PSC-PSOE",30
25,"25167",223,165,164,3,1,"PSC-PSOE",5
17,"17211",837,677,674,6,3,"PSC-PSOE",39
8,"8097",1103,845,840,4,5,"PSC-PSOE",84
25,"25034",2271,1616,1600,12,16,"PSC-PSOE",87
8,"8048",580,427,426,1,1,"PSC-PSOE",31
17,"17047",5016,3087,3068,22,19,"PSC-PSOE",450
8,"8017",2808,2033,2016,16,17,"PSC-PSOE",297
43,"43017",112,94,94,1,0,"PSC-PSOE",6
43,"43151",107,88,88,0,0,"PSC-PSOE",5
8,"8245",77841,53719,53443,430,276,"PSC-PSOE",18906
43,"43905",15100,9689,9630,43,59,"PSC-PSOE",2175
25,"25141",154,105,104,3,1,"PSC-PSOE",2
8,"8069",3323,2555,2540,21,15,"PSC-PSOE",295
43,"43047",4234,2590,2564,19,26,"PSC-PSOE",730
25,"25104",120,88,88,0,0,"PSC-PSOE",7
8,"8117",2489,1954,1941,21,13,"PSC-PSOE",221
8,"8272",164,128,128,1,0,"PSC-PSOE",4
8,"8114",18838,13519,13442,81,77,"PSC-PSOE",3521
17,"17058",176,128,128,0,0,"PSC-PSOE",3
8,"8253",132,103,102,0,1,"PSC-PSOE",1
25,"25089",93,70,68,1,2,"PSC-PSOE",5
17,"17019",1780,1403,1393,5,10,"PSC-PSOE",143
17,"17160",14756,9892,9852,58,40,"PSC-PSOE",2137
8,"8094",1588,1258,1252,7,6,"PSC-PSOE",165
25,"25221",115,82,81,1,1,"PSC-PSOE",7
43,"43069",183,148,147,2,1,"PSC-PSOE",18
17,"17015",12829,9612,9580,51,32,"PSC-PSOE",770
43,"43023",211,171,169,2,2,"PSC-PSOE",28
25,"25232",1357,1012,1007,6,5,"PSC-PSOE",152
8,"8092",3713,2758,2745,9,13,"PSC-PSOE",334
25,"25102",647,484,482,5,2,"PSC-PSOE",66
8,"8065",1183,920,913,8,7,"PSC-PSOE",83
43,"43110",247,178,178,2,0,"PSC-PSOE",37
8,"8257",103,82,82,0,0,"PSC-PSOE",7
8,"8129",486,399,398,0,1,"PSC-PSOE",18
8,"8039",413,322,321,1,1,"PSC-PSOE",22
25,"25003",3717,2577,2561,15,16,"PSC-PSOE",264
43,"43068",484,322,317,2,5,"PSC-PSOE",68
25,"25082",292,197,197,2,0,"PSC-PSOE",15
43,"43904",2864,1881,1851,20,30,"PSC-PSOE",358
43,"43122",112,91,91,1,0,"PSC-PSOE",10
8,"8299",380,301,300,4,1,"PSC-PSOE",24
8,"8901",240,200,195,2,5,"PSC-PSOE",9
17,"17207",2420,1920,1901,9,19,"PSC-PSOE",81
17,"17129",143,108,108,2,0,"PSC-PSOE",11
8,"8041",10698,7324,7258,57,66,"PSC-PSOE",2277
8,"8185",197,162,162,1,0,"PSC-PSOE",8
43,"43154",126,104,104,0,0,"PSC-PSOE",4
8,"8147",17389,12679,12601,102,78,"PSC-PSOE",2583
8,"8086",14137,9971,9912,77,59,"PSC-PSOE",2108
17,"17224",299,226,222,2,4,"PSC-PSOE",14
8,"8283",6165,4546,4524,33,22,"PSC-PSOE",503
8,"8238",14946,11911,11873,85,38,"PSC-PSOE",1707
8,"8184",55053,38519,38323,298,196,"PSC-PSOE",9732
43,"43081",629,500,499,2,1,"PSC-PSOE",51
8,"8902",3941,2974,2962,16,12,"PSC-PSOE",452
17,"17221",4138,2999,2988,23,11,"PSC-PSOE",498
43,"43051",9194,6133,6048,44,85,"PSC-PSOE",1648
25,"25076",131,91,91,0,0,"PSC-PSOE",6
25,"25227",656,476,476,2,0,"PSC-PSOE",31
25,"25239",582,330,330,3,0,"PSC-PSOE",45
25,"25161",339,221,221,0,0,"PSC-PSOE",20
43,"43055",1970,1548,1535,12,13,"PSC-PSOE",215
17,"17168",373,309,308,3,1,"PSC-PSOE",18
8,"8194",25680,16465,16376,131,89,"PSC-PSOE",4605
43,"43102",458,331,324,2,7,"PSC-PSOE",78
8,"8225",94,83,82,1,1,"PSC-PSOE",2
17,"17070",110,87,87,0,0,"PSC-PSOE",4
17,"17101",566,389,382,1,7,"PSC-PSOE",61
25,"25200",318,245,245,0,0,"PSC-PSOE",22
8,"8079",333,260,258,2,2,"PSC-PSOE",20
25,"25110",2745,1943,1927,13,16,"PSC-PSOE",285
17,"17159",622,459,459,1,0,"PSC-PSOE",23
25,"25097",89,71,71,2,0,"PSC-PSOE",2
17,"17128",321,239,238,1,1,"PSC-PSOE",19
8,"8066",1466,1109,1104,7,5,"PSC-PSOE",176
17,"17042",410,299,297,5,2,"PSC-PSOE",22
25,"25137",8684,5802,5757,48,45,"PSC-PSOE",911
43,"43100",3557,2666,2649,22,17,"PSC-PSOE",499
25,"25011",5271,3529,3505,21,24,"PSC-PSOE",391
25,"25007",1378,1010,999,12,11,"PSC-PSOE",125
43,"43046",88,69,68,1,1,"PSC-PSOE",8
25,"25062",691,498,491,4,7,"PSC-PSOE",36
8,"8180",27198,19822,19704,160,118,"PSC-PSOE",5392
25,"25146",223,158,155,3,3,"PSC-PSOE",7
8,"8235",3875,3004,2996,19,8,"PSC-PSOE",240
17,"17223",808,566,563,1,3,"PSC-PSOE",84
43,"43088",2013,1429,1420,11,9,"PSC-PSOE",117
25,"25081",281,195,193,3,2,"PSC-PSOE",20
8,"8197",7986,5829,5805,37,24,"PSC-PSOE",719
17,"17041",217,150,146,1,4,"PSC-PSOE",17
17,"17064",324,249,247,2,2,"PSC-PSOE",37
25,"25177",356,252,250,1,2,"PSC-PSOE",24
25,"25192",727,527,524,4,3,"PSC-PSOE",55
25,"25077",435,312,312,1,0,"PSC-PSOE",34
25,"25046",410,331,326,4,5,"PSC-PSOE",27
8,"8259",6979,5362,5341,27,21,"PSC-PSOE",777
17,"17191",163,140,140,1,0,"PSC-PSOE",6
43,"43013",4406,3004,2975,19,29,"PSC-PSOE",358
8,"8285",10349,7630,7599,48,31,"PSC-PSOE",981
17,"17214",714,516,511,6,5,"PSC-PSOE",29
8,"8132",356,265,265,1,0,"PSC-PSOE",25
25,"25255",390,301,301,0,0,"PSC-PSOE",27
8,"8243",154,125,125,2,0,"PSC-PSOE",2
17,"17901",987,733,725,5,8,"PSC-PSOE",66
43,"43031",1447,1085,1072,13,13,"PSC-PSOE",102
8,"8056",42897,30873,30757,259,116,"PSC-PSOE",7067
25,"25253",147,118,117,0,1,"PSC-PSOE",7
17,"17213",5567,3654,3630,19,24,"PSC-PSOE",507
25,"25052",1541,1183,1176,7,7,"PSC-PSOE",98
8,"8291",4972,3531,3519,23,12,"PSC-PSOE",572
8,"8284",12597,8244,8183,60,61,"PSC-PSOE",1545
8,"8107",11965,8604,8554,67,50,"PSC-PSOE",1815
8,"8215",2617,1954,1946,22,8,"PSC-PSOE",203
43,"43063",544,376,374,2,2,"PSC-PSOE",63
25,"25243",3729,2370,2349,33,21,"PSC-PSOE",643
43,"43099",284,214,214,4,0,"PSC-PSOE",20
8,"8210",4640,3226,3200,24,26,"PSC-PSOE",383
17,"17141",6019,3855,3833,43,22,"PSC-PSOE",601
8,"8242",223,159,159,0,0,"PSC-PSOE",9
25,"25230",1541,1105,1099,9,6,"PSC-PSOE",161
8,"8031",2339,1760,1750,15,10,"PSC-PSOE",259
43,"43003",349,257,255,3,2,"PSC-PSOE",38
8,"8020",5243,4117,4100,29,17,"PSC-PSOE",581
43,"43113",387,305,303,1,2,"PSC-PSOE",22
43,"43165",571,469,467,2,2,"PSC-PSOE",54
17,"17043",165,133,133,0,0,"PSC-PSOE",8
25,"25109",211,155,154,1,1,"PSC-PSOE",6
43,"43136",10489,7029,6996,47,33,"PSC-PSOE",1024
8,"8190",255,184,182,1,2,"PSC-PSOE",20
8,"8101",175048,121359,120620,830,739,"PSC-PSOE",40739
25,"25168",496,399,399,6,0,"PSC-PSOE",23
17,"17183",253,197,197,2,0,"PSC-PSOE",12
43,"43148",91182,65076,64756,441,320,"PSC-PSOE",14363
17,"17021",119,89,87,0,2,"PSC-PSOE",12
8,"8053",2896,1939,1929,13,10,"PSC-PSOE",356
43,"43012",3700,2882,2858,20,24,"PSC-PSOE",474
8,"8203",2466,1678,1675,7,3,"PSC-PSOE",212
43,"43067",526,426,424,3,2,"PSC-PSOE",41
25,"25004",582,437,432,3,5,"PSC-PSOE",40
8,"8055",542,426,424,3,2,"PSC-PSOE",38
17,"17124",1593,1163,1160,8,3,"PSC-PSOE",171
43,"43083",146,110,109,0,1,"PSC-PSOE",8
25,"25005",269,193,193,3,0,"PSC-PSOE",22
8,"8212",491,393,386,6,7,"PSC-PSOE",22
43,"43072",90,69,67,1,2,"PSC-PSOE",3
8,"8046",13541,10510,10455,73,55,"PSC-PSOE",1582
43,"43120",421,256,254,1,2,"PSC-PSOE",46
43,"43078",835,610,605,7,5,"PSC-PSOE",99
8,"8213",6600,4925,4906,30,19,"PSC-PSOE",696
8,"8118",17634,13450,13402,80,48,"PSC-PSOE",1928
8,"8189",119,96,96,1,0,"PSC-PSOE",1
17,"17126",316,269,269,1,0,"PSC-PSOE",7
43,"43084",514,388,383,2,5,"PSC-PSOE",48
8,"8258",815,636,632,5,4,"PSC-PSOE",22
8,"8230",7648,5797,5774,40,23,"PSC-PSOE",985
8,"8096",43926,32120,31960,217,160,"PSC-PSOE",7310
43,"43168",83,55,55,1,0,"PSC-PSOE",4
17,"17192",143,107,104,0,3,"PSC-PSOE",9
25,"25906",205,133,131,2,2,"PSC-PSOE",16
17,"17069",359,270,267,2,3,"PSC-PSOE",15
8,"8058",1808,1280,1262,6,18,"PSC-PSOE",289
17,"17074",536,403,401,1,2,"PSC-PSOE",50
25,"25023",4560,3350,3334,24,16,"PSC-PSOE",432
17,"17046",709,537,531,2,6,"PSC-PSOE",49
8,"8143",2727,1989,1977,19,12,"PSC-PSOE",430
8,"8124",37157,27139,26994,179,145,"PSC-PSOE",7713
8,"8112",12926,9268,9230,61,38,"PSC-PSOE",1428
25,"25189",2181,1468,1461,11,7,"PSC-PSOE",192
8,"8218",8091,5899,5869,50,30,"PSC-PSOE",1311
25,"25063",84,52,51,0,1,"PSC-PSOE",16
8,"8308",139,109,109,1,0,"PSC-PSOE",7
25,"25165",271,210,208,0,2,"PSC-PSOE",18
17,"17155",14957,9519,9410,71,109,"PSC-PSOE",2062
25,"25103",133,88,87,0,1,"PSC-PSOE",5
25,"25193",768,567,563,4,4,"PSC-PSOE",44
43,"43134",281,217,215,5,2,"PSC-PSOE",35
43,"43147",528,425,420,3,5,"PSC-PSOE",19
25,"25119",2258,1701,1686,11,15,"PSC-PSOE",164
25,"25202",108,72,72,2,0,"PSC-PSOE",8
25,"25176",307,241,238,3,3,"PSC-PSOE",5
17,"17098",308,232,230,4,2,"PSC-PSOE",27
17,"17164",3918,2856,2838,17,18,"PSC-PSOE",330
25,"25036",180,124,124,1,0,"PSC-PSOE",26
43,"43094",2143,1558,1541,6,17,"PSC-PSOE",236
43,"43043",3317,2457,2445,12,12,"PSC-PSOE",459
8,"8149",980,702,694,6,8,"PSC-PSOE",40
8,"8288",1696,1103,1096,9,7,"PSC-PSOE",240
25,"25057",208,151,149,4,2,"PSC-PSOE",24
25,"25100",184,137,136,1,1,"PSC-PSOE",13
8,"8016",1803,1371,1363,11,8,"PSC-PSOE",212
25,"25068",515,359,358,0,1,"PSC-PSOE",28
8,"8287",1067,853,844,4,9,"PSC-PSOE",59
25,"25040",10651,7041,6987,57,54,"PSC-PSOE",1186
43,"43171",14849,10140,10081,76,59,"PSC-PSOE",2568
8,"8174",388,322,318,2,4,"PSC-PSOE",26
8,"8306",535,368,368,5,0,"PSC-PSOE",32
25,"25208",337,242,241,2,1,"PSC-PSOE",15
43,"43025",591,448,443,4,5,"PSC-PSOE",120
25,"25143",82,63,62,0,1,"PSC-PSOE",12
17,"17154",101,76,76,0,0,"PSC-PSOE",12
8,"8214",7007,5390,5371,25,19,"PSC-PSOE",647
25,"25085",141,109,108,2,1,"PSC-PSOE",7
17,"17055",142,124,124,0,0,"PSC-PSOE",10
43,"43160",1324,967,956,6,11,"PSC-PSOE",208
25,"25163",230,162,161,0,1,"PSC-PSOE",3
25,"25242",688,494,488,5,6,"PSC-PSOE",47
17,"17038",377,303,301,0,2,"PSC-PSOE",15
8,"8164",936,750,747,6,3,"PSC-PSOE",62
25,"25025",1362,909,898,15,11,"PSC-PSOE",199
17,"17081",252,186,185,2,1,"PSC-PSOE",9
43,"43009",1384,966,959,5,7,"PSC-PSOE",120
8,"8050",139,118,115,4,3,"PSC-PSOE",4
17,"17050",664,554,550,10,4,"PSC-PSOE",35
17,"17158",565,296,295,2,1,"PSC-PSOE",30
25,"25148",224,158,158,0,0,"PSC-PSOE",5
25,"25016",2083,1404,1399,3,5,"PSC-PSOE",183
17,"17094",1058,757,747,3,10,"PSC-PSOE",55
25,"25061",80,51,51,0,0,"PSC-PSOE",2
8,"8279",156327,112605,112030,952,575,"PSC-PSOE",25285
25,"25154",117,86,85,0,1,"PSC-PSOE",3
17,"17092",3462,2414,2389,14,25,"PSC-PSOE",417
8,"8160",317,234,234,0,0,"PSC-PSOE",13
17,"17177",562,426,423,1,3,"PSC-PSOE",32
25,"25185",680,452,451,0,1,"PSC-PSOE",45
8,"8187",153822,113081,112470,758,611,"PSC-PSOE",26927
17,"17212",145,111,109,0,2,"PSC-PSOE",6
43,"43174",144,118,114,0,4,"PSC-PSOE",5
17,"17170",173,140,140,2,0,"PSC-PSOE",2
17,"17067",704,551,549,6,2,"PSC-PSOE",49
25,"25098",227,160,158,1,2,"PSC-PSOE",21
43,"43123",71435,49166,48873,318,293,"PSC-PSOE",10111
25,"25174",390,312,312,1,0,"PSC-PSOE",31
25,"25252",553,380,379,2,1,"PSC-PSOE",24
8,"8038",1541,1129,1120,6,9,"PSC-PSOE",109
17,"17006",1178,826,818,9,8,"PSC-PSOE",70
17,"17184",1261,1016,1010,7,6,"PSC-PSOE",68
17,"17201",137,103,103,0,0,"PSC-PSOE",7
25,"25197",140,109,109,0,0,"PSC-PSOE",4
8,"8051",18570,14112,14054,86,58,"PSC-PSOE",2604
43,"43060",2672,2032,2015,7,17,"PSC-PSOE",254
8,"8290",1549,1254,1248,6,6,"PSC-PSOE",133
8,"8219",15755,12235,12206,72,29,"PSC-PSOE",1659
25,"25907",500,366,364,5,2,"PSC-PSOE",22
8,"8237",1644,1263,1254,9,9,"PSC-PSOE",124
17,"17063",179,153,149,0,4,"PSC-PSOE",6
8,"8127",2254,1548,1544,10,4,"PSC-PSOE",283
8,"8163",19672,13421,13364,70,57,"PSC-PSOE",3336
43,"43157",339,279,279,1,0,"PSC-PSOE",24
8,"8074",11190,7698,7651,51,47,"PSC-PSOE",1727
17,"17083",2971,2164,2154,13,10,"PSC-PSOE",374
17,"17195",338,274,272,1,2,"PSC-PSOE",19
25,"25074",179,155,151,2,4,"PSC-PSOE",15
17,"17020",3677,2851,2835,14,16,"PSC-PSOE",236
25,"25114",96,83,82,1,1,"PSC-PSOE",1
8,"8903",201,181,181,1,0,"PSC-PSOE",6
43,"43902",2751,1794,1776,21,18,"PSC-PSOE",472
8,"8207",2026,1667,1659,12,8,"PSC-PSOE",72
17,"17065",321,264,263,3,1,"PSC-PSOE",12
43,"43029",312,241,240,1,1,"PSC-PSOE",16
17,"17135",393,307,303,0,4,"PSC-PSOE",33
17,"17222",104,87,87,1,0,"PSC-PSOE",4
43,"43116",465,356,352,0,4,"PSC-PSOE",34
25,"25171",2117,1539,1534,5,5,"PSC-PSOE",281
8,"8099",753,529,529,4,0,"PSC-PSOE",89
17,"17082",435,308,307,1,1,"PSC-PSOE",18
17,"17152",11065,6959,6927,68,32,"PSC-PSOE",1432
8,"8262",6945,4649,4599,38,50,"PSC-PSOE",885
43,"43139",2007,1432,1419,9,13,"PSC-PSOE",119
8,"8183",4573,3406,3398,14,8,"PSC-PSOE",350
17,"17018",494,377,372,4,5,"PSC-PSOE",28
25,"25048",1641,1207,1194,13,13,"PSC-PSOE",145
8,"8220",2411,2010,2001,8,9,"PSC-PSOE",70
25,"25112",269,205,200,2,5,"PSC-PSOE",16
8,"8298",27148,19655,19568,102,87,"PSC-PSOE",2194
43,"43105",155,126,123,4,3,"PSC-PSOE",6
17,"17097",200,170,167,2,3,"PSC-PSOE",4
17,"17194",73,56,56,0,0,"PSC-PSOE",2
43,"43011",1086,862,860,5,2,"PSC-PSOE",77
8,"8104",657,496,493,4,3,"PSC-PSOE",33
25,"25073",559,377,377,2,0,"PSC-PSOE",21
8,"8265",1597,1262,1260,4,2,"PSC-PSOE",90
25,"25210",1073,791,780,3,11,"PSC-PSOE",111
43,"43061",40,27,27,3,0,"PSC-PSOE",0
8,"8192",5701,4366,4349,15,17,"PSC-PSOE",508
8,"8196",19542,14264,14185,123,79,"PSC-PSOE",4385
17,"17054",342,250,250,2,0,"PSC-PSOE",32
43,"43034",465,365,365,5,0,"PSC-PSOE",58
43,"43008",305,171,171,7,0,"PSC-PSOE",22
25,"25204",1187,858,849,13,9,"PSC-PSOE",81
8,"8030",5208,4045,4033,25,12,"PSC-PSOE",419
17,"17167",2585,2015,1998,11,17,"PSC-PSOE",212
25,"25093",629,455,443,5,12,"PSC-PSOE",42
25,"25001",143,102,102,1,0,"PSC-PSOE",9
17,"17140",635,506,505,2,1,"PSC-PSOE",58
8,"8172",20543,15191,15140,85,51,"PSC-PSOE",2759
8,"8126",8906,6673,6646,41,27,"PSC-PSOE",1194
43,"43090",1199,689,686,5,3,"PSC-PSOE",166
8,"8167",6056,4520,4500,38,20,"PSC-PSOE",1173
32,"32034",1062,763,753,6,10,"PSdeG-PSOE",254
32,"32051",1369,1062,1058,13,4,"PSdeG-PSOE",241
15,"15901",3334,1948,1928,27,20,"PSdeG-PSOE",610
36,"36040",2505,1597,1563,15,34,"PSdeG-PSOE",490
15,"15053",7469,4622,4579,44,43,"PSdeG-PSOE",1419
15,"15001",4697,3069,3022,45,47,"PSdeG-PSOE",817
32,"32075",4362,3117,3077,30,40,"PSdeG-PSOE",874
15,"15052",4070,2512,2488,18,24,"PSdeG-PSOE",873
32,"32022",1238,840,835,10,5,"PSdeG-PSOE",295
15,"15043",4944,3184,3117,27,67,"PSdeG-PSOE",948
36,"36039",15609,10562,10341,102,221,"PSdeG-PSOE",3053
36,"36060",30431,19909,19673,206,236,"PSdeG-PSOE",6600
15,"15018",1087,680,670,13,10,"PSdeG-PSOE",269
36,"36033",12305,8759,8597,67,162,"PSdeG-PSOE",2840
15,"15090",1115,711,701,19,10,"PSdeG-PSOE",130
15,"15004",4924,3333,3292,38,41,"PSdeG-PSOE",1080
32,"32038",387,253,251,4,2,"PSdeG-PSOE",101
32,"32023",1130,787,782,2,5,"PSdeG-PSOE",298
32,"32059",1686,1099,1082,20,17,"PSdeG-PSOE",342
36,"36036",2546,1763,1742,14,21,"PSdeG-PSOE",516
15,"15029",5354,3082,3050,46,32,"PSdeG-PSOE",925
36,"36025",2127,1235,1221,5,14,"PSdeG-PSOE",242
15,"15073",21725,13008,12820,126,188,"PSdeG-PSOE",3074
36,"36026",19890,13041,12891,169,150,"PSdeG-PSOE",3453
15,"15015",2877,1845,1821,26,24,"PSdeG-PSOE",515
15,"15064",2103,1458,1447,20,11,"PSdeG-PSOE",491
32,"32010",364,271,267,2,4,"PSdeG-PSOE",81
15,"15023",6277,4021,3968,34,53,"PSdeG-PSOE",1427
15,"15059",10229,6900,6734,85,166,"PSdeG-PSOE",1809
15,"15033",2421,1673,1655,6,18,"PSdeG-PSOE",474
36,"36056",4932,3368,3310,24,58,"PSdeG-PSOE",791
15,"15084",3039,2002,1981,12,21,"PSdeG-PSOE",408
36,"36018",3033,1951,1926,9,25,"PSdeG-PSOE",636
36,"36032",3527,2407,2369,24,38,"PSdeG-PSOE",675
15,"15021",5254,3473,3422,58,51,"PSdeG-PSOE",1103
36,"36003",10023,6877,6789,66,88,"PSdeG-PSOE",1951
36,"36004",10109,6611,6502,79,109,"PSdeG-PSOE",1696
32,"32054",86117,56997,56376,581,621,"PSdeG-PSOE",21129
36,"36043",4696,3038,3003,21,35,"PSdeG-PSOE",855
32,"32062",784,557,550,1,7,"PSdeG-PSOE",136
15,"15024",4314,2859,2790,44,69,"PSdeG-PSOE",933
15,"15066",3995,2746,2695,29,51,"PSdeG-PSOE",621
36,"36010",2825,1983,1947,19,36,"PSdeG-PSOE",678
32,"32049",683,375,372,3,3,"PSdeG-PSOE",128
36,"36019",1462,916,908,8,8,"PSdeG-PSOE",442
32,"32050",2254,1630,1612,15,18,"PSdeG-PSOE",413
32,"32009",10558,6621,6549,50,72,"PSdeG-PSOE",2350
36,"36055",13585,9177,8986,115,191,"PSdeG-PSOE",2662
32,"32017",1193,735,724,3,11,"PSdeG-PSOE",189
32,"32018",1181,883,871,5,12,"PSdeG-PSOE",463
15,"15074",3902,2629,2589,23,40,"PSdeG-PSOE",605
32,"32030",945,642,641,8,1,"PSdeG-PSOE",356
15,"15014",3836,2191,2158,27,33,"PSdeG-PSOE",512
36,"36022",9046,5834,5720,37,114,"PSdeG-PSOE",1937
15,"15039",1224,802,785,9,17,"PSdeG-PSOE",204
15,"15086",2760,1829,1810,26,19,"PSdeG-PSOE",426
15,"15080",1637,1009,992,11,17,"PSdeG-PSOE",332
15,"15062",5597,3406,3360,16,46,"PSdeG-PSOE",812
15,"15072",9434,6304,6228,48,76,"PSdeG-PSOE",1783
32,"32046",1089,679,670,4,9,"PSdeG-PSOE",241
15,"15058",28761,20250,20098,261,152,"PSdeG-PSOE",5959
15,"15048",5087,3426,3383,40,43,"PSdeG-PSOE",1036
15,"15044",1194,806,788,7,18,"PSdeG-PSOE",224
15,"15067",7933,5329,5282,43,47,"PSdeG-PSOE",1552
15,"15007",3164,2081,2060,24,21,"PSdeG-PSOE",707
32,"32007",1413,873,862,2,11,"PSdeG-PSOE",262
32,"32019",11469,7336,7225,98,111,"PSdeG-PSOE",2179
15,"15030",199701,137611,136590,1540,1021,"PSdeG-PSOE",43374
15,"15035",11189,7256,7165,104,91,"PSdeG-PSOE",2320
32,"32031",997,684,680,5,4,"PSdeG-PSOE",159
36,"36053",5783,3955,3899,39,56,"PSdeG-PSOE",923
32,"32037",679,454,446,6,8,"PSdeG-PSOE",91
32,"32004",1608,835,824,5,11,"PSdeG-PSOE",91
32,"32090",734,448,441,2,7,"PSdeG-PSOE",129
15,"15042",2928,1879,1853,11,26,"PSdeG-PSOE",473
36,"36038",66807,46235,45781,493,454,"PSdeG-PSOE",14440
36,"36008",21845,14553,14373,138,180,"PSdeG-PSOE",3808
32,"32029",441,286,283,2,3,"PSdeG-PSOE",66
15,"15019",25981,15866,15672,207,194,"PSdeG-PSOE",4723
36,"36052",7266,4772,4685,43,87,"PSdeG-PSOE",1407
32,"32066",547,396,396,0,0,"PSdeG-PSOE",63
32,"32071",1351,821,814,6,7,"PSdeG-PSOE",310
15,"15082",15446,10821,10687,130,134,"PSdeG-PSOE",2845
36,"36031",563,426,420,7,6,"PSdeG-PSOE",95
15,"15087",5710,3436,3392,31,44,"PSdeG-PSOE",1087
32,"32001",5100,3377,3333,32,44,"PSdeG-PSOE",756
15,"15092",6220,3810,3756,30,54,"PSdeG-PSOE",1433
15,"15079",1437,887,868,8,19,"PSdeG-PSOE",232
15,"15075",12871,8751,8637,129,114,"PSdeG-PSOE",2491
32,"32065",633,422,419,8,3,"PSdeG-PSOE",160
15,"15017",19866,13497,13344,195,153,"PSdeG-PSOE",4279
36,"36035",14615,10011,9880,103,131,"PSdeG-PSOE",3230
15,"15060",5871,4044,3978,58,66,"PSdeG-PSOE",1135
15,"15022",5580,3508,3472,47,36,"PSdeG-PSOE",1007
15,"15076",2490,1539,1517,25,22,"PSdeG-PSOE",380
32,"32042",1487,1010,1001,12,9,"PSdeG-PSOE",256
36,"36007",1610,1047,1016,5,31,"PSdeG-PSOE",326
32,"32076",1935,1320,1306,15,14,"PSdeG-PSOE",320
15,"15012",3603,2484,2422,20,62,"PSdeG-PSOE",611
15,"15054",31805,19579,19321,335,258,"PSdeG-PSOE",5892
15,"15061",5149,3221,3168,44,53,"PSdeG-PSOE",886
15,"15028",1392,944,936,4,8,"PSdeG-PSOE",314
32,"32080",284,209,209,1,0,"PSdeG-PSOE",45
32,"32045",2346,1604,1579,20,25,"PSdeG-PSOE",572
36,"36021",12180,8188,8058,115,130,"PSdeG-PSOE",2521
15,"15046",6157,3965,3865,23,100,"PSdeG-PSOE",989
32,"32091",1695,1163,1156,2,7,"PSdeG-PSOE",433
32,"32087",1669,1158,1136,14,22,"PSdeG-PSOE",321
32,"32083",805,498,494,3,4,"PSdeG-PSOE",135
15,"15011",15501,9988,9846,78,142,"PSdeG-PSOE",2746
32,"32061",1078,777,770,5,7,"PSdeG-PSOE",251
15,"15031",23868,16113,15954,207,159,"PSdeG-PSOE",5685
36,"36902",5028,3453,3396,19,57,"PSdeG-PSOE",1105
32,"32014",1028,719,708,6,11,"PSdeG-PSOE",174
15,"15069",6604,4587,4520,55,67,"PSdeG-PSOE",1409
32,"32081",2057,1466,1445,17,21,"PSdeG-PSOE",500
32,"32036",1242,856,838,14,18,"PSdeG-PSOE",170
36,"36009",4401,2712,2649,33,63,"PSdeG-PSOE",806
15,"15051",4545,2978,2945,47,33,"PSdeG-PSOE",975
15,"15036",56053,36487,36175,501,312,"PSdeG-PSOE",11287
15,"15081",976,713,695,4,18,"PSdeG-PSOE",101
32,"32069",4223,3064,3023,31,41,"PSdeG-PSOE",1095
36,"36047",2248,1379,1363,11,16,"PSdeG-PSOE",436
32,"32013",1985,1242,1230,16,12,"PSdeG-PSOE",278
32,"32086",2531,1348,1332,11,16,"PSdeG-PSOE",418
32,"32063",1795,1135,1119,16,16,"PSdeG-PSOE",473
15,"15027",1563,1159,1140,23,19,"PSdeG-PSOE",317
15,"15025",986,529,517,6,12,"PSdeG-PSOE",168
36,"36041",13691,9022,8916,85,106,"PSdeG-PSOE",2421
32,"32041",752,462,458,4,4,"PSdeG-PSOE",130
36,"36045",24459,16966,16735,124,231,"PSdeG-PSOE",5887
36,"36006",11502,8057,7927,53,130,"PSdeG-PSOE",2034
15,"15013",6324,4132,4083,35,49,"PSdeG-PSOE",1127
32,"32070",495,247,238,4,9,"PSdeG-PSOE",84
36,"36029",16126,10936,10771,96,165,"PSdeG-PSOE",3012
32,"32026",2655,1762,1731,17,31,"PSdeG-PSOE",701
32,"32067",1189,696,692,4,4,"PSdeG-PSOE",169
15,"15050",1732,931,917,15,14,"PSdeG-PSOE",319
32,"32024",4817,3064,3014,34,50,"PSdeG-PSOE",950
32,"32040",1400,1001,990,10,11,"PSdeG-PSOE",248
15,"15009",10605,7245,7133,101,112,"PSdeG-PSOE",2313
32,"32077",1104,703,700,9,3,"PSdeG-PSOE",252
15,"15002",24040,16302,16117,183,185,"PSdeG-PSOE",4553
15,"15065",7134,4869,4785,53,84,"PSdeG-PSOE",1334
32,"32048",846,460,458,1,2,"PSdeG-PSOE",182
15,"15077",8103,4893,4818,61,75,"PSdeG-PSOE",1192
36,"36016",1069,639,633,5,6,"PSdeG-PSOE",109
15,"15055",4446,2829,2762,50,67,"PSdeG-PSOE",922
15,"15008",5646,3859,3836,52,23,"PSdeG-PSOE",1095
32,"32060",753,520,515,5,5,"PSdeG-PSOE",224
32,"32092",491,280,275,0,5,"PSdeG-PSOE",75
32,"32073",1273,863,857,6,6,"PSdeG-PSOE",294
32,"32002",2028,1349,1340,4,9,"PSdeG-PSOE",534
32,"32043",2497,1607,1582,14,25,"PSdeG-PSOE",488
32,"32008",8647,5570,5495,56,75,"PSdeG-PSOE",1834
36,"36034",3299,2155,2132,15,23,"PSdeG-PSOE",619
15,"15089",4299,2924,2887,41,37,"PSdeG-PSOE",764
15,"15038",2126,1312,1296,12,16,"PSdeG-PSOE",388
36,"36042",18125,11975,11775,126,200,"PSdeG-PSOE",3515
15,"15010",1805,1047,1031,19,16,"PSdeG-PSOE",304
32,"32053",1362,1001,989,10,12,"PSdeG-PSOE",212
15,"15045",3610,2057,2044,15,13,"PSdeG-PSOE",475
32,"32078",1099,715,707,4,8,"PSdeG-PSOE",173
15,"15032",3430,2243,2197,12,46,"PSdeG-PSOE",523
15,"15071",7780,4937,4848,34,89,"PSdeG-PSOE",1352
15,"15085",3176,2073,2047,29,26,"PSdeG-PSOE",515
36,"36051",14358,9408,9255,86,153,"PSdeG-PSOE",2591
36,"36005",8105,5258,5152,54,106,"PSdeG-PSOE",1745
32,"32003",863,632,619,3,13,"PSdeG-PSOE",182
36,"36050",7645,5137,5049,48,88,"PSdeG-PSOE",1734
32,"32072",3664,2387,2355,24,32,"PSdeG-PSOE",867
32,"32064",453,304,302,0,2,"PSdeG-PSOE",71
36,"36015",4079,2653,2606,29,47,"PSdeG-PSOE",956
15,"15049",1068,752,747,7,5,"PSdeG-PSOE",121
15,"15070",8778,5802,5656,131,146,"PSdeG-PSOE",1705
36,"36001",2397,1674,1651,6,23,"PSdeG-PSOE",456
32,"32079",1280,880,869,13,11,"PSdeG-PSOE",331
15,"15006",5159,3008,2960,44,48,"PSdeG-PSOE",786
15,"15040",2647,1779,1762,15,17,"PSdeG-PSOE",457
36,"36057",238417,165843,164264,1641,1579,"PSdeG-PSOE",60107
15,"15902",4507,2885,2837,34,48,"PSdeG-PSOE",812
36,"36017",17364,11771,11598,123,173,"PSdeG-PSOE",3287
36,"36024",16335,11431,11256,99,175,"PSdeG-PSOE",2551
36,"36014",1867,1265,1243,16,22,"PSdeG-PSOE",321
15,"15041",9569,6362,6269,104,93,"PSdeG-PSOE",1805
32,"32082",1164,736,728,11,8,"PSdeG-PSOE",224
15,"15037",4026,2375,2349,10,26,"PSdeG-PSOE",658
15,"15020",3568,2226,2217,19,9,"PSdeG-PSOE",746
32,"32068",1401,882,878,4,4,"PSdeG-PSOE",328
32,"32044",794,547,540,2,7,"PSdeG-PSOE",203
15,"15083",1029,627,614,5,13,"PSdeG-PSOE",118
32,"32025",1014,731,718,5,13,"PSdeG-PSOE",178
32,"32039",1154,801,790,11,11,"PSdeG-PSOE",278
15,"15047",2256,1429,1405,25,24,"PSdeG-PSOE",446
32,"32047",1761,1192,1175,10,17,"PSdeG-PSOE",281
15,"15078",78810,55693,55183,569,510,"PSdeG-PSOE",15475
15,"15093",4012,2413,2386,24,27,"PSdeG-PSOE",608
32,"32021",872,555,550,6,5,"PSdeG-PSOE",239
36,"36049",6990,4877,4787,40,90,"PSdeG-PSOE",1190
36,"36059",4641,2844,2796,29,48,"PSdeG-PSOE",647
36,"36046",4073,2887,2818,31,69,"PSdeG-PSOE",829
36,"36901",4154,3094,3029,21,65,"PSdeG-PSOE",1236
32,"32027",989,670,660,5,10,"PSdeG-PSOE",187
32,"32006",1418,986,970,14,16,"PSdeG-PSOE",224
32,"32085",10584,6687,6611,58,76,"PSdeG-PSOE",2151
32,"32016",714,494,493,12,1,"PSdeG-PSOE",296
32,"32020",2428,1728,1714,10,14,"PSdeG-PSOE",510
32,"32012",708,448,440,2,8,"PSdeG-PSOE",148
36,"36054",11107,7027,6894,57,133,"PSdeG-PSOE",2054
32,"32028",1537,1012,1004,5,8,"PSdeG-PSOE",171
36,"36028",4049,2783,2739,22,44,"PSdeG-PSOE",894
15,"15091",1097,705,686,17,19,"PSdeG-PSOE",177
32,"32011",916,512,507,3,5,"PSdeG-PSOE",43
36,"36037",2538,1650,1625,12,25,"PSdeG-PSOE",423
32,"32074",977,642,631,2,11,"PSdeG-PSOE",203
15,"15016",4558,2747,2705,16,42,"PSdeG-PSOE",1201
32,"32056",1490,1009,1003,10,6,"PSdeG-PSOE",308
15,"15003",1675,1029,1020,9,9,"PSdeG-PSOE",312
36,"36048",5248,3429,3378,25,51,"PSdeG-PSOE",957
32,"32005",810,576,568,9,8,"PSdeG-PSOE",141
36,"36061",8613,5822,5718,56,104,"PSdeG-PSOE",1362
32,"32058",5247,3547,3489,30,58,"PSdeG-PSOE",1045
15,"15088",3396,2047,2022,22,25,"PSdeG-PSOE",576
36,"36013",2216,1298,1290,18,8,"PSdeG-PSOE",331
15,"15057",12077,8109,8018,83,91,"PSdeG-PSOE",2239
36,"36002",3049,1994,1968,22,26,"PSdeG-PSOE",490
32,"32052",1817,1278,1268,12,10,"PSdeG-PSOE",320
36,"36020",2172,1435,1418,19,17,"PSdeG-PSOE",360
32,"32084",878,532,527,8,5,"PSdeG-PSOE",200
32,"32033",667,439,436,4,3,"PSdeG-PSOE",131
36,"36044",2527,1535,1499,12,36,"PSdeG-PSOE",379
32,"32032",7900,5186,5091,48,95,"PSdeG-PSOE",1421
32,"32015",817,454,452,2,2,"PSdeG-PSOE",114
15,"15034",2712,1605,1585,15,20,"PSdeG-PSOE",820
36,"36027",4401,2940,2781,20,159,"PSdeG-PSOE",749
36,"36058",4957,3043,2994,55,49,"PSdeG-PSOE",985
32,"32088",1636,955,944,17,11,"PSdeG-PSOE",342
36,"36023",8258,5504,5384,44,120,"PSdeG-PSOE",1347
36,"36030",3921,2516,2484,31,32,"PSdeG-PSOE",718
32,"32057",505,334,328,3,6,"PSdeG-PSOE",166
32,"32055",1216,781,764,10,17,"PSdeG-PSOE",210
15,"15005",25347,15441,15211,226,230,"PSdeG-PSOE",4701
15,"15068",4824,2976,2937,54,39,"PSdeG-PSOE",945
32,"32035",1352,782,768,6,14,"PSdeG-PSOE",185
15,"15056",5615,3697,3646,31,51,"PSdeG-PSOE",1180
32,"32089",1206,740,726,8,14,"PSdeG-PSOE",210
20,"20049",4195,2918,2901,12,17,"PSE-EE (PSOE)",392
1,"1021",471,321,319,3,2,"PSE-EE (PSOE)",36
20,"20017",8462,5944,5917,11,27,"PSE-EE (PSOE)",663
48,"48015",33077,22441,22295,145,146,"PSE-EE (PSOE)",5855
20,"20079",18151,13106,13054,58,52,"PSE-EE (PSOE)",1586
48,"48058",947,682,679,2,3,"PSE-EE (PSOE)",64
48,"48070",527,357,355,0,2,"PSE-EE (PSOE)",10
1,"1008",808,546,536,6,10,"PSE-EE (PSOE)",89
48,"48902",18987,12762,12670,88,92,"PSE-EE (PSOE)",2951
20,"20006",261,154,153,1,1,"PSE-EE (PSOE)",4
1,"1002",8014,5838,5786,24,52,"PSE-EE (PSOE)",930
20,"20078",1143,819,816,1,3,"PSE-EE (PSOE)",49
48,"48023",579,451,448,0,3,"PSE-EE (PSOE)",9
1,"1052",272,189,186,2,3,"PSE-EE (PSOE)",38
48,"48036",24015,16501,16425,83,76,"PSE-EE (PSOE)",2940
20,"20048",183,112,112,0,0,"PSE-EE (PSOE)",5
48,"48031",303,221,221,0,0,"PSE-EE (PSOE)",2
48,"48038",1151,829,829,1,0,"PSE-EE (PSOE)",41
48,"48001",5899,4094,4074,19,20,"PSE-EE (PSOE)",721
48,"48021",1325,891,888,3,3,"PSE-EE (PSOE)",60
48,"48901",5160,3705,3684,16,21,"PSE-EE (PSOE)",747
1,"1042",911,680,671,8,9,"PSE-EE (PSOE)",46
48,"48076",288,211,211,1,0,"PSE-EE (PSOE)",15
48,"48048",527,381,380,3,1,"PSE-EE (PSOE)",13
48,"48005",116,80,79,0,1,"PSE-EE (PSOE)",7
48,"48030",591,449,447,2,2,"PSE-EE (PSOE)",8
20,"20055",17300,11784,11725,43,59,"PSE-EE (PSOE)",2147
48,"48911",381,303,302,1,1,"PSE-EE (PSOE)",0
20,"20038",387,294,293,2,1,"PSE-EE (PSOE)",3
20,"20031",185,113,112,3,1,"PSE-EE (PSOE)",4
20,"20028",2254,1442,1441,6,1,"PSE-EE (PSOE)",224
48,"48094",3121,2201,2188,7,13,"PSE-EE (PSOE)",160
48,"48067",1133,810,805,0,5,"PSE-EE (PSOE)",27
48,"48066",344,246,246,2,0,"PSE-EE (PSOE)",1
20,"20037",101,69,69,0,0,"PSE-EE (PSOE)",0
20,"20067",30609,20017,19927,111,90,"PSE-EE (PSOE)",5235
1,"1027",444,273,271,0,2,"PSE-EE (PSOE)",21
48,"48077",3366,2483,2467,9,16,"PSE-EE (PSOE)",207
20,"20062",941,688,683,1,5,"PSE-EE (PSOE)",33
48,"48043",4591,3337,3325,20,12,"PSE-EE (PSOE)",280
1,"1053",596,364,362,1,2,"PSE-EE (PSOE)",31
48,"48034",12623,8789,8711,76,78,"PSE-EE (PSOE)",2607
20,"20018",11231,7640,7611,33,29,"PSE-EE (PSOE)",440
20,"20007",337,223,221,2,2,"PSE-EE (PSOE)",2
48,"48042",1359,1055,1045,7,10,"PSE-EE (PSOE)",113
48,"48011",9640,6753,6722,41,31,"PSE-EE (PSOE)",1227
48,"48039",254,221,220,2,1,"PSE-EE (PSOE)",6
20,"20019",9892,6740,6717,40,23,"PSE-EE (PSOE)",1126
1,"1057",235,196,194,0,2,"PSE-EE (PSOE)",13
48,"48905",2496,1778,1766,12,12,"PSE-EE (PSOE)",218
1,"1028",1091,735,728,5,7,"PSE-EE (PSOE)",128
20,"20902",14282,9670,9618,52,52,"PSE-EE (PSOE)",2985
20,"20072",4762,3175,3153,21,22,"PSE-EE (PSOE)",599
48,"48086",2024,1371,1358,5,13,"PSE-EE (PSOE)",152
48,"48002",7791,5510,5471,42,39,"PSE-EE (PSOE)",1186
48,"48029",8681,6057,6027,41,30,"PSE-EE (PSOE)",1466
20,"20001",253,163,163,1,0,"PSE-EE (PSOE)",2
20,"20008",713,424,424,5,0,"PSE-EE (PSOE)",20
48,"48085",10716,7707,7679,51,28,"PSE-EE (PSOE)",864
20,"20059",8892,6505,6490,18,15,"PSE-EE (PSOE)",521
48,"48025",874,667,662,2,5,"PSE-EE (PSOE)",18
48,"48027",22745,16240,16158,74,82,"PSE-EE (PSOE)",2406
48,"48019",3429,2424,2411,14,13,"PSE-EE (PSOE)",403
48,"48914",332,276,275,0,1,"PSE-EE (PSOE)",3
48,"48033",217,162,162,1,0,"PSE-EE (PSOE)",4
48,"48052",1562,1220,1210,5,10,"PSE-EE (PSOE)",36
48,"48059",402,299,297,0,2,"PSE-EE (PSOE)",13
48,"48061",789,602,601,2,1,"PSE-EE (PSOE)",33
20,"20042",3180,2056,2053,7,3,"PSE-EE (PSOE)",318
20,"20058",740,523,522,3,1,"PSE-EE (PSOE)",101
1,"1019",148,112,112,0,0,"PSE-EE (PSOE)",5
1,"1060",204,159,151,0,8,"PSE-EE (PSOE)",19
48,"48095",2324,1568,1555,13,13,"PSE-EE (PSOE)",292
48,"48018",854,563,560,5,3,"PSE-EE (PSOE)",23
48,"48010",476,343,343,1,0,"PSE-EE (PSOE)",8
20,"20069",147446,102068,101696,564,372,"PSE-EE (PSOE)",20237
20,"20073",4707,3272,3260,14,12,"PSE-EE (PSOE)",360
1,"1902",723,485,478,8,7,"PSE-EE (PSOE)",85
48,"48074",3275,2308,2295,11,13,"PSE-EE (PSOE)",267
48,"48080",9916,6849,6793,44,56,"PSE-EE (PSOE)",1856
20,"20021",185,104,104,2,0,"PSE-EE (PSOE)",4
1,"1006",174,124,122,1,2,"PSE-EE (PSOE)",20
48,"48065",3285,2341,2326,8,15,"PSE-EE (PSOE)",307
48,"48049",543,415,414,1,1,"PSE-EE (PSOE)",9
1,"1062",318,221,219,2,2,"PSE-EE (PSOE)",39
48,"48083",6934,4800,4765,21,35,"PSE-EE (PSOE)",1176
20,"20907",118,82,82,0,0,"PSE-EE (PSOE)",0
1,"1013",710,469,465,2,4,"PSE-EE (PSOE)",38
48,"48068",1534,1154,1149,1,5,"PSE-EE (PSOE)",30
48,"48037",696,497,485,0,12,"PSE-EE (PSOE)",38
48,"48090",6004,4305,4254,28,51,"PSE-EE (PSOE)",905
48,"48096",6516,4862,4816,33,46,"PSE-EE (PSOE)",749
48,"48024",1000,761,752,1,9,"PSE-EE (PSOE)",13
20,"20075",4312,2848,2845,8,3,"PSE-EE (PSOE)",387
20,"20045",47031,30933,30787,172,146,"PSE-EE (PSOE)",8868
48,"48091",1078,758,757,5,1,"PSE-EE (PSOE)",69
48,"48071",6013,4240,4205,23,35,"PSE-EE (PSOE)",1017
20,"20011",1624,1234,1225,3,9,"PSE-EE (PSOE)",130
1,"1034",152,107,107,1,0,"PSE-EE (PSOE)",21
20,"20016",1529,887,883,3,4,"PSE-EE (PSOE)",32
48,"48009",774,585,578,0,7,"PSE-EE (PSOE)",30
1,"1020",323,228,224,1,4,"PSE-EE (PSOE)",20
48,"48915",339,245,243,0,2,"PSE-EE (PSOE)",5
20,"20015",1245,880,876,5,4,"PSE-EE (PSOE)",31
20,"20026",207,172,171,4,1,"PSE-EE (PSOE)",2
1,"1011",213,162,160,3,2,"PSE-EE (PSOE)",28
20,"20054",461,294,294,1,0,"PSE-EE (PSOE)",5
1,"1047",982,653,642,6,11,"PSE-EE (PSOE)",135
1,"1056",202,107,107,0,0,"PSE-EE (PSOE)",2
20,"20065",2921,1983,1970,16,13,"PSE-EE (PSOE)",362
48,"48057",5730,4126,4115,14,11,"PSE-EE (PSOE)",131
20,"20004",230,133,133,2,0,"PSE-EE (PSOE)",10
1,"1063",1852,1316,1303,6,13,"PSE-EE (PSOE)",148
48,"48075",2066,1524,1508,9,16,"PSE-EE (PSOE)",100
48,"48072",965,730,724,3,6,"PSE-EE (PSOE)",30
1,"1031",1136,844,830,1,14,"PSE-EE (PSOE)",114
1,"1044",232,151,148,2,3,"PSE-EE (PSOE)",20
1,"1032",498,363,353,1,10,"PSE-EE (PSOE)",70
48,"48084",21780,14368,14271,79,97,"PSE-EE (PSOE)",4281
20,"20024",395,245,245,4,0,"PSE-EE (PSOE)",8
20,"20064",12395,7959,7916,42,43,"PSE-EE (PSOE)",1727
20,"20035",480,361,361,0,0,"PSE-EE (PSOE)",18
20,"20027",2761,1866,1861,10,5,"PSE-EE (PSOE)",98
48,"48055",2603,1833,1820,14,13,"PSE-EE (PSOE)",182
48,"48020",272771,184893,183922,1227,971,"PSE-EE (PSOE)",36338
48,"48903",1800,1358,1353,4,5,"PSE-EE (PSOE)",94
20,"20066",437,288,286,1,2,"PSE-EE (PSOE)",0
20,"20043",1718,1189,1183,2,6,"PSE-EE (PSOE)",52
20,"20057",198,148,147,1,1,"PSE-EE (PSOE)",4
48,"48053",926,704,702,6,2,"PSE-EE (PSOE)",47
20,"20032",8654,6000,5972,21,28,"PSE-EE (PSOE)",984
20,"20905",160,123,123,2,0,"PSE-EE (PSOE)",0
20,"20029",4264,3116,3104,14,12,"PSE-EE (PSOE)",273
20,"20023",441,254,251,1,3,"PSE-EE (PSOE)",16
1,"1036",14698,10207,10131,51,76,"PSE-EE (PSOE)",1989
20,"20044",355,261,261,1,0,"PSE-EE (PSOE)",24
48,"48907",343,274,273,0,1,"PSE-EE (PSOE)",2
1,"1004",1357,952,945,5,7,"PSE-EE (PSOE)",108
20,"20012",149,104,104,1,0,"PSE-EE (PSOE)",3
20,"20056",4077,2796,2781,12,15,"PSE-EE (PSOE)",164
1,"1059",189597,128849,127910,688,939,"PSE-EE (PSOE)",30503
48,"48006",307,242,240,3,2,"PSE-EE (PSOE)",13
48,"48082",37358,25328,25167,125,161,"PSE-EE (PSOE)",6539
48,"48913",1236,899,890,8,9,"PSE-EE (PSOE)",85
1,"1018",1399,953,947,1,6,"PSE-EE (PSOE)",125
48,"48046",12626,9300,9250,31,50,"PSE-EE (PSOE)",825
48,"48007",389,243,243,0,0,"PSE-EE (PSOE)",2
48,"48909",201,158,157,0,1,"PSE-EE (PSOE)",0
48,"48904",3547,2563,2541,18,22,"PSE-EE (PSOE)",303
20,"20068",179,119,119,2,0,"PSE-EE (PSOE)",2
1,"1039",188,150,147,2,3,"PSE-EE (PSOE)",39
48,"48016",5471,3964,3935,31,29,"PSE-EE (PSOE)",557
20,"20077",5269,3845,3830,9,15,"PSE-EE (PSOE)",724
20,"20047",455,314,314,1,0,"PSE-EE (PSOE)",15
48,"48062",295,236,236,0,0,"PSE-EE (PSOE)",1
20,"20033",858,644,638,1,6,"PSE-EE (PSOE)",28
1,"1901",2473,1633,1612,9,21,"PSE-EE (PSOE)",368
20,"20002",359,234,231,7,3,"PSE-EE (PSOE)",4
1,"1017",817,537,532,3,5,"PSE-EE (PSOE)",73
48,"48908",250,212,210,1,2,"PSE-EE (PSOE)",10
48,"48026",1132,834,832,2,2,"PSE-EE (PSOE)",11
48,"48081",1903,1455,1447,7,8,"PSE-EE (PSOE)",101
20,"20013",5433,3906,3893,24,13,"PSE-EE (PSOE)",479
48,"48022",2305,1434,1425,11,9,"PSE-EE (PSOE)",189
20,"20070",1084,798,795,7,3,"PSE-EE (PSOE)",25
20,"20903",5033,3355,3341,18,14,"PSE-EE (PSOE)",421
20,"20046",1243,822,816,1,6,"PSE-EE (PSOE)",88
20,"20022",849,574,571,8,3,"PSE-EE (PSOE)",24
48,"48906",736,550,548,2,2,"PSE-EE (PSOE)",29
48,"48035",406,314,314,0,0,"PSE-EE (PSOE)",6
20,"20906",128,87,87,0,0,"PSE-EE (PSOE)",2
20,"20005",1274,822,822,1,0,"PSE-EE (PSOE)",63
20,"20036",13208,9102,9056,59,46,"PSE-EE (PSOE)",1237
1,"1049",130,94,94,1,0,"PSE-EE (PSOE)",9
20,"20030",21147,14598,14521,92,77,"PSE-EE (PSOE)",3930
20,"20009",11369,7402,7355,32,47,"PSE-EE (PSOE)",1804
1,"1058",1414,893,884,1,9,"PSE-EE (PSOE)",119
48,"48044",61957,45253,45063,299,190,"PSE-EE (PSOE)",5983
1,"1009",1258,839,833,2,6,"PSE-EE (PSOE)",88
20,"20076",7013,5011,4991,16,20,"PSE-EE (PSOE)",694
48,"48028",682,551,548,3,3,"PSE-EE (PSOE)",4
1,"1043",2340,1487,1468,11,19,"PSE-EE (PSOE)",411
48,"48078",37858,25959,25819,157,140,"PSE-EE (PSOE)",7760
20,"20061",4427,3073,3053,13,20,"PSE-EE (PSOE)",302
1,"1033",654,476,476,0,0,"PSE-EE (PSOE)",97
20,"20050",275,174,174,2,0,"PSE-EE (PSOE)",3
20,"20010",1524,1057,1053,5,4,"PSE-EE (PSOE)",111
20,"20025",1110,791,788,4,3,"PSE-EE (PSOE)",36
1,"1030",141,102,102,0,0,"PSE-EE (PSOE)",19
48,"48093",891,669,666,5,3,"PSE-EE (PSOE)",48
1,"1046",639,433,432,2,1,"PSE-EE (PSOE)",59
48,"48088",134,95,95,0,0,"PSE-EE (PSOE)",5
1,"1010",2315,1705,1688,6,17,"PSE-EE (PSOE)",171
1,"1041",150,103,102,1,1,"PSE-EE (PSOE)",9
1,"1014",366,271,266,2,5,"PSE-EE (PSOE)",35
48,"48050",188,141,141,0,0,"PSE-EE (PSOE)",5
48,"48014",1229,845,843,8,2,"PSE-EE (PSOE)",98
1,"1054",998,701,700,4,1,"PSE-EE (PSOE)",68
48,"48910",2811,1952,1942,11,10,"PSE-EE (PSOE)",381
48,"48012",2057,1610,1600,1,10,"PSE-EE (PSOE)",67
48,"48063",354,256,252,1,4,"PSE-EE (PSOE)",8
1,"1037",589,378,374,1,4,"PSE-EE (PSOE)",31
20,"20071",15062,10442,10407,47,35,"PSE-EE (PSOE)",1196
1,"1016",428,194,192,4,2,"PSE-EE (PSOE)",21
1,"1055",839,557,552,11,5,"PSE-EE (PSOE)",74
48,"48073",6827,4614,4591,38,23,"PSE-EE (PSOE)",207
20,"20081",7690,5382,5363,31,19,"PSE-EE (PSOE)",772
1,"1051",3569,2259,2244,3,15,"PSE-EE (PSOE)",339
20,"20074",11520,8379,8357,19,22,"PSE-EE (PSOE)",988
1,"1001",2020,1385,1372,5,13,"PSE-EE (PSOE)",284
48,"48097",1314,886,882,6,4,"PSE-EE (PSOE)",134
48,"48032",5762,4287,4262,14,25,"PSE-EE (PSOE)",548
20,"20052",1050,746,743,4,3,"PSE-EE (PSOE)",79
48,"48064",608,461,461,0,0,"PSE-EE (PSOE)",17
48,"48045",5207,3851,3817,9,34,"PSE-EE (PSOE)",509
20,"20060",87,75,75,0,0,"PSE-EE (PSOE)",0
20,"20039",2126,1623,1618,9,5,"PSE-EE (PSOE)",66
48,"48051",220,151,150,0,1,"PSE-EE (PSOE)",22
48,"48013",79353,53591,53205,331,386,"PSE-EE (PSOE)",15460
48,"48017",13121,8929,8886,45,43,"PSE-EE (PSOE)",610
20,"20003",549,360,355,1,5,"PSE-EE (PSOE)",16
20,"20020",114,64,64,0,0,"PSE-EE (PSOE)",0
20,"20901",1399,960,957,3,3,"PSE-EE (PSOE)",141
48,"48054",25063,17705,17597,122,108,"PSE-EE (PSOE)",3418
20,"20040",15771,10549,10481,54,68,"PSE-EE (PSOE)",1632
48,"48060",3625,2429,2418,12,11,"PSE-EE (PSOE)",99
48,"48912",2321,1684,1670,8,14,"PSE-EE (PSOE)",263
48,"48092",872,614,608,3,6,"PSE-EE (PSOE)",46
20,"20034",3200,2193,2180,8,13,"PSE-EE (PSOE)",354
1,"1023",262,193,190,1,3,"PSE-EE (PSOE)",21
20,"20904",87,56,55,1,1,"PSE-EE (PSOE)",1
20,"20014",1161,699,693,0,6,"PSE-EE (PSOE)",49
48,"48079",397,289,287,1,2,"PSE-EE (PSOE)",7
48,"48047",147,105,105,2,0,"PSE-EE (PSOE)",0
48,"48008",609,415,407,4,8,"PSE-EE (PSOE)",26
20,"20080",7705,5276,5244,21,32,"PSE-EE (PSOE)",1513
48,"48004",326,245,245,1,0,"PSE-EE (PSOE)",4
20,"20053",4856,3169,3153,15,16,"PSE-EE (PSOE)",439
48,"48056",980,731,728,3,3,"PSE-EE (PSOE)",24
1,"1061",155,116,116,1,0,"PSE-EE (PSOE)",3
48,"48069",13131,9211,9162,55,49,"PSE-EE (PSOE)",866
20,"20051",6736,4829,4804,22,25,"PSE-EE (PSOE)",817
48,"48089",3540,2561,2555,7,6,"PSE-EE (PSOE)",261
48,"48041",687,548,547,4,1,"PSE-EE (PSOE)",12
1,"1003",1166,843,837,6,6,"PSE-EE (PSOE)",26
48,"48087",437,335,332,0,3,"PSE-EE (PSOE)",54
48,"48040",1303,933,926,7,7,"PSE-EE (PSOE)",49
20,"20041",241,143,142,2,1,"PSE-EE (PSOE)",7
1,"1022",755,532,523,4,9,"PSE-EE (PSOE)",147
48,"48003",14518,10375,10310,49,65,"PSE-EE (PSOE)",1415
20,"20063",8023,5611,5597,19,14,"PSE-EE (PSOE)",345
27,"27035",183,110,110,3,0,"PSOE",47
27,"27038",923,624,619,8,5,"PSOE",289
27,"27017",952,568,562,3,6,"PSOE",168
27,"27015",3995,2518,2460,25,58,"PSOE",714
27,"27057",11047,7078,6941,64,137,"PSOE",2240
27,"27061",1018,704,683,12,21,"PSOE",204
27,"27020",3365,2544,2500,42,44,"PSOE",524
27,"27010",4378,2719,2670,49,49,"PSOE",710
27,"27051",7986,5324,5241,58,83,"PSOE",1594
27,"27016",6958,4697,4616,50,81,"PSOE",1496
27,"27001",2187,1111,1102,17,9,"PSOE",271
27,"27055",1191,773,764,7,9,"PSOE",305
27,"27042",1639,1120,1107,8,13,"PSOE",291
27,"27006",2441,1479,1460,11,19,"PSOE",472
27,"27049",1324,847,829,8,18,"PSOE",226
27,"27050",2821,1980,1954,11,26,"PSOE",520
27,"27066",12588,8116,7954,109,162,"PSOE",2705
27,"27901",2249,1373,1360,22,13,"PSOE",349
27,"27058",3283,2275,2241,12,34,"PSOE",681
27,"27037",1001,714,707,11,7,"PSOE",206
27,"27011",2341,1387,1362,7,25,"PSOE",518
27,"27047",1517,955,940,12,15,"PSOE",311
27,"27054",1135,807,782,5,25,"PSOE",220
27,"27062",583,403,400,2,3,"PSOE",148
27,"27048",1992,1317,1285,21,32,"PSOE",530
27,"27013",3690,2811,2766,30,45,"PSOE",862
27,"27045",926,588,583,6,5,"PSOE",358
27,"27064",1505,972,951,9,21,"PSOE",248
27,"27034",1010,565,558,3,7,"PSOE",229
27,"27030",3117,1945,1898,19,47,"PSOE",570
27,"27007",2723,1822,1776,23,46,"PSOE",460
27,"27012",1264,658,650,6,8,"PSOE",294
27,"27018",3211,1830,1800,17,30,"PSOE",835
27,"27052",860,564,558,7,6,"PSOE",264
27,"27059",2035,1356,1322,7,34,"PSOE",345
27,"27063",1699,1131,1109,7,22,"PSOE",398
27,"27005",2560,1691,1662,19,29,"PSOE",442
27,"27008",1326,865,853,5,12,"PSOE",283
27,"27041",2216,1463,1445,19,18,"PSOE",386
27,"27026",2299,1385,1368,9,17,"PSOE",470
27,"27046",1444,945,921,7,24,"PSOE",343
27,"27027",1791,1198,1167,17,31,"PSOE",401
27,"27902",7122,4472,4385,43,87,"PSOE",1243
27,"27019",8188,5478,5395,88,83,"PSOE",1789
27,"27023",2453,1674,1644,25,30,"PSOE",414
27,"27044",2703,1495,1463,15,32,"PSOE",422
27,"27022",4654,2760,2696,20,64,"PSOE",863
27,"27025",2731,2047,2006,18,41,"PSOE",444
27,"27021",1632,962,935,23,27,"PSOE",279
27,"27065",12055,7566,7379,119,187,"PSOE",2285
27,"27004",1143,640,625,2,15,"PSOE",185
27,"27039",4467,3179,3121,47,58,"PSOE",761
27,"27043",1222,746,737,12,9,"PSOE",258
27,"27033",591,334,328,0,6,"PSOE",116
27,"27002",1535,990,968,13,22,"PSOE",389
27,"27060",2434,1458,1434,17,24,"PSOE",467
27,"27024",1447,1048,1032,6,16,"PSOE",366
27,"27031",15107,9759,9593,87,166,"PSOE",3428
27,"27053",497,342,334,2,8,"PSOE",173
27,"27014",3144,2009,1985,24,24,"PSOE",632
27,"27056",1218,787,778,6,9,"PSOE",248
27,"27003",1743,1161,1134,18,27,"PSOE",304
27,"27009",2005,1324,1303,11,21,"PSOE",319
27,"27028",78725,52642,51965,642,677,"PSOE",17118
27,"27032",3197,1979,1956,30,23,"PSOE",600
27,"27040",3008,2071,2046,21,25,"PSOE",586
27,"27029",1425,925,910,11,15,"PSOE",276
46,"46010",943,691,681,7,10,"PSOE",149
12,"12124",1842,1343,1328,13,15,"PSOE",279
50,"50100",304,215,212,1,3,"PSOE",91
22,"22044",234,166,164,1,2,"PSOE",73
22,"22078",431,285,285,4,0,"PSOE",100
3,"3010",332,275,268,1,7,"PSOE",65
10,"10073",733,513,499,8,14,"PSOE",200
40,"40086",656,513,496,7,17,"PSOE",147
3,"3001",337,260,258,0,2,"PSOE",39
22,"22047",248,202,201,1,1,"PSOE",40
24,"24097",200,138,137,1,1,"PSOE",27
33,"33072",1443,816,814,8,2,"PSOE",319
34,"34102",197,158,156,1,2,"PSOE",37
24,"24057",1295,909,891,7,18,"PSOE",366
9,"9022",58,46,46,1,0,"PSOE",9
28,"28153",816,547,544,3,3,"PSOE",145
18,"18071",5636,3909,3807,45,102,"PSOE",1408
33,"33076",12115,7519,7456,76,63,"PSOE",2214
19,"19042",22,18,17,0,1,"PSOE",13
50,"50276",118,91,91,0,0,"PSOE",40
34,"34011",379,290,284,2,6,"PSOE",94
19,"19334",43,35,35,0,0,"PSOE",20
9,"9195",57,40,40,0,0,"PSOE",15
50,"50155",95,65,65,0,0,"PSOE",23
46,"46144",628,483,478,4,5,"PSOE",117
16,"16137",37,27,25,0,2,"PSOE",6
34,"34245",307,212,212,0,0,"PSOE",70
26,"26029",34,26,26,1,0,"PSOE",7
46,"46192",786,534,519,7,15,"PSOE",161
14,"14041",3113,2234,2160,43,74,"PSOE",668
47,"47231",4439,3359,3323,36,36,"PSOE",916
6,"6143",3389,2430,2371,24,59,"PSOE",1363
47,"47119",89,59,58,2,1,"PSOE",12
44,"44177",101,68,68,1,0,"PSOE",28
37,"37014",1140,747,737,7,10,"PSOE",299
34,"34071",158,128,128,2,0,"PSOE",32
2,"2013",125,90,88,0,2,"PSOE",21
18,"18030",566,382,380,2,2,"PSOE",152
31,"31186",283,183,182,1,1,"PSOE",22
50,"50107",988,758,755,8,3,"PSOE",246
16,"16154",4739,3416,3379,33,37,"PSOE",1144
29,"29056",1047,708,696,5,12,"PSOE",279
2,"2028",111,81,81,0,0,"PSOE",44
7,"7047",2399,1504,1477,20,27,"PSOE",338
37,"37297",394,298,297,0,1,"PSOE",87
31,"31003",121,71,71,0,0,"PSOE",12
9,"9337",113,80,77,2,3,"PSOE",27
50,"50083",81,64,64,2,0,"PSOE",27
47,"47100",118,93,87,2,6,"PSOE",37
7,"7048",18455,9929,9858,116,71,"PSOE",2753
26,"26166",144,125,124,0,1,"PSOE",18
19,"19274",953,693,676,9,17,"PSOE",218
28,"28005",136518,101397,100485,871,912,"PSOE",30865
23,"23903",3498,2633,2601,28,32,"PSOE",1052
46,"46259",457,374,371,2,3,"PSOE",121
29,"29025",41540,27170,26897,271,273,"PSOE",7079
19,"19303",41,32,32,0,0,"PSOE",6
50,"50271",246,179,173,4,6,"PSOE",35
19,"19170",189,115,115,1,0,"PSOE",34
18,"18112",104,68,66,2,2,"PSOE",21
3,"3047",9768,6220,6144,41,76,"PSOE",1966
34,"34236",147,104,104,0,0,"PSOE",20
6,"6133",1795,1308,1294,11,14,"PSOE",606
9,"9050",57,38,38,1,0,"PSOE",10
5,"5205",81,59,58,2,1,"PSOE",20
47,"47161",3970,3111,3089,24,22,"PSOE",575
49,"49003",860,534,530,5,4,"PSOE",149
47,"47015",177,129,129,0,0,"PSOE",38
30,"30023",3874,2831,2788,18,43,"PSOE",795
45,"45051",1678,1238,1209,13,29,"PSOE",404
40,"40044",134,101,101,3,0,"PSOE",29
42,"42070",31,23,23,1,0,"PSOE",14
31,"31213",99,50,50,0,0,"PSOE",7
45,"45083",568,433,429,2,4,"PSOE",110
29,"29009",1435,971,957,17,14,"PSOE",470
3,"3004",603,425,423,2,2,"PSOE",146
49,"49207",215,144,143,1,1,"PSOE",46
47,"47215",48,43,43,0,0,"PSOE",9
37,"37016",563,419,411,4,8,"PSOE",104
45,"45050",505,338,332,2,6,"PSOE",122
45,"45055",1004,768,755,4,13,"PSOE",317
24,"24121",599,422,418,3,4,"PSOE",143
23,"23054",375,280,272,1,8,"PSOE",150
50,"50041",16,10,10,0,0,"PSOE",8
24,"24036",252,146,146,1,0,"PSOE",77
49,"49172",474,278,271,1,7,"PSOE",58
28,"28009",14593,11026,10913,73,113,"PSOE",2525
37,"37071",76,64,62,1,2,"PSOE",28
44,"44239",21,19,19,0,0,"PSOE",0
34,"34134",44,25,25,0,0,"PSOE",8
34,"34101",48,36,36,1,0,"PSOE",8
6,"6001",664,474,460,3,14,"PSOE",198
44,"44039",204,144,143,1,1,"PSOE",17
31,"31219",80,59,58,2,1,"PSOE",17
31,"31255",103,79,79,0,0,"PSOE",20
24,"24081",121,72,72,0,0,"PSOE",8
21,"21001",621,431,418,0,13,"PSOE",209
12,"12102",518,424,417,4,7,"PSOE",182
3,"3088",5895,4030,3961,29,69,"PSOE",998
19,"19017",56,47,47,0,0,"PSOE",13
5,"5256",110,88,86,1,2,"PSOE",32
12,"12025",116,82,79,1,3,"PSOE",22
7,"7024",7283,3574,3538,36,36,"PSOE",921
10,"10197",106,74,74,0,0,"PSOE",22
34,"34093",83,61,60,0,1,"PSOE",5
31,"31051",241,169,167,3,2,"PSOE",48
50,"50025",4541,3110,3083,39,27,"PSOE",905
50,"50075",70,55,55,1,0,"PSOE",7
33,"33003",603,322,317,7,5,"PSOE",112
47,"47148",419,332,324,3,8,"PSOE",83
45,"45102",3613,2495,2464,27,31,"PSOE",673
26,"26160",731,539,533,4,6,"PSOE",183
18,"18076",789,534,532,2,2,"PSOE",330
24,"24221",738,492,485,9,7,"PSOE",123
9,"9073",964,713,706,3,7,"PSOE",193
21,"21022",187,121,116,0,5,"PSOE",48
4,"4072",311,212,211,0,1,"PSOE",72
22,"22066",755,529,520,8,9,"PSOE",174
9,"9901",334,228,226,4,2,"PSOE",70
10,"10055",697,488,473,3,15,"PSOE",134
34,"34052",164,127,125,1,2,"PSOE",25
12,"12042",574,459,446,9,13,"PSOE",82
22,"22081",247,173,171,3,2,"PSOE",29
28,"28062",306,232,227,0,5,"PSOE",35
19,"19240",49,36,36,0,0,"PSOE",15
37,"37270",184,139,136,2,3,"PSOE",38
14,"14047",1644,1198,1183,14,15,"PSOE",456
10,"10093",387,278,253,4,25,"PSOE",160
39,"39008",13900,9814,9734,63,80,"PSOE",2512
44,"44172",296,216,216,1,0,"PSOE",65
28,"28039",134,93,93,1,0,"PSOE",39
46,"46184",26514,19610,19399,180,211,"PSOE",5229
40,"40180",276,215,210,2,5,"PSOE",36
10,"10006",1224,907,893,7,14,"PSOE",446
14,"14026",2000,1294,1253,20,41,"PSOE",554
45,"45103",363,286,283,0,3,"PSOE",125
9,"9904",464,344,339,3,5,"PSOE",99
19,"19300",782,591,588,5,3,"PSOE",121
6,"6902",1651,1198,1174,19,24,"PSOE",489
33,"33010",1722,1085,1069,15,16,"PSOE",457
3,"3106",559,469,465,3,4,"PSOE",142
49,"49100",281,164,157,2,7,"PSOE",63
26,"26121",30,19,19,0,0,"PSOE",8
10,"10123",575,450,438,1,12,"PSOE",254
41,"41026",4302,3355,3288,26,67,"PSOE",1291
22,"22905",287,217,217,1,0,"PSOE",59
28,"28045",35523,26213,25966,212,247,"PSOE",6424
29,"29044",749,477,473,1,4,"PSOE",187
37,"37368",17,12,11,0,1,"PSOE",0
19,"19076",29,23,23,0,0,"PSOE",6
29,"29067",431757,290824,287855,3289,2969,"PSOE",83901
4,"4004",405,282,272,2,10,"PSOE",99
10,"10099",563,369,358,3,11,"PSOE",157
37,"37376",2130,1446,1423,18,23,"PSOE",343
16,"16142",119,90,90,0,0,"PSOE",28
26,"26001",199,145,141,3,4,"PSOE",59
2,"2017",760,498,493,1,5,"PSOE",239
9,"9270",157,112,109,2,3,"PSOE",24
18,"18181",194,134,133,0,1,"PSOE",23
47,"47152",67,59,59,0,0,"PSOE",32
31,"31149",2285,1531,1520,10,11,"PSOE",173
4,"4084",337,238,232,0,6,"PSOE",95
40,"40207",802,593,590,11,3,"PSOE",149
45,"45160",1097,838,824,4,14,"PSOE",231
19,"19038",19,16,15,0,1,"PSOE",4
45,"45085",1535,1061,1052,11,9,"PSOE",198
10,"10007",627,457,447,3,10,"PSOE",157
24,"24131",684,416,415,2,1,"PSOE",91
19,"19294",26,18,18,0,0,"PSOE",8
38,"38032",13579,8941,8880,92,61,"PSOE",2272
2,"2073",4825,3433,3394,35,39,"PSOE",1176
50,"50044",224,159,159,2,0,"PSOE",78
9,"9120",41,34,33,3,1,"PSOE",9
24,"24171",337,136,134,4,2,"PSOE",61
37,"37226",152,113,113,2,0,"PSOE",14
28,"28011",417,295,292,6,3,"PSOE",74
42,"42021",65,46,45,2,1,"PSOE",8
26,"26049",156,120,115,0,5,"PSOE",29
19,"19139",26,19,19,2,0,"PSOE",8
5,"5215",156,120,113,0,7,"PSOE",26
46,"46070",17824,12888,12802,106,86,"PSOE",2726
3,"3062",228,173,172,3,1,"PSOE",37
24,"24001",165,93,93,0,0,"PSOE",20
5,"5136",83,55,55,0,0,"PSOE",20
9,"9432",170,125,123,0,2,"PSOE",44
22,"22902",206,147,144,1,3,"PSOE",26
9,"9236",34,25,25,1,0,"PSOE",1
28,"28121",209,156,152,1,4,"PSOE",52
44,"44263",373,267,267,2,0,"PSOE",65
19,"19044",275,186,182,0,4,"PSOE",44
6,"6147",329,234,234,1,0,"PSOE",130
14,"14038",32742,23345,22974,242,371,"PSOE",5950
33,"33037",33074,20693,20412,259,281,"PSOE",7719
16,"16171",1728,1334,1313,10,21,"PSOE",516
29,"29026",1021,703,698,15,5,"PSOE",286
44,"44101",55,41,40,1,1,"PSOE",8
24,"24180",1086,767,759,9,8,"PSOE",181
6,"6140",612,456,451,1,5,"PSOE",123
47,"47088",101,79,79,0,0,"PSOE",24
47,"47083",81,63,61,0,2,"PSOE",9
22,"22909",307,219,217,0,2,"PSOE",76
42,"42159",39,34,33,0,1,"PSOE",8
9,"9411",153,105,104,0,1,"PSOE",29
26,"26164",50,36,35,0,1,"PSOE",18
44,"44143",388,298,298,2,0,"PSOE",97
9,"9384",292,199,193,3,6,"PSOE",41
42,"42190",94,61,61,1,0,"PSOE",27
29,"29005",4507,3012,2965,29,47,"PSOE",892
46,"46220",49112,33766,33424,312,342,"PSOE",9541
39,"39085",7017,5029,4992,23,37,"PSOE",1191
37,"37122",203,162,161,3,1,"PSOE",50
37,"37041",71,53,53,0,0,"PSOE",6
31,"31904",1559,989,972,11,17,"PSOE",200
34,"34091",118,82,82,1,0,"PSOE",22
4,"4902",45571,29423,29169,272,254,"PSOE",5868
23,"23001",912,723,712,2,11,"PSOE",354
2,"2068",323,239,239,3,0,"PSOE",87
49,"49214",666,486,477,6,9,"PSOE",142
37,"37203",151,114,113,1,1,"PSOE",36
12,"12107",350,299,295,3,4,"PSOE",98
50,"50183",316,227,223,1,4,"PSOE",57
37,"37277",74,55,55,0,0,"PSOE",11
6,"6051",1523,1147,1137,5,10,"PSOE",517
14,"14001",3423,2563,2515,11,48,"PSOE",1011
3,"3046",1636,1073,1061,7,12,"PSOE",291
34,"34221",168,129,127,2,2,"PSOE",51
33,"33056",4850,3068,3044,25,24,"PSOE",970
22,"22102",180,137,136,3,1,"PSOE",55
16,"16023",513,367,367,3,0,"PSOE",142
40,"40025",129,109,107,1,2,"PSOE",22
37,"37050",66,52,52,1,0,"PSOE",16
9,"9345",111,87,86,2,1,"PSOE",27
45,"45075",120,77,74,0,3,"PSOE",24
47,"47028",30,17,17,0,0,"PSOE",2
5,"5148",22,19,19,0,0,"PSOE",5
26,"26174",134,100,99,3,1,"PSOE",27
50,"50246",37,24,24,0,0,"PSOE",6
47,"47225",73,61,59,1,2,"PSOE",10
37,"37036",55,36,34,0,2,"PSOE",6
5,"5201",497,404,401,0,3,"PSOE",139
31,"31161",350,261,256,1,5,"PSOE",57
5,"5177",136,117,116,0,1,"PSOE",64
18,"18093",2751,1693,1674,18,19,"PSOE",638
10,"10143",141,109,105,0,4,"PSOE",53
42,"42082",8,8,8,0,0,"PSOE",2
45,"45113",1770,1189,1171,5,18,"PSOE",374
37,"37113",404,286,285,13,1,"PSOE",125
44,"44082",84,66,66,0,0,"PSOE",18
39,"39069",1934,1475,1458,2,17,"PSOE",256
33,"33051",6787,4318,4268,48,50,"PSOE",1490
11,"11019",1757,1233,1172,13,61,"PSOE",437
37,"37132",317,211,207,0,4,"PSOE",83
46,"46222",402,329,326,0,3,"PSOE",113
44,"44138",120,92,92,0,0,"PSOE",23
26,"26024",204,157,156,1,1,"PSOE",53
31,"31258",7879,5668,5631,50,37,"PSOE",1249
11,"11001",4360,2810,2744,32,66,"PSOE",1302
23,"23031",764,660,640,6,20,"PSOE",385
40,"40218",80,56,55,0,1,"PSOE",4
46,"46100",281,190,187,1,3,"PSOE",61
46,"46080",979,720,712,2,8,"PSOE",245
28,"28042",1261,918,908,9,10,"PSOE",179
10,"10034",337,244,240,0,4,"PSOE",110
39,"39088",59,40,40,2,0,"PSOE",17
45,"45123",3196,2252,2218,11,34,"PSOE",608
28,"28084",16243,11562,11408,90,154,"PSOE",3363
46,"46126",5580,4361,4328,36,33,"PSOE",1236
19,"19082",100,72,71,1,1,"PSOE",29
37,"37271",349,262,258,2,4,"PSOE",88
45,"45042",172,122,121,0,1,"PSOE",41
19,"19153",22,20,20,2,0,"PSOE",11
39,"39053",212,133,133,4,0,"PSOE",15
34,"34023",5103,3585,3543,45,42,"PSOE",1354
30,"30042",2218,1645,1625,10,20,"PSOE",455
9,"9368",29,19,19,1,0,"PSOE",1
3,"3094",9795,6528,6481,37,47,"PSOE",1449
37,"37257",51,36,36,1,0,"PSOE",5
44,"44114",233,161,159,0,2,"PSOE",37
24,"24155",441,340,334,2,6,"PSOE",113
47,"47176",199,110,110,0,0,"PSOE",26
3,"3033",101,82,78,0,4,"PSOE",15
19,"19262",125,98,98,0,0,"PSOE",33
6,"6085",3429,2439,2382,21,57,"PSOE",1103
45,"45072",653,469,462,1,7,"PSOE",164
37,"37377",215,174,173,0,1,"PSOE",45
41,"41061",2141,1661,1621,7,40,"PSOE",288
50,"50045",1217,891,878,10,13,"PSOE",274
4,"4903",4320,2907,2873,18,34,"PSOE",585
14,"14073",2768,1934,1880,33,54,"PSOE",890
49,"49041",409,287,282,1,5,"PSOE",129
46,"46240",200,167,155,1,12,"PSOE",25
12,"12041",92,69,69,2,0,"PSOE",13
28,"28133",6146,4245,4180,25,65,"PSOE",1193
12,"12033",1953,1391,1368,6,23,"PSOE",393
2,"2038",262,197,193,0,4,"PSOE",66
44,"44153",1733,1131,1125,0,6,"PSOE",240
10,"10118",278,232,231,1,1,"PSOE",125
24,"24166",1346,929,916,14,13,"PSOE",281
40,"40190",43,37,35,0,2,"PSOE",5
12,"12134",135,95,95,1,0,"PSOE",29
4,"4047",2224,1649,1627,13,22,"PSOE",610
26,"26028",135,111,110,3,1,"PSOE",27
9,"9466",113,84,83,1,1,"PSOE",17
39,"39060",6704,4959,4887,23,72,"PSOE",1113
11,"11042",1158,806,793,6,13,"PSOE",358
42,"42069",1483,896,878,2,18,"PSOE",314
39,"39075",136789,95707,95089,478,618,"PSOE",21507
47,"47065",820,608,602,2,6,"PSOE",209
26,"26041",109,67,65,0,2,"PSOE",13
50,"50167",208,166,163,1,3,"PSOE",50
31,"31096",99,79,79,3,0,"PSOE",20
40,"40075",152,116,116,0,0,"PSOE",41
46,"46015",7519,5575,5532,34,43,"PSOE",1410
3,"3085",271,229,227,5,2,"PSOE",51
37,"37108",98,75,75,3,0,"PSOE",17
9,"9355",85,67,67,1,0,"PSOE",4
16,"16063",112,81,81,1,0,"PSOE",28
3,"3133",41333,24527,24340,146,187,"PSOE",6716
41,"41001",1558,1129,1104,6,25,"PSOE",510
9,"9065",136,112,111,0,1,"PSOE",34
28,"28046",4824,3726,3707,33,19,"PSOE",816
24,"24182",410,273,270,7,3,"PSOE",77
24,"24130",415,291,289,2,2,"PSOE",68
45,"45064",3987,2918,2880,33,38,"PSOE",797
33,"33011",10563,5646,5578,92,68,"PSOE",1670
14,"14039",2577,1858,1801,29,57,"PSOE",800
5,"5174",62,51,51,1,0,"PSOE",8
46,"46161",1467,1129,1113,5,16,"PSOE",362
9,"9323",57,37,36,0,1,"PSOE",6
50,"50116",169,124,123,0,1,"PSOE",55
22,"22002",99,81,81,0,0,"PSOE",30
37,"37073",613,448,440,4,8,"PSOE",109
9,"9194",1970,1376,1359,15,17,"PSOE",421
2,"2071",1027,800,795,7,5,"PSOE",331
37,"37131",175,125,125,0,0,"PSOE",26
14,"14031",556,462,456,5,6,"PSOE",170
2,"2072",1528,981,958,7,23,"PSOE",389
50,"50152",1351,942,932,14,10,"PSOE",319
45,"45193",586,478,469,0,9,"PSOE",145
5,"5254",184,149,147,1,2,"PSOE",39
10,"10185",558,376,374,2,2,"PSOE",141
22,"22203",77,62,62,2,0,"PSOE",19
31,"31116",57,27,27,3,0,"PSOE",1
23,"23014",2535,1890,1861,28,29,"PSOE",779
26,"26044",51,38,36,0,2,"PSOE",13
10,"10078",365,271,263,7,8,"PSOE",119
9,"9054",89,65,63,4,2,"PSOE",10
5,"5072",92,74,72,1,2,"PSOE",9
9,"9037",105,94,93,0,1,"PSOE",45
5,"5060",108,79,79,2,0,"PSOE",12
44,"44160",438,287,285,4,2,"PSOE",69
31,"31185",461,291,290,1,1,"PSOE",34
9,"9307",102,76,74,1,2,"PSOE",39
6,"6067",1897,1268,1242,14,26,"PSOE",494
34,"34092",257,189,189,1,0,"PSOE",45
41,"41102",14773,10377,10028,174,349,"PSOE",3827
44,"44064",62,46,46,0,0,"PSOE",9
37,"37238",105,83,80,0,3,"PSOE",32
23,"23048",817,605,599,4,6,"PSOE",154
3,"3070",2115,1399,1376,9,23,"PSOE",346
50,"50195",53,42,38,0,4,"PSOE",9
28,"28070",105,80,80,3,0,"PSOE",12
16,"16202",733,533,526,4,7,"PSOE",238
49,"49004",110,74,71,3,3,"PSOE",14
31,"31212",128,91,91,1,0,"PSOE",27
5,"5138",283,218,217,1,1,"PSOE",38
47,"47208",53,35,35,1,0,"PSOE",3
33,"33021",4304,2643,2610,32,33,"PSOE",1035
5,"5014",5263,3699,3648,35,51,"PSOE",1194
10,"10120",153,97,97,0,0,"PSOE",45
18,"18049",588,418,415,4,3,"PSOE",163
10,"10213",533,397,385,0,12,"PSOE",161
6,"6126",2121,1443,1429,14,14,"PSOE",671
49,"49028",108,90,89,1,1,"PSOE",19
47,"47071",396,321,316,5,5,"PSOE",60
6,"6055",1976,1343,1313,11,30,"PSOE",546
13,"13061",5616,3679,3634,51,45,"PSOE",1221
18,"18162",919,664,652,3,12,"PSOE",267
21,"21013",10626,6990,6807,99,183,"PSOE",2655
47,"47021",73,57,55,0,2,"PSOE",14
2,"2016",528,353,352,4,1,"PSOE",115
44,"44071",585,419,418,6,1,"PSOE",90
37,"37294",11750,8395,8280,88,115,"PSOE",2420
7,"7005",6956,4042,3996,35,46,"PSOE",1203
37,"37078",781,626,603,9,23,"PSOE",196
16,"16165",56,45,45,0,0,"PSOE",21
28,"28083",9836,7278,7206,64,72,"PSOE",1726
24,"24020",436,230,228,0,2,"PSOE",63
47,"47051",324,261,258,6,3,"PSOE",64
22,"22106",20,13,13,2,0,"PSOE",6
34,"34129",168,118,118,1,0,"PSOE",22
50,"50061",190,157,155,2,2,"PSOE",67
14,"14063",994,731,719,8,12,"PSOE",307
40,"40007",68,55,55,1,0,"PSOE",9
39,"39081",440,330,327,1,3,"PSOE",35
45,"45201",3692,2198,2175,15,23,"PSOE",602
49,"49071",716,432,429,6,3,"PSOE",101
34,"34038",259,183,178,0,5,"PSOE",31
22,"22135",173,123,121,0,2,"PSOE",27
2,"2011",556,429,427,1,2,"PSOE",167
9,"9135",41,28,28,0,0,"PSOE",5
29,"29085",138,98,93,1,5,"PSOE",39
47,"47050",3908,2713,2673,39,40,"PSOE",792
44,"44025",5804,4024,3991,11,33,"PSOE",1242
42,"42218",68,44,43,0,1,"PSOE",12
2,"2074",5890,4054,4010,39,44,"PSOE",1486
18,"18144",816,592,582,3,10,"PSOE",129
38,"38024",15316,9131,9005,60,126,"PSOE",2240
34,"34171",928,572,562,2,10,"PSOE",172
44,"44112",400,265,265,2,0,"PSOE",72
49,"49053",919,676,661,8,15,"PSOE",245
13,"13082",25917,16834,16670,137,164,"PSOE",4397
6,"6010",1063,760,732,2,28,"PSOE",361
31,"31246",130,89,87,2,2,"PSOE",25
22,"22046",713,555,549,9,6,"PSOE",235
47,"47102",257,212,210,2,2,"PSOE",68
47,"47027",2799,2059,2025,12,34,"PSOE",685
9,"9180",132,94,91,1,3,"PSOE",25
45,"45009",455,277,274,2,3,"PSOE",77
12,"12093",161,111,109,2,2,"PSOE",26
18,"18067",682,442,437,2,5,"PSOE",213
19,"19326",2463,1671,1650,13,21,"PSOE",414
40,"40049",37,27,27,0,0,"PSOE",4
10,"10128",5618,3799,3630,37,169,"PSOE",1554
24,"24060",561,297,296,2,1,"PSOE",93
40,"40084",52,41,41,2,0,"PSOE",6
16,"16215",237,162,158,1,4,"PSOE",99
4,"4080",196,148,147,2,1,"PSOE",41
7,"7014",7885,3934,3893,43,41,"PSOE",1305
49,"49159",269,182,182,2,0,"PSOE",66
2,"2065",441,368,361,0,7,"PSOE",149
19,"19238",43,30,28,0,2,"PSOE",7
33,"33047",1068,771,759,9,12,"PSOE",250
12,"12031",3960,2913,2869,13,44,"PSOE",733
13,"13073",501,392,385,2,7,"PSOE",176
37,"37201",238,170,168,0,2,"PSOE",51
40,"40109",69,51,50,3,1,"PSOE",4
18,"18178",664,474,467,1,7,"PSOE",206
9,"9178",39,24,24,0,0,"PSOE",6
31,"31101",1428,986,981,6,5,"PSOE",150
40,"40189",471,344,329,1,15,"PSOE",148
49,"49046",246,174,169,0,5,"PSOE",51
19,"19277",15,10,10,0,0,"PSOE",5
47,"47026",50,37,37,1,0,"PSOE",6
50,"50250",54,44,44,2,0,"PSOE",7
2,"2066",222,165,163,1,2,"PSOE",63
3,"3073",222,178,178,0,0,"PSOE",66
12,"12002",114,96,94,1,2,"PSOE",35
44,"44159",37,27,27,1,0,"PSOE",2
46,"46146",1647,1241,1229,12,12,"PSOE",284
46,"46017",33041,23469,23277,173,192,"PSOE",5255
3,"3002",3649,2568,2542,11,26,"PSOE",689
40,"40078",150,123,123,6,0,"PSOE",46
49,"49108",446,312,309,2,3,"PSOE",97
44,"44182",203,160,158,0,2,"PSOE",39
23,"23026",3431,2430,2375,25,55,"PSOE",1050
24,"24031",207,160,158,0,2,"PSOE",45
10,"10145",123,90,84,0,6,"PSOE",37
44,"44141",122,88,85,0,3,"PSOE",21
42,"42073",73,56,55,0,1,"PSOE",9
9,"9160",83,63,63,1,0,"PSOE",15
3,"3091",244,194,193,2,1,"PSOE",52
7,"7013",7353,4725,4639,43,86,"PSOE",756
40,"40123",141,98,94,4,4,"PSOE",27
9,"9229",178,127,127,1,0,"PSOE",37
50,"50050",87,62,62,1,0,"PSOE",29
5,"5115",509,350,344,0,6,"PSOE",78
10,"10132",360,251,243,1,8,"PSOE",138
44,"44122",1277,939,934,5,5,"PSOE",314
19,"19115",29,23,23,0,0,"PSOE",2
37,"37152",400,268,261,4,7,"PSOE",50
19,"19282",138,107,106,0,1,"PSOE",19
45,"45099",3700,2524,2501,9,23,"PSOE",725
39,"39097",666,342,335,2,7,"PSOE",68
39,"39068",642,442,438,1,4,"PSOE",68
44,"44093",78,62,61,0,1,"PSOE",12
42,"42184",55,36,33,0,3,"PSOE",11
40,"40099",54,44,42,0,2,"PSOE",13
40,"40122",524,398,392,2,6,"PSOE",114
19,"19133",78,64,64,2,0,"PSOE",31
41,"41099",3961,2448,2413,14,35,"PSOE",1202
44,"44055",75,52,50,0,2,"PSOE",12
2,"2059",320,225,217,0,8,"PSOE",116
13,"13018",774,625,622,0,3,"PSOE",304
24,"24066",439,274,273,3,1,"PSOE",71
22,"22007",751,527,520,1,7,"PSOE",166
16,"16255",132,99,99,0,0,"PSOE",46
47,"47174",271,215,213,4,2,"PSOE",57
50,"50210",37,26,26,0,0,"PSOE",9
7,"7039",5019,3066,3017,23,49,"PSOE",630
46,"46194",15852,11124,11009,86,115,"PSOE",3173
19,"19117",1632,1187,1167,12,20,"PSOE",406
12,"12104",6843,5181,5111,32,70,"PSOE",1469
37,"37099",63,46,46,1,0,"PSOE",24
18,"18074",265,205,205,0,0,"PSOE",87
23,"23073",4363,3214,3176,24,38,"PSOE",1395
28,"28136",693,538,533,2,5,"PSOE",146
45,"45054",3798,2612,2587,10,25,"PSOE",800
4,"4087",157,115,113,0,2,"PSOE",31
46,"46232",853,661,648,7,13,"PSOE",266
33,"33074",3366,2042,2011,35,31,"PSOE",792
42,"42135",69,40,40,1,0,"PSOE",12
14,"14044",1613,1186,1164,10,22,"PSOE",586
3,"3130",28,19,19,0,0,"PSOE",4
47,"47177",104,78,78,0,0,"PSOE",27
31,"31080",486,362,361,4,1,"PSOE",105
33,"33006",1476,862,857,9,5,"PSOE",376
50,"50180",107,85,85,1,0,"PSOE",26
16,"16181",54,40,40,0,0,"PSOE",13
12,"12027",17506,11776,11649,84,127,"PSOE",3271
12,"12082",9602,7323,7248,53,75,"PSOE",1865
42,"42189",57,43,43,0,0,"PSOE",8
22,"22195",238,190,186,0,4,"PSOE",46
11,"11026",4700,3387,3293,17,94,"PSOE",1071
22,"22218",39,34,34,0,0,"PSOE",18
33,"33063",375,269,267,5,2,"PSOE",116
40,"40029",25,21,19,0,2,"PSOE",6
49,"49008",423,263,259,1,4,"PSOE",99
50,"50285",657,448,442,4,6,"PSOE",125
40,"40156",272,194,190,4,4,"PSOE",57
31,"31211",17,15,14,3,1,"PSOE",0
18,"18050",1649,1113,1095,5,18,"PSOE",389
22,"22143",190,118,115,1,3,"PSOE",31
9,"9455",45,34,33,0,1,"PSOE",9
49,"49059",84,61,58,0,3,"PSOE",14
19,"19143",1781,1278,1266,18,12,"PSOE",364
47,"47053",123,101,97,3,4,"PSOE",32
41,"41043",669,447,436,11,11,"PSOE",232
31,"31180",202,144,143,1,1,"PSOE",26
19,"19011",237,165,162,3,3,"PSOE",72
12,"12125",215,179,179,2,0,"PSOE",62
22,"22208",192,150,147,1,3,"PSOE",49
16,"16227",109,78,76,0,2,"PSOE",24
9,"9450",23,18,18,1,0,"PSOE",8
5,"5158",346,263,261,0,2,"PSOE",66
44,"44211",33,22,22,0,0,"PSOE",11
34,"34170",50,30,30,1,0,"PSOE",4
45,"45024",1034,742,733,1,9,"PSOE",211
31,"31194",328,224,222,3,2,"PSOE",27
9,"9276",390,256,244,4,12,"PSOE",69
10,"10212",1658,1113,1068,19,45,"PSOE",441
37,"37280",70,47,46,0,1,"PSOE",9
4,"4058",342,238,236,3,2,"PSOE",101
14,"14075",552,413,391,5,22,"PSOE",203
42,"42016",20,13,13,0,0,"PSOE",3
19,"19155",64,49,49,0,0,"PSOE",19
4,"4020",302,207,206,2,1,"PSOE",54
46,"46060",9278,6796,6724,49,72,"PSOE",1883
37,"37379",169,133,132,0,1,"PSOE",40
46,"46197",1930,1430,1411,11,19,"PSOE",357
30,"30029",12122,8231,8125,54,106,"PSOE",2636
37,"37284",317,229,222,2,7,"PSOE",66
6,"6047",829,618,605,1,13,"PSOE",283
24,"24148",1602,1152,1140,11,12,"PSOE",238
2,"2010",1784,1374,1349,12,25,"PSOE",547
5,"5252",56,46,45,0,1,"PSOE",5
47,"47097",305,239,237,0,2,"PSOE",102
19,"19289",23,16,16,0,0,"PSOE",2
41,"41014",2476,1852,1799,10,53,"PSOE",680
24,"24074",97,70,70,1,0,"PSOE",15
10,"10170",231,164,162,2,2,"PSOE",54
28,"28023",5159,4052,4019,27,33,"PSOE",829
5,"5058",71,45,43,0,2,"PSOE",6
39,"39048",1772,1311,1295,8,16,"PSOE",214
49,"49027",125,82,81,0,1,"PSOE",15
21,"21012",285,224,221,0,3,"PSOE",105
10,"10210",489,314,313,2,1,"PSOE",174
50,"50151",607,450,449,12,1,"PSOE",206
16,"16053",388,306,303,3,3,"PSOE",134
9,"9314",90,75,75,2,0,"PSOE",38
41,"41904",1789,1125,1109,31,16,"PSOE",758
46,"46067",1753,1356,1341,8,15,"PSOE",439
37,"37169",177,122,122,0,0,"PSOE",45
13,"13055",616,445,444,3,1,"PSOE",202
39,"39080",3477,2404,2388,4,16,"PSOE",627
37,"37287",297,204,202,2,2,"PSOE",47
19,"19022",592,423,420,6,3,"PSOE",102
45,"45114",549,400,394,1,6,"PSOE",165
49,"49092",115,72,72,0,0,"PSOE",33
22,"22112",9525,6317,6245,91,72,"PSOE",1676
31,"31006",1877,1328,1310,14,18,"PSOE",494
37,"37118",117,86,86,3,0,"PSOE",24
37,"37319",88,68,64,2,4,"PSOE",26
9,"9360",26,19,19,0,0,"PSOE",5
37,"37381",138,98,93,0,5,"PSOE",23
44,"44103",122,96,96,3,0,"PSOE",23
28,"28028",1836,1374,1363,3,11,"PSOE",310
44,"44067",106,75,71,0,4,"PSOE",20
19,"19160",883,535,530,11,5,"PSOE",115
19,"19020",46,31,31,0,0,"PSOE",7
23,"23040",1438,1175,1159,3,16,"PSOE",491
37,"37372",133,99,98,0,1,"PSOE",34
34,"34107",73,47,46,1,1,"PSOE",10
50,"50109",95,65,62,2,3,"PSOE",10
9,"9138",84,67,66,1,1,"PSOE",21
47,"47069",115,87,87,0,0,"PSOE",30
22,"22087",60,46,46,0,0,"PSOE",8
44,"44151",180,134,134,1,0,"PSOE",46
5,"5036",118,91,90,0,1,"PSOE",7
26,"26163",126,104,104,1,0,"PSOE",35
9,"9038",109,87,86,1,1,"PSOE",29
31,"31074",394,293,292,5,1,"PSOE",39
10,"10215",438,266,262,2,4,"PSOE",131
5,"5105",330,247,242,2,5,"PSOE",78
46,"46018",562,442,436,2,6,"PSOE",143
40,"40005",25,23,23,1,0,"PSOE",6
26,"26138",4504,2982,2930,32,52,"PSOE",1004
29,"29048",1364,1053,1039,8,14,"PSOE",490
47,"47117",287,199,197,6,2,"PSOE",41
39,"39092",863,534,533,3,1,"PSOE",146
26,"26007",482,360,348,0,12,"PSOE",137
5,"5038",114,83,82,0,1,"PSOE",13
16,"16006",113,100,100,1,0,"PSOE",25
42,"42093",36,28,28,1,0,"PSOE",6
5,"5025",78,65,65,0,0,"PSOE",10
5,"5027",258,209,203,5,6,"PSOE",38
34,"34060",133,109,107,0,2,"PSOE",32
37,"37361",84,55,54,1,1,"PSOE",6
9,"9406",239,165,162,2,3,"PSOE",52
21,"21078",2641,1718,1670,10,48,"PSOE",872
24,"24219",489,334,329,7,5,"PSOE",96
45,"45086",483,339,332,0,7,"PSOE",104
6,"6162",2885,2067,2032,19,35,"PSOE",914
33,"33015",1396,849,842,7,7,"PSOE",302
12,"12073",133,97,97,0,0,"PSOE",17
42,"42142",42,36,36,1,0,"PSOE",6
26,"26073",92,68,66,1,2,"PSOE",24
34,"34081",60,45,44,0,1,"PSOE",8
12,"12017",145,111,110,2,1,"PSOE",32
40,"40201",42,37,37,0,0,"PSOE",4
50,"50003",117,89,89,1,0,"PSOE",39
34,"34160",133,107,106,0,1,"PSOE",53
26,"26153",10,10,10,1,0,"PSOE",7
31,"31202",4360,2806,2767,30,39,"PSOE",772
40,"40138",2102,1585,1565,13,20,"PSOE",524
29,"29077",207,135,134,1,1,"PSOE",61
47,"47103",252,195,192,1,3,"PSOE",77
19,"19255",74,37,37,0,0,"PSOE",18
12,"12007",724,622,614,2,8,"PSOE",119
47,"47138",224,169,166,0,3,"PSOE",57
21,"21008",2604,1663,1626,10,37,"PSOE",900
50,"50026",418,292,288,4,4,"PSOE",132
6,"6090",827,570,553,3,17,"PSOE",257
50,"50005",228,185,184,2,1,"PSOE",34
34,"34006",79,73,69,2,4,"PSOE",6
45,"45177",1998,1557,1525,10,32,"PSOE",537
42,"42095",1909,1345,1326,32,19,"PSOE",404
11,"11027",68774,45571,45137,567,434,"PSOE",11323
47,"47180",57,41,41,1,0,"PSOE",9
42,"42031",25,17,17,1,0,"PSOE",1
18,"18174",435,324,320,3,4,"PSOE",149
22,"22094",102,69,69,3,0,"PSOE",25
47,"47150",253,193,187,3,6,"PSOE",53
26,"26040",64,47,47,1,0,"PSOE",14
50,"50164",381,245,243,3,2,"PSOE",83
50,"50289",53,42,42,1,0,"PSOE",13
5,"5225",355,276,273,6,3,"PSOE",63
28,"28021",571,365,364,1,1,"PSOE",61
30,"30022",17108,11041,10851,100,190,"PSOE",3194
33,"33009",878,545,542,4,3,"PSOE",154
24,"24224",564,381,375,5,6,"PSOE",113
6,"6070",7668,5404,5228,59,176,"PSOE",2225
47,"47191",111,81,81,0,0,"PSOE",15
2,"2053",2888,2086,2042,14,44,"PSOE",780
24,"24119",695,464,458,7,6,"PSOE",179
49,"49147",250,164,162,1,2,"PSOE",50
9,"9316",104,80,80,0,0,"PSOE",18
24,"24084",153,105,102,2,3,"PSOE",45
23,"23010",14264,9801,9635,120,166,"PSOE",3366
38,"38030",1962,1332,1318,9,14,"PSOE",471
37,"37328",159,112,110,1,2,"PSOE",36
44,"44076",2089,1577,1565,8,12,"PSOE",536
2,"2901",2196,1441,1419,10,22,"PSOE",539
7,"7002",6678,4149,4108,31,41,"PSOE",1000
6,"6077",319,234,229,2,5,"PSOE",138
5,"5133",61,44,43,0,1,"PSOE",14
22,"22133",108,71,71,3,0,"PSOE",36
31,"31206",2077,1433,1417,15,16,"PSOE",301
7,"7036",28132,18650,18510,222,140,"PSOE",4243
13,"13012",381,265,261,1,4,"PSOE",142
24,"24014",7152,4494,4448,47,46,"PSOE",1830
50,"50007",51,34,34,1,0,"PSOE",7
7,"7059",3074,1973,1948,17,25,"PSOE",503
47,"47204",235,159,157,3,2,"PSOE",45
47,"47110",445,335,327,1,8,"PSOE",108
12,"12050",1226,904,891,3,13,"PSOE",357
49,"49005",125,80,80,1,0,"PSOE",26
5,"5157",227,146,146,3,0,"PSOE",60
42,"42056",28,25,24,0,1,"PSOE",3
42,"42027",72,48,47,1,1,"PSOE",17
29,"29079",2326,1609,1582,12,27,"PSOE",675
40,"40905",130,95,95,0,0,"PSOE",15
31,"31098",1984,1443,1428,11,15,"PSOE",274
3,"3059",20710,14788,14685,89,103,"PSOE",3382
30,"30019",25911,17485,17264,157,221,"PSOE",4140
16,"16058",94,71,71,1,0,"PSOE",43
3,"3039",89,65,65,0,0,"PSOE",17
18,"18070",287,216,216,3,0,"PSOE",88
3,"3110",312,258,258,0,0,"PSOE",42
26,"26147",34,26,25,0,1,"PSOE",17
24,"24203",88,62,62,1,0,"PSOE",14
34,"34149",23,20,20,0,0,"PSOE",4
22,"22213",2918,2084,2062,20,22,"PSOE",715
40,"40077",966,718,704,10,14,"PSOE",192
24,"24088",996,750,745,9,5,"PSOE",184
44,"44198",182,138,135,0,3,"PSOE",37
49,"49263",44,32,32,1,0,"PSOE",2
31,"31136",461,294,293,3,1,"PSOE",42
31,"31100",256,166,165,0,1,"PSOE",19
44,"44080",281,202,199,0,3,"PSOE",62
31,"31174",100,55,55,0,0,"PSOE",11
9,"9380",71,42,41,0,1,"PSOE",12
33,"33068",1031,518,510,5,8,"PSOE",248
41,"41092",7681,5408,5299,79,109,"PSOE",2767
34,"34048",62,51,51,1,0,"PSOE",16
4,"4073",327,224,223,0,1,"PSOE",75
37,"37268",106,62,61,1,1,"PSOE",12
10,"10160",240,179,177,2,2,"PSOE",94
9,"9105",95,65,64,1,1,"PSOE",22
16,"16088",100,86,86,0,0,"PSOE",45
29,"29001",4207,3002,2959,40,43,"PSOE",1328
4,"4038",3105,2020,1984,17,36,"PSOE",694
37,"37112",158,110,109,2,1,"PSOE",29
9,"9007",54,37,35,0,2,"PSOE",5
29,"29011",2893,1763,1736,12,27,"PSOE",879
46,"46094",20805,15353,15211,122,142,"PSOE",3843
24,"24054",410,275,271,0,4,"PSOE",64
5,"5170",47,34,34,1,0,"PSOE",14
23,"23016",386,313,305,4,8,"PSOE",158
24,"24019",338,259,256,4,3,"PSOE",123
3,"3058",4976,3733,3669,20,64,"PSOE",767
7,"7031",24972,14866,14757,127,109,"PSOE",3610
29,"29086",770,479,476,5,3,"PSOE",204
44,"44096",155,115,114,1,1,"PSOE",29
26,"26140",239,180,177,1,3,"PSOE",55
21,"21017",2302,1469,1452,18,17,"PSOE",667
14,"14052",9039,5579,5478,79,101,"PSOE",2016
3,"3071",4000,2858,2813,27,45,"PSOE",699
5,"5178",340,261,255,3,6,"PSOE",42
28,"28168",1347,933,918,6,15,"PSOE",246
5,"5143",59,52,51,1,1,"PSOE",15
5,"5199",37,31,31,0,0,"PSOE",3
10,"10041",1022,720,706,2,14,"PSOE",282
28,"28148",89174,65500,64784,566,716,"PSOE",18699
2,"2027",274,209,203,1,6,"PSOE",74
24,"24056",2726,1803,1772,21,31,"PSOE",623
31,"31031",212,134,132,2,2,"PSOE",16
5,"5002",1905,1361,1329,11,32,"PSOE",463
50,"50147",744,508,506,5,2,"PSOE",222
26,"26012",37,28,28,1,0,"PSOE",6
46,"46027",924,746,737,2,9,"PSOE",203
19,"19233",79,65,65,2,0,"PSOE",14
9,"9311",59,45,45,0,0,"PSOE",30
44,"44174",402,289,288,1,1,"PSOE",69
45,"45176",3859,2694,2662,24,32,"PSOE",634
40,"40082",104,84,84,2,0,"PSOE",16
50,"50138",45,37,37,3,0,"PSOE",9
50,"50296",385,240,235,3,5,"PSOE",105
6,"6043",677,493,488,5,5,"PSOE",209
12,"12074",756,611,601,3,10,"PSOE",204
19,"19234",44,30,30,0,0,"PSOE",11
11,"11037",5656,4374,4273,24,101,"PSOE",1265
14,"14036",3677,2619,2555,39,64,"PSOE",1168
16,"16145",413,333,326,6,7,"PSOE",156
19,"19110",51,39,39,0,0,"PSOE",9
44,"44034",124,90,90,0,0,"PSOE",28
31,"31118",156,104,104,3,0,"PSOE",25
3,"3063",27209,18236,18101,164,135,"PSOE",5731
34,"34009",30,26,26,0,0,"PSOE",2
26,"26103",814,617,603,10,14,"PSOE",217
13,"13070",747,575,556,7,19,"PSOE",222
34,"34083",1647,1089,1080,2,9,"PSOE",305
12,"12133",59,46,45,0,1,"PSOE",10
50,"50190",669,532,518,10,14,"PSOE",214
19,"19298",53,43,41,0,2,"PSOE",17
26,"26003",379,311,306,1,5,"PSOE",103
11,"11008",17923,11702,11464,192,238,"PSOE",3390
41,"41016",7820,5523,5407,57,116,"PSOE",1561
44,"44132",54,49,49,0,0,"PSOE",13
24,"24150",226,163,162,0,1,"PSOE",44
47,"47047",199,136,135,4,1,"PSOE",21
6,"6056",447,351,340,2,11,"PSOE",178
44,"44036",22,20,20,0,0,"PSOE",1
9,"9151",446,352,346,3,6,"PSOE",151
49,"49235",415,300,290,4,10,"PSOE",106
34,"34010",550,407,399,7,8,"PSOE",111
26,"26091",147,115,114,0,1,"PSOE",16
12,"12003",954,710,702,6,8,"PSOE",161
14,"14009",2653,1658,1631,24,27,"PSOE",666
9,"9172",131,88,88,1,0,"PSOE",27
19,"19145",40,32,32,0,0,"PSOE",0
24,"24133",357,256,256,1,0,"PSOE",68
19,"19041",163,118,117,1,1,"PSOE",54
40,"40021",18,15,15,0,0,"PSOE",4
46,"46030",810,641,625,7,16,"PSOE",201
19,"19267",20,15,14,0,1,"PSOE",4
31,"31036",879,601,589,5,12,"PSOE",194
16,"16018",376,290,290,2,0,"PSOE",99
28,"28015",20885,16237,16104,134,133,"PSOE",3380
45,"45022",395,292,292,2,0,"PSOE",93
16,"16199",27,18,18,0,0,"PSOE",4
9,"9100",55,33,33,0,0,"PSOE",1
22,"22245",303,222,213,3,9,"PSOE",59
50,"50064",439,348,346,1,2,"PSOE",154
49,"49197",155,109,104,0,5,"PSOE",39
44,"44207",125,98,97,2,1,"PSOE",33
9,"9226",54,45,45,2,0,"PSOE",11
10,"10089",1334,864,837,8,27,"PSOE",403
40,"40216",785,633,621,9,12,"PSOE",163
16,"16019",187,141,141,1,0,"PSOE",41
49,"49038",88,63,58,1,5,"PSOE",21
39,"39095",2266,1637,1619,8,18,"PSOE",535
3,"3086",169,140,140,2,0,"PSOE",42
49,"49262",367,263,261,1,2,"PSOE",83
12,"12128",1365,990,972,16,18,"PSOE",297
16,"16010",134,92,88,0,4,"PSOE",19
22,"22234",743,498,491,5,7,"PSOE",152
6,"6004",1561,1130,1111,7,19,"PSOE",568
24,"24172",389,208,202,1,6,"PSOE",59
47,"47092",101,81,79,0,2,"PSOE",10
44,"44124",71,57,57,0,0,"PSOE",19
49,"49134",158,100,99,1,1,"PSOE",29
22,"22901",714,433,423,6,10,"PSOE",189
50,"50227",107,62,62,1,0,"PSOE",13
28,"28047",42984,30772,30486,270,286,"PSOE",8215
16,"16135",115,76,76,0,0,"PSOE",24
28,"28017",1280,975,963,10,12,"PSOE",183
9,"9122",86,55,55,0,0,"PSOE",13
49,"49054",847,576,569,8,7,"PSOE",189
19,"19179",74,64,64,3,0,"PSOE",29
22,"22225",2606,1638,1612,20,26,"PSOE",469
34,"34062",148,94,93,0,1,"PSOE",19
3,"3068",41,38,37,0,1,"PSOE",4
28,"28018",4121,3174,3151,22,23,"PSOE",747
5,"5243",80,57,56,1,1,"PSOE",13
42,"42046",46,32,32,0,0,"PSOE",9
34,"34156",51,42,42,0,0,"PSOE",4
19,"19270",14,13,13,0,0,"PSOE",1
31,"31260",1265,817,815,7,2,"PSOE",162
40,"40124",234,169,164,0,5,"PSOE",54
49,"49265",110,79,78,2,1,"PSOE",31
37,"37310",166,116,115,3,1,"PSOE",55
10,"10214",216,170,170,2,0,"PSOE",57
38,"38017",30964,16228,16102,108,126,"PSOE",4545
40,"40208",724,546,543,5,3,"PSOE",137
28,"28091",5491,3709,3650,20,59,"PSOE",1034
9,"9125",555,386,382,4,4,"PSOE",115
9,"9179",39,30,30,1,0,"PSOE",9
31,"31138",948,629,627,8,2,"PSOE",106
5,"5106",27,14,14,0,0,"PSOE",1
13,"13096",7526,5212,5131,25,81,"PSOE",1862
49,"49032",282,196,196,0,0,"PSOE",54
40,"40233",399,279,273,0,6,"PSOE",73
18,"18908",776,553,528,3,25,"PSOE",218
4,"4098",1424,890,885,0,5,"PSOE",321
16,"16153",924,751,741,4,10,"PSOE",297
50,"50060",171,126,125,1,1,"PSOE",34
16,"16905",1302,951,934,10,17,"PSOE",379
7,"7061",9451,5735,5666,60,69,"PSOE",1307
5,"5135",399,294,292,2,2,"PSOE",64
22,"22113",478,335,333,6,2,"PSOE",115
42,"42158",97,73,73,1,0,"PSOE",27
24,"24103",274,134,134,0,0,"PSOE",34
11,"11025",4374,2808,2759,30,49,"PSOE",1446
10,"10136",274,205,202,1,3,"PSOE",94
50,"50052",81,61,61,0,0,"PSOE",15
13,"13081",584,412,405,0,7,"PSOE",189
37,"37344",229,157,147,2,10,"PSOE",47
37,"37250",325,212,211,0,1,"PSOE",112
37,"37054",233,190,186,2,4,"PSOE",85
39,"39043",1517,1167,1154,3,13,"PSOE",133
5,"5246",48,35,35,0,0,"PSOE",15
31,"31251",3144,2197,2164,18,33,"PSOE",723
46,"46035",6828,5155,5089,33,66,"PSOE",1704
45,"45079",355,250,250,0,0,"PSOE",77
39,"39100",849,567,565,5,2,"PSOE",95
22,"22116",1342,915,905,11,10,"PSOE",302
37,"37314",81,65,65,0,0,"PSOE",12
6,"6058",1984,1372,1331,13,41,"PSOE",538
50,"50205",72,51,49,0,2,"PSOE",27
46,"46149",350,252,249,3,3,"PSOE",50
3,"3044",4608,3437,3391,13,46,"PSOE",849
10,"10056",533,377,371,2,6,"PSOE",181
9,"9183",42,32,32,0,0,"PSOE",9
39,"39045",352,238,234,0,4,"PSOE",61
22,"22220",147,106,105,1,1,"PSOE",40
37,"37002",125,64,63,0,1,"PSOE",27
22,"22158",11994,8115,8049,79,66,"PSOE",2676
37,"37282",193,132,131,3,1,"PSOE",40
3,"3008",158,120,118,1,2,"PSOE",36
47,"47033",205,151,150,2,1,"PSOE",35
37,"37013",104,72,70,2,2,"PSOE",16
31,"31229",39,32,32,0,0,"PSOE",1
37,"37209",415,276,275,2,1,"PSOE",117
46,"46150",1794,1276,1272,8,4,"PSOE",373
41,"41006",2733,1776,1742,17,34,"PSOE",901
18,"18025",277,198,197,0,1,"PSOE",99
3,"3055",5265,3741,3697,16,44,"PSOE",738
9,"9025",110,61,58,0,3,"PSOE",15
47,"47040",56,42,41,0,1,"PSOE",8
34,"34080",5231,3207,3161,35,46,"PSOE",1047
23,"23095",8571,6159,6101,37,58,"PSOE",2280
5,"5100",260,193,192,3,1,"PSOE",65
19,"19111",160,128,125,0,3,"PSOE",40
11,"11029",5442,2826,2765,44,61,"PSOE",1038
9,"9133",38,33,33,0,0,"PSOE",9
12,"12068",41,22,21,0,1,"PSOE",7
18,"18903",852,544,537,9,7,"PSOE",201
16,"16146",85,49,49,0,0,"PSOE",20
50,"50006",913,670,654,13,16,"PSOE",282
2,"2075",1700,1357,1347,6,10,"PSOE",472
42,"42097",14,9,9,1,0,"PSOE",5
5,"5022",1580,1202,1193,6,9,"PSOE",196
10,"10059",329,202,201,1,1,"PSOE",107
4,"4091",318,251,250,0,1,"PSOE",173
13,"13042",880,638,626,2,12,"PSOE",220
5,"5089",455,342,324,0,18,"PSOE",92
47,"47066",1482,1096,1086,14,10,"PSOE",272
40,"40001",708,544,536,3,8,"PSOE",124
49,"49171",603,433,427,4,6,"PSOE",153
47,"47087",362,272,268,1,4,"PSOE",95
9,"9209",4404,2997,2950,31,47,"PSOE",789
19,"19210",18,16,16,0,0,"PSOE",2
39,"39066",866,616,606,6,10,"PSOE",174
12,"12119",139,97,94,3,3,"PSOE",13
50,"50031",134,78,75,0,3,"PSOE",28
40,"40002",32,22,21,0,1,"PSOE",4
31,"31049",679,461,453,2,8,"PSOE",37
45,"45157",2288,1490,1472,5,18,"PSOE",349
31,"31232",25687,17548,17304,243,244,"PSOE",4868
38,"38015",4055,2635,2601,16,34,"PSOE",654
50,"50225",1532,983,971,12,12,"PSOE",287
34,"34012",342,237,232,3,5,"PSOE",73
31,"31001",79,56,56,0,0,"PSOE",7
37,"37202",1004,773,763,12,10,"PSOE",221
47,"47194",295,228,227,1,1,"PSOE",70
45,"45073",288,214,210,2,4,"PSOE",75
46,"46085",11089,7581,7503,60,78,"PSOE",2123
16,"16110",90,70,70,1,0,"PSOE",3
26,"26162",108,90,89,1,1,"PSOE",32
50,"50048",33,25,25,0,0,"PSOE",14
16,"16239",118,88,87,0,1,"PSOE",45
6,"6065",293,230,228,2,2,"PSOE",98
2,"2078",891,650,642,4,8,"PSOE",244
10,"10104",5123,3470,3396,21,74,"PSOE",1153
49,"49103",392,319,316,5,3,"PSOE",71
19,"19220",2608,1673,1653,10,20,"PSOE",375
31,"31160",104,83,82,1,1,"PSOE",10
34,"34123",1634,1274,1258,4,16,"PSOE",395
21,"21075",338,243,235,3,8,"PSOE",117
16,"16240",98,71,69,0,2,"PSOE",29
24,"24005",342,218,217,0,1,"PSOE",52
31,"31235",156,112,108,1,4,"PSOE",23
46,"46245",527,407,404,2,3,"PSOE",106
31,"31906",2707,1800,1781,22,19,"PSOE",430
44,"44218",28,24,24,3,0,"PSOE",4
39,"39022",970,673,668,2,5,"PSOE",104
2,"2014",354,254,252,3,2,"PSOE",110
44,"44011",47,34,34,0,0,"PSOE",9
42,"42155",146,83,80,2,3,"PSOE",15
7,"7062",7972,3946,3896,42,50,"PSOE",1149
45,"45148",263,184,184,0,0,"PSOE",65
11,"11033",21804,13361,13133,213,228,"PSOE",4147
37,"37288",281,220,218,4,2,"PSOE",57
16,"16112",1466,972,957,12,15,"PSOE",386
45,"45038",3528,2556,2521,26,35,"PSOE",528
31,"31126",352,223,223,3,0,"PSOE",32
22,"22127",521,353,352,5,1,"PSOE",89
34,"34125",105,80,80,2,0,"PSOE",16
37,"37373",692,451,442,4,9,"PSOE",209
44,"44084",54,46,46,1,0,"PSOE",15
41,"41901",2692,2101,2051,47,50,"PSOE",1478
18,"18072",655,452,445,4,7,"PSOE",207
46,"46224",156,125,124,0,1,"PSOE",30
23,"23076",774,606,595,6,11,"PSOE",287
41,"41049",9515,6961,6843,115,118,"PSOE",2866
31,"31200",745,489,483,1,6,"PSOE",148
18,"18194",2038,1373,1348,12,25,"PSOE",602
35,"35027",10502,6831,6750,67,81,"PSOE",2000
10,"10108",203,116,116,1,0,"PSOE",43
3,"3015",12818,9127,9017,46,110,"PSOE",2305
24,"24067",602,327,324,6,3,"PSOE",63
5,"5902",286,214,211,1,3,"PSOE",49
9,"9041",25,21,21,2,0,"PSOE",10
28,"28061",22757,17091,16965,115,126,"PSOE",4004
19,"19193",22,21,21,1,0,"PSOE",13
42,"42062",20,10,10,0,0,"PSOE",4
47,"47168",30,26,26,1,0,"PSOE",1
16,"16194",219,169,161,0,8,"PSOE",104
22,"22059",1135,765,752,2,13,"PSOE",240
45,"45127",775,510,502,1,8,"PSOE",105
44,"44193",73,60,60,1,0,"PSOE",21
19,"19127",88,60,60,1,0,"PSOE",10
30,"30025",5016,3663,3623,22,40,"PSOE",1185
50,"50238",84,65,65,0,0,"PSOE",17
31,"31020",435,224,222,1,2,"PSOE",9
45,"45128",2569,1676,1652,6,24,"PSOE",549
9,"9421",240,180,180,3,0,"PSOE",51
24,"24009",274,136,135,1,1,"PSOE",44
5,"5260",95,73,73,0,0,"PSOE",11
44,"44221",386,307,304,1,3,"PSOE",93
10,"10151",189,145,142,2,3,"PSOE",78
44,"44222",125,92,92,0,0,"PSOE",19
13,"13007",1219,871,852,4,19,"PSOE",395
9,"9332",137,93,91,2,2,"PSOE",20
28,"28128",453,334,331,1,3,"PSOE",101
13,"13039",14195,10104,9933,122,171,"PSOE",3285
42,"42174",174,121,118,4,3,"PSOE",54
45,"45092",223,193,190,1,3,"PSOE",60
22,"22130",10146,6505,6436,57,69,"PSOE",2109
37,"37188",158,107,105,3,2,"PSOE",32
37,"37116",70,50,50,0,0,"PSOE",11
49,"49133",287,206,203,1,3,"PSOE",71
40,"40107",90,67,67,0,0,"PSOE",12
47,"47200",70,60,60,0,0,"PSOE",10
2,"2019",2352,1806,1766,9,40,"PSOE",765
16,"16118",1351,1022,1009,13,13,"PSOE",309
46,"46253",112,84,84,0,0,"PSOE",29
12,"12083",88,69,67,9,2,"PSOE",24
44,"44156",47,31,31,0,0,"PSOE",8
44,"44157",61,37,37,0,0,"PSOE",16
31,"31084",1946,1367,1362,9,5,"PSOE",128
30,"30028",6390,4054,3973,25,81,"PSOE",1629
22,"22012",102,75,75,2,0,"PSOE",20
31,"31902",4661,3228,3201,39,27,"PSOE",707
5,"5131",96,64,64,1,0,"PSOE",4
4,"4102",14202,9264,9139,57,125,"PSOE",2486
14,"14056",23477,15826,15470,177,356,"PSOE",5977
40,"40141",822,584,568,9,16,"PSOE",157
49,"49077",157,80,80,0,0,"PSOE",18
29,"29089",3138,2262,2186,13,76,"PSOE",808
9,"9208",176,121,120,4,1,"PSOE",26
14,"14028",302,241,240,3,1,"PSOE",125
34,"34042",294,224,221,1,3,"PSOE",61
22,"22062",154,107,107,1,0,"PSOE",31
45,"45205",7438,4772,4701,27,71,"PSOE",1296
49,"49148",259,119,115,1,4,"PSOE",34
47,"47045",732,558,549,3,9,"PSOE",198
45,"45901",779,542,534,5,8,"PSOE",181
11,"11009",579,399,390,0,9,"PSOE",136
34,"34133",101,75,73,0,2,"PSOE",9
21,"21052",4403,2688,2631,26,57,"PSOE",1359
42,"42132",140,102,101,2,1,"PSOE",23
47,"47077",234,172,170,1,2,"PSOE",25
16,"16148",544,452,451,2,1,"PSOE",122
37,"37329",38,29,28,1,1,"PSOE",1
3,"3029",236,174,172,2,2,"PSOE",66
26,"26006",1833,1358,1335,7,23,"PSOE",493
19,"19197",28,22,22,1,0,"PSOE",14
10,"10156",97,71,69,0,2,"PSOE",35
24,"24051",389,275,269,1,6,"PSOE",88
41,"41073",1684,1100,1074,7,26,"PSOE",516
44,"44129",35,29,29,1,0,"PSOE",16
7,"7060",2713,1796,1772,17,24,"PSOE",355
40,"40228",493,362,361,3,1,"PSOE",91
46,"46183",6036,4276,4213,21,63,"PSOE",915
10,"10171",347,238,219,1,19,"PSOE",122
50,"50251",8209,5732,5658,66,74,"PSOE",1921
24,"24027",1214,841,828,6,13,"PSOE",338
26,"26134",81,67,67,3,0,"PSOE",20
9,"9066",54,37,37,0,0,"PSOE",19
9,"9414",180,137,135,1,2,"PSOE",44
47,"47144",72,54,53,2,1,"PSOE",10
50,"50016",44,31,31,0,0,"PSOE",10
23,"23086",11427,7984,7735,81,249,"PSOE",3361
19,"19260",38,27,27,1,0,"PSOE",16
6,"6081",1036,760,745,2,15,"PSOE",404
42,"42209",134,86,84,4,2,"PSOE",24
5,"5266",100,79,79,1,0,"PSOE",13
6,"6127",2809,2105,2074,9,31,"PSOE",830
41,"41084",2799,2029,1937,9,92,"PSOE",943
10,"10159",314,207,207,2,0,"PSOE",96
40,"40906",2149,1701,1662,18,39,"PSOE",489
39,"39059",7518,5327,5287,23,40,"PSOE",1246
50,"50292",130,108,107,0,1,"PSOE",16
10,"10037",76966,54717,53914,546,803,"PSOE",16543
16,"16205",106,73,73,1,0,"PSOE",16
22,"22248",103,73,73,0,0,"PSOE",32
40,"40079",229,160,159,2,1,"PSOE",54
49,"49082",341,273,270,12,3,"PSOE",102
46,"46139",4520,3486,3457,18,29,"PSOE",887
37,"37142",554,396,394,5,2,"PSOE",111
40,"40145",1098,824,820,4,4,"PSOE",249
22,"22067",70,52,52,0,0,"PSOE",23
31,"31065",1843,1311,1300,12,11,"PSOE",465
45,"45173",9756,6811,6720,49,91,"PSOE",1839
47,"47049",91,58,58,0,0,"PSOE",16
10,"10038",83,59,59,0,0,"PSOE",18
34,"34049",329,229,227,1,2,"PSOE",69
16,"16206",184,126,125,4,1,"PSOE",51
19,"19046",22204,16001,15752,156,249,"PSOE",5169
9,"9906",1185,883,877,16,6,"PSOE",198
45,"45174",300,218,217,2,1,"PSOE",57
2,"2082",98,80,80,0,0,"PSOE",34
49,"49220",146,102,98,3,4,"PSOE",43
39,"39052",19005,13859,13748,83,111,"PSOE",2671
31,"31054",453,279,276,2,3,"PSOE",49
24,"24042",60,47,47,2,0,"PSOE",16
37,"37290",130,106,106,0,0,"PSOE",34
9,"9127",52,36,35,0,1,"PSOE",7
31,"31238",119,96,95,4,1,"PSOE",16
11,"11035",13751,8535,8396,125,139,"PSOE",2668
34,"34067",129,80,78,1,2,"PSOE",45
28,"28116",748,576,569,2,7,"PSOE",134
41,"41087",10557,7217,7029,67,188,"PSOE",2323
31,"31030",135,94,94,0,0,"PSOE",17
38,"38011",21655,13974,13831,106,143,"PSOE",3934
10,"10122",219,159,157,2,2,"PSOE",61
37,"37145",236,173,170,3,3,"PSOE",67
5,"5140",99,83,81,0,2,"PSOE",16
28,"28149",6298,4751,4699,35,52,"PSOE",1084
49,"49119",217,158,156,2,2,"PSOE",74
34,"34196",87,67,67,3,0,"PSOE",16
22,"22181",86,55,54,2,1,"PSOE",21
50,"50094",1500,1041,1022,12,19,"PSOE",390
31,"31068",2816,2028,1989,20,39,"PSOE",822
16,"16211",335,228,227,1,1,"PSOE",105
49,"49011",214,147,146,5,1,"PSOE",16
33,"33025",8956,5493,5453,81,40,"PSOE",1940
22,"22072",197,127,126,1,1,"PSOE",36
34,"34146",53,43,43,0,0,"PSOE",16
9,"9438",562,447,437,6,10,"PSOE",143
44,"44203",9,9,9,0,0,"PSOE",2
40,"40018",73,50,50,0,0,"PSOE",5
47,"47159",825,672,661,0,11,"PSOE",258
16,"16167",288,225,217,0,8,"PSOE",105
37,"37346",251,208,207,1,1,"PSOE",48
29,"29033",1084,733,722,5,11,"PSOE",316
18,"18120",266,204,204,4,0,"PSOE",126
50,"50247",852,600,594,8,6,"PSOE",152
10,"10043",746,525,520,4,5,"PSOE",280
13,"13085",2265,1768,1735,5,33,"PSOE",705
16,"16052",539,422,419,3,3,"PSOE",180
21,"21059",221,169,163,1,6,"PSOE",123
40,"40150",60,42,42,0,0,"PSOE",10
4,"4078",1127,725,718,8,7,"PSOE",271
5,"5077",154,113,110,0,3,"PSOE",34
31,"31070",2633,1714,1682,16,32,"PSOE",551
42,"42161",136,99,99,0,0,"PSOE",17
44,"44075",321,255,252,1,3,"PSOE",42
10,"10060",921,615,596,4,19,"PSOE",260
37,"37058",56,38,38,1,0,"PSOE",8
41,"41053",21693,15843,15379,171,464,"PSOE",6141
41,"41098",5161,3792,3732,33,60,"PSOE",1326
44,"44195",82,58,57,0,1,"PSOE",18
42,"42001",250,172,172,3,0,"PSOE",69
9,"9335",86,66,66,3,0,"PSOE",25
5,"5175",144,109,109,0,0,"PSOE",19
29,"29099",969,688,669,11,19,"PSOE",308
22,"22253",56,40,40,1,0,"PSOE",13
42,"42084",20,15,15,0,0,"PSOE",3
5,"5905",214,148,142,1,6,"PSOE",28
28,"28120",1220,910,897,5,13,"PSOE",277
44,"44088",24,23,23,0,0,"PSOE",6
9,"9224",147,113,112,0,1,"PSOE",17
24,"24024",636,407,403,6,4,"PSOE",84
9,"9391",347,247,246,2,1,"PSOE",80
38,"38038",165135,101564,100807,709,757,"PSOE",27612
50,"50096",34,22,22,0,0,"PSOE",8
42,"42085",179,107,106,2,1,"PSOE",23
6,"6093",4325,3176,3073,26,103,"PSOE",1204
31,"31024",100,52,52,0,0,"PSOE",5
49,"49114",40,31,27,0,4,"PSOE",9
30,"30902",8294,5235,5174,29,61,"PSOE",1596
46,"46114",552,417,412,6,5,"PSOE",107
45,"45108",465,343,341,0,2,"PSOE",134
41,"41036",3903,2708,2645,35,63,"PSOE",992
50,"50176",220,142,142,3,0,"PSOE",52
9,"9119",42,24,24,0,0,"PSOE",9
24,"24210",524,353,353,1,0,"PSOE",134
9,"9394",668,432,429,6,3,"PSOE",187
29,"29054",42538,28080,27814,225,266,"PSOE",7176
50,"50098",162,119,118,1,1,"PSOE",38
18,"18028",898,723,718,3,5,"PSOE",273
40,"40143",82,68,67,2,1,"PSOE",16
46,"46145",22215,15688,15538,127,150,"PSOE",4333
5,"5037",210,135,135,0,0,"PSOE",32
9,"9377",626,468,460,6,8,"PSOE",93
26,"26069",230,166,166,0,0,"PSOE",49
9,"9137",187,129,127,0,2,"PSOE",33
28,"28027",1215,836,826,8,10,"PSOE",248
45,"45062",1075,816,808,11,8,"PSOE",234
21,"21064",6674,4503,4426,68,77,"PSOE",1871
29,"29901",44757,29291,28960,307,331,"PSOE",7455
39,"39067",753,476,474,1,2,"PSOE",113
44,"44236",60,38,38,0,0,"PSOE",4
9,"9228",155,129,129,0,0,"PSOE",32
40,"40056",31,21,20,0,1,"PSOE",3
46,"46123",1926,1392,1368,11,24,"PSOE",305
28,"28123",62178,49883,49515,397,368,"PSOE",13812
40,"40155",3897,2920,2880,56,40,"PSOE",844
26,"26020",449,319,313,1,6,"PSOE",93
18,"18094",2299,1712,1652,20,60,"PSOE",596
24,"24212",983,693,684,10,9,"PSOE",244
46,"46032",5719,4297,4262,35,35,"PSOE",1174
3,"3013",1063,809,794,3,15,"PSOE",251
24,"24028",367,275,273,5,2,"PSOE",98
16,"16060",715,519,513,3,6,"PSOE",194
10,"10173",558,389,385,5,4,"PSOE",127
18,"18029",1812,1104,1065,7,39,"PSOE",482
49,"49093",280,226,223,5,3,"PSOE",93
18,"18095",2054,1475,1433,14,42,"PSOE",556
29,"29057",330,222,218,2,4,"PSOE",116
50,"50178",269,165,163,6,2,"PSOE",81
26,"26021",2742,1967,1932,14,35,"PSOE",593
38,"38041",7025,4729,4684,42,45,"PSOE",1013
19,"19009",263,186,184,0,2,"PSOE",77
9,"9230",33,26,26,0,0,"PSOE",1
24,"24139",2071,1371,1346,15,25,"PSOE",403
42,"42010",21,15,14,0,1,"PSOE",2
33,"33004",65304,43473,43153,563,320,"PSOE",14268
6,"6129",577,438,416,1,22,"PSOE",206
44,"44200",39,26,26,0,0,"PSOE",3
47,"47113",134,110,110,0,0,"PSOE",41
10,"10039",400,256,217,0,39,"PSOE",55
22,"22089",274,195,193,2,2,"PSOE",62
26,"26072",287,239,235,3,4,"PSOE",93
42,"42187",58,44,39,1,5,"PSOE",5
40,"40221",50,38,35,0,3,"PSOE",8
22,"22168",22,20,19,0,1,"PSOE",9
45,"45162",630,448,438,1,10,"PSOE",171
18,"18064",366,289,286,0,3,"PSOE",132
26,"26086",15,15,15,0,0,"PSOE",1
50,"50137",958,740,731,8,9,"PSOE",289
49,"49021",14204,9429,9295,87,134,"PSOE",3154
10,"10054",523,389,380,1,9,"PSOE",192
9,"9072",331,261,260,4,1,"PSOE",93
16,"16177",83,65,65,1,0,"PSOE",18
9,"9405",122,94,91,0,3,"PSOE",23
46,"46057",463,308,304,1,4,"PSOE",67
5,"5214",28,18,18,0,0,"PSOE",3
37,"37281",39,28,27,0,1,"PSOE",11
47,"47001",52,43,42,1,1,"PSOE",1
18,"18128",332,263,260,1,3,"PSOE",74
44,"44061",77,60,58,1,2,"PSOE",18
10,"10137",394,297,296,3,1,"PSOE",134
12,"12009",17943,12389,12292,102,97,"PSOE",3461
49,"49167",180,131,131,2,0,"PSOE",49
24,"24217",135,93,93,0,0,"PSOE",21
40,"40222",161,134,131,1,3,"PSOE",50
42,"42051",15,9,9,0,0,"PSOE",0
18,"18901",489,323,322,5,1,"PSOE",94
10,"10015",630,429,424,1,5,"PSOE",173
34,"34112",39,31,31,0,0,"PSOE",7
3,"3072",352,281,277,3,4,"PSOE",87
45,"45116",666,492,489,4,3,"PSOE",167
9,"9352",102,74,74,0,0,"PSOE",20
33,"33054",1601,1025,1010,17,15,"PSOE",367
49,"49034",408,282,281,2,1,"PSOE",78
23,"23032",529,427,419,5,8,"PSOE",266
6,"6013",261,209,204,4,5,"PSOE",138
50,"50156",212,156,151,2,5,"PSOE",67
5,"5173",60,54,54,0,0,"PSOE",7
35,"35028",10156,5483,5425,56,58,"PSOE",1529
50,"50231",253,199,195,4,4,"PSOE",68
47,"47222",85,70,70,1,0,"PSOE",16
50,"50105",277,203,198,4,5,"PSOE",68
44,"44099",644,422,421,2,1,"PSOE",168
34,"34055",254,185,184,3,1,"PSOE",48
37,"37003",104,75,75,2,0,"PSOE",19
18,"18045",1065,720,690,11,30,"PSOE",335
2,"2043",1165,872,858,6,14,"PSOE",362
50,"50175",907,638,632,11,6,"PSOE",216
40,"40120",195,169,163,0,6,"PSOE",48
37,"37211",208,148,148,0,0,"PSOE",30
34,"34027",1049,677,665,15,12,"PSOE",267
3,"3074",1766,1347,1336,4,11,"PSOE",295
28,"28129",8589,6397,6338,46,59,"PSOE",1413
40,"40063",6913,4948,4838,57,110,"PSOE",1594
5,"5185",96,63,61,1,2,"PSOE",9
26,"26143",260,197,192,1,5,"PSOE",55
13,"13041",236,155,155,3,0,"PSOE",53
29,"29062",658,557,551,2,6,"PSOE",268
50,"50030",197,124,124,1,0,"PSOE",41
9,"9078",32,27,27,0,0,"PSOE",10
50,"50133",98,76,76,0,0,"PSOE",41
44,"44243",25,19,19,0,0,"PSOE",3
22,"22232",88,61,61,2,0,"PSOE",16
28,"28055",944,636,627,4,9,"PSOE",238
50,"50258",53,25,25,1,0,"PSOE",4
10,"10142",833,555,539,0,16,"PSOE",268
9,"9134",217,142,138,1,4,"PSOE",49
5,"5209",74,58,58,1,0,"PSOE",12
29,"29007",28907,20371,20129,254,242,"PSOE",5042
5,"5057",2418,1785,1748,9,37,"PSOE",625
33,"33066",42818,27780,27466,425,314,"PSOE",8656
37,"37129",248,181,181,1,0,"PSOE",63
24,"24037",330,189,189,1,0,"PSOE",48
40,"40065",467,338,329,1,9,"PSOE",81
16,"16280",163,122,119,2,3,"PSOE",47
3,"3076",8846,6105,6029,40,76,"PSOE",1854
47,"47131",167,122,120,2,2,"PSOE",46
40,"40055",31,26,26,0,0,"PSOE",12
50,"50185",140,93,92,1,1,"PSOE",20
23,"23012",4004,2726,2689,21,37,"PSOE",1194
31,"31196",31,23,23,0,0,"PSOE",3
7,"7038",2046,1416,1406,12,10,"PSOE",321
22,"22223",77,60,59,2,1,"PSOE",26
10,"10049",3752,2949,2864,25,85,"PSOE",1286
10,"10091",351,275,271,2,4,"PSOE",84
47,"47007",4051,2987,2954,27,33,"PSOE",785
2,"2012",1835,1462,1420,9,42,"PSOE",631
14,"14021",260521,185270,183300,2192,1970,"PSOE",46855
40,"40132",45,26,25,0,1,"PSOE",4
42,"42058",103,74,72,1,2,"PSOE",14
6,"6111",487,318,314,2,4,"PSOE",168
47,"47132",39,32,32,1,0,"PSOE",4
34,"34074",690,502,490,13,12,"PSOE",193
24,"24151",433,307,304,1,3,"PSOE",107
12,"12120",149,125,121,3,4,"PSOE",33
11,"11032",54731,31560,31284,492,276,"PSOE",9775
5,"5189",397,293,291,3,2,"PSOE",112
28,"28058",141836,104142,103011,896,1131,"PSOE",34486
34,"34076",532,443,438,1,5,"PSOE",114
46,"46131",49805,35527,35231,298,296,"PSOE",9493
13,"13047",5782,4232,4160,27,72,"PSOE",1655
33,"33013",430,294,292,1,2,"PSOE",82
19,"19124",378,230,229,2,1,"PSOE",88
34,"34077",395,282,278,7,4,"PSOE",86
45,"45197",1888,1446,1426,5,20,"PSOE",606
49,"49105",135,94,94,2,0,"PSOE",24
44,"44040",189,153,150,1,3,"PSOE",43
18,"18907",1762,1358,1351,4,7,"PSOE",638
18,"18011",4403,3002,2947,24,55,"PSOE",1084
21,"21045",231,177,174,4,3,"PSOE",86
33,"33069",3379,2249,2231,41,18,"PSOE",886
31,"31090",139,67,67,0,0,"PSOE",12
19,"19055",44,32,31,2,1,"PSOE",10
50,"50059",757,556,551,5,5,"PSOE",203
42,"42185",24,20,20,0,0,"PSOE",6
50,"50179",255,197,197,0,0,"PSOE",81
34,"34050",187,136,136,1,0,"PSOE",41
19,"19172",51,38,38,0,0,"PSOE",14
38,"38010",3969,2463,2418,11,45,"PSOE",920
10,"10026",647,464,452,6,12,"PSOE",156
45,"45089",1432,1076,1064,10,12,"PSOE",449
16,"16244",698,598,585,7,13,"PSOE",277
16,"16140",18,14,14,1,0,"PSOE",10
39,"39099",3193,2363,2346,10,17,"PSOE",522
42,"42200",74,49,46,0,3,"PSOE",8
33,"33061",344,174,174,1,0,"PSOE",66
40,"40028",103,88,87,2,1,"PSOE",14
3,"3024",3937,2992,2952,19,40,"PSOE",976
13,"13050",475,348,345,1,3,"PSOE",113
40,"40071",39,32,26,0,6,"PSOE",3
9,"9419",67,52,49,0,3,"PSOE",7
41,"41022",4255,2735,2667,32,68,"PSOE",1340
26,"26112",218,152,148,1,4,"PSOE",49
46,"46247",972,649,646,3,3,"PSOE",152
19,"19319",4609,3303,3273,22,30,"PSOE",806
37,"37291",269,186,185,1,1,"PSOE",52
2,"2050",85,66,66,1,0,"PSOE",22
37,"37001",165,120,120,0,0,"PSOE",45
31,"31019",1831,1231,1224,17,7,"PSOE",230
24,"24043",116,54,52,0,2,"PSOE",29
26,"26152",27,20,20,1,0,"PSOE",4
42,"42024",84,64,62,1,2,"PSOE",18
23,"23079",3624,2661,2630,19,31,"PSOE",1073
22,"22206",179,138,137,0,1,"PSOE",67
21,"21079",678,428,417,2,11,"PSOE",208
9,"9091",686,479,467,4,12,"PSOE",116
45,"45202",3963,2806,2771,10,35,"PSOE",870
5,"5193",179,140,139,2,1,"PSOE",43
18,"18087",182877,131811,130184,1106,1627,"PSOE",34749
19,"19015",82,74,73,1,1,"PSOE",29
50,"50021",25,21,21,0,0,"PSOE",1
33,"33045",4359,2819,2787,32,32,"PSOE",1183
41,"41052",3032,2162,2092,6,70,"PSOE",1071
6,"6073",703,451,441,6,10,"PSOE",171
40,"40223",235,177,174,1,3,"PSOE",56
38,"38004",4536,2914,2887,28,27,"PSOE",907
47,"47105",169,138,137,2,1,"PSOE",51
26,"26115",23,22,21,3,1,"PSOE",3
40,"40902",113,78,76,1,2,"PSOE",14
9,"9094",53,42,42,0,0,"PSOE",9
44,"44165",168,125,125,2,0,"PSOE",37
10,"10153",281,183,181,0,2,"PSOE",54
37,"37147",184,126,124,1,2,"PSOE",43
34,"34056",1926,1335,1311,10,24,"PSOE",401
19,"19016",57,40,40,0,0,"PSOE",21
31,"31242",258,168,167,2,1,"PSOE",22
10,"10141",284,207,205,1,2,"PSOE",93
3,"3083",5479,3736,3674,39,62,"PSOE",1340
45,"45204",630,453,449,1,4,"PSOE",161
50,"50115",3279,2170,2131,27,39,"PSOE",717
5,"5035",92,68,68,0,0,"PSOE",26
45,"45131",259,219,216,1,3,"PSOE",74
26,"26157",283,222,217,0,5,"PSOE",54
50,"50265",74,54,54,1,0,"PSOE",12
51,"51001",59820,33614,33265,323,349,"PSOE",10405
44,"44196",121,88,88,0,0,"PSOE",40
49,"49113",162,131,131,2,0,"PSOE",21
13,"13057",1099,858,849,2,9,"PSOE",321
24,"24159",1716,1238,1216,6,22,"PSOE",251
5,"5263",162,117,115,1,2,"PSOE",20
24,"24012",278,182,180,0,2,"PSOE",45
46,"46254",944,673,661,6,12,"PSOE",217
42,"42207",48,42,41,0,1,"PSOE",8
23,"23047",1558,1203,1186,8,17,"PSOE",569
37,"37359",165,105,103,0,2,"PSOE",22
29,"29090",1649,1138,1124,10,14,"PSOE",300
9,"9152",244,161,161,0,0,"PSOE",51
13,"13058",4026,2822,2766,29,56,"PSOE",992
34,"34234",66,48,45,0,3,"PSOE",12
19,"19258",84,63,62,0,1,"PSOE",15
34,"34088",265,195,191,1,4,"PSOE",59
44,"44257",149,92,91,0,1,"PSOE",25
2,"2055",1055,672,668,2,4,"PSOE",337
9,"9261",446,279,271,2,8,"PSOE",90
4,"4901",490,343,343,2,0,"PSOE",151
30,"30005",30268,20979,20778,148,201,"PSOE",4639
50,"50169",333,231,230,0,1,"PSOE",77
14,"14058",7866,5451,5334,69,117,"PSOE",1912
2,"2056",1640,1204,1179,11,25,"PSOE",517
49,"49275",51064,34471,34017,475,454,"PSOE",11353
39,"39021",464,370,364,1,6,"PSOE",107
47,"47099",154,123,118,0,5,"PSOE",27
24,"24076",1283,926,913,10,13,"PSOE",309
31,"31099",51,38,38,0,0,"PSOE",13
46,"46047",540,428,420,1,8,"PSOE",155
46,"46138",361,289,287,1,2,"PSOE",91
5,"5070",30,29,29,0,0,"PSOE",13
9,"9213",264,182,182,1,0,"PSOE",38
5,"5265",83,59,58,1,1,"PSOE",9
5,"5198",70,53,51,0,2,"PSOE",6
42,"42120",131,87,86,1,1,"PSOE",31
34,"34238",294,238,236,1,2,"PSOE",112
12,"12024",138,107,107,1,0,"PSOE",33
39,"39003",261,189,187,2,2,"PSOE",33
22,"22004",123,83,83,0,0,"PSOE",27
28,"28008",2008,1333,1323,7,10,"PSOE",335
31,"31173",845,642,636,4,6,"PSOE",243
16,"16161",51,44,44,1,0,"PSOE",14
29,"29047",1082,860,846,0,14,"PSOE",428
46,"46116",13606,10262,10200,87,62,"PSOE",2522
14,"14032",388,302,293,0,9,"PSOE",122
40,"40178",85,61,60,0,1,"PSOE",4
50,"50118",2101,1484,1477,17,7,"PSOE",630
42,"42121",54,39,39,0,0,"PSOE",15
3,"3060",105,78,77,0,1,"PSOE",20
47,"47080",33,25,24,0,1,"PSOE",3
46,"46071",471,355,349,1,6,"PSOE",129
26,"26046",1552,1056,1027,11,29,"PSOE",375
13,"13063",3648,2464,2406,28,58,"PSOE",802
6,"6038",785,561,550,5,11,"PSOE",254
39,"39004",1479,1050,1031,5,19,"PSOE",281
37,"37039",279,202,197,2,5,"PSOE",59
9,"9108",433,315,311,3,4,"PSOE",116
19,"19036",242,202,200,1,2,"PSOE",71
42,"42078",1000,653,640,5,13,"PSOE",199
9,"9056",4833,3191,3156,37,35,"PSOE",856
3,"3119",17253,12346,12258,81,88,"PSOE",3242
37,"37009",197,145,144,1,1,"PSOE",41
49,"49083",47,37,37,1,0,"PSOE",4
28,"28030",1832,1319,1297,13,22,"PSOE",337
6,"6161",289,199,197,1,2,"PSOE",106
16,"16025",24,20,20,0,0,"PSOE",5
18,"18042",417,332,330,4,2,"PSOE",126
19,"19126",1701,1223,1207,6,16,"PSOE",280
9,"9010",33,25,25,2,0,"PSOE",4
47,"47020",270,212,207,5,5,"PSOE",58
35,"35019",32830,18390,18243,87,147,"PSOE",5485
3,"3120",2433,1688,1652,13,36,"PSOE",534
3,"3034",1404,1028,1010,5,18,"PSOE",276
44,"44144",319,225,223,0,2,"PSOE",104
10,"10082",1793,1333,1305,11,28,"PSOE",699
14,"14062",945,700,693,2,7,"PSOE",347
7,"7009",737,495,488,3,7,"PSOE",121
7,"7043",3431,2196,2166,21,30,"PSOE",418
45,"45066",7815,5540,5447,25,93,"PSOE",1510
4,"4043",517,398,395,1,3,"PSOE",150
5,"5204",578,445,442,3,3,"PSOE",129
46,"46073",1066,823,817,11,6,"PSOE",287
37,"37241",167,121,119,3,2,"PSOE",23
14,"14035",5774,4076,4017,35,59,"PSOE",1481
31,"31105",1471,1144,1124,10,20,"PSOE",371
37,"37365",162,125,121,0,4,"PSOE",26
10,"10083",96,76,74,0,2,"PSOE",17
47,"47211",48,37,37,1,0,"PSOE",3
10,"10205",1934,1071,1042,4,29,"PSOE",499
33,"33053",1078,602,599,10,3,"PSOE",265
28,"28150",3191,2423,2401,13,22,"PSOE",494
38,"38044",2215,1270,1257,5,13,"PSOE",405
22,"22042",116,91,89,1,2,"PSOE",28
9,"9113",453,321,315,8,6,"PSOE",101
19,"19039",56,48,48,2,0,"PSOE",15
10,"10084",1266,755,717,7,38,"PSOE",331
22,"22109",261,184,183,1,1,"PSOE",46
44,"44087",67,52,50,0,2,"PSOE",15
16,"16213",34,27,26,0,1,"PSOE",8
24,"24058",189,115,114,1,1,"PSOE",30
28,"28013",41661,29431,29168,241,263,"PSOE",8176
28,"28085",4194,3126,3091,24,35,"PSOE",891
34,"34202",28,23,23,2,0,"PSOE",4
24,"24118",101,72,72,0,0,"PSOE",32
42,"42115",89,68,66,0,2,"PSOE",7
47,"47203",54,40,40,0,0,"PSOE",4
38,"38005",5646,3302,3283,24,19,"PSOE",1133
46,"46204",6625,4946,4882,52,64,"PSOE",1605
44,"44026",100,73,72,0,1,"PSOE",15
22,"22186",189,148,145,3,3,"PSOE",68
46,"46098",2405,1778,1751,7,27,"PSOE",392
24,"24132",610,330,329,5,1,"PSOE",98
10,"10207",455,298,291,0,7,"PSOE",130
14,"14065",1820,1374,1352,13,22,"PSOE",508
28,"28075",6020,4521,4469,37,52,"PSOE",1082
44,"44176",152,114,113,1,1,"PSOE",36
19,"19333",96,68,67,0,1,"PSOE",34
45,"45107",3463,2621,2585,23,36,"PSOE",792
24,"24209",2597,1651,1636,12,15,"PSOE",656
10,"10087",1588,1105,1093,10,12,"PSOE",462
18,"18057",5584,4042,3958,51,84,"PSOE",1185
12,"12110",222,156,155,3,1,"PSOE",76
28,"28183",1162,823,813,9,10,"PSOE",196
39,"39094",840,611,611,2,0,"PSOE",91
5,"5112",95,59,58,0,1,"PSOE",9
9,"9117",71,58,58,0,0,"PSOE",14
39,"39010",610,457,453,1,4,"PSOE",117
28,"28016",79,55,55,0,0,"PSOE",17
9,"9064",305,225,219,6,6,"PSOE",52
33,"33029",315,145,142,1,3,"PSOE",78
19,"19006",755,506,494,4,12,"PSOE",171
12,"12085",5081,3271,3235,17,36,"PSOE",923
31,"31073",298,207,206,1,1,"PSOE",25
21,"21032",1827,1337,1314,13,23,"PSOE",675
6,"6003",768,579,557,4,22,"PSOE",279
12,"12032",23728,16870,16726,121,144,"PSOE",4472
5,"5113",62,42,42,0,0,"PSOE",6
26,"26172",25,16,15,0,1,"PSOE",9
24,"24062",126,79,79,0,0,"PSOE",34
19,"19043",99,80,79,0,1,"PSOE",30
42,"42006",154,105,103,0,2,"PSOE",33
33,"33057",1525,1005,988,17,17,"PSOE",419
46,"46206",555,417,408,0,9,"PSOE",164
34,"34089",141,102,101,4,1,"PSOE",17
2,"2001",687,513,505,1,8,"PSOE",177
14,"14068",517,388,378,3,10,"PSOE",182
10,"10131",12803,8477,8347,77,130,"PSOE",2451
49,"49017",247,176,176,1,0,"PSOE",28
5,"5081",37,21,21,3,0,"PSOE",1
37,"37371",252,156,155,0,1,"PSOE",58
39,"39096",669,451,450,1,1,"PSOE",91
31,"31111",91,52,52,0,0,"PSOE",6
7,"7016",2970,1891,1865,22,26,"PSOE",529
21,"21003",684,476,452,4,24,"PSOE",295
26,"26057",50,45,45,2,0,"PSOE",20
13,"13076",455,359,356,0,3,"PSOE",162
16,"16098",521,418,415,2,3,"PSOE",177
46,"46009",3144,2473,2449,22,24,"PSOE",698
9,"9176",58,46,45,2,1,"PSOE",6
44,"44092",70,53,52,0,1,"PSOE",9
42,"42139",21,16,16,2,0,"PSOE",2
41,"41038",102752,71545,70538,980,1007,"PSOE",24678
9,"9446",10,7,7,0,0,"PSOE",3
40,"40089",209,155,148,2,7,"PSOE",21
46,"46215",1407,1088,1068,10,20,"PSOE",341
26,"26175",47,40,38,1,2,"PSOE",12
16,"16224",72,60,58,0,2,"PSOE",18
23,"23062",1410,1094,1076,0,18,"PSOE",520
19,"19045",122,97,96,0,1,"PSOE",15
21,"21005",15754,9502,9340,84,162,"PSOE",3308
47,"47090",2447,1823,1784,15,39,"PSOE",578
44,"44180",74,56,56,0,0,"PSOE",15
5,"5116",96,68,68,0,0,"PSOE",11
33,"33032",11056,7052,6905,109,147,"PSOE",2968
46,"46125",852,660,650,5,10,"PSOE",216
10,"10052",172,114,113,3,1,"PSOE",12
13,"13079",12233,8274,8138,93,136,"PSOE",3105
49,"49230",84,69,69,0,0,"PSOE",33
19,"19232",56,40,40,0,0,"PSOE",11
47,"47070",29,24,24,0,0,"PSOE",3
50,"50262",1161,849,832,11,17,"PSOE",368
44,"44210",750,577,572,2,5,"PSOE",164
40,"40125",76,48,46,0,2,"PSOE",17
31,"31151",53,37,37,0,0,"PSOE",9
26,"26150",97,77,77,1,0,"PSOE",36
24,"24202",7504,4607,4538,51,69,"PSOE",1938
50,"50068",1943,1299,1287,10,12,"PSOE",517
34,"34109",60,34,34,0,0,"PSOE",3
46,"46103",1354,993,978,8,15,"PSOE",243
10,"10095",317,245,239,0,6,"PSOE",110
31,"31226",572,347,343,4,4,"PSOE",62
5,"5118",64,41,41,1,0,"PSOE",9
10,"10217",506,378,377,3,1,"PSOE",141
24,"24176",302,232,226,0,6,"PSOE",50
21,"21067",406,274,271,3,3,"PSOE",159
42,"42092",61,40,39,0,1,"PSOE",5
24,"24142",24715,16839,16616,159,223,"PSOE",5572
26,"26178",72,56,56,1,0,"PSOE",27
29,"29003",916,677,666,4,11,"PSOE",321
13,"13036",752,552,546,1,6,"PSOE",213
49,"49131",231,149,145,1,4,"PSOE",44
46,"46195",2000,1540,1532,3,8,"PSOE",473
2,"2039",945,745,734,8,11,"PSOE",322
40,"40159",130,94,93,2,1,"PSOE",21
31,"31153",2174,1417,1415,12,2,"PSOE",207
5,"5053",76,48,48,0,0,"PSOE",5
50,"50130",354,225,222,1,3,"PSOE",75
10,"10138",527,386,379,2,7,"PSOE",223
40,"40128",123,88,87,1,1,"PSOE",29
5,"5153",86,58,56,3,2,"PSOE",12
5,"5216",209,149,149,0,0,"PSOE",29
28,"28043",6190,4031,3969,33,62,"PSOE",1050
26,"26026",1268,986,970,4,16,"PSOE",366
26,"26141",98,70,70,0,0,"PSOE",12
26,"26102",6076,4276,4205,52,71,"PSOE",1455
21,"21069",1681,1073,1056,9,17,"PSOE",547
23,"23033",1325,1008,989,11,19,"PSOE",368
9,"9408",40,29,29,0,0,"PSOE",2
47,"47094",120,100,100,0,0,"PSOE",35
16,"16104",53,42,42,0,0,"PSOE",18
50,"50054",55,37,37,2,0,"PSOE",10
40,"40094",353,265,263,3,2,"PSOE",71
12,"12092",123,95,95,0,0,"PSOE",16
40,"40083",73,52,52,1,0,"PSOE",1
6,"6045",467,347,346,6,1,"PSOE",172
9,"9149",36,29,29,0,0,"PSOE",9
28,"28044",6266,4693,4642,36,51,"PSOE",1104
37,"37243",89,66,66,0,0,"PSOE",10
31,"31901",15487,11077,10991,117,86,"PSOE",2960
26,"26104",10,9,9,1,0,"PSOE",2
34,"34116",54,35,35,0,0,"PSOE",7
31,"31047",238,163,163,2,0,"PSOE",43
46,"46219",125,107,104,0,3,"PSOE",29
31,"31230",90,66,66,0,0,"PSOE",14
26,"26064",2335,1617,1584,28,33,"PSOE",571
9,"9298",72,52,52,1,0,"PSOE",3
10,"10902",744,514,498,4,16,"PSOE",231
24,"24071",947,618,611,6,7,"PSOE",231
34,"34220",152,133,132,1,1,"PSOE",40
10,"10903",806,555,545,8,10,"PSOE",248
46,"46083",15372,10939,10815,78,124,"PSOE",2244
42,"42192",36,22,22,2,0,"PSOE",9
44,"44185",88,69,69,2,0,"PSOE",14
35,"35007",517,347,345,2,2,"PSOE",79
3,"3134",139,107,107,0,0,"PSOE",33
22,"22200",239,165,164,2,1,"PSOE",46
24,"24181",1404,944,925,7,19,"PSOE",369
21,"21011",3500,2371,2314,23,57,"PSOE",1177
31,"31048",166,121,119,1,2,"PSOE",20
24,"24073",437,285,282,1,3,"PSOE",85
44,"44216",27003,19997,19909,80,88,"PSOE",3268
10,"10102",496,378,377,1,1,"PSOE",219
31,"31903",6950,4430,4394,39,36,"PSOE",1292
3,"3048",4993,3549,3502,13,47,"PSOE",830
50,"50282",55,38,38,1,0,"PSOE",8
42,"42018",127,94,94,1,0,"PSOE",17
41,"41045",5873,3901,3802,53,99,"PSOE",1480
3,"3105",5510,3879,3792,27,87,"PSOE",1068
37,"37161",123,86,86,0,0,"PSOE",17
22,"22233",81,53,53,0,0,"PSOE",27
44,"44245",240,177,174,0,3,"PSOE",43
9,"9413",405,267,263,0,4,"PSOE",66
12,"12112",102,79,79,1,0,"PSOE",28
40,"40003",116,82,79,3,3,"PSOE",8
22,"22125",39530,27358,27075,344,283,"PSOE",9226
5,"5024",193,127,125,2,2,"PSOE",32
24,"24004",495,387,384,10,3,"PSOE",92
44,"44158",1153,879,872,6,7,"PSOE",219
6,"6156",1170,829,814,12,15,"PSOE",357
24,"24039",1949,1420,1412,33,8,"PSOE",375
10,"10063",159,130,130,0,0,"PSOE",54
40,"40068",22,21,21,0,0,"PSOE",2
42,"42103",543,383,374,2,9,"PSOE",100
19,"19091",23,17,17,0,0,"PSOE",5
9,"9304",198,152,149,1,3,"PSOE",23
49,"49250",1191,844,824,8,20,"PSOE",256
47,"47068",29,21,21,0,0,"PSOE",5
24,"24184",177,106,105,0,1,"PSOE",37
3,"3078",468,340,336,0,4,"PSOE",68
31,"31124",207,134,134,2,0,"PSOE",18
40,"40004",436,330,319,2,11,"PSOE",109
7,"7028",944,635,628,2,7,"PSOE",128
14,"14050",2350,1774,1720,20,54,"PSOE",553
31,"31015",1989,1399,1386,17,13,"PSOE",455
41,"41047",10449,7884,7770,119,114,"PSOE",2302
21,"21014",4066,3089,3029,30,60,"PSOE",1384
49,"49029",609,435,419,6,16,"PSOE",75
50,"50260",35,31,31,0,0,"PSOE",7
4,"4063",1058,766,750,6,16,"PSOE",256
26,"26034",606,457,440,5,17,"PSOE",195
6,"6068",427,298,294,5,4,"PSOE",167
12,"12121",1043,878,856,5,22,"PSOE",365
11,"11003",1230,802,787,9,15,"PSOE",276
46,"46132",2176,1725,1708,5,17,"PSOE",468
44,"44105",68,53,53,0,0,"PSOE",20
16,"16001",62,45,45,0,0,"PSOE",17
49,"49141",290,191,191,1,0,"PSOE",87
31,"31199",138,86,84,0,2,"PSOE",12
47,"47196",29,21,21,0,0,"PSOE",1
42,"42123",157,103,102,6,1,"PSOE",32
10,"10202",583,457,453,1,4,"PSOE",172
10,"10148",33054,21731,21379,231,352,"PSOE",7179
37,"37259",39,28,28,1,0,"PSOE",3
50,"50298",5439,4053,4007,41,46,"PSOE",1252
9,"9347",140,111,107,1,4,"PSOE",24
28,"28020",193,96,93,0,3,"PSOE",20
5,"5245",353,262,256,0,6,"PSOE",50
37,"37196",70,50,50,0,0,"PSOE",17
29,"29012",9718,6664,6553,85,111,"PSOE",2649
49,"49142",244,163,160,0,3,"PSOE",71
44,"44192",341,274,272,2,2,"PSOE",74
31,"31018",426,287,283,2,4,"PSOE",91
28,"28031",2129,1501,1486,8,15,"PSOE",495
46,"46133",462,359,352,1,7,"PSOE",190
34,"34229",58,47,47,1,0,"PSOE",10
9,"9476",60,46,46,0,0,"PSOE",13
9,"9090",49,41,39,2,2,"PSOE",1
3,"3081",1492,1070,1044,12,26,"PSOE",272
41,"41095",40187,27090,26680,512,410,"PSOE",10144
6,"6072",2211,1610,1586,11,24,"PSOE",659
40,"40105",43,35,35,0,0,"PSOE",4
2,"2083",209,181,181,0,0,"PSOE",88
6,"6026",804,578,562,5,16,"PSOE",234
45,"45091",376,270,269,3,1,"PSOE",115
49,"49256",236,183,179,0,4,"PSOE",47
21,"21018",1719,1048,1029,12,19,"PSOE",591
46,"46225",351,267,262,1,5,"PSOE",58
2,"2084",298,197,191,2,6,"PSOE",71
5,"5030",40,32,32,0,0,"PSOE",12
46,"46020",3757,2834,2783,16,51,"PSOE",822
9,"9044",55,46,44,1,2,"PSOE",14
47,"47063",86,68,68,0,0,"PSOE",12
31,"31130",321,203,203,0,0,"PSOE",28
40,"40008",42,36,36,1,0,"PSOE",13
6,"6028",4098,3457,3350,22,107,"PSOE",1534
33,"33073",8096,4377,4320,59,57,"PSOE",1481
22,"22243",43,32,31,0,1,"PSOE",11
6,"6029",1174,873,865,5,8,"PSOE",565
3,"3082",12941,8399,8304,51,95,"PSOE",2201
31,"31094",105,70,70,1,0,"PSOE",20
30,"30035",19432,13174,13013,114,161,"PSOE",2531
16,"16117",1018,723,715,9,8,"PSOE",321
24,"24191",106,70,69,2,1,"PSOE",20
16,"16082",272,194,192,1,2,"PSOE",84
19,"19226",37,22,22,0,0,"PSOE",11
26,"26128",94,71,71,1,0,"PSOE",40
34,"34084",158,125,125,1,0,"PSOE",23
50,"50079",226,162,160,1,2,"PSOE",65
28,"28003",167,133,131,4,2,"PSOE",43
47,"47170",43,36,30,0,6,"PSOE",12
10,"10114",964,644,637,6,7,"PSOE",349
39,"39027",3045,2231,2199,23,32,"PSOE",477
10,"10072",837,545,539,5,6,"PSOE",328
13,"13010",872,615,601,3,14,"PSOE",231
42,"42162",2298,1493,1462,18,31,"PSOE",352
44,"44017",269,217,216,0,1,"PSOE",55
29,"29015",32093,22044,21716,253,328,"PSOE",7411
38,"38901",1466,908,894,4,14,"PSOE",313
28,"28035",1404,981,966,4,15,"PSOE",295
16,"16007",1153,857,847,3,10,"PSOE",313
24,"24194",267,178,177,1,1,"PSOE",107
24,"24158",296,197,192,0,5,"PSOE",50
37,"37358",159,124,124,0,0,"PSOE",18
50,"50141",104,80,78,0,2,"PSOE",15
21,"21021",12545,7816,7696,104,120,"PSOE",2104
7,"7003",12521,6457,6381,60,76,"PSOE",1594
31,"31244",157,69,69,0,0,"PSOE",15
28,"28110",2029,1498,1478,9,20,"PSOE",506
24,"24050",105,77,77,2,0,"PSOE",26
50,"50242",99,74,74,0,0,"PSOE",19
46,"46091",110,100,100,0,0,"PSOE",14
12,"12127",63,45,44,1,1,"PSOE",17
45,"45132",2387,1765,1754,13,11,"PSOE",342
24,"24120",305,182,181,1,1,"PSOE",32
35,"35015",10752,5289,5222,39,67,"PSOE",1606
37,"37005",65,44,44,1,0,"PSOE",6
19,"19064",64,56,56,0,0,"PSOE",14
44,"44111",78,61,61,0,0,"PSOE",20
16,"16250",67,52,52,1,0,"PSOE",16
5,"5167",223,177,172,0,5,"PSOE",90
16,"16122",244,184,182,1,2,"PSOE",78
31,"31134",172,106,106,1,0,"PSOE",19
21,"21023",2033,1215,1193,10,22,"PSOE",578
19,"19169",30,27,27,0,0,"PSOE",11
50,"50142",23,16,16,1,0,"PSOE",8
6,"6080",1898,1336,1307,6,29,"PSOE",580
2,"2057",1947,1358,1333,15,25,"PSOE",639
10,"10199",154,99,99,2,0,"PSOE",25
4,"4036",239,178,176,0,2,"PSOE",65
34,"34136",143,89,89,1,0,"PSOE",31
39,"39002",3408,2360,2323,7,37,"PSOE",630
47,"47079",55,44,43,1,1,"PSOE",1
9,"9265",38,31,31,1,0,"PSOE",5
47,"47017",190,146,146,0,0,"PSOE",14
5,"5232",104,86,83,1,3,"PSOE",14
9,"9003",182,134,132,1,2,"PSOE",48
40,"40014",56,39,38,0,1,"PSOE",18
47,"47111",1001,738,732,5,6,"PSOE",265
3,"3003",449,368,367,1,1,"PSOE",85
49,"49040",109,89,87,2,2,"PSOE",42
7,"7006",5393,3257,3220,34,37,"PSOE",929
50,"50218",112,88,88,1,0,"PSOE",22
26,"26122",115,81,80,4,1,"PSOE",24
12,"12129",1783,1207,1184,16,23,"PSOE",466
42,"42032",138,96,96,0,0,"PSOE",30
44,"44199",39,37,37,2,0,"PSOE",3
16,"16125",1607,1166,1150,11,16,"PSOE",396
3,"3089",9496,6617,6484,51,133,"PSOE",2093
34,"34139",160,117,115,2,2,"PSOE",31
7,"7040",289448,169300,167908,1594,1392,"PSOE",43018
31,"31248",272,142,138,3,4,"PSOE",27
16,"16011",20,14,14,0,0,"PSOE",4
39,"39032",1420,1032,1027,7,5,"PSOE",185
19,"19261",33,23,23,0,0,"PSOE",4
16,"16254",199,159,159,0,0,"PSOE",70
41,"41057",258,174,170,3,4,"PSOE",86
46,"46003",948,770,757,8,13,"PSOE",216
26,"26083",337,255,250,3,5,"PSOE",75
6,"6084",1061,780,769,11,11,"PSOE",304
9,"9163",573,436,432,7,4,"PSOE",131
46,"46026",1220,974,965,7,9,"PSOE",247
47,"47135",82,65,65,3,0,"PSOE",24
16,"16126",720,552,545,3,7,"PSOE",189
31,"31139",152,100,100,1,0,"PSOE",21
7,"7041",2090,1454,1434,17,20,"PSOE",257
22,"22128",188,145,143,3,2,"PSOE",38
9,"9472",52,40,38,0,2,"PSOE",15
50,"50212",32,26,26,0,0,"PSOE",10
26,"26165",336,248,242,3,6,"PSOE",92
14,"14034",302,222,215,1,7,"PSOE",78
42,"42079",21,17,17,1,0,"PSOE",0
37,"37144",327,233,233,2,0,"PSOE",56
50,"50120",55,42,42,1,0,"PSOE",17
16,"16128",50,38,38,0,0,"PSOE",14
11,"11015",64414,39635,39220,776,415,"PSOE",10326
26,"26084",7264,5130,5059,61,71,"PSOE",1361
40,"40115",142,100,100,0,0,"PSOE",41
16,"16014",558,419,417,6,2,"PSOE",181
16,"16166",240,173,171,0,2,"PSOE",65
39,"39006",1729,1207,1192,1,15,"PSOE",197
4,"4076",1209,873,850,7,23,"PSOE",412
37,"37207",336,244,240,4,4,"PSOE",38
18,"18183",623,380,376,0,4,"PSOE",158
4,"4006",7192,4389,4335,39,54,"PSOE",1353
16,"16092",149,108,108,1,0,"PSOE",20
9,"9059",136870,99937,98641,1416,1296,"PSOE",31853
23,"23092",27717,19749,19490,217,259,"PSOE",6833
47,"47022",59,52,48,1,4,"PSOE",2
28,"28117",99,87,86,0,1,"PSOE",19
50,"50221",29,18,18,0,0,"PSOE",7
49,"49044",78,56,53,0,3,"PSOE",22
40,"40181",4182,3102,3038,35,64,"PSOE",1096
50,"50222",1574,1024,1008,12,16,"PSOE",406
41,"41005",9285,6637,6497,83,140,"PSOE",2430
26,"26127",182,149,149,1,0,"PSOE",66
9,"9168",270,211,210,5,1,"PSOE",102
28,"28118",61,52,50,0,2,"PSOE",15
4,"4044",1542,1092,1080,8,12,"PSOE",328
23,"23093",3119,2264,2216,24,48,"PSOE",1347
5,"5237",153,125,123,0,2,"PSOE",10
26,"26088",39,35,34,0,1,"PSOE",11
46,"46165",7349,5460,5412,39,48,"PSOE",1378
31,"31143",91,44,41,1,3,"PSOE",9
6,"6089",610,470,463,2,7,"PSOE",225
6,"6044",29258,19865,19594,205,271,"PSOE",7084
45,"45069",1820,1370,1355,1,15,"PSOE",437
2,"2085",306,232,226,2,6,"PSOE",103
3,"3103",238,196,194,2,2,"PSOE",70
19,"19322",26,20,19,1,1,"PSOE",7
13,"13025",290,233,231,0,2,"PSOE",99
16,"16169",49,28,28,0,0,"PSOE",11
5,"5110",696,469,464,2,5,"PSOE",118
18,"18121",119,79,79,1,0,"PSOE",40
28,"28086",5446,3643,3600,19,43,"PSOE",940
21,"21030",1887,1493,1458,12,35,"PSOE",714
47,"47213",104,78,78,0,0,"PSOE",26
42,"42176",27,21,21,0,0,"PSOE",5
14,"14010",3992,2786,2723,14,63,"PSOE",1262
16,"16265",22,18,18,0,0,"PSOE",9
45,"45033",297,205,201,1,4,"PSOE",80
22,"22110",700,476,473,3,3,"PSOE",163
19,"19266",229,184,182,1,2,"PSOE",33
38,"38014",1342,943,930,6,13,"PSOE",205
19,"19177",60,45,45,0,0,"PSOE",24
16,"16132",33,25,25,1,0,"PSOE",11
31,"31145",160,121,120,2,1,"PSOE",29
6,"6092",558,438,426,2,12,"PSOE",211
41,"41063",2735,1855,1797,30,58,"PSOE",752
42,"42131",50,39,39,2,0,"PSOE",13
41,"41008",1044,788,766,3,22,"PSOE",478
31,"31109",1657,1165,1160,12,5,"PSOE",192
24,"24061",1753,1234,1223,10,11,"PSOE",334
47,"47182",1328,940,934,8,6,"PSOE",292
34,"34904",300,188,186,0,2,"PSOE",72
28,"28087",3301,2539,2519,20,20,"PSOE",587
3,"3038",330,260,254,3,6,"PSOE",89
31,"31110",83,61,61,1,0,"PSOE",20
35,"35023",11742,7787,7651,95,136,"PSOE",2102
37,"37307",146,94,91,1,3,"PSOE",24
39,"39038",1512,992,983,5,9,"PSOE",234
34,"34152",124,99,94,0,5,"PSOE",33
34,"34015",37,24,24,0,0,"PSOE",1
49,"49052",183,120,117,2,3,"PSOE",34
10,"10090",489,307,302,1,5,"PSOE",153
50,"50125",340,230,229,2,1,"PSOE",89
47,"47184",537,411,402,1,9,"PSOE",81
44,"44178",52,34,34,0,0,"PSOE",9
42,"42182",49,39,39,1,0,"PSOE",6
3,"3125",332,226,226,2,0,"PSOE",58
18,"18189",785,598,592,9,6,"PSOE",170
41,"41037",3201,2306,2260,22,46,"PSOE",1105
29,"29902",2593,1561,1533,15,28,"PSOE",801
21,"21033",569,410,405,3,5,"PSOE",184
37,"37121",536,413,403,4,10,"PSOE",139
19,"19269",86,61,61,0,0,"PSOE",30
44,"44121",52,42,42,1,0,"PSOE",10
37,"37017",226,169,168,4,1,"PSOE",16
3,"3012",1138,863,846,4,17,"PSOE",261
31,"31259",475,313,311,5,2,"PSOE",55
44,"44208",27,17,17,0,0,"PSOE",5
44,"44268",32,30,30,0,0,"PSOE",9
42,"42183",102,74,74,1,0,"PSOE",5
5,"5211",425,336,330,2,6,"PSOE",80
19,"19181",50,34,34,0,0,"PSOE",7
47,"47123",461,360,358,2,2,"PSOE",84
45,"45037",1520,1072,1055,5,17,"PSOE",417
46,"46169",32403,23890,23698,222,192,"PSOE",7673
22,"22151",85,60,60,0,0,"PSOE",11
44,"44031",83,50,50,0,0,"PSOE",19
37,"37018",106,75,75,0,0,"PSOE",19
16,"16272",201,149,147,2,2,"PSOE",25
49,"49164",141,95,92,1,3,"PSOE",42
9,"9177",1140,790,780,7,10,"PSOE",188
46,"46101",819,670,663,8,7,"PSOE",228
22,"22048",12635,8889,8807,98,82,"PSOE",2699
46,"46238",13117,9172,9088,50,84,"PSOE",2228
50,"50128",26,23,23,0,0,"PSOE",6
9,"9287",191,144,143,2,1,"PSOE",46
2,"2070",373,306,301,6,5,"PSOE",207
34,"34158",283,170,167,0,3,"PSOE",78
34,"34108",499,391,384,3,7,"PSOE",155
26,"26177",306,233,229,2,4,"PSOE",75
16,"16012",76,66,66,0,0,"PSOE",35
22,"22049",73,62,62,0,0,"PSOE",16
28,"28126",50,36,36,0,0,"PSOE",15
31,"31262",234,190,188,0,2,"PSOE",34
18,"18096",340,227,226,0,1,"PSOE",132
37,"37249",37,28,28,0,0,"PSOE",8
9,"9109",1072,575,558,0,17,"PSOE",160
40,"40158",15,11,11,0,0,"PSOE",1
21,"21037",462,320,313,1,7,"PSOE",190
19,"19152",540,377,374,2,3,"PSOE",143
29,"29030",770,618,611,4,7,"PSOE",366
21,"21036",204,128,121,1,7,"PSOE",72
19,"19183",70,59,58,0,1,"PSOE",31
2,"2005",554,426,419,8,7,"PSOE",129
28,"28051",1644,1231,1220,9,11,"PSOE",274
31,"31115",159,93,93,2,0,"PSOE",8
46,"46904",812,615,605,2,10,"PSOE",183
49,"49243",107,74,74,0,0,"PSOE",9
28,"28127",66793,53258,53009,458,249,"PSOE",9512
12,"12139",299,202,200,3,2,"PSOE",31
23,"23902",2219,1813,1770,6,43,"PSOE",1200
31,"31044",291,227,227,1,0,"PSOE",19
31,"31043",29,23,23,0,0,"PSOE",6
28,"28052",3961,2700,2659,14,41,"PSOE",590
9,"9129",91,74,74,0,0,"PSOE",43
5,"5018",23,17,17,2,0,"PSOE",2
44,"44183",61,47,47,1,0,"PSOE",16
42,"42188",46,35,35,1,0,"PSOE",13
47,"47093",795,585,573,7,12,"PSOE",189
39,"39016",23850,17235,17106,70,129,"PSOE",4045
45,"45190",462,361,353,3,8,"PSOE",151
42,"42094",596,448,436,9,12,"PSOE",135
12,"12038",157,101,100,3,1,"PSOE",23
12,"12116",61,49,49,0,0,"PSOE",16
26,"26180",221,164,162,4,2,"PSOE",41
50,"50255",199,152,147,3,5,"PSOE",93
3,"3017",379,320,314,4,6,"PSOE",94
41,"41042",5872,4477,4424,42,53,"PSOE",2204
19,"19049",8,8,7,0,1,"PSOE",4
50,"50078",227,168,166,0,2,"PSOE",79
22,"22906",177,123,122,6,1,"PSOE",46
16,"16234",23,17,17,0,0,"PSOE",14
5,"5249",96,63,63,0,0,"PSOE",21
22,"22229",107,70,70,2,0,"PSOE",19
33,"33036",11281,7240,7153,96,87,"PSOE",2630
9,"9223",42,36,36,0,0,"PSOE",4
39,"39083",1063,619,611,2,8,"PSOE",109
40,"40052",72,55,55,0,0,"PSOE",18
45,"45155",311,240,240,0,0,"PSOE",108
5,"5056",91,71,70,0,1,"PSOE",12
46,"46105",16126,10958,10847,76,111,"PSOE",3422
3,"3018",12433,8582,8502,54,80,"PSOE",2440
10,"10140",1109,778,769,7,9,"PSOE",272
6,"6106",407,261,258,4,3,"PSOE",89
50,"50157",289,199,196,1,3,"PSOE",99
9,"9184",6,6,6,0,0,"PSOE",1
16,"16030",24,18,18,1,0,"PSOE",9
31,"31156",238,175,174,2,1,"PSOE",31
35,"35029",4415,2498,2472,29,26,"PSOE",629
9,"9132",170,121,120,0,1,"PSOE",22
5,"5186",1564,1140,1125,5,15,"PSOE",276
19,"19309",20,15,14,0,1,"PSOE",3
40,"40162",380,273,265,1,8,"PSOE",63
49,"49101",144,88,82,1,6,"PSOE",17
19,"19279",54,42,42,0,0,"PSOE",6
44,"44100",177,136,135,1,1,"PSOE",54
23,"23070",3813,2384,2354,11,30,"PSOE",776
42,"42193",14,7,7,0,0,"PSOE",1
47,"47035",901,659,653,4,6,"PSOE",212
47,"47192",89,78,76,3,2,"PSOE",19
22,"22021",1884,1331,1319,26,12,"PSOE",569
7,"7025",443,313,310,5,3,"PSOE",66
46,"46038",302,221,220,1,1,"PSOE",76
9,"9460",162,141,140,0,1,"PSOE",31
34,"34121",187,150,150,3,0,"PSOE",14
37,"37224",189,156,153,2,3,"PSOE",29
24,"24002",224,165,162,1,3,"PSOE",66
9,"9191",33,23,23,1,0,"PSOE",6
38,"38023",126137,79423,78706,605,717,"PSOE",22004
46,"46084",1487,1136,1123,4,13,"PSOE",317
24,"24003",603,374,372,0,2,"PSOE",127
18,"18905",15688,10406,10200,122,206,"PSOE",3010
19,"19090",90,69,68,1,1,"PSOE",27
45,"45121",7345,4949,4899,24,50,"PSOE",1384
34,"34223",203,147,143,1,4,"PSOE",20
40,"40164",186,131,130,0,1,"PSOE",20
23,"23038",3786,2934,2900,21,34,"PSOE",952
45,"45122",5605,4321,4288,33,33,"PSOE",1229
3,"3049",12103,8872,8785,57,87,"PSOE",2115
18,"18069",484,356,356,5,0,"PSOE",136
7,"7027",22101,13161,13028,140,133,"PSOE",3425
19,"19159",87,73,72,1,1,"PSOE",17
47,"47006",182,149,145,1,4,"PSOE",43
50,"50283",69,46,46,0,0,"PSOE",15
19,"19189",114,87,84,0,3,"PSOE",31
49,"49210",447,350,348,3,2,"PSOE",143
46,"46176",2077,1362,1348,14,14,"PSOE",357
40,"40134",692,522,509,10,13,"PSOE",178
28,"28101",226,174,172,1,2,"PSOE",44
30,"30006",833,699,695,1,4,"PSOE",191
50,"50009",97,61,61,1,0,"PSOE",9
39,"39050",260,164,164,1,0,"PSOE",28
10,"10023",842,597,589,2,8,"PSOE",314
14,"14022",3881,2888,2853,15,35,"PSOE",1179
9,"9361",103,64,64,1,0,"PSOE",18
30,"30007",6474,4354,4317,26,37,"PSOE",1084
31,"31052",101,78,75,0,3,"PSOE",15
4,"4062",4457,3241,3197,22,44,"PSOE",1220
16,"16035",224,177,174,2,3,"PSOE",87
4,"4026",57,38,37,0,1,"PSOE",8
13,"13002",1415,966,950,3,16,"PSOE",345
9,"9196",133,95,95,2,0,"PSOE",47
44,"44131",26,22,22,0,0,"PSOE",9
28,"28134",63936,48022,47631,421,391,"PSOE",13053
46,"46177",4832,3592,3539,20,53,"PSOE",1131
41,"41048",2195,1445,1400,13,45,"PSOE",666
14,"14023",1999,1629,1593,11,36,"PSOE",556
9,"9471",140,108,107,1,1,"PSOE",34
37,"37195",39,31,31,0,0,"PSOE",20
40,"40199",101,76,72,2,4,"PSOE",15
23,"23041",489,378,376,1,2,"PSOE",140
47,"47186",244314,182449,180833,1818,1616,"PSOE",56756
7,"7063",1434,1025,1016,10,9,"PSOE",221
50,"50286",75,54,53,0,1,"PSOE",21
45,"45126",234,146,144,2,2,"PSOE",58
10,"10066",161,121,120,1,1,"PSOE",47
24,"24114",2866,1753,1742,15,11,"PSOE",759
18,"18193",14934,10301,10127,116,174,"PSOE",2870
37,"37229",138,103,101,0,2,"PSOE",16
50,"50237",100,75,75,2,0,"PSOE",20
42,"42061",270,188,186,5,2,"PSOE",59
4,"4064",2878,1937,1924,16,13,"PSOE",579
37,"37030",82,60,60,0,0,"PSOE",19
13,"13005",23256,16610,16367,132,243,"PSOE",6010
24,"24008",8931,6291,6214,79,77,"PSOE",1527
9,"9365",26,17,17,0,0,"PSOE",5
10,"10149",432,284,280,2,4,"PSOE",132
31,"31055",267,192,191,0,1,"PSOE",29
29,"29040",1933,1260,1235,11,25,"PSOE",440
12,"12123",40,32,32,0,0,"PSOE",7
46,"46088",152,114,110,1,4,"PSOE",41
16,"16078",41384,28809,28500,322,309,"PSOE",10465
18,"18013",4154,2892,2812,28,80,"PSOE",980
50,"50901",133,96,96,0,0,"PSOE",33
46,"46157",2959,2145,2126,11,19,"PSOE",532
13,"13097",2186,1592,1574,5,18,"PSOE",621
4,"4066",13438,8615,8519,78,96,"PSOE",2289
37,"37324",333,247,242,3,5,"PSOE",68
3,"3025",1304,944,934,4,10,"PSOE",252
50,"50086",176,106,102,1,4,"PSOE",57
18,"18014",6938,4864,4742,64,122,"PSOE",1335
19,"19194",91,69,69,0,0,"PSOE",28
46,"46111",11367,7995,7908,66,87,"PSOE",2052
50,"50189",678,494,487,6,7,"PSOE",153
6,"6074",4720,3355,3271,24,84,"PSOE",1180
29,"29014",218,122,121,3,1,"PSOE",36
24,"24082",847,615,608,16,7,"PSOE",256
3,"3054",334,248,245,2,3,"PSOE",70
50,"50062",1885,1332,1308,15,24,"PSOE",409
47,"47199",71,57,57,2,0,"PSOE",24
42,"42113",510,370,366,2,4,"PSOE",94
44,"44016",424,299,297,1,2,"PSOE",70
44,"44194",103,67,64,0,3,"PSOE",8
38,"38028",22144,14312,14174,89,138,"PSOE",5108
9,"9202",22,16,16,2,0,"PSOE",2
24,"24083",997,659,647,9,12,"PSOE",297
4,"4031",2238,1649,1645,15,4,"PSOE",884
50,"50248",501,344,328,3,16,"PSOE",140
7,"7057",7471,4430,4392,41,38,"PSOE",1022
35,"35014",11962,5994,5888,60,106,"PSOE",1434
24,"24047",708,462,459,1,3,"PSOE",113
49,"49224",166,102,100,0,2,"PSOE",24
28,"28140",3156,2359,2331,16,28,"PSOE",526
31,"31059",182,121,121,1,0,"PSOE",26
46,"46090",1631,1360,1339,6,21,"PSOE",423
4,"4101",4356,2818,2768,32,50,"PSOE",1051
21,"21051",222,171,168,3,3,"PSOE",77
45,"45058",344,245,236,1,9,"PSOE",84
50,"50241",582,414,406,2,8,"PSOE",112
26,"26077",16,16,16,0,0,"PSOE",3
18,"18046",1738,1042,1023,7,19,"PSOE",375
49,"49183",90,67,65,2,2,"PSOE",5
24,"24902",331,239,239,0,0,"PSOE",82
19,"19102",88,75,73,0,2,"PSOE",23
50,"50290",360,260,255,5,5,"PSOE",108
10,"10032",1588,1114,1099,6,15,"PSOE",429
28,"28065",131232,100864,99883,846,981,"PSOE",32103
40,"40904",344,286,284,8,2,"PSOE",45
16,"16158",513,371,366,5,5,"PSOE",115
39,"39056",2262,1683,1671,14,12,"PSOE",287
23,"23084",902,627,621,4,6,"PSOE",304
30,"30037",19407,13252,13120,99,132,"PSOE",2497
3,"3115",255,213,213,3,0,"PSOE",56
37,"37140",630,395,393,0,2,"PSOE",96
26,"26005",2483,1589,1570,13,19,"PSOE",507
12,"12021",4398,3314,3277,32,37,"PSOE",917
34,"34045",72,62,62,0,0,"PSOE",17
14,"14029",4001,2855,2821,30,34,"PSOE",1254
18,"18913",771,530,514,2,16,"PSOE",135
23,"23011",2138,1536,1507,17,29,"PSOE",745
45,"45133",2798,1957,1922,11,35,"PSOE",682
13,"13059",193,150,150,0,0,"PSOE",57
45,"45060",152,109,109,1,0,"PSOE",67
29,"29045",1679,1162,1144,5,18,"PSOE",306
28,"28144",6525,5032,4987,39,45,"PSOE",1157
3,"3116",1155,819,805,5,14,"PSOE",188
22,"22064",155,100,100,2,0,"PSOE",44
47,"47046",124,99,99,1,0,"PSOE",34
41,"41055",14791,10197,10000,125,197,"PSOE",4068
22,"22247",28,18,18,0,0,"PSOE",11
22,"22099",490,349,343,2,6,"PSOE",139
22,"22003",135,107,107,0,0,"PSOE",25
24,"24197",717,500,499,2,1,"PSOE",154
14,"14003",1245,925,907,5,18,"PSOE",396
46,"46024",454,343,339,1,4,"PSOE",110
9,"9052",28,21,20,0,1,"PSOE",1
45,"45171",1329,958,940,4,18,"PSOE",312
40,"40046",83,67,67,1,0,"PSOE",25
3,"3117",377,306,302,2,4,"PSOE",75
42,"42211",84,67,67,0,0,"PSOE",12
28,"28145",2671,1927,1895,21,32,"PSOE",543
10,"10036",304,194,192,4,2,"PSOE",103
26,"26008",1821,1310,1290,15,20,"PSOE",492
47,"47048",175,124,122,0,2,"PSOE",27
46,"46230",14116,10038,9946,63,92,"PSOE",3305
37,"37237",296,212,204,1,8,"PSOE",80
24,"24123",709,461,457,2,4,"PSOE",187
9,"9215",359,217,216,2,1,"PSOE",62
13,"13017",240,178,176,0,2,"PSOE",76
5,"5169",218,171,171,1,0,"PSOE",32
11,"11901",5739,3759,3686,99,73,"PSOE",1751
9,"9381",28,19,19,0,0,"PSOE",4
45,"45063",375,268,264,0,4,"PSOE",100
33,"33022",802,460,452,4,8,"PSOE",205
40,"40047",37,23,23,0,0,"PSOE",4
18,"18916",1815,1093,1086,6,7,"PSOE",422
37,"37332",65,49,49,0,0,"PSOE",9
18,"18021",17929,12165,11949,139,216,"PSOE",3526
18,"18116",2856,2027,1979,13,48,"PSOE",667
10,"10161",81,50,50,0,0,"PSOE",23
38,"38033",3593,2277,2242,15,35,"PSOE",855
26,"26010",85,66,63,1,3,"PSOE",22
30,"30016",153034,101232,100202,776,1030,"PSOE",22730
37,"37239",203,175,174,2,1,"PSOE",48
46,"46117",493,386,380,2,6,"PSOE",107
28,"28147",991,702,698,4,4,"PSOE",227
16,"16163",64,51,51,0,0,"PSOE",24
50,"50146",189,149,149,3,0,"PSOE",57
46,"46110",21364,15132,15019,120,113,"PSOE",4567
28,"28010",10649,8167,8098,76,69,"PSOE",1672
3,"3005",7937,5907,5869,40,38,"PSOE",1334
42,"42035",730,464,460,3,4,"PSOE",161
18,"18051",1092,735,718,8,17,"PSOE",378
34,"34094",61,45,45,2,0,"PSOE",10
37,"37010",925,645,638,5,7,"PSOE",215
10,"10040",426,301,289,2,12,"PSOE",146
49,"49189",186,104,104,1,0,"PSOE",25
42,"42216",26,20,20,0,0,"PSOE",11
9,"9386",55,43,43,0,0,"PSOE",4
50,"50172",174,125,123,2,2,"PSOE",34
10,"10204",423,289,287,1,2,"PSOE",111
37,"37114",74,58,55,1,3,"PSOE",15
23,"23091",675,516,512,1,4,"PSOE",247
26,"26126",29,27,27,0,0,"PSOE",5
50,"50093",87,66,64,1,2,"PSOE",12
13,"13021",412,325,320,1,5,"PSOE",122
5,"5172",111,83,83,1,0,"PSOE",18
6,"6041",456,329,321,2,8,"PSOE",130
49,"49085",904,583,579,5,4,"PSOE",208
37,"37042",36,27,27,1,0,"PSOE",2
5,"5903",137,84,83,0,1,"PSOE",27
9,"9387",107,89,88,0,1,"PSOE",34
19,"19203",29,25,25,0,0,"PSOE",8
16,"16129",88,72,72,0,0,"PSOE",28
40,"40149",479,345,338,3,7,"PSOE",74
33,"33026",8201,5014,4974,74,40,"PSOE",1724
5,"5109",445,334,329,4,5,"PSOE",104
6,"6134",526,306,301,1,5,"PSOE",145
31,"31069",823,596,595,1,1,"PSOE",171
47,"47149",46,33,32,1,1,"PSOE",4
9,"9060",126,104,104,2,0,"PSOE",21
37,"37336",56,45,43,2,2,"PSOE",15
45,"45068",179,129,127,0,2,"PSOE",71
34,"34201",171,131,130,1,1,"PSOE",36
44,"44052",75,54,54,0,0,"PSOE",10
49,"49087",476,246,244,0,2,"PSOE",56
37,"37242",82,59,59,1,0,"PSOE",12
6,"6136",1489,1086,1060,11,26,"PSOE",547
44,"44223",73,48,48,0,0,"PSOE",10
28,"28034",368,258,255,0,3,"PSOE",66
22,"22184",167,132,130,4,2,"PSOE",36
9,"9115",90,65,63,3,2,"PSOE",9
9,"9062",40,34,33,0,1,"PSOE",12
5,"5044",244,170,170,1,0,"PSOE",25
49,"49123",519,384,383,4,1,"PSOE",152
10,"10127",4691,3044,2974,34,70,"PSOE",994
42,"42219",40,34,34,1,0,"PSOE",9
44,"44232",364,255,255,3,0,"PSOE",66
40,"40151",43,31,31,0,0,"PSOE",3
44,"44147",401,264,256,7,8,"PSOE",81
28,"28152",16986,13444,13366,111,78,"PSOE",2364
34,"34204",50,35,35,0,0,"PSOE",9
24,"24207",276,215,215,2,0,"PSOE",71
37,"37338",77,58,58,0,0,"PSOE",9
47,"47055",188,147,147,2,0,"PSOE",56
46,"46121",106,91,90,1,1,"PSOE",28
39,"39065",222,166,163,0,3,"PSOE",34
37,"37244",129,97,97,1,0,"PSOE",17
40,"40054",108,79,78,3,1,"PSOE",20
50,"50249",283,202,200,0,2,"PSOE",36
14,"14066",5748,4116,4035,59,81,"PSOE",1299
29,"29070",43686,27672,27323,290,349,"PSOE",7445
45,"45182",996,760,754,5,6,"PSOE",286
22,"22222",516,379,377,6,2,"PSOE",113
47,"47214",1349,1036,1019,5,17,"PSOE",276
5,"5079",66,53,52,0,1,"PSOE",4
30,"30021",9498,6251,6193,36,58,"PSOE",1411
9,"9338",225,174,172,3,2,"PSOE",56
22,"22045",65,52,52,0,0,"PSOE",19
22,"22187",288,220,220,2,0,"PSOE",68
44,"44149",99,74,73,4,1,"PSOE",26
16,"16172",325,233,228,1,5,"PSOE",79
37,"37150",34,31,31,0,0,"PSOE",0
44,"44054",95,82,81,0,1,"PSOE",17
19,"19113",454,327,322,4,5,"PSOE",103
16,"16269",378,287,285,2,2,"PSOE",105
39,"39011",1587,1178,1178,6,0,"PSOE",148
26,"26055",39,30,30,0,0,"PSOE",8
45,"45036",638,455,449,1,6,"PSOE",151
34,"34104",231,164,162,2,2,"PSOE",34
37,"37370",316,238,237,2,1,"PSOE",43
16,"16173",175,128,127,0,1,"PSOE",45
37,"37151",142,109,109,1,0,"PSOE",17
21,"21063",2611,1948,1891,23,57,"PSOE",1125
46,"46191",1956,1439,1414,8,25,"PSOE",430
29,"29055",1892,1425,1394,3,31,"PSOE",595
18,"18158",7978,4861,4771,43,90,"PSOE",2317
9,"9067",399,232,230,3,2,"PSOE",59
13,"13030",115,81,81,0,0,"PSOE",22
45,"45074",397,300,293,2,7,"PSOE",115
4,"4083",1727,1265,1250,8,15,"PSOE",567
6,"6142",257,203,194,1,9,"PSOE",112
9,"9343",92,66,65,0,1,"PSOE",17
33,"33031",33775,20484,20184,276,300,"PSOE",7509
11,"11022",48785,24758,24422,398,336,"PSOE",7543
22,"22189",175,142,142,1,0,"PSOE",66
3,"3040",264,227,221,1,6,"PSOE",46
31,"31076",2543,1965,1956,19,9,"PSOE",246
50,"50252",5019,3486,3456,53,30,"PSOE",1082
50,"50126",2240,1528,1509,24,19,"PSOE",442
21,"21004",1586,994,964,23,30,"PSOE",499
40,"40057",1397,1081,1067,15,14,"PSOE",437
24,"24029",686,430,428,6,2,"PSOE",190
28,"28156",1082,788,784,3,4,"PSOE",195
34,"34211",171,154,153,2,1,"PSOE",28
26,"26136",90,65,64,2,1,"PSOE",22
37,"37154",129,97,94,1,3,"PSOE",12
16,"16175",5071,3807,3732,43,75,"PSOE",1553
49,"49202",173,103,101,0,2,"PSOE",45
23,"23029",798,595,590,0,5,"PSOE",279
10,"10134",550,361,354,1,7,"PSOE",108
22,"22079",118,85,84,1,1,"PSOE",40
22,"22190",123,77,77,1,0,"PSOE",27
19,"19213",67,53,52,1,1,"PSOE",23
40,"40091",109,87,85,0,2,"PSOE",24
47,"47219",39,31,28,1,3,"PSOE",11
5,"5016",6355,4677,4584,28,93,"PSOE",1133
24,"24141",96,74,74,0,0,"PSOE",28
37,"37155",68,48,48,0,0,"PSOE",25
28,"28050",4406,3202,3167,29,35,"PSOE",619
34,"34066",54,47,47,1,0,"PSOE",7
26,"26060",78,51,50,2,1,"PSOE",9
6,"6009",221,166,166,2,0,"PSOE",66
46,"46239",446,357,352,1,5,"PSOE",113
40,"40059",109,92,91,2,1,"PSOE",25
18,"18033",279,179,174,0,5,"PSOE",84
45,"45188",2770,1925,1886,12,39,"PSOE",678
31,"31188",319,197,191,3,6,"PSOE",37
38,"38043",19365,12355,12212,126,143,"PSOE",3310
44,"44060",32,25,25,0,0,"PSOE",2
12,"12064",80,71,69,0,2,"PSOE",27
19,"19305",139,104,103,1,1,"PSOE",34
10,"10177",1702,1241,1186,10,55,"PSOE",497
50,"50254",179,115,113,0,2,"PSOE",47
31,"31189",1125,702,698,6,4,"PSOE",174
49,"49096",155,113,112,2,1,"PSOE",38
39,"39071",410,251,250,1,1,"PSOE",10
19,"19215",135,109,109,0,0,"PSOE",19
44,"44212",41,29,29,0,0,"PSOE",2
49,"49168",89,68,68,0,0,"PSOE",16
37,"37125",231,154,148,1,6,"PSOE",38
19,"19013",111,89,89,0,0,"PSOE",46
41,"41069",29669,20316,19848,381,468,"PSOE",5801
49,"49058",301,222,221,1,1,"PSOE",76
19,"19048",19,14,13,1,1,"PSOE",4
9,"9130",64,39,39,2,0,"PSOE",7
34,"34161",22,12,12,0,0,"PSOE",3
24,"24033",209,149,149,0,0,"PSOE",31
24,"24032",99,70,66,1,4,"PSOE",23
13,"13038",1589,1162,1136,21,26,"PSOE",611
34,"34216",61,41,41,0,0,"PSOE",3
14,"14017",10953,7929,7791,84,138,"PSOE",3480
10,"10016",329,242,232,2,10,"PSOE",106
37,"37158",230,149,149,1,0,"PSOE",45
37,"37252",99,65,65,1,0,"PSOE",10
44,"44126",314,222,221,0,1,"PSOE",75
18,"18035",1179,882,870,7,12,"PSOE",351
31,"31082",627,385,385,5,0,"PSOE",45
9,"9131",485,390,388,7,2,"PSOE",144
9,"9440",80,61,61,0,0,"PSOE",22
31,"31216",3867,2592,2566,37,26,"PSOE",675
21,"21040",3193,2219,2123,32,96,"PSOE",882
4,"4057",1261,886,872,6,14,"PSOE",321
39,"39102",2229,1524,1514,10,10,"PSOE",310
28,"28054",11943,8800,8731,72,69,"PSOE",2102
33,"33064",240,151,151,0,0,"PSOE",73
12,"12039",792,665,659,2,6,"PSOE",237
5,"5122",118,91,89,1,2,"PSOE",27
37,"37190",189,141,139,1,2,"PSOE",38
9,"9410",3019,1924,1898,21,26,"PSOE",842
50,"50257",159,128,125,2,3,"PSOE",57
6,"6015",118127,79482,78553,855,929,"PSOE",21967
31,"31193",1440,1062,1055,11,7,"PSOE",164
9,"9077",26,21,21,0,0,"PSOE",3
10,"10101",178,129,125,0,4,"PSOE",53
31,"31231",104,65,65,1,0,"PSOE",19
12,"12040",119116,85613,84993,620,620,"PSOE",23736
6,"6062",564,394,391,0,3,"PSOE",173
19,"19218",43,31,31,0,0,"PSOE",13
37,"37160",597,380,370,3,10,"PSOE",129
16,"16067",123,91,90,1,1,"PSOE",29
9,"9242",66,53,52,3,1,"PSOE",18
37,"37348",100,76,76,0,0,"PSOE",9
22,"22053",783,494,492,6,2,"PSOE",211
37,"37223",106,75,74,0,1,"PSOE",27
9,"9243",73,50,49,1,1,"PSOE",20
23,"23037",518,403,398,10,5,"PSOE",205
28,"28056",946,664,660,2,4,"PSOE",176
4,"4059",1000,676,666,3,10,"PSOE",386
12,"12012",2622,2084,2056,12,28,"PSOE",759
40,"40163",42,35,35,1,0,"PSOE",2
6,"6018",727,483,476,0,7,"PSOE",264
42,"42017",131,99,96,1,3,"PSOE",49
34,"34168",45,39,39,1,0,"PSOE",9
9,"9244",45,31,31,2,0,"PSOE",9
10,"10184",734,520,511,4,9,"PSOE",216
10,"10062",389,303,299,2,4,"PSOE",170
22,"22164",42,28,28,0,0,"PSOE",5
34,"34073",180,123,120,3,3,"PSOE",32
37,"37350",403,281,274,1,7,"PSOE",56
38,"38048",3952,2543,2519,22,24,"PSOE",768
31,"31234",146,101,101,0,0,"PSOE",19
9,"9464",33,24,24,0,0,"PSOE",5
19,"19311",85,60,59,0,1,"PSOE",17
37,"37027",239,182,179,2,3,"PSOE",53
45,"45158",2545,1805,1786,9,19,"PSOE",514
46,"46244",59910,42120,41826,338,294,"PSOE",11696
45,"45049",419,303,295,1,8,"PSOE",83
33,"33039",1646,1118,1110,8,8,"PSOE",465
46,"46039",2111,1657,1640,16,17,"PSOE",551
37,"37061",195,136,136,1,0,"PSOE",33
4,"4094",215,156,156,0,0,"PSOE",29
21,"21044",18061,11170,11003,123,167,"PSOE",2654
37,"37163",34,24,24,0,0,"PSOE",2
28,"28166",357,281,276,1,5,"PSOE",88
28,"28165",1917,1339,1321,2,18,"PSOE",314
9,"9084",165,116,111,1,5,"PSOE",33
6,"6158",13367,9319,9131,90,188,"PSOE",3362
24,"24040",416,293,292,2,1,"PSOE",105
18,"18039",3343,2293,2252,22,41,"PSOE",892
33,"33040",4556,2837,2784,58,53,"PSOE",1006
24,"24152",433,269,267,4,2,"PSOE",59
3,"3137",654,449,443,7,6,"PSOE",119
34,"34225",5016,3708,3650,41,58,"PSOE",1350
6,"6022",2635,1920,1862,15,58,"PSOE",891
39,"39078",1410,1004,997,5,7,"PSOE",193
22,"22204",1117,728,723,14,5,"PSOE",173
50,"50187",55,42,42,0,0,"PSOE",16
41,"41020",13012,8148,7999,135,149,"PSOE",3855
16,"16192",42,28,28,0,0,"PSOE",19
22,"22088",143,98,97,1,1,"PSOE",39
50,"50136",532,366,361,3,5,"PSOE",82
23,"23075",3222,2513,2475,19,38,"PSOE",1166
21,"21015",645,361,356,8,5,"PSOE",172
13,"13094",294,216,215,1,1,"PSOE",74
45,"45199",3188,2077,2055,20,22,"PSOE",527
5,"5191",121,99,99,0,0,"PSOE",34
47,"47229",221,150,149,0,1,"PSOE",61
37,"37322",2462,1580,1537,14,43,"PSOE",510
12,"12122",754,608,600,3,8,"PSOE",161
19,"19021",978,678,662,3,16,"PSOE",207
46,"46064",532,395,387,3,8,"PSOE",104
50,"50110",340,248,238,1,10,"PSOE",99
18,"18140",42474,26967,26648,225,319,"PSOE",8661
12,"12016",1549,1244,1234,9,10,"PSOE",400
5,"5095",236,181,177,1,4,"PSOE",53
41,"41021",21410,14369,14139,195,230,"PSOE",5645
26,"26151",412,317,317,4,0,"PSOE",128
47,"47167",245,198,198,1,0,"PSOE",66
49,"49221",233,122,120,2,2,"PSOE",40
10,"10067",10210,7090,6946,62,144,"PSOE",2471
45,"45090",370,262,261,2,1,"PSOE",117
50,"50188",26,23,23,0,0,"PSOE",3
18,"18141",382,240,237,0,3,"PSOE",51
42,"42110",54,43,43,0,0,"PSOE",8
47,"47011",554,466,462,7,4,"PSOE",120
37,"37261",213,153,149,0,4,"PSOE",42
46,"46202",17801,13010,12906,87,104,"PSOE",2799
44,"44163",115,79,78,0,1,"PSOE",28
28,"28169",1577,1214,1209,7,5,"PSOE",209
26,"26037",125,98,98,3,0,"PSOE",34
9,"9255",83,58,58,0,0,"PSOE",12
10,"10191",511,374,365,5,9,"PSOE",136
5,"5097",464,309,305,0,4,"PSOE",68
31,"31093",275,201,198,3,3,"PSOE",46
23,"23044",4697,3495,3400,31,95,"PSOE",1255
42,"42111",274,183,181,0,2,"PSOE",53
47,"47042",51,39,39,0,0,"PSOE",8
47,"47073",116,80,79,2,1,"PSOE",18
28,"28002",3250,2261,2243,14,18,"PSOE",507
47,"47074",141,110,109,0,1,"PSOE",53
28,"28033",4177,2972,2936,20,36,"PSOE",612
9,"9148",77,58,58,3,0,"PSOE",20
34,"34130",195,154,153,5,1,"PSOE",55
37,"37292",91,65,65,0,0,"PSOE",10
16,"16155",490,389,388,7,1,"PSOE",134
3,"3112",650,503,497,3,6,"PSOE",136
41,"41024",22819,14767,14455,169,312,"PSOE",5973
13,"13054",4870,3630,3575,26,55,"PSOE",1086
9,"9257",85,67,67,2,0,"PSOE",7
34,"34179",25,18,16,0,2,"PSOE",2
26,"26154",10,10,9,1,1,"PSOE",2
2,"2052",466,371,370,6,1,"PSOE",138
49,"49111",119,84,84,3,0,"PSOE",25
12,"12048",243,159,155,4,4,"PSOE",51
10,"10113",2231,1534,1508,14,26,"PSOE",726
19,"19027",129,97,95,1,2,"PSOE",36
33,"33046",480,334,329,0,5,"PSOE",86
47,"47075",4772,3557,3512,34,45,"PSOE",811
31,"31132",147,100,100,2,0,"PSOE",12
41,"41025",2031,1409,1349,11,60,"PSOE",499
7,"7001",3647,2430,2383,26,47,"PSOE",706
12,"12020",118,104,103,1,1,"PSOE",12
29,"29043",2463,1508,1460,20,48,"PSOE",581
16,"16119",175,117,115,0,2,"PSOE",40
47,"47171",375,295,290,9,5,"PSOE",66
22,"22209",161,121,121,3,0,"PSOE",54
37,"37070",523,371,365,4,6,"PSOE",112
41,"41081",30061,21488,21059,331,429,"PSOE",9340
37,"37264",56,39,39,0,0,"PSOE",8
9,"9425",472,311,309,3,2,"PSOE",121
26,"26158",242,184,181,1,3,"PSOE",59
3,"3056",8588,6219,6135,29,84,"PSOE",1994
47,"47076",17787,13484,13306,179,178,"PSOE",4083
45,"45021",2639,1798,1755,22,43,"PSOE",586
14,"14057",6157,4773,4707,59,66,"PSOE",1758
5,"5197",100,82,79,1,3,"PSOE",10
9,"9427",1363,854,842,7,12,"PSOE",178
6,"6123",4502,2989,2894,29,95,"PSOE",1296
9,"9318",56,33,33,0,0,"PSOE",12
37,"37171",396,272,270,2,2,"PSOE",45
45,"45096",987,748,725,9,23,"PSOE",211
46,"46137",248,201,197,3,4,"PSOE",56
6,"6033",1276,986,972,5,14,"PSOE",426
31,"31245",76,51,48,2,3,"PSOE",2
9,"9902",439,334,326,10,8,"PSOE",95
44,"44077",68,52,51,0,1,"PSOE",32
33,"33048",132,86,85,1,1,"PSOE",44
18,"18048",2494,1708,1657,18,51,"PSOE",650
50,"50267",565,380,375,4,5,"PSOE",165
50,"50117",123,93,93,4,0,"PSOE",28
16,"16045",180,128,127,0,1,"PSOE",61
47,"47206",79,66,66,0,0,"PSOE",30
45,"45098",2090,1488,1469,7,19,"PSOE",282
37,"37110",104,81,79,1,2,"PSOE",29
24,"24016",488,244,243,0,1,"PSOE",119
21,"21054",8175,6014,5887,41,127,"PSOE",1496
45,"45061",2490,1690,1669,9,21,"PSOE",684
16,"16086",872,699,690,7,9,"PSOE",260
40,"40176",372,288,287,2,1,"PSOE",129
41,"41028",2108,1652,1632,22,20,"PSOE",504
28,"28175",940,740,730,2,10,"PSOE",150
44,"44169",298,216,216,0,0,"PSOE",69
49,"49228",53,36,36,0,0,"PSOE",3
33,"33049",5973,3569,3518,48,51,"PSOE",1454
37,"37267",177,130,129,0,1,"PSOE",42
6,"6036",4930,3492,3394,20,98,"PSOE",1503
19,"19105",2550,1913,1889,10,24,"PSOE",501
24,"24053",398,250,248,1,2,"PSOE",52
19,"19034",25,22,21,0,1,"PSOE",10
19,"19327",385,313,308,2,5,"PSOE",58
14,"14060",3715,2714,2641,41,73,"PSOE",1066
49,"49116",356,239,234,4,5,"PSOE",79
47,"47175",6755,4950,4870,49,80,"PSOE",1632
5,"5104",33,21,19,0,2,"PSOE",2
7,"7007",416,277,275,4,2,"PSOE",83
41,"41029",13520,9849,9663,134,186,"PSOE",3568
22,"22103",664,489,489,4,0,"PSOE",197
6,"6037",1656,1033,1018,8,15,"PSOE",411
50,"50269",287,172,167,2,5,"PSOE",55
49,"49117",431,294,289,0,5,"PSOE",104
10,"10079",848,641,632,2,9,"PSOE",205
23,"23052",1094,920,896,6,24,"PSOE",524
10,"10201",178,142,141,2,1,"PSOE",73
34,"34241",17,17,16,3,1,"PSOE",2
31,"31102",135,60,60,1,0,"PSOE",11
41,"41030",501,376,366,9,10,"PSOE",167
50,"50119",876,633,625,11,8,"PSOE",207
14,"14061",687,536,523,1,13,"PSOE",268
47,"47081",39,32,32,0,0,"PSOE",14
18,"18022",13875,8948,8764,98,184,"PSOE",3029
45,"45138",1058,813,802,5,11,"PSOE",272
7,"7008",6113,4003,3961,26,42,"PSOE",980
19,"19138",215,158,154,4,4,"PSOE",76
50,"50196",101,73,73,0,0,"PSOE",37
39,"39033",536,375,372,1,3,"PSOE",97
41,"41059",35358,26408,26052,346,356,"PSOE",8128
50,"50019",63,46,46,0,0,"PSOE",9
44,"44085",49,29,29,0,0,"PSOE",1
28,"28179",1451,1043,1033,6,10,"PSOE",222
9,"9437",266,207,203,4,4,"PSOE",59
2,"2061",605,464,458,3,6,"PSOE",156
9,"9110",77,50,50,0,0,"PSOE",19
28,"28041",4805,3666,3634,38,32,"PSOE",753
44,"44050",3113,2173,2154,14,19,"PSOE",538
31,"31177",245,161,159,1,2,"PSOE",42
29,"29096",2757,1847,1790,19,57,"PSOE",863
24,"24092",731,506,504,1,2,"PSOE",175
39,"39090",773,557,553,2,4,"PSOE",102
31,"31104",1751,1147,1125,8,22,"PSOE",445
10,"10042",85,58,58,0,0,"PSOE",31
5,"5108",39,21,21,0,0,"PSOE",11
50,"50295",48,41,41,0,0,"PSOE",18
47,"47115",276,212,211,1,1,"PSOE",34
22,"22107",102,53,53,0,0,"PSOE",23
34,"34098",790,562,558,3,4,"PSOE",167
44,"44086",410,302,298,3,4,"PSOE",91
26,"26050",125,92,91,1,1,"PSOE",20
18,"18152",928,663,660,3,3,"PSOE",499
40,"40118",46,32,32,1,0,"PSOE",9
37,"37272",132,97,95,0,2,"PSOE",29
50,"50272",13226,9250,9153,97,97,"PSOE",2660
26,"26168",5584,3757,3696,35,61,"PSOE",1170
2,"2062",382,261,256,2,5,"PSOE",113
49,"49012",70,34,34,0,0,"PSOE",12
31,"31215",4670,3270,3219,33,51,"PSOE",1258
50,"50122",68,43,42,1,1,"PSOE",11
18,"18054",820,573,569,2,4,"PSOE",181
23,"23056",3052,2279,2207,26,72,"PSOE",841
31,"31106",721,547,545,1,2,"PSOE",202
26,"26169",66,51,50,0,1,"PSOE",22
50,"50095",12149,8322,8239,91,83,"PSOE",3410
29,"29052",213,129,128,0,1,"PSOE",47
31,"31179",486,315,312,3,3,"PSOE",110
22,"22074",303,209,208,5,1,"PSOE",65
37,"37081",879,680,674,2,6,"PSOE",288
37,"37337",137,104,103,0,1,"PSOE",7
49,"49158",206,159,155,0,4,"PSOE",72
19,"19004",59,44,44,0,0,"PSOE",3
29,"29069",87188,54019,53240,633,779,"PSOE",15864
26,"26170",423,303,301,2,2,"PSOE",91
37,"37273",85,58,58,2,0,"PSOE",11
46,"46261",1708,1259,1237,12,22,"PSOE",355
46,"46075",144,125,122,2,3,"PSOE",43
3,"3065",169894,121210,120342,1045,868,"PSOE",34510
37,"37082",733,468,456,7,12,"PSOE",161
4,"4010",587,421,409,5,12,"PSOE",213
49,"49014",116,83,83,1,0,"PSOE",26
50,"50046",162,125,125,6,0,"PSOE",29
50,"50123",430,304,297,3,7,"PSOE",137
47,"47181",165,136,135,1,1,"PSOE",42
39,"39009",3325,2306,2293,7,13,"PSOE",449
9,"9442",368,265,262,1,3,"PSOE",103
50,"50224",61,44,44,2,0,"PSOE",11
37,"37369",126,83,81,0,2,"PSOE",25
9,"9277",103,84,82,1,2,"PSOE",42
34,"34058",182,152,152,0,0,"PSOE",62
6,"6139",498,402,395,4,7,"PSOE",206
26,"26054",291,225,223,3,2,"PSOE",86
9,"9443",151,113,112,0,1,"PSOE",31
24,"24025",283,190,185,3,5,"PSOE",30
3,"3124",459,360,358,0,2,"PSOE",121
3,"3066",41762,28723,28388,358,335,"PSOE",9164
6,"6048",821,666,653,1,13,"PSOE",304
50,"50047",38,24,24,0,0,"PSOE",11
46,"46213",15499,10610,10482,173,128,"PSOE",2975
23,"23059",5736,4245,4119,51,126,"PSOE",2023
31,"31221",1228,823,815,6,8,"PSOE",158
28,"28901",890,624,618,5,6,"PSOE",165
23,"23060",19210,13677,13495,145,182,"PSOE",5295
31,"31147",110,79,78,1,1,"PSOE",10
18,"18061",999,781,770,5,11,"PSOE",279
37,"37214",120,70,68,2,2,"PSOE",15
26,"26094",67,51,51,0,0,"PSOE",13
40,"40186",35,29,29,0,0,"PSOE",9
3,"3067",91,78,78,0,0,"PSOE",25
9,"9280",26,18,18,0,0,"PSOE",7
19,"19901",35,27,27,0,0,"PSOE",7
45,"45110",1685,1288,1274,5,14,"PSOE",585
26,"26095",93,71,68,0,3,"PSOE",43
22,"22014",227,164,162,5,2,"PSOE",67
9,"9281",136,97,97,2,0,"PSOE",30
31,"31222",57,35,34,3,1,"PSOE",11
28,"28902",521,394,389,3,5,"PSOE",53
50,"50275",111,50,50,0,0,"PSOE",12
42,"42045",273,175,174,4,1,"PSOE",51
37,"37086",107,86,85,2,1,"PSOE",20
44,"44179",324,201,201,2,0,"PSOE",70
47,"47089",133,111,111,2,0,"PSOE",11
49,"49018",277,197,190,2,7,"PSOE",83
29,"29073",1657,1082,1069,15,13,"PSOE",431
47,"47185",82,62,61,1,1,"PSOE",16
16,"16271",612,482,481,3,1,"PSOE",166
22,"22015",299,218,215,1,3,"PSOE",71
49,"49127",2402,1640,1604,18,36,"PSOE",504
7,"7018",389,238,236,1,2,"PSOE",50
40,"40188",83,63,60,0,3,"PSOE",16
18,"18062",11226,7969,7777,88,192,"PSOE",2319
9,"9447",43,37,36,0,1,"PSOE",15
12,"12113",90,59,59,1,0,"PSOE",15
37,"37087",911,675,665,5,10,"PSOE",137
50,"50203",1065,817,804,5,13,"PSOE",228
23,"23063",3784,2699,2664,22,35,"PSOE",1156
9,"9400",307,225,224,4,1,"PSOE",100
28,"28019",1272,926,914,6,12,"PSOE",332
24,"24065",2164,1524,1492,12,32,"PSOE",481
49,"49019",232,162,152,2,10,"PSOE",54
26,"26176",56,43,43,0,0,"PSOE",5
14,"14071",874,551,540,5,11,"PSOE",235
19,"19151",1077,703,693,8,10,"PSOE",214
49,"49129",810,541,527,4,14,"PSOE",245
46,"46011",7523,5154,5077,34,77,"PSOE",1223
10,"10135",1240,834,826,3,8,"PSOE",346
47,"47030",935,680,669,5,11,"PSOE",177
47,"47125",49,42,42,0,0,"PSOE",7
12,"12114",200,144,140,0,4,"PSOE",41
28,"28092",153631,112460,111341,913,1119,"PSOE",34075
49,"49130",155,116,112,1,4,"PSOE",35
47,"47187",71,49,49,0,0,"PSOE",10
5,"5017",84,70,67,2,3,"PSOE",14
45,"45003",554,398,393,2,5,"PSOE",137
9,"9449",91,78,76,1,2,"PSOE",6
16,"16101",137,111,109,1,2,"PSOE",53
31,"31079",65,46,46,2,0,"PSOE",17
45,"45004",546,400,398,2,2,"PSOE",139
38,"38018",4466,2867,2821,21,46,"PSOE",821
16,"16102",1159,815,767,9,48,"PSOE",208
46,"46012",965,689,675,4,14,"PSOE",195
9,"9292",72,55,55,3,0,"PSOE",17
28,"28093",2177,1681,1658,11,23,"PSOE",356
10,"10097",107,84,80,0,4,"PSOE",30
29,"29059",2662,1950,1895,16,55,"PSOE",745
28,"28159",589,455,447,4,8,"PSOE",123
19,"19118",11,10,9,0,1,"PSOE",7
29,"29004",283,222,218,3,4,"PSOE",88
16,"16231",45,38,38,0,0,"PSOE",6
28,"28094",988,711,707,5,4,"PSOE",143
14,"14016",1273,936,922,5,14,"PSOE",476
3,"3101",4933,3502,3462,16,40,"PSOE",921
33,"33035",11214,7359,7303,102,56,"PSOE",2253
28,"28022",37338,30620,30455,229,165,"PSOE",4820
50,"50206",457,349,345,5,4,"PSOE",96
18,"18065",588,464,451,2,13,"PSOE",166
5,"5120",33,26,26,0,0,"PSOE",6
9,"9238",931,473,461,1,12,"PSOE",168
40,"40160",93,65,62,0,3,"PSOE",7
50,"50131",212,152,147,4,5,"PSOE",40
5,"5019",44865,32917,32586,282,331,"PSOE",7856
23,"23067",2405,1765,1724,14,41,"PSOE",731
19,"19245",1138,798,778,6,20,"PSOE",263
22,"22019",176,128,126,1,2,"PSOE",45
3,"3132",512,376,373,2,3,"PSOE",137
39,"39074",7050,5074,5029,26,45,"PSOE",810
26,"26142",789,572,564,6,8,"PSOE",190
24,"24106",218,139,139,1,0,"PSOE",40
9,"9353",74,56,54,1,2,"PSOE",14
41,"41071",5571,3608,3516,64,92,"PSOE",1579
24,"24107",206,147,147,1,0,"PSOE",45
19,"19186",76,60,60,0,0,"PSOE",27
49,"49170",99,68,68,1,0,"PSOE",28
37,"37222",78,55,55,2,0,"PSOE",10
42,"42054",18,12,12,0,0,"PSOE",8
10,"10100",783,494,447,5,47,"PSOE",207
47,"47096",127,94,93,1,1,"PSOE",27
50,"50281",68,52,50,0,2,"PSOE",10
49,"49025",157,121,118,0,3,"PSOE",53
31,"31120",376,211,209,7,2,"PSOE",33
6,"6016",2937,2042,1978,12,64,"PSOE",943
16,"16187",55,38,38,3,0,"PSOE",13
19,"19051",61,52,52,0,0,"PSOE",24
47,"47130",94,64,63,0,1,"PSOE",14
26,"26183",66,48,48,0,0,"PSOE",10
46,"46152",90,63,63,0,0,"PSOE",16
49,"49135",576,368,366,3,2,"PSOE",114
40,"40097",130,103,102,5,1,"PSOE",44
37,"37285",360,271,270,0,1,"PSOE",92
5,"5023",174,148,145,2,3,"PSOE",36
31,"31121",62,42,42,0,0,"PSOE",5
5,"5123",106,78,78,0,0,"PSOE",13
13,"13088",585,413,409,3,4,"PSOE",189
50,"50056",399,296,296,3,0,"PSOE",104
22,"22122",69,52,50,2,2,"PSOE",15
45,"45010",383,258,257,3,1,"PSOE",116
45,"45120",113,86,86,0,0,"PSOE",38
19,"19052",21,16,16,0,0,"PSOE",13
50,"50234",242,159,154,4,5,"PSOE",31
24,"24222",14499,10219,10076,99,143,"PSOE",3135
37,"37191",102,57,57,1,0,"PSOE",15
7,"7026",31129,17489,17342,178,147,"PSOE",5330
6,"6064",847,616,601,3,15,"PSOE",323
6,"6155",1810,1172,1140,23,32,"PSOE",479
37,"37380",55,41,40,2,1,"PSOE",15
47,"47098",567,452,446,4,6,"PSOE",113
29,"29064",423,291,285,2,6,"PSOE",112
47,"47163",277,208,205,3,3,"PSOE",93
18,"18136",1778,1320,1284,14,36,"PSOE",709
50,"50057",1331,933,922,10,11,"PSOE",252
50,"50108",50,37,37,0,0,"PSOE",11
26,"26031",95,83,83,0,0,"PSOE",27
19,"19123",37,30,28,0,2,"PSOE",9
30,"30030",321454,235061,233183,1744,1878,"PSOE",53175
24,"24183",748,464,460,9,4,"PSOE",163
44,"44066",85,62,62,0,0,"PSOE",32
10,"10022",409,301,291,1,10,"PSOE",120
9,"9247",21,18,18,0,0,"PSOE",6
19,"19053",1906,1323,1304,12,19,"PSOE",431
6,"6066",1708,1180,1171,6,9,"PSOE",682
22,"22235",88,69,68,1,1,"PSOE",20
37,"37382",162,127,124,0,3,"PSOE",55
50,"50284",129,98,98,0,0,"PSOE",39
50,"50058",63,45,43,0,2,"PSOE",13
40,"40198",24,20,19,0,1,"PSOE",3
22,"22126",89,64,64,0,0,"PSOE",12
49,"49251",159,116,109,2,7,"PSOE",38
40,"40101",918,672,665,11,7,"PSOE",167
31,"31125",271,173,171,3,2,"PSOE",37
50,"50135",85,59,59,0,0,"PSOE",16
46,"46154",795,619,608,5,11,"PSOE",102
47,"47195",426,314,310,2,4,"PSOE",113
46,"46086",80,66,65,1,1,"PSOE",19
40,"40103",139,113,113,0,0,"PSOE",35
24,"24078",324,228,225,0,3,"PSOE",94
49,"49139",149,112,112,0,0,"PSOE",34
18,"18171",2098,1521,1460,11,61,"PSOE",564
19,"19161",212,158,157,3,1,"PSOE",61
5,"5026",183,149,147,1,2,"PSOE",34
3,"3079",18422,13560,13378,152,182,"PSOE",3841
42,"42107",70,48,47,1,1,"PSOE",14
9,"9140",117,78,77,1,1,"PSOE",31
3,"3138",3190,2244,2207,9,37,"PSOE",582
37,"37353",122,82,80,0,2,"PSOE",28
33,"33042",4237,2862,2816,49,46,"PSOE",863
28,"28060",1585,1160,1146,5,14,"PSOE",512
40,"40104",283,203,200,0,3,"PSOE",56
16,"16002",192,160,158,2,2,"PSOE",46
19,"19162",67,41,41,0,0,"PSOE",16
31,"31127",131,90,86,0,4,"PSOE",9
3,"3080",1330,1040,1032,4,8,"PSOE",243
13,"13095",66,56,56,3,0,"PSOE",14
35,"35011",24859,15025,14833,149,192,"PSOE",4211
45,"45016",4486,3288,3251,19,37,"PSOE",1010
9,"9309",293,198,193,5,5,"PSOE",39
9,"9473",85,68,64,0,4,"PSOE",20
10,"10109",1714,1030,1006,4,24,"PSOE",425
31,"31128",349,217,215,4,2,"PSOE",37
5,"5029",100,73,73,1,0,"PSOE",16
44,"44107",212,135,135,0,0,"PSOE",56
41,"41050",5173,3954,3878,36,76,"PSOE",1486
23,"23043",517,360,360,1,0,"PSOE",139
19,"19163",60,49,49,0,0,"PSOE",11
5,"5129",111,70,69,0,1,"PSOE",5
31,"31239",282,196,193,6,3,"PSOE",32
23,"23077",604,482,477,2,5,"PSOE",245
37,"37103",409,295,294,2,1,"PSOE",83
11,"11036",683,401,395,15,6,"PSOE",194
9,"9200",48,29,29,0,0,"PSOE",14
31,"31129",388,239,238,3,1,"PSOE",35
24,"24189",5872,3915,3873,42,42,"PSOE",1008
9,"9144",44,31,31,0,0,"PSOE",5
29,"29013",1613,1191,1154,9,37,"PSOE",484
7,"7033",28539,15238,15070,187,168,"PSOE",3468
21,"21019",592,397,389,6,8,"PSOE",210
38,"38003",1517,899,890,5,9,"PSOE",395
40,"40106",179,140,139,2,1,"PSOE",50
10,"10070",667,493,489,1,4,"PSOE",176
2,"2051",1654,1115,1101,13,14,"PSOE",276
12,"12018",279,233,231,3,2,"PSOE",84
50,"50264",151,111,110,0,1,"PSOE",57
50,"50037",125,85,80,0,5,"PSOE",22
46,"46203",3546,2717,2689,28,28,"PSOE",815
47,"47012",100,72,71,0,1,"PSOE",17
29,"29088",2689,1817,1747,15,70,"PSOE",763
19,"19165",45,39,39,0,0,"PSOE",15
9,"9423",27,24,24,1,0,"PSOE",2
47,"47013",91,77,77,1,0,"PSOE",37
37,"37106",248,161,160,4,1,"PSOE",39
5,"5034",15,14,13,0,1,"PSOE",3
37,"37069",981,669,657,3,12,"PSOE",174
50,"50114",132,108,108,0,0,"PSOE",45
9,"9482",34,22,22,0,0,"PSOE",1
21,"21020",349,230,228,2,2,"PSOE",115
45,"45130",294,222,222,1,0,"PSOE",72
19,"19130",61556,45926,45388,408,538,"PSOE",14484
22,"22032",102,69,68,1,1,"PSOE",24
5,"5262",318,238,235,1,3,"PSOE",104
9,"9483",189,156,155,2,1,"PSOE",48
19,"19256",46,36,36,0,0,"PSOE",10
2,"2054",375,288,283,0,5,"PSOE",82
19,"19061",56,42,41,0,1,"PSOE",10
37,"37004",25,18,18,0,0,"PSOE",3
7,"7035",1595,1095,1078,13,17,"PSOE",275
16,"16083",44,24,24,0,0,"PSOE",3
40,"40108",109,85,85,2,0,"PSOE",23
47,"47014",48,39,39,1,0,"PSOE",13
47,"47106",44,30,30,0,0,"PSOE",9
44,"44110",37,30,30,0,0,"PSOE",6
31,"31133",34,27,27,1,0,"PSOE",7
40,"40012",241,160,156,7,4,"PSOE",47
34,"34087",125,99,99,2,0,"PSOE",20
16,"16121",227,160,152,0,8,"PSOE",65
9,"9317",20,18,18,0,0,"PSOE",3
11,"11010",6327,3998,3928,112,70,"PSOE",1570
46,"46205",14237,10641,10533,77,108,"PSOE",3062
16,"16044",43,29,28,0,1,"PSOE",8
6,"6078",500,363,359,1,4,"PSOE",134
28,"28111",629,479,475,2,4,"PSOE",134
29,"29017",6404,4575,4468,48,107,"PSOE",1965
16,"16008",80,63,63,1,0,"PSOE",28
37,"37265",198,167,163,1,4,"PSOE",88
19,"19103",247,205,202,1,3,"PSOE",82
49,"49149",368,270,266,1,4,"PSOE",68
46,"46160",1922,1395,1381,4,14,"PSOE",472
47,"47016",65,55,55,0,0,"PSOE",13
40,"40206",162,126,123,0,3,"PSOE",26
23,"23085",2171,1587,1575,7,12,"PSOE",904
10,"10117",238,133,130,0,3,"PSOE",85
5,"5134",47,40,40,0,0,"PSOE",7
34,"34135",398,267,264,4,3,"PSOE",63
6,"6035",851,630,620,0,10,"PSOE",222
19,"19033",47,38,37,1,1,"PSOE",15
4,"4001",1002,717,710,3,7,"PSOE",310
41,"41101",6025,4299,4213,53,86,"PSOE",1808
16,"16123",66,42,41,0,1,"PSOE",15
33,"33077",1097,688,683,4,5,"PSOE",240
50,"50291",95,76,76,0,0,"PSOE",17
50,"50066",2903,2095,2078,19,17,"PSOE",424
40,"40013",57,47,47,0,0,"PSOE",3
49,"49081",1321,972,953,6,19,"PSOE",395
50,"50090",134,96,96,0,0,"PSOE",16
24,"24198",541,346,344,6,2,"PSOE",206
19,"19066",51,42,42,0,0,"PSOE",6
24,"24089",101036,71905,71305,744,600,"PSOE",21752
21,"21024",464,328,312,1,16,"PSOE",167
50,"50219",4283,3034,2990,30,44,"PSOE",720
26,"26082",101,79,79,0,0,"PSOE",35
45,"45025",1218,849,844,9,5,"PSOE",314
6,"6082",399,295,291,6,4,"PSOE",127
47,"47112",2561,1960,1933,13,27,"PSOE",481
18,"18083",232,181,179,1,2,"PSOE",72
38,"38008",5699,3719,3669,26,50,"PSOE",1049
22,"22039",813,635,634,4,1,"PSOE",229
9,"9905",373,239,238,2,1,"PSOE",64
50,"50293",392,257,255,2,2,"PSOE",116
22,"22137",1009,671,665,1,6,"PSOE",301
42,"42034",41,25,25,0,0,"PSOE",9
33,"33078",127,81,81,0,0,"PSOE",35
45,"45026",219,166,164,1,2,"PSOE",71
24,"24090",323,200,200,2,0,"PSOE",58
18,"18084",4533,3233,3178,35,55,"PSOE",931
34,"34001",39,27,27,1,0,"PSOE",8
47,"47019",92,68,68,1,0,"PSOE",15
37,"37205",212,157,155,1,2,"PSOE",55
19,"19067",68,46,44,0,2,"PSOE",22
46,"46231",2403,1670,1652,11,18,"PSOE",488
37,"37206",87,65,54,0,11,"PSOE",16
49,"49266",66,46,45,1,1,"PSOE",10
22,"22139",80,57,57,1,0,"PSOE",6
10,"10081",176,121,119,0,2,"PSOE",43
29,"29095",3285,2313,2224,39,89,"PSOE",1068
16,"16049",137,98,98,2,0,"PSOE",43
26,"26125",2665,1885,1853,21,32,"PSOE",692
47,"47082",805,641,630,3,11,"PSOE",152
23,"23090",1204,953,938,6,15,"PSOE",406
18,"18182",1926,1222,1204,8,18,"PSOE",536
34,"34004",5517,3819,3769,36,50,"PSOE",1223
12,"12055",103,77,76,2,1,"PSOE",16
16,"16013",26,24,24,0,0,"PSOE",10
21,"21057",995,600,590,8,10,"PSOE",402
22,"22217",370,274,269,4,5,"PSOE",88
46,"46004",1932,1530,1512,10,18,"PSOE",364
19,"19108",95,78,78,0,0,"PSOE",28
24,"24127",263,183,181,1,2,"PSOE",48
5,"5042",141,111,111,0,0,"PSOE",27
42,"42173",29860,19581,19206,337,375,"PSOE",7786
49,"49120",54,35,35,0,0,"PSOE",16
16,"16259",28,22,22,0,0,"PSOE",12
41,"41088",515,368,358,2,10,"PSOE",187
28,"28072",6176,4716,4673,44,43,"PSOE",975
9,"9012",93,70,68,0,2,"PSOE",25
49,"49268",364,266,263,3,3,"PSOE",50
10,"10124",867,622,612,1,10,"PSOE",296
47,"47116",396,304,302,2,2,"PSOE",81
24,"24093",342,214,212,2,2,"PSOE",63
29,"29051",42179,27231,26724,282,507,"PSOE",6804
40,"40212",26,19,19,1,0,"PSOE",7
46,"46097",948,670,663,1,7,"PSOE",173
14,"14008",2758,1880,1836,21,44,"PSOE",765
12,"12132",477,391,385,3,6,"PSOE",110
49,"49156",218,149,144,0,5,"PSOE",48
45,"45141",848,626,615,0,11,"PSOE",238
40,"40019",29,23,23,1,0,"PSOE",8
5,"5043",73,58,58,0,0,"PSOE",24
3,"3093",19702,13903,13728,113,175,"PSOE",4184
29,"29098",1228,902,876,11,26,"PSOE",439
4,"4045",1696,1268,1254,17,14,"PSOE",670
45,"45105",376,277,268,5,9,"PSOE",91
18,"18056",3382,2397,2350,30,47,"PSOE",961
18,"18153",8834,6174,6063,54,111,"PSOE",1808
9,"9114",77,60,59,0,1,"PSOE",13
41,"41090",3489,2560,2467,27,93,"PSOE",1082
46,"46212",1620,1130,1112,12,18,"PSOE",306
39,"39064",1352,1007,990,3,17,"PSOE",150
24,"24168",430,325,322,6,3,"PSOE",97
10,"10004",692,482,473,8,9,"PSOE",227
7,"7045",1317,931,928,8,3,"PSOE",258
18,"18088",1526,1000,993,10,7,"PSOE",468
5,"5045",81,58,58,0,0,"PSOE",8
49,"49048",113,88,88,0,0,"PSOE",18
9,"9170",207,151,150,1,1,"PSOE",35
44,"44118",154,109,106,1,3,"PSOE",30
42,"42177",61,42,41,0,1,"PSOE",16
12,"12058",59,47,45,1,2,"PSOE",4
18,"18089",14504,9854,9746,100,108,"PSOE",3340
3,"3009",46125,33613,33319,315,294,"PSOE",11423
44,"44119",116,80,79,1,1,"PSOE",22
18,"18187",510,350,350,2,0,"PSOE",219
5,"5239",215,163,163,3,0,"PSOE",34
9,"9063",215,184,181,2,3,"PSOE",23
33,"33028",1143,519,518,7,1,"PSOE",241
34,"34151",148,98,96,1,2,"PSOE",27
18,"18154",982,668,668,4,0,"PSOE",213
42,"42004",2290,1595,1565,30,30,"PSOE",487
37,"37015",198,127,125,2,2,"PSOE",43
10,"10129",340,234,227,2,7,"PSOE",111
50,"50274",64,46,43,1,3,"PSOE",10
31,"31146",30,22,22,1,0,"PSOE",3
37,"37119",99,78,78,1,0,"PSOE",44
6,"6094",1457,868,858,5,10,"PSOE",512
47,"47025",114,85,85,3,0,"PSOE",31
45,"45145",2631,1746,1707,12,39,"PSOE",428
9,"9018",24624,17232,16983,192,249,"PSOE",5858
47,"47121",517,410,398,2,12,"PSOE",183
34,"34154",77,48,48,1,0,"PSOE",9
10,"10130",1754,1199,1189,10,10,"PSOE",603
2,"2067",1137,808,794,2,14,"PSOE",315
18,"18059",4265,2960,2886,23,74,"PSOE",1201
29,"29072",3291,2360,2307,19,53,"PSOE",1046
44,"44001",65,43,43,1,0,"PSOE",6
10,"10008",1274,921,908,1,13,"PSOE",336
39,"39039",540,355,355,1,0,"PSOE",72
47,"47216",111,94,91,0,3,"PSOE",1
24,"24211",259,199,198,3,1,"PSOE",50
3,"3096",5786,4355,4281,38,74,"PSOE",1285
40,"40088",272,192,192,0,0,"PSOE",44
31,"31148",92,62,59,2,3,"PSOE",21
5,"5047",4105,3004,2936,23,68,"PSOE",1077
37,"37309",36,21,21,0,0,"PSOE",3
10,"10009",255,165,162,1,3,"PSOE",48
40,"40024",823,582,575,8,7,"PSOE",171
10,"10172",696,447,443,5,4,"PSOE",180
9,"9021",50,30,30,3,0,"PSOE",4
34,"34017",889,676,665,7,11,"PSOE",233
34,"34018",199,151,149,4,2,"PSOE",36
12,"12061",374,263,261,4,2,"PSOE",103
24,"24100",737,506,502,9,4,"PSOE",145
19,"19080",67,47,47,0,0,"PSOE",9
44,"44056",446,327,325,1,2,"PSOE",71
19,"19211",350,272,269,0,3,"PSOE",78
7,"7050",3513,2036,2013,25,23,"PSOE",311
23,"23099",4824,3523,3435,35,88,"PSOE",1324
5,"5049",403,261,253,1,8,"PSOE",90
39,"39041",1753,1285,1269,7,16,"PSOE",304
50,"50001",89,68,68,0,0,"PSOE",13
7,"7051",5484,3133,3094,43,39,"PSOE",758
6,"6098",530,379,376,4,3,"PSOE",186
47,"47029",50,37,35,1,2,"PSOE",6
44,"44209",799,584,573,2,11,"PSOE",124
18,"18063",1232,687,678,9,9,"PSOE",267
50,"50229",65,46,46,1,0,"PSOE",11
39,"39042",5910,4354,4315,14,39,"PSOE",810
16,"16024",121,85,84,0,1,"PSOE",39
42,"42049",108,71,71,1,0,"PSOE",11
29,"29074",771,561,555,1,6,"PSOE",253
5,"5244",39,29,29,0,0,"PSOE",3
3,"3099",43101,30222,29885,196,337,"PSOE",7035
46,"46102",19696,14700,14579,125,121,"PSOE",5258
11,"11024",6550,4500,4402,67,98,"PSOE",1859
9,"9232",139,100,97,1,3,"PSOE",40
3,"3129",1224,934,923,4,11,"PSOE",238
37,"37312",244,191,189,1,2,"PSOE",49
26,"26099",1220,956,931,7,25,"PSOE",376
5,"5052",85,70,69,0,1,"PSOE",2
10,"10013",265,184,182,0,2,"PSOE",69
41,"41068",13963,9596,9407,96,189,"PSOE",4771
6,"6101",437,355,346,1,9,"PSOE",129
5,"5151",83,60,60,0,0,"PSOE",14
24,"24215",149,116,115,0,1,"PSOE",17
19,"19214",74,51,51,0,0,"PSOE",15
7,"7053",1209,870,864,10,6,"PSOE",232
22,"22157",181,122,121,2,1,"PSOE",50
44,"44033",243,165,165,3,0,"PSOE",46
4,"4054",363,279,278,2,1,"PSOE",105
45,"45152",545,402,393,1,9,"PSOE",175
10,"10014",1816,1285,1254,13,31,"PSOE",546
39,"39044",3921,2805,2783,18,22,"PSOE",591
26,"26179",39,27,27,0,0,"PSOE",15
7,"7021",229,154,150,3,4,"PSOE",21
26,"26101",31,18,17,0,1,"PSOE",7
22,"22050",93,77,77,0,0,"PSOE",26
47,"47031",191,141,140,0,1,"PSOE",38
31,"31117",583,373,372,3,1,"PSOE",25
49,"49205",359,252,251,7,1,"PSOE",58
40,"40191",198,143,138,0,5,"PSOE",25
12,"12140",1147,849,841,5,8,"PSOE",280
21,"21039",303,211,210,6,1,"PSOE",115
16,"16143",15,10,10,1,0,"PSOE",1
34,"34024",25,14,14,0,0,"PSOE",1
46,"46104",1906,1422,1409,5,13,"PSOE",380
49,"49132",310,220,215,2,5,"PSOE",61
50,"50004",475,360,356,2,4,"PSOE",155
37,"37221",391,259,257,2,2,"PSOE",113
45,"45043",776,608,598,3,10,"PSOE",201
45,"45191",524,437,432,2,5,"PSOE",205
23,"23904",2570,1583,1562,10,21,"PSOE",672
45,"45117",718,552,548,0,4,"PSOE",265
50,"50256",70,43,43,0,0,"PSOE",5
34,"34069",2184,1555,1517,17,38,"PSOE",634
6,"6014",6503,4235,4181,35,54,"PSOE",1315
14,"14018",3617,2632,2568,31,64,"PSOE",842
6,"6105",592,367,363,1,4,"PSOE",152
37,"37128",235,169,168,0,1,"PSOE",76
7,"7056",5271,3429,3386,44,43,"PSOE",711
13,"13086",158,122,120,0,2,"PSOE",61
37,"37092",1933,1342,1327,13,15,"PSOE",314
5,"5088",29,22,22,0,0,"PSOE",3
39,"39046",1342,910,902,3,8,"PSOE",204
45,"45154",1491,1033,1024,11,9,"PSOE",308
24,"24146",254,202,201,1,1,"PSOE",56
40,"40161",32,24,23,1,1,"PSOE",1
44,"44127",57,43,43,0,0,"PSOE",11
16,"16236",857,615,608,1,7,"PSOE",163
13,"13087",23255,15400,15127,213,273,"PSOE",4935
9,"9458",490,388,385,6,3,"PSOE",109
12,"12011",4583,3228,3177,24,51,"PSOE",1161
47,"47224",93,75,75,1,0,"PSOE",21
10,"10019",1412,948,934,2,14,"PSOE",321
46,"46174",942,746,736,1,10,"PSOE",276
9,"9190",86,58,54,2,4,"PSOE",6
18,"18006",4062,2765,2711,25,54,"PSOE",935
37,"37025",245,198,196,5,2,"PSOE",57
49,"49063",303,228,227,3,1,"PSOE",72
40,"40032",368,247,244,5,3,"PSOE",71
21,"21042",15610,8112,8011,164,101,"PSOE",2174
35,"35030",10046,5584,5505,44,79,"PSOE",1462
26,"26106",79,67,67,0,0,"PSOE",33
50,"50081",487,355,349,5,6,"PSOE",128
31,"31158",248,156,151,0,5,"PSOE",19
24,"24108",348,247,246,4,1,"PSOE",57
34,"34072",145,125,123,1,2,"PSOE",25
22,"22085",94,78,76,0,2,"PSOE",38
22,"22163",426,338,335,0,3,"PSOE",91
34,"34029",665,524,518,1,6,"PSOE",118
24,"24109",857,534,528,8,6,"PSOE",227
11,"11030",22999,14858,14586,207,272,"PSOE",3739
40,"40131",51,45,45,0,0,"PSOE",11
37,"37130",173,135,134,2,1,"PSOE",15
10,"10144",915,618,614,0,4,"PSOE",281
12,"12095",950,723,712,5,11,"PSOE",257
45,"45011",279,235,233,4,2,"PSOE",86
39,"39049",304,198,195,2,3,"PSOE",60
37,"37286",204,140,137,2,3,"PSOE",59
13,"13091",537,466,464,3,2,"PSOE",185
37,"37098",290,197,197,1,0,"PSOE",104
44,"44102",26,19,19,0,0,"PSOE",0
3,"3021",5573,4423,4343,23,80,"PSOE",1123
44,"44217",32,25,25,0,0,"PSOE",11
6,"6020",1752,1330,1296,6,34,"PSOE",573
50,"50161",98,75,74,2,1,"PSOE",12
47,"47037",161,128,125,1,3,"PSOE",34
45,"45159",83,71,69,0,2,"PSOE",24
47,"47038",100,61,61,0,0,"PSOE",27
3,"3022",140,125,121,1,4,"PSOE",21
23,"23002",17427,12837,12542,126,295,"PSOE",4738
5,"5059",92,49,48,0,1,"PSOE",17
29,"29038",18908,12122,11931,197,191,"PSOE",3648
37,"37028",131,96,93,2,3,"PSOE",17
22,"22165",449,305,300,3,5,"PSOE",95
50,"50236",95,77,75,0,2,"PSOE",25
16,"16150",98,66,66,2,0,"PSOE",22
42,"42059",20,14,14,0,0,"PSOE",0
22,"22057",364,253,248,4,5,"PSOE",141
5,"5159",224,133,132,3,1,"PSOE",8
10,"10024",672,492,480,6,12,"PSOE",132
3,"3023",1377,1138,1122,9,16,"PSOE",343
47,"47165",6823,4999,4906,48,93,"PSOE",1140
37,"37133",101,73,69,1,4,"PSOE",15
42,"42197",68,54,53,0,1,"PSOE",12
46,"46109",6248,4516,4440,37,76,"PSOE",1332
19,"19095",11,7,6,0,1,"PSOE",1
5,"5224",102,85,84,2,1,"PSOE",8
19,"19125",45,23,23,0,0,"PSOE",5
6,"6069",2985,1921,1874,17,47,"PSOE",964
49,"49107",115,70,70,0,0,"PSOE",29
47,"47197",875,659,656,9,3,"PSOE",201
47,"47166",251,183,181,2,2,"PSOE",44
35,"35034",8392,3946,3908,27,38,"PSOE",1010
24,"24226",194,118,118,1,0,"PSOE",26
12,"12072",1083,852,827,10,25,"PSOE",274
41,"41077",8631,5788,5598,51,190,"PSOE",2473
19,"19096",105,72,70,0,2,"PSOE",20
24,"24007",735,500,496,8,4,"PSOE",237
7,"7064",5566,3232,3204,18,28,"PSOE",913
50,"50163",3846,2863,2840,25,23,"PSOE",575
40,"40037",30,17,17,0,0,"PSOE",5
49,"49069",337,210,201,0,9,"PSOE",56
45,"45163",8326,5835,5693,48,142,"PSOE",1932
5,"5259",99,80,79,2,1,"PSOE",19
34,"34036",230,159,158,0,1,"PSOE",76
34,"34176",127,95,90,3,5,"PSOE",10
46,"46248",4868,3434,3374,16,60,"PSOE",938
16,"16245",396,304,298,1,6,"PSOE",85
37,"37230",220,169,168,1,1,"PSOE",62
10,"10150",339,279,275,3,4,"PSOE",161
7,"7065",2319,1429,1411,15,18,"PSOE",218
18,"18909",514,403,403,0,0,"PSOE",217
18,"18108",822,604,599,2,5,"PSOE",264
31,"31092",683,413,413,6,0,"PSOE",71
33,"33044",177059,121380,120421,1543,959,"PSOE",33441
22,"22060",1167,817,808,14,9,"PSOE",302
30,"30009",12728,9487,9365,46,122,"PSOE",2590
37,"37355",159,121,120,1,1,"PSOE",27
6,"6027",645,523,513,0,10,"PSOE",178
24,"24116",387,227,226,3,1,"PSOE",72
24,"24117",410,302,301,1,1,"PSOE",46
2,"2018",789,611,606,3,5,"PSOE",215
37,"37231",236,185,183,5,2,"PSOE",55
24,"24190",146,103,103,2,0,"PSOE",28
45,"45129",98,77,77,1,0,"PSOE",32
26,"26075",315,234,229,1,5,"PSOE",82
16,"16004",228,175,174,0,1,"PSOE",66
37,"37104",24,16,16,0,0,"PSOE",4
13,"13009",1383,1081,1070,3,11,"PSOE",314
47,"47139",997,728,719,4,9,"PSOE",272
7,"7902",1091,663,645,13,18,"PSOE",165
5,"5164",18,12,12,0,0,"PSOE",2
46,"46021",24053,17331,17194,159,137,"PSOE",5606
11,"11038",13632,10047,9812,99,235,"PSOE",3153
31,"31058",199,134,133,2,1,"PSOE",16
16,"16041",334,244,243,2,1,"PSOE",87
18,"18077",471,350,343,1,7,"PSOE",177
22,"22131",84,62,58,5,4,"PSOE",27
19,"19288",21,20,20,2,0,"PSOE",7
47,"47140",106,83,83,0,0,"PSOE",12
9,"9372",204,175,169,2,6,"PSOE",62
6,"6076",825,573,562,1,11,"PSOE",250
44,"44136",48,43,43,1,0,"PSOE",12
37,"37263",339,215,210,0,5,"PSOE",78
37,"37327",179,148,147,2,1,"PSOE",54
9,"9047",52,42,41,1,1,"PSOE",5
18,"18078",714,546,538,5,8,"PSOE",250
9,"9048",1373,937,911,10,26,"PSOE",293
18,"18016",297,200,198,3,2,"PSOE",97
11,"11039",9957,6134,6043,152,91,"PSOE",2160
46,"46113",2558,1791,1773,7,18,"PSOE",400
18,"18912",1352,926,912,7,14,"PSOE",468
47,"47141",112,90,89,0,1,"PSOE",16
22,"22174",462,352,350,0,2,"PSOE",124
37,"37234",314,194,192,3,2,"PSOE",77
44,"44045",360,271,271,0,0,"PSOE",83
4,"4069",4742,3364,3325,46,39,"PSOE",1193
10,"10115",3460,2584,2503,15,81,"PSOE",939
9,"9375",42,35,35,0,0,"PSOE",6
4,"4070",1529,1088,1076,8,12,"PSOE",368
33,"33019",2844,1702,1680,11,22,"PSOE",561
5,"5230",65,57,56,1,1,"PSOE",4
18,"18146",930,645,629,10,16,"PSOE",258
52,"52001",54293,31015,30776,185,239,"PSOE",5042
47,"47142",121,85,85,0,0,"PSOE",12
10,"10033",397,269,268,0,1,"PSOE",75
4,"4103",1432,1003,993,10,10,"PSOE",337
10,"10116",3737,2579,2507,34,72,"PSOE",1041
31,"31207",280,194,191,3,3,"PSOE",29
9,"9051",164,125,125,0,0,"PSOE",27
42,"42071",159,92,92,2,0,"PSOE",29
10,"10157",246,163,161,0,2,"PSOE",53
42,"42208",20,12,12,1,0,"PSOE",3
6,"6125",1644,1251,1222,7,29,"PSOE",522
9,"9211",1369,938,921,14,17,"PSOE",275
24,"24015",2193,1532,1500,12,32,"PSOE",415
23,"23049",1740,1215,1183,12,32,"PSOE",611
46,"46093",2151,1652,1640,10,12,"PSOE",487
28,"28037",1570,1135,1123,4,12,"PSOE",474
46,"46229",903,715,708,5,7,"PSOE",223
49,"49151",591,389,388,3,1,"PSOE",155
31,"31172",370,257,250,6,7,"PSOE",41
16,"16046",213,142,142,0,0,"PSOE",44
5,"5168",3503,2536,2511,29,25,"PSOE",571
49,"49186",230,172,170,0,2,"PSOE",33
29,"29046",2494,1727,1693,13,34,"PSOE",699
18,"18148",787,618,605,5,13,"PSOE",239
24,"24052",139,94,93,0,1,"PSOE",43
34,"34186",49,44,44,0,0,"PSOE",11
12,"12079",414,310,305,2,5,"PSOE",92
18,"18915",726,474,467,4,7,"PSOE",257
50,"50091",39,32,32,0,0,"PSOE",7
9,"9214",632,409,407,2,2,"PSOE",148
37,"37331",186,115,114,2,1,"PSOE",31
42,"42075",78,50,50,1,0,"PSOE",10
2,"2025",7345,5388,5278,51,110,"PSOE",1417
31,"31064",1398,1035,1031,5,4,"PSOE",408
24,"24124",338,196,195,2,1,"PSOE",60
6,"6128",4457,2996,2934,28,62,"PSOE",1211
18,"18020",489,318,310,2,8,"PSOE",117
19,"19106",77,57,57,0,0,"PSOE",21
4,"4074",2910,1813,1789,15,24,"PSOE",618
44,"44048",52,47,47,0,0,"PSOE",13
5,"5073",282,210,207,1,3,"PSOE",53
23,"23015",1316,979,973,18,6,"PSOE",499
3,"3032",97,82,82,0,0,"PSOE",18
37,"37074",136,93,90,1,3,"PSOE",38
9,"9216",370,245,241,3,4,"PSOE",72
34,"34190",50,33,33,1,0,"PSOE",6
33,"33023",3249,2127,2097,30,30,"PSOE",837
9,"9217",342,240,237,1,3,"PSOE",61
31,"31175",66,46,46,0,0,"PSOE",9
41,"41086",16199,10227,10105,137,122,"PSOE",3957
9,"9382",27,22,22,0,0,"PSOE",5
41,"41058",17956,12890,12553,200,337,"PSOE",4219
45,"45065",264,211,206,1,5,"PSOE",98
9,"9009",158,127,124,5,3,"PSOE",29
9,"9269",29,24,23,0,1,"PSOE",4
19,"19037",131,109,108,0,1,"PSOE",19
46,"46163",1883,1471,1460,8,11,"PSOE",321
5,"5901",247,154,152,3,2,"PSOE",36
23,"23017",1498,1153,1129,11,24,"PSOE",650
34,"34192",76,59,59,0,0,"PSOE",5
49,"49084",266,197,195,11,2,"PSOE",44
31,"31176",2919,1974,1933,27,41,"PSOE",727
49,"49232",85,64,64,0,0,"PSOE",22
29,"29021",155,111,109,1,2,"PSOE",39
40,"40211",66,54,54,1,0,"PSOE",13
22,"22250",346,241,241,0,0,"PSOE",72
39,"39034",255,133,128,2,5,"PSOE",21
30,"30017",11428,8196,8113,44,83,"PSOE",2357
22,"22069",423,296,294,4,2,"PSOE",87
41,"41003",2373,1747,1708,18,39,"PSOE",738
37,"37240",928,648,637,2,11,"PSOE",165
46,"46028",383,305,299,8,6,"PSOE",82
16,"16015",349,242,239,6,3,"PSOE",57
12,"12001",1028,783,768,6,15,"PSOE",249
29,"29050",392,229,227,3,2,"PSOE",93
19,"19003",36,30,30,0,0,"PSOE",18
30,"30018",8399,6226,6148,28,78,"PSOE",1917
10,"10165",252,204,201,3,3,"PSOE",85
3,"3121",21997,14689,14572,103,117,"PSOE",3528
39,"39063",936,618,616,4,2,"PSOE",150
2,"2029",3333,2363,2320,13,43,"PSOE",776
3,"3035",627,485,485,2,0,"PSOE",184
42,"42081",126,88,88,0,0,"PSOE",27
9,"9221",498,380,377,8,3,"PSOE",114
46,"46142",778,536,524,3,12,"PSOE",159
13,"13023",8944,6251,6165,50,86,"PSOE",1172
26,"26014",443,278,273,3,5,"PSOE",129
50,"50174",80,58,57,0,1,"PSOE",16
28,"28073",12707,9198,9080,94,118,"PSOE",2543
44,"44146",164,133,133,2,0,"PSOE",52
24,"24022",304,198,195,2,3,"PSOE",60
38,"38036",6857,4170,4090,37,80,"PSOE",1706
45,"45179",493,362,357,5,5,"PSOE",130
2,"2030",2949,2158,2122,16,36,"PSOE",956
34,"34901",1053,762,759,10,3,"PSOE",177
3,"3037",340,261,255,3,6,"PSOE",82
47,"47085",16330,11556,11419,121,137,"PSOE",3553
18,"18185",545,434,424,5,10,"PSOE",148
24,"24023",264,188,185,1,3,"PSOE",44
42,"42083",26,20,20,0,0,"PSOE",5
10,"10045",971,686,682,4,4,"PSOE",355
19,"19208",39,32,32,0,0,"PSOE",11
46,"46052",515,423,419,4,4,"PSOE",142
31,"31181",133,87,84,1,3,"PSOE",11
2,"2031",535,406,401,4,5,"PSOE",203
2,"2032",259,183,178,2,5,"PSOE",83
19,"19005",91,63,62,0,1,"PSOE",24
49,"49088",80,51,51,0,0,"PSOE",12
6,"6138",1021,677,658,5,19,"PSOE",368
13,"13026",413,333,331,2,2,"PSOE",132
6,"6137",934,696,693,3,3,"PSOE",355
50,"50022",504,373,369,12,4,"PSOE",133
13,"13072",727,518,510,3,8,"PSOE",171
40,"40184",245,196,194,0,2,"PSOE",31
26,"26131",34,33,33,0,0,"PSOE",7
13,"13027",3185,2112,2055,12,57,"PSOE",852
19,"19209",40,30,29,0,1,"PSOE",10
31,"31182",29,25,25,0,0,"PSOE",6
23,"23025",2725,1894,1870,11,24,"PSOE",801
4,"4081",351,264,263,0,1,"PSOE",166
46,"46190",50042,35290,35066,284,224,"PSOE",9804
6,"6002",4313,2914,2804,37,110,"PSOE",842
26,"26018",10443,7664,7538,80,126,"PSOE",3113
47,"47056",81,57,57,0,0,"PSOE",12
12,"12004",4149,2945,2910,25,35,"PSOE",834
37,"37339",295,219,219,5,0,"PSOE",60
49,"49091",246,168,167,1,1,"PSOE",71
42,"42086",33,19,19,1,0,"PSOE",3
45,"45183",2378,1555,1525,16,30,"PSOE",354
46,"46031",10574,7233,7158,58,75,"PSOE",2099
37,"37213",83,64,64,0,0,"PSOE",8
44,"44029",585,454,451,2,3,"PSOE",189
14,"14012",6046,4215,4120,56,95,"PSOE",1881
24,"24136",495,347,344,1,3,"PSOE",76
41,"41009",1148,750,732,5,18,"PSOE",336
33,"33030",876,632,630,8,2,"PSOE",150
19,"19007",433,316,310,1,6,"PSOE",92
26,"26019",346,260,251,2,9,"PSOE",81
24,"24063",362,247,245,2,2,"PSOE",57
9,"9445",41,28,27,1,1,"PSOE",9
2,"2035",1946,1494,1473,5,21,"PSOE",531
12,"12088",57,53,53,0,0,"PSOE",13
42,"42007",108,80,80,1,0,"PSOE",20
47,"47058",199,126,125,3,1,"PSOE",40
6,"6006",4479,2991,2934,27,57,"PSOE",1392
34,"34061",91,70,69,1,1,"PSOE",8
9,"9398",73,52,52,0,0,"PSOE",18
23,"23027",711,547,539,5,8,"PSOE",310
5,"5082",491,379,369,2,10,"PSOE",116
31,"31112",91,56,56,0,0,"PSOE",6
7,"7017",899,604,596,10,8,"PSOE",109
16,"16219",81,58,58,0,0,"PSOE",35
16,"16099",179,108,105,0,3,"PSOE",34
45,"45185",7573,5422,5320,31,102,"PSOE",2106
44,"44237",367,267,262,0,5,"PSOE",96
5,"5212",197,117,117,0,0,"PSOE",36
9,"9070",33,28,27,0,1,"PSOE",11
44,"44059",562,411,407,2,4,"PSOE",101
10,"10051",421,316,308,0,8,"PSOE",79
37,"37248",150,116,116,1,0,"PSOE",17
45,"45076",574,361,357,1,4,"PSOE",118
42,"42089",57,44,43,0,1,"PSOE",18
13,"13033",1544,1231,1196,5,35,"PSOE",634
46,"46056",176,142,142,0,0,"PSOE",48
44,"44238",2278,1630,1620,3,10,"PSOE",622
2,"2037",22963,14737,14588,68,149,"PSOE",4513
31,"31078",2418,1752,1729,16,23,"PSOE",636
37,"37343",66,44,43,1,1,"PSOE",10
13,"13034",58768,42473,42028,359,445,"PSOE",11959
23,"23901",1125,905,895,3,10,"PSOE",431
18,"18001",222,147,146,0,1,"PSOE",80
22,"22080",263,188,184,3,4,"PSOE",49
45,"45187",3967,3133,3074,16,59,"PSOE",1283
23,"23030",1207,998,977,7,21,"PSOE",611
6,"6146",1039,764,752,7,12,"PSOE",442
26,"26139",58,43,43,2,0,"PSOE",6
47,"47157",490,398,397,2,1,"PSOE",134
5,"5085",31,27,27,0,0,"PSOE",2
4,"4086",1631,1128,1114,3,14,"PSOE",351
34,"34159",375,221,214,4,7,"PSOE",87
10,"10176",344,223,213,2,10,"PSOE",89
9,"9348",131,103,101,0,2,"PSOE",31
50,"50230",1140,771,767,11,4,"PSOE",276
49,"49204",58,44,43,1,1,"PSOE",12
9,"9235",144,107,105,0,2,"PSOE",37
5,"5182",721,457,436,3,21,"PSOE",112
37,"37156",4261,2928,2869,23,59,"PSOE",689
45,"45078",1333,1084,1077,6,7,"PSOE",403
31,"31264",179,91,90,2,1,"PSOE",11
9,"9181",276,194,191,7,3,"PSOE",29
49,"49022",282,230,229,2,1,"PSOE",102
37,"37055",117,97,93,0,4,"PSOE",20
14,"14045",2997,2329,2287,30,42,"PSOE",1230
19,"19184",59,47,47,0,0,"PSOE",11
31,"31008",61,42,42,0,0,"PSOE",10
38,"38019",13884,7888,7809,49,79,"PSOE",2949
24,"24144",621,419,412,4,7,"PSOE",109
46,"46058",1734,1245,1230,8,15,"PSOE",471
37,"37251",108,75,75,0,0,"PSOE",11
9,"9407",25,19,17,0,2,"PSOE",6
16,"16185",36,31,31,0,0,"PSOE",12
47,"47127",138,89,88,2,1,"PSOE",18
44,"44240",151,119,117,0,2,"PSOE",31
45,"45080",3,3,3,0,0,"PSOE",1
31,"31191",3024,2156,2133,23,23,"PSOE",648
22,"22051",90,72,72,2,0,"PSOE",25
19,"19119",76,65,65,0,0,"PSOE",22
22,"22197",436,327,325,3,2,"PSOE",118
6,"6059",1724,1084,1067,6,17,"PSOE",460
28,"28095",1719,1236,1226,5,10,"PSOE",288
50,"50132",780,549,538,7,11,"PSOE",123
9,"9409",117,80,80,0,0,"PSOE",25
39,"39073",10260,7537,7482,42,55,"PSOE",1577
50,"50055",3635,2298,2244,36,54,"PSOE",685
45,"45082",1145,904,893,7,11,"PSOE",377
38,"38021",1609,900,876,2,24,"PSOE",307
2,"2009",19495,13877,13663,134,214,"PSOE",5184
46,"46014",3156,2324,2294,13,30,"PSOE",600
23,"23034",2480,1923,1882,15,41,"PSOE",900
50,"50106",123,78,78,0,0,"PSOE",32
37,"37378",92,54,54,0,0,"PSOE",16
5,"5217",54,42,41,0,1,"PSOE",12
37,"37159",74,59,59,0,0,"PSOE",19
28,"28162",2784,2143,2131,20,12,"PSOE",413
21,"21071",206,148,144,4,4,"PSOE",69
3,"3104",27072,19732,19477,218,255,"PSOE",5957
29,"29080",6940,4676,4617,36,59,"PSOE",1502
2,"2042",810,581,577,1,4,"PSOE",265
6,"6153",20252,14183,13924,154,259,"PSOE",5254
3,"3075",154,117,115,1,2,"PSOE",16
10,"10181",676,470,462,2,8,"PSOE",230
28,"28097",126,87,87,2,0,"PSOE",28
34,"34120",63790,46117,45597,464,520,"PSOE",16163
26,"26066",263,201,194,5,7,"PSOE",54
14,"14048",1199,883,866,4,17,"PSOE",450
37,"37254",174,140,135,0,5,"PSOE",39
19,"19121",265,205,204,0,1,"PSOE",83
21,"21072",10233,7374,7183,116,191,"PSOE",3190
16,"16189",264,196,194,4,2,"PSOE",41
12,"12094",871,671,661,1,10,"PSOE",227
9,"9412",750,484,482,4,2,"PSOE",141
28,"28026",6767,5058,5024,27,34,"PSOE",956
31,"31122",4981,3539,3504,38,35,"PSOE",709
19,"19018",142,112,112,1,0,"PSOE",21
6,"6019",2010,1367,1330,23,37,"PSOE",655
28,"28164",3230,2371,2345,28,26,"PSOE",543
19,"19219",9,8,7,0,1,"PSOE",5
42,"42100",30,24,24,1,0,"PSOE",5
9,"9079",47,38,38,0,0,"PSOE",2
41,"41091",539590,389351,384943,4676,4408,"PSOE",122475
40,"40229",26,22,22,0,0,"PSOE",10
21,"21074",2736,1826,1790,19,36,"PSOE",750
47,"47067",153,112,112,3,0,"PSOE",18
22,"22202",147,128,128,3,0,"PSOE",46
28,"28057",1556,1155,1141,7,14,"PSOE",262
19,"19281",19,18,18,0,0,"PSOE",6
42,"42195",86,51,51,2,0,"PSOE",22
46,"46062",4552,3402,3362,27,40,"PSOE",874
18,"18038",1042,782,760,5,22,"PSOE",351
12,"12070",505,407,398,2,9,"PSOE",129
50,"50082",82,57,57,0,0,"PSOE",23
37,"37060",283,205,202,1,3,"PSOE",64
12,"12014",164,111,111,0,0,"PSOE",42
9,"9415",275,178,178,3,0,"PSOE",34
46,"46199",5878,4217,4182,21,35,"PSOE",1160
31,"31197",67,51,51,2,0,"PSOE",25
16,"16072",132,84,84,1,0,"PSOE",39
37,"37351",268,229,226,0,3,"PSOE",78
12,"12096",732,526,519,4,7,"PSOE",210
31,"31198",36,30,30,0,0,"PSOE",3
16,"16191",850,664,653,11,11,"PSOE",267
50,"50186",37,26,26,1,0,"PSOE",4
26,"26149",42,34,34,0,0,"PSOE",22
10,"10064",1400,998,972,3,26,"PSOE",426
44,"44068",634,497,493,2,4,"PSOE",148
46,"46200",1840,1475,1455,5,20,"PSOE",460
38,"38049",2690,1406,1389,27,17,"PSOE",451
9,"9139",98,79,79,2,0,"PSOE",31
19,"19317",124,83,82,0,1,"PSOE",31
40,"40070",143,94,92,1,2,"PSOE",28
6,"6023",4138,2811,2749,12,62,"PSOE",1500
12,"12015",115,94,94,0,0,"PSOE",13
26,"26035",16,12,11,0,1,"PSOE",6
26,"26071",8644,5668,5591,53,77,"PSOE",2057
3,"3051",342,288,286,4,2,"PSOE",102
10,"10107",1019,766,755,12,11,"PSOE",360
26,"26111",250,191,187,3,4,"PSOE",97
22,"22239",85,67,65,0,2,"PSOE",15
44,"44161",428,294,292,2,2,"PSOE",85
24,"24153",228,171,171,3,0,"PSOE",59
6,"6024",1123,876,849,3,27,"PSOE",386
9,"9250",264,195,193,3,2,"PSOE",69
34,"34228",77,59,59,1,0,"PSOE",17
45,"45200",4471,3351,3269,25,82,"PSOE",1325
46,"46201",62,40,40,0,0,"PSOE",25
18,"18043",129,74,71,0,3,"PSOE",8
2,"2049",778,506,496,1,10,"PSOE",255
14,"14053",5918,4054,3968,92,86,"PSOE",1707
31,"31091",322,201,201,3,0,"PSOE",28
5,"5096",76,62,62,0,0,"PSOE",20
19,"19318",26,18,18,0,0,"PSOE",9
44,"44249",40,30,30,0,0,"PSOE",11
40,"40072",224,175,171,1,4,"PSOE",43
10,"10190",513,334,325,10,9,"PSOE",124
16,"16195",458,343,338,0,5,"PSOE",165
10,"10068",707,532,521,4,11,"PSOE",186
5,"5226",63,43,42,0,1,"PSOE",6
24,"24228",619,370,364,2,6,"PSOE",70
49,"49109",561,419,415,6,4,"PSOE",121
3,"3053",7568,5551,5468,40,83,"PSOE",1191
18,"18175",11793,8099,7943,62,156,"PSOE",2871
35,"35012",10862,5617,5568,40,49,"PSOE",1255
38,"38052",1283,806,794,3,12,"PSOE",192
4,"4100",9433,5599,5556,48,43,"PSOE",1464
18,"18044",161,91,91,0,0,"PSOE",31
22,"22207",121,66,65,0,1,"PSOE",33
49,"49110",344,196,195,2,1,"PSOE",72
9,"9256",330,221,219,0,2,"PSOE",59
46,"46252",125,89,86,1,3,"PSOE",26
46,"46066",1274,972,970,4,2,"PSOE",287
47,"47043",306,241,240,4,1,"PSOE",101
21,"21902",1136,744,739,2,5,"PSOE",483
45,"45203",2777,1986,1961,18,25,"PSOE",627
31,"31203",30,19,19,2,0,"PSOE",7
37,"37068",337,240,236,1,4,"PSOE",69
34,"34232",725,505,492,13,13,"PSOE",179
5,"5099",451,350,344,3,6,"PSOE",134
45,"45019",7560,5216,5135,50,81,"PSOE",1866
7,"7034",1074,796,779,9,17,"PSOE",173
49,"49002",58,43,40,0,3,"PSOE",13
26,"26155",145,120,119,0,1,"PSOE",58
28,"28171",4410,2921,2889,8,32,"PSOE",758
24,"24157",2542,1846,1809,16,37,"PSOE",462
40,"40074",246,193,189,2,4,"PSOE",49
22,"22095",66,52,51,1,1,"PSOE",27
6,"6075",470,363,360,7,3,"PSOE",217
31,"31095",71,59,59,0,0,"PSOE",12
16,"16198",1281,938,928,6,10,"PSOE",359
18,"18111",2863,2038,2001,29,37,"PSOE",655
34,"34086",102,81,81,2,0,"PSOE",25
5,"5196",57,43,43,0,0,"PSOE",29
28,"28173",523,384,381,1,3,"PSOE",125
42,"42116",37,30,29,2,1,"PSOE",10
5,"5101",266,206,205,1,1,"PSOE",27
19,"19132",86,65,63,0,2,"PSOE",13
49,"49112",118,72,72,2,0,"PSOE",26
37,"37170",1361,909,884,9,25,"PSOE",232
9,"9259",230,178,176,2,2,"PSOE",53
19,"19227",68,42,41,1,1,"PSOE",16
40,"40174",319,229,227,3,2,"PSOE",40
10,"10196",294,208,206,3,2,"PSOE",97
3,"3904",1434,1032,1022,8,10,"PSOE",367
49,"49078",138,113,109,4,4,"PSOE",43
34,"34182",746,558,553,9,5,"PSOE",183
49,"49037",174,139,136,1,3,"PSOE",32
50,"50216",236,169,167,0,2,"PSOE",49
39,"39001",2063,1474,1467,5,7,"PSOE",351
41,"41054",719,562,546,3,16,"PSOE",260
40,"40076",6576,4700,4607,32,93,"PSOE",1258
38,"38006",41593,20823,20624,127,199,"PSOE",6325
9,"9262",160,122,120,2,2,"PSOE",31
19,"19228",27,17,17,1,0,"PSOE",11
47,"47078",157,114,107,0,7,"PSOE",27
19,"19325",154,86,86,1,0,"PSOE",19
24,"24161",294,208,204,3,4,"PSOE",43
31,"31208",2568,1855,1835,24,20,"PSOE",781
47,"47173",879,627,622,9,5,"PSOE",262
42,"42165",414,246,237,4,9,"PSOE",73
49,"49115",167,121,121,2,0,"PSOE",42
30,"30038",15752,10987,10904,39,83,"PSOE",2700
37,"37037",108,72,72,0,0,"PSOE",10
9,"9378",31,20,19,0,1,"PSOE",5
41,"41100",954,670,635,7,35,"PSOE",330
10,"10077",626,444,441,5,3,"PSOE",198
9,"9321",1576,1151,1135,10,16,"PSOE",412
40,"40177",139,106,105,0,1,"PSOE",27
23,"23050",90664,65260,64519,581,741,"PSOE",19809
49,"49080",622,440,437,4,3,"PSOE",180
37,"37141",149,101,100,0,1,"PSOE",44
28,"28007",127491,96937,96102,810,835,"PSOE",29467
14,"14059",679,527,521,11,6,"PSOE",211
31,"31209",149,111,110,0,1,"PSOE",16
46,"46207",6761,4966,4909,46,57,"PSOE",1374
24,"24162",1753,1259,1245,12,14,"PSOE",376
13,"13062",567,450,446,4,4,"PSOE",164
37,"37362",4783,3469,3420,44,49,"PSOE",796
9,"9104",49,35,34,0,1,"PSOE",2
50,"50194",80,51,51,0,0,"PSOE",13
30,"30039",20442,13299,13167,84,132,"PSOE",3009
9,"9267",117,95,93,1,2,"PSOE",23
31,"31210",186,131,130,2,1,"PSOE",25
50,"50042",19,17,17,1,0,"PSOE",2
45,"45100",178,141,138,0,3,"PSOE",63
24,"24163",4076,2979,2954,35,25,"PSOE",746
12,"12105",825,602,598,6,4,"PSOE",124
22,"22214",117,92,89,0,3,"PSOE",13
5,"5200",41,26,26,0,0,"PSOE",6
6,"6083",46577,31113,30748,338,365,"PSOE",10912
13,"13064",1845,1314,1298,10,16,"PSOE",455
28,"28177",10851,8550,8485,89,65,"PSOE",1725
49,"49118",193,151,151,2,0,"PSOE",43
10,"10080",353,243,238,1,5,"PSOE",108
28,"28080",49866,39769,39583,346,186,"PSOE",7087
46,"46208",1071,854,845,2,9,"PSOE",272
24,"24164",351,175,174,0,1,"PSOE",33
47,"47146",275,215,214,1,1,"PSOE",83
28,"28178",1149,869,853,4,16,"PSOE",203
5,"5001",182,139,138,1,1,"PSOE",39
5,"5041",984,743,732,5,11,"PSOE",140
37,"37301",84,64,64,1,0,"PSOE",17
24,"24091",575,368,362,5,6,"PSOE",101
6,"6131",1057,809,800,6,9,"PSOE",463
46,"46072",3522,2792,2741,25,51,"PSOE",801
40,"40080",51,31,31,0,0,"PSOE",6
5,"5107",54,36,35,2,1,"PSOE",3
40,"40081",117,80,76,1,4,"PSOE",19
19,"19330",69,62,62,0,0,"PSOE",27
19,"19263",21,15,15,0,0,"PSOE",6
4,"4075",5462,3714,3676,19,38,"PSOE",1205
16,"16050",218,172,169,2,3,"PSOE",66
40,"40148",231,165,163,4,2,"PSOE",49
44,"44229",141,99,98,1,1,"PSOE",24
47,"47210",399,278,275,3,3,"PSOE",79
49,"49267",96,67,63,2,4,"PSOE",10
46,"46141",433,340,337,6,3,"PSOE",77
13,"13067",334,279,271,2,8,"PSOE",150
19,"19202",16,13,13,1,0,"PSOE",3
46,"46050",185,141,141,1,0,"PSOE",66
37,"37302",262,161,161,2,0,"PSOE",44
28,"28012",929,707,698,7,9,"PSOE",180
4,"4007",735,514,509,3,5,"PSOE",196
31,"31214",87,55,54,0,1,"PSOE",11
6,"6042",984,644,629,5,15,"PSOE",313
26,"26167",50,34,33,1,1,"PSOE",6
19,"19331",2677,1892,1841,18,51,"PSOE",625
47,"47179",368,256,254,2,2,"PSOE",78
44,"44175",112,76,75,1,1,"PSOE",18
49,"49121",372,239,233,1,6,"PSOE",54
14,"14064",296,211,208,6,3,"PSOE",96
19,"19264",33,25,25,0,0,"PSOE",16
9,"9439",1061,801,790,2,11,"PSOE",228
22,"22011",98,80,79,0,1,"PSOE",19
16,"16212",233,186,184,0,2,"PSOE",81
5,"5007",109,73,72,0,1,"PSOE",10
5,"5206",26,17,17,0,0,"PSOE",11
49,"49234",394,282,277,0,5,"PSOE",107
2,"2063",1358,987,973,3,14,"PSOE",422
37,"37179",197,167,165,0,2,"PSOE",49
19,"19040",53,43,42,1,1,"PSOE",18
23,"23020",1510,1263,1253,16,10,"PSOE",433
28,"28182",203,167,163,1,4,"PSOE",45
40,"40214",198,160,154,0,6,"PSOE",37
37,"37045",27,19,19,0,0,"PSOE",6
12,"12029",670,524,514,5,10,"PSOE",198
31,"31107",1671,1204,1182,12,22,"PSOE",247
19,"19237",39,34,34,0,0,"PSOE",12
50,"50199",318,206,201,1,5,"PSOE",68
50,"50273",33,24,24,1,0,"PSOE",6
33,"33055",1485,992,966,14,26,"PSOE",350
9,"9441",94,76,76,0,0,"PSOE",3
6,"6046",1250,983,959,6,24,"PSOE",453
37,"37274",118296,84144,83280,880,864,"PSOE",25133
49,"49124",238,170,164,2,6,"PSOE",48
31,"31217",327,204,196,1,8,"PSOE",46
16,"16095",82,70,70,1,0,"PSOE",19
30,"30901",10556,7862,7775,58,87,"PSOE",1959
16,"16216",272,207,204,0,3,"PSOE",103
46,"46235",21229,15171,15011,126,160,"PSOE",4081
18,"18122",15994,11009,10773,109,236,"PSOE",4010
23,"23058",8832,6528,6407,57,121,"PSOE",2620
19,"19146",47,35,35,0,0,"PSOE",18
50,"50200",479,389,383,5,6,"PSOE",182
26,"26171",155,109,107,2,2,"PSOE",23
24,"24170",1806,1232,1220,9,12,"PSOE",537
46,"46262",206,136,134,1,2,"PSOE",23
44,"44089",49,41,41,0,0,"PSOE",4
37,"37275",98,67,67,0,0,"PSOE",33
49,"49237",142,78,78,0,0,"PSOE",23
10,"10088",198,112,112,1,0,"PSOE",44
12,"12111",327,259,255,8,4,"PSOE",105
41,"41064",5602,3520,3417,56,103,"PSOE",1806
46,"46008",2617,1954,1931,17,23,"PSOE",583
16,"16217",91,72,72,0,0,"PSOE",24
21,"21002",16070,11301,11137,132,164,"PSOE",2912
9,"9444",63,40,40,1,0,"PSOE",7
34,"34103",96,79,76,0,3,"PSOE",18
12,"12005",8049,5643,5552,71,91,"PSOE",1705
22,"22077",362,280,272,5,8,"PSOE",125
40,"40087",85,70,70,0,0,"PSOE",10
5,"5114",1257,989,968,5,21,"PSOE",404
33,"33058",1668,1050,1035,13,15,"PSOE",463
6,"6050",4031,3005,2934,38,71,"PSOE",1044
5,"5013",834,658,653,2,5,"PSOE",232
46,"46054",11389,8266,8190,54,76,"PSOE",2436
42,"42044",53,37,35,1,2,"PSOE",3
19,"19178",27,17,16,0,1,"PSOE",6
31,"31002",431,294,290,3,4,"PSOE",40
49,"49126",260,153,150,1,3,"PSOE",57
19,"19148",42,29,28,1,1,"PSOE",5
45,"45147",592,449,443,2,6,"PSOE",172
35,"35002",24229,15311,15133,101,178,"PSOE",4058
37,"37183",377,267,267,5,0,"PSOE",97
39,"39012",6772,4807,4755,31,52,"PSOE",1183
13,"13077",3383,2050,1997,20,53,"PSOE",766
24,"24173",896,590,583,2,7,"PSOE",178
2,"2002",427,340,337,2,3,"PSOE",142
41,"41066",1307,927,898,7,29,"PSOE",587
45,"45111",56,47,47,1,0,"PSOE",26
42,"42008",54,41,41,0,0,"PSOE",6
6,"6052",3962,2728,2642,26,86,"PSOE",907
45,"45112",1844,1121,1086,8,35,"PSOE",399
10,"10010",2206,1308,1281,8,27,"PSOE",632
31,"31223",953,667,654,4,13,"PSOE",229
4,"4014",152,105,103,1,2,"PSOE",60
19,"19241",35,26,25,2,1,"PSOE",3
9,"9124",1405,946,928,6,18,"PSOE",376
31,"31224",884,637,630,7,7,"PSOE",224
49,"49128",520,384,378,7,6,"PSOE",136
12,"12034",1389,1022,1002,5,20,"PSOE",324
33,"33060",13991,8629,8481,109,148,"PSOE",3694
46,"46147",17186,11507,11399,72,108,"PSOE",2805
39,"39098",1381,1088,1080,5,8,"PSOE",95
4,"4015",113,81,81,0,0,"PSOE",36
18,"18161",245,199,196,0,3,"PSOE",79
47,"47091",76,60,59,2,1,"PSOE",23
41,"41039",31538,22078,21717,278,361,"PSOE",7289
22,"22193",272,199,194,4,5,"PSOE",56
14,"14043",7406,5323,5211,63,112,"PSOE",2437
31,"31225",35,29,28,0,1,"PSOE",12
10,"10216",1518,1082,1056,11,26,"PSOE",404
44,"44094",127,103,103,0,0,"PSOE",20
49,"49242",439,342,336,2,6,"PSOE",90
39,"39015",828,559,556,3,3,"PSOE",84
29,"29075",12886,8292,8191,63,101,"PSOE",2332
46,"46171",16446,11616,11499,94,117,"PSOE",3253
37,"37186",94,68,68,0,0,"PSOE",20
44,"44152",70,46,46,0,0,"PSOE",2
30,"30001",4507,3357,3331,17,26,"PSOE",914
41,"41012",3375,2259,2214,26,45,"PSOE",1009
5,"5181",46,34,34,0,0,"PSOE",11
12,"12037",17,13,13,1,0,"PSOE",5
12,"12115",205,161,161,1,0,"PSOE",38
4,"4017",1276,833,818,4,15,"PSOE",282
34,"34110",75,64,64,0,0,"PSOE",27
26,"26061",1542,1104,1079,12,25,"PSOE",442
13,"13037",776,573,563,2,10,"PSOE",241
18,"18098",5959,3816,3749,33,67,"PSOE",1472
37,"37090",68,47,47,0,0,"PSOE",9
13,"13083",2382,1623,1587,12,36,"PSOE",443
44,"44097",126,76,73,0,3,"PSOE",15
29,"29032",6655,4900,4775,36,125,"PSOE",1945
5,"5086",76,58,58,1,0,"PSOE",12
50,"50053",643,476,466,3,10,"PSOE",190
19,"19244",74,55,55,3,0,"PSOE",14
24,"24178",60,54,54,1,0,"PSOE",18
45,"45005",225,170,167,3,3,"PSOE",55
24,"24069",37,26,25,0,1,"PSOE",0
18,"18132",3101,2418,2382,23,36,"PSOE",1294
31,"31009",674,455,451,2,4,"PSOE",125
13,"13084",841,652,644,6,8,"PSOE",267
42,"42145",129,105,104,1,1,"PSOE",36
29,"29060",665,454,450,1,4,"PSOE",156
26,"26063",118,88,88,2,0,"PSOE",30
46,"46241",388,288,283,5,5,"PSOE",89
9,"9076",24,19,19,1,0,"PSOE",5
19,"19216",127,88,88,0,0,"PSOE",31
46,"46059",1244,1007,995,5,12,"PSOE",293
37,"37189",114,75,74,1,1,"PSOE",30
9,"9456",130,86,86,1,0,"PSOE",30
34,"34165",57,45,44,1,1,"PSOE",0
5,"5021",1861,1323,1304,22,19,"PSOE",367
37,"37253",135,109,109,1,0,"PSOE",37
6,"6060",5696,4006,3900,37,106,"PSOE",1680
19,"19088",91,67,66,0,1,"PSOE",15
39,"39018",4284,3211,3177,22,34,"PSOE",915
21,"21010",15011,8812,8694,174,118,"PSOE",2960
16,"16278",61,45,45,0,0,"PSOE",24
37,"37057",208,151,149,0,2,"PSOE",28
19,"19050",15,13,13,0,0,"PSOE",7
49,"49246",214,183,180,3,3,"PSOE",32
6,"6061",1074,829,819,5,10,"PSOE",496
6,"6152",1273,888,867,7,21,"PSOE",366
47,"47004",1135,878,872,5,6,"PSOE",369
2,"2076",313,233,230,2,3,"PSOE",104
4,"4021",179,132,129,2,3,"PSOE",49
39,"39047",1998,1408,1392,8,16,"PSOE",238
16,"16107",94,56,56,0,0,"PSOE",22
5,"5156",242,145,145,1,0,"PSOE",34
19,"19280",3669,2622,2597,24,25,"PSOE",675
30,"30004",1129,838,833,1,5,"PSOE",333
44,"44187",193,147,146,0,1,"PSOE",34
14,"14901",932,753,750,6,3,"PSOE",441
9,"9301",658,497,488,5,9,"PSOE",121
28,"28025",405,294,291,5,3,"PSOE",65
39,"39019",2232,1628,1603,10,25,"PSOE",308
13,"13089",1609,1248,1228,10,20,"PSOE",543
19,"19157",53,37,37,0,0,"PSOE",14
45,"45084",2103,1533,1508,7,25,"PSOE",659
9,"9356",43,31,30,0,1,"PSOE",6
46,"46175",429,362,355,3,7,"PSOE",96
38,"38022",18630,11420,11284,87,136,"PSOE",2863
16,"16109",41,30,30,0,0,"PSOE",10
31,"31013",615,371,365,1,6,"PSOE",65
22,"22124",183,119,119,0,0,"PSOE",42
50,"50134",120,85,82,4,3,"PSOE",15
29,"29008",15249,10396,10234,108,162,"PSOE",2693
45,"45195",2064,1519,1481,9,38,"PSOE",678
9,"9246",599,381,372,2,9,"PSOE",90
9,"9136",169,129,125,2,4,"PSOE",36
31,"31233",91,62,60,2,2,"PSOE",11
14,"14049",16185,11561,11323,145,238,"PSOE",4553
37,"37162",212,139,137,3,2,"PSOE",40
16,"16071",20,16,16,0,0,"PSOE",4
44,"44189",44,35,35,0,0,"PSOE",10
50,"50209",2785,1893,1865,24,28,"PSOE",507
50,"50008",5187,3334,3288,37,46,"PSOE",1117
31,"31905",2992,1994,1984,9,10,"PSOE",628
3,"3136",399,302,301,3,1,"PSOE",69
44,"44190",63,45,45,0,0,"PSOE",10
42,"42020",4170,2732,2686,35,46,"PSOE",970
16,"16111",168,114,111,2,3,"PSOE",50
45,"45012",623,482,472,0,10,"PSOE",145
34,"34124",60,45,45,0,0,"PSOE",13
29,"29083",2063,1471,1444,14,27,"PSOE",639
24,"24077",212,166,162,0,4,"PSOE",59
47,"47008",22,13,13,0,0,"PSOE",1
19,"19250",16,12,12,0,0,"PSOE",7
45,"45013",1679,1266,1248,5,18,"PSOE",395
19,"19092",395,286,279,2,7,"PSOE",91
41,"41075",10320,7159,6972,88,187,"PSOE",2380
16,"16242",300,245,243,2,2,"PSOE",55
35,"35010",3853,2224,2194,18,30,"PSOE",666
28,"28029",576,443,443,4,0,"PSOE",89
7,"7029",4393,2888,2855,37,33,"PSOE",883
16,"16903",992,750,732,8,18,"PSOE",172
26,"26070",152,125,122,1,3,"PSOE",42
45,"45124",2080,1628,1595,15,33,"PSOE",595
44,"44012",303,215,215,2,0,"PSOE",65
44,"44191",714,509,500,5,9,"PSOE",168
46,"46087",109,94,94,2,0,"PSOE",47
37,"37062",78,59,59,0,0,"PSOE",5
34,"34175",87,67,66,1,1,"PSOE",7
9,"9417",42,31,31,1,0,"PSOE",1
21,"21077",1739,1266,1235,13,31,"PSOE",554
5,"5061",257,193,189,1,4,"PSOE",69
7,"7030",1598,1127,1098,14,29,"PSOE",171
33,"33070",3267,2211,2185,27,26,"PSOE",809
22,"22236",232,190,188,2,2,"PSOE",76
19,"19057",69,51,51,0,0,"PSOE",24
37,"37101",138,101,100,1,1,"PSOE",22
16,"16113",3065,2142,2108,13,34,"PSOE",738
45,"45015",656,449,438,2,11,"PSOE",167
38,"38026",33585,24091,23889,170,202,"PSOE",5637
21,"21016",985,703,680,5,23,"PSOE",417
31,"31164",542,410,408,5,2,"PSOE",163
44,"44013",11232,7872,7801,64,71,"PSOE",2125
9,"9141",617,463,456,5,7,"PSOE",160
46,"46019",8932,6721,6647,40,74,"PSOE",2587
34,"34127",80,62,62,0,0,"PSOE",13
6,"6071",238,192,187,2,5,"PSOE",103
4,"4029",8830,5546,5482,43,64,"PSOE",1923
49,"49143",201,119,118,1,1,"PSOE",24
28,"28106",78872,54111,53443,412,668,"PSOE",17064
46,"46156",2017,1538,1524,9,14,"PSOE",455
9,"9310",15,14,11,0,3,"PSOE",5
39,"39025",8637,6256,6179,33,77,"PSOE",1704
50,"50012",94,76,72,0,4,"PSOE",32
40,"40170",1302,962,948,6,14,"PSOE",243
16,"16906",70,44,44,1,0,"PSOE",18
10,"10110",2226,1431,1400,7,31,"PSOE",485
42,"42202",19,11,10,0,1,"PSOE",2
37,"37065",276,167,167,2,0,"PSOE",51
47,"47198",64,43,43,0,0,"PSOE",8
22,"22129",162,110,110,0,0,"PSOE",29
10,"10111",1297,888,872,11,16,"PSOE",303
31,"31240",514,352,352,3,0,"PSOE",39
13,"13901",875,628,619,1,9,"PSOE",244
47,"47104",2816,2153,2099,20,54,"PSOE",501
9,"9480",105,84,84,0,0,"PSOE",20
5,"5130",94,77,77,1,0,"PSOE",32
24,"24156",220,135,133,0,2,"PSOE",37
35,"35013",6593,4596,4516,47,80,"PSOE",1185
42,"42204",53,37,35,1,2,"PSOE",8
47,"47232",96,67,65,0,2,"PSOE",11
37,"37033",94,67,67,0,0,"PSOE",19
46,"46089",2182,1590,1576,9,14,"PSOE",406
10,"10112",1495,1071,1049,7,22,"PSOE",380
16,"16005",234,163,160,1,3,"PSOE",70
5,"5065",452,339,337,2,2,"PSOE",59
12,"12075",110,85,83,3,2,"PSOE",26
16,"16247",63,51,50,1,1,"PSOE",25
31,"31241",126,86,85,2,1,"PSOE",9
49,"49146",265,183,181,4,2,"PSOE",69
16,"16248",862,710,700,6,10,"PSOE",255
34,"34132",106,73,72,0,1,"PSOE",14
50,"50140",153,96,95,1,1,"PSOE",23
26,"26004",69,47,46,0,1,"PSOE",4
10,"10031",162,128,124,0,4,"PSOE",41
31,"31022",477,303,301,2,2,"PSOE",28
49,"49036",503,319,316,5,3,"PSOE",106
23,"23081",1494,1084,1061,9,23,"PSOE",532
5,"5229",75,61,61,1,0,"PSOE",7
19,"19167",129,104,103,1,1,"PSOE",17
49,"49260",693,480,473,3,7,"PSOE",163
37,"37107",10444,6997,6884,76,113,"PSOE",1916
12,"12049",415,317,305,4,12,"PSOE",110
40,"40010",108,83,82,0,1,"PSOE",15
46,"46228",2426,1819,1802,19,17,"PSOE",434
5,"5132",857,548,539,7,9,"PSOE",170
47,"47109",161,120,120,1,0,"PSOE",41
42,"42029",131,94,94,4,0,"PSOE",14
2,"2021",1013,806,798,6,8,"PSOE",309
26,"26119",178,132,132,0,0,"PSOE",72
49,"49261",1504,1044,1026,7,18,"PSOE",353
39,"39084",868,608,605,3,3,"PSOE",85
49,"49226",240,200,198,2,2,"PSOE",67
3,"3028",959,780,767,7,13,"PSOE",235
46,"46182",1312,908,904,5,4,"PSOE",239
9,"9154",123,90,90,7,0,"PSOE",18
50,"50192",227,182,181,0,1,"PSOE",63
16,"16084",48,34,30,1,4,"PSOE",17
44,"44019",70,42,42,0,0,"PSOE",6
42,"42030",91,69,69,2,0,"PSOE",3
45,"45023",2300,1700,1685,19,15,"PSOE",505
6,"6079",649,451,445,3,6,"PSOE",216
47,"47205",355,248,244,2,4,"PSOE",42
16,"16251",1805,1318,1302,9,16,"PSOE",319
24,"24087",582,431,427,3,4,"PSOE",74
29,"29091",9490,6428,6304,61,124,"PSOE",1714
16,"16009",54,44,44,2,0,"PSOE",6
29,"29018",2009,1421,1362,17,59,"PSOE",528
9,"9102",33,22,22,0,0,"PSOE",5
50,"50040",82,66,66,1,0,"PSOE",22
9,"9159",62,49,47,0,2,"PSOE",5
37,"37109",178,127,126,0,1,"PSOE",22
31,"31063",84,59,59,0,0,"PSOE",11
41,"41056",3687,2836,2779,37,57,"PSOE",1533
49,"49039",324,249,239,3,10,"PSOE",71
9,"9430",25,21,21,0,0,"PSOE",10
16,"16203",10221,6960,6883,42,77,"PSOE",2735
13,"13016",656,463,454,3,9,"PSOE",128
46,"46256",7280,4996,4940,32,56,"PSOE",1234
16,"16253",308,230,228,2,2,"PSOE",58
34,"34137",24,19,19,2,0,"PSOE",9
45,"45135",4152,3118,3066,21,52,"PSOE",1079
42,"42033",50,48,48,2,0,"PSOE",14
31,"31247",141,99,96,1,3,"PSOE",8
31,"31137",198,83,83,1,0,"PSOE",12
14,"14004",1963,1465,1437,15,28,"PSOE",537
42,"42167",235,163,161,4,2,"PSOE",37
37,"37204",253,176,173,2,3,"PSOE",49
19,"19171",5380,3964,3919,22,45,"PSOE",1487
12,"12052",537,409,398,5,11,"PSOE",108
29,"29093",2150,1543,1520,8,23,"PSOE",722
49,"49152",474,289,282,2,7,"PSOE",74
9,"9162",130,102,100,1,2,"PSOE",21
23,"23087",11169,8193,8045,79,148,"PSOE",2539
21,"21025",3886,2489,2431,31,58,"PSOE",962
30,"30015",19344,13502,13347,107,155,"PSOE",3665
40,"40015",23,19,19,0,0,"PSOE",2
9,"9326",156,111,110,1,1,"PSOE",35
31,"31249",1798,1235,1227,13,8,"PSOE",588
50,"50067",13928,9831,9699,92,132,"PSOE",2884
42,"42168",108,73,73,0,0,"PSOE",24
10,"10121",7882,5294,5183,42,111,"PSOE",1975
35,"35018",13153,7742,7674,80,68,"PSOE",2274
29,"29094",59795,39350,38854,454,496,"PSOE",11162
40,"40210",97,69,69,1,0,"PSOE",12
49,"49153",150,110,107,2,3,"PSOE",33
50,"50270",38,26,25,0,1,"PSOE",9
26,"26047",1852,1449,1434,6,15,"PSOE",580
34,"34051",91,72,70,0,2,"PSOE",10
34,"34242",91,65,62,2,3,"PSOE",14
34,"34140",93,57,57,1,0,"PSOE",16
47,"47114",3900,2549,2514,18,35,"PSOE",712
9,"9328",70,37,37,3,0,"PSOE",9
46,"46095",580,445,438,5,7,"PSOE",108
42,"42172",28,26,26,0,0,"PSOE",2
41,"41902",4599,2906,2868,50,38,"PSOE",1403
49,"49010",350,260,256,8,4,"PSOE",110
42,"42125",71,55,55,0,0,"PSOE",19
10,"10203",4421,2810,2764,15,46,"PSOE",979
12,"12131",97,87,87,0,0,"PSOE",37
10,"10163",348,239,238,2,1,"PSOE",105
9,"9058",394,286,284,6,2,"PSOE",62
19,"19173",47,40,40,0,0,"PSOE",13
31,"31252",80,52,52,1,0,"PSOE",5
22,"22142",94,72,70,0,2,"PSOE",17
21,"21028",370,265,259,2,6,"PSOE",128
44,"44230",149,111,110,2,1,"PSOE",44
35,"35020",5941,3740,3702,27,38,"PSOE",1552
34,"34143",161,115,112,2,3,"PSOE",28
31,"31032",1670,1158,1147,18,11,"PSOE",477
19,"19174",90,65,64,0,1,"PSOE",12
18,"18086",338,253,247,1,6,"PSOE",170
49,"49269",218,126,124,1,2,"PSOE",33
21,"21029",1514,1036,1003,14,33,"PSOE",488
45,"45140",1075,788,772,10,16,"PSOE",340
45,"45030",471,346,334,4,12,"PSOE",152
31,"31033",45,25,25,2,0,"PSOE",4
34,"34053",194,156,154,3,2,"PSOE",39
3,"3007",173,141,139,0,2,"PSOE",26
47,"47212",356,289,287,4,2,"PSOE",61
24,"24205",990,678,667,6,11,"PSOE",154
45,"45031",2861,1894,1858,13,36,"PSOE",593
16,"16130",533,407,404,0,3,"PSOE",211
37,"37012",144,111,111,0,0,"PSOE",27
31,"31253",121,100,100,0,0,"PSOE",15
9,"9169",97,72,70,1,2,"PSOE",23
46,"46006",4454,3527,3486,27,41,"PSOE",877
4,"4079",54675,35691,35365,328,326,"PSOE",8386
10,"10044",1405,968,955,11,13,"PSOE",522
22,"22221",92,56,55,0,1,"PSOE",8
49,"49047",98,74,72,1,2,"PSOE",16
45,"45032",445,290,286,2,4,"PSOE",137
23,"23094",3739,2920,2876,29,44,"PSOE",1487
16,"16017",336,276,270,1,6,"PSOE",115
42,"42041",31,23,23,0,0,"PSOE",5
19,"19176",227,172,172,0,0,"PSOE",36
49,"49271",176,128,127,3,1,"PSOE",54
39,"39037",2033,1431,1420,3,11,"PSOE",279
50,"50150",624,387,384,2,3,"PSOE",132
21,"21061",5083,3325,3255,36,70,"PSOE",1284
31,"31144",760,442,441,4,1,"PSOE",54
35,"35022",51765,29309,29034,184,275,"PSOE",8409
44,"44206",100,73,73,3,0,"PSOE",15
37,"37305",219,177,175,2,2,"PSOE",47
40,"40152",732,575,565,10,10,"PSOE",172
5,"5010",142,102,100,2,2,"PSOE",17
41,"41007",12488,7657,7421,126,236,"PSOE",3226
50,"50072",183,131,129,0,2,"PSOE",48
40,"40121",249,188,178,1,10,"PSOE",38
9,"9173",123,96,93,2,3,"PSOE",27
42,"42042",53,42,41,1,1,"PSOE",6
4,"4048",1499,964,957,4,7,"PSOE",287
49,"49160",42,27,27,0,0,"PSOE",17
46,"46099",744,539,535,2,4,"PSOE",218
31,"31257",915,654,642,9,12,"PSOE",181
40,"40215",79,66,66,2,0,"PSOE",14
31,"31183",718,536,534,5,2,"PSOE",104
2,"2033",1864,1352,1315,12,37,"PSOE",444
37,"37212",104,76,76,0,0,"PSOE",22
44,"44120",219,147,145,3,2,"PSOE",25
14,"14011",580,444,443,3,1,"PSOE",182
46,"46236",929,723,716,2,7,"PSOE",219
44,"44267",70,47,46,0,1,"PSOE",6
18,"18157",1148,843,827,7,16,"PSOE",251
33,"33002",9403,5920,5839,69,81,"PSOE",2321
37,"37120",98,78,76,0,2,"PSOE",21
4,"4049",5711,3766,3732,25,34,"PSOE",1357
9,"9340",74,49,49,1,0,"PSOE",7
23,"23097",6346,4243,4194,31,49,"PSOE",1390
26,"26173",8,8,8,1,0,"PSOE",2
16,"16218",184,134,133,1,1,"PSOE",53
46,"46214",16637,12113,12014,84,99,"PSOE",3330
29,"29027",2325,1543,1516,13,27,"PSOE",459
47,"47153",101,69,69,1,0,"PSOE",13
49,"49163",203,139,138,3,1,"PSOE",38
50,"50177",288,196,193,0,3,"PSOE",59
31,"31075",113,69,69,2,0,"PSOE",12
28,"28048",514,386,384,4,2,"PSOE",129
3,"3097",1014,778,764,5,14,"PSOE",186
21,"21034",1155,768,748,5,20,"PSOE",338
18,"18192",1462,1125,1103,3,22,"PSOE",507
5,"5242",679,571,562,9,9,"PSOE",72
21,"21065",259,178,175,0,3,"PSOE",54
41,"41010",4586,3218,3157,42,61,"PSOE",1102
12,"12006",177,133,133,2,0,"PSOE",54
19,"19114",30,22,21,1,1,"PSOE",12
37,"37215",133,93,90,1,3,"PSOE",31
28,"28049",57814,44977,44559,385,418,"PSOE",14474
49,"49240",185,125,123,3,2,"PSOE",32
29,"29903",485,326,324,2,2,"PSOE",153
38,"38016",1174,595,589,2,6,"PSOE",213
31,"31041",1671,1118,1105,15,13,"PSOE",245
46,"46033",196,155,153,0,2,"PSOE",35
14,"14014",2496,1962,1907,20,55,"PSOE",847
21,"21035",9766,6114,5998,92,116,"PSOE",2625
16,"16139",317,226,222,1,4,"PSOE",63
47,"47218",981,728,723,4,5,"PSOE",248
31,"31261",240,161,158,2,3,"PSOE",42
42,"42048",60,52,52,0,0,"PSOE",9
50,"50154",114,92,92,1,0,"PSOE",17
46,"46170",3417,2618,2577,11,41,"PSOE",953
5,"5051",157,117,115,1,2,"PSOE",22
10,"10012",553,427,421,1,6,"PSOE",232
16,"16274",97,76,75,1,1,"PSOE",38
34,"34020",49,37,37,1,0,"PSOE",13
19,"19182",37,32,32,0,0,"PSOE",8
44,"44123",95,68,68,0,0,"PSOE",19
40,"40126",67,44,42,0,2,"PSOE",5
45,"45150",428,322,319,3,3,"PSOE",173
49,"49056",285,191,190,3,1,"PSOE",82
28,"28158",694,501,495,2,6,"PSOE",81
29,"29904",418,328,322,1,6,"PSOE",251
9,"9024",150,100,99,1,1,"PSOE",27
45,"45040",1247,727,715,3,12,"PSOE",233
49,"49166",1193,835,821,7,14,"PSOE",315
18,"18002",529,387,384,1,3,"PSOE",256
47,"47126",42,35,35,1,0,"PSOE",0
29,"29031",1555,1015,986,6,29,"PSOE",510
3,"3100",499,384,378,0,6,"PSOE",111
31,"31263",231,137,137,1,0,"PSOE",7
9,"9026",377,288,288,1,0,"PSOE",78
5,"5152",644,498,496,3,2,"PSOE",105
5,"5119",24,17,17,1,0,"PSOE",2
37,"37345",150,117,113,0,4,"PSOE",33
7,"7054",23257,12613,12464,111,149,"PSOE",3074
44,"44125",63,41,41,0,0,"PSOE",8
9,"9350",421,316,311,5,5,"PSOE",52
16,"16103",235,183,181,2,2,"PSOE",47
30,"30002",9701,6794,6717,27,77,"PSOE",1676
16,"16276",20,17,17,1,0,"PSOE",6
40,"40127",36,25,23,0,2,"PSOE",5
33,"33007",1382,804,795,4,9,"PSOE",345
47,"47221",97,85,84,1,1,"PSOE",21
4,"4055",361,298,290,3,8,"PSOE",156
37,"37219",169,88,85,1,3,"PSOE",20
45,"45153",1568,1168,1162,8,6,"PSOE",385
46,"46173",1309,1029,1010,13,19,"PSOE",270
46,"46218",1043,842,829,6,13,"PSOE",167
3,"3131",176,129,126,1,3,"PSOE",24
34,"34113",40,38,38,0,0,"PSOE",9
37,"37091",161,104,104,0,0,"PSOE",21
49,"49023",899,627,620,3,7,"PSOE",163
22,"22160",207,149,149,1,0,"PSOE",48
5,"5055",532,417,413,3,4,"PSOE",138
18,"18100",7997,5523,5367,66,156,"PSOE",2360
18,"18902",752,589,568,3,21,"PSOE",219
31,"31046",53,38,38,0,0,"PSOE",5
50,"50232",160,93,92,1,1,"PSOE",34
31,"31010",5719,3799,3770,22,29,"PSOE",821
40,"40224",18,15,15,0,0,"PSOE",2
18,"18005",363,232,230,3,2,"PSOE",120
45,"45081",19268,13690,13516,104,174,"PSOE",3458
47,"47003",206,167,166,5,1,"PSOE",38
31,"31083",49,39,39,1,0,"PSOE",2
26,"26144",187,147,143,1,4,"PSOE",27
45,"45192",2380,1890,1854,8,36,"PSOE",724
44,"44007",149,112,111,1,1,"PSOE",18
29,"29006",679,461,452,4,9,"PSOE",175
22,"22908",190,135,134,0,1,"PSOE",47
26,"26105",2188,1564,1536,24,28,"PSOE",564
49,"49208",352,223,214,1,9,"PSOE",31
50,"50159",640,493,486,3,7,"PSOE",189
49,"49247",412,255,252,2,3,"PSOE",65
12,"12118",78,64,63,0,1,"PSOE",13
10,"10904",714,487,473,8,14,"PSOE",187
42,"42055",158,113,113,1,0,"PSOE",48
18,"18037",535,417,410,2,7,"PSOE",129
18,"18904",741,500,498,1,2,"PSOE",219
37,"37317",287,211,209,1,2,"PSOE",69
12,"12901",3339,2583,2561,25,22,"PSOE",772
46,"46243",124,93,90,1,3,"PSOE",30
44,"44037",447,288,288,1,0,"PSOE",71
6,"6063",2924,2141,2108,8,33,"PSOE",1183
44,"44244",67,40,40,0,0,"PSOE",8
31,"31195",169,108,108,0,0,"PSOE",7
39,"39076",3512,2517,2491,13,26,"PSOE",573
6,"6109",3821,2943,2813,16,130,"PSOE",1549
19,"19188",36,31,31,0,0,"PSOE",8
22,"22054",1614,1029,1009,19,20,"PSOE",256
5,"5187",1714,1247,1221,9,26,"PSOE",386
49,"49064",478,297,296,6,1,"PSOE",80
50,"50160",2140,1421,1394,14,27,"PSOE",635
12,"12902",2250,1557,1532,16,25,"PSOE",354
31,"31050",6016,3675,3612,41,63,"PSOE",587
28,"28132",12197,8622,8537,75,85,"PSOE",2489
46,"46016",1070,827,814,10,13,"PSOE",283
19,"19249",29,26,26,0,0,"PSOE",7
42,"42153",12,10,10,0,0,"PSOE",2
24,"24110",1158,784,773,1,11,"PSOE",373
47,"47226",148,115,115,1,0,"PSOE",54
41,"41018",9432,6463,6368,86,95,"PSOE",3258
37,"37026",180,148,147,5,1,"PSOE",54
9,"9035",284,191,190,2,1,"PSOE",72
9,"9036",31,24,24,4,0,"PSOE",1
40,"40230",93,66,64,0,2,"PSOE",28
18,"18103",714,500,498,3,2,"PSOE",224
47,"47227",53,36,35,0,1,"PSOE",10
16,"16034",155,116,113,0,3,"PSOE",48
35,"35032",3331,2293,2252,23,41,"PSOE",622
46,"46040",993,745,733,3,12,"PSOE",247
19,"19190",2284,1632,1613,16,19,"PSOE",702
44,"44130",28,23,23,0,0,"PSOE",2
3,"3107",2785,1766,1746,13,20,"PSOE",451
6,"6021",898,628,617,16,11,"PSOE",223
4,"4095",687,462,457,4,5,"PSOE",146
10,"10146",1494,924,903,1,21,"PSOE",377
47,"47039",162,119,117,0,2,"PSOE",45
45,"45087",8180,5737,5628,41,109,"PSOE",1647
31,"31907",11272,8478,8421,97,57,"PSOE",1911
37,"37258",134,92,92,1,0,"PSOE",30
13,"13048",495,392,391,4,1,"PSOE",144
37,"37352",209,157,155,3,2,"PSOE",46
34,"34174",172,142,136,0,6,"PSOE",26
10,"10147",1277,873,837,6,36,"PSOE",490
3,"3109",3003,2186,2151,14,35,"PSOE",750
49,"49252",312,240,236,7,4,"PSOE",87
40,"40166",251,201,201,0,0,"PSOE",55
9,"9308",58,34,34,1,0,"PSOE",9
50,"50261",201,154,151,0,3,"PSOE",86
41,"41094",6496,4733,4628,47,105,"PSOE",1689
9,"9197",144,105,103,2,2,"PSOE",20
37,"37134",209,143,141,3,2,"PSOE",49
9,"9363",906,660,655,5,5,"PSOE",94
31,"31163",2011,1422,1404,6,18,"PSOE",509
16,"16038",27,20,20,0,0,"PSOE",5
23,"23005",29876,20565,20268,254,297,"PSOE",6961
40,"40136",102,79,77,3,2,"PSOE",18
37,"37165",31,22,22,0,0,"PSOE",3
19,"19284",10,10,10,0,0,"PSOE",8
38,"38050",2417,1288,1273,9,15,"PSOE",497
21,"21047",1878,1144,1112,12,32,"PSOE",455
5,"5161",545,395,395,0,0,"PSOE",101
24,"24154",952,625,618,5,7,"PSOE",216
47,"47041",147,105,103,3,2,"PSOE",26
41,"41078",2445,1722,1689,12,33,"PSOE",816
14,"14025",2834,2352,2299,9,53,"PSOE",1000
13,"13006",552,411,406,0,5,"PSOE",184
19,"19192",1762,1251,1240,5,11,"PSOE",386
19,"19285",20,16,16,0,0,"PSOE",8
40,"40234",375,278,269,3,9,"PSOE",91
21,"21048",318,234,229,3,5,"PSOE",106
19,"19224",106,83,83,1,0,"PSOE",8
22,"22170",672,460,456,5,4,"PSOE",121
13,"13052",6288,4360,4278,36,82,"PSOE",1388
45,"45164",166,143,142,1,1,"PSOE",45
16,"16079",28,16,16,0,0,"PSOE",9
42,"42025",1125,741,732,12,9,"PSOE",278
41,"41096",6178,4739,4655,60,84,"PSOE",1432
40,"40139",255,194,192,2,2,"PSOE",62
10,"10028",83,62,61,1,1,"PSOE",39
31,"31166",242,172,172,2,0,"PSOE",31
30,"30010",6852,5161,5106,25,55,"PSOE",1389
49,"49075",130,100,97,1,3,"PSOE",39
39,"39054",4541,3271,3252,30,19,"PSOE",803
37,"37232",377,303,303,2,0,"PSOE",67
22,"22029",118,85,83,1,2,"PSOE",23
9,"9369",419,288,284,3,4,"PSOE",122
45,"45018",550,385,380,1,5,"PSOE",101
12,"12100",1273,1069,1052,5,17,"PSOE",365
47,"47169",62,52,52,0,0,"PSOE",3
6,"6120",3370,2507,2460,11,47,"PSOE",1192
4,"4067",504,340,330,4,10,"PSOE",189
42,"42065",23,18,18,1,0,"PSOE",2
49,"49223",701,498,494,7,4,"PSOE",129
37,"37199",128,92,92,2,0,"PSOE",37
19,"19099",286,179,175,1,4,"PSOE",75
22,"22173",219,147,141,3,6,"PSOE",50
33,"33017",2969,1787,1768,38,19,"PSOE",705
42,"42205",77,59,57,3,2,"PSOE",18
16,"16910",75,44,44,1,0,"PSOE",16
24,"24901",853,517,513,4,4,"PSOE",191
9,"9095",103,54,53,3,1,"PSOE",8
37,"37357",248,193,192,1,1,"PSOE",64
13,"13011",4439,2762,2694,16,68,"PSOE",1155
16,"16042",1091,832,823,4,9,"PSOE",404
33,"33018",2804,1830,1806,30,24,"PSOE",595
24,"24011",182,104,102,3,2,"PSOE",78
45,"45167",1370,1078,1065,1,13,"PSOE",369
44,"44137",187,139,139,0,0,"PSOE",20
19,"19196",89,70,67,1,3,"PSOE",20
6,"6122",6535,4204,4110,47,94,"PSOE",1604
28,"28141",6284,4617,4570,42,47,"PSOE",961
12,"12126",24374,17741,17553,111,188,"PSOE",5064
31,"31169",2203,1429,1415,15,14,"PSOE",651
30,"30012",9085,6704,6599,46,105,"PSOE",2622
9,"9374",93,75,72,2,3,"PSOE",17
31,"31097",10559,6977,6919,71,58,"PSOE",1483
19,"19031",8,8,8,0,0,"PSOE",2
12,"12077",4828,3395,3357,28,38,"PSOE",966
22,"22063",161,128,126,0,2,"PSOE",48
42,"42163",50,27,27,1,0,"PSOE",9
6,"6032",80,68,68,1,0,"PSOE",15
37,"37296",297,215,210,0,5,"PSOE",92
30,"30013",7421,5171,5094,32,77,"PSOE",2218
44,"44018",16,16,16,0,0,"PSOE",1
26,"26078",86,63,63,0,0,"PSOE",21
4,"4034",169,91,91,1,0,"PSOE",20
49,"49079",104,79,76,0,3,"PSOE",21
50,"50015",81,57,56,0,1,"PSOE",37
14,"14030",7761,5711,5588,84,123,"PSOE",2401
18,"18914",1660,1255,1227,11,28,"PSOE",604
39,"39058",806,556,554,2,2,"PSOE",178
50,"50168",29,20,20,0,0,"PSOE",7
13,"13013",7056,5041,4945,52,96,"PSOE",1543
50,"50089",8616,6420,6364,50,56,"PSOE",1314
28,"28067",4416,3359,3311,18,48,"PSOE",965
40,"40045",119,93,93,1,0,"PSOE",28
39,"39030",1874,1199,1187,6,12,"PSOE",278
18,"18082",810,503,500,3,3,"PSOE",212
47,"47143",104,67,67,0,0,"PSOE",11
37,"37172",846,530,524,6,6,"PSOE",109
16,"16160",58,41,41,1,0,"PSOE",9
19,"19104",19,15,14,0,1,"PSOE",1
49,"49185",156,120,116,0,4,"PSOE",24
19,"19198",17,14,14,0,0,"PSOE",6
5,"5103",63,44,44,1,0,"PSOE",5
13,"13015",5220,3665,3629,25,36,"PSOE",1442
19,"19291",1143,803,794,2,9,"PSOE",267
40,"40144",16,15,15,0,0,"PSOE",1
2,"2024",3361,2444,2411,24,33,"PSOE",889
34,"34047",1711,1275,1248,18,27,"PSOE",275
10,"10200",336,243,242,0,1,"PSOE",102
46,"46002",1253,946,940,4,6,"PSOE",287
19,"19293",1945,1402,1388,19,14,"PSOE",409
22,"22177",96,69,68,0,1,"PSOE",19
28,"28146",1806,1232,1218,3,14,"PSOE",419
49,"49187",1197,839,819,12,20,"PSOE",274
44,"44227",72,58,58,0,0,"PSOE",12
45,"45172",640,475,462,6,13,"PSOE",179
50,"50170",357,245,242,6,3,"PSOE",109
12,"12080",1883,1472,1438,8,34,"PSOE",628
26,"26123",128,110,110,0,0,"PSOE",32
16,"16162",39,31,31,0,0,"PSOE",10
44,"44021",104,77,77,1,0,"PSOE",21
44,"44260",137,93,93,1,0,"PSOE",22
9,"9055",47,33,32,0,1,"PSOE",8
28,"28069",58,44,42,1,2,"PSOE",6
37,"37143",384,273,273,2,0,"PSOE",91
39,"39061",3470,2605,2591,14,14,"PSOE",367
13,"13019",5101,3502,3468,33,34,"PSOE",1004
26,"26124",768,603,590,4,13,"PSOE",211
9,"9327",26,20,20,0,0,"PSOE",5
2,"2026",834,644,633,4,11,"PSOE",323
9,"9057",147,110,108,0,2,"PSOE",29
44,"44201",477,399,395,1,4,"PSOE",143
7,"7042",10846,6354,6299,77,55,"PSOE",1804
37,"37363",104,81,80,0,1,"PSOE",31
12,"12130",414,329,327,0,2,"PSOE",41
50,"50018",883,622,616,5,6,"PSOE",284
37,"37333",203,125,124,2,1,"PSOE",25
45,"45175",603,476,473,1,3,"PSOE",183
47,"47147",103,86,82,0,4,"PSOE",15
37,"37334",71,30,30,0,0,"PSOE",7
22,"22141",115,94,93,0,1,"PSOE",15
37,"37115",108,67,65,0,2,"PSOE",17
21,"21027",49,32,32,0,0,"PSOE",8
31,"31250",2761,1776,1759,13,17,"PSOE",303
19,"19002",55,45,45,0,0,"PSOE",22
40,"40017",83,71,68,2,3,"PSOE",16
5,"5236",105,69,69,1,0,"PSOE",22
19,"19071",8277,5838,5763,53,75,"PSOE",1375
23,"23018",2243,1606,1584,17,22,"PSOE",901
49,"49190",50,42,42,3,0,"PSOE",15
42,"42037",28,13,13,2,0,"PSOE",3
10,"10164",707,391,382,4,9,"PSOE",183
37,"37146",106,82,76,0,6,"PSOE",10
9,"9220",69,52,52,3,0,"PSOE",19
23,"23019",1466,1117,1090,5,27,"PSOE",503
9,"9388",31,26,25,0,1,"PSOE",11
13,"13022",348,244,239,1,5,"PSOE",130
19,"19109",33,26,26,2,0,"PSOE",1
46,"46119",761,587,580,6,7,"PSOE",187
44,"44051",2579,1924,1901,10,23,"PSOE",542
45,"45067",2267,1722,1675,14,47,"PSOE",517
47,"47084",1077,794,784,11,10,"PSOE",269
42,"42128",45,40,39,2,1,"PSOE",14
37,"37178",98,70,70,0,0,"PSOE",16
10,"10002",360,239,236,1,3,"PSOE",115
46,"46051",8469,6120,6070,40,50,"PSOE",1463
28,"28151",3274,2344,2310,16,34,"PSOE",699
19,"19204",150,105,104,3,1,"PSOE",47
3,"3036",82,73,71,1,2,"PSOE",12
9,"9061",147,119,119,0,0,"PSOE",11
26,"26015",185,140,138,2,2,"PSOE",34
13,"13024",875,587,577,7,10,"PSOE",222
12,"12109",646,489,482,4,7,"PSOE",176
34,"34100",132,96,95,1,1,"PSOE",31
9,"9016",85,54,54,0,0,"PSOE",18
33,"33027",752,412,405,11,7,"PSOE",183
46,"46007",12333,8890,8803,79,87,"PSOE",2209
23,"23021",512,406,399,2,7,"PSOE",231
38,"38037",12817,7582,7494,55,88,"PSOE",2460
9,"9390",554,455,450,6,5,"PSOE",135
45,"45180",2850,2044,2023,15,21,"PSOE",512
3,"3123",7579,5491,5416,50,75,"PSOE",1623
22,"22075",116,71,69,1,2,"PSOE",34
24,"24169",2777,1908,1880,10,28,"PSOE",916
26,"26016",28,20,18,0,2,"PSOE",7
16,"16055",669,429,426,0,3,"PSOE",148
26,"26130",205,153,150,1,3,"PSOE",38
10,"10168",320,210,206,1,4,"PSOE",92
38,"38013",3011,1850,1829,14,21,"PSOE",574
45,"45143",1192,877,865,9,12,"PSOE",247
10,"10209",259,151,149,0,2,"PSOE",78
49,"49236",71,54,54,0,0,"PSOE",10
22,"22076",285,207,203,4,4,"PSOE",79
9,"9392",49,28,28,0,0,"PSOE",12
47,"47151",26,22,22,0,0,"PSOE",2
44,"44148",74,56,54,0,2,"PSOE",28
16,"16056",442,275,270,4,5,"PSOE",114
13,"13028",10230,7682,7559,65,123,"PSOE",2598
10,"10047",938,710,694,1,16,"PSOE",361
41,"41035",1051,733,722,10,11,"PSOE",348
49,"49015",198,156,155,0,1,"PSOE",55
22,"22111",143,96,95,2,1,"PSOE",28
16,"16133",4399,3317,3256,34,61,"PSOE",1120
11,"11020",166773,111205,109956,1580,1249,"PSOE",32000
37,"37083",181,155,153,1,2,"PSOE",55
40,"40154",22,18,18,1,0,"PSOE",4
2,"2034",1323,1024,1018,6,6,"PSOE",452
37,"37182",75,47,47,1,0,"PSOE",2
5,"5145",43,28,28,0,0,"PSOE",10
28,"28154",5570,3999,3961,29,38,"PSOE",1112
6,"6141",1678,1183,1158,15,25,"PSOE",509
37,"37340",141,97,97,1,0,"PSOE",17
34,"34208",48,40,40,1,0,"PSOE",1
49,"49199",236,159,157,3,2,"PSOE",59
44,"44028",171,136,136,0,0,"PSOE",25
9,"9175",120,78,76,1,2,"PSOE",12
22,"22150",459,325,321,8,4,"PSOE",104
37,"37085",5060,3732,3689,52,43,"PSOE",889
49,"49239",599,393,384,6,9,"PSOE",190
37,"37246",5146,3791,3737,42,54,"PSOE",1226
34,"34106",110,92,92,3,0,"PSOE",10
5,"5210",81,56,56,0,0,"PSOE",3
13,"13031",2475,1855,1834,9,21,"PSOE",719
37,"37247",171,129,128,0,1,"PSOE",20
42,"42088",62,45,44,0,1,"PSOE",10
44,"44150",28,17,17,0,0,"PSOE",4
18,"18159",989,765,762,2,3,"PSOE",299
33,"33059",4359,2651,2625,33,26,"PSOE",836
14,"14069",7340,5100,5000,69,100,"PSOE",2428
10,"10092",260,201,200,1,1,"PSOE",98
9,"9283",39,25,24,1,1,"PSOE",5
23,"23028",6103,4369,4286,26,83,"PSOE",1789
29,"29029",383,256,254,4,2,"PSOE",73
39,"39013",517,359,356,1,3,"PSOE",48
22,"22016",558,384,382,5,2,"PSOE",172
16,"16061",939,746,727,16,19,"PSOE",321
49,"49201",283,232,228,3,4,"PSOE",128
6,"6007",1418,984,968,13,16,"PSOE",577
45,"45186",2943,2142,2121,12,21,"PSOE",560
5,"5083",137,92,91,0,1,"PSOE",23
14,"14042",18695,13788,13514,206,274,"PSOE",5267
47,"47059",94,64,64,0,0,"PSOE",16
6,"6144",504,391,382,6,9,"PSOE",209
42,"42090",83,65,64,1,1,"PSOE",18
34,"34063",84,74,74,1,0,"PSOE",19
18,"18032",247,164,163,1,1,"PSOE",55
28,"28157",690,471,467,1,4,"PSOE",117
19,"19010",9,9,9,0,0,"PSOE",4
10,"10175",1351,918,901,8,17,"PSOE",401
5,"5084",66,44,44,0,0,"PSOE",15
37,"37052",287,192,191,2,1,"PSOE",71
47,"47060",224,171,168,1,3,"PSOE",58
50,"50253",379,294,290,1,4,"PSOE",89
50,"50027",223,166,161,2,5,"PSOE",67
13,"13035",947,704,690,6,14,"PSOE",363
9,"9289",1353,873,861,4,12,"PSOE",292
45,"45077",546,413,409,0,4,"PSOE",129
3,"3042",1475,1053,1043,7,10,"PSOE",247
38,"38042",3778,2410,2386,11,24,"PSOE",928
46,"46034",1826,1345,1335,3,10,"PSOE",335
26,"26023",433,316,314,3,2,"PSOE",111
45,"45151",544,413,409,0,4,"PSOE",166
34,"34214",176,121,120,1,1,"PSOE",46
34,"34215",161,126,125,6,1,"PSOE",49
37,"37218",51,25,23,0,2,"PSOE",2
14,"14072",983,692,680,6,12,"PSOE",375
41,"41013",4836,3174,3124,41,50,"PSOE",1811
21,"21038",1082,688,676,4,12,"PSOE",269
41,"41041",9765,7172,6943,63,229,"PSOE",2622
10,"10096",3311,2248,2201,15,47,"PSOE",948
26,"26025",84,69,65,2,4,"PSOE",32
31,"31190",44,30,30,1,0,"PSOE",9
23,"23065",1530,1068,1054,7,14,"PSOE",510
39,"39072",325,184,182,0,2,"PSOE",23
4,"4088",2444,1587,1574,17,13,"PSOE",642
19,"19306",24,18,18,0,0,"PSOE",2
6,"6012",3231,2306,2278,25,28,"PSOE",1134
16,"16064",651,556,550,4,6,"PSOE",208
37,"37157",76,64,63,1,1,"PSOE",34
30,"30026",16345,10049,9914,84,135,"PSOE",2720
44,"44006",220,152,151,1,1,"PSOE",42
5,"5183",123,103,100,0,3,"PSOE",18
10,"10179",272,209,209,2,0,"PSOE",98
31,"31154",217,107,104,0,3,"PSOE",14
6,"6104",648,470,459,2,11,"PSOE",272
35,"35005",1009,680,668,2,12,"PSOE",206
26,"26027",139,99,97,0,2,"PSOE",42
5,"5184",238,163,160,2,3,"PSOE",46
49,"49061",143,98,97,1,1,"PSOE",29
41,"41015",5426,3778,3639,41,139,"PSOE",1416
12,"12010",232,191,187,3,4,"PSOE",63
28,"28161",52164,38607,38193,306,414,"PSOE",8980
22,"22083",447,360,355,6,5,"PSOE",133
24,"24034",3466,2382,2359,25,23,"PSOE",1053
44,"44035",102,82,80,1,2,"PSOE",16
40,"40062",56,43,42,0,1,"PSOE",10
47,"47160",395,296,294,3,2,"PSOE",89
40,"40095",453,341,329,2,12,"PSOE",64
18,"18036",3986,2956,2917,22,39,"PSOE",714
5,"5218",104,81,79,0,2,"PSOE",21
22,"22020",115,83,80,3,3,"PSOE",21
19,"19308",57,49,49,0,0,"PSOE",23
37,"37024",89,60,60,0,0,"PSOE",19
47,"47223",148,105,102,4,3,"PSOE",32
12,"12142",142,113,113,0,0,"PSOE",25
40,"40130",127,95,87,1,8,"PSOE",21
42,"42151",38,27,27,0,0,"PSOE",11
41,"41072",4031,2969,2933,15,36,"PSOE",1217
44,"44215",167,113,113,2,0,"PSOE",29
44,"44128",58,39,37,0,2,"PSOE",9
41,"41044",7753,5636,5547,55,89,"PSOE",1820
5,"5219",33,23,23,0,0,"PSOE",5
38,"38046",9267,6652,6594,55,58,"PSOE",1672
26,"26030",18,18,17,1,1,"PSOE",1
6,"6154",2799,1851,1782,20,69,"PSOE",724
16,"16068",125,88,88,3,0,"PSOE",30
10,"10183",950,696,684,3,12,"PSOE",291
29,"29035",1478,1054,1040,3,14,"PSOE",545
42,"42152",67,47,44,1,3,"PSOE",6
37,"37097",42,29,29,0,0,"PSOE",7
10,"10061",1591,1010,992,9,18,"PSOE",519
26,"26146",84,56,55,0,1,"PSOE",16
22,"22201",264,188,186,3,2,"PSOE",95
34,"34222",107,71,68,1,3,"PSOE",11
10,"10103",422,290,286,1,4,"PSOE",138
3,"3135",195,134,131,1,3,"PSOE",57
5,"5090",73,63,62,0,1,"PSOE",12
46,"46198",862,670,660,3,10,"PSOE",187
37,"37256",191,123,123,1,0,"PSOE",38
21,"21073",1902,1073,1043,13,30,"PSOE",403
5,"5188",39,33,33,0,0,"PSOE",2
26,"26108",309,240,231,2,9,"PSOE",71
50,"50235",2421,1721,1702,18,19,"PSOE",482
16,"16190",4930,3747,3688,26,59,"PSOE",1250
13,"13045",622,459,451,0,8,"PSOE",160
49,"49249",61,45,45,1,0,"PSOE",7
34,"34169",371,263,259,5,4,"PSOE",57
18,"18102",8233,5424,5266,46,158,"PSOE",2568
9,"9083",26,21,21,0,0,"PSOE",2
34,"34224",39,25,25,0,0,"PSOE",6
26,"26032",43,36,35,0,1,"PSOE",18
42,"42105",47,40,40,2,0,"PSOE",3
31,"31087",179,124,124,3,0,"PSOE",14
23,"23039",2170,1502,1460,10,42,"PSOE",688
29,"29065",191,145,143,3,2,"PSOE",42
19,"19221",31,22,22,1,0,"PSOE",8
41,"41019",4931,3323,3251,39,72,"PSOE",1193
13,"13092",1703,1327,1307,4,20,"PSOE",455
42,"42196",7,7,7,1,0,"PSOE",1
26,"26033",162,133,132,3,1,"PSOE",62
46,"46063",1786,1270,1255,8,15,"PSOE",378
23,"23003",8639,6296,6226,41,70,"PSOE",2821
31,"31089",236,168,167,1,1,"PSOE",37
2,"2080",498,358,352,0,6,"PSOE",141
49,"49030",79,56,56,0,0,"PSOE",3
29,"29010",1637,1263,1187,2,76,"PSOE",605
42,"42106",13,11,11,0,0,"PSOE",2
34,"34079",1729,1296,1275,19,21,"PSOE",367
5,"5094",133,105,105,0,0,"PSOE",4
5,"5190",53,44,43,0,1,"PSOE",3
24,"24185",447,303,295,1,8,"PSOE",93
45,"45198",1808,1442,1428,6,14,"PSOE",531
4,"4027",218,130,130,0,0,"PSOE",30
42,"42022",206,147,146,6,1,"PSOE",22
13,"13049",742,509,500,4,9,"PSOE",169
34,"34227",70,56,52,1,4,"PSOE",5
10,"10188",483,354,340,0,14,"PSOE",166
44,"44070",55,49,49,0,0,"PSOE",6
5,"5192",92,75,72,1,3,"PSOE",21
37,"37289",210,147,144,0,3,"PSOE",35
26,"26036",16989,11463,11260,101,203,"PSOE",3728
34,"34035",97,76,75,3,1,"PSOE",28
22,"22205",448,294,292,0,2,"PSOE",146
31,"31201",151450,105649,104976,1004,673,"PSOE",23619
18,"18173",8999,5958,5871,50,87,"PSOE",2294
37,"37166",196,134,133,1,1,"PSOE",39
3,"3139",23126,14650,14522,127,128,"PSOE",4216
23,"23042",292,219,219,0,0,"PSOE",79
46,"46251",2465,1938,1903,19,35,"PSOE",617
28,"28001",70,48,47,1,1,"PSOE",7
46,"46065",1584,1199,1183,11,16,"PSOE",302
33,"33043",656,408,401,2,7,"PSOE",195
30,"30033",10377,7330,7215,59,115,"PSOE",1932
19,"19254",43,34,34,0,0,"PSOE",8
28,"28137",1770,1300,1289,6,11,"PSOE",364
6,"6118",155,114,112,0,2,"PSOE",72
44,"44250",20,15,15,0,0,"PSOE",0
34,"34177",178,149,149,1,0,"PSOE",50
26,"26113",29,28,28,0,0,"PSOE",2
9,"9143",28,17,17,0,0,"PSOE",3
28,"28170",2495,1714,1695,13,19,"PSOE",470
30,"30034",1067,818,801,8,17,"PSOE",252
22,"22090",86,61,61,1,0,"PSOE",25
34,"34231",211,157,153,3,4,"PSOE",30
19,"19129",25,21,21,0,0,"PSOE",4
19,"19024",8561,6015,5942,44,73,"PSOE",1635
44,"44074",440,314,308,2,6,"PSOE",70
39,"39082",1611,1108,1102,8,6,"PSOE",173
46,"46135",9817,7596,7558,58,38,"PSOE",1673
50,"50013",199,158,158,0,0,"PSOE",68
31,"31057",1741,1237,1219,6,18,"PSOE",444
33,"33016",18848,12845,12737,173,108,"PSOE",3738
19,"19225",851,618,611,2,7,"PSOE",176
6,"6903",2011,1443,1416,18,27,"PSOE",568
49,"49258",111,93,93,2,0,"PSOE",27
24,"24230",403,268,265,3,3,"PSOE",83
44,"44109",99,64,64,0,0,"PSOE",23
31,"31204",36,25,25,0,0,"PSOE",2
10,"10071",126,78,71,0,7,"PSOE",33
45,"45093",147,115,114,0,1,"PSOE",23
16,"16197",67,44,43,0,1,"PSOE",20
9,"9315",384,245,242,3,3,"PSOE",69
28,"28109",1651,1131,1116,8,15,"PSOE",197
28,"28172",9915,7715,7652,60,63,"PSOE",1493
45,"45094",365,274,271,3,3,"PSOE",103
24,"24049",1417,983,975,14,8,"PSOE",394
23,"23046",2334,1880,1855,9,25,"PSOE",948
19,"19323",36,26,26,0,0,"PSOE",13
10,"10195",7514,5243,5148,47,95,"PSOE",1761
22,"22001",212,147,146,0,1,"PSOE",30
31,"31205",419,290,289,4,1,"PSOE",114
3,"3084",501,413,413,1,0,"PSOE",149
9,"9373",399,254,251,5,3,"PSOE",24
45,"45095",663,496,492,2,4,"PSOE",168
46,"46159",23038,16719,16596,127,123,"PSOE",4609
46,"46023",322,254,252,1,2,"PSOE",54
22,"22035",225,153,152,1,1,"PSOE",83
3,"3114",1593,1158,1142,4,16,"PSOE",361
37,"37139",189,150,148,1,2,"PSOE",38
26,"26118",71,54,53,1,1,"PSOE",12
5,"5166",155,108,104,1,4,"PSOE",18
37,"37035",162,115,115,1,0,"PSOE",40
50,"50088",274,195,191,2,4,"PSOE",79
39,"39029",629,476,469,1,7,"PSOE",62
45,"45169",179,114,111,1,3,"PSOE",38
24,"24086",258,197,196,1,1,"PSOE",45
26,"26042",795,578,572,8,6,"PSOE",208
12,"12022",323,257,254,5,3,"PSOE",75
50,"50266",120,77,76,3,1,"PSOE",29
19,"19032",145,94,93,2,1,"PSOE",45
42,"42118",21,11,11,0,0,"PSOE",1
28,"28174",1858,1284,1273,1,11,"PSOE",311
16,"16085",131,106,106,0,0,"PSOE",38
9,"9428",102,73,73,1,0,"PSOE",19
39,"39086",358,236,235,2,1,"PSOE",63
46,"46001",771,562,560,3,2,"PSOE",200
18,"18147",3655,2273,2241,16,32,"PSOE",842
9,"9429",53,34,34,1,0,"PSOE",2
11,"11041",9869,6438,6295,100,143,"PSOE",2240
22,"22212",69,52,52,1,0,"PSOE",32
13,"13060",274,205,202,3,3,"PSOE",85
35,"35016",300581,181532,179831,1458,1701,"PSOE",53942
19,"19065",109,86,85,1,1,"PSOE",29
28,"28112",160,129,129,0,0,"PSOE",48
12,"12051",437,297,295,3,2,"PSOE",38
4,"4071",362,286,281,2,5,"PSOE",157
24,"24122",1292,818,810,7,8,"PSOE",320
19,"19199",19,15,15,0,0,"PSOE",6
26,"26045",11,10,10,1,0,"PSOE",6
49,"49007",361,241,233,7,8,"PSOE",105
9,"9266",97,71,68,1,3,"PSOE",24
10,"10119",574,417,414,2,3,"PSOE",200
37,"37299",230,148,147,0,1,"PSOE",32
16,"16087",238,184,184,6,0,"PSOE",53
9,"9431",116,85,84,2,1,"PSOE",18
50,"50268",41,32,32,1,0,"PSOE",7
44,"44171",176,115,115,0,0,"PSOE",21
49,"49229",109,80,77,1,3,"PSOE",32
9,"9006",57,30,29,0,1,"PSOE",7
33,"33050",548,316,314,1,2,"PSOE",134
46,"46257",5436,3972,3933,28,39,"PSOE",1108
23,"23051",2736,2066,2021,16,45,"PSOE",948
34,"34240",84,67,66,1,1,"PSOE",17
46,"46048",3504,2609,2576,17,33,"PSOE",743
47,"47018",36,31,31,0,0,"PSOE",0
3,"3098",523,382,378,1,4,"PSOE",140
19,"19136",11,10,10,0,0,"PSOE",6
9,"9268",89,62,62,0,0,"PSOE",35
22,"22249",125,93,92,1,1,"PSOE",27
37,"37269",424,280,277,2,3,"PSOE",110
49,"49188",111,75,73,0,2,"PSOE",21
9,"9433",52,40,40,0,0,"PSOE",12
6,"6039",1802,1375,1343,9,32,"PSOE",827
37,"37077",251,206,204,1,2,"PSOE",97
46,"46258",2617,1925,1914,5,11,"PSOE",560
9,"9164",147,112,111,0,1,"PSOE",29
38,"38034",3997,2687,2648,19,39,"PSOE",795
6,"6040",993,679,668,3,11,"PSOE",343
37,"37176",128,99,98,1,1,"PSOE",31
23,"23053",9451,6038,5975,60,63,"PSOE",2756
34,"34243",323,243,239,1,4,"PSOE",67
22,"22105",102,65,65,0,0,"PSOE",31
29,"29049",2890,2069,2034,12,35,"PSOE",1016
24,"24165",317,202,199,1,3,"PSOE",88
26,"26048",21,21,21,0,0,"PSOE",3
9,"9218",350,254,252,5,2,"PSOE",88
46,"46209",1903,1406,1383,5,23,"PSOE",444
46,"46118",3649,2730,2701,20,29,"PSOE",934
6,"6132",823,543,533,4,10,"PSOE",271
49,"49043",256,191,189,1,2,"PSOE",80
16,"16091",63,43,42,1,1,"PSOE",27
45,"45139",144,111,111,0,0,"PSOE",60
14,"14007",15016,10248,10043,99,205,"PSOE",3706
39,"39062",1864,1395,1376,3,19,"PSOE",176
9,"9329",113,76,75,5,1,"PSOE",28
41,"41060",15058,10551,10302,122,249,"PSOE",3930
44,"44024",31,26,25,0,1,"PSOE",4
13,"13068",1023,737,722,2,15,"PSOE",277
50,"50197",95,69,68,2,1,"PSOE",22
9,"9272",251,166,166,1,0,"PSOE",59
9,"9273",48,40,39,0,1,"PSOE",9
49,"49233",85,51,51,0,0,"PSOE",10
28,"28181",20801,16353,16243,97,110,"PSOE",2915
41,"41033",4958,3299,3250,38,49,"PSOE",1515
18,"18024",837,651,639,11,12,"PSOE",253
40,"40213",93,78,78,1,0,"PSOE",22
37,"37303",179,118,117,1,1,"PSOE",37
39,"39091",1881,1297,1291,8,6,"PSOE",259
46,"46260",2685,2072,2053,14,19,"PSOE",568
10,"10085",310,219,219,1,0,"PSOE",86
19,"19235",98,77,76,1,1,"PSOE",47
44,"44264",254,170,170,0,0,"PSOE",61
46,"46074",2687,2033,2020,18,13,"PSOE",530
30,"30043",25449,18839,18477,180,362,"PSOE",4774
7,"7012",1908,1301,1282,12,19,"PSOE",319
42,"42129",678,485,480,6,5,"PSOE",178
49,"49122",761,517,505,7,12,"PSOE",139
5,"5904",108,70,69,5,1,"PSOE",9
40,"40182",169,112,112,1,0,"PSOE",37
38,"38012",2286,1520,1510,8,10,"PSOE",537
37,"37367",179,147,143,2,4,"PSOE",29
41,"41034",23576,15461,15214,264,247,"PSOE",6073
13,"13071",37945,24340,24091,227,249,"PSOE",9230
9,"9275",167,114,114,1,0,"PSOE",33
16,"16094",121,86,84,0,2,"PSOE",18
28,"28014",34522,25016,24748,229,268,"PSOE",6800
10,"10208",122,85,83,0,2,"PSOE",48
28,"28119",2294,1760,1738,12,22,"PSOE",347
44,"44265",175,138,136,1,2,"PSOE",29
34,"34902",123,91,91,0,0,"PSOE",24
39,"39093",297,216,214,1,2,"PSOE",47
4,"4009",140,109,106,2,3,"PSOE",23
16,"16170",646,451,449,5,2,"PSOE",196
40,"40020",149,112,111,1,1,"PSOE",30
19,"19299",100,72,71,1,1,"PSOE",27
31,"31072",5324,3733,3684,33,49,"PSOE",1287
44,"44266",102,81,79,0,2,"PSOE",12
50,"50124",394,269,266,0,3,"PSOE",54
31,"31256",95,55,55,1,0,"PSOE",2
34,"34903",179,129,129,1,0,"PSOE",32
16,"16096",278,219,217,1,2,"PSOE",91
46,"46076",610,500,494,1,6,"PSOE",151
50,"50073",2122,1559,1540,14,19,"PSOE",469
49,"49272",73,49,46,2,3,"PSOE",8
16,"16266",356,269,265,4,4,"PSOE",67
37,"37245",331,221,220,4,1,"PSOE",83
2,"2044",1040,665,656,5,9,"PSOE",266
47,"47005",506,358,348,3,10,"PSOE",110
10,"10211",446,303,300,0,3,"PSOE",169
29,"29071",980,580,564,11,16,"PSOE",229
24,"24098",1149,753,741,8,12,"PSOE",323
10,"10048",202,141,139,0,2,"PSOE",47
9,"9279",166,116,114,1,2,"PSOE",23
13,"13075",196,147,146,2,1,"PSOE",42
40,"40185",800,560,553,4,7,"PSOE",162
28,"28089",3856,2866,2829,21,37,"PSOE",663
46,"46263",235,182,180,2,2,"PSOE",98
12,"12060",434,366,360,1,6,"PSOE",81
19,"19335",51,39,38,0,1,"PSOE",22
19,"19079",7,6,6,0,0,"PSOE",0
23,"23061",7711,5357,5231,44,126,"PSOE",2304
26,"26056",404,312,301,2,11,"PSOE",114
31,"31184",65,41,40,0,1,"PSOE",0
50,"50024",543,400,397,3,3,"PSOE",200
34,"34155",122,95,95,0,0,"PSOE",50
7,"7049",1479,935,918,5,17,"PSOE",173
39,"39040",4271,3103,3080,18,23,"PSOE",732
9,"9123",42,36,36,0,0,"PSOE",10
28,"28903",35555,28875,28671,341,204,"PSOE",7130
4,"4050",742,465,464,0,1,"PSOE",208
26,"26135",152,115,114,0,1,"PSOE",36
5,"5048",107,89,88,2,1,"PSOE",20
35,"35024",14323,8360,8289,81,71,"PSOE",2268
46,"46902",352,283,283,0,0,"PSOE",118
2,"2069",11401,8055,7975,30,80,"PSOE",2436
13,"13032",1076,772,765,0,7,"PSOE",320
47,"47217",1984,1460,1437,11,23,"PSOE",386
4,"4051",404,323,319,2,4,"PSOE",104
22,"22114",124,75,72,1,3,"PSOE",30
50,"50051",802,551,550,2,1,"PSOE",243
26,"26058",149,114,114,2,0,"PSOE",30
19,"19242",74,53,53,1,0,"PSOE",4
42,"42009",77,58,58,0,0,"PSOE",9
28,"28102",880,639,621,7,18,"PSOE",216
31,"31150",200,120,119,1,1,"PSOE",15
50,"50277",45,34,34,0,0,"PSOE",8
26,"26098",92,63,63,1,0,"PSOE",17
14,"14070",1280,911,902,4,9,"PSOE",345
44,"44004",379,275,275,2,0,"PSOE",59
21,"21006",3321,2197,2125,19,72,"PSOE",1234
24,"24175",1821,1316,1305,15,11,"PSOE",328
50,"50129",212,129,127,0,2,"PSOE",37
40,"40092",105,75,75,2,0,"PSOE",22
16,"16225",55,30,30,0,0,"PSOE",11
22,"22115",348,263,261,3,2,"PSOE",78
22,"22017",826,613,608,2,5,"PSOE",262
46,"46148",1515,1131,1113,5,18,"PSOE",255
50,"50204",2396,1723,1712,17,11,"PSOE",875
39,"39070",126,91,89,0,2,"PSOE",15
50,"50076",70,56,56,0,0,"PSOE",23
16,"16062",25,20,20,0,0,"PSOE",10
47,"47156",150,117,117,0,0,"PSOE",23
50,"50102",815,594,584,7,10,"PSOE",226
18,"18097",947,633,631,0,2,"PSOE",242
44,"44005",48,36,36,0,0,"PSOE",5
26,"26100",54,43,43,0,0,"PSOE",20
34,"34022",1022,813,798,7,15,"PSOE",345
6,"6102",1027,834,815,3,19,"PSOE",400
40,"40093",74,62,62,1,0,"PSOE",7
12,"12091",171,110,108,4,2,"PSOE",25
46,"46172",5488,3724,3674,26,50,"PSOE",906
12,"12065",167,142,141,0,1,"PSOE",43
49,"49244",46,23,23,0,0,"PSOE",2
16,"16228",173,147,145,2,2,"PSOE",33
18,"18003",14454,10162,9935,105,227,"PSOE",2962
18,"18163",311,206,204,0,2,"PSOE",70
24,"24104",243,167,166,0,1,"PSOE",56
10,"10218",1074,685,672,0,13,"PSOE",355
37,"37126",30,25,25,0,0,"PSOE",3
22,"22018",303,216,215,3,1,"PSOE",89
9,"9294",99,81,78,0,3,"PSOE",35
42,"42014",57,35,35,0,0,"PSOE",9
9,"9182",74,54,54,0,0,"PSOE",11
10,"10098",387,272,267,0,5,"PSOE",93
18,"18066",2095,1401,1378,12,23,"PSOE",679
18,"18133",2101,1496,1477,6,19,"PSOE",557
34,"34217",1269,999,983,14,16,"PSOE",288
31,"31045",510,347,345,8,2,"PSOE",97
47,"47128",53,45,43,0,2,"PSOE",2
49,"49245",251,174,171,1,3,"PSOE",52
24,"24145",612,338,337,1,1,"PSOE",150
21,"21009",834,527,508,4,19,"PSOE",239
22,"22117",2384,1606,1596,18,10,"PSOE",474
19,"19154",58,45,45,0,0,"PSOE",7
37,"37283",116,83,83,0,0,"PSOE",27
34,"34114",200,134,134,0,0,"PSOE",21
46,"46151",757,560,552,2,8,"PSOE",156
5,"5121",263,194,189,1,5,"PSOE",54
12,"12117",3532,2512,2479,12,33,"PSOE",712
28,"28024",168,137,136,2,1,"PSOE",17
42,"42191",183,116,114,5,2,"PSOE",43
35,"35006",31373,20764,20476,189,288,"PSOE",6908
18,"18134",6104,4049,3972,39,77,"PSOE",1067
6,"6151",1049,746,741,5,5,"PSOE",372
42,"42149",386,273,270,2,3,"PSOE",91
21,"21070",6294,4232,4124,64,108,"PSOE",1813
46,"46128",1569,1216,1179,7,37,"PSOE",335
50,"50063",64,49,49,0,0,"PSOE",24
50,"50233",96,78,78,0,0,"PSOE",11
49,"49062",103,58,58,0,0,"PSOE",23
22,"22162",125,94,94,0,0,"PSOE",25
16,"16031",35,26,26,0,0,"PSOE",11
5,"5251",56,35,34,0,1,"PSOE",4
26,"26065",63,46,43,0,3,"PSOE",8
14,"14019",6380,4933,4831,71,102,"PSOE",1971
9,"9032",103,62,62,3,0,"PSOE",32
19,"19156",917,686,679,2,7,"PSOE",222
29,"29081",250,185,182,2,3,"PSOE",67
50,"50208",1761,1267,1250,16,17,"PSOE",488
19,"19089",23,17,17,0,0,"PSOE",11
28,"28131",13510,9647,9544,89,103,"PSOE",2247
33,"33038",2218,1501,1477,17,24,"PSOE",591
29,"29063",305,244,242,2,2,"PSOE",66
4,"4092",2791,2058,2023,4,35,"PSOE",686
18,"18068",1638,1197,1167,12,30,"PSOE",333
19,"19168",265,182,175,4,7,"PSOE",82
7,"7037",3448,1875,1856,18,19,"PSOE",491
2,"2077",52,41,41,0,0,"PSOE",19
37,"37059",117,95,95,3,0,"PSOE",38
4,"4022",356,237,236,5,1,"PSOE",95
34,"34122",83,56,56,0,0,"PSOE",18
16,"16238",461,380,378,1,2,"PSOE",157
46,"46153",443,353,349,2,4,"PSOE",110
42,"42019",519,345,341,3,4,"PSOE",93
31,"31014",268,168,168,2,0,"PSOE",29
22,"22086",194,137,137,1,0,"PSOE",37
4,"4093",1916,1143,1130,5,13,"PSOE",367
13,"13090",1005,754,733,4,21,"PSOE",304
18,"18168",783,566,561,11,5,"PSOE",153
29,"29036",614,393,387,1,6,"PSOE",182
26,"26068",78,61,61,0,0,"PSOE",25
41,"41074",2994,2154,2105,19,49,"PSOE",897
6,"6110",138,105,102,0,3,"PSOE",51
16,"16901",624,443,438,5,5,"PSOE",145
44,"44010",185,144,143,0,1,"PSOE",45
5,"5221",322,231,231,0,0,"PSOE",75
3,"3077",1391,1052,1032,10,20,"PSOE",261
5,"5125",56,47,46,0,1,"PSOE",8
35,"35009",20229,13378,13201,95,177,"PSOE",3914
2,"2079",2807,2000,1978,17,22,"PSOE",681
22,"22023",385,293,283,2,10,"PSOE",126
42,"42154",103,76,76,1,0,"PSOE",31
49,"49104",326,218,216,0,2,"PSOE",71
23,"23074",2984,2271,2236,20,35,"PSOE",989
37,"37320",85,65,64,1,1,"PSOE",19
24,"24112",288,188,186,2,2,"PSOE",115
50,"50033",61,44,44,1,0,"PSOE",12
22,"22024",220,159,158,1,1,"PSOE",61
33,"33041",7101,4564,4513,58,51,"PSOE",1682
6,"6159",2329,1297,1273,22,24,"PSOE",534
12,"12097",62,53,51,0,2,"PSOE",9
50,"50211",236,174,173,0,1,"PSOE",61
10,"10106",126,102,102,0,0,"PSOE",48
22,"22006",268,167,164,4,3,"PSOE",56
46,"46223",7776,5848,5798,36,50,"PSOE",1664
45,"45052",3132,2433,2416,29,17,"PSOE",743
40,"40231",100,79,76,0,3,"PSOE",16
41,"41093",19064,14867,14700,151,167,"PSOE",3634
6,"6160",3005,2083,2056,9,27,"PSOE",850
34,"34126",248,177,176,3,1,"PSOE",34
47,"47101",1634,1278,1262,7,16,"PSOE",495
38,"38001",21069,10844,10777,63,67,"PSOE",3567
46,"46155",972,731,716,3,15,"PSOE",249
42,"42023",57,48,48,0,0,"PSOE",9
11,"11004",89919,55211,54544,830,667,"PSOE",15066
5,"5127",600,472,469,7,3,"PSOE",123
24,"24227",1527,1036,1032,13,4,"PSOE",244
30,"30032",2864,2154,2129,18,25,"PSOE",649
12,"12098",529,417,413,3,4,"PSOE",121
49,"49177",255,145,144,1,1,"PSOE",71
24,"24115",53159,35203,34784,410,419,"PSOE",13645
6,"6025",5083,3543,3469,28,74,"PSOE",1498
24,"24080",207,155,154,1,1,"PSOE",50
47,"47010",14718,11521,11392,137,129,"PSOE",2746
38,"38051",7328,5017,4969,32,48,"PSOE",1355
38,"38002",971,577,570,8,7,"PSOE",279
16,"16003",134,108,105,0,3,"PSOE",39
12,"12045",333,243,235,2,8,"PSOE",90
11,"11005",4508,2978,2900,34,78,"PSOE",1416
39,"39024",1802,1325,1314,7,11,"PSOE",264
50,"50085",182,121,121,0,0,"PSOE",37
31,"31165",2772,1946,1930,16,16,"PSOE",703
46,"46043",135,119,118,0,1,"PSOE",24
3,"3111",5579,3777,3737,23,40,"PSOE",1007
42,"42201",23,21,21,0,0,"PSOE",8
37,"37135",1146,849,837,5,12,"PSOE",269
49,"49178",748,520,505,7,15,"PSOE",127
13,"13098",1946,1404,1361,13,43,"PSOE",419
37,"37197",88,53,53,1,0,"PSOE",12
26,"26074",107,87,86,2,1,"PSOE",29
49,"49145",208,113,113,1,0,"PSOE",27
28,"28032",5090,3716,3675,22,41,"PSOE",949
50,"50139",318,237,237,1,0,"PSOE",91
5,"5033",169,135,134,0,1,"PSOE",29
16,"16246",451,327,322,1,5,"PSOE",116
50,"50214",18,18,14,1,4,"PSOE",4
50,"50036",100,76,76,1,0,"PSOE",26
7,"7901",598,410,402,6,8,"PSOE",81
10,"10193",1392,1045,1025,6,20,"PSOE",281
26,"26002",821,611,597,1,14,"PSOE",191
5,"5227",341,230,228,1,2,"PSOE",64
23,"23080",1720,1313,1294,6,19,"PSOE",699
37,"37325",88,63,63,0,0,"PSOE",17
14,"14055",18411,13054,12798,192,256,"PSOE",4049
24,"24010",8251,5357,5275,40,82,"PSOE",1365
22,"22244",42,33,32,1,1,"PSOE",10
40,"40009",41,35,34,0,1,"PSOE",8
13,"13903",498,395,394,0,1,"PSOE",107
34,"34131",56,46,46,0,0,"PSOE",2
49,"49259",79,59,59,0,0,"PSOE",11
16,"16156",84,64,64,0,0,"PSOE",26
44,"44044",82,65,65,2,0,"PSOE",8
34,"34180",68,54,54,1,0,"PSOE",9
50,"50215",20,14,14,0,0,"PSOE",6
47,"47044",323,273,270,4,3,"PSOE",86
31,"31168",238,176,174,1,2,"PSOE",27
24,"24193",363,264,264,1,0,"PSOE",87
23,"23082",1850,1292,1279,13,13,"PSOE",527
47,"47054",599,465,460,1,5,"PSOE",124
29,"29016",253,196,194,0,2,"PSOE",68
40,"40903",75,61,59,0,2,"PSOE",7
31,"31243",300,216,213,6,3,"PSOE",37
18,"18177",375,235,231,5,4,"PSOE",91
16,"16249",1938,1422,1406,6,16,"PSOE",620
50,"50014",119,81,81,0,0,"PSOE",27
40,"40043",1773,1376,1345,21,31,"PSOE",387
9,"9098",470,318,309,3,9,"PSOE",102
3,"3903",2612,1838,1814,7,24,"PSOE",548
45,"45168",62836,46917,46353,424,564,"PSOE",13710
42,"42117",129,98,95,1,3,"PSOE",14
22,"22096",332,248,241,10,7,"PSOE",55
5,"5067",73,56,54,0,2,"PSOE",14
44,"44224",21,14,14,2,0,"PSOE",6
37,"37149",60,50,50,0,0,"PSOE",3
9,"9174",768,536,522,6,14,"PSOE",161
40,"40205",228,159,157,1,2,"PSOE",49
49,"49125",1392,883,871,11,12,"PSOE",318
16,"16188",74,57,57,1,0,"PSOE",24
18,"18079",3466,2391,2333,22,58,"PSOE",1294
22,"22036",84,71,71,1,0,"PSOE",11
31,"31025",762,497,490,1,7,"PSOE",78
11,"11011",1726,1124,1084,8,40,"PSOE",354
40,"40110",316,237,234,4,3,"PSOE",77
38,"38007",1619,1053,1043,3,10,"PSOE",337
31,"31135",111,73,72,3,1,"PSOE",18
4,"4035",8439,5822,5768,45,54,"PSOE",2149
49,"49150",123,95,92,3,3,"PSOE",33
34,"34237",579,408,400,1,8,"PSOE",121
42,"42166",55,38,37,0,1,"PSOE",7
26,"26080",451,347,344,0,3,"PSOE",90
10,"10035",1798,1201,1171,8,30,"PSOE",560
28,"28068",11740,8615,8543,72,72,"PSOE",1963
44,"44226",123,85,84,0,1,"PSOE",27
21,"21053",3306,2161,2106,11,55,"PSOE",833
50,"50217",426,333,333,1,0,"PSOE",165
49,"49238",273,205,200,4,5,"PSOE",72
37,"37049",125,76,76,0,0,"PSOE",18
37,"37330",314,227,223,2,4,"PSOE",66
40,"40111",50,39,39,0,0,"PSOE",9
39,"39031",1237,870,865,1,5,"PSOE",113
26,"26081",15,14,14,1,0,"PSOE",1
18,"18115",2635,1766,1738,13,28,"PSOE",768
50,"50143",541,373,367,2,6,"PSOE",115
28,"28113",36951,27912,27604,241,308,"PSOE",8166
16,"16124",1807,1367,1347,14,20,"PSOE",490
28,"28038",5213,3801,3753,24,48,"PSOE",1008
44,"44113",74,51,51,0,0,"PSOE",12
9,"9325",177,103,101,2,2,"PSOE",21
40,"40112",2813,2126,2087,26,39,"PSOE",574
4,"4037",1212,890,875,17,15,"PSOE",400
28,"28114",141,97,97,0,0,"PSOE",19
11,"11013",2352,1564,1522,13,42,"PSOE",636
46,"46162",1168,839,832,3,7,"PSOE",319
28,"28079",2384271,1765443,1753633,13854,11810,"PSOE",463364
45,"45039",201,157,157,0,0,"PSOE",29
3,"3128",4285,2849,2819,18,30,"PSOE",621
37,"37300",540,355,352,7,3,"PSOE",130
44,"44022",464,330,325,1,5,"PSOE",81
29,"29020",3278,2329,2260,22,69,"PSOE",632
34,"34189",53,33,33,0,0,"PSOE",6
23,"23088",6017,4529,4427,61,102,"PSOE",1881
30,"30040",686,564,560,1,4,"PSOE",179
38,"38009",4315,2846,2817,27,29,"PSOE",715
24,"24201",1029,683,676,9,7,"PSOE",212
14,"14005",6298,3905,3828,71,77,"PSOE",1431
50,"50220",45,38,38,0,0,"PSOE",16
2,"2060",1268,953,939,7,14,"PSOE",248
18,"18150",6964,4717,4622,51,95,"PSOE",1596
5,"5235",141,97,97,2,0,"PSOE",33
14,"14006",1319,1088,1057,8,31,"PSOE",347
16,"16258",172,124,119,0,5,"PSOE",49
28,"28115",62612,50619,50431,399,188,"PSOE",8163
45,"45028",3613,2675,2647,22,28,"PSOE",1106
37,"37364",760,502,500,0,2,"PSOE",175
18,"18085",690,440,432,1,8,"PSOE",184
42,"42036",40,33,32,1,1,"PSOE",13
16,"16209",110,95,94,2,1,"PSOE",36
9,"9908",423,254,253,4,1,"PSOE",60
31,"31103",40,28,27,0,1,"PSOE",2
3,"3006",493,365,360,2,5,"PSOE",77
6,"6086",1174,767,750,6,17,"PSOE",340
44,"44023",18,15,14,0,1,"PSOE",1
16,"16275",12,12,12,1,0,"PSOE",3
22,"22228",532,371,364,4,7,"PSOE",90
6,"6088",12527,8326,8198,89,128,"PSOE",2966
34,"34005",786,601,593,3,8,"PSOE",186
6,"6087",1999,1472,1455,13,17,"PSOE",680
26,"26013",330,243,242,2,1,"PSOE",88
11,"11016",15079,9353,9192,137,161,"PSOE",2705
26,"26087",180,123,123,3,0,"PSOE",34
29,"29023",2330,1441,1429,11,12,"PSOE",260
39,"39035",9142,6574,6517,24,57,"PSOE",1465
46,"46096",263,204,202,0,2,"PSOE",62
50,"50148",304,213,211,2,2,"PSOE",90
37,"37208",71,49,49,0,0,"PSOE",12
7,"7011",28971,17082,16964,164,118,"PSOE",4960
5,"5076",468,376,367,1,9,"PSOE",84
41,"41903",6776,4616,4494,72,122,"PSOE",1835
37,"37079",77,59,59,1,0,"PSOE",10
16,"16263",967,724,721,3,3,"PSOE",346
50,"50070",50,30,29,0,1,"PSOE",17
5,"5141",95,79,78,1,1,"PSOE",27
7,"7044",8812,5679,5569,67,110,"PSOE",1122
42,"42175",22,16,16,0,0,"PSOE",0
5,"5142",88,76,75,0,1,"PSOE",16
9,"9014",182,101,101,0,0,"PSOE",34
3,"3122",43774,30060,29834,230,226,"PSOE",8508
46,"46211",1862,1395,1381,12,14,"PSOE",387
37,"37080",221,164,163,1,1,"PSOE",47
31,"31254",1916,1336,1322,9,14,"PSOE",479
37,"37044",431,309,308,3,1,"PSOE",77
16,"16131",123,84,84,0,0,"PSOE",33
4,"4046",849,617,612,6,5,"PSOE",248
26,"26089",111981,80365,79216,893,1149,"PSOE",27475
19,"19075",58,38,37,3,1,"PSOE",7
47,"47118",147,97,97,2,0,"PSOE",33
6,"6091",3669,2581,2525,20,56,"PSOE",1054
47,"47024",223,170,168,1,2,"PSOE",73
14,"14037",3161,2233,2158,22,75,"PSOE",973
34,"34218",437,313,309,3,4,"PSOE",65
44,"44053",103,87,85,1,2,"PSOE",24
22,"22144",255,192,190,2,2,"PSOE",69
10,"10005",527,325,301,1,24,"PSOE",120
9,"9017",89,61,60,3,1,"PSOE",20
30,"30020",6503,4521,4484,35,37,"PSOE",972
9,"9354",34,31,31,2,0,"PSOE",8
45,"45046",2369,1679,1651,11,28,"PSOE",674
49,"49194",331,198,197,0,1,"PSOE",73
44,"44027",144,113,113,2,0,"PSOE",45
28,"28076",432,330,327,4,3,"PSOE",85
26,"26092",104,82,81,3,1,"PSOE",20
5,"5176",221,163,159,0,4,"PSOE",49
5,"5144",65,47,46,1,1,"PSOE",16
3,"3095",4807,3453,3410,31,43,"PSOE",949
12,"12069",50,38,38,0,0,"PSOE",6
16,"16147",54,34,33,0,1,"PSOE",6
31,"31220",742,551,539,6,12,"PSOE",181
6,"6017",250,202,198,0,4,"PSOE",64
46,"46167",342,240,239,0,1,"PSOE",102
16,"16032",284,220,220,1,0,"PSOE",97
19,"19239",93,70,70,1,0,"PSOE",17
40,"40022",195,144,141,2,3,"PSOE",53
24,"24134",3287,2278,2226,18,52,"PSOE",978
19,"19147",42,32,32,0,0,"PSOE",12
26,"26093",48,34,33,0,1,"PSOE",14
9,"9019",146,105,103,4,2,"PSOE",29
33,"33001",1475,758,753,15,5,"PSOE",276
3,"3011",8014,5278,5212,50,66,"PSOE",1551
31,"31038",1343,975,963,16,12,"PSOE",279
44,"44090",66,49,49,0,0,"PSOE",9
45,"45146",101,79,79,0,0,"PSOE",21
49,"49273",165,90,90,0,0,"PSOE",26
42,"42134",2651,1875,1836,21,39,"PSOE",590
9,"9020",233,170,166,3,4,"PSOE",51
16,"16097",139,117,116,0,1,"PSOE",62
46,"46077",7338,5447,5356,44,91,"PSOE",1823
19,"19078",47,37,36,0,1,"PSOE",25
34,"34032",38,30,30,0,0,"PSOE",5
50,"50099",3036,2137,2113,17,24,"PSOE",783
16,"16174",166,130,129,2,1,"PSOE",49
14,"14013",16619,11968,11719,153,249,"PSOE",3628
5,"5147",144,101,99,0,2,"PSOE",14
49,"49200",936,679,670,9,9,"PSOE",231
16,"16022",76,63,63,0,0,"PSOE",23
9,"9068",23,16,16,0,0,"PSOE",9
34,"34210",98,82,82,1,0,"PSOE",23
46,"46055",1298,992,977,9,15,"PSOE",245
12,"12137",40,28,28,0,0,"PSOE",10
28,"28090",9252,7216,7153,58,63,"PSOE",1670
31,"31113",130,77,76,0,1,"PSOE",17
50,"50202",124,76,74,0,2,"PSOE",35
6,"6053",592,441,428,7,13,"PSOE",249
31,"31040",186,131,129,1,2,"PSOE",26
19,"19271",41,22,21,1,1,"PSOE",5
11,"11023",9386,6363,6248,116,115,"PSOE",2751
4,"4096",285,222,222,0,0,"PSOE",88
37,"37228",324,262,262,1,0,"PSOE",105
49,"49094",210,111,111,0,0,"PSOE",48
37,"37216",294,234,227,5,7,"PSOE",68
18,"18127",17005,11790,11583,150,207,"PSOE",4091
40,"40220",64,46,45,0,1,"PSOE",13
24,"24214",626,438,433,8,5,"PSOE",190
28,"28125",3208,2275,2252,5,23,"PSOE",470
35,"35026",83172,48751,48109,449,642,"PSOE",13188
7,"7052",4853,2765,2743,33,22,"PSOE",705
4,"4053",12545,8864,8744,67,120,"PSOE",2713
33,"33005",1357,832,825,11,7,"PSOE",365
12,"12008",228,195,194,1,1,"PSOE",51
19,"19081",27,21,21,0,0,"PSOE",5
31,"31042",2707,1926,1900,11,26,"PSOE",829
10,"10053",279,171,169,1,2,"PSOE",64
50,"50278",175,133,131,2,2,"PSOE",32
47,"47061",237,185,184,0,1,"PSOE",77
35,"35003",5644,2987,2943,20,44,"PSOE",674
37,"37063",58,47,47,0,0,"PSOE",19
24,"24030",4158,2746,2696,18,50,"PSOE",1092
50,"50111",181,130,130,1,0,"PSOE",34
37,"37260",137,110,109,0,1,"PSOE",42
37,"37021",66,45,44,0,1,"PSOE",12
16,"16141",131,98,96,1,2,"PSOE",51
19,"19272",66,55,55,2,0,"PSOE",20
49,"49057",107,74,71,0,3,"PSOE",23
47,"47220",151,106,105,1,1,"PSOE",16
24,"24188",3795,2877,2825,40,52,"PSOE",907
5,"5162",76,47,45,1,2,"PSOE",14
3,"3043",2906,2360,2334,27,26,"PSOE",799
2,"2006",573,425,424,1,1,"PSOE",179
45,"45189",633,462,459,7,3,"PSOE",134
24,"24143",497,344,343,3,1,"PSOE",163
6,"6057",530,409,400,0,9,"PSOE",157
2,"2040",548,476,474,1,2,"PSOE",194
6,"6149",10177,7582,7455,64,127,"PSOE",2595
40,"40060",67,40,40,1,0,"PSOE",2
6,"6103",4756,3285,3224,38,61,"PSOE",1391
47,"47032",147,102,102,0,0,"PSOE",14
16,"16027",691,500,495,1,5,"PSOE",175
31,"31228",496,356,354,1,2,"PSOE",94
24,"24105",1512,1054,1047,10,7,"PSOE",321
2,"2007",1017,757,746,5,11,"PSOE",423
9,"9295",52,36,35,1,1,"PSOE",5
45,"45006",1334,866,858,1,8,"PSOE",367
16,"16065",370,287,287,3,0,"PSOE",94
46,"46127",2748,2035,2009,6,26,"PSOE",626
4,"4056",165,120,120,0,0,"PSOE",22
47,"47002",18,18,18,0,0,"PSOE",6
33,"33008",1679,1140,1133,10,7,"PSOE",466
22,"22907",1463,1016,1006,21,10,"PSOE",318
34,"34025",52,34,34,1,0,"PSOE",5
23,"23905",1828,1320,1302,12,18,"PSOE",491
40,"40031",546,410,406,3,4,"PSOE",120
31,"31155",246,165,161,3,4,"PSOE",71
11,"11028",32829,21934,21654,310,280,"PSOE",8090
29,"29061",1043,803,773,9,30,"PSOE",197
16,"16066",2280,1765,1734,18,31,"PSOE",490
47,"47129",855,660,648,7,12,"PSOE",228
7,"7023",3776,2425,2386,34,39,"PSOE",566
19,"19120",107,86,86,1,0,"PSOE",23
9,"9241",244,171,169,6,2,"PSOE",42
46,"46196",134,111,110,0,1,"PSOE",28
16,"16157",183,150,148,0,2,"PSOE",53
37,"37233",53,39,39,1,0,"PSOE",17
42,"42206",8,5,5,2,0,"PSOE",0
6,"6107",1555,980,969,8,11,"PSOE",509
28,"28130",28569,22050,21799,187,251,"PSOE",7103
5,"5155",46,33,31,1,2,"PSOE",11
39,"39028",3892,2905,2878,20,27,"PSOE",462
31,"31023",7778,5977,5948,106,29,"PSOE",1245
31,"31011",715,483,481,5,2,"PSOE",78
40,"40194",39173,28641,28260,353,381,"PSOE",8930
22,"22084",571,400,391,5,9,"PSOE",128
31,"31085",500,365,362,2,3,"PSOE",55
18,"18101",9449,6688,6568,77,120,"PSOE",1900
38,"38047",1755,1132,1110,9,22,"PSOE",290
46,"46129",511,389,379,9,10,"PSOE",136
41,"41082",3354,2545,2507,11,38,"PSOE",1282
5,"5012",117,88,88,1,0,"PSOE",17
13,"13043",205,163,162,1,1,"PSOE",54
45,"45034",1290,968,948,7,20,"PSOE",329
28,"28163",429,332,326,0,6,"PSOE",106
22,"22175",184,129,128,0,1,"PSOE",44
47,"47036",204,159,156,1,3,"PSOE",49
40,"40195",776,573,565,4,8,"PSOE",162
23,"23071",1704,1278,1258,10,20,"PSOE",485
19,"19248",73,54,54,0,0,"PSOE",20
49,"49173",335,165,163,4,2,"PSOE",52
42,"42057",145,70,70,0,0,"PSOE",15
24,"24223",2533,1727,1705,40,22,"PSOE",541
9,"9192",54,46,45,1,1,"PSOE",14
40,"40100",262,208,204,4,4,"PSOE",59
31,"31123",615,350,347,4,3,"PSOE",57
18,"18007",730,490,478,3,12,"PSOE",243
46,"46107",1857,1421,1402,4,19,"PSOE",489
50,"50032",243,167,164,3,3,"PSOE",63
45,"45048",360,276,271,2,5,"PSOE",100
23,"23072",1879,1389,1363,3,26,"PSOE",586
40,"40034",74,59,58,0,1,"PSOE",13
19,"19290",851,551,550,4,1,"PSOE",154
9,"9339",128,106,105,0,1,"PSOE",27
16,"16149",147,105,105,2,0,"PSOE",48
4,"4061",625,489,479,5,10,"PSOE",211
18,"18906",903,641,639,2,2,"PSOE",236
40,"40035",135,110,110,2,0,"PSOE",26
22,"22055",305,242,235,2,7,"PSOE",87
16,"16902",124,86,86,1,0,"PSOE",43
5,"5093",362,251,249,0,2,"PSOE",39
6,"6157",389,277,271,1,6,"PSOE",132
44,"44246",1599,1012,1001,11,11,"PSOE",319
49,"49174",127,86,85,1,1,"PSOE",23
9,"9248",80,62,61,1,1,"PSOE",18
33,"33012",5085,3158,3142,27,16,"PSOE",964
19,"19054",161,136,135,3,1,"PSOE",48
5,"5126",60,47,45,0,2,"PSOE",11
29,"29084",27199,18102,17800,268,302,"PSOE",5446
16,"16073",190,153,153,1,0,"PSOE",70
44,"44228",96,75,74,0,1,"PSOE",13
41,"41085",4182,3258,3181,43,77,"PSOE",1146
31,"31053",509,354,350,4,4,"PSOE",108
9,"9416",52,30,30,0,0,"PSOE",6
9,"9249",47,35,35,3,0,"PSOE",13
49,"49219",7196,4613,4528,64,85,"PSOE",1503
39,"39051",73,64,64,1,0,"PSOE",9
5,"5258",107,80,80,1,0,"PSOE",20
28,"28135",998,712,703,2,9,"PSOE",152
2,"2015",1432,1163,1148,8,15,"PSOE",408
5,"5062",163,121,119,3,2,"PSOE",9
18,"18106",413,270,261,3,9,"PSOE",115
45,"45053",7820,5814,5712,56,102,"PSOE",2205
22,"22058",193,141,141,0,0,"PSOE",56
40,"40200",38,28,28,0,0,"PSOE",18
33,"33014",8735,5744,5689,67,55,"PSOE",1972
19,"19252",56,44,44,0,0,"PSOE",9
40,"40168",27,20,20,0,0,"PSOE",3
4,"4097",231,173,173,1,0,"PSOE",77
45,"45101",3671,2842,2808,13,34,"PSOE",728
13,"13051",336,253,249,1,4,"PSOE",97
13,"13066",2621,2029,1998,12,31,"PSOE",777
44,"44262",141,104,103,0,1,"PSOE",12
6,"6116",1500,1015,998,7,17,"PSOE",485
40,"40039",180,133,133,0,0,"PSOE",29
42,"42063",45,31,30,1,1,"PSOE",14
31,"31056",186,128,124,2,4,"PSOE",24
19,"19097",14,14,13,0,1,"PSOE",3
29,"29022",177,137,136,1,1,"PSOE",67
42,"42012",29,22,22,0,0,"PSOE",7
46,"46179",2136,1624,1596,17,28,"PSOE",484
6,"6901",2125,1549,1520,28,29,"PSOE",616
3,"3140",26036,18637,18267,237,370,"PSOE",5420
23,"23006",4582,3536,3461,43,75,"PSOE",2020
37,"37323",474,335,325,5,10,"PSOE",72
41,"41023",7999,5500,5435,60,65,"PSOE",2368
34,"34230",16,11,11,0,0,"PSOE",1
37,"37136",625,388,387,7,1,"PSOE",150
10,"10029",380,284,276,0,8,"PSOE",158
41,"41079",9285,6591,6446,101,145,"PSOE",2904
49,"49179",337,210,209,3,1,"PSOE",56
50,"50902",77,65,62,0,3,"PSOE",15
44,"44043",86,60,60,0,0,"PSOE",16
44,"44251",239,187,183,1,4,"PSOE",33
28,"28107",442,316,310,5,6,"PSOE",122
9,"9422",19,13,13,0,0,"PSOE",0
44,"44135",99,73,73,1,0,"PSOE",18
3,"3901",1137,783,776,9,7,"PSOE",203
45,"45165",62598,43750,43259,329,491,"PSOE",13645
49,"49180",135,82,81,5,1,"PSOE",16
44,"44252",73,56,55,0,1,"PSOE",15
31,"31021",59,42,42,1,0,"PSOE",9
28,"28108",3736,2681,2652,21,29,"PSOE",592
9,"9046",23,17,17,0,0,"PSOE",5
29,"29042",14586,9793,9649,95,144,"PSOE",2399
50,"50903",2268,1685,1670,16,15,"PSOE",433
45,"45166",1575,1231,1210,5,21,"PSOE",570
12,"12076",72,54,54,0,0,"PSOE",15
9,"9424",31,24,23,0,1,"PSOE",5
50,"50038",1404,1024,1007,15,17,"PSOE",411
5,"5195",199,125,125,1,0,"PSOE",38
2,"2020",425,336,332,4,4,"PSOE",147
40,"40172",47,33,32,0,1,"PSOE",10
6,"6031",462,285,280,2,5,"PSOE",116
18,"18109",597,430,422,5,8,"PSOE",164
46,"46143",4274,3027,2995,19,32,"PSOE",776
46,"46166",8214,6093,6031,38,62,"PSOE",1497
47,"47086",3818,2835,2784,36,51,"PSOE",1009
44,"44167",34,26,26,0,0,"PSOE",6
16,"16043",88,60,60,3,0,"PSOE",13
46,"46022",15392,10624,10546,69,78,"PSOE",3301
26,"26053",191,144,140,2,4,"PSOE",57
10,"10018",1605,974,948,16,26,"PSOE",427
9,"9485",55,41,41,0,0,"PSOE",3
45,"45047",2694,1733,1706,24,27,"PSOE",345
31,"31060",14323,9547,9434,79,113,"PSOE",2544
5,"5208",39,32,32,0,0,"PSOE",13
40,"40142",52,39,37,0,2,"PSOE",11
4,"4033",121,78,77,3,1,"PSOE",40
49,"49225",122,68,68,0,0,"PSOE",16
50,"50023",199,145,143,2,2,"PSOE",40
42,"42098",8,7,7,0,0,"PSOE",3
46,"46053",525,433,428,2,5,"PSOE",159
9,"9033",80,64,63,1,1,"PSOE",18
12,"12059",220,183,183,2,0,"PSOE",60
18,"18167",1839,1243,1224,9,19,"PSOE",521
34,"34046",43,29,29,0,0,"PSOE",15
18,"18017",18201,11500,11358,94,142,"PSOE",3133
16,"16159",198,135,135,2,0,"PSOE",53
13,"13014",472,361,352,4,9,"PSOE",163
2,"2022",341,243,243,2,0,"PSOE",69
12,"12103",87,61,60,0,1,"PSOE",11
37,"37235",214,163,159,2,4,"PSOE",38
3,"3030",559,442,433,2,9,"PSOE",135
10,"10158",344,247,246,7,1,"PSOE",140
9,"9155",25,23,23,0,0,"PSOE",6
34,"34185",69,36,35,0,1,"PSOE",6
46,"46115",330,219,213,0,6,"PSOE",45
6,"6034",171,114,114,2,0,"PSOE",39
9,"9903",3112,2087,2058,24,29,"PSOE",626
46,"46092",262,176,174,2,2,"PSOE",35
22,"22136",749,524,518,5,6,"PSOE",195
37,"37276",125,92,92,0,0,"PSOE",12
18,"18114",585,425,424,7,1,"PSOE",186
16,"16270",154,123,122,1,1,"PSOE",27
41,"41065",22527,14684,14463,205,221,"PSOE",6625
9,"9103",200,168,166,1,2,"PSOE",63
44,"44047",225,103,103,0,0,"PSOE",36
44,"44142",29,21,21,0,0,"PSOE",7
37,"37007",391,289,281,7,8,"PSOE",90
50,"50017",1773,1283,1265,13,18,"PSOE",316
28,"28176",13980,10765,10701,72,64,"PSOE",1687
39,"39087",41241,29341,29084,152,257,"PSOE",8249
21,"21055",7326,5395,5309,43,86,"PSOE",1264
16,"16047",214,154,148,3,6,"PSOE",35
24,"24017",532,375,374,1,1,"PSOE",107
26,"26009",394,282,278,1,4,"PSOE",86
47,"47207",256,198,195,3,3,"PSOE",41
5,"5267",103,67,67,1,0,"PSOE",16
3,"3118",2446,1617,1598,8,19,"PSOE",397
37,"37038",756,531,517,4,14,"PSOE",181
37,"37342",250,190,189,3,1,"PSOE",42
21,"21066",490,394,389,4,5,"PSOE",257
22,"22903",618,484,482,5,2,"PSOE",179
19,"19200",66,53,52,0,1,"PSOE",20
46,"46185",361,301,299,5,2,"PSOE",86
16,"16048",404,300,298,2,2,"PSOE",105
3,"3041",6132,4204,4167,22,37,"PSOE",1034
11,"11902",3664,2123,2094,46,29,"PSOE",833
24,"24018",172,129,128,0,1,"PSOE",20
37,"37051",79,58,58,0,0,"PSOE",20
31,"31029",913,606,601,14,5,"PSOE",156
22,"22068",64,41,41,1,0,"PSOE",10
50,"50245",74,51,51,0,0,"PSOE",16
34,"34141",176,149,146,0,3,"PSOE",44
28,"28040",16741,10717,10604,79,113,"PSOE",2907
33,"33024",224741,151660,150461,1597,1199,"PSOE",49797
37,"37040",376,291,288,0,3,"PSOE",109
31,"31066",819,577,559,4,18,"PSOE",202
44,"44049",784,539,532,3,7,"PSOE",182
5,"5213",94,72,70,0,2,"PSOE",14
42,"42124",56,27,27,0,0,"PSOE",11
42,"42108",10,7,7,0,0,"PSOE",0
49,"49255",387,304,298,3,6,"PSOE",63
5,"5139",71,59,58,1,1,"PSOE",2
34,"34096",48,39,38,0,1,"PSOE",16
9,"9166",96,77,77,0,0,"PSOE",12
5,"5075",96,76,76,0,0,"PSOE",21
37,"37313",535,395,394,1,1,"PSOE",103
46,"46217",900,672,667,7,5,"PSOE",209
50,"50011",117,90,89,3,1,"PSOE",42
16,"16026",91,69,68,0,1,"PSOE",22
9,"9219",27097,17874,17629,192,245,"PSOE",7229
46,"46233",3766,2688,2650,14,38,"PSOE",726
9,"9167",53,36,36,0,0,"PSOE",4
44,"44116",75,58,58,0,0,"PSOE",6
24,"24129",114,79,78,2,1,"PSOE",25
50,"50173",156,114,114,0,0,"PSOE",32
21,"21058",2567,1806,1766,32,40,"PSOE",1066
31,"31178",476,323,320,7,3,"PSOE",130
34,"34199",1150,767,754,14,13,"PSOE",286
46,"46187",1292,924,920,4,4,"PSOE",245
44,"44145",974,698,697,3,1,"PSOE",197
37,"37011",100,78,78,3,0,"PSOE",27
29,"29068",7833,4897,4806,50,91,"PSOE",1256
47,"47052",6781,5213,5156,50,57,"PSOE",1513
50,"50121",270,209,208,3,1,"PSOE",90
19,"19073",16,15,15,1,0,"PSOE",4
50,"50198",47,32,32,0,0,"PSOE",12
10,"10206",196,135,133,0,2,"PSOE",58
46,"46188",693,565,560,2,5,"PSOE",123
49,"49192",123,93,90,2,3,"PSOE",40
6,"6135",1101,860,849,2,11,"PSOE",291
4,"4008",466,374,371,3,3,"PSOE",113
19,"19074",67,57,57,1,0,"PSOE",24
7,"7046",16884,9184,9097,97,87,"PSOE",2752
50,"50149",34,25,25,0,0,"PSOE",4
2,"2064",371,288,283,2,5,"PSOE",131
49,"49013",219,160,159,0,1,"PSOE",61
46,"46120",1179,903,880,5,23,"PSOE",269
31,"31034",31,24,24,0,0,"PSOE",1
10,"10167",301,198,198,0,0,"PSOE",92
31,"31071",13,11,11,0,0,"PSOE",6
21,"21060",12287,7761,7638,134,123,"PSOE",2324
5,"5078",95,78,78,2,0,"PSOE",10
9,"9258",165,128,127,0,1,"PSOE",37
12,"12101",354,274,270,5,4,"PSOE",75
30,"30036",15432,10030,9879,64,151,"PSOE",1960
45,"45070",1412,1158,1136,7,22,"PSOE",404
45,"45181",2330,1693,1661,10,32,"PSOE",609
42,"42130",51,42,40,1,2,"PSOE",3
37,"37316",711,546,541,7,5,"PSOE",122
37,"37180",68,45,44,1,1,"PSOE",18
34,"34028",132,95,92,2,3,"PSOE",21
5,"5066",435,344,341,2,3,"PSOE",139
10,"10169",497,370,366,0,4,"PSOE",144
16,"16237",98,82,82,1,0,"PSOE",22
34,"34205",55,38,38,0,0,"PSOE",10
45,"45144",736,562,557,1,5,"PSOE",241
37,"37046",10648,7396,7241,62,155,"PSOE",2149
10,"10020",1571,1135,1117,2,18,"PSOE",573
12,"12135",36287,25912,25655,184,257,"PSOE",7273
24,"24149",149,123,123,0,0,"PSOE",33
14,"14067",3842,2863,2800,42,63,"PSOE",916
18,"18135",4385,2882,2798,24,84,"PSOE",1319
31,"31157",3447,2182,2160,29,22,"PSOE",717
41,"41017",15907,11486,11302,158,184,"PSOE",3239
13,"13074",943,759,749,5,10,"PSOE",315
4,"4011",2744,2010,1984,20,26,"PSOE",887
49,"49016",230,155,155,0,0,"PSOE",55
26,"26132",106,73,70,2,3,"PSOE",22
22,"22188",75,50,50,1,0,"PSOE",18
47,"47057",272,200,199,0,1,"PSOE",29
38,"38039",11149,7375,7326,68,49,"PSOE",1579
19,"19301",37,26,26,0,0,"PSOE",5
42,"42181",384,281,278,3,3,"PSOE",156
16,"16134",4368,3143,3102,22,41,"PSOE",974
12,"12136",2603,2151,2119,20,32,"PSOE",556
24,"24099",153,111,110,1,1,"PSOE",43
4,"4012",184,151,150,3,1,"PSOE",62
6,"6095",9506,6616,6425,109,191,"PSOE",2939
31,"31026",130,108,107,0,1,"PSOE",46
28,"28122",578,404,401,1,3,"PSOE",110
33,"33020",12981,8550,8453,120,97,"PSOE",3258
2,"2046",1125,892,870,12,22,"PSOE",247
6,"6096",206,158,153,0,5,"PSOE",48
5,"5179",199,176,172,1,4,"PSOE",18
19,"19008",36,30,30,0,0,"PSOE",5
4,"4013",143819,93083,92383,893,700,"PSOE",26715
44,"44002",47,41,41,0,0,"PSOE",18
3,"3127",350,260,255,1,5,"PSOE",89
24,"24064",1501,1030,1012,2,18,"PSOE",443
10,"10050",987,707,704,4,3,"PSOE",280
49,"49175",204,136,135,3,1,"PSOE",40
24,"24199",398,263,256,4,7,"PSOE",85
37,"37184",289,178,177,1,1,"PSOE",51
10,"10133",1159,914,893,4,21,"PSOE",622
31,"31004",31,22,22,1,0,"PSOE",3
46,"46124",786,638,625,1,13,"PSOE",147
31,"31236",1319,815,808,8,7,"PSOE",108
19,"19251",39,30,30,0,0,"PSOE",9
9,"9085",481,349,342,2,7,"PSOE",125
4,"4052",12882,8400,8322,93,78,"PSOE",2222
40,"40058",306,244,240,1,4,"PSOE",48
22,"22155",66,52,52,0,0,"PSOE",13
34,"34034",112,82,82,1,0,"PSOE",28
44,"44003",17,15,15,0,0,"PSOE",2
6,"6008",615,522,507,2,15,"PSOE",304
28,"28167",8640,6564,6504,51,60,"PSOE",1913
30,"30024",60389,42200,41831,281,369,"PSOE",11765
9,"9231",57,35,35,2,0,"PSOE",11
49,"49203",280,218,212,1,6,"PSOE",53
37,"37088",199,135,133,0,2,"PSOE",50
9,"9071",39,29,29,1,0,"PSOE",5
12,"12090",102,79,78,1,1,"PSOE",10
23,"23064",1669,1311,1296,9,15,"PSOE",577
9,"9403",103,79,78,1,1,"PSOE",18
7,"7020",3707,2522,2493,40,29,"PSOE",541
9,"9088",63,31,30,0,1,"PSOE",12
19,"19070",65,45,45,0,0,"PSOE",18
42,"42215",723,468,452,10,16,"PSOE",150
12,"12026",828,577,566,11,11,"PSOE",163
9,"9434",1279,966,956,11,10,"PSOE",288
37,"37124",195,137,137,2,0,"PSOE",47
14,"14015",2045,1465,1418,16,47,"PSOE",490
31,"31152",1255,826,817,8,9,"PSOE",251
37,"37354",5479,3969,3905,37,64,"PSOE",1069
9,"9253",101,77,76,0,1,"PSOE",24
31,"31140",112,73,73,1,0,"PSOE",16
24,"24216",666,453,445,4,8,"PSOE",112
46,"46081",9999,7486,7412,47,74,"PSOE",1907
24,"24068",430,289,281,0,8,"PSOE",155
31,"31227",8118,5691,5636,65,55,"PSOE",1539
24,"24177",467,265,263,2,2,"PSOE",71
50,"50104",320,251,251,1,0,"PSOE",101
33,"33062",385,194,187,4,7,"PSOE",109
6,"6148",957,682,665,1,17,"PSOE",329
28,"28160",8709,6507,6460,62,47,"PSOE",1422
47,"47158",859,618,608,4,10,"PSOE",269
34,"34068",29,25,24,0,1,"PSOE",3
9,"9074",844,610,609,12,1,"PSOE",158
37,"37022",242,191,190,0,1,"PSOE",32
7,"7022",11659,7045,6965,84,80,"PSOE",1660
40,"40192",134,106,105,1,1,"PSOE",34
9,"9027",47,38,34,1,4,"PSOE",14
46,"46013",17761,13652,13548,144,104,"PSOE",3307
4,"4018",245,202,197,2,5,"PSOE",91
10,"10152",444,312,309,2,3,"PSOE",149
2,"2041",316,238,236,0,2,"PSOE",73
9,"9075",104,82,82,0,0,"PSOE",17
40,"40061",63,47,44,0,3,"PSOE",8
44,"44241",500,361,357,0,4,"PSOE",97
19,"19307",25,23,23,0,0,"PSOE",4
44,"44063",63,52,52,0,0,"PSOE",10
4,"4090",298,229,225,1,4,"PSOE",105
3,"3045",216,176,172,1,4,"PSOE",51
42,"42096",244,132,129,2,3,"PSOE",31
23,"23069",5240,4153,4065,26,88,"PSOE",1650
45,"45008",144,112,110,1,2,"PSOE",55
28,"28096",20022,14440,14238,115,202,"PSOE",3571
34,"34070",131,98,96,0,2,"PSOE",38
10,"10058",979,628,599,6,29,"PSOE",264
39,"39017",550,378,372,1,6,"PSOE",39
37,"37347",463,349,345,9,4,"PSOE",92
26,"26052",146,106,105,0,1,"PSOE",27
9,"9334",51,36,34,1,2,"PSOE",12
49,"49193",428,261,253,3,8,"PSOE",66
28,"28004",6618,4502,4457,28,45,"PSOE",1122
42,"42028",75,57,56,0,1,"PSOE",21
9,"9189",123,83,78,0,5,"PSOE",24
19,"19257",3279,2233,2206,21,27,"PSOE",675
40,"40173",140,120,118,2,2,"PSOE",29
13,"13904",496,353,342,5,11,"PSOE",121
21,"21041",113074,73295,72313,1063,982,"PSOE",23158
6,"6108",2238,1524,1478,15,46,"PSOE",659
46,"46068",345,283,279,2,4,"PSOE",89
37,"37096",203,144,144,2,0,"PSOE",32
47,"47162",70,57,57,2,0,"PSOE",6
31,"31012",763,550,542,7,8,"PSOE",208
34,"34181",422,289,285,0,4,"PSOE",146
23,"23035",1111,877,856,2,21,"PSOE",378
22,"22149",301,211,210,1,1,"PSOE",77
23,"23096",2543,2029,1986,16,43,"PSOE",1163
5,"5046",38,35,35,0,0,"PSOE",13
47,"47172",135,114,113,0,1,"PSOE",35
3,"3057",174,138,136,0,2,"PSOE",31
37,"37318",196,132,132,0,0,"PSOE",29
46,"46061",351,276,272,6,4,"PSOE",60
44,"44009",798,593,589,4,4,"PSOE",187
49,"49209",451,274,269,7,5,"PSOE",66
9,"9082",36,32,32,0,0,"PSOE",1
12,"12013",135,106,106,1,0,"PSOE",32
35,"35031",7456,4938,4868,39,70,"PSOE",1058
46,"46108",420,328,324,1,4,"PSOE",130
5,"5092",145,111,107,1,4,"PSOE",20
40,"40196",30,24,24,0,0,"PSOE",3
9,"9303",73,58,58,0,0,"PSOE",10
2,"2023",504,419,412,0,7,"PSOE",165
18,"18018",542,384,377,2,7,"PSOE",190
45,"45109",2791,2123,2072,20,51,"PSOE",644
37,"37236",123,85,82,1,3,"PSOE",24
46,"46221",348,292,290,1,2,"PSOE",83
45,"45170",194,146,140,0,6,"PSOE",34
39,"39077",237,151,148,1,3,"PSOE",34
19,"19019",14,11,11,1,0,"PSOE",2
18,"18137",968,733,731,3,2,"PSOE",252
47,"47164",349,283,281,1,2,"PSOE",98
11,"11002",4218,3176,3149,16,27,"PSOE",1483
47,"47133",2776,2096,2073,28,23,"PSOE",571
37,"37193",362,253,252,4,1,"PSOE",94
19,"19230",558,409,406,1,3,"PSOE",103
19,"19135",90,71,69,1,2,"PSOE",17
49,"49264",529,334,329,2,5,"PSOE",88
37,"37173",1412,951,937,15,14,"PSOE",322
12,"12071",1272,936,925,3,11,"PSOE",308
19,"19314",44,33,33,0,0,"PSOE",7
29,"29019",853,604,588,2,16,"PSOE",141
3,"3050",19420,13210,13116,70,94,"PSOE",3388
2,"2058",300,186,177,1,9,"PSOE",100
37,"37174",975,716,705,2,11,"PSOE",252
4,"4003",17583,11062,10941,77,121,"PSOE",2831
21,"21076",2153,1459,1426,31,33,"PSOE",767
31,"31016",7790,5541,5502,56,39,"PSOE",1663
49,"49067",329,200,198,4,2,"PSOE",62
18,"18126",1436,1024,1002,9,22,"PSOE",442
29,"29066",357,248,246,1,2,"PSOE",89
41,"41076",2134,1246,1230,11,16,"PSOE",616
31,"31114",388,272,271,3,1,"PSOE",58
2,"2048",1173,912,901,9,11,"PSOE",342
9,"9418",73,54,51,0,3,"PSOE",7
4,"4028",207,175,171,1,4,"PSOE",97
16,"16193",55,50,49,0,1,"PSOE",28
24,"24079",861,601,595,9,6,"PSOE",146
45,"45161",15469,10281,10167,68,114,"PSOE",2571
12,"12044",442,371,368,1,3,"PSOE",160
40,"40179",620,500,490,3,10,"PSOE",158
9,"9198",100,75,74,2,1,"PSOE",23
50,"50043",241,155,154,1,1,"PSOE",49
19,"19243",34,32,31,1,1,"PSOE",9
19,"19107",306,245,244,0,1,"PSOE",89
19,"19223",99,66,65,1,1,"PSOE",26
3,"3052",959,747,735,4,12,"PSOE",179
16,"16074",30,25,25,0,0,"PSOE",10
9,"9251",362,258,256,3,2,"PSOE",57
33,"33071",546,385,383,7,2,"PSOE",230
10,"10162",519,401,394,4,7,"PSOE",249
37,"37102",375,260,260,4,0,"PSOE",83
42,"42050",27,17,17,0,0,"PSOE",0
16,"16115",49,32,32,0,0,"PSOE",16
9,"9199",91,68,68,0,0,"PSOE",13
44,"44042",114,82,81,0,1,"PSOE",18
34,"34037",301,206,204,1,2,"PSOE",30
44,"44133",15,12,12,0,0,"PSOE",1
4,"4065",365,273,271,1,2,"PSOE",141
38,"38027",5581,3577,3533,22,44,"PSOE",839
7,"7032",21005,12039,11928,114,111,"PSOE",3383
40,"40171",40,32,32,1,0,"PSOE",6
40,"40073",387,327,323,1,4,"PSOE",92
46,"46134",2419,1697,1678,14,19,"PSOE",475
49,"49222",369,250,247,2,3,"PSOE",132
50,"50113",587,471,461,2,10,"PSOE",237
44,"44164",19,16,16,1,0,"PSOE",3
4,"4030",1052,690,678,6,12,"PSOE",301
45,"45056",2341,1315,1295,11,20,"PSOE",389
13,"13008",422,280,272,2,8,"PSOE",99
3,"3026",1331,987,975,7,12,"PSOE",294
42,"42038",33,22,22,1,0,"PSOE",1
5,"5194",132,105,104,1,1,"PSOE",39
23,"23045",2054,1423,1412,10,11,"PSOE",533
37,"37198",202,147,144,2,3,"PSOE",61
49,"49076",330,230,226,9,4,"PSOE",64
19,"19098",20,17,17,0,0,"PSOE",12
13,"13902",449,329,326,4,3,"PSOE",131
49,"49035",220,180,180,4,0,"PSOE",63
19,"19166",154,110,108,0,2,"PSOE",31
46,"46158",1047,771,763,7,8,"PSOE",250
23,"23008",1422,1042,1020,9,22,"PSOE",558
2,"2086",2389,1567,1554,10,13,"PSOE",752
31,"31131",913,672,664,8,8,"PSOE",98
37,"37034",77,63,62,0,1,"PSOE",15
38,"38053",3768,2275,2244,16,31,"PSOE",674
5,"5165",361,266,261,4,5,"PSOE",76
6,"6121",3276,2301,2256,30,45,"PSOE",812
46,"46181",16967,11951,11835,98,116,"PSOE",3149
3,"3113",4339,2978,2935,23,43,"PSOE",964
42,"42068",77,58,57,0,1,"PSOE",10
34,"34057",464,308,302,4,6,"PSOE",79
42,"42003",65,49,47,0,2,"PSOE",10
40,"40204",145,102,101,0,1,"PSOE",25
31,"31108",1819,1348,1325,13,23,"PSOE",466
26,"26129",939,657,644,2,13,"PSOE",221
34,"34167",110,84,83,0,1,"PSOE",14
40,"40053",79,56,56,1,0,"PSOE",21
46,"46242",326,260,257,3,3,"PSOE",45
19,"19247",140,103,102,1,1,"PSOE",42
19,"19112",53,35,34,0,1,"PSOE",8
45,"45059",1702,1315,1303,1,12,"PSOE",311
31,"31170",44,31,30,2,1,"PSOE",9
29,"29100",2379,1582,1551,22,31,"PSOE",790
29,"29053",1717,1133,1116,12,17,"PSOE",300
42,"42178",99,71,71,0,0,"PSOE",12
21,"21062",1403,849,838,10,11,"PSOE",321
26,"26145",239,194,187,3,7,"PSOE",50
16,"16279",173,109,108,0,1,"PSOE",22
45,"45194",64,45,44,1,1,"PSOE",18
37,"37349",100,61,58,0,3,"PSOE",11
10,"10075",238,150,148,0,2,"PSOE",67
18,"18047",6103,3992,3922,61,70,"PSOE",1219
44,"44168",181,119,117,1,2,"PSOE",24
26,"26079",633,503,499,2,4,"PSOE",124
24,"24160",633,404,403,2,1,"PSOE",109
37,"37072",144,121,118,5,3,"PSOE",22
45,"45097",1037,834,819,7,15,"PSOE",319
42,"42119",141,78,78,1,0,"PSOE",10
41,"41027",4007,2628,2546,33,82,"PSOE",970
49,"49227",317,245,244,4,1,"PSOE",77
44,"44020",22,21,21,0,0,"PSOE",3
6,"6049",956,625,604,8,21,"PSOE",241
5,"5241",3062,2011,1977,21,34,"PSOE",499
10,"10198",1053,897,889,4,8,"PSOE",339
2,"2045",3609,2797,2752,38,45,"PSOE",921
26,"26161",8,8,8,0,0,"PSOE",2
26,"26107",86,65,64,1,1,"PSOE",21
10,"10105",2442,1541,1515,11,26,"PSOE",540
14,"14040",3749,2905,2845,53,60,"PSOE",696
49,"49006",139,98,95,3,3,"PSOE",31
22,"22037",112,87,87,2,0,"PSOE",8
31,"31039",92,70,69,1,1,"PSOE",14
11,"11012",97338,67120,66466,861,654,"PSOE",19311
18,"18180",636,410,401,2,9,"PSOE",191
47,"47154",146,115,111,6,4,"PSOE",23
24,"24137",1043,700,691,8,9,"PSOE",312
16,"16204",237,179,177,1,2,"PSOE",60
4,"4002",1013,711,699,1,12,"PSOE",349
31,"31028",215,121,121,2,0,"PSOE",13
31,"31027",811,527,521,1,6,"PSOE",30
26,"26109",73,68,68,0,0,"PSOE",32
19,"19231",10,6,6,0,0,"PSOE",0
19,"19150",116,89,89,0,0,"PSOE",28
3,"3069",3329,2102,2077,11,25,"PSOE",518
22,"22226",761,537,530,13,7,"PSOE",215
4,"4085",360,291,289,0,2,"PSOE",119
50,"50101",833,557,550,5,7,"PSOE",207
18,"18149",5408,3926,3859,42,67,"PSOE",1062
10,"10187",431,288,281,0,7,"PSOE",135
12,"12138",19207,13018,12891,87,127,"PSOE",3870
47,"47124",383,302,300,3,2,"PSOE",85
44,"44247",291,207,206,4,1,"PSOE",85
45,"45002",2619,1676,1663,14,13,"PSOE",572
37,"37279",713,488,480,4,8,"PSOE",141
46,"46140",383,321,321,2,0,"PSOE",69
49,"49009",382,251,251,0,0,"PSOE",61
39,"39089",131,82,82,0,0,"PSOE",12
44,"44261",713,553,549,3,4,"PSOE",203
37,"37175",412,298,293,4,5,"PSOE",72
12,"12063",41,31,31,1,0,"PSOE",10
33,"33052",681,418,416,3,2,"PSOE",205
4,"4016",2136,1486,1467,13,19,"PSOE",466
3,"3090",18095,12539,12412,75,127,"PSOE",3373
37,"37374",1138,889,872,2,17,"PSOE",303
50,"50171",99,69,69,2,0,"PSOE",17
28,"28071",63,46,45,0,1,"PSOE",7
28,"28082",6110,4622,4581,41,41,"PSOE",1022
49,"49231",288,208,203,0,5,"PSOE",57
30,"30041",14040,8999,8876,94,123,"PSOE",2467
40,"40016",55,44,43,1,1,"PSOE",5
5,"5128",339,258,253,5,5,"PSOE",93
37,"37020",431,320,314,3,6,"PSOE",86
29,"29076",2354,1498,1444,21,54,"PSOE",504
35,"35004",41975,20773,20602,156,171,"PSOE",6835
45,"45115",2602,2013,1969,12,44,"PSOE",639
31,"31141",106,66,61,1,5,"PSOE",7
49,"49155",81,60,59,0,1,"PSOE",14
45,"45029",186,154,154,2,0,"PSOE",79
42,"42127",37,26,26,1,0,"PSOE",7
37,"37177",259,198,197,3,1,"PSOE",50
18,"18053",1554,1001,985,9,16,"PSOE",447
19,"19142",263,179,179,1,0,"PSOE",69
45,"45104",419,328,324,1,4,"PSOE",145
5,"5005",165,127,119,0,8,"PSOE",27
19,"19297",32,28,28,0,0,"PSOE",5
41,"41004",57692,38578,37814,696,764,"PSOE",12680
12,"12028",13004,9801,9732,74,69,"PSOE",2151
9,"9454",41,34,33,1,1,"PSOE",10
13,"13069",613,438,419,2,19,"PSOE",196
37,"37067",3278,2568,2529,30,39,"PSOE",779
9,"9013",42,32,32,0,0,"PSOE",5
11,"11017",3198,2054,2004,37,50,"PSOE",945
26,"26051",213,165,165,1,0,"PSOE",42
19,"19332",85,59,57,4,2,"PSOE",8
37,"37304",156,97,96,1,1,"PSOE",26
10,"10166",307,197,195,0,2,"PSOE",62
16,"16093",54,45,45,0,0,"PSOE",15
34,"34099",53,44,42,0,2,"PSOE",7
44,"44117",327,258,258,0,0,"PSOE",97
39,"39036",965,707,703,4,4,"PSOE",158
22,"22043",93,53,53,0,0,"PSOE",19
3,"3064",5015,3514,3461,15,53,"PSOE",949
35,"35021",15072,9791,9696,80,95,"PSOE",2512
11,"11018",1434,1001,977,8,24,"PSOE",402
28,"28074",141137,106626,105602,885,1024,"PSOE",36821
45,"45106",7418,5380,5306,34,74,"PSOE",1906
10,"10003",543,350,335,0,15,"PSOE",118
24,"24096",105,56,54,1,2,"PSOE",22
6,"6030",168,131,128,1,3,"PSOE",50
45,"45020",1240,905,900,5,5,"PSOE",306
37,"37200",190,132,131,0,1,"PSOE",49
23,"23057",727,582,572,7,10,"PSOE",259
50,"50191",446,327,326,1,1,"PSOE",107
10,"10194",524,408,404,2,4,"PSOE",146
37,"37148",399,295,291,0,4,"PSOE",60
21,"21050",12567,8522,8392,89,130,"PSOE",3075
33,"33075",244,125,122,3,3,"PSOE",61
46,"46227",893,687,675,6,12,"PSOE",253
45,"45156",3334,2561,2502,23,59,"PSOE",917
5,"5240",3346,2259,2232,11,27,"PSOE",603
45,"45071",1779,1374,1342,7,32,"PSOE",574
46,"46106",1471,1033,1028,8,5,"PSOE",317
10,"10182",122,81,81,0,0,"PSOE",31
3,"3019",15501,11261,11106,86,155,"PSOE",3157
26,"26017",364,274,269,2,5,"PSOE",137
49,"49050",498,305,305,2,0,"PSOE",66
44,"44234",71,49,49,0,0,"PSOE",11
44,"44065",55,33,32,0,1,"PSOE",2
19,"19310",7,7,7,0,0,"PSOE",4
9,"9302",96,66,66,0,0,"PSOE",16
31,"31086",13781,10133,10054,114,79,"PSOE",1967
46,"46168",2004,1463,1447,12,16,"PSOE",462
34,"34206",810,608,602,5,6,"PSOE",234
37,"37181",265,158,158,0,0,"PSOE",52
28,"28078",40,38,38,0,0,"PSOE",4
28,"28088",296,196,191,1,5,"PSOE",54
47,"47183",135,100,100,1,0,"PSOE",23
7,"7015",22248,12375,12286,202,89,"PSOE",2679
9,"9227",112,89,89,1,0,"PSOE",42
5,"5124",87,67,67,2,0,"PSOE",12
16,"16033",1633,1199,1174,8,25,"PSOE",490
34,"34031",26,26,26,1,0,"PSOE",4
30,"30014",1587,1150,1134,4,16,"PSOE",470
37,"37225",97,78,74,0,4,"PSOE",19
38,"38031",29301,20926,20701,157,225,"PSOE",6387
31,"31159",1097,813,812,2,1,"PSOE",120
21,"21056",2914,2148,2046,29,102,"PSOE",980
39,"39005",1419,1039,1030,9,9,"PSOE",170
49,"49065",1048,747,725,6,22,"PSOE",207
29,"29028",1215,803,779,9,24,"PSOE",359
6,"6097",2258,1631,1602,10,29,"PSOE",746
9,"9306",94,69,69,1,0,"PSOE",19
23,"23098",847,704,700,0,4,"PSOE",342
18,"18124",355,232,231,1,1,"PSOE",61
37,"37298",170,109,109,0,0,"PSOE",32
3,"3031",42046,25035,24819,168,216,"PSOE",7743
45,"45184",204,123,122,0,1,"PSOE",59
50,"50279",74,49,49,0,0,"PSOE",36
19,"19047",55,47,47,1,0,"PSOE",20
49,"49216",147,115,109,0,6,"PSOE",45
46,"46025",2445,1875,1853,16,22,"PSOE",515
13,"13078",8946,6166,6103,49,63,"PSOE",2257
9,"9467",59,46,46,2,0,"PSOE",11
10,"10065",199,135,135,0,0,"PSOE",55
37,"37164",232,176,175,3,1,"PSOE",48
13,"13093",3901,2617,2569,16,48,"PSOE",863
37,"37194",229,161,160,0,1,"PSOE",65
5,"5149",101,72,71,2,1,"PSOE",15
5,"5039",47,43,43,0,0,"PSOE",5
18,"18040",237,146,145,0,1,"PSOE",71
40,"40135",277,212,210,3,2,"PSOE",74
49,"49055",91,72,72,3,0,"PSOE",18
42,"42157",10,9,9,0,0,"PSOE",0
31,"31237",182,138,135,2,3,"PSOE",31
13,"13080",316,226,225,0,1,"PSOE",102
29,"29002",1143,777,766,6,11,"PSOE",330
16,"16273",300,214,211,3,3,"PSOE",41
22,"22227",200,140,140,2,0,"PSOE",65
49,"49020",253,189,187,0,2,"PSOE",68
40,"40006",22,19,19,0,0,"PSOE",5
10,"10094",220,167,165,0,2,"PSOE",95
10,"10189",2499,1747,1700,15,47,"PSOE",740
49,"49095",282,202,201,6,1,"PSOE",62
50,"50092",290,218,214,0,4,"PSOE",99
16,"16089",381,292,289,8,3,"PSOE",121
13,"13020",4701,3114,3069,42,45,"PSOE",1185
50,"50182",3657,2499,2485,23,14,"PSOE",470
44,"44155",1063,779,778,3,1,"PSOE",285
41,"41031",1204,780,769,5,11,"PSOE",480
24,"24059",804,466,463,5,3,"PSOE",250
5,"5207",645,485,478,4,7,"PSOE",208
9,"9366",76,55,55,2,0,"PSOE",12
47,"47230",285,209,206,1,3,"PSOE",71
45,"45041",3967,2723,2689,18,34,"PSOE",773
37,"37217",59,43,43,3,0,"PSOE",18
47,"47137",29,25,25,0,0,"PSOE",9
3,"3016",88,66,66,0,0,"PSOE",15
46,"46037",1120,891,879,7,12,"PSOE",261
16,"16039",365,241,238,3,3,"PSOE",81
33,"33034",9979,5937,5873,64,64,"PSOE",2255
44,"44154",240,164,161,1,3,"PSOE",29
21,"21068",973,562,556,11,6,"PSOE",267
10,"10178",724,499,494,3,5,"PSOE",201
26,"26062",85,62,62,1,0,"PSOE",14
47,"47189",151,128,122,1,6,"PSOE",28
5,"5247",231,132,131,1,1,"PSOE",45
19,"19086",1371,1003,996,9,7,"PSOE",433
37,"37262",69,51,51,0,0,"PSOE",3
42,"42013",34,22,22,2,0,"PSOE",11
46,"46210",338,256,251,0,5,"PSOE",74
34,"34178",119,94,91,0,3,"PSOE",9
49,"49098",200,139,138,3,1,"PSOE",39
10,"10219",1184,698,686,9,12,"PSOE",316
44,"44184",44,37,37,0,0,"PSOE",1
30,"30003",25200,16249,16120,159,129,"PSOE",5017
24,"24179",287,207,207,2,0,"PSOE",49
10,"10901",1161,758,753,1,5,"PSOE",267
45,"45118",2124,1403,1380,8,23,"PSOE",450
24,"24070",3886,2677,2625,18,52,"PSOE",1236
22,"22119",1267,880,871,4,9,"PSOE",315
9,"9029",151,111,108,2,3,"PSOE",32
10,"10180",4206,2609,2574,13,35,"PSOE",849
31,"31192",160,125,123,0,2,"PSOE",12
18,"18165",4265,2870,2820,22,50,"PSOE",1057
38,"38045",3542,1825,1801,7,24,"PSOE",593
11,"11903",1769,1116,1101,22,15,"PSOE",452
50,"50035",74,57,57,0,0,"PSOE",4
3,"3902",10640,7024,6952,36,72,"PSOE",1406
26,"26011",7251,4807,4711,47,96,"PSOE",1784
18,"18170",317,212,209,0,3,"PSOE",117
31,"31035",50,30,29,0,1,"PSOE",12
18,"18145",10909,7925,7780,67,145,"PSOE",2050
46,"46189",469,374,367,2,7,"PSOE",102
28,"28064",125,98,95,3,3,"PSOE",25
23,"23009",12849,9722,9572,99,150,"PSOE",3205
19,"19195",36,26,25,2,1,"PSOE",12
5,"5063",31,26,26,0,0,"PSOE",3
37,"37089",60,44,43,0,1,"PSOE",13
19,"19187",42,32,32,0,0,"PSOE",15
33,"33065",1077,670,657,11,13,"PSOE",192
45,"45119",3499,2217,2190,3,27,"PSOE",563
10,"10155",1073,735,717,6,18,"PSOE",317
29,"29034",461,333,332,2,1,"PSOE",75
22,"22254",1084,744,735,10,9,"PSOE",307
18,"18027",2598,1730,1706,12,24,"PSOE",815
21,"21031",1166,773,736,11,37,"PSOE",345
37,"37306",238,140,136,3,4,"PSOE",30
49,"49090",190,135,134,3,1,"PSOE",40
23,"23024",12215,8702,8447,69,255,"PSOE",3288
42,"42164",1580,1043,1029,8,14,"PSOE",327
39,"39057",2366,1636,1607,10,29,"PSOE",460
28,"28099",1950,1409,1404,16,5,"PSOE",289
46,"46130",862,633,625,6,8,"PSOE",193
9,"9463",246,174,174,4,0,"PSOE",63
41,"41046",3005,2241,2198,11,43,"PSOE",1073
33,"33067",751,543,538,7,5,"PSOE",267
29,"29082",34683,24751,24495,263,256,"PSOE",6348
39,"39020",23993,15944,15792,89,152,"PSOE",5153
16,"16070",29,27,27,0,0,"PSOE",15
5,"5231",150,123,122,2,1,"PSOE",31
45,"45134",1622,1187,1177,8,10,"PSOE",389
12,"12078",334,224,221,2,3,"PSOE",54
50,"50074",6156,4100,4022,33,78,"PSOE",1350
22,"22246",63,43,43,0,0,"PSOE",13
10,"10905",636,443,433,7,10,"PSOE",143
19,"19287",134,100,98,2,2,"PSOE",22
46,"46136",2598,1875,1851,14,24,"PSOE",527
12,"12081",606,454,446,2,8,"PSOE",128
24,"24095",317,228,228,3,0,"PSOE",51
49,"49181",333,197,195,2,2,"PSOE",51
4,"4024",3241,2315,2290,34,25,"PSOE",677
22,"22176",171,140,138,2,2,"PSOE",28
49,"49066",437,276,272,2,4,"PSOE",64
49,"49138",205,141,140,2,1,"PSOE",43
19,"19302",52,42,42,1,0,"PSOE",11
9,"9396",149,121,121,4,0,"PSOE",15
50,"50166",235,186,186,0,0,"PSOE",47
29,"29037",215,156,153,1,3,"PSOE",52
9,"9043",172,112,111,1,1,"PSOE",26
10,"10027",77,62,62,0,0,"PSOE",34
50,"50297",503800,365284,362768,3385,2516,"PSOE",108977
50,"50144",31,24,24,0,0,"PSOE",7
37,"37008",4213,3092,3046,21,46,"PSOE",705
45,"45136",5827,3908,3864,22,44,"PSOE",1297
42,"42076",200,149,143,2,6,"PSOE",50
42,"42212",57,45,45,2,0,"PSOE",11
24,"24174",457,294,289,3,5,"PSOE",100
47,"47134",150,120,116,2,4,"PSOE",39
26,"26022",177,130,128,0,2,"PSOE",24
34,"34019",111,87,86,1,1,"PSOE",17
47,"47155",3454,2445,2405,26,40,"PSOE",667
16,"16151",61,51,51,1,0,"PSOE",12
23,"23101",351,238,238,3,0,"PSOE",131
41,"41067",7273,5114,5036,59,78,"PSOE",2111
22,"22025",1022,705,694,14,11,"PSOE",231
13,"13004",976,698,694,6,4,"PSOE",346
22,"22027",311,210,209,1,1,"PSOE",65
50,"50084",67,47,47,1,0,"PSOE",19
28,"28104",15528,12342,12234,103,108,"PSOE",2538
11,"11014",17203,10923,10805,222,118,"PSOE",3127
50,"50294",65,45,45,0,0,"PSOE",15
9,"9907",1526,1140,1119,18,21,"PSOE",308
18,"18117",497,360,354,1,6,"PSOE",184
46,"46216",5277,4146,4111,42,35,"PSOE",850
13,"13065",2777,1766,1728,10,38,"PSOE",531
31,"31171",670,466,462,1,4,"PSOE",203
49,"49154",111,63,59,0,4,"PSOE",36
18,"18015",424,331,330,4,1,"PSOE",152
40,"40146",260,206,204,0,2,"PSOE",52
12,"12053",2040,1587,1579,8,8,"PSOE",484
13,"13056",11706,8399,8288,88,111,"PSOE",2805
10,"10154",177,117,116,0,1,"PSOE",49
12,"12084",17785,12557,12422,108,135,"PSOE",3661
44,"44041",60,48,48,0,0,"PSOE",14
18,"18107",920,643,626,1,17,"PSOE",328
40,"40069",68,59,59,0,0,"PSOE",10
40,"40165",73,53,52,0,1,"PSOE",24
38,"38029",1475,752,744,10,8,"PSOE",235
9,"9451",237,196,189,1,7,"PSOE",94
50,"50069",66,33,33,1,0,"PSOE",17
12,"12099",597,444,436,6,8,"PSOE",109
22,"22242",60,41,40,0,1,"PSOE",9
19,"19059",73,47,47,0,0,"PSOE",6
50,"50288",3440,2513,2486,26,27,"PSOE",627
9,"9312",89,68,68,1,0,"PSOE",17
40,"40202",56,33,33,0,0,"PSOE",8
49,"49033",655,440,434,4,6,"PSOE",128
42,"42064",83,65,65,1,0,"PSOE",32
49,"49086",111,89,89,1,0,"PSOE",29
37,"37356",84,58,58,0,0,"PSOE",17
16,"16908",166,133,132,2,1,"PSOE",55
46,"46005",23129,16610,16437,148,173,"PSOE",5206
46,"46180",659,509,500,7,9,"PSOE",171
28,"28063",252,188,187,1,1,"PSOE",48
37,"37137",98,60,59,2,1,"PSOE",4
41,"41097",3131,2197,2140,13,57,"PSOE",1093
5,"5064",101,77,77,0,0,"PSOE",11
16,"16909",655,493,488,4,5,"PSOE",273
14,"14027",7890,5841,5726,78,115,"PSOE",2174
45,"45057",224,177,173,0,4,"PSOE",56
41,"41080",1231,832,815,14,17,"PSOE",372
19,"19060",157,123,122,0,1,"PSOE",36
40,"40140",76,54,54,0,0,"PSOE",19
46,"46044",4159,3062,2997,26,65,"PSOE",1058
18,"18176",242,164,161,2,3,"PSOE",113
41,"41040",11183,8351,8253,71,98,"PSOE",2024
49,"49270",139,93,92,0,1,"PSOE",36
41,"41002",1421,938,911,7,27,"PSOE",410
46,"46029",20448,14673,14556,99,117,"PSOE",3523
22,"22199",6884,4438,4384,71,54,"PSOE",1708
10,"10186",951,756,735,6,21,"PSOE",336
42,"42087",51,45,42,1,3,"PSOE",9
28,"28155",487,374,369,0,5,"PSOE",166
37,"37138",222,163,159,3,4,"PSOE",41
38,"38040",5482,3094,3060,14,34,"PSOE",650
37,"37031",329,241,238,3,3,"PSOE",55
46,"46237",7172,5199,5146,53,53,"PSOE",1554
10,"10017",775,554,545,1,9,"PSOE",222
46,"46042",3335,2655,2620,12,35,"PSOE",849
13,"13046",686,524,521,6,3,"PSOE",214
44,"44008",1556,1109,1100,7,9,"PSOE",424
10,"10046",184,144,140,0,4,"PSOE",72
9,"9225",80,55,55,0,0,"PSOE",21
35,"35017",27498,15513,15240,121,273,"PSOE",3821
49,"49026",199,134,134,0,0,"PSOE",53
50,"50228",249,207,207,3,0,"PSOE",47
2,"2003",134196,96374,95521,913,853,"PSOE",27074
40,"40219",573,382,366,5,16,"PSOE",38
45,"45088",2366,1526,1501,8,25,"PSOE",453
37,"37255",43,33,31,1,2,"PSOE",8
49,"49102",182,130,130,2,0,"PSOE",52
28,"28036",2699,1977,1957,20,20,"PSOE",422
14,"14002",10895,7599,7479,109,120,"PSOE",3306
19,"19259",28,22,22,0,0,"PSOE",14
50,"50193",664,487,475,4,12,"PSOE",143
29,"29092",576,375,366,7,9,"PSOE",147
9,"9001",32,25,25,0,0,"PSOE",12
18,"18179",493,315,309,8,6,"PSOE",131
16,"16020",9,5,5,1,0,"PSOE",1
9,"9358",247,165,161,3,4,"PSOE",35
24,"24038",3024,2121,2071,25,50,"PSOE",843
35,"35008",6214,4193,4143,33,50,"PSOE",1289
21,"21043",1853,1354,1325,23,29,"PSOE",756
49,"49157",188,136,133,2,3,"PSOE",34
19,"19201",60,44,44,0,0,"PSOE",9
50,"50223",906,702,693,9,9,"PSOE",375
21,"21026",262,172,168,2,4,"PSOE",91
6,"6130",185,152,149,0,3,"PSOE",84
4,"4019",236,174,172,0,2,"PSOE",96
46,"46045",1245,984,961,3,23,"PSOE",186
37,"37341",47,29,29,0,0,"PSOE",7
50,"50077",201,140,140,1,0,"PSOE",59
44,"44256",36,30,30,2,0,"PSOE",5
46,"46249",9136,6538,6439,73,99,"PSOE",2175
45,"45007",656,502,497,0,5,"PSOE",273
6,"6005",1694,1167,1139,9,28,"PSOE",665
10,"10139",92,66,65,1,1,"PSOE",31
22,"22041",145,116,116,2,0,"PSOE",30
16,"16051",128,96,96,3,0,"PSOE",39
31,"31088",5656,3929,3893,56,36,"PSOE",1025
4,"4077",296,270,268,3,2,"PSOE",78
24,"24213",158,127,126,1,1,"PSOE",34
24,"24094",1320,866,852,11,14,"PSOE",238
12,"12056",257,205,199,1,6,"PSOE",63
30,"30031",497,387,382,1,5,"PSOE",80
28,"28180",5317,4011,3959,35,52,"PSOE",1410
37,"37187",548,407,399,0,8,"PSOE",132
16,"16036",120,94,93,0,1,"PSOE",45
5,"5160",289,220,213,0,7,"PSOE",47
50,"50153",914,683,675,9,8,"PSOE",316
21,"21046",1729,1212,1187,14,25,"PSOE",314
9,"9039",54,38,37,0,1,"PSOE",3
3,"3014",238937,161861,160809,1308,1052,"PSOE",44785
5,"5234",45,38,38,0,0,"PSOE",5
45,"45137",1541,1007,998,8,9,"PSOE",437
49,"49042",229,166,164,2,2,"PSOE",31
44,"44115",102,91,91,0,0,"PSOE",36
40,"40157",39,30,30,0,0,"PSOE",9
41,"41011",15462,11019,10696,183,323,"PSOE",5379
37,"37185",539,372,363,2,9,"PSOE",75
42,"42141",101,59,59,0,0,"PSOE",14
40,"40113",404,308,304,2,4,"PSOE",110
50,"50065",56,37,37,0,0,"PSOE",18
16,"16106",2701,2029,2001,6,28,"PSOE",861
47,"47209",32,23,23,0,0,"PSOE",5
50,"50207",87,58,58,1,0,"PSOE",16
49,"49206",776,515,504,7,11,"PSOE",168
40,"40048",35,27,27,0,0,"PSOE",11
18,"18911",7933,5464,5348,53,116,"PSOE",1472
34,"34033",18,14,14,0,0,"PSOE",0
34,"34041",82,64,64,3,0,"PSOE",15
40,"40183",117,105,99,1,6,"PSOE",5
47,"47122",2007,1520,1492,8,28,"PSOE",493
13,"13001",1188,865,858,4,7,"PSOE",439
22,"22082",288,217,214,0,3,"PSOE",56
46,"46036",558,339,331,6,8,"PSOE",67
42,"42148",9,9,9,0,0,"PSOE",0
47,"47034",75,58,58,2,0,"PSOE",17
9,"9330",1481,1050,1037,17,13,"PSOE",333
16,"16108",44,35,34,1,1,"PSOE",13
31,"31142",1389,909,900,9,9,"PSOE",261
47,"47145",583,430,426,6,4,"PSOE",92
2,"2047",110,83,81,0,2,"PSOE",26
12,"12108",443,354,352,4,2,"PSOE",112
10,"10174",171,112,110,0,2,"PSOE",40
24,"24113",346,240,240,2,0,"PSOE",65
41,"41070",6451,4715,4632,70,83,"PSOE",1285
19,"19286",772,585,575,3,10,"PSOE",136
16,"16040",91,76,76,2,0,"PSOE",10
50,"50239",63,46,45,1,1,"PSOE",4
18,"18184",2193,1542,1511,16,31,"PSOE",654
5,"5238",728,529,525,1,4,"PSOE",158
9,"9389",63,45,45,0,0,"PSOE",9
19,"19265",134,97,97,5,0,"PSOE",24
42,"42053",21,17,17,0,0,"PSOE",0
44,"44204",27,18,18,0,0,"PSOE",8
37,"37127",205,139,139,1,0,"PSOE",48
37,"37117",1572,1103,1092,12,11,"PSOE",270
42,"42039",216,144,141,1,3,"PSOE",50
50,"50071",126,84,84,0,0,"PSOE",8
5,"5074",668,540,537,5,3,"PSOE",131
11,"11031",76427,49773,49248,654,525,"PSOE",14033
10,"10057",126,90,89,1,1,"PSOE",55
4,"4041",344,227,222,4,5,"PSOE",59
45,"45027",315,249,246,2,3,"PSOE",109
4,"4032",5716,3727,3696,43,31,"PSOE",1311
40,"40119",166,133,132,2,1,"PSOE",16
24,"24206",1594,1104,1093,11,11,"PSOE",547
18,"18010",527,398,394,5,4,"PSOE",199
6,"6112",379,295,293,0,2,"PSOE",139
34,"34233",128,104,104,0,0,"PSOE",20
50,"50240",943,693,683,12,10,"PSOE",268
42,"42015",30,20,20,0,0,"PSOE",3
24,"24218",451,310,308,3,2,"PSOE",97
26,"26120",1441,1027,1011,11,16,"PSOE",356
31,"31265",76,43,40,0,3,"PSOE",3
21,"21007",6379,4268,4178,66,90,"PSOE",1597
50,"50080",34,27,27,0,0,"PSOE",11
6,"6117",1388,982,958,11,24,"PSOE",372
49,"49257",305,186,184,0,2,"PSOE",63
7,"7055",8062,4546,4492,40,54,"PSOE",1064
5,"5222",140,118,118,0,0,"PSOE",23
34,"34082",78,59,58,0,1,"PSOE",21
23,"23066",4274,3517,3460,16,57,"PSOE",1272
31,"31077",5416,3840,3794,38,46,"PSOE",1229
37,"37019",138,111,109,0,2,"PSOE",18
31,"31119",35,24,24,1,0,"PSOE",3
44,"44225",105,82,81,2,1,"PSOE",25
24,"24026",1085,724,712,14,12,"PSOE",129
22,"22013",271,200,197,3,3,"PSOE",74
42,"42043",3816,2602,2540,23,62,"PSOE",656
49,"49162",170,117,116,1,1,"PSOE",44
45,"45035",286,206,204,2,2,"PSOE",77
28,"28100",4482,3146,3113,21,33,"PSOE",675
5,"5069",73,59,59,0,0,"PSOE",10
50,"50243",307,227,224,2,3,"PSOE",77
37,"37266",68,44,44,0,0,"PSOE",6
19,"19087",17,16,16,0,0,"PSOE",6
44,"44181",65,57,57,0,0,"PSOE",9
4,"4005",534,422,419,3,3,"PSOE",161
39,"39055",1065,747,736,4,11,"PSOE",127
37,"37293",102,68,68,1,0,"PSOE",18
22,"22040",149,119,119,3,0,"PSOE",40
3,"3061",1060,793,787,5,6,"PSOE",160
29,"29024",371,216,204,3,12,"PSOE",88
9,"9206",52,43,43,0,0,"PSOE",6
5,"5008",202,158,155,0,3,"PSOE",47
12,"12067",514,381,373,3,8,"PSOE",140
38,"38020",16057,9921,9809,66,112,"PSOE",2777
34,"34163",46,37,37,0,0,"PSOE",13
12,"12046",188,135,135,4,0,"PSOE",48
12,"12089",4555,3070,3045,22,25,"PSOE",612
6,"6113",2649,1889,1862,16,27,"PSOE",732
47,"47188",98,73,70,0,3,"PSOE",16
31,"31007",122,88,82,1,6,"PSOE",16
7,"7058",2866,2013,1996,24,17,"PSOE",471
40,"40225",1085,822,809,5,13,"PSOE",206
42,"42080",153,108,108,1,0,"PSOE",39
19,"19321",34,28,28,0,0,"PSOE",15
50,"50028",78,53,53,0,0,"PSOE",26
19,"19212",678,501,491,1,10,"PSOE",154
26,"26148",154,125,122,3,3,"PSOE",50
26,"26038",76,52,52,0,0,"PSOE",28
34,"34003",147,104,103,0,1,"PSOE",11
4,"4023",118,84,82,2,2,"PSOE",25
26,"26117",2105,1537,1500,17,37,"PSOE",587
24,"24101",370,219,213,4,6,"PSOE",116
34,"34157",2353,1697,1669,18,28,"PSOE",515
29,"29039",2759,1900,1860,23,40,"PSOE",563
9,"9346",90,61,60,1,1,"PSOE",17
22,"22156",289,216,213,1,3,"PSOE",68
33,"33033",9381,5848,5770,88,78,"PSOE",2309
29,"29058",1542,994,979,5,15,"PSOE",339
22,"22167",465,358,356,8,2,"PSOE",119
40,"40036",496,395,380,8,15,"PSOE",86
46,"46186",19689,14688,14576,118,112,"PSOE",4024
12,"12043",570,405,397,1,8,"PSOE",97
12,"12141",92,72,72,0,0,"PSOE",8
9,"9201",27,17,17,0,0,"PSOE",3
26,"26076",115,83,83,0,0,"PSOE",33
37,"37123",159,124,123,2,1,"PSOE",14
11,"11034",2319,1520,1487,17,33,"PSOE",713
30,"30011",4702,3390,3324,8,66,"PSOE",928
47,"47023",3057,2369,2359,20,10,"PSOE",567
9,"9297",310,233,233,6,0,"PSOE",33
37,"37023",1624,1233,1211,15,22,"PSOE",329
45,"45196",1382,1029,1005,7,24,"PSOE",361
18,"18164",1790,1135,1108,11,27,"PSOE",336
39,"39101",231,134,132,2,2,"PSOE",27
40,"40129",159,119,117,2,2,"PSOE",24
50,"50034",767,516,511,10,5,"PSOE",199
19,"19304",224,169,166,3,3,"PSOE",51
24,"24167",703,436,430,3,6,"PSOE",147
13,"13053",14031,9930,9796,97,134,"PSOE",3548
37,"37375",678,539,523,8,16,"PSOE",258
42,"42144",419,302,298,6,4,"PSOE",112
46,"46164",12145,8373,8248,44,125,"PSOE",2486
9,"9128",76,56,56,0,0,"PSOE",24
9,"9011",70,42,40,0,2,"PSOE",8
50,"50244",192,131,130,1,1,"PSOE",37
10,"10069",786,566,554,3,12,"PSOE",260
37,"37335",384,282,279,1,3,"PSOE",66
40,"40193",219,156,155,3,1,"PSOE",60
47,"47064",37,30,29,1,1,"PSOE",2
42,"42217",33,25,25,0,0,"PSOE",13
44,"44258",53,46,46,0,0,"PSOE",7
13,"13029",89,67,65,0,2,"PSOE",19
16,"16196",589,490,476,3,14,"PSOE",251
42,"42052",16,14,14,0,0,"PSOE",0
19,"19278",24,20,20,0,0,"PSOE",3
9,"9239",47,31,31,0,0,"PSOE",7
5,"5154",31,23,23,0,0,"PSOE",5
41,"41089",6621,4650,4549,64,101,"PSOE",1799
9,"9030",116,81,81,1,0,"PSOE",26
42,"42026",28,25,25,0,0,"PSOE",8
4,"4904",1900,1308,1299,4,9,"PSOE",240
5,"5163",1702,1258,1233,5,25,"PSOE",352
50,"50259",82,55,55,2,0,"PSOE",10
19,"19191",13,12,12,0,0,"PSOE",6
28,"28124",73,51,50,0,1,"PSOE",11
10,"10086",304,228,225,4,3,"PSOE",81
45,"45142",7792,5717,5624,62,93,"PSOE",1878
31,"31067",1887,1265,1249,6,16,"PSOE",486
19,"19001",43,32,32,0,0,"PSOE",5
14,"14074",2225,1775,1743,17,32,"PSOE",881
49,"49169",38,33,32,0,1,"PSOE",8
18,"18099",1582,1184,1156,13,28,"PSOE",415
3,"3102",7181,5126,5073,36,53,"PSOE",1324
41,"41083",1145,821,814,6,7,"PSOE",423
46,"46122",2726,1957,1934,13,23,"PSOE",669
45,"45001",1846,1213,1181,10,32,"PSOE",469
4,"4068",170,129,128,0,1,"PSOE",53
24,"24006",488,356,347,4,9,"PSOE",90
19,"19324",164,122,120,4,2,"PSOE",45
46,"46046",901,623,609,2,14,"PSOE",102
6,"6124",1635,1158,1119,10,39,"PSOE",600
49,"49248",171,128,128,1,0,"PSOE",45
10,"10021",4987,3574,3475,31,99,"PSOE",1745
40,"40033",70,55,52,1,3,"PSOE",10
29,"29041",3697,2406,2361,47,45,"PSOE",620
37,"37278",793,570,567,6,3,"PSOE",123
34,"34147",164,120,120,1,0,"PSOE",15
37,"37315",89,65,64,0,1,"PSOE",11
19,"19296",29,24,24,0,0,"PSOE",3
5,"5015",68,45,44,1,1,"PSOE",17
41,"41032",3842,2800,2704,24,96,"PSOE",1244
5,"5257",132,98,95,4,3,"PSOE",20
46,"46049",268,221,217,2,4,"PSOE",52
18,"18105",3827,2436,2392,22,44,"PSOE",1168
19,"19175",29,18,17,1,1,"PSOE",1
50,"50280",290,220,216,1,4,"PSOE",83
14,"14033",1239,875,856,8,19,"PSOE",384
3,"3020",94,84,84,1,0,"PSOE",22
5,"5253",75,54,54,0,0,"PSOE",6
49,"49191",265,192,188,2,4,"PSOE",119
50,"50020",795,548,545,4,3,"PSOE",193
46,"46234",317,247,245,1,2,"PSOE",85
42,"42011",16,11,11,0,0,"PSOE",3
26,"26043",346,243,235,2,8,"PSOE",99
9,"9112",102,73,73,0,0,"PSOE",23
35,"35025",1752,1113,1095,5,18,"PSOE",274
24,"24225",979,678,668,5,10,"PSOE",175
31,"31162",48,28,27,1,1,"PSOE",10
31,"31187",99,53,52,0,1,"PSOE",6
18,"18012",2114,1519,1492,9,27,"PSOE",596
10,"10126",1455,966,948,9,18,"PSOE",350
16,"16016",217,157,157,1,0,"PSOE",59
47,"47009",98,84,84,0,0,"PSOE",26
22,"22178",105,89,89,1,0,"PSOE",22
5,"5233",223,174,173,0,1,"PSOE",41
18,"18034",484,345,342,3,3,"PSOE",144
29,"29097",4160,2872,2800,56,72,"PSOE",1306
22,"22252",118,95,91,1,4,"PSOE",34
44,"44205",619,420,415,5,5,"PSOE",128
49,"49024",626,432,426,3,6,"PSOE",130
45,"45045",1338,926,915,9,11,"PSOE",326
46,"46178",5001,3513,3477,26,36,"PSOE",618
28,"28059",4516,3343,3299,30,44,"PSOE",770
9,"9086",652,479,471,3,8,"PSOE",106
22,"22008",144,113,112,2,1,"PSOE",34
16,"16029",104,76,74,0,2,"PSOE",22
3,"3027",167,142,138,1,4,"PSOE",43
5,"5228",168,99,98,0,1,"PSOE",7
50,"50029",594,432,431,3,1,"PSOE",239
11,"11007",18032,9872,9745,213,127,"PSOE",3017
9,"9351",61,46,45,1,1,"PSOE",4
37,"37100",74,59,58,1,1,"PSOE",2
9,"9093",162,131,131,1,0,"PSOE",38
41,"41051",2317,1715,1688,4,27,"PSOE",690
11,"11006",24558,15334,15113,231,221,"PSOE",5778
37,"37168",397,271,266,3,5,"PSOE",86
40,"40041",966,729,716,8,13,"PSOE",211
6,"6115",1243,808,798,8,10,"PSOE",297
16,"16081",50,37,36,0,1,"PSOE",12
38,"38035",10518,5870,5819,37,51,"PSOE",1321
47,"47095",41,29,28,0,1,"PSOE",2
16,"16186",403,309,305,3,4,"PSOE",140
46,"46078",28484,19694,19520,173,174,"PSOE",6195
42,"42156",29,21,21,0,0,"PSOE",4
31,"31037",91,70,70,0,0,"PSOE",6
49,"49137",167,123,121,0,2,"PSOE",31
34,"34059",411,304,292,6,12,"PSOE",93
46,"46903",6306,4762,4743,44,19,"PSOE",900
47,"47190",95,75,75,1,0,"PSOE",20
26,"26039",40,31,31,0,0,"PSOE",14
26,"26181",15,14,14,0,0,"PSOE",4
38,"38025",7065,4657,4590,34,67,"PSOE",1524
6,"6150",777,592,588,0,4,"PSOE",259
34,"34184",49,37,35,0,2,"PSOE",4
44,"44014",2506,1828,1818,8,10,"PSOE",499
4,"4082",275,185,182,2,3,"PSOE",52
16,"16116",76,59,58,1,1,"PSOE",24
22,"22028",358,237,233,1,4,"PSOE",88
5,"5054",1192,871,856,6,15,"PSOE",309
18,"18138",2470,1597,1573,25,24,"PSOE",658
13,"13044",2582,1838,1804,13,34,"PSOE",643
24,"24196",1907,1322,1299,4,23,"PSOE",550
5,"5261",32,25,25,0,0,"PSOE",4
10,"10030",455,311,305,2,6,"PSOE",126
46,"46069",152,112,111,1,1,"PSOE",56
46,"46112",533,435,432,7,3,"PSOE",128
40,"40030",419,317,314,3,3,"PSOE",127
19,"19229",58,53,53,0,0,"PSOE",18
47,"47228",432,324,320,2,4,"PSOE",100
4,"4060",416,286,282,2,4,"PSOE",82
19,"19217",43,36,36,0,0,"PSOE",12
22,"22215",127,81,81,0,0,"PSOE",34
5,"5040",64,47,46,0,1,"PSOE",10
6,"6100",845,626,624,2,2,"PSOE",277
39,"39026",1702,1160,1151,11,9,"PSOE",207
44,"44046",44,33,33,0,0,"PSOE",10
41,"41062",2151,1619,1589,12,30,"PSOE",739
39,"39014",882,538,536,0,2,"PSOE",117
31,"31061",48,45,45,2,0,"PSOE",9
6,"6145",900,683,669,7,14,"PSOE",337
42,"42060",28,16,14,0,2,"PSOE",3
5,"5171",67,49,47,0,2,"PSOE",8
44,"44062",31,20,20,0,0,"PSOE",5
37,"37167",174,147,144,2,3,"PSOE",68
23,"23055",46314,30950,30506,279,444,"PSOE",10608
10,"10192",777,567,563,3,4,"PSOE",245
19,"19023",119,87,85,0,2,"PSOE",29
24,"24046",893,595,583,6,12,"PSOE",222
19,"19329",58,46,46,0,0,"PSOE",20
31,"31062",1070,778,770,10,8,"PSOE",309
46,"46246",1049,808,793,3,15,"PSOE",199
16,"16264",385,311,305,1,6,"PSOE",133
5,"5087",147,108,107,3,1,"PSOE",11
24,"24125",416,233,231,3,2,"PSOE",69
44,"44219",173,118,115,1,3,"PSOE",25
7,"7019",161,104,102,0,2,"PSOE",9
12,"12036",541,401,395,6,6,"PSOE",126
7,"7004",4069,2652,2624,27,28,"PSOE",700
34,"34039",58,48,47,0,1,"PSOE",6
13,"13040",839,639,623,7,16,"PSOE",230
40,"40203",987,753,740,13,13,"PSOE",223
2,"2036",93,66,66,0,0,"PSOE",24
16,"16152",32,26,26,3,0,"PSOE",3
12,"12057",572,456,437,1,19,"PSOE",159
34,"34213",53,46,46,0,0,"PSOE",9
23,"23007",3015,2252,2229,14,23,"PSOE",974
50,"50087",28,19,19,0,0,"PSOE",5
9,"9274",1035,774,762,8,12,"PSOE",291
31,"31167",833,581,573,2,8,"PSOE",135
37,"37056",39,28,28,0,0,"PSOE",1
22,"22172",520,373,369,5,4,"PSOE",100
39,"39007",386,265,264,0,1,"PSOE",58
37,"37366",40,34,33,2,1,"PSOE",8
9,"9478",45,34,34,1,0,"PSOE",16
28,"28006",80903,60936,60508,482,428,"PSOE",16382
26,"26096",257,198,193,2,5,"PSOE",70
45,"45017",264,199,196,4,3,"PSOE",88
22,"22052",874,660,652,7,8,"PSOE",265
10,"10011",518,385,370,2,15,"PSOE",204
44,"44231",35,30,30,0,0,"PSOE",7
42,"42198",19,9,9,1,0,"PSOE",2
13,"13003",448,329,319,1,10,"PSOE",125
12,"12087",26,16,16,0,0,"PSOE",1
5,"5080",42,30,30,0,0,"PSOE",3
2,"2081",18287,12910,12675,130,235,"PSOE",3869
11,"11021",4914,3187,3069,61,118,"PSOE",1202
9,"9034",291,227,224,1,3,"PSOE",61
18,"18143",945,661,651,2,10,"PSOE",255
46,"46226",29,20,19,0,1,"PSOE",15
50,"50010",67,52,52,1,0,"PSOE",4
18,"18910",710,439,434,1,5,"PSOE",150
18,"18119",1708,1264,1240,7,24,"PSOE",463
30,"30008",14560,9974,9840,79,134,"PSOE",2334
50,"50201",449,345,344,4,1,"PSOE",110
37,"37047",215,89,89,0,0,"PSOE",17
14,"14024",1849,1417,1391,5,26,"PSOE",561
5,"5180",76,55,53,0,2,"PSOE",3
14,"14902",1113,877,851,15,26,"PSOE",441
2,"2008",1103,737,722,8,15,"PSOE",273
47,"47062",155,128,128,0,0,"PSOE",19
37,"37006",116,71,70,3,1,"PSOE",13
50,"50287",253,189,188,11,1,"PSOE",61
24,"24044",150,91,89,2,2,"PSOE",26
24,"24055",674,484,482,8,2,"PSOE",152
19,"19185",26,15,15,1,0,"PSOE",4
50,"50039",462,339,333,1,6,"PSOE",148
18,"18004",669,467,466,6,1,"PSOE",189
14,"14046",4442,3283,3190,34,93,"PSOE",1202
46,"46250",582242,437146,434438,3315,2708,"PSOE",107790
30,"30027",50067,36417,36074,242,343,"PSOE",8692
31,"31005",279,183,183,4,0,"PSOE",55
23,"23004",407,321,315,2,6,"PSOE",93
12,"12106",1151,928,908,9,20,"PSOE",429
18,"18151",261,167,166,4,1,"PSOE",80
49,"49031",148,107,105,2,2,"PSOE",22
22,"22230",291,209,207,4,2,"PSOE",63
44,"44108",306,209,205,1,4,"PSOE",56
42,"42160",246,177,175,3,2,"PSOE",76
44,"44213",68,47,47,0,0,"PSOE",10
50,"50263",171,110,108,1,2,"PSOE",56
14,"14051",1323,975,951,7,24,"PSOE",477
37,"37029",186,125,124,1,1,"PSOE",36
35,"35033",6393,4147,4072,38,75,"PSOE",1161
4,"4089",687,484,479,2,5,"PSOE",148
10,"10125",859,561,546,3,15,"PSOE",224
44,"44197",51,35,35,1,0,"PSOE",12
16,"16176",29,20,20,0,0,"PSOE",9
47,"47178",170,128,124,2,4,"PSOE",35
14,"14054",13775,10464,10165,105,299,"PSOE",3638
46,"46082",4981,3547,3523,29,24,"PSOE",909
19,"19268",50,37,35,0,2,"PSOE",15
10,"10001",287,207,203,2,4,"PSOE",112
24,"24041",513,312,305,4,7,"PSOE",107
16,"16904",453,348,345,11,3,"PSOE",124
26,"26114",72,61,61,0,0,"PSOE",23
9,"9101",72,52,52,0,0,"PSOE",7
22,"22022",542,405,403,2,2,"PSOE",154
5,"5220",364,277,274,0,3,"PSOE",51
34,"34246",68,52,52,0,0,"PSOE",13
21,"21049",3262,2028,1977,15,51,"PSOE",1034
49,"49068",422,263,261,4,2,"PSOE",68
49,"49099",96,67,67,0,0,"PSOE",30
7,"7010",5078,3353,3318,30,35,"PSOE",724
31,"31081",338,229,227,1,2,"PSOE",35
44,"44235",87,65,64,1,1,"PSOE",17
40,"40051",34,25,25,0,0,"PSOE",6
19,"19058",7458,5705,5663,40,42,"PSOE",1693
6,"6054",5452,3773,3657,34,116,"PSOE",1346
44,"44106",151,107,106,0,1,"PSOE",28
40,"40026",112,101,99,0,2,"PSOE",28
9,"9448",203,159,157,0,2,"PSOE",25
50,"50184",87,70,70,0,0,"PSOE",19
44,"44173",103,81,79,0,2,"PSOE",14
50,"50181",999,748,732,3,16,"PSOE",218
50,"50213",92,70,70,2,0,"PSOE",9
9,"9395",121,74,74,1,0,"PSOE",16
42,"42171",111,72,71,1,1,"PSOE",15
49,"49097",67,44,44,0,0,"PSOE",15
44,"44032",17,13,13,0,0,"PSOE",8
50,"50002",125,91,86,0,5,"PSOE",19
24,"24021",1595,1037,1025,7,12,"PSOE",376
49,"49165",55,52,52,1,0,"PSOE",9
22,"22182",227,132,131,3,1,"PSOE",57
37,"37321",150,118,115,0,3,"PSOE",39
9,"9288",87,64,64,0,0,"PSOE",15
19,"19122",81,62,60,2,2,"PSOE",22
19,"19246",42,27,27,1,0,"PSOE",12
14,"14020",336,227,225,0,2,"PSOE",132
4,"4099",4930,3526,3462,22,64,"PSOE",1078
18,"18023",15717,10964,10751,132,213,"PSOE",3219
42,"42213",25,17,16,1,1,"PSOE",3
6,"6011",24731,16786,16538,167,248,"PSOE",4795
29,"29087",363,249,243,4,6,"PSOE",77
45,"45014",4039,2606,2552,35,54,"PSOE",1011
37,"37192",361,200,198,3,2,"PSOE",54
49,"49241",235,178,177,1,1,"PSOE",25
6,"6114",127,105,105,0,0,"PSOE",71
22,"22009",581,387,386,7,1,"PSOE",147
45,"45125",2256,1711,1689,16,22,"PSOE",670
35,"35001",4566,3148,3105,18,43,"PSOE",1067
22,"22904",751,516,511,3,5,"PSOE",148
46,"46255",3220,2361,2340,20,21,"PSOE",667
39,"39023",6563,4788,4753,14,35,"PSOE",1300
22,"22251",327,259,256,0,3,"PSOE",68
16,"16277",105,74,74,0,0,"PSOE",13
26,"26067",22,18,18,3,0,"PSOE",7
46,"46041",313,229,228,1,1,"PSOE",65
42,"42194",144,101,100,2,1,"PSOE",38
26,"26059",1109,801,791,6,10,"PSOE",265
19,"19283",29,26,26,0,0,"PSOE",14
46,"46193",8959,6880,6824,66,56,"PSOE",2031
6,"6119",674,516,511,1,5,"PSOE",225
28,"28053",6956,5475,5414,44,61,"PSOE",1259
5,"5102",1681,1252,1228,8,24,"PSOE",387
2,"2004",597,459,455,3,4,"PSOE",199
47,"47193",1625,1251,1236,10,15,"PSOE",386
18,"18188",1646,1224,1202,10,22,"PSOE",592
3,"3092",6712,4924,4858,35,66,"PSOE",1285
18,"18123",284,202,200,5,2,"PSOE",92
42,"42140",15,11,11,1,0,"PSOE",0
19,"19116",12,10,10,0,0,"PSOE",3
19,"19222",95,70,70,2,0,"PSOE",28
44,"44038",101,85,83,1,2,"PSOE",30
40,"40901",413,320,315,7,5,"PSOE",82
9,"9362",198,156,156,4,0,"PSOE",48
16,"16243",376,316,309,4,7,"PSOE",113
22,"22061",6567,4446,4410,48,36,"PSOE",1371
16,"16057",62,45,45,0,0,"PSOE",14
10,"10076",791,537,525,10,12,"PSOE",236
46,"46079",314,244,240,0,4,"PSOE",68
49,"49184",172,110,107,2,3,"PSOE",10
39,"39079",8850,6247,6175,28,72,"PSOE",1540
50,"50162",135,100,99,3,1,"PSOE",46
9,"9045",269,159,158,0,1,"PSOE",46
6,"6099",1156,683,652,5,31,"PSOE",333
16,"16100",642,518,514,2,4,"PSOE",209
50,"50165",1768,1255,1222,20,33,"PSOE",404
10,"10025",377,308,299,3,9,"PSOE",124
37,"37360",206,135,135,1,0,"PSOE",39
49,"49176",605,360,353,0,7,"PSOE",68
37,"37311",201,157,156,1,1,"PSOE",47
5,"5117",191,155,153,1,2,"PSOE",21
44,"44220",113,82,82,1,0,"PSOE",9
26,"26110",149,116,114,0,2,"PSOE",43
19,"19134",23,14,14,0,0,"PSOE",6
31,"31908",1076,763,762,5,1,"PSOE",132
37,"37032",553,388,388,2,0,"PSOE",95
49,"49136",313,218,217,5,1,"PSOE",51
9,"9023",1190,891,879,17,12,"PSOE",225
31,"31017",375,250,250,10,0,"PSOE",35
11,"11040",396,332,324,3,8,"PSOE",197
28,"28143",77,58,58,0,0,"PSOE",14
24,"24102",587,403,399,7,4,"PSOE",173
40,"40040",2489,1766,1744,26,22,"PSOE",462
45,"45149",517,400,393,2,7,"PSOE",132
24,"24229",376,275,269,2,6,"PSOE",67
28,"28138",60,43,42,0,1,"PSOE",5
24,"24187",834,559,549,11,10,"PSOE",151
28,"28066",7575,5771,5718,58,53,"PSOE",940
5,"5264",54,32,31,4,1,"PSOE",1
20,"20019",9892,6740,6717,40,23,"PUM+J",6
48,"48092",872,614,608,3,6,"PUM+J",1
48,"48064",608,461,461,0,0,"PUM+J",0
48,"48050",188,141,141,0,0,"PUM+J",0
20,"20008",713,424,424,5,0,"PUM+J",0
1,"1021",471,321,319,3,2,"PUM+J",0
1,"1028",1091,735,728,5,7,"PUM+J",1
48,"48908",250,212,210,1,2,"PUM+J",0
20,"20059",8892,6505,6490,18,15,"PUM+J",2
1,"1053",596,364,362,1,2,"PUM+J",1
20,"20028",2254,1442,1441,6,1,"PUM+J",2
48,"48911",381,303,302,1,1,"PUM+J",0
48,"48052",1562,1220,1210,5,10,"PUM+J",0
48,"48030",591,449,447,2,2,"PUM+J",0
1,"1054",998,701,700,4,1,"PUM+J",0
48,"48907",343,274,273,0,1,"PUM+J",0
20,"20039",2126,1623,1618,9,5,"PUM+J",1
20,"20062",941,688,683,1,5,"PUM+J",1
20,"20901",1399,960,957,3,3,"PUM+J",0
20,"20069",147446,102068,101696,564,372,"PUM+J",150
48,"48005",116,80,79,0,1,"PUM+J",0
1,"1042",911,680,671,8,9,"PUM+J",0
48,"48002",7791,5510,5471,42,39,"PUM+J",4
1,"1008",808,546,536,6,10,"PUM+J",1
20,"20048",183,112,112,0,0,"PUM+J",0
48,"48040",1303,933,926,7,7,"PUM+J",0
20,"20055",17300,11784,11725,43,59,"PUM+J",4
1,"1006",174,124,122,1,2,"PUM+J",1
1,"1037",589,378,374,1,4,"PUM+J",1
1,"1013",710,469,465,2,4,"PUM+J",0
1,"1033",654,476,476,0,0,"PUM+J",1
1,"1011",213,162,160,3,2,"PUM+J",0
48,"48901",5160,3705,3684,16,21,"PUM+J",5
48,"48058",947,682,679,2,3,"PUM+J",2
20,"20012",149,104,104,1,0,"PUM+J",0
48,"48077",3366,2483,2467,9,16,"PUM+J",3
20,"20006",261,154,153,1,1,"PUM+J",0
48,"48010",476,343,343,1,0,"PUM+J",0
20,"20068",179,119,119,2,0,"PUM+J",0
48,"48049",543,415,414,1,1,"PUM+J",0
20,"20058",740,523,522,3,1,"PUM+J",0
1,"1052",272,189,186,2,3,"PUM+J",0
20,"20065",2921,1983,1970,16,13,"PUM+J",3
20,"20025",1110,791,788,4,3,"PUM+J",0
1,"1027",444,273,271,0,2,"PUM+J",1
48,"48096",6516,4862,4816,33,46,"PUM+J",2
48,"48027",22745,16240,16158,74,82,"PUM+J",20
20,"20904",87,56,55,1,1,"PUM+J",0
20,"20018",11231,7640,7611,33,29,"PUM+J",1
1,"1043",2340,1487,1468,11,19,"PUM+J",4
1,"1057",235,196,194,0,2,"PUM+J",0
1,"1034",152,107,107,1,0,"PUM+J",0
48,"48073",6827,4614,4591,38,23,"PUM+J",0
20,"20026",207,172,171,4,1,"PUM+J",0
1,"1036",14698,10207,10131,51,76,"PUM+J",19
20,"20038",387,294,293,2,1,"PUM+J",0
48,"48090",6004,4305,4254,28,51,"PUM+J",1
20,"20032",8654,6000,5972,21,28,"PUM+J",4
20,"20005",1274,822,822,1,0,"PUM+J",0
48,"48014",1229,845,843,8,2,"PUM+J",0
48,"48053",926,704,702,6,2,"PUM+J",1
20,"20052",1050,746,743,4,3,"PUM+J",2
1,"1020",323,228,224,1,4,"PUM+J",0
48,"48048",527,381,380,3,1,"PUM+J",1
20,"20067",30609,20017,19927,111,90,"PUM+J",18
20,"20057",198,148,147,1,1,"PUM+J",0
20,"20027",2761,1866,1861,10,5,"PUM+J",1
48,"48066",344,246,246,2,0,"PUM+J",0
20,"20907",118,82,82,0,0,"PUM+J",0
20,"20017",8462,5944,5917,11,27,"PUM+J",16
48,"48029",8681,6057,6027,41,30,"PUM+J",4
48,"48914",332,276,275,0,1,"PUM+J",0
20,"20024",395,245,245,4,0,"PUM+J",0
1,"1063",1852,1316,1303,6,13,"PUM+J",2
48,"48024",1000,761,752,1,9,"PUM+J",0
1,"1018",1399,953,947,1,6,"PUM+J",0
48,"48008",609,415,407,4,8,"PUM+J",0
48,"48905",2496,1778,1766,12,12,"PUM+J",1
20,"20037",101,69,69,0,0,"PUM+J",0
20,"20011",1624,1234,1225,3,9,"PUM+J",0
48,"48006",307,242,240,3,2,"PUM+J",0
48,"48012",2057,1610,1600,1,10,"PUM+J",1
20,"20022",849,574,571,8,3,"PUM+J",0
48,"48902",18987,12762,12670,88,92,"PUM+J",7
20,"20002",359,234,231,7,3,"PUM+J",1
20,"20015",1245,880,876,5,4,"PUM+J",1
48,"48093",891,669,666,5,3,"PUM+J",0
48,"48018",854,563,560,5,3,"PUM+J",0
20,"20078",1143,819,816,1,3,"PUM+J",0
48,"48076",288,211,211,1,0,"PUM+J",0
48,"48020",272771,184893,183922,1227,971,"PUM+J",186
48,"48016",5471,3964,3935,31,29,"PUM+J",4
1,"1031",1136,844,830,1,14,"PUM+J",3
20,"20072",4762,3175,3153,21,22,"PUM+J",4
48,"48034",12623,8789,8711,76,78,"PUM+J",7
20,"20042",3180,2056,2053,7,3,"PUM+J",2
1,"1003",1166,843,837,6,6,"PUM+J",0
48,"48095",2324,1568,1555,13,13,"PUM+J",0
48,"48070",527,357,355,0,2,"PUM+J",0
20,"20079",18151,13106,13054,58,52,"PUM+J",11
48,"48086",2024,1371,1358,5,13,"PUM+J",1
48,"48023",579,451,448,0,3,"PUM+J",0
48,"48060",3625,2429,2418,12,11,"PUM+J",2
20,"20045",47031,30933,30787,172,146,"PUM+J",47
20,"20902",14282,9670,9618,52,52,"PUM+J",13
20,"20003",549,360,355,1,5,"PUM+J",0
48,"48044",61957,45253,45063,299,190,"PUM+J",27
20,"20033",858,644,638,1,6,"PUM+J",0
48,"48025",874,667,662,2,5,"PUM+J",0
48,"48062",295,236,236,0,0,"PUM+J",0
20,"20905",160,123,123,2,0,"PUM+J",0
20,"20001",253,163,163,1,0,"PUM+J",0
48,"48043",4591,3337,3325,20,12,"PUM+J",3
48,"48083",6934,4800,4765,21,35,"PUM+J",1
20,"20035",480,361,361,0,0,"PUM+J",0
1,"1056",202,107,107,0,0,"PUM+J",0
48,"48097",1314,886,882,6,4,"PUM+J",0
1,"1058",1414,893,884,1,9,"PUM+J",0
20,"20036",13208,9102,9056,59,46,"PUM+J",13
48,"48035",406,314,314,0,0,"PUM+J",0
1,"1030",141,102,102,0,0,"PUM+J",0
48,"48082",37358,25328,25167,125,161,"PUM+J",17
48,"48909",201,158,157,0,1,"PUM+J",0
48,"48080",9916,6849,6793,44,56,"PUM+J",2
48,"48015",33077,22441,22295,145,146,"PUM+J",18
48,"48074",3275,2308,2295,11,13,"PUM+J",2
1,"1901",2473,1633,1612,9,21,"PUM+J",2
48,"48039",254,221,220,2,1,"PUM+J",0
48,"48067",1133,810,805,0,5,"PUM+J",0
48,"48069",13131,9211,9162,55,49,"PUM+J",11
20,"20043",1718,1189,1183,2,6,"PUM+J",0
20,"20071",15062,10442,10407,47,35,"PUM+J",8
1,"1044",232,151,148,2,3,"PUM+J",0
1,"1051",3569,2259,2244,3,15,"PUM+J",1
48,"48001",5899,4094,4074,19,20,"PUM+J",2
48,"48910",2811,1952,1942,11,10,"PUM+J",2
1,"1046",639,433,432,2,1,"PUM+J",0
20,"20029",4264,3116,3104,14,12,"PUM+J",4
1,"1032",498,363,353,1,10,"PUM+J",0
1,"1017",817,537,532,3,5,"PUM+J",3
48,"48045",5207,3851,3817,9,34,"PUM+J",1
1,"1016",428,194,192,4,2,"PUM+J",0
48,"48004",326,245,245,1,0,"PUM+J",0
20,"20050",275,174,174,2,0,"PUM+J",0
48,"48079",397,289,287,1,2,"PUM+J",0
20,"20061",4427,3073,3053,13,20,"PUM+J",3
20,"20903",5033,3355,3341,18,14,"PUM+J",1
1,"1010",2315,1705,1688,6,17,"PUM+J",2
1,"1049",130,94,94,1,0,"PUM+J",0
48,"48903",1800,1358,1353,4,5,"PUM+J",0
20,"20073",4707,3272,3260,14,12,"PUM+J",1
48,"48065",3285,2341,2326,8,15,"PUM+J",3
48,"48061",789,602,601,2,1,"PUM+J",3
48,"48046",12626,9300,9250,31,50,"PUM+J",4
1,"1060",204,159,151,0,8,"PUM+J",0
48,"48021",1325,891,888,3,3,"PUM+J",0
1,"1055",839,557,552,11,5,"PUM+J",1
48,"48089",3540,2561,2555,7,6,"PUM+J",0
1,"1023",262,193,190,1,3,"PUM+J",0
1,"1041",150,103,102,1,1,"PUM+J",0
48,"48032",5762,4287,4262,14,25,"PUM+J",0
20,"20041",241,143,142,2,1,"PUM+J",0
48,"48913",1236,899,890,8,9,"PUM+J",0
1,"1902",723,485,478,8,7,"PUM+J",0
20,"20053",4856,3169,3153,15,16,"PUM+J",0
20,"20047",455,314,314,1,0,"PUM+J",0
48,"48007",389,243,243,0,0,"PUM+J",0
20,"20906",128,87,87,0,0,"PUM+J",0
48,"48915",339,245,243,0,2,"PUM+J",0
20,"20010",1524,1057,1053,5,4,"PUM+J",0
48,"48033",217,162,162,1,0,"PUM+J",0
20,"20056",4077,2796,2781,12,15,"PUM+J",1
20,"20081",7690,5382,5363,31,19,"PUM+J",4
48,"48042",1359,1055,1045,7,10,"PUM+J",0
20,"20030",21147,14598,14521,92,77,"PUM+J",16
20,"20054",461,294,294,1,0,"PUM+J",0
20,"20007",337,223,221,2,2,"PUM+J",0
1,"1039",188,150,147,2,3,"PUM+J",0
1,"1014",366,271,266,2,5,"PUM+J",0
48,"48071",6013,4240,4205,23,35,"PUM+J",2
20,"20009",11369,7402,7355,32,47,"PUM+J",6
48,"48026",1132,834,832,2,2,"PUM+J",0
48,"48011",9640,6753,6722,41,31,"PUM+J",4
48,"48036",24015,16501,16425,83,76,"PUM+J",15
20,"20020",114,64,64,0,0,"PUM+J",0
20,"20031",185,113,112,3,1,"PUM+J",0
1,"1059",189597,128849,127910,688,939,"PUM+J",258
20,"20021",185,104,104,2,0,"PUM+J",0
48,"48081",1903,1455,1447,7,8,"PUM+J",0
48,"48013",79353,53591,53205,331,386,"PUM+J",49
1,"1004",1357,952,945,5,7,"PUM+J",0
48,"48072",965,730,724,3,6,"PUM+J",0
20,"20063",8023,5611,5597,19,14,"PUM+J",3
48,"48051",220,151,150,0,1,"PUM+J",0
1,"1002",8014,5838,5786,24,52,"PUM+J",12
1,"1061",155,116,116,1,0,"PUM+J",0
1,"1047",982,653,642,6,11,"PUM+J",1
48,"48091",1078,758,757,5,1,"PUM+J",0
48,"48904",3547,2563,2541,18,22,"PUM+J",0
20,"20013",5433,3906,3893,24,13,"PUM+J",1
20,"20051",6736,4829,4804,22,25,"PUM+J",2
20,"20074",11520,8379,8357,19,22,"PUM+J",3
48,"48063",354,256,252,1,4,"PUM+J",1
48,"48057",5730,4126,4115,14,11,"PUM+J",1
1,"1009",1258,839,833,2,6,"PUM+J",1
48,"48078",37858,25959,25819,157,140,"PUM+J",20
20,"20064",12395,7959,7916,42,43,"PUM+J",13
20,"20076",7013,5011,4991,16,20,"PUM+J",0
48,"48055",2603,1833,1820,14,13,"PUM+J",1
20,"20075",4312,2848,2845,8,3,"PUM+J",1
20,"20077",5269,3845,3830,9,15,"PUM+J",4
48,"48054",25063,17705,17597,122,108,"PUM+J",13
20,"20004",230,133,133,2,0,"PUM+J",0
1,"1001",2020,1385,1372,5,13,"PUM+J",2
48,"48019",3429,2424,2411,14,13,"PUM+J",1
20,"20034",3200,2193,2180,8,13,"PUM+J",1
48,"48906",736,550,548,2,2,"PUM+J",0
48,"48088",134,95,95,0,0,"PUM+J",0
48,"48037",696,497,485,0,12,"PUM+J",0
1,"1062",318,221,219,2,2,"PUM+J",0
20,"20070",1084,798,795,7,3,"PUM+J",0
20,"20014",1161,699,693,0,6,"PUM+J",1
20,"20044",355,261,261,1,0,"PUM+J",1
1,"1019",148,112,112,0,0,"PUM+J",0
48,"48017",13121,8929,8886,45,43,"PUM+J",2
48,"48047",147,105,105,2,0,"PUM+J",1
20,"20040",15771,10549,10481,54,68,"PUM+J",5
48,"48094",3121,2201,2188,7,13,"PUM+J",0
48,"48056",980,731,728,3,3,"PUM+J",0
48,"48085",10716,7707,7679,51,28,"PUM+J",7
20,"20060",87,75,75,0,0,"PUM+J",0
48,"48028",682,551,548,3,3,"PUM+J",1
48,"48075",2066,1524,1508,9,16,"PUM+J",0
20,"20046",1243,822,816,1,6,"PUM+J",0
48,"48009",774,585,578,0,7,"PUM+J",0
1,"1022",755,532,523,4,9,"PUM+J",2
48,"48084",21780,14368,14271,79,97,"PUM+J",11
20,"20066",437,288,286,1,2,"PUM+J",0
48,"48041",687,548,547,4,1,"PUM+J",0
48,"48022",2305,1434,1425,11,9,"PUM+J",0
48,"48003",14518,10375,10310,49,65,"PUM+J",8
48,"48068",1534,1154,1149,1,5,"PUM+J",0
20,"20049",4195,2918,2901,12,17,"PUM+J",2
48,"48912",2321,1684,1670,8,14,"PUM+J",0
20,"20023",441,254,251,1,3,"PUM+J",0
48,"48038",1151,829,829,1,0,"PUM+J",1
48,"48059",402,299,297,0,2,"PUM+J",0
20,"20080",7705,5276,5244,21,32,"PUM+J",6
20,"20016",1529,887,883,3,4,"PUM+J",0
48,"48031",303,221,221,0,0,"PUM+J",0
48,"48087",437,335,332,0,3,"PUM+J",0
25,"25114",96,83,82,1,1,"PUM+J",0
43,"43056",803,566,558,6,8,"PUM+J",2
17,"17196",252,200,200,1,0,"PUM+J",3
25,"25049",156,110,109,1,1,"PUM+J",0
17,"17112",198,148,147,3,1,"PUM+J",4
17,"17234",181,129,129,1,0,"PUM+J",0
8,"8151",450,351,346,5,5,"PUM+J",0
43,"43141",109,85,84,0,1,"PUM+J",0
8,"8290",1549,1254,1248,6,6,"PUM+J",0
43,"43013",4406,3004,2975,19,29,"PUM+J",1
43,"43092",7308,4703,4679,33,24,"PUM+J",1
17,"17032",1745,1139,1133,6,6,"PUM+J",0
43,"43907",4386,3083,3067,24,16,"PUM+J",4
25,"25019",4606,2860,2829,19,31,"PUM+J",5
17,"17216",158,122,121,0,1,"PUM+J",0
17,"17123",343,286,284,2,2,"PUM+J",0
25,"25059",800,546,534,5,12,"PUM+J",0
8,"8022",12213,8594,8558,42,36,"PUM+J",1
8,"8011",1739,1360,1353,10,7,"PUM+J",0
17,"17205",209,167,166,0,1,"PUM+J",0
17,"17028",297,216,214,2,2,"PUM+J",0
43,"43002",1890,1233,1210,12,23,"PUM+J",2
43,"43048",768,564,554,7,10,"PUM+J",1
25,"25139",477,348,346,3,2,"PUM+J",0
8,"8231",21269,14655,14573,111,82,"PUM+J",8
17,"17133",1262,976,964,7,12,"PUM+J",0
17,"17199",6984,4919,4894,39,25,"PUM+J",3
43,"43030",483,356,351,2,5,"PUM+J",0
8,"8115",3826,2777,2770,31,7,"PUM+J",2
25,"25134",605,457,456,5,1,"PUM+J",0
17,"17020",3677,2851,2835,14,16,"PUM+J",1
43,"43119",849,591,588,8,3,"PUM+J",0
17,"17175",559,348,343,5,5,"PUM+J",1
25,"25150",167,132,130,2,2,"PUM+J",0
43,"43901",8796,5431,5390,41,41,"PUM+J",2
43,"43082",350,276,271,5,5,"PUM+J",0
25,"25238",212,161,160,0,1,"PUM+J",0
8,"8247",982,799,798,4,1,"PUM+J",0
8,"8075",4144,2951,2943,20,8,"PUM+J",0
43,"43098",362,274,274,1,0,"PUM+J",0
17,"17147",7916,5672,5641,41,31,"PUM+J",7
17,"17056",1780,1379,1374,13,5,"PUM+J",1
8,"8305",27661,20346,20221,118,125,"PUM+J",11
43,"43127",775,607,606,3,1,"PUM+J",0
17,"17151",179,131,130,0,1,"PUM+J",0
25,"25191",321,227,222,2,5,"PUM+J",0
25,"25212",219,176,176,1,0,"PUM+J",0
8,"8240",9469,7351,7327,39,24,"PUM+J",4
8,"8083",1672,1433,1430,6,3,"PUM+J",0
17,"17223",808,566,563,1,3,"PUM+J",1
8,"8169",48478,35283,35114,278,169,"PUM+J",19
25,"25249",176,129,127,2,2,"PUM+J",0
17,"17039",1726,1306,1297,7,9,"PUM+J",1
25,"25205",563,412,407,3,5,"PUM+J",0
25,"25024",352,248,247,0,1,"PUM+J",0
8,"8108",5181,3880,3861,30,19,"PUM+J",1
17,"17046",709,537,531,2,6,"PUM+J",0
25,"25244",374,275,270,1,5,"PUM+J",0
25,"25056",209,145,145,0,0,"PUM+J",0
8,"8297",138,99,99,0,0,"PUM+J",0
17,"17160",14756,9892,9852,58,40,"PUM+J",5
8,"8146",1384,1030,1027,8,3,"PUM+J",0
17,"17163",2868,2281,2268,13,13,"PUM+J",2
25,"25093",629,455,443,5,12,"PUM+J",0
43,"43903",2332,1502,1487,18,15,"PUM+J",0
25,"25153",190,139,136,0,3,"PUM+J",0
8,"8040",11116,7923,7891,49,32,"PUM+J",4
43,"43074",1818,1341,1336,2,5,"PUM+J",0
8,"8206",744,604,599,5,5,"PUM+J",0
43,"43083",146,110,109,0,1,"PUM+J",0
43,"43162",4436,3191,3163,24,28,"PUM+J",3
25,"25163",230,162,161,0,1,"PUM+J",0
25,"25003",3717,2577,2561,15,16,"PUM+J",2
25,"25029",1590,1190,1185,4,5,"PUM+J",1
43,"43149",690,512,509,3,3,"PUM+J",0
43,"43071",896,652,647,3,5,"PUM+J",0
8,"8168",388,280,279,3,1,"PUM+J",0
43,"43161",17103,11905,11838,82,67,"PUM+J",7
25,"25101",536,412,411,5,1,"PUM+J",0
43,"43172",334,248,243,4,5,"PUM+J",0
43,"43050",2695,1742,1730,10,12,"PUM+J",0
17,"17093",913,637,634,5,3,"PUM+J",2
8,"8077",34690,25896,25767,164,129,"PUM+J",12
17,"17080",144,113,113,1,0,"PUM+J",0
8,"8105",9741,6946,6896,62,50,"PUM+J",1
43,"43016",3470,2547,2508,15,39,"PUM+J",1
17,"17105",248,187,186,2,1,"PUM+J",0
8,"8032",2100,1472,1465,12,7,"PUM+J",0
17,"17012",1175,845,842,4,3,"PUM+J",0
43,"43904",2864,1881,1851,20,30,"PUM+J",6
8,"8100",2083,1707,1699,13,8,"PUM+J",1
17,"17005",457,322,320,3,2,"PUM+J",1
8,"8136",11692,8527,8456,98,71,"PUM+J",9
25,"25180",227,158,155,1,3,"PUM+J",0
17,"17187",625,496,492,3,4,"PUM+J",0
8,"8068",6863,5064,5041,40,23,"PUM+J",0
43,"43104",1767,1285,1271,4,14,"PUM+J",0
8,"8284",12597,8244,8183,60,61,"PUM+J",6
17,"17200",624,469,467,6,2,"PUM+J",0
17,"17109",704,542,539,2,3,"PUM+J",0
8,"8191",5302,3872,3860,21,12,"PUM+J",1
25,"25222",69,58,58,0,0,"PUM+J",0
43,"43019",1332,911,904,8,7,"PUM+J",1
17,"17117",14497,9438,9382,66,56,"PUM+J",7
8,"8279",156327,112605,112030,952,575,"PUM+J",58
8,"8291",4972,3531,3519,23,12,"PUM+J",1
25,"25901",289,214,211,4,3,"PUM+J",0
43,"43101",146,112,112,2,0,"PUM+J",0
25,"25194",410,292,289,3,3,"PUM+J",0
25,"25145",75,59,59,0,0,"PUM+J",0
8,"8012",1726,1323,1309,17,14,"PUM+J",0
8,"8138",4461,3286,3259,27,27,"PUM+J",1
43,"43176",746,564,561,2,3,"PUM+J",0
25,"25130",181,130,128,0,2,"PUM+J",0
25,"25004",582,437,432,3,5,"PUM+J",2
17,"17171",177,138,137,0,1,"PUM+J",0
43,"43039",101,77,77,0,0,"PUM+J",0
43,"43150",1233,954,941,6,13,"PUM+J",0
17,"17013",2765,1999,1985,15,14,"PUM+J",2
17,"17188",171,134,134,1,0,"PUM+J",0
17,"17192",143,107,104,0,3,"PUM+J",1
25,"25206",247,188,188,2,0,"PUM+J",2
8,"8078",216,154,154,2,0,"PUM+J",0
8,"8182",2922,2041,2031,10,10,"PUM+J",1
17,"17097",200,170,167,2,3,"PUM+J",0
17,"17050",664,554,550,10,4,"PUM+J",0
8,"8905",2329,1872,1863,7,9,"PUM+J",5
17,"17068",253,191,191,0,0,"PUM+J",0
43,"43173",98,70,68,0,2,"PUM+J",0
25,"25158",1605,1193,1180,8,13,"PUM+J",0
17,"17161",1023,844,843,5,1,"PUM+J",1
17,"17075",340,257,256,2,1,"PUM+J",0
25,"25228",3143,2261,2250,18,11,"PUM+J",3
43,"43144",1245,975,966,1,9,"PUM+J",1
43,"43004",6288,4314,4262,36,52,"PUM+J",2
43,"43129",4607,3284,3261,21,23,"PUM+J",1
17,"17178",1065,774,771,9,3,"PUM+J",0
8,"8171",2046,1520,1510,13,10,"PUM+J",3
25,"25099",1285,908,904,6,4,"PUM+J",1
17,"17095",20044,12638,12576,88,62,"PUM+J",15
25,"25033",1120,838,831,5,7,"PUM+J",0
25,"25069",426,296,294,0,2,"PUM+J",0
8,"8301",49348,36261,36045,292,216,"PUM+J",28
25,"25034",2271,1616,1600,12,16,"PUM+J",0
8,"8005",6425,4830,4816,28,14,"PUM+J",2
8,"8139",172,148,147,2,1,"PUM+J",0
43,"43107",387,285,285,3,0,"PUM+J",1
25,"25183",520,372,370,4,2,"PUM+J",1
43,"43124",468,343,339,3,4,"PUM+J",0
17,"17213",5567,3654,3630,19,24,"PUM+J",5
43,"43080",230,192,192,2,0,"PUM+J",0
17,"17126",316,269,269,1,0,"PUM+J",0
43,"43125",884,658,645,12,13,"PUM+J",0
25,"25186",207,162,161,0,1,"PUM+J",0
25,"25088",96,73,73,0,0,"PUM+J",0
17,"17004",529,411,410,3,1,"PUM+J",1
8,"8131",745,552,550,3,2,"PUM+J",0
8,"8307",49499,35471,35312,199,159,"PUM+J",21
8,"8264",4608,3459,3444,30,15,"PUM+J",2
25,"25030",117,76,76,0,0,"PUM+J",0
25,"25220",991,768,762,1,6,"PUM+J",1
17,"17225",205,150,150,1,0,"PUM+J",0
17,"17001",575,428,426,4,2,"PUM+J",0
17,"17153",189,150,149,1,1,"PUM+J",0
25,"25254",704,511,508,2,3,"PUM+J",0
25,"25913",88,72,72,1,0,"PUM+J",0
43,"43075",86,65,63,0,2,"PUM+J",0
8,"8080",40,27,27,3,0,"PUM+J",0
8,"8034",820,644,640,0,4,"PUM+J",0
43,"43037",18216,11749,11672,70,77,"PUM+J",15
43,"43018",384,297,297,2,0,"PUM+J",0
17,"17049",3246,2527,2502,12,25,"PUM+J",0
43,"43089",279,201,201,1,0,"PUM+J",0
8,"8110",13671,9362,9311,60,51,"PUM+J",4
8,"8148",2344,1655,1646,13,9,"PUM+J",2
43,"43001",708,510,507,0,3,"PUM+J",0
17,"17079",65572,47740,47502,279,238,"PUM+J",38
17,"17172",452,336,335,5,1,"PUM+J",0
25,"25035",364,257,256,0,1,"PUM+J",0
25,"25223",890,673,666,7,7,"PUM+J",1
25,"25122",1929,1408,1398,21,10,"PUM+J",1
17,"17071",1134,943,940,1,3,"PUM+J",0
17,"17066",27378,16755,16644,122,111,"PUM+J",22
17,"17197",128,97,97,0,0,"PUM+J",0
8,"8098",2438,1781,1778,21,3,"PUM+J",1
43,"43106",784,605,598,3,7,"PUM+J",1
43,"43033",766,555,555,4,0,"PUM+J",0
25,"25142",359,283,283,2,0,"PUM+J",0
25,"25011",5271,3529,3505,21,24,"PUM+J",2
8,"8087",144,120,120,0,0,"PUM+J",0
17,"17201",137,103,103,0,0,"PUM+J",0
25,"25079",276,202,202,0,0,"PUM+J",0
8,"8067",5746,4299,4270,24,29,"PUM+J",0
25,"25078",995,746,743,7,3,"PUM+J",0
17,"17065",321,264,263,3,1,"PUM+J",0
8,"8153",573,457,452,3,5,"PUM+J",0
17,"17220",801,649,647,2,2,"PUM+J",0
8,"8086",14137,9971,9912,77,59,"PUM+J",4
43,"43011",1086,862,860,5,2,"PUM+J",0
25,"25001",143,102,102,1,0,"PUM+J",0
8,"8033",13262,9887,9833,64,54,"PUM+J",2
8,"8144",722,551,545,3,6,"PUM+J",0
8,"8141",4578,3369,3357,28,12,"PUM+J",0
25,"25907",500,366,364,5,2,"PUM+J",0
25,"25102",647,484,482,5,2,"PUM+J",1
17,"17169",2511,1901,1890,8,11,"PUM+J",3
8,"8239",467,362,361,3,1,"PUM+J",0
8,"8276",241,179,179,3,0,"PUM+J",1
43,"43135",339,255,255,0,0,"PUM+J",0
17,"17086",1769,1116,1109,6,7,"PUM+J",1
17,"17022",7043,4940,4903,34,37,"PUM+J",4
8,"8143",2727,1989,1977,19,12,"PUM+J",2
17,"17036",2639,1944,1934,21,10,"PUM+J",4
8,"8018",2540,1862,1855,7,7,"PUM+J",1
17,"17128",321,239,238,1,1,"PUM+J",0
8,"8274",4640,3385,3363,24,22,"PUM+J",1
17,"17010",332,252,251,2,1,"PUM+J",0
17,"17164",3918,2856,2838,17,18,"PUM+J",1
17,"17230",504,383,382,3,1,"PUM+J",0
8,"8252",24885,18507,18383,162,124,"PUM+J",7
17,"17088",599,467,465,3,2,"PUM+J",2
25,"25208",337,242,241,2,1,"PUM+J",0
17,"17136",196,150,150,0,0,"PUM+J",0
8,"8292",1074,796,790,2,6,"PUM+J",3
25,"25245",427,312,308,4,4,"PUM+J",1
8,"8204",3141,2395,2383,16,12,"PUM+J",2
17,"17185",2260,1657,1652,8,5,"PUM+J",1
25,"25173",1646,1180,1169,6,11,"PUM+J",0
25,"25202",108,72,72,2,0,"PUM+J",0
17,"17094",1058,757,747,3,10,"PUM+J",0
17,"17150",1444,1177,1163,13,14,"PUM+J",1
25,"25242",688,494,488,5,6,"PUM+J",0
25,"25251",708,526,524,1,2,"PUM+J",0
43,"43059",250,193,192,1,1,"PUM+J",1
17,"17180",8508,5977,5953,38,24,"PUM+J",4
43,"43116",465,356,352,0,4,"PUM+J",0
25,"25097",89,71,71,2,0,"PUM+J",0
25,"25196",108,75,75,1,0,"PUM+J",0
43,"43102",458,331,324,2,7,"PUM+J",0
25,"25151",731,555,549,1,6,"PUM+J",0
17,"17057",968,770,769,7,1,"PUM+J",0
17,"17085",293,239,238,0,1,"PUM+J",0
17,"17177",562,426,423,1,3,"PUM+J",0
17,"17224",299,226,222,2,4,"PUM+J",0
8,"8037",1947,1547,1543,11,4,"PUM+J",0
17,"17111",984,728,728,7,0,"PUM+J",1
43,"43095",2583,1864,1854,12,10,"PUM+J",1
25,"25113",1114,873,863,3,10,"PUM+J",1
8,"8064",1956,1439,1423,7,16,"PUM+J",1
17,"17025",1182,943,938,5,5,"PUM+J",0
17,"17030",654,460,459,1,1,"PUM+J",0
25,"25172",1762,1332,1323,8,9,"PUM+J",0
43,"43103",908,705,701,9,4,"PUM+J",0
25,"25149",1377,1034,1028,9,6,"PUM+J",0
8,"8215",2617,1954,1946,22,8,"PUM+J",1
8,"8224",885,653,652,6,1,"PUM+J",1
43,"43053",186,135,134,0,1,"PUM+J",0
8,"8052",140,102,102,1,0,"PUM+J",0
17,"17069",359,270,267,2,3,"PUM+J",1
25,"25133",671,481,479,1,2,"PUM+J",0
17,"17037",112,86,86,1,0,"PUM+J",0
8,"8244",6099,4733,4706,39,27,"PUM+J",3
8,"8060",139,110,108,1,2,"PUM+J",0
25,"25067",702,500,494,8,6,"PUM+J",0
17,"17040",551,440,439,5,1,"PUM+J",2
43,"43065",379,281,277,4,4,"PUM+J",0
8,"8009",9531,7200,7171,47,29,"PUM+J",2
17,"17144",211,162,159,3,3,"PUM+J",0
25,"25070",817,619,617,11,2,"PUM+J",2
17,"17096",159,116,116,3,0,"PUM+J",0
17,"17116",351,261,261,2,0,"PUM+J",1
8,"8287",1067,853,844,4,9,"PUM+J",0
8,"8229",521,418,417,3,1,"PUM+J",0
17,"17208",978,723,719,6,4,"PUM+J",0
43,"43005",3677,2505,2493,17,12,"PUM+J",2
43,"43108",1787,1293,1282,6,11,"PUM+J",0
25,"25128",125,85,85,0,0,"PUM+J",0
17,"17176",128,111,111,0,0,"PUM+J",0
8,"8063",469,390,390,4,0,"PUM+J",0
43,"43134",281,217,215,5,2,"PUM+J",1
8,"8270",19014,13635,13594,74,41,"PUM+J",4
17,"17198",437,307,306,0,1,"PUM+J",0
17,"17092",3462,2414,2389,14,25,"PUM+J",2
8,"8296",1869,1412,1408,10,4,"PUM+J",1
8,"8221",12793,10123,10079,73,44,"PUM+J",8
43,"43073",80,67,65,0,2,"PUM+J",0
17,"17129",143,108,108,2,0,"PUM+J",0
25,"25141",154,105,104,3,1,"PUM+J",0
8,"8019",1122912,824423,821037,5287,3386,"PUM+J",489
17,"17118",12934,8723,8665,38,58,"PUM+J",25
43,"43097",407,331,328,4,3,"PUM+J",0
17,"17189",1481,1228,1223,5,5,"PUM+J",2
8,"8102",28940,21108,21014,157,94,"PUM+J",12
8,"8180",27198,19822,19704,160,118,"PUM+J",10
8,"8128",579,428,423,4,5,"PUM+J",0
43,"43159",76,60,60,0,0,"PUM+J",0
8,"8091",5428,4048,4024,20,24,"PUM+J",1
8,"8127",2254,1548,1544,10,4,"PUM+J",0
8,"8181",8133,5949,5924,31,25,"PUM+J",2
8,"8133",123,96,94,5,2,"PUM+J",0
17,"17181",3458,2454,2443,18,11,"PUM+J",3
17,"17125",136,100,100,3,0,"PUM+J",0
8,"8090",142,116,116,0,0,"PUM+J",0
8,"8027",724,584,582,1,2,"PUM+J",1
43,"43110",247,178,178,2,0,"PUM+J",0
43,"43031",1447,1085,1072,13,13,"PUM+J",2
17,"17227",147,104,104,0,0,"PUM+J",1
43,"43128",910,665,658,6,7,"PUM+J",0
43,"43906",2113,1490,1480,12,10,"PUM+J",0
25,"25227",656,476,476,2,0,"PUM+J",0
8,"8004",208,177,177,1,0,"PUM+J",0
25,"25217",10891,7651,7610,63,41,"PUM+J",5
17,"17029",207,154,154,1,0,"PUM+J",0
8,"8106",7500,5442,5410,43,32,"PUM+J",1
25,"25125",383,265,265,3,0,"PUM+J",0
43,"43168",83,55,55,1,0,"PUM+J",0
8,"8222",1821,1439,1424,7,15,"PUM+J",0
8,"8017",2808,2033,2016,16,17,"PUM+J",2
25,"25042",204,149,149,5,0,"PUM+J",0
17,"17142",2713,2166,2159,18,7,"PUM+J",1
43,"43079",364,290,289,2,1,"PUM+J",0
17,"17182",269,195,195,0,0,"PUM+J",0
8,"8001",9097,6860,6818,39,42,"PUM+J",4
25,"25123",189,135,133,0,2,"PUM+J",0
17,"17042",410,299,297,5,2,"PUM+J",0
8,"8269",2729,2114,2105,9,9,"PUM+J",0
43,"43111",2129,1412,1401,8,11,"PUM+J",1
25,"25135",997,675,671,3,4,"PUM+J",0
43,"43167",391,307,307,2,0,"PUM+J",1
25,"25203",8809,5813,5770,40,43,"PUM+J",3
43,"43100",3557,2666,2649,22,17,"PUM+J",2
17,"17033",5647,3879,3852,25,27,"PUM+J",1
17,"17212",145,111,109,0,2,"PUM+J",0
25,"25179",169,132,132,0,0,"PUM+J",0
8,"8220",2411,2010,2001,8,9,"PUM+J",0
8,"8154",697,541,539,3,2,"PUM+J",0
43,"43047",4234,2590,2564,19,26,"PUM+J",2
43,"43026",756,576,574,1,2,"PUM+J",1
17,"17121",225,166,163,2,3,"PUM+J",0
8,"8251",5130,3719,3698,20,21,"PUM+J",2
25,"25096",885,597,591,2,6,"PUM+J",0
17,"17193",4351,2945,2927,21,18,"PUM+J",4
8,"8196",19542,14264,14185,123,79,"PUM+J",5
25,"25105",105,88,87,4,1,"PUM+J",0
17,"17210",572,414,411,2,3,"PUM+J",0
17,"17073",1939,1649,1640,11,9,"PUM+J",2
8,"8262",6945,4649,4599,38,50,"PUM+J",2
8,"8070",269,215,211,1,4,"PUM+J",0
25,"25215",339,249,249,5,0,"PUM+J",1
17,"17034",7289,4880,4862,23,18,"PUM+J",5
25,"25156",765,571,567,3,4,"PUM+J",0
43,"43051",9194,6133,6048,44,85,"PUM+J",5
25,"25050",3256,2260,2249,20,11,"PUM+J",0
8,"8055",542,426,424,3,2,"PUM+J",0
43,"43045",143,114,113,0,1,"PUM+J",0
8,"8094",1588,1258,1252,7,6,"PUM+J",0
8,"8217",25466,19864,19773,129,91,"PUM+J",9
25,"25115",803,601,593,4,8,"PUM+J",0
8,"8111",216,195,194,2,1,"PUM+J",0
43,"43072",90,69,67,1,2,"PUM+J",0
25,"25098",227,160,158,1,2,"PUM+J",0
17,"17130",325,270,270,1,0,"PUM+J",0
17,"17062",5982,4025,4001,19,24,"PUM+J",0
25,"25127",217,145,145,1,0,"PUM+J",0
8,"8200",62225,45235,44991,306,244,"PUM+J",34
25,"25014",246,184,178,0,6,"PUM+J",0
43,"43152",435,348,342,2,6,"PUM+J",0
8,"8216",25,17,17,0,0,"PUM+J",0
8,"8003",7213,5425,5409,41,16,"PUM+J",2
25,"25234",4139,2786,2772,13,14,"PUM+J",1
25,"25166",170,131,130,2,1,"PUM+J",0
17,"17083",2971,2164,2154,13,10,"PUM+J",0
8,"8268",975,729,723,6,6,"PUM+J",0
25,"25910",91,63,63,0,0,"PUM+J",0
8,"8193",988,739,737,10,2,"PUM+J",0
25,"25060",71,42,42,0,0,"PUM+J",0
25,"25912",841,620,619,5,1,"PUM+J",0
25,"25031",57,32,32,0,0,"PUM+J",0
8,"8043",3414,2429,2422,15,7,"PUM+J",0
25,"25086",525,410,407,3,3,"PUM+J",0
25,"25121",632,380,374,3,6,"PUM+J",1
43,"43042",2215,1723,1710,18,13,"PUM+J",0
25,"25052",1541,1183,1176,7,7,"PUM+J",1
8,"8059",340,255,250,1,5,"PUM+J",1
8,"8201",455,319,318,12,1,"PUM+J",0
25,"25009",596,448,442,1,6,"PUM+J",1
8,"8002",217,172,172,2,0,"PUM+J",0
8,"8053",2896,1939,1929,13,10,"PUM+J",1
17,"17134",220,175,174,1,1,"PUM+J",0
8,"8166",964,700,697,7,3,"PUM+J",1
25,"25038",1478,1057,1048,10,9,"PUM+J",1
43,"43090",1199,689,686,5,3,"PUM+J",1
43,"43010",334,262,262,2,0,"PUM+J",0
8,"8175",3369,2388,2372,18,16,"PUM+J",0
8,"8185",197,162,162,1,0,"PUM+J",0
25,"25131",394,281,279,3,2,"PUM+J",0
8,"8089",34190,24548,24404,194,144,"PUM+J",16
8,"8073",62934,45699,45407,281,292,"PUM+J",21
17,"17143",145,104,104,0,0,"PUM+J",0
43,"43046",88,69,68,1,1,"PUM+J",0
25,"25089",93,70,68,1,2,"PUM+J",0
43,"43078",835,610,605,7,5,"PUM+J",1
8,"8205",61957,49325,49196,441,129,"PUM+J",31
17,"17087",219,179,177,0,2,"PUM+J",0
25,"25040",10651,7041,6987,57,54,"PUM+J",2
43,"43178",1435,1071,1066,2,5,"PUM+J",2
8,"8117",2489,1954,1941,21,13,"PUM+J",0
43,"43058",95,78,78,0,0,"PUM+J",0
43,"43024",1545,1019,1014,14,5,"PUM+J",1
8,"8026",195,148,146,0,2,"PUM+J",0
8,"8028",1125,744,743,7,1,"PUM+J",0
43,"43055",1970,1548,1535,12,13,"PUM+J",1
17,"17014",66,51,49,0,2,"PUM+J",0
17,"17209",615,472,471,5,1,"PUM+J",0
8,"8248",5687,4187,4165,21,22,"PUM+J",1
25,"25046",410,331,326,4,5,"PUM+J",0
8,"8198",4679,3491,3469,12,22,"PUM+J",3
43,"43158",74,52,50,0,2,"PUM+J",0
17,"17100",193,147,141,0,6,"PUM+J",0
25,"25211",680,470,470,3,0,"PUM+J",0
8,"8241",70,52,52,0,0,"PUM+J",0
17,"17139",1407,1128,1119,8,9,"PUM+J",0
43,"43175",534,363,359,5,4,"PUM+J",1
25,"25209",1586,1115,1102,6,13,"PUM+J",1
8,"8118",17634,13450,13402,80,48,"PUM+J",8
17,"17031",178,117,117,0,0,"PUM+J",2
17,"17191",163,140,140,1,0,"PUM+J",0
8,"8277",168,148,146,1,2,"PUM+J",0
25,"25911",419,298,297,3,1,"PUM+J",0
25,"25164",353,259,255,0,4,"PUM+J",0
43,"43153",11197,7685,7649,53,36,"PUM+J",4
8,"8209",6925,4976,4948,39,28,"PUM+J",0
17,"17145",1410,1040,1032,6,8,"PUM+J",2
8,"8039",413,322,321,1,1,"PUM+J",1
8,"8298",27148,19655,19568,102,87,"PUM+J",4
17,"17023",27314,18677,18546,117,131,"PUM+J",22
25,"25255",390,301,301,0,0,"PUM+J",0
17,"17038",377,303,301,0,2,"PUM+J",0
8,"8300",5927,4609,4589,41,20,"PUM+J",2
43,"43171",14849,10140,10081,76,59,"PUM+J",10
17,"17173",181,143,143,1,0,"PUM+J",0
43,"43020",2291,1712,1688,19,24,"PUM+J",2
8,"8061",1628,1154,1151,15,3,"PUM+J",0
43,"43169",445,388,388,3,0,"PUM+J",1
8,"8145",2712,2060,2049,8,11,"PUM+J",1
8,"8062",1009,778,776,9,2,"PUM+J",0
8,"8246",1692,1345,1340,7,5,"PUM+J",0
17,"17003",103,85,85,0,0,"PUM+J",0
25,"25182",1043,763,760,8,3,"PUM+J",1
43,"43115",128,106,106,0,0,"PUM+J",0
25,"25248",870,676,675,5,1,"PUM+J",0
43,"43163",26162,17276,17128,98,148,"PUM+J",25
25,"25129",161,113,112,0,1,"PUM+J",0
8,"8082",1164,796,780,5,16,"PUM+J",1
8,"8066",1466,1109,1104,7,5,"PUM+J",0
43,"43021",349,245,243,2,2,"PUM+J",0
25,"25124",160,102,101,1,1,"PUM+J",0
17,"17183",253,197,197,2,0,"PUM+J",1
8,"8235",3875,3004,2996,19,8,"PUM+J",0
8,"8036",163,122,122,0,0,"PUM+J",1
43,"43070",243,194,193,0,1,"PUM+J",0
17,"17232",146,111,111,0,0,"PUM+J",0
8,"8289",4473,3379,3371,25,8,"PUM+J",0
43,"43132",375,295,291,1,4,"PUM+J",1
25,"25136",95,74,74,2,0,"PUM+J",0
25,"25155",616,446,443,2,3,"PUM+J",0
8,"8006",11774,8375,8329,53,46,"PUM+J",2
43,"43034",465,365,365,5,0,"PUM+J",0
17,"17052",135,93,92,0,1,"PUM+J",0
8,"8007",6795,5099,5081,29,18,"PUM+J",1
43,"43130",169,131,130,2,1,"PUM+J",0
17,"17054",342,250,250,2,0,"PUM+J",0
17,"17016",737,570,563,2,7,"PUM+J",0
25,"25015",336,234,233,3,1,"PUM+J",0
8,"8113",52589,36864,36690,244,174,"PUM+J",9
43,"43052",927,680,674,7,6,"PUM+J",2
25,"25013",2099,1430,1414,13,16,"PUM+J",2
8,"8025",1573,1170,1160,9,10,"PUM+J",0
8,"8157",8574,6514,6472,47,42,"PUM+J",3
17,"17064",324,249,247,2,2,"PUM+J",0
43,"43017",112,94,94,1,0,"PUM+J",0
25,"25036",180,124,124,1,0,"PUM+J",0
8,"8081",349,274,270,0,4,"PUM+J",0
25,"25037",361,270,269,4,1,"PUM+J",0
43,"43038",22070,15127,15018,113,109,"PUM+J",11
17,"17103",5057,3196,3174,21,22,"PUM+J",3
25,"25152",148,106,106,0,0,"PUM+J",0
43,"43006",676,462,462,3,0,"PUM+J",1
25,"25219",146,111,111,1,0,"PUM+J",0
43,"43109",2706,1751,1738,17,13,"PUM+J",2
8,"8218",8091,5899,5869,50,30,"PUM+J",2
43,"43027",168,129,129,3,0,"PUM+J",0
8,"8122",1733,1179,1175,4,4,"PUM+J",0
17,"17077",565,395,394,2,1,"PUM+J",0
8,"8261",2405,1726,1718,11,8,"PUM+J",2
17,"17070",110,87,87,0,0,"PUM+J",0
8,"8178",444,363,361,2,2,"PUM+J",1
43,"43044",3962,2751,2719,33,32,"PUM+J",3
8,"8109",207,176,174,0,2,"PUM+J",0
8,"8271",66,48,47,2,1,"PUM+J",0
8,"8158",3094,2261,2251,11,10,"PUM+J",0
8,"8097",1103,845,840,4,5,"PUM+J",0
43,"43066",158,108,108,1,0,"PUM+J",0
17,"17186",3834,2980,2954,17,26,"PUM+J",4
17,"17119",71,53,52,3,1,"PUM+J",0
25,"25092",125,93,92,0,1,"PUM+J",0
17,"17084",228,163,162,1,1,"PUM+J",0
8,"8120",7129,5649,5621,51,28,"PUM+J",2
43,"43145",4209,3193,3170,17,23,"PUM+J",5
43,"43062",269,229,226,5,3,"PUM+J",0
43,"43036",869,565,557,7,8,"PUM+J",1
8,"8199",648,509,508,3,1,"PUM+J",0
8,"8099",753,529,529,4,0,"PUM+J",0
17,"17114",23268,16423,16333,111,90,"PUM+J",15
17,"17099",78,55,55,0,0,"PUM+J",0
25,"25010",194,138,136,0,2,"PUM+J",0
43,"43133",5627,3794,3773,31,21,"PUM+J",3
17,"17159",622,459,459,1,0,"PUM+J",0
8,"8306",535,368,368,5,0,"PUM+J",1
25,"25047",956,745,736,14,9,"PUM+J",3
8,"8045",65,44,43,0,1,"PUM+J",0
8,"8010",4224,3109,3090,22,19,"PUM+J",1
43,"43177",276,229,227,2,2,"PUM+J",0
8,"8208",5793,4267,4244,21,23,"PUM+J",1
43,"43012",3700,2882,2858,20,24,"PUM+J",4
43,"43029",312,241,240,1,1,"PUM+J",0
8,"8160",317,234,234,0,0,"PUM+J",0
17,"17115",276,208,208,4,0,"PUM+J",0
17,"17190",834,624,619,1,5,"PUM+J",2
17,"17184",1261,1016,1010,7,6,"PUM+J",0
8,"8904",10516,7068,7025,54,43,"PUM+J",3
8,"8130",110,81,81,2,0,"PUM+J",0
17,"17024",281,203,201,4,2,"PUM+J",0
25,"25061",80,51,51,0,0,"PUM+J",0
8,"8273",2390,1871,1855,14,16,"PUM+J",0
17,"17018",494,377,372,4,5,"PUM+J",1
8,"8176",158,119,119,0,0,"PUM+J",0
25,"25157",159,127,126,1,1,"PUM+J",0
8,"8074",11190,7698,7651,51,47,"PUM+J",3
8,"8044",4156,2991,2976,16,15,"PUM+J",4
8,"8303",257,207,205,1,2,"PUM+J",0
8,"8263",21208,15014,14890,111,124,"PUM+J",7
17,"17146",3150,2243,2224,8,19,"PUM+J",4
25,"25045",57,26,26,2,0,"PUM+J",0
17,"17166",547,442,440,0,2,"PUM+J",2
25,"25216",244,186,186,0,0,"PUM+J",0
25,"25902",536,406,403,1,3,"PUM+J",0
8,"8219",15755,12235,12206,72,29,"PUM+J",11
43,"43118",422,338,338,0,0,"PUM+J",0
17,"17078",335,245,245,0,0,"PUM+J",0
25,"25032",65,53,52,0,1,"PUM+J",0
43,"43022",1436,1028,1024,13,4,"PUM+J",1
25,"25006",319,229,229,2,0,"PUM+J",0
43,"43028",2770,1784,1770,7,14,"PUM+J",3
43,"43077",453,306,304,1,2,"PUM+J",0
8,"8161",11826,8001,7951,58,50,"PUM+J",9
25,"25076",131,91,91,0,0,"PUM+J",0
17,"17106",142,114,114,0,0,"PUM+J",0
25,"25239",582,330,330,3,0,"PUM+J",0
25,"25218",88,76,75,2,1,"PUM+J",0
8,"8202",12943,9408,9358,58,50,"PUM+J",1
17,"17061",180,141,139,1,2,"PUM+J",1
25,"25165",271,210,208,0,2,"PUM+J",0
8,"8152",117,94,94,0,0,"PUM+J",0
17,"17048",6284,4077,4048,34,29,"PUM+J",5
43,"43091",125,90,90,1,0,"PUM+J",0
8,"8046",13541,10510,10455,73,55,"PUM+J",9
25,"25197",140,109,109,0,0,"PUM+J",0
43,"43114",370,281,278,1,3,"PUM+J",0
25,"25021",2513,1668,1662,17,6,"PUM+J",1
25,"25094",138,96,93,2,3,"PUM+J",0
17,"17019",1780,1403,1393,5,10,"PUM+J",1
17,"17074",536,403,401,1,2,"PUM+J",0
25,"25120",92888,62740,62389,450,351,"PUM+J",83
8,"8184",55053,38519,38323,298,196,"PUM+J",36
43,"43143",50,40,39,0,1,"PUM+J",0
43,"43015",115,92,91,1,1,"PUM+J",0
17,"17228",285,218,217,0,1,"PUM+J",0
17,"17041",217,150,146,1,4,"PUM+J",0
43,"43035",233,182,182,5,0,"PUM+J",1
25,"25137",8684,5802,5757,48,45,"PUM+J",2
17,"17051",202,161,160,0,1,"PUM+J",0
43,"43902",2751,1794,1776,21,18,"PUM+J",1
25,"25081",281,195,193,3,2,"PUM+J",0
8,"8103",652,476,474,1,2,"PUM+J",0
8,"8211",33934,26136,26000,198,136,"PUM+J",12
43,"43112",245,179,179,3,0,"PUM+J",0
17,"17047",5016,3087,3068,22,19,"PUM+J",2
8,"8058",1808,1280,1262,6,18,"PUM+J",0
8,"8057",61,47,47,1,0,"PUM+J",0
8,"8088",12347,9316,9270,75,46,"PUM+J",2
8,"8020",5243,4117,4100,29,17,"PUM+J",1
17,"17226",884,603,600,4,3,"PUM+J",0
43,"43121",593,404,403,1,1,"PUM+J",0
8,"8282",6731,5333,5317,40,16,"PUM+J",2
17,"17211",837,677,674,6,3,"PUM+J",0
8,"8101",175048,121359,120620,830,739,"PUM+J",73
8,"8164",936,750,747,6,3,"PUM+J",0
8,"8119",6897,5096,5052,31,44,"PUM+J",2
25,"25168",496,399,399,6,0,"PUM+J",0
17,"17035",544,447,447,2,0,"PUM+J",0
17,"17149",370,302,300,1,2,"PUM+J",0
8,"8150",258,207,207,1,0,"PUM+J",0
8,"8021",60,44,44,1,0,"PUM+J",0
8,"8069",3323,2555,2540,21,15,"PUM+J",2
25,"25247",142,89,89,2,0,"PUM+J",0
17,"17021",119,89,87,0,2,"PUM+J",0
25,"25225",531,395,393,0,2,"PUM+J",0
17,"17058",176,128,128,0,0,"PUM+J",0
17,"17107",267,207,205,2,2,"PUM+J",0
43,"43009",1384,966,959,5,7,"PUM+J",1
43,"43064",2027,1456,1445,19,11,"PUM+J",0
8,"8054",9215,6994,6943,38,51,"PUM+J",1
25,"25002",465,324,323,4,1,"PUM+J",0
25,"25126",281,211,210,1,1,"PUM+J",0
17,"17155",14957,9519,9410,71,109,"PUM+J",12
17,"17204",609,429,428,6,1,"PUM+J",0
8,"8236",1564,1145,1133,4,12,"PUM+J",0
8,"8304",822,655,655,5,0,"PUM+J",0
17,"17218",576,456,451,3,5,"PUM+J",0
25,"25138",558,427,424,2,3,"PUM+J",0
25,"25143",82,63,62,0,1,"PUM+J",0
43,"43023",211,171,169,2,2,"PUM+J",0
8,"8071",249,209,208,0,1,"PUM+J",0
17,"17081",252,186,185,2,1,"PUM+J",0
8,"8234",3443,2561,2550,15,11,"PUM+J",1
8,"8302",9359,6483,6430,78,53,"PUM+J",2
8,"8065",1183,920,913,8,7,"PUM+J",0
25,"25012",2349,1563,1556,17,7,"PUM+J",2
8,"8267",6789,4975,4935,41,40,"PUM+J",1
25,"25169",170,117,117,5,0,"PUM+J",0
25,"25908",217,136,136,0,0,"PUM+J",0
17,"17202",3848,2632,2615,16,17,"PUM+J",7
8,"8104",657,496,493,4,3,"PUM+J",0
25,"25062",691,498,491,4,7,"PUM+J",0
17,"17002",578,477,474,2,3,"PUM+J",0
8,"8275",247,218,218,3,0,"PUM+J",0
8,"8159",14343,10656,10603,87,53,"PUM+J",4
17,"17214",714,516,511,6,5,"PUM+J",0
17,"17102",556,398,396,1,2,"PUM+J",0
8,"8129",486,399,398,0,1,"PUM+J",1
25,"25171",2117,1539,1534,5,5,"PUM+J",1
8,"8253",132,103,102,0,1,"PUM+J",0
25,"25057",208,151,149,4,2,"PUM+J",0
43,"43157",339,279,279,1,0,"PUM+J",0
8,"8243",154,125,125,2,0,"PUM+J",0
25,"25140",779,540,539,2,1,"PUM+J",0
8,"8072",10769,7632,7600,56,32,"PUM+J",5
25,"25118",326,223,218,0,5,"PUM+J",0
25,"25017",228,175,174,0,1,"PUM+J",0
8,"8140",4816,3541,3520,25,21,"PUM+J",1
43,"43084",514,388,383,2,5,"PUM+J",0
8,"8147",17389,12679,12601,102,78,"PUM+J",7
17,"17009",4068,3061,3050,16,11,"PUM+J",0
17,"17132",1344,1019,1009,12,10,"PUM+J",3
17,"17089",5749,3973,3949,17,24,"PUM+J",1
17,"17098",308,232,230,4,2,"PUM+J",0
25,"25174",390,312,312,1,0,"PUM+J",0
8,"8112",12926,9268,9230,61,38,"PUM+J",0
43,"43032",462,354,350,2,4,"PUM+J",0
25,"25232",1357,1012,1007,6,5,"PUM+J",0
43,"43040",325,268,267,1,1,"PUM+J",1
8,"8116",557,449,449,1,0,"PUM+J",0
25,"25250",327,269,265,1,4,"PUM+J",0
43,"43041",216,156,156,2,0,"PUM+J",0
25,"25175",173,119,119,2,0,"PUM+J",0
8,"8125",25583,18334,18225,122,109,"PUM+J",11
25,"25072",5881,4059,4031,30,28,"PUM+J",0
8,"8047",3751,2600,2578,26,22,"PUM+J",1
8,"8177",36,27,27,1,0,"PUM+J",0
8,"8254",1766,1433,1427,16,6,"PUM+J",0
43,"43025",591,448,443,4,5,"PUM+J",0
43,"43138",2636,1761,1745,11,16,"PUM+J",0
17,"17207",2420,1920,1901,9,19,"PUM+J",1
17,"17043",165,133,133,0,0,"PUM+J",0
17,"17203",165,126,126,0,0,"PUM+J",0
25,"25103",133,88,87,0,1,"PUM+J",0
25,"25903",226,169,169,1,0,"PUM+J",0
8,"8093",25,22,22,0,0,"PUM+J",0
43,"43093",3863,2728,2716,22,12,"PUM+J",7
8,"8048",580,427,426,1,1,"PUM+J",0
25,"25226",236,156,155,0,1,"PUM+J",0
25,"25071",41,31,30,0,1,"PUM+J",0
8,"8107",11965,8604,8554,67,50,"PUM+J",0
8,"8031",2339,1760,1750,15,10,"PUM+J",0
8,"8135",6770,5187,5158,42,29,"PUM+J",3
25,"25104",120,88,88,0,0,"PUM+J",0
43,"43170",877,664,661,4,3,"PUM+J",1
17,"17902",1294,992,990,9,2,"PUM+J",0
43,"43164",310,235,231,3,4,"PUM+J",0
8,"8258",815,636,632,5,4,"PUM+J",1
8,"8213",6600,4925,4906,30,19,"PUM+J",1
17,"17027",2857,2236,2229,9,7,"PUM+J",3
17,"17162",153,106,105,1,1,"PUM+J",0
8,"8056",42897,30873,30757,259,116,"PUM+J",13
17,"17101",566,389,382,1,7,"PUM+J",1
8,"8172",20543,15191,15140,85,51,"PUM+J",7
8,"8250",7235,4917,4876,41,41,"PUM+J",5
8,"8155",7056,5050,5011,38,39,"PUM+J",0
8,"8272",164,128,128,1,0,"PUM+J",0
17,"17148",1550,1121,1114,15,7,"PUM+J",0
8,"8121",87515,62961,62574,429,387,"PUM+J",34
8,"8259",6979,5362,5341,27,21,"PUM+J",4
17,"17138",836,591,584,7,7,"PUM+J",0
43,"43154",126,104,104,0,0,"PUM+J",0
8,"8170",442,322,320,0,2,"PUM+J",0
25,"25167",223,165,164,3,1,"PUM+J",0
17,"17157",122,104,103,0,1,"PUM+J",1
8,"8156",11254,8440,8411,58,29,"PUM+J",1
17,"17007",1763,1367,1359,9,8,"PUM+J",0
25,"25082",292,197,197,2,0,"PUM+J",1
8,"8295",11290,8091,8054,72,37,"PUM+J",4
8,"8230",7648,5797,5774,40,23,"PUM+J",1
43,"43003",349,257,255,3,2,"PUM+J",0
25,"25043",800,584,581,2,3,"PUM+J",0
8,"8226",929,748,747,10,1,"PUM+J",0
17,"17091",391,296,290,3,6,"PUM+J",0
25,"25189",2181,1468,1461,11,7,"PUM+J",7
8,"8050",139,118,115,4,3,"PUM+J",0
8,"8114",18838,13519,13442,81,77,"PUM+J",2
43,"43165",571,469,467,2,2,"PUM+J",0
8,"8165",1680,1177,1171,7,6,"PUM+J",0
43,"43174",144,118,114,0,4,"PUM+J",0
8,"8242",223,159,159,0,0,"PUM+J",0
43,"43131",4827,3134,3116,32,18,"PUM+J",6
8,"8189",119,96,96,1,0,"PUM+J",0
8,"8013",1287,982,972,6,10,"PUM+J",2
17,"17063",179,153,149,0,4,"PUM+J",0
8,"8902",3941,2974,2962,16,12,"PUM+J",1
43,"43061",40,27,27,3,0,"PUM+J",0
8,"8024",357,282,282,2,0,"PUM+J",1
43,"43126",1230,937,933,3,4,"PUM+J",0
17,"17076",119,95,94,2,1,"PUM+J",0
8,"8278",4925,3820,3804,22,16,"PUM+J",2
8,"8008",175,136,136,2,0,"PUM+J",0
43,"43067",526,426,424,3,2,"PUM+J",0
25,"25185",680,452,451,0,1,"PUM+J",0
43,"43146",40,32,32,0,0,"PUM+J",0
8,"8014",2013,1526,1521,4,5,"PUM+J",1
43,"43105",155,126,123,4,3,"PUM+J",0
43,"43081",629,500,499,2,1,"PUM+J",0
25,"25233",289,219,218,6,1,"PUM+J",0
43,"43086",5252,3811,3790,28,21,"PUM+J",2
8,"8308",139,109,109,1,0,"PUM+J",0
8,"8901",240,200,195,2,5,"PUM+J",0
8,"8195",75,62,62,0,0,"PUM+J",0
43,"43142",1069,783,774,3,9,"PUM+J",0
8,"8167",6056,4520,4500,38,20,"PUM+J",1
8,"8085",986,769,767,6,2,"PUM+J",2
25,"25075",132,101,101,0,0,"PUM+J",1
25,"25087",54,45,45,0,0,"PUM+J",0
17,"17011",645,518,514,10,4,"PUM+J",1
43,"43049",727,557,555,3,2,"PUM+J",0
43,"43014",14386,9542,9464,74,78,"PUM+J",5
25,"25200",318,245,245,0,0,"PUM+J",0
43,"43140",2433,1685,1674,11,11,"PUM+J",0
25,"25111",114,86,86,2,0,"PUM+J",0
25,"25909",138,99,98,2,1,"PUM+J",0
8,"8285",10349,7630,7599,48,31,"PUM+J",3
17,"17174",164,130,130,4,0,"PUM+J",0
43,"43088",2013,1429,1420,11,9,"PUM+J",0
25,"25181",172,137,137,1,0,"PUM+J",0
8,"8084",1172,902,894,9,8,"PUM+J",0
17,"17124",1593,1163,1160,8,3,"PUM+J",0
8,"8197",7986,5829,5805,37,24,"PUM+J",3
8,"8142",136,117,117,3,0,"PUM+J",0
8,"8137",272,208,207,2,1,"PUM+J",0
8,"8266",43422,32827,32696,241,131,"PUM+J",20
8,"8903",201,181,181,1,0,"PUM+J",0
8,"8092",3713,2758,2745,9,13,"PUM+J",0
25,"25005",269,193,193,3,0,"PUM+J",0
8,"8016",1803,1371,1363,11,8,"PUM+J",2
8,"8123",19570,15378,15316,91,62,"PUM+J",3
17,"17217",350,287,284,0,3,"PUM+J",0
43,"43085",237,190,185,1,5,"PUM+J",0
8,"8228",292,234,233,0,1,"PUM+J",0
17,"17055",142,124,124,0,0,"PUM+J",0
25,"25041",525,375,370,4,5,"PUM+J",0
17,"17165",645,502,502,2,0,"PUM+J",0
25,"25201",110,81,81,0,0,"PUM+J",0
17,"17168",373,309,308,3,1,"PUM+J",0
25,"25077",435,312,312,1,0,"PUM+J",0
8,"8249",274,238,237,0,1,"PUM+J",1
43,"43008",305,171,171,7,0,"PUM+J",0
25,"25044",178,144,142,0,2,"PUM+J",1
43,"43166",1646,1183,1176,4,7,"PUM+J",0
17,"17233",2347,1853,1840,11,13,"PUM+J",2
8,"8187",153822,113081,112470,758,611,"PUM+J",52
8,"8256",693,542,542,3,0,"PUM+J",0
17,"17060",409,300,298,1,2,"PUM+J",0
43,"43057",38,32,32,1,0,"PUM+J",0
17,"17026",549,421,415,3,6,"PUM+J",1
8,"8245",77841,53719,53443,430,276,"PUM+J",35
8,"8179",636,466,465,2,1,"PUM+J",0
25,"25048",1641,1207,1194,13,13,"PUM+J",1
25,"25132",141,106,105,0,1,"PUM+J",0
8,"8225",94,83,82,1,1,"PUM+J",0
8,"8029",3586,2868,2862,20,6,"PUM+J",1
17,"17120",823,560,558,5,2,"PUM+J",1
43,"43113",387,305,303,1,2,"PUM+J",0
8,"8203",2466,1678,1675,7,3,"PUM+J",1
8,"8194",25680,16465,16376,131,89,"PUM+J",8
8,"8293",227,177,177,0,0,"PUM+J",0
8,"8041",10698,7324,7258,57,66,"PUM+J",1
25,"25055",163,114,114,0,0,"PUM+J",0
8,"8162",2118,1581,1576,13,5,"PUM+J",1
25,"25210",1073,791,780,3,11,"PUM+J",0
8,"8183",4573,3406,3398,14,8,"PUM+J",0
8,"8238",14946,11911,11873,85,38,"PUM+J",13
43,"43156",3956,2812,2784,22,28,"PUM+J",2
17,"17067",704,551,549,6,2,"PUM+J",1
8,"8023",7029,5027,5000,39,27,"PUM+J",1
25,"25068",515,359,358,0,1,"PUM+J",0
8,"8134",848,618,609,4,9,"PUM+J",0
43,"43123",71435,49166,48873,318,293,"PUM+J",72
8,"8286",2943,2051,2042,12,9,"PUM+J",1
8,"8049",1309,910,903,3,7,"PUM+J",1
17,"17141",6019,3855,3833,43,22,"PUM+J",5
43,"43136",10489,7029,6996,47,33,"PUM+J",5
25,"25905",366,281,276,4,5,"PUM+J",0
25,"25154",117,86,85,0,1,"PUM+J",1
8,"8281",4858,3783,3762,19,21,"PUM+J",1
8,"8233",1872,1428,1420,15,8,"PUM+J",0
25,"25192",727,527,524,4,3,"PUM+J",0
25,"25176",307,241,238,3,3,"PUM+J",0
17,"17008",3605,2595,2577,8,18,"PUM+J",3
25,"25039",259,197,196,7,1,"PUM+J",0
25,"25073",559,377,377,2,0,"PUM+J",0
8,"8095",66,49,49,0,0,"PUM+J",0
43,"43096",97,76,76,0,0,"PUM+J",0
17,"17903",883,681,676,3,5,"PUM+J",0
25,"25161",339,221,221,0,0,"PUM+J",0
8,"8124",37157,27139,26994,179,145,"PUM+J",15
8,"8232",1773,1368,1362,9,6,"PUM+J",2
25,"25074",179,155,151,2,4,"PUM+J",0
25,"25190",262,202,202,2,0,"PUM+J",0
43,"43117",147,119,119,0,0,"PUM+J",0
8,"8210",4640,3226,3200,24,26,"PUM+J",2
25,"25906",205,133,131,2,2,"PUM+J",0
25,"25064",96,78,78,0,0,"PUM+J",0
43,"43060",2672,2032,2015,7,17,"PUM+J",1
8,"8212",491,393,386,6,7,"PUM+J",1
17,"17137",3486,2812,2808,15,4,"PUM+J",1
17,"17006",1178,826,818,9,8,"PUM+J",1
43,"43007",631,479,474,1,5,"PUM+J",0
8,"8188",115,89,89,0,0,"PUM+J",0
8,"8079",333,260,258,2,2,"PUM+J",0
17,"17152",11065,6959,6927,68,32,"PUM+J",13
25,"25243",3729,2370,2349,33,21,"PUM+J",2
43,"43099",284,214,214,4,0,"PUM+J",0
43,"43147",528,425,420,3,5,"PUM+J",0
43,"43137",1890,1373,1353,8,20,"PUM+J",1
25,"25252",553,380,379,2,1,"PUM+J",0
8,"8132",356,265,265,1,0,"PUM+J",0
8,"8260",18515,13563,13487,84,76,"PUM+J",9
25,"25240",1366,1030,1021,4,9,"PUM+J",0
43,"43155",22586,15295,15204,120,91,"PUM+J",13
25,"25170",262,210,210,1,0,"PUM+J",1
43,"43905",15100,9689,9630,43,59,"PUM+J",12
25,"25053",1100,819,811,7,8,"PUM+J",0
43,"43054",2807,1972,1957,14,15,"PUM+J",1
8,"8035",13006,8957,8918,50,39,"PUM+J",3
25,"25230",1541,1105,1099,9,6,"PUM+J",1
8,"8015",156540,109145,108440,957,705,"PUM+J",59
8,"8042",2390,1772,1764,12,8,"PUM+J",0
43,"43120",421,256,254,1,2,"PUM+J",0
17,"17154",101,76,76,0,0,"PUM+J",0
17,"17222",104,87,87,1,0,"PUM+J",0
8,"8149",980,702,694,6,8,"PUM+J",0
17,"17167",2585,2015,1998,11,17,"PUM+J",1
8,"8255",133,100,100,2,0,"PUM+J",0
25,"25146",223,158,155,3,3,"PUM+J",0
25,"25022",105,80,79,0,1,"PUM+J",0
25,"25085",141,109,108,2,1,"PUM+J",0
25,"25204",1187,858,849,13,9,"PUM+J",0
8,"8207",2026,1667,1659,12,8,"PUM+J",0
25,"25016",2083,1404,1399,3,5,"PUM+J",1
8,"8280",93,76,75,1,1,"PUM+J",0
43,"43063",544,376,374,2,2,"PUM+J",0
25,"25148",224,158,158,0,0,"PUM+J",0
17,"17215",2286,1855,1844,13,11,"PUM+J",0
25,"25051",1522,1066,1059,6,7,"PUM+J",0
17,"17158",565,296,295,2,1,"PUM+J",0
43,"43068",484,322,317,2,5,"PUM+J",0
25,"25112",269,205,200,2,5,"PUM+J",0
25,"25253",147,118,117,0,1,"PUM+J",0
25,"25207",6443,4525,4492,31,33,"PUM+J",1
8,"8283",6165,4546,4524,33,22,"PUM+J",2
25,"25224",122,94,94,0,0,"PUM+J",0
17,"17221",4138,2999,2988,23,11,"PUM+J",2
25,"25063",84,52,51,0,1,"PUM+J",0
25,"25023",4560,3350,3334,24,16,"PUM+J",0
43,"43069",183,148,147,2,1,"PUM+J",0
17,"17135",393,307,303,0,4,"PUM+J",0
43,"43076",454,336,335,1,1,"PUM+J",0
25,"25177",356,252,250,1,2,"PUM+J",0
25,"25904",160,134,133,2,1,"PUM+J",1
17,"17195",338,274,272,1,2,"PUM+J",1
17,"17090",539,440,440,2,0,"PUM+J",0
25,"25110",2745,1943,1927,13,16,"PUM+J",4
43,"43043",3317,2457,2445,12,12,"PUM+J",2
8,"8190",255,184,182,1,2,"PUM+J",0
43,"43094",2143,1558,1541,6,17,"PUM+J",0
8,"8299",380,301,300,4,1,"PUM+J",0
43,"43139",2007,1432,1419,9,13,"PUM+J",0
25,"25231",483,387,385,0,2,"PUM+J",0
17,"17082",435,308,307,1,1,"PUM+J",0
43,"43160",1324,967,956,6,11,"PUM+J",1
8,"8163",19672,13421,13364,70,57,"PUM+J",6
17,"17206",158,111,109,0,2,"PUM+J",1
43,"43148",91182,65076,64756,441,320,"PUM+J",58
8,"8096",43926,32120,31960,217,160,"PUM+J",16
8,"8265",1597,1262,1260,4,2,"PUM+J",0
8,"8076",16526,11988,11893,90,95,"PUM+J",5
17,"17015",12829,9612,9580,51,32,"PUM+J",4
43,"43151",107,88,88,0,0,"PUM+J",0
25,"25221",115,82,81,1,1,"PUM+J",0
8,"8223",1897,1345,1341,10,4,"PUM+J",0
8,"8051",18570,14112,14054,86,58,"PUM+J",10
25,"25008",1081,803,799,4,4,"PUM+J",1
25,"25007",1378,1010,999,12,11,"PUM+J",1
25,"25109",211,155,154,1,1,"PUM+J",0
8,"8294",2093,1546,1534,11,12,"PUM+J",1
25,"25119",2258,1701,1686,11,15,"PUM+J",0
8,"8237",1644,1263,1254,9,9,"PUM+J",0
25,"25100",184,137,136,1,1,"PUM+J",0
8,"8214",7007,5390,5371,25,19,"PUM+J",1
8,"8192",5701,4366,4349,15,17,"PUM+J",2
17,"17140",635,506,505,2,1,"PUM+J",0
8,"8288",1696,1103,1096,9,7,"PUM+J",0
8,"8227",2420,1775,1769,11,6,"PUM+J",0
17,"17194",73,56,56,0,0,"PUM+J",0
17,"17044",6938,5245,5212,33,33,"PUM+J",3
25,"25020",270,202,201,2,1,"PUM+J",0
25,"25027",978,695,690,3,5,"PUM+J",0
8,"8174",388,322,318,2,4,"PUM+J",0
8,"8030",5208,4045,4033,25,12,"PUM+J",1
17,"17170",173,140,140,2,0,"PUM+J",0
17,"17901",987,733,725,5,8,"PUM+J",2
17,"17110",1332,990,981,3,9,"PUM+J",0
43,"43122",112,91,91,1,0,"PUM+J",0
8,"8126",8906,6673,6646,41,27,"PUM+J",3
25,"25058",4345,3058,3045,13,13,"PUM+J",1
25,"25193",768,567,563,4,4,"PUM+J",0
8,"8038",1541,1129,1120,6,9,"PUM+J",0
8,"8257",103,82,82,0,0,"PUM+J",0
25,"25025",1362,909,898,15,11,"PUM+J",0
15,"15901",3334,1948,1928,27,20,"PUM+J",2
27,"27065",12055,7566,7379,119,187,"PUM+J",11
32,"32022",1238,840,835,10,5,"PUM+J",0
27,"27034",1010,565,558,3,7,"PUM+J",2
32,"32014",1028,719,708,6,11,"PUM+J",0
36,"36007",1610,1047,1016,5,31,"PUM+J",1
36,"36050",7645,5137,5049,48,88,"PUM+J",3
36,"36029",16126,10936,10771,96,165,"PUM+J",11
32,"32049",683,375,372,3,3,"PUM+J",0
27,"27022",4654,2760,2696,20,64,"PUM+J",3
32,"32030",945,642,641,8,1,"PUM+J",0
15,"15084",3039,2002,1981,12,21,"PUM+J",0
36,"36015",4079,2653,2606,29,47,"PUM+J",1
27,"27003",1743,1161,1134,18,27,"PUM+J",1
15,"15070",8778,5802,5656,131,146,"PUM+J",6
27,"27042",1639,1120,1107,8,13,"PUM+J",1
15,"15023",6277,4021,3968,34,53,"PUM+J",4
32,"32050",2254,1630,1612,15,18,"PUM+J",0
15,"15077",8103,4893,4818,61,75,"PUM+J",1
32,"32046",1089,679,670,4,9,"PUM+J",2
32,"32065",633,422,419,8,3,"PUM+J",0
15,"15024",4314,2859,2790,44,69,"PUM+J",2
15,"15018",1087,680,670,13,10,"PUM+J",0
32,"32081",2057,1466,1445,17,21,"PUM+J",2
32,"32024",4817,3064,3014,34,50,"PUM+J",5
15,"15052",4070,2512,2488,18,24,"PUM+J",1
36,"36038",66807,46235,45781,493,454,"PUM+J",34
32,"32010",364,271,267,2,4,"PUM+J",1
15,"15029",5354,3082,3050,46,32,"PUM+J",1
32,"32062",784,557,550,1,7,"PUM+J",0
15,"15056",5615,3697,3646,31,51,"PUM+J",2
32,"32001",5100,3377,3333,32,44,"PUM+J",2
15,"15087",5710,3436,3392,31,44,"PUM+J",0
36,"36010",2825,1983,1947,19,36,"PUM+J",5
32,"32035",1352,782,768,6,14,"PUM+J",0
15,"15035",11189,7256,7165,104,91,"PUM+J",7
32,"32009",10558,6621,6549,50,72,"PUM+J",10
32,"32090",734,448,441,2,7,"PUM+J",1
36,"36056",4932,3368,3310,24,58,"PUM+J",4
27,"27004",1143,640,625,2,15,"PUM+J",1
15,"15017",19866,13497,13344,195,153,"PUM+J",17
32,"32017",1193,735,724,3,11,"PUM+J",0
32,"32042",1487,1010,1001,12,9,"PUM+J",1
15,"15046",6157,3965,3865,23,100,"PUM+J",10
32,"32087",1669,1158,1136,14,22,"PUM+J",0
32,"32026",2655,1762,1731,17,31,"PUM+J",1
27,"27031",15107,9759,9593,87,166,"PUM+J",15
15,"15013",6324,4132,4083,35,49,"PUM+J",7
27,"27043",1222,746,737,12,9,"PUM+J",0
15,"15076",2490,1539,1517,25,22,"PUM+J",0
36,"36025",2127,1235,1221,5,14,"PUM+J",2
32,"32029",441,286,283,2,3,"PUM+J",1
27,"27040",3008,2071,2046,21,25,"PUM+J",2
27,"27051",7986,5324,5241,58,83,"PUM+J",6
32,"32047",1761,1192,1175,10,17,"PUM+J",1
15,"15053",7469,4622,4579,44,43,"PUM+J",4
27,"27020",3365,2544,2500,42,44,"PUM+J",1
15,"15078",78810,55693,55183,569,510,"PUM+J",51
32,"32067",1189,696,692,4,4,"PUM+J",1
27,"27025",2731,2047,2006,18,41,"PUM+J",1
15,"15091",1097,705,686,17,19,"PUM+J",0
15,"15090",1115,711,701,19,10,"PUM+J",0
27,"27044",2703,1495,1463,15,32,"PUM+J",2
32,"32070",495,247,238,4,9,"PUM+J",1
27,"27048",1992,1317,1285,21,32,"PUM+J",1
32,"32033",667,439,436,4,3,"PUM+J",0
32,"32037",679,454,446,6,8,"PUM+J",0
27,"27061",1018,704,683,12,21,"PUM+J",0
32,"32045",2346,1604,1579,20,25,"PUM+J",1
15,"15069",6604,4587,4520,55,67,"PUM+J",2
27,"27058",3283,2275,2241,12,34,"PUM+J",0
36,"36902",5028,3453,3396,19,57,"PUM+J",2
27,"27033",591,334,328,0,6,"PUM+J",0
36,"36005",8105,5258,5152,54,106,"PUM+J",1
36,"36004",10109,6611,6502,79,109,"PUM+J",6
15,"15062",5597,3406,3360,16,46,"PUM+J",6
15,"15009",10605,7245,7133,101,112,"PUM+J",9
15,"15092",6220,3810,3756,30,54,"PUM+J",1
32,"32034",1062,763,753,6,10,"PUM+J",0
15,"15014",3836,2191,2158,27,33,"PUM+J",0
36,"36055",13585,9177,8986,115,191,"PUM+J",11
32,"32082",1164,736,728,11,8,"PUM+J",0
32,"32038",387,253,251,4,2,"PUM+J",0
27,"27023",2453,1674,1644,25,30,"PUM+J",3
32,"32041",752,462,458,4,4,"PUM+J",0
27,"27055",1191,773,764,7,9,"PUM+J",0
15,"15066",3995,2746,2695,29,51,"PUM+J",2
27,"27002",1535,990,968,13,22,"PUM+J",2
36,"36901",4154,3094,3029,21,65,"PUM+J",2
32,"32020",2428,1728,1714,10,14,"PUM+J",2
32,"32008",8647,5570,5495,56,75,"PUM+J",10
15,"15028",1392,944,936,4,8,"PUM+J",0
15,"15059",10229,6900,6734,85,166,"PUM+J",4
32,"32068",1401,882,878,4,4,"PUM+J",0
32,"32053",1362,1001,989,10,12,"PUM+J",2
27,"27013",3690,2811,2766,30,45,"PUM+J",5
36,"36059",4641,2844,2796,29,48,"PUM+J",4
15,"15048",5087,3426,3383,40,43,"PUM+J",1
36,"36019",1462,916,908,8,8,"PUM+J",1
36,"36003",10023,6877,6789,66,88,"PUM+J",6
36,"36026",19890,13041,12891,169,150,"PUM+J",6
15,"15032",3430,2243,2197,12,46,"PUM+J",3
27,"27027",1791,1198,1167,17,31,"PUM+J",1
36,"36042",18125,11975,11775,126,200,"PUM+J",12
36,"36039",15609,10562,10341,102,221,"PUM+J",6
32,"32086",2531,1348,1332,11,16,"PUM+J",1
32,"32078",1099,715,707,4,8,"PUM+J",0
32,"32011",916,512,507,3,5,"PUM+J",0
27,"27014",3144,2009,1985,24,24,"PUM+J",1
36,"36006",11502,8057,7927,53,130,"PUM+J",8
15,"15022",5580,3508,3472,47,36,"PUM+J",1
32,"32006",1418,986,970,14,16,"PUM+J",0
27,"27052",860,564,558,7,6,"PUM+J",1
32,"32071",1351,821,814,6,7,"PUM+J",0
32,"32059",1686,1099,1082,20,17,"PUM+J",1
15,"15011",15501,9988,9846,78,142,"PUM+J",8
32,"32027",989,670,660,5,10,"PUM+J",0
15,"15068",4824,2976,2937,54,39,"PUM+J",2
27,"27063",1699,1131,1109,7,22,"PUM+J",2
36,"36054",11107,7027,6894,57,133,"PUM+J",3
15,"15083",1029,627,614,5,13,"PUM+J",1
27,"27046",1444,945,921,7,24,"PUM+J",1
32,"32048",846,460,458,1,2,"PUM+J",0
32,"32012",708,448,440,2,8,"PUM+J",2
27,"27057",11047,7078,6941,64,137,"PUM+J",9
32,"32061",1078,777,770,5,7,"PUM+J",1
36,"36048",5248,3429,3378,25,51,"PUM+J",1
15,"15086",2760,1829,1810,26,19,"PUM+J",3
32,"32057",505,334,328,3,6,"PUM+J",0
36,"36041",13691,9022,8916,85,106,"PUM+J",16
36,"36052",7266,4772,4685,43,87,"PUM+J",3
32,"32077",1104,703,700,9,3,"PUM+J",0
32,"32056",1490,1009,1003,10,6,"PUM+J",1
27,"27024",1447,1048,1032,6,16,"PUM+J",1
36,"36045",24459,16966,16735,124,231,"PUM+J",18
15,"15073",21725,13008,12820,126,188,"PUM+J",11
32,"32025",1014,731,718,5,13,"PUM+J",1
15,"15042",2928,1879,1853,11,26,"PUM+J",1
32,"32004",1608,835,824,5,11,"PUM+J",3
36,"36049",6990,4877,4787,40,90,"PUM+J",6
27,"27041",2216,1463,1445,19,18,"PUM+J",0
32,"32066",547,396,396,0,0,"PUM+J",0
32,"32005",810,576,568,9,8,"PUM+J",0
36,"36053",5783,3955,3899,39,56,"PUM+J",1
27,"27038",923,624,619,8,5,"PUM+J",0
27,"27016",6958,4697,4616,50,81,"PUM+J",6
32,"32089",1206,740,726,8,14,"PUM+J",0
15,"15034",2712,1605,1585,15,20,"PUM+J",1
36,"36031",563,426,420,7,6,"PUM+J",1
15,"15044",1194,806,788,7,18,"PUM+J",0
15,"15004",4924,3333,3292,38,41,"PUM+J",3
27,"27045",926,588,583,6,5,"PUM+J",0
32,"32023",1130,787,782,2,5,"PUM+J",0
32,"32019",11469,7336,7225,98,111,"PUM+J",12
32,"32031",997,684,680,5,4,"PUM+J",0
32,"32043",2497,1607,1582,14,25,"PUM+J",1
15,"15002",24040,16302,16117,183,185,"PUM+J",18
32,"32039",1154,801,790,11,11,"PUM+J",0
15,"15074",3902,2629,2589,23,40,"PUM+J",0
36,"36040",2505,1597,1563,15,34,"PUM+J",0
27,"27029",1425,925,910,11,15,"PUM+J",1
36,"36058",4957,3043,2994,55,49,"PUM+J",1
36,"36034",3299,2155,2132,15,23,"PUM+J",1
15,"15054",31805,19579,19321,335,258,"PUM+J",24
32,"32013",1985,1242,1230,16,12,"PUM+J",0
27,"27026",2299,1385,1368,9,17,"PUM+J",0
36,"36009",4401,2712,2649,33,63,"PUM+J",5
15,"15041",9569,6362,6269,104,93,"PUM+J",5
32,"32085",10584,6687,6611,58,76,"PUM+J",13
27,"27012",1264,658,650,6,8,"PUM+J",0
36,"36047",2248,1379,1363,11,16,"PUM+J",0
32,"32064",453,304,302,0,2,"PUM+J",0
15,"15050",1732,931,917,15,14,"PUM+J",1
36,"36020",2172,1435,1418,19,17,"PUM+J",2
27,"27001",2187,1111,1102,17,9,"PUM+J",1
32,"32036",1242,856,838,14,18,"PUM+J",4
32,"32069",4223,3064,3023,31,41,"PUM+J",3
27,"27032",3197,1979,1956,30,23,"PUM+J",0
15,"15093",4012,2413,2386,24,27,"PUM+J",1
27,"27006",2441,1479,1460,11,19,"PUM+J",0
32,"32021",872,555,550,6,5,"PUM+J",0
32,"32058",5247,3547,3489,30,58,"PUM+J",3
15,"15021",5254,3473,3422,58,51,"PUM+J",2
15,"15007",3164,2081,2060,24,21,"PUM+J",1
27,"27021",1632,962,935,23,27,"PUM+J",0
27,"27008",1326,865,853,5,12,"PUM+J",1
15,"15088",3396,2047,2022,22,25,"PUM+J",0
15,"15058",28761,20250,20098,261,152,"PUM+J",25
32,"32016",714,494,493,12,1,"PUM+J",0
27,"27015",3995,2518,2460,25,58,"PUM+J",1
27,"27056",1218,787,778,6,9,"PUM+J",0
27,"27007",2723,1822,1776,23,46,"PUM+J",3
27,"27011",2341,1387,1362,7,25,"PUM+J",0
15,"15064",2103,1458,1447,20,11,"PUM+J",4
32,"32063",1795,1135,1119,16,16,"PUM+J",2
15,"15071",7780,4937,4848,34,89,"PUM+J",8
36,"36036",2546,1763,1742,14,21,"PUM+J",1
27,"27018",3211,1830,1800,17,30,"PUM+J",2
32,"32044",794,547,540,2,7,"PUM+J",0
15,"15057",12077,8109,8018,83,91,"PUM+J",12
27,"27059",2035,1356,1322,7,34,"PUM+J",1
15,"15033",2421,1673,1655,6,18,"PUM+J",0
32,"32040",1400,1001,990,10,11,"PUM+J",2
36,"36032",3527,2407,2369,24,38,"PUM+J",0
15,"15012",3603,2484,2422,20,62,"PUM+J",1
27,"27047",1517,955,940,12,15,"PUM+J",0
36,"36018",3033,1951,1926,9,25,"PUM+J",2
15,"15055",4446,2829,2762,50,67,"PUM+J",4
27,"27053",497,342,334,2,8,"PUM+J",0
15,"15019",25981,15866,15672,207,194,"PUM+J",13
32,"32007",1413,873,862,2,11,"PUM+J",0
27,"27028",78725,52642,51965,642,677,"PUM+J",64
32,"32055",1216,781,764,10,17,"PUM+J",2
32,"32083",805,498,494,3,4,"PUM+J",1
15,"15038",2126,1312,1296,12,16,"PUM+J",0
32,"32088",1636,955,944,17,11,"PUM+J",0
15,"15065",7134,4869,4785,53,84,"PUM+J",1
32,"32073",1273,863,857,6,6,"PUM+J",2
15,"15080",1637,1009,992,11,17,"PUM+J",0
15,"15020",3568,2226,2217,19,9,"PUM+J",0
27,"27019",8188,5478,5395,88,83,"PUM+J",6
15,"15045",3610,2057,2044,15,13,"PUM+J",1
27,"27009",2005,1324,1303,11,21,"PUM+J",1
15,"15051",4545,2978,2945,47,33,"PUM+J",3
36,"36028",4049,2783,2739,22,44,"PUM+J",3
36,"36046",4073,2887,2818,31,69,"PUM+J",8
15,"15040",2647,1779,1762,15,17,"PUM+J",1
36,"36030",3921,2516,2484,31,32,"PUM+J",2
36,"36035",14615,10011,9880,103,131,"PUM+J",9
32,"32003",863,632,619,3,13,"PUM+J",0
15,"15902",4507,2885,2837,34,48,"PUM+J",3
27,"27902",7122,4472,4385,43,87,"PUM+J",2
32,"32091",1695,1163,1156,2,7,"PUM+J",0
32,"32075",4362,3117,3077,30,40,"PUM+J",8
15,"15081",976,713,695,4,18,"PUM+J",0
36,"36033",12305,8759,8597,67,162,"PUM+J",6
32,"32074",977,642,631,2,11,"PUM+J",0
15,"15049",1068,752,747,7,5,"PUM+J",1
27,"27050",2821,1980,1954,11,26,"PUM+J",2
32,"32002",2028,1349,1340,4,9,"PUM+J",0
15,"15036",56053,36487,36175,501,312,"PUM+J",26
27,"27017",952,568,562,3,6,"PUM+J",0
15,"15006",5159,3008,2960,44,48,"PUM+J",1
15,"15010",1805,1047,1031,19,16,"PUM+J",0
27,"27060",2434,1458,1434,17,24,"PUM+J",2
15,"15005",25347,15441,15211,226,230,"PUM+J",26
15,"15003",1675,1029,1020,9,9,"PUM+J",0
27,"27054",1135,807,782,5,25,"PUM+J",0
36,"36021",12180,8188,8058,115,130,"PUM+J",7
15,"15008",5646,3859,3836,52,23,"PUM+J",2
15,"15082",15446,10821,10687,130,134,"PUM+J",11
36,"36002",3049,1994,1968,22,26,"PUM+J",1
15,"15030",199701,137611,136590,1540,1021,"PUM+J",160
27,"27062",583,403,400,2,3,"PUM+J",0
15,"15037",4026,2375,2349,10,26,"PUM+J",3
15,"15043",4944,3184,3117,27,67,"PUM+J",3
36,"36051",14358,9408,9255,86,153,"PUM+J",5
27,"27901",2249,1373,1360,22,13,"PUM+J",0
15,"15061",5149,3221,3168,44,53,"PUM+J",1
27,"27035",183,110,110,3,0,"PUM+J",0
36,"36022",9046,5834,5720,37,114,"PUM+J",5
27,"27037",1001,714,707,11,7,"PUM+J",0
32,"32076",1935,1320,1306,15,14,"PUM+J",1
15,"15039",1224,802,785,9,17,"PUM+J",0
15,"15075",12871,8751,8637,129,114,"PUM+J",7
32,"32032",7900,5186,5091,48,95,"PUM+J",4
32,"32080",284,209,209,1,0,"PUM+J",3
36,"36023",8258,5504,5384,44,120,"PUM+J",4
36,"36043",4696,3038,3003,21,35,"PUM+J",1
36,"36060",30431,19909,19673,206,236,"PUM+J",20
36,"36061",8613,5822,5718,56,104,"PUM+J",5
36,"36016",1069,639,633,5,6,"PUM+J",1
27,"27005",2560,1691,1662,19,29,"PUM+J",4
32,"32092",491,280,275,0,5,"PUM+J",0
27,"27030",3117,1945,1898,19,47,"PUM+J",7
32,"32054",86117,56997,56376,581,621,"PUM+J",161
15,"15031",23868,16113,15954,207,159,"PUM+J",18
32,"32079",1280,880,869,13,11,"PUM+J",1
15,"15089",4299,2924,2887,41,37,"PUM+J",0
36,"36014",1867,1265,1243,16,22,"PUM+J",2
15,"15067",7933,5329,5282,43,47,"PUM+J",0
36,"36037",2538,1650,1625,12,25,"PUM+J",2
15,"15027",1563,1159,1140,23,19,"PUM+J",1
32,"32060",753,520,515,5,5,"PUM+J",2
32,"32084",878,532,527,8,5,"PUM+J",1
36,"36044",2527,1535,1499,12,36,"PUM+J",0
27,"27066",12588,8116,7954,109,162,"PUM+J",23
27,"27039",4467,3179,3121,47,58,"PUM+J",2
36,"36013",2216,1298,1290,18,8,"PUM+J",3
27,"27010",4378,2719,2670,49,49,"PUM+J",2
15,"15060",5871,4044,3978,58,66,"PUM+J",1
36,"36024",16335,11431,11256,99,175,"PUM+J",6
15,"15079",1437,887,868,8,19,"PUM+J",1
36,"36027",4401,2940,2781,20,159,"PUM+J",2
15,"15016",4558,2747,2705,16,42,"PUM+J",2
27,"27049",1324,847,829,8,18,"PUM+J",1
27,"27064",1505,972,951,9,21,"PUM+J",1
32,"32052",1817,1278,1268,12,10,"PUM+J",3
36,"36008",21845,14553,14373,138,180,"PUM+J",13
32,"32015",817,454,452,2,2,"PUM+J",0
32,"32018",1181,883,871,5,12,"PUM+J",0
15,"15025",986,529,517,6,12,"PUM+J",2
15,"15001",4697,3069,3022,45,47,"PUM+J",4
36,"36017",17364,11771,11598,123,173,"PUM+J",10
32,"32072",3664,2387,2355,24,32,"PUM+J",4
36,"36001",2397,1674,1651,6,23,"PUM+J",2
15,"15047",2256,1429,1405,25,24,"PUM+J",3
15,"15085",3176,2073,2047,29,26,"PUM+J",0
32,"32051",1369,1062,1058,13,4,"PUM+J",0
32,"32028",1537,1012,1004,5,8,"PUM+J",0
15,"15015",2877,1845,1821,26,24,"PUM+J",1
15,"15072",9434,6304,6228,48,76,"PUM+J",7
36,"36057",238417,165843,164264,1641,1579,"PUM+J",125
5,"5046",38,35,35,0,0,"PUM+J",0
28,"28068",11740,8615,8543,72,72,"PUM+J",12
7,"7014",7885,3934,3893,43,41,"PUM+J",10
9,"9361",103,64,64,1,0,"PUM+J",0
19,"19121",265,205,204,0,1,"PUM+J",0
28,"28083",9836,7278,7206,64,72,"PUM+J",10
5,"5089",455,342,324,0,18,"PUM+J",0
40,"40063",6913,4948,4838,57,110,"PUM+J",12
49,"49128",520,384,378,7,6,"PUM+J",0
46,"46238",13117,9172,9088,50,84,"PUM+J",7
16,"16150",98,66,66,2,0,"PUM+J",1
18,"18023",15717,10964,10751,132,213,"PUM+J",14
3,"3133",41333,24527,24340,146,187,"PUM+J",29
46,"46033",196,155,153,0,2,"PUM+J",0
5,"5266",100,79,79,1,0,"PUM+J",0
26,"26144",187,147,143,1,4,"PUM+J",0
24,"24163",4076,2979,2954,35,25,"PUM+J",2
12,"12079",414,310,305,2,5,"PUM+J",0
50,"50026",418,292,288,4,4,"PUM+J",0
28,"28174",1858,1284,1273,1,11,"PUM+J",1
44,"44156",47,31,31,0,0,"PUM+J",0
39,"39006",1729,1207,1192,1,15,"PUM+J",2
9,"9230",33,26,26,0,0,"PUM+J",0
10,"10204",423,289,287,1,2,"PUM+J",0
2,"2065",441,368,361,0,7,"PUM+J",0
19,"19170",189,115,115,1,0,"PUM+J",0
46,"46212",1620,1130,1112,12,18,"PUM+J",2
2,"2043",1165,872,858,6,14,"PUM+J",0
4,"4070",1529,1088,1076,8,12,"PUM+J",0
39,"39053",212,133,133,4,0,"PUM+J",0
47,"47080",33,25,24,0,1,"PUM+J",0
24,"24173",896,590,583,2,7,"PUM+J",1
41,"41056",3687,2836,2779,37,57,"PUM+J",1
9,"9117",71,58,58,0,0,"PUM+J",0
5,"5264",54,32,31,4,1,"PUM+J",0
19,"19076",29,23,23,0,0,"PUM+J",0
13,"13033",1544,1231,1196,5,35,"PUM+J",1
46,"46197",1930,1430,1411,11,19,"PUM+J",0
2,"2003",134196,96374,95521,913,853,"PUM+J",217
19,"19309",20,15,14,0,1,"PUM+J",0
7,"7003",12521,6457,6381,60,76,"PUM+J",10
28,"28028",1836,1374,1363,3,11,"PUM+J",0
39,"39093",297,216,214,1,2,"PUM+J",0
41,"41084",2799,2029,1937,9,92,"PUM+J",1
47,"47086",3818,2835,2784,36,51,"PUM+J",4
9,"9123",42,36,36,0,0,"PUM+J",0
12,"12104",6843,5181,5111,32,70,"PUM+J",4
2,"2032",259,183,178,2,5,"PUM+J",0
41,"41063",2735,1855,1797,30,58,"PUM+J",3
9,"9400",307,225,224,4,1,"PUM+J",2
11,"11023",9386,6363,6248,116,115,"PUM+J",0
9,"9340",74,49,49,1,0,"PUM+J",0
50,"50034",767,516,511,10,5,"PUM+J",0
6,"6066",1708,1180,1171,6,9,"PUM+J",0
29,"29084",27199,18102,17800,268,302,"PUM+J",24
49,"49117",431,294,289,0,5,"PUM+J",1
28,"28066",7575,5771,5718,58,53,"PUM+J",10
45,"45063",375,268,264,0,4,"PUM+J",0
23,"23054",375,280,272,1,8,"PUM+J",1
5,"5205",81,59,58,2,1,"PUM+J",0
37,"37371",252,156,155,0,1,"PUM+J",0
49,"49085",904,583,579,5,4,"PUM+J",2
28,"28049",57814,44977,44559,385,418,"PUM+J",50
26,"26109",73,68,68,0,0,"PUM+J",0
50,"50249",283,202,200,0,2,"PUM+J",0
12,"12110",222,156,155,3,1,"PUM+J",0
45,"45042",172,122,121,0,1,"PUM+J",0
16,"16091",63,43,42,1,1,"PUM+J",0
16,"16018",376,290,290,2,0,"PUM+J",0
44,"44112",400,265,265,2,0,"PUM+J",0
39,"39090",773,557,553,2,4,"PUM+J",0
46,"46137",248,201,197,3,4,"PUM+J",0
42,"42070",31,23,23,1,0,"PUM+J",0
2,"2061",605,464,458,3,6,"PUM+J",0
18,"18029",1812,1104,1065,7,39,"PUM+J",0
2,"2076",313,233,230,2,3,"PUM+J",0
37,"37015",198,127,125,2,2,"PUM+J",0
23,"23014",2535,1890,1861,28,29,"PUM+J",0
24,"24224",564,381,375,5,6,"PUM+J",0
10,"10199",154,99,99,2,0,"PUM+J",0
5,"5010",142,102,100,2,2,"PUM+J",0
18,"18047",6103,3992,3922,61,70,"PUM+J",4
40,"40121",249,188,178,1,10,"PUM+J",0
2,"2058",300,186,177,1,9,"PUM+J",0
12,"12033",1953,1391,1368,6,23,"PUM+J",1
46,"46184",26514,19610,19399,180,211,"PUM+J",13
40,"40111",50,39,39,0,0,"PUM+J",0
19,"19156",917,686,679,2,7,"PUM+J",1
22,"22077",362,280,272,5,8,"PUM+J",0
16,"16161",51,44,44,1,0,"PUM+J",0
37,"37247",171,129,128,0,1,"PUM+J",0
14,"14069",7340,5100,5000,69,100,"PUM+J",3
37,"37090",68,47,47,0,0,"PUM+J",0
34,"34154",77,48,48,1,0,"PUM+J",0
5,"5265",83,59,58,1,1,"PUM+J",0
49,"49151",591,389,388,3,1,"PUM+J",2
11,"11029",5442,2826,2765,44,61,"PUM+J",4
50,"50279",74,49,49,0,0,"PUM+J",0
18,"18903",852,544,537,9,7,"PUM+J",0
40,"40020",149,112,111,1,1,"PUM+J",0
40,"40205",228,159,157,1,2,"PUM+J",1
47,"47038",100,61,61,0,0,"PUM+J",0
33,"33003",603,322,317,7,5,"PUM+J",0
37,"37298",170,109,109,0,0,"PUM+J",0
6,"6035",851,630,620,0,10,"PUM+J",2
24,"24067",602,327,324,6,3,"PUM+J",0
9,"9194",1970,1376,1359,15,17,"PUM+J",2
33,"33059",4359,2651,2625,33,26,"PUM+J",0
34,"34092",257,189,189,1,0,"PUM+J",0
9,"9104",49,35,34,0,1,"PUM+J",0
39,"39018",4284,3211,3177,22,34,"PUM+J",4
2,"2040",548,476,474,1,2,"PUM+J",0
49,"49008",423,263,259,1,4,"PUM+J",0
46,"46256",7280,4996,4940,32,56,"PUM+J",3
26,"26098",92,63,63,1,0,"PUM+J",1
9,"9467",59,46,46,2,0,"PUM+J",0
29,"29062",658,557,551,2,6,"PUM+J",0
46,"46007",12333,8890,8803,79,87,"PUM+J",7
28,"28045",35523,26213,25966,212,247,"PUM+J",34
24,"24097",200,138,137,1,1,"PUM+J",2
16,"16048",404,300,298,2,2,"PUM+J",0
12,"12107",350,299,295,3,4,"PUM+J",0
45,"45114",549,400,394,1,6,"PUM+J",0
49,"49124",238,170,164,2,6,"PUM+J",1
49,"49097",67,44,44,0,0,"PUM+J",0
9,"9466",113,84,83,1,1,"PUM+J",0
34,"34123",1634,1274,1258,4,16,"PUM+J",1
29,"29086",770,479,476,5,3,"PUM+J",0
2,"2035",1946,1494,1473,5,21,"PUM+J",2
24,"24076",1283,926,913,10,13,"PUM+J",1
40,"40177",139,106,105,0,1,"PUM+J",0
49,"49083",47,37,37,1,0,"PUM+J",0
9,"9360",26,19,19,0,0,"PUM+J",0
3,"3088",5895,4030,3961,29,69,"PUM+J",4
33,"33007",1382,804,795,4,9,"PUM+J",0
34,"34023",5103,3585,3543,45,42,"PUM+J",6
10,"10172",696,447,443,5,4,"PUM+J",0
22,"22209",161,121,121,3,0,"PUM+J",0
4,"4094",215,156,156,0,0,"PUM+J",0
28,"28005",136518,101397,100485,871,912,"PUM+J",114
42,"42125",71,55,55,0,0,"PUM+J",0
4,"4076",1209,873,850,7,23,"PUM+J",0
7,"7054",23257,12613,12464,111,149,"PUM+J",14
9,"9387",107,89,88,0,1,"PUM+J",1
7,"7050",3513,2036,2013,25,23,"PUM+J",2
21,"21065",259,178,175,0,3,"PUM+J",0
26,"26175",47,40,38,1,2,"PUM+J",0
26,"26173",8,8,8,1,0,"PUM+J",0
9,"9443",151,113,112,0,1,"PUM+J",0
12,"12074",756,611,601,3,10,"PUM+J",0
5,"5014",5263,3699,3648,35,51,"PUM+J",3
33,"33019",2844,1702,1680,11,22,"PUM+J",0
19,"19311",85,60,59,0,1,"PUM+J",1
50,"50228",249,207,207,3,0,"PUM+J",0
28,"28160",8709,6507,6460,62,47,"PUM+J",6
49,"49069",337,210,201,0,9,"PUM+J",0
50,"50210",37,26,26,0,0,"PUM+J",0
40,"40124",234,169,164,0,5,"PUM+J",0
16,"16134",4368,3143,3102,22,41,"PUM+J",1
30,"30025",5016,3663,3623,22,40,"PUM+J",2
22,"22228",532,371,364,4,7,"PUM+J",3
47,"47153",101,69,69,1,0,"PUM+J",0
37,"37049",125,76,76,0,0,"PUM+J",0
40,"40057",1397,1081,1067,15,14,"PUM+J",1
3,"3009",46125,33613,33319,315,294,"PUM+J",37
10,"10040",426,301,289,2,12,"PUM+J",0
22,"22066",755,529,520,8,9,"PUM+J",0
6,"6025",5083,3543,3469,28,74,"PUM+J",6
40,"40062",56,43,42,0,1,"PUM+J",0
19,"19334",43,35,35,0,0,"PUM+J",0
44,"44169",298,216,216,0,0,"PUM+J",0
45,"45110",1685,1288,1274,5,14,"PUM+J",2
6,"6047",829,618,605,1,13,"PUM+J",5
46,"46035",6828,5155,5089,33,66,"PUM+J",3
7,"7002",6678,4149,4108,31,41,"PUM+J",5
2,"2021",1013,806,798,6,8,"PUM+J",0
50,"50271",246,179,173,4,6,"PUM+J",0
37,"37154",129,97,94,1,3,"PUM+J",0
22,"22226",761,537,530,13,7,"PUM+J",0
22,"22083",447,360,355,6,5,"PUM+J",0
42,"42083",26,20,20,0,0,"PUM+J",0
22,"22096",332,248,241,10,7,"PUM+J",1
3,"3115",255,213,213,3,0,"PUM+J",0
37,"37274",118296,84144,83280,880,864,"PUM+J",121
9,"9276",390,256,244,4,12,"PUM+J",0
4,"4075",5462,3714,3676,19,38,"PUM+J",4
37,"37040",376,291,288,0,3,"PUM+J",1
39,"39061",3470,2605,2591,14,14,"PUM+J",0
45,"45064",3987,2918,2880,33,38,"PUM+J",7
28,"28120",1220,910,897,5,13,"PUM+J",1
34,"34098",790,562,558,3,4,"PUM+J",4
18,"18039",3343,2293,2252,22,41,"PUM+J",3
24,"24117",410,302,301,1,1,"PUM+J",1
4,"4066",13438,8615,8519,78,96,"PUM+J",6
12,"12122",754,608,600,3,8,"PUM+J",0
42,"42023",57,48,48,0,0,"PUM+J",0
50,"50284",129,98,98,0,0,"PUM+J",1
45,"45109",2791,2123,2072,20,51,"PUM+J",0
37,"37246",5146,3791,3737,42,54,"PUM+J",10
35,"35032",3331,2293,2252,23,41,"PUM+J",4
45,"45062",1075,816,808,11,8,"PUM+J",0
47,"47061",237,185,184,0,1,"PUM+J",0
37,"37054",233,190,186,2,4,"PUM+J",0
4,"4069",4742,3364,3325,46,39,"PUM+J",7
47,"47171",375,295,290,9,5,"PUM+J",0
37,"37361",84,55,54,1,1,"PUM+J",0
26,"26151",412,317,317,4,0,"PUM+J",1
41,"41101",6025,4299,4213,53,86,"PUM+J",3
3,"3059",20710,14788,14685,89,103,"PUM+J",16
19,"19230",558,409,406,1,3,"PUM+J",1
39,"39099",3193,2363,2346,10,17,"PUM+J",1
9,"9054",89,65,63,4,2,"PUM+J",0
22,"22057",364,253,248,4,5,"PUM+J",0
50,"50257",159,128,125,2,3,"PUM+J",0
45,"45037",1520,1072,1055,5,17,"PUM+J",0
16,"16137",37,27,25,0,2,"PUM+J",0
42,"42097",14,9,9,1,0,"PUM+J",0
9,"9335",86,66,66,3,0,"PUM+J",0
46,"46027",924,746,737,2,9,"PUM+J",0
44,"44047",225,103,103,0,0,"PUM+J",0
37,"37071",76,64,62,1,2,"PUM+J",0
19,"19150",116,89,89,0,0,"PUM+J",0
42,"42211",84,67,67,0,0,"PUM+J",0
19,"19265",134,97,97,5,0,"PUM+J",0
33,"33026",8201,5014,4974,74,40,"PUM+J",5
38,"38015",4055,2635,2601,16,34,"PUM+J",0
22,"22233",81,53,53,0,0,"PUM+J",0
24,"24026",1085,724,712,14,12,"PUM+J",0
49,"49054",847,576,569,8,7,"PUM+J",0
47,"47058",199,126,125,3,1,"PUM+J",0
24,"24151",433,307,304,1,3,"PUM+J",0
28,"28056",946,664,660,2,4,"PUM+J",0
44,"44070",55,49,49,0,0,"PUM+J",1
49,"49032",282,196,196,0,0,"PUM+J",0
34,"34036",230,159,158,0,1,"PUM+J",0
46,"46062",4552,3402,3362,27,40,"PUM+J",1
50,"50292",130,108,107,0,1,"PUM+J",0
44,"44096",155,115,114,1,1,"PUM+J",0
6,"6162",2885,2067,2032,19,35,"PUM+J",5
24,"24031",207,160,158,0,2,"PUM+J",1
34,"34155",122,95,95,0,0,"PUM+J",0
37,"37350",403,281,274,1,7,"PUM+J",0
24,"24039",1949,1420,1412,33,8,"PUM+J",1
3,"3049",12103,8872,8785,57,87,"PUM+J",1
28,"28048",514,386,384,4,2,"PUM+J",0
38,"38043",19365,12355,12212,126,143,"PUM+J",4
46,"46080",979,720,712,2,8,"PUM+J",0
26,"26060",78,51,50,2,1,"PUM+J",1
10,"10054",523,389,380,1,9,"PUM+J",0
40,"40115",142,100,100,0,0,"PUM+J",0
4,"4043",517,398,395,1,3,"PUM+J",0
19,"19234",44,30,30,0,0,"PUM+J",1
9,"9398",73,52,52,0,0,"PUM+J",1
22,"22158",11994,8115,8049,79,66,"PUM+J",8
5,"5030",40,32,32,0,0,"PUM+J",0
11,"11006",24558,15334,15113,231,221,"PUM+J",8
9,"9027",47,38,34,1,4,"PUM+J",1
10,"10181",676,470,462,2,8,"PUM+J",0
7,"7007",416,277,275,4,2,"PUM+J",3
16,"16162",39,31,31,0,0,"PUM+J",0
22,"22051",90,72,72,2,0,"PUM+J",0
12,"12038",157,101,100,3,1,"PUM+J",0
49,"49012",70,34,34,0,0,"PUM+J",0
26,"26127",182,149,149,1,0,"PUM+J",0
40,"40048",35,27,27,0,0,"PUM+J",0
9,"9268",89,62,62,0,0,"PUM+J",0
19,"19329",58,46,46,0,0,"PUM+J",0
30,"30005",30268,20979,20778,148,201,"PUM+J",21
9,"9226",54,45,45,2,0,"PUM+J",0
50,"50036",100,76,76,1,0,"PUM+J",0
13,"13096",7526,5212,5131,25,81,"PUM+J",4
19,"19022",592,423,420,6,3,"PUM+J",1
47,"47102",257,212,210,2,2,"PUM+J",0
18,"18074",265,205,205,0,0,"PUM+J",0
19,"19057",69,51,51,0,0,"PUM+J",1
10,"10145",123,90,84,0,6,"PUM+J",0
2,"2068",323,239,239,3,0,"PUM+J",0
37,"37381",138,98,93,0,5,"PUM+J",0
42,"42032",138,96,96,0,0,"PUM+J",0
33,"33071",546,385,383,7,2,"PUM+J",0
34,"34176",127,95,90,3,5,"PUM+J",0
50,"50254",179,115,113,0,2,"PUM+J",0
12,"12037",17,13,13,1,0,"PUM+J",0
14,"14059",679,527,521,11,6,"PUM+J",0
22,"22110",700,476,473,3,3,"PUM+J",0
34,"34204",50,35,35,0,0,"PUM+J",0
5,"5251",56,35,34,0,1,"PUM+J",0
37,"37081",879,680,674,2,6,"PUM+J",0
34,"34070",131,98,96,0,2,"PUM+J",0
47,"47161",3970,3111,3089,24,22,"PUM+J",2
49,"49208",352,223,214,1,9,"PUM+J",0
14,"14029",4001,2855,2821,30,34,"PUM+J",1
34,"34903",179,129,129,1,0,"PUM+J",0
44,"44119",116,80,79,1,1,"PUM+J",0
26,"26041",109,67,65,0,2,"PUM+J",0
46,"46121",106,91,90,1,1,"PUM+J",0
37,"37369",126,83,81,0,2,"PUM+J",0
39,"39100",849,567,565,5,2,"PUM+J",0
23,"23096",2543,2029,1986,16,43,"PUM+J",2
18,"18057",5584,4042,3958,51,84,"PUM+J",5
47,"47142",121,85,85,0,0,"PUM+J",0
4,"4103",1432,1003,993,10,10,"PUM+J",0
30,"30027",50067,36417,36074,242,343,"PUM+J",19
50,"50021",25,21,21,0,0,"PUM+J",0
45,"45157",2288,1490,1472,5,18,"PUM+J",6
19,"19258",84,63,62,0,1,"PUM+J",0
3,"3119",17253,12346,12258,81,88,"PUM+J",15
38,"38009",4315,2846,2817,27,29,"PUM+J",0
49,"49081",1321,972,953,6,19,"PUM+J",0
9,"9141",617,463,456,5,7,"PUM+J",4
33,"33014",8735,5744,5689,67,55,"PUM+J",2
9,"9455",45,34,33,0,1,"PUM+J",0
47,"47170",43,36,30,0,6,"PUM+J",0
9,"9251",362,258,256,3,2,"PUM+J",2
13,"13081",584,412,405,0,7,"PUM+J",1
37,"37065",276,167,167,2,0,"PUM+J",0
26,"26072",287,239,235,3,4,"PUM+J",1
16,"16115",49,32,32,0,0,"PUM+J",0
22,"22188",75,50,50,1,0,"PUM+J",0
34,"34074",690,502,490,13,12,"PUM+J",0
26,"26080",451,347,344,0,3,"PUM+J",1
34,"34102",197,158,156,1,2,"PUM+J",0
44,"44163",115,79,78,0,1,"PUM+J",1
7,"7016",2970,1891,1865,22,26,"PUM+J",1
9,"9281",136,97,97,2,0,"PUM+J",0
24,"24027",1214,841,828,6,13,"PUM+J",0
44,"44179",324,201,201,2,0,"PUM+J",0
9,"9446",10,7,7,0,0,"PUM+J",0
5,"5147",144,101,99,0,2,"PUM+J",0
49,"49163",203,139,138,3,1,"PUM+J",0
16,"16022",76,63,63,0,0,"PUM+J",0
50,"50083",81,64,64,2,0,"PUM+J",1
29,"29038",18908,12122,11931,197,191,"PUM+J",12
42,"42183",102,74,74,1,0,"PUM+J",0
45,"45075",120,77,74,0,3,"PUM+J",0
16,"16192",42,28,28,0,0,"PUM+J",0
46,"46139",4520,3486,3457,18,29,"PUM+J",0
37,"37212",104,76,76,0,0,"PUM+J",0
29,"29903",485,326,324,2,2,"PUM+J",0
3,"3060",105,78,77,0,1,"PUM+J",0
45,"45173",9756,6811,6720,49,91,"PUM+J",18
34,"34001",39,27,27,1,0,"PUM+J",0
18,"18050",1649,1113,1095,5,18,"PUM+J",0
16,"16206",184,126,125,4,1,"PUM+J",0
41,"41086",16199,10227,10105,137,122,"PUM+J",14
42,"42022",206,147,146,6,1,"PUM+J",0
45,"45182",996,760,754,5,6,"PUM+J",1
38,"38006",41593,20823,20624,127,199,"PUM+J",6
16,"16264",385,311,305,1,6,"PUM+J",0
24,"24179",287,207,207,2,0,"PUM+J",0
16,"16113",3065,2142,2108,13,34,"PUM+J",1
34,"34003",147,104,103,0,1,"PUM+J",0
44,"44132",54,49,49,0,0,"PUM+J",0
10,"10095",317,245,239,0,6,"PUM+J",0
10,"10108",203,116,116,1,0,"PUM+J",0
34,"34210",98,82,82,1,0,"PUM+J",0
16,"16071",20,16,16,0,0,"PUM+J",0
24,"24016",488,244,243,0,1,"PUM+J",0
37,"37030",82,60,60,0,0,"PUM+J",0
45,"45078",1333,1084,1077,6,7,"PUM+J",0
5,"5118",64,41,41,1,0,"PUM+J",0
18,"18018",542,384,377,2,7,"PUM+J",0
37,"37378",92,54,54,0,0,"PUM+J",0
26,"26178",72,56,56,1,0,"PUM+J",1
24,"24020",436,230,228,0,2,"PUM+J",0
12,"12131",97,87,87,0,0,"PUM+J",0
26,"26166",144,125,124,0,1,"PUM+J",0
14,"14062",945,700,693,2,7,"PUM+J",0
9,"9073",964,713,706,3,7,"PUM+J",5
44,"44212",41,29,29,0,0,"PUM+J",0
18,"18151",261,167,166,4,1,"PUM+J",0
22,"22069",423,296,294,4,2,"PUM+J",4
4,"4006",7192,4389,4335,39,54,"PUM+J",7
16,"16166",240,173,171,0,2,"PUM+J",0
46,"46073",1066,823,817,11,6,"PUM+J",3
18,"18901",489,323,322,5,1,"PUM+J",1
29,"29032",6655,4900,4775,36,125,"PUM+J",5
42,"42009",77,58,58,0,0,"PUM+J",0
9,"9422",19,13,13,0,0,"PUM+J",0
29,"29041",3697,2406,2361,47,45,"PUM+J",0
37,"37355",159,121,120,1,1,"PUM+J",1
9,"9074",844,610,609,12,1,"PUM+J",2
34,"34069",2184,1555,1517,17,38,"PUM+J",4
18,"18910",710,439,434,1,5,"PUM+J",1
50,"50104",320,251,251,1,0,"PUM+J",0
3,"3093",19702,13903,13728,113,175,"PUM+J",23
49,"49265",110,79,78,2,1,"PUM+J",0
7,"7030",1598,1127,1098,14,29,"PUM+J",1
10,"10130",1754,1199,1189,10,10,"PUM+J",1
9,"9444",63,40,40,1,0,"PUM+J",0
19,"19204",150,105,104,3,1,"PUM+J",0
2,"2030",2949,2158,2122,16,36,"PUM+J",1
5,"5127",600,472,469,7,3,"PUM+J",0
16,"16002",192,160,158,2,2,"PUM+J",0
3,"3080",1330,1040,1032,4,8,"PUM+J",0
44,"44041",60,48,48,0,0,"PUM+J",0
10,"10135",1240,834,826,3,8,"PUM+J",0
50,"50085",182,121,121,0,0,"PUM+J",0
5,"5081",37,21,21,3,0,"PUM+J",0
44,"44102",26,19,19,0,0,"PUM+J",0
26,"26161",8,8,8,0,0,"PUM+J",0
13,"13051",336,253,249,1,4,"PUM+J",0
49,"49239",599,393,384,6,9,"PUM+J",0
28,"28182",203,167,163,1,4,"PUM+J",0
5,"5186",1564,1140,1125,5,15,"PUM+J",0
9,"9132",170,121,120,0,1,"PUM+J",1
10,"10208",122,85,83,0,2,"PUM+J",0
24,"24036",252,146,146,1,0,"PUM+J",0
3,"3065",169894,121210,120342,1045,868,"PUM+J",132
34,"34101",48,36,36,1,0,"PUM+J",0
26,"26170",423,303,301,2,2,"PUM+J",0
38,"38014",1342,943,930,6,13,"PUM+J",0
3,"3010",332,275,268,1,7,"PUM+J",1
37,"37254",174,140,135,0,5,"PUM+J",0
47,"47151",26,22,22,0,0,"PUM+J",0
16,"16216",272,207,204,0,3,"PUM+J",0
10,"10101",178,129,125,0,4,"PUM+J",0
41,"41016",7820,5523,5407,57,116,"PUM+J",7
49,"49101",144,88,82,1,6,"PUM+J",0
28,"28026",6767,5058,5024,27,34,"PUM+J",3
49,"49026",199,134,134,0,0,"PUM+J",0
44,"44187",193,147,146,0,1,"PUM+J",0
19,"19197",28,22,22,1,0,"PUM+J",0
46,"46160",1922,1395,1381,4,14,"PUM+J",0
28,"28036",2699,1977,1957,20,20,"PUM+J",3
37,"37005",65,44,44,1,0,"PUM+J",0
40,"40228",493,362,361,3,1,"PUM+J",0
50,"50160",2140,1421,1394,14,27,"PUM+J",0
37,"37175",412,298,293,4,5,"PUM+J",2
3,"3073",222,178,178,0,0,"PUM+J",0
19,"19147",42,32,32,0,0,"PUM+J",0
46,"46145",22215,15688,15538,127,150,"PUM+J",13
19,"19332",85,59,57,4,2,"PUM+J",0
12,"12048",243,159,155,4,4,"PUM+J",0
16,"16102",1159,815,767,9,48,"PUM+J",0
40,"40233",399,279,273,0,6,"PUM+J",0
6,"6036",4930,3492,3394,20,98,"PUM+J",4
16,"16274",97,76,75,1,1,"PUM+J",0
9,"9449",91,78,76,1,2,"PUM+J",22
19,"19096",105,72,70,0,2,"PUM+J",0
40,"40155",3897,2920,2880,56,40,"PUM+J",9
5,"5017",84,70,67,2,3,"PUM+J",0
19,"19249",29,26,26,0,0,"PUM+J",0
47,"47006",182,149,145,1,4,"PUM+J",0
44,"44190",63,45,45,0,0,"PUM+J",0
45,"45012",623,482,472,0,10,"PUM+J",0
47,"47227",53,36,35,0,1,"PUM+J",0
3,"3106",559,469,465,3,4,"PUM+J",0
4,"4024",3241,2315,2290,34,25,"PUM+J",6
45,"45123",3196,2252,2218,11,34,"PUM+J",5
47,"47133",2776,2096,2073,28,23,"PUM+J",2
14,"14022",3881,2888,2853,15,35,"PUM+J",0
24,"24028",367,275,273,5,2,"PUM+J",0
38,"38024",15316,9131,9005,60,126,"PUM+J",4
10,"10106",126,102,102,0,0,"PUM+J",0
6,"6051",1523,1147,1137,5,10,"PUM+J",0
29,"29073",1657,1082,1069,15,13,"PUM+J",1
47,"47195",426,314,310,2,4,"PUM+J",0
18,"18062",11226,7969,7777,88,192,"PUM+J",7
42,"42140",15,11,11,1,0,"PUM+J",0
2,"2036",93,66,66,0,0,"PUM+J",0
24,"24174",457,294,289,3,5,"PUM+J",0
24,"24164",351,175,174,0,1,"PUM+J",0
13,"13064",1845,1314,1298,10,16,"PUM+J",1
44,"44084",54,46,46,1,0,"PUM+J",0
24,"24078",324,228,225,0,3,"PUM+J",0
18,"18093",2751,1693,1674,18,19,"PUM+J",1
9,"9191",33,23,23,1,0,"PUM+J",0
46,"46117",493,386,380,2,6,"PUM+J",0
49,"49266",66,46,45,1,1,"PUM+J",0
24,"24019",338,259,256,4,3,"PUM+J",0
39,"39052",19005,13859,13748,83,111,"PUM+J",11
44,"44192",341,274,272,2,2,"PUM+J",0
16,"16153",924,751,741,4,10,"PUM+J",1
18,"18045",1065,720,690,11,30,"PUM+J",1
12,"12016",1549,1244,1234,9,10,"PUM+J",0
19,"19211",350,272,269,0,3,"PUM+J",0
18,"18103",714,500,498,3,2,"PUM+J",0
19,"19240",49,36,36,0,0,"PUM+J",2
37,"37260",137,110,109,0,1,"PUM+J",0
24,"24148",1602,1152,1140,11,12,"PUM+J",1
45,"45090",370,262,261,2,1,"PUM+J",0
40,"40170",1302,962,948,6,14,"PUM+J",0
26,"26139",58,43,43,2,0,"PUM+J",0
44,"44182",203,160,158,0,2,"PUM+J",0
19,"19305",139,104,103,1,1,"PUM+J",0
49,"49204",58,44,43,1,1,"PUM+J",0
9,"9437",266,207,203,4,4,"PUM+J",2
7,"7009",737,495,488,3,7,"PUM+J",2
12,"12140",1147,849,841,5,8,"PUM+J",2
44,"44124",71,57,57,0,0,"PUM+J",0
34,"34245",307,212,212,0,0,"PUM+J",1
28,"28052",3961,2700,2659,14,41,"PUM+J",0
50,"50138",45,37,37,3,0,"PUM+J",0
44,"44154",240,164,161,1,3,"PUM+J",0
14,"14044",1613,1186,1164,10,22,"PUM+J",1
3,"3026",1331,987,975,7,12,"PUM+J",1
12,"12065",167,142,141,0,1,"PUM+J",0
10,"10137",394,297,296,3,1,"PUM+J",0
7,"7022",11659,7045,6965,84,80,"PUM+J",16
47,"47094",120,100,100,0,0,"PUM+J",0
24,"24069",37,26,25,0,1,"PUM+J",0
41,"41032",3842,2800,2704,24,96,"PUM+J",0
9,"9480",105,84,84,0,0,"PUM+J",0
41,"41904",1789,1125,1109,31,16,"PUM+J",0
14,"14061",687,536,523,1,13,"PUM+J",0
5,"5106",27,14,14,0,0,"PUM+J",0
14,"14064",296,211,208,6,3,"PUM+J",0
6,"6059",1724,1084,1067,6,17,"PUM+J",4
21,"21009",834,527,508,4,19,"PUM+J",1
14,"14005",6298,3905,3828,71,77,"PUM+J",0
45,"45105",376,277,268,5,9,"PUM+J",0
21,"21902",1136,744,739,2,5,"PUM+J",1
50,"50298",5439,4053,4007,41,46,"PUM+J",2
50,"50058",63,45,43,0,2,"PUM+J",0
46,"46102",19696,14700,14579,125,121,"PUM+J",9
19,"19126",1701,1223,1207,6,16,"PUM+J",1
38,"38050",2417,1288,1273,9,15,"PUM+J",0
21,"21033",569,410,405,3,5,"PUM+J",0
46,"46222",402,329,326,0,3,"PUM+J",1
40,"40162",380,273,265,1,8,"PUM+J",0
19,"19088",91,67,66,0,1,"PUM+J",0
34,"34132",106,73,72,0,1,"PUM+J",0
21,"21030",1887,1493,1458,12,35,"PUM+J",0
16,"16030",24,18,18,1,0,"PUM+J",0
5,"5229",75,61,61,1,0,"PUM+J",0
49,"49134",158,100,99,1,1,"PUM+J",0
39,"39102",2229,1524,1514,10,10,"PUM+J",1
47,"47065",820,608,602,2,6,"PUM+J",0
49,"49247",412,255,252,2,3,"PUM+J",0
33,"33037",33074,20693,20412,259,281,"PUM+J",16
24,"24159",1716,1238,1216,6,22,"PUM+J",1
24,"24119",695,464,458,7,6,"PUM+J",0
28,"28025",405,294,291,5,3,"PUM+J",0
42,"42116",37,30,29,2,1,"PUM+J",0
5,"5101",266,206,205,1,1,"PUM+J",0
49,"49037",174,139,136,1,3,"PUM+J",1
44,"44077",68,52,51,0,1,"PUM+J",0
22,"22245",303,222,213,3,9,"PUM+J",0
26,"26042",795,578,572,8,6,"PUM+J",0
12,"12021",4398,3314,3277,32,37,"PUM+J",5
5,"5036",118,91,90,0,1,"PUM+J",0
40,"40904",344,286,284,8,2,"PUM+J",0
19,"19052",21,16,16,0,0,"PUM+J",0
24,"24050",105,77,77,2,0,"PUM+J",0
9,"9428",102,73,73,1,0,"PUM+J",0
41,"41045",5873,3901,3802,53,99,"PUM+J",6
45,"45133",2798,1957,1922,11,35,"PUM+J",0
7,"7037",3448,1875,1856,18,19,"PUM+J",0
39,"39011",1587,1178,1178,6,0,"PUM+J",1
4,"4056",165,120,120,0,0,"PUM+J",0
35,"35026",83172,48751,48109,449,642,"PUM+J",36
35,"35011",24859,15025,14833,149,192,"PUM+J",14
33,"33045",4359,2819,2787,32,32,"PUM+J",1
3,"3015",12818,9127,9017,46,110,"PUM+J",12
40,"40172",47,33,32,0,1,"PUM+J",0
9,"9304",198,152,149,1,3,"PUM+J",1
30,"30022",17108,11041,10851,100,190,"PUM+J",6
46,"46201",62,40,40,0,0,"PUM+J",0
5,"5085",31,27,27,0,0,"PUM+J",0
38,"38007",1619,1053,1043,3,10,"PUM+J",0
5,"5103",63,44,44,1,0,"PUM+J",0
26,"26162",108,90,89,1,1,"PUM+J",1
50,"50143",541,373,367,2,6,"PUM+J",0
7,"7005",6956,4042,3996,35,46,"PUM+J",5
47,"47111",1001,738,732,5,6,"PUM+J",1
16,"16253",308,230,228,2,2,"PUM+J",0
19,"19065",109,86,85,1,1,"PUM+J",0
16,"16123",66,42,41,0,1,"PUM+J",0
9,"9323",57,37,36,0,1,"PUM+J",0
26,"26122",115,81,80,4,1,"PUM+J",1
46,"46040",993,745,733,3,12,"PUM+J",0
46,"46192",786,534,519,7,15,"PUM+J",0
39,"39069",1934,1475,1458,2,17,"PUM+J",0
42,"42196",7,7,7,1,0,"PUM+J",0
42,"42197",68,54,53,0,1,"PUM+J",0
19,"19171",5380,3964,3919,22,45,"PUM+J",7
40,"40178",85,61,60,0,1,"PUM+J",0
28,"28176",13980,10765,10701,72,64,"PUM+J",8
4,"4037",1212,890,875,17,15,"PUM+J",3
10,"10214",216,170,170,2,0,"PUM+J",0
5,"5212",197,117,117,0,0,"PUM+J",0
40,"40112",2813,2126,2087,26,39,"PUM+J",2
33,"33070",3267,2211,2185,27,26,"PUM+J",3
9,"9140",117,78,77,1,1,"PUM+J",0
19,"19036",242,202,200,1,2,"PUM+J",0
37,"37101",138,101,100,1,1,"PUM+J",0
34,"34050",187,136,136,1,0,"PUM+J",0
40,"40146",260,206,204,0,2,"PUM+J",1
28,"28125",3208,2275,2252,5,23,"PUM+J",4
28,"28050",4406,3202,3167,29,35,"PUM+J",1
26,"26155",145,120,119,0,1,"PUM+J",0
19,"19226",37,22,22,0,0,"PUM+J",0
41,"41021",21410,14369,14139,195,230,"PUM+J",31
24,"24157",2542,1846,1809,16,37,"PUM+J",4
37,"37131",175,125,125,0,0,"PUM+J",0
9,"9365",26,17,17,0,0,"PUM+J",0
46,"46103",1354,993,978,8,15,"PUM+J",0
45,"45049",419,303,295,1,8,"PUM+J",0
10,"10059",329,202,201,1,1,"PUM+J",0
24,"24188",3795,2877,2825,40,52,"PUM+J",6
44,"44211",33,22,22,0,0,"PUM+J",0
26,"26100",54,43,43,0,0,"PUM+J",0
24,"24043",116,54,52,0,2,"PUM+J",0
47,"47197",875,659,656,9,3,"PUM+J",0
11,"11903",1769,1116,1101,22,15,"PUM+J",0
38,"38010",3969,2463,2418,11,45,"PUM+J",2
22,"22195",238,190,186,0,4,"PUM+J",0
50,"50102",815,594,584,7,10,"PUM+J",1
34,"34243",323,243,239,1,4,"PUM+J",0
37,"37177",259,198,197,3,1,"PUM+J",2
40,"40127",36,25,23,0,2,"PUM+J",1
9,"9143",28,17,17,0,0,"PUM+J",0
42,"42127",37,26,26,1,0,"PUM+J",0
16,"16116",76,59,58,1,1,"PUM+J",0
39,"39025",8637,6256,6179,33,77,"PUM+J",0
26,"26179",39,27,27,0,0,"PUM+J",0
47,"47103",252,195,192,1,3,"PUM+J",0
46,"46020",3757,2834,2783,16,51,"PUM+J",2
34,"34230",16,11,11,0,0,"PUM+J",0
40,"40106",179,140,139,2,1,"PUM+J",0
45,"45164",166,143,142,1,1,"PUM+J",0
19,"19013",111,89,89,0,0,"PUM+J",0
9,"9330",1481,1050,1037,17,13,"PUM+J",3
28,"28150",3191,2423,2401,13,22,"PUM+J",2
34,"34146",53,43,43,0,0,"PUM+J",0
37,"37044",431,309,308,3,1,"PUM+J",1
37,"37188",158,107,105,3,2,"PUM+J",0
22,"22074",303,209,208,5,1,"PUM+J",0
49,"49234",394,282,277,0,5,"PUM+J",0
9,"9179",39,30,30,1,0,"PUM+J",0
29,"29048",1364,1053,1039,8,14,"PUM+J",2
22,"22109",261,184,183,1,1,"PUM+J",0
12,"12138",19207,13018,12891,87,127,"PUM+J",10
49,"49255",387,304,298,3,6,"PUM+J",0
16,"16082",272,194,192,1,2,"PUM+J",2
24,"24191",106,70,69,2,1,"PUM+J",1
19,"19047",55,47,47,1,0,"PUM+J",0
24,"24004",495,387,384,10,3,"PUM+J",0
9,"9242",66,53,52,3,1,"PUM+J",0
4,"4046",849,617,612,6,5,"PUM+J",3
34,"34010",550,407,399,7,8,"PUM+J",1
9,"9275",167,114,114,1,0,"PUM+J",1
3,"3074",1766,1347,1336,4,11,"PUM+J",0
2,"2901",2196,1441,1419,10,22,"PUM+J",2
19,"19266",229,184,182,1,2,"PUM+J",0
16,"16265",22,18,18,0,0,"PUM+J",0
28,"28035",1404,981,966,4,15,"PUM+J",0
29,"29070",43686,27672,27323,290,349,"PUM+J",38
12,"12134",135,95,95,1,0,"PUM+J",2
44,"44088",24,23,23,0,0,"PUM+J",0
28,"28183",1162,823,813,9,10,"PUM+J",2
42,"42042",53,42,41,1,1,"PUM+J",0
45,"45107",3463,2621,2585,23,36,"PUM+J",3
47,"47119",89,59,58,2,1,"PUM+J",0
49,"49048",113,88,88,0,0,"PUM+J",0
10,"10088",198,112,112,1,0,"PUM+J",0
41,"41035",1051,733,722,10,11,"PUM+J",1
16,"16266",356,269,265,4,4,"PUM+J",0
34,"34087",125,99,99,2,0,"PUM+J",1
41,"41026",4302,3355,3288,26,67,"PUM+J",3
47,"47141",112,90,89,0,1,"PUM+J",0
9,"9261",446,279,271,2,8,"PUM+J",1
47,"47098",567,452,446,4,6,"PUM+J",0
47,"47193",1625,1251,1236,10,15,"PUM+J",2
37,"37201",238,170,168,0,2,"PUM+J",0
47,"47056",81,57,57,0,0,"PUM+J",0
22,"22076",285,207,203,4,4,"PUM+J",0
44,"44027",144,113,113,2,0,"PUM+J",0
29,"29024",371,216,204,3,12,"PUM+J",0
9,"9131",485,390,388,7,2,"PUM+J",1
26,"26068",78,61,61,0,0,"PUM+J",0
10,"10126",1455,966,948,9,18,"PUM+J",1
44,"44165",168,125,125,2,0,"PUM+J",0
49,"49040",109,89,87,2,2,"PUM+J",0
10,"10131",12803,8477,8347,77,130,"PUM+J",12
46,"46017",33041,23469,23277,173,192,"PUM+J",24
46,"46034",1826,1345,1335,3,10,"PUM+J",1
28,"28037",1570,1135,1123,4,12,"PUM+J",0
12,"12005",8049,5643,5552,71,91,"PUM+J",5
28,"28017",1280,975,963,10,12,"PUM+J",1
22,"22046",713,555,549,9,6,"PUM+J",0
37,"37121",536,413,403,4,10,"PUM+J",1
46,"46100",281,190,187,1,3,"PUM+J",0
42,"42045",273,175,174,4,1,"PUM+J",0
24,"24212",983,693,684,10,9,"PUM+J",1
19,"19269",86,61,61,0,0,"PUM+J",0
37,"37183",377,267,267,5,0,"PUM+J",0
4,"4013",143819,93083,92383,893,700,"PUM+J",141
22,"22225",2606,1638,1612,20,26,"PUM+J",3
34,"34061",91,70,69,1,1,"PUM+J",0
44,"44067",106,75,71,0,4,"PUM+J",0
13,"13092",1703,1327,1307,4,20,"PUM+J",2
6,"6097",2258,1631,1602,10,29,"PUM+J",2
18,"18095",2054,1475,1433,14,42,"PUM+J",1
34,"34156",51,42,42,0,0,"PUM+J",1
7,"7051",5484,3133,3094,43,39,"PUM+J",3
50,"50153",914,683,675,9,8,"PUM+J",2
9,"9022",58,46,46,1,0,"PUM+J",0
44,"44082",84,66,66,0,0,"PUM+J",0
28,"28177",10851,8550,8485,89,65,"PUM+J",11
47,"47185",82,62,61,1,1,"PUM+J",0
9,"9007",54,37,35,0,2,"PUM+J",0
22,"22103",664,489,489,4,0,"PUM+J",1
42,"42010",21,15,14,0,1,"PUM+J",0
28,"28009",14593,11026,10913,73,113,"PUM+J",10
44,"44012",303,215,215,2,0,"PUM+J",1
24,"24125",416,233,231,3,2,"PUM+J",0
9,"9382",27,22,22,0,0,"PUM+J",0
26,"26164",50,36,35,0,1,"PUM+J",0
47,"47176",199,110,110,0,0,"PUM+J",0
11,"11024",6550,4500,4402,67,98,"PUM+J",1
9,"9327",26,20,20,0,0,"PUM+J",0
50,"50212",32,26,26,0,0,"PUM+J",0
47,"47070",29,24,24,0,0,"PUM+J",0
49,"49166",1193,835,821,7,14,"PUM+J",2
50,"50286",75,54,53,0,1,"PUM+J",0
24,"24052",139,94,93,0,1,"PUM+J",0
45,"45015",656,449,438,2,11,"PUM+J",1
42,"42011",16,11,11,0,0,"PUM+J",0
7,"7031",24972,14866,14757,127,109,"PUM+J",14
45,"45016",4486,3288,3251,19,37,"PUM+J",6
24,"24215",149,116,115,0,1,"PUM+J",1
49,"49120",54,35,35,0,0,"PUM+J",0
30,"30001",4507,3357,3331,17,26,"PUM+J",7
29,"29003",916,677,666,4,11,"PUM+J",0
42,"42036",40,33,32,1,1,"PUM+J",0
28,"28116",748,576,569,2,7,"PUM+J",1
9,"9406",239,165,162,2,3,"PUM+J",0
16,"16142",119,90,90,0,0,"PUM+J",0
2,"2083",209,181,181,0,0,"PUM+J",0
26,"26086",15,15,15,0,0,"PUM+J",0
28,"28159",589,455,447,4,8,"PUM+J",0
10,"10041",1022,720,706,2,14,"PUM+J",0
19,"19184",59,47,47,0,0,"PUM+J",1
46,"46240",200,167,155,1,12,"PUM+J",1
37,"37271",349,262,258,2,4,"PUM+J",2
28,"28127",66793,53258,53009,458,249,"PUM+J",51
29,"29004",283,222,218,3,4,"PUM+J",0
37,"37314",81,65,65,0,0,"PUM+J",0
47,"47221",97,85,84,1,1,"PUM+J",0
42,"42202",19,11,10,0,1,"PUM+J",0
37,"37376",2130,1446,1423,18,23,"PUM+J",0
19,"19245",1138,798,778,6,20,"PUM+J",0
45,"45080",3,3,3,0,0,"PUM+J",0
40,"40061",63,47,44,0,3,"PUM+J",0
42,"42082",8,8,8,0,0,"PUM+J",0
41,"41033",4958,3299,3250,38,49,"PUM+J",3
5,"5249",96,63,63,0,0,"PUM+J",0
2,"2074",5890,4054,4010,39,44,"PUM+J",7
21,"21039",303,211,210,6,1,"PUM+J",1
38,"38012",2286,1520,1510,8,10,"PUM+J",0
39,"39045",352,238,234,0,4,"PUM+J",0
10,"10099",563,369,358,3,11,"PUM+J",0
37,"37169",177,122,122,0,0,"PUM+J",0
44,"44252",73,56,55,0,1,"PUM+J",0
13,"13025",290,233,231,0,2,"PUM+J",0
44,"44013",11232,7872,7801,64,71,"PUM+J",5
33,"33046",480,334,329,0,5,"PUM+J",0
2,"2053",2888,2086,2042,14,44,"PUM+J",1
34,"34220",152,133,132,1,1,"PUM+J",0
28,"28130",28569,22050,21799,187,251,"PUM+J",22
39,"39046",1342,910,902,3,8,"PUM+J",0
37,"37069",981,669,657,3,12,"PUM+J",1
37,"37148",399,295,291,0,4,"PUM+J",0
5,"5121",263,194,189,1,5,"PUM+J",1
44,"44007",149,112,111,1,1,"PUM+J",0
39,"39037",2033,1431,1420,3,11,"PUM+J",2
24,"24001",165,93,93,0,0,"PUM+J",1
16,"16107",94,56,56,0,0,"PUM+J",0
4,"4058",342,238,236,3,2,"PUM+J",0
5,"5122",118,91,89,1,2,"PUM+J",0
39,"39075",136789,95707,95089,478,618,"PUM+J",56
45,"45083",568,433,429,2,4,"PUM+J",0
22,"22162",125,94,94,0,0,"PUM+J",0
5,"5022",1580,1202,1193,6,9,"PUM+J",1
10,"10904",714,487,473,8,14,"PUM+J",0
37,"37096",203,144,144,2,0,"PUM+J",0
16,"16188",74,57,57,1,0,"PUM+J",1
50,"50233",96,78,78,0,0,"PUM+J",0
47,"47192",89,78,76,3,2,"PUM+J",0
18,"18913",771,530,514,2,16,"PUM+J",0
52,"52001",54293,31015,30776,185,239,"PUM+J",29
47,"47172",135,114,113,0,1,"PUM+J",0
9,"9318",56,33,33,0,0,"PUM+J",0
11,"11010",6327,3998,3928,112,70,"PUM+J",3
9,"9227",112,89,89,1,0,"PUM+J",1
49,"49064",478,297,296,6,1,"PUM+J",0
49,"49136",313,218,217,5,1,"PUM+J",1
24,"24003",603,374,372,0,2,"PUM+J",0
41,"41036",3903,2708,2645,35,63,"PUM+J",3
50,"50169",333,231,230,0,1,"PUM+J",0
46,"46206",555,417,408,0,9,"PUM+J",0
47,"47068",29,21,21,0,0,"PUM+J",0
49,"49250",1191,844,824,8,20,"PUM+J",1
47,"47164",349,283,281,1,2,"PUM+J",0
5,"5025",78,65,65,0,0,"PUM+J",0
19,"19901",35,27,27,0,0,"PUM+J",0
19,"19007",433,316,310,1,6,"PUM+J",0
6,"6141",1678,1183,1158,15,25,"PUM+J",1
16,"16239",118,88,87,0,1,"PUM+J",0
46,"46039",2111,1657,1640,16,17,"PUM+J",1
14,"14021",260521,185270,183300,2192,1970,"PUM+J",225
42,"42058",103,74,72,1,2,"PUM+J",0
23,"23002",17427,12837,12542,126,295,"PUM+J",13
5,"5254",184,149,147,1,2,"PUM+J",0
49,"49214",666,486,477,6,9,"PUM+J",0
24,"24184",177,106,105,0,1,"PUM+J",0
4,"4061",625,489,479,5,10,"PUM+J",2
29,"29009",1435,971,957,17,14,"PUM+J",0
21,"21044",18061,11170,11003,123,167,"PUM+J",18
23,"23003",8639,6296,6226,41,70,"PUM+J",4
39,"39068",642,442,438,1,4,"PUM+J",0
10,"10050",987,707,704,4,3,"PUM+J",0
13,"13001",1188,865,858,4,7,"PUM+J",2
40,"40069",68,59,59,0,0,"PUM+J",0
45,"45013",1679,1266,1248,5,18,"PUM+J",3
9,"9037",105,94,93,0,1,"PUM+J",0
39,"39022",970,673,668,2,5,"PUM+J",0
37,"37258",134,92,92,1,0,"PUM+J",0
34,"34157",2353,1697,1669,18,28,"PUM+J",2
5,"5148",22,19,19,0,0,"PUM+J",0
50,"50293",392,257,255,2,2,"PUM+J",0
4,"4003",17583,11062,10941,77,121,"PUM+J",5
12,"12034",1389,1022,1002,5,20,"PUM+J",0
29,"29039",2759,1900,1860,23,40,"PUM+J",1
28,"28059",4516,3343,3299,30,44,"PUM+J",4
6,"6084",1061,780,769,11,11,"PUM+J",4
50,"50018",883,622,616,5,6,"PUM+J",0
33,"33051",6787,4318,4268,48,50,"PUM+J",5
34,"34159",375,221,214,4,7,"PUM+J",0
41,"41039",31538,22078,21717,278,361,"PUM+J",24
49,"49153",150,110,107,2,3,"PUM+J",0
37,"37124",195,137,137,2,0,"PUM+J",0
47,"47146",275,215,214,1,1,"PUM+J",1
19,"19070",65,45,45,0,0,"PUM+J",0
22,"22128",188,145,143,3,2,"PUM+J",1
19,"19272",66,55,55,2,0,"PUM+J",1
16,"16025",24,20,20,0,0,"PUM+J",0
42,"42187",58,44,39,1,5,"PUM+J",0
37,"37134",209,143,141,3,2,"PUM+J",0
9,"9127",52,36,35,0,1,"PUM+J",0
24,"24142",24715,16839,16616,159,223,"PUM+J",17
18,"18072",655,452,445,4,7,"PUM+J",1
37,"37344",229,157,147,2,10,"PUM+J",0
19,"19192",1762,1251,1240,5,11,"PUM+J",0
26,"26036",16989,11463,11260,101,203,"PUM+J",13
49,"49021",14204,9429,9295,87,134,"PUM+J",6
16,"16227",109,78,76,0,2,"PUM+J",0
45,"45029",186,154,154,2,0,"PUM+J",0
50,"50221",29,18,18,0,0,"PUM+J",0
44,"44201",477,399,395,1,4,"PUM+J",0
33,"33034",9979,5937,5873,64,64,"PUM+J",6
50,"50238",84,65,65,0,0,"PUM+J",0
40,"40201",42,37,37,0,0,"PUM+J",0
9,"9366",76,55,55,2,0,"PUM+J",0
29,"29013",1613,1191,1154,9,37,"PUM+J",0
5,"5054",1192,871,856,6,15,"PUM+J",0
10,"10191",511,374,365,5,9,"PUM+J",0
28,"28138",60,43,42,0,1,"PUM+J",0
24,"24229",376,275,269,2,6,"PUM+J",0
28,"28137",1770,1300,1289,6,11,"PUM+J",4
14,"14073",2768,1934,1880,33,54,"PUM+J",1
28,"28002",3250,2261,2243,14,18,"PUM+J",1
37,"37032",553,388,388,2,0,"PUM+J",0
37,"37324",333,247,242,3,5,"PUM+J",0
40,"40107",90,67,67,0,0,"PUM+J",0
29,"29068",7833,4897,4806,50,91,"PUM+J",4
5,"5019",44865,32917,32586,282,331,"PUM+J",41
3,"3008",158,120,118,1,2,"PUM+J",0
6,"6044",29258,19865,19594,205,271,"PUM+J",50
49,"49146",265,183,181,4,2,"PUM+J",0
5,"5216",209,149,149,0,0,"PUM+J",0
3,"3902",10640,7024,6952,36,72,"PUM+J",4
46,"46044",4159,3062,2997,26,65,"PUM+J",2
22,"22029",118,85,83,1,2,"PUM+J",0
37,"37106",248,161,160,4,1,"PUM+J",0
40,"40009",41,35,34,0,1,"PUM+J",0
40,"40074",246,193,189,2,4,"PUM+J",0
21,"21060",12287,7761,7638,134,123,"PUM+J",11
3,"3037",340,261,255,3,6,"PUM+J",0
23,"23035",1111,877,856,2,21,"PUM+J",0
47,"47024",223,170,168,1,2,"PUM+J",0
47,"47203",54,40,40,0,0,"PUM+J",0
23,"23095",8571,6159,6101,37,58,"PUM+J",2
4,"4057",1261,886,872,6,14,"PUM+J",2
39,"39083",1063,619,611,2,8,"PUM+J",1
44,"44076",2089,1577,1565,8,12,"PUM+J",0
5,"5055",532,417,413,3,4,"PUM+J",0
4,"4033",121,78,77,3,1,"PUM+J",0
29,"29090",1649,1138,1124,10,14,"PUM+J",1
6,"6077",319,234,229,2,5,"PUM+J",0
18,"18111",2863,2038,2001,29,37,"PUM+J",4
21,"21051",222,171,168,3,3,"PUM+J",0
16,"16083",44,24,24,0,0,"PUM+J",0
45,"45095",663,496,492,2,4,"PUM+J",1
38,"38005",5646,3302,3283,24,19,"PUM+J",1
33,"33075",244,125,122,3,3,"PUM+J",0
9,"9208",176,121,120,4,1,"PUM+J",0
2,"2055",1055,672,668,2,4,"PUM+J",1
49,"49113",162,131,131,2,0,"PUM+J",2
49,"49148",259,119,115,1,4,"PUM+J",0
10,"10102",496,378,377,1,1,"PUM+J",0
4,"4022",356,237,236,5,1,"PUM+J",1
2,"2033",1864,1352,1315,12,37,"PUM+J",2
50,"50216",236,169,167,0,2,"PUM+J",0
10,"10020",1571,1135,1117,2,18,"PUM+J",3
5,"5252",56,46,45,0,1,"PUM+J",0
9,"9050",57,38,38,1,0,"PUM+J",0
40,"40044",134,101,101,3,0,"PUM+J",0
44,"44046",44,33,33,0,0,"PUM+J",0
4,"4048",1499,964,957,4,7,"PUM+J",2
44,"44207",125,98,97,2,1,"PUM+J",0
18,"18914",1660,1255,1227,11,28,"PUM+J",2
33,"33076",12115,7519,7456,76,63,"PUM+J",9
16,"16159",198,135,135,2,0,"PUM+J",0
44,"44066",85,62,62,0,0,"PUM+J",0
45,"45073",288,214,210,2,4,"PUM+J",0
12,"12042",574,459,446,9,13,"PUM+J",1
30,"30030",321454,235061,233183,1744,1878,"PUM+J",152
3,"3077",1391,1052,1032,10,20,"PUM+J",2
12,"12128",1365,990,972,16,18,"PUM+J",0
9,"9159",62,49,47,0,2,"PUM+J",0
44,"44020",22,21,21,0,0,"PUM+J",0
44,"44198",182,138,135,0,3,"PUM+J",0
28,"28145",2671,1927,1895,21,32,"PUM+J",2
12,"12051",437,297,295,3,2,"PUM+J",0
24,"24122",1292,818,810,7,8,"PUM+J",1
11,"11042",1158,806,793,6,13,"PUM+J",0
33,"33021",4304,2643,2610,32,33,"PUM+J",0
47,"47144",72,54,53,2,1,"PUM+J",0
5,"5070",30,29,29,0,0,"PUM+J",0
5,"5169",218,171,171,1,0,"PUM+J",0
33,"33068",1031,518,510,5,8,"PUM+J",0
22,"22235",88,69,68,1,1,"PUM+J",0
37,"37237",296,212,204,1,8,"PUM+J",0
34,"34048",62,51,51,1,0,"PUM+J",0
9,"9105",95,65,64,1,1,"PUM+J",0
47,"47145",583,430,426,6,4,"PUM+J",0
50,"50244",192,131,130,1,1,"PUM+J",0
35,"35017",27498,15513,15240,121,273,"PUM+J",13
3,"3118",2446,1617,1598,8,19,"PUM+J",5
5,"5073",282,210,207,1,3,"PUM+J",0
9,"9177",1140,790,780,7,10,"PUM+J",3
42,"42184",55,36,33,0,3,"PUM+J",0
45,"45125",2256,1711,1689,16,22,"PUM+J",2
47,"47113",134,110,110,0,0,"PUM+J",0
3,"3089",9496,6617,6484,51,133,"PUM+J",6
29,"29011",2893,1763,1736,12,27,"PUM+J",0
24,"24054",410,275,271,0,4,"PUM+J",1
50,"50119",876,633,625,11,8,"PUM+J",0
34,"34139",160,117,115,2,2,"PUM+J",0
29,"29094",59795,39350,38854,454,496,"PUM+J",27
19,"19271",41,22,21,1,1,"PUM+J",0
44,"44114",233,161,159,0,2,"PUM+J",0
24,"24175",1821,1316,1305,15,11,"PUM+J",1
3,"3014",238937,161861,160809,1308,1052,"PUM+J",155
24,"24201",1029,683,676,9,7,"PUM+J",0
16,"16243",376,316,309,4,7,"PUM+J",0
42,"42061",270,188,186,5,2,"PUM+J",0
9,"9041",25,21,21,2,0,"PUM+J",0
29,"29021",155,111,109,1,2,"PUM+J",0
28,"28136",693,538,533,2,5,"PUM+J",1
42,"42200",74,49,46,0,3,"PUM+J",0
47,"47157",490,398,397,2,1,"PUM+J",0
9,"9199",91,68,68,0,0,"PUM+J",0
11,"11015",64414,39635,39220,776,415,"PUM+J",47
40,"40211",66,54,54,1,0,"PUM+J",0
22,"22181",86,55,54,2,1,"PUM+J",0
42,"42079",21,17,17,1,0,"PUM+J",0
49,"49243",107,74,74,0,0,"PUM+J",0
6,"6147",329,234,234,1,0,"PUM+J",1
19,"19117",1632,1187,1167,12,20,"PUM+J",1
44,"44193",73,60,60,1,0,"PUM+J",0
50,"50020",795,548,545,4,3,"PUM+J",0
34,"34052",164,127,125,1,2,"PUM+J",0
44,"44086",410,302,298,3,4,"PUM+J",0
16,"16092",149,108,108,1,0,"PUM+J",0
6,"6042",984,644,629,5,15,"PUM+J",1
28,"28012",929,707,698,7,9,"PUM+J",0
3,"3063",27209,18236,18101,164,135,"PUM+J",28
9,"9012",93,70,68,0,2,"PUM+J",0
24,"24058",189,115,114,1,1,"PUM+J",0
9,"9044",55,46,44,1,2,"PUM+J",1
19,"19174",90,65,64,0,1,"PUM+J",0
34,"34199",1150,767,754,14,13,"PUM+J",3
16,"16015",349,242,239,6,3,"PUM+J",0
40,"40213",93,78,78,1,0,"PUM+J",0
46,"46051",8469,6120,6070,40,50,"PUM+J",5
19,"19166",154,110,108,0,2,"PUM+J",0
14,"14017",10953,7929,7791,84,138,"PUM+J",8
29,"29005",4507,3012,2965,29,47,"PUM+J",4
9,"9061",147,119,119,0,0,"PUM+J",0
24,"24022",304,198,195,2,3,"PUM+J",0
10,"10166",307,197,195,0,2,"PUM+J",0
5,"5077",154,113,110,0,3,"PUM+J",0
47,"47053",123,101,97,3,4,"PUM+J",0
16,"16053",388,306,303,3,3,"PUM+J",1
23,"23020",1510,1263,1253,16,10,"PUM+J",1
5,"5904",108,70,69,5,1,"PUM+J",0
37,"37003",104,75,75,2,0,"PUM+J",0
24,"24047",708,462,459,1,3,"PUM+J",0
42,"42054",18,12,12,0,0,"PUM+J",0
40,"40010",108,83,82,0,1,"PUM+J",0
9,"9373",399,254,251,5,3,"PUM+J",0
37,"37128",235,169,168,0,1,"PUM+J",0
44,"44195",82,58,57,0,1,"PUM+J",0
7,"7013",7353,4725,4639,43,86,"PUM+J",4
49,"49088",80,51,51,0,0,"PUM+J",0
24,"24132",610,330,329,5,1,"PUM+J",2
22,"22075",116,71,69,1,2,"PUM+J",0
11,"11018",1434,1001,977,8,24,"PUM+J",0
39,"39065",222,166,163,0,3,"PUM+J",0
10,"10128",5618,3799,3630,37,169,"PUM+J",2
22,"22221",92,56,55,0,1,"PUM+J",0
9,"9392",49,28,28,0,0,"PUM+J",0
5,"5045",81,58,58,0,0,"PUM+J",0
6,"6001",664,474,460,3,14,"PUM+J",0
44,"44148",74,56,54,0,2,"PUM+J",0
40,"40054",108,79,78,3,1,"PUM+J",0
22,"22044",234,166,164,1,2,"PUM+J",1
10,"10006",1224,907,893,7,14,"PUM+J",1
24,"24025",283,190,185,3,5,"PUM+J",0
42,"42029",131,94,94,4,0,"PUM+J",0
50,"50039",462,339,333,1,6,"PUM+J",0
5,"5102",1681,1252,1228,8,24,"PUM+J",0
10,"10170",231,164,162,2,2,"PUM+J",0
41,"41082",3354,2545,2507,11,38,"PUM+J",0
3,"3029",236,174,172,2,2,"PUM+J",0
21,"21062",1403,849,838,10,11,"PUM+J",0
37,"37339",295,219,219,5,0,"PUM+J",0
24,"24210",524,353,353,1,0,"PUM+J",1
50,"50098",162,119,118,1,1,"PUM+J",0
28,"28154",5570,3999,3961,29,38,"PUM+J",1
49,"49197",155,109,104,0,5,"PUM+J",0
22,"22212",69,52,52,1,0,"PUM+J",0
5,"5167",223,177,172,0,5,"PUM+J",0
7,"7004",4069,2652,2624,27,28,"PUM+J",3
26,"26032",43,36,35,0,1,"PUM+J",0
16,"16009",54,44,44,2,0,"PUM+J",0
2,"2056",1640,1204,1179,11,25,"PUM+J",1
28,"28902",521,394,389,3,5,"PUM+J",0
49,"49017",247,176,176,1,0,"PUM+J",1
12,"12136",2603,2151,2119,20,32,"PUM+J",3
3,"3125",332,226,226,2,0,"PUM+J",1
21,"21064",6674,4503,4426,68,77,"PUM+J",9
9,"9228",155,129,129,0,0,"PUM+J",0
50,"50024",543,400,397,3,3,"PUM+J",0
26,"26134",81,67,67,3,0,"PUM+J",0
16,"16058",94,71,71,1,0,"PUM+J",0
3,"3012",1138,863,846,4,17,"PUM+J",1
29,"29902",2593,1561,1533,15,28,"PUM+J",1
21,"21034",1155,768,748,5,20,"PUM+J",1
10,"10132",360,251,243,1,8,"PUM+J",0
50,"50252",5019,3486,3456,53,30,"PUM+J",0
24,"24137",1043,700,691,8,9,"PUM+J",1
6,"6006",4479,2991,2934,27,57,"PUM+J",1
46,"46055",1298,992,977,9,15,"PUM+J",0
5,"5082",491,379,369,2,10,"PUM+J",1
39,"39097",666,342,335,2,7,"PUM+J",0
16,"16175",5071,3807,3732,43,75,"PUM+J",1
47,"47059",94,64,64,0,0,"PUM+J",0
33,"33069",3379,2249,2231,41,18,"PUM+J",1
5,"5233",223,174,173,0,1,"PUM+J",0
40,"40220",64,46,45,0,1,"PUM+J",0
38,"38017",30964,16228,16102,108,126,"PUM+J",9
10,"10161",81,50,50,0,0,"PUM+J",0
40,"40103",139,113,113,0,0,"PUM+J",0
22,"22215",127,81,81,0,0,"PUM+J",0
3,"3090",18095,12539,12412,75,127,"PUM+J",12
3,"3099",43101,30222,29885,196,337,"PUM+J",30
26,"26010",85,66,63,1,3,"PUM+J",0
39,"39070",126,91,89,0,2,"PUM+J",0
46,"46156",2017,1538,1524,9,14,"PUM+J",1
24,"24007",735,500,496,8,4,"PUM+J",1
5,"5149",101,72,71,2,1,"PUM+J",0
26,"26099",1220,956,931,7,25,"PUM+J",1
40,"40059",109,92,91,2,1,"PUM+J",0
9,"9071",39,29,29,1,0,"PUM+J",0
29,"29030",770,618,611,4,7,"PUM+J",0
7,"7053",1209,870,864,10,6,"PUM+J",4
2,"2005",554,426,419,8,7,"PUM+J",0
22,"22168",22,20,19,0,1,"PUM+J",0
9,"9166",96,77,77,0,0,"PUM+J",0
2,"2072",1528,981,958,7,23,"PUM+J",0
10,"10176",344,223,213,2,10,"PUM+J",0
46,"46057",463,308,304,1,4,"PUM+J",0
6,"6010",1063,760,732,2,28,"PUM+J",1
5,"5172",111,83,83,1,0,"PUM+J",0
3,"3034",1404,1028,1010,5,18,"PUM+J",0
42,"42216",26,20,20,0,0,"PUM+J",0
42,"42217",33,25,25,0,0,"PUM+J",0
41,"41069",29669,20316,19848,381,468,"PUM+J",21
18,"18098",5959,3816,3749,33,67,"PUM+J",1
42,"42051",15,9,9,0,0,"PUM+J",0
42,"42093",36,28,28,1,0,"PUM+J",0
23,"23031",764,660,640,6,20,"PUM+J",1
9,"9182",74,54,54,0,0,"PUM+J",0
10,"10097",107,84,80,0,4,"PUM+J",0
5,"5053",76,48,48,0,0,"PUM+J",0
19,"19153",22,20,20,2,0,"PUM+J",0
41,"41042",5872,4477,4424,42,53,"PUM+J",3
44,"44183",61,47,47,1,0,"PUM+J",0
22,"22082",288,217,214,0,3,"PUM+J",0
50,"50231",253,199,195,4,4,"PUM+J",0
24,"24033",209,149,149,0,0,"PUM+J",0
4,"4088",2444,1587,1574,17,13,"PUM+J",0
22,"22042",116,91,89,1,2,"PUM+J",1
44,"44087",67,52,50,0,2,"PUM+J",0
6,"6135",1101,860,849,2,11,"PUM+J",1
19,"19277",15,10,10,0,0,"PUM+J",0
39,"39073",10260,7537,7482,42,55,"PUM+J",3
42,"42190",94,61,61,1,0,"PUM+J",0
10,"10057",126,90,89,1,1,"PUM+J",0
18,"18066",2095,1401,1378,12,23,"PUM+J",0
41,"41043",669,447,436,11,11,"PUM+J",0
41,"41024",22819,14767,14455,169,312,"PUM+J",9
24,"24230",403,268,265,3,3,"PUM+J",0
22,"22220",147,106,105,1,1,"PUM+J",0
49,"49087",476,246,244,0,2,"PUM+J",0
19,"19130",61556,45926,45388,408,538,"PUM+J",98
34,"34084",158,125,125,1,0,"PUM+J",0
3,"3103",238,196,194,2,2,"PUM+J",1
18,"18077",471,350,343,1,7,"PUM+J",0
12,"12084",17785,12557,12422,108,135,"PUM+J",25
28,"28129",8589,6397,6338,46,59,"PUM+J",9
47,"47223",148,105,102,4,3,"PUM+J",0
14,"14018",3617,2632,2568,31,64,"PUM+J",3
37,"37348",100,76,76,0,0,"PUM+J",0
37,"37159",74,59,59,0,0,"PUM+J",0
50,"50183",316,227,223,1,4,"PUM+J",0
5,"5088",29,22,22,0,0,"PUM+J",0
3,"3046",1636,1073,1061,7,12,"PUM+J",1
34,"34071",158,128,128,2,0,"PUM+J",0
10,"10182",122,81,81,0,0,"PUM+J",0
50,"50159",640,493,486,3,7,"PUM+J",0
21,"21011",3500,2371,2314,23,57,"PUM+J",6
19,"19218",43,31,31,0,0,"PUM+J",0
29,"29007",28907,20371,20129,254,242,"PUM+J",22
5,"5023",174,148,145,2,3,"PUM+J",0
2,"2010",1784,1374,1349,12,25,"PUM+J",2
24,"24073",437,285,282,1,3,"PUM+J",0
34,"34168",45,39,39,1,0,"PUM+J",0
40,"40131",51,45,45,0,0,"PUM+J",0
23,"23025",2725,1894,1870,11,24,"PUM+J",0
6,"6017",250,202,198,0,4,"PUM+J",0
33,"33067",751,543,538,7,5,"PUM+J",0
47,"47066",1482,1096,1086,14,10,"PUM+J",1
22,"22054",1614,1029,1009,19,20,"PUM+J",4
47,"47131",167,122,120,2,2,"PUM+J",0
7,"7059",3074,1973,1948,17,25,"PUM+J",3
39,"39058",806,556,554,2,2,"PUM+J",0
16,"16122",244,184,182,1,2,"PUM+J",0
49,"49005",125,80,80,1,0,"PUM+J",0
44,"44245",240,177,174,0,3,"PUM+J",0
50,"50016",44,31,31,0,0,"PUM+J",0
37,"37225",97,78,74,0,4,"PUM+J",0
10,"10090",489,307,302,1,5,"PUM+J",0
18,"18038",1042,782,760,5,22,"PUM+J",0
10,"10144",915,618,614,0,4,"PUM+J",0
40,"40068",22,21,21,0,0,"PUM+J",0
26,"26147",34,26,25,0,1,"PUM+J",0
3,"3136",399,302,301,3,1,"PUM+J",0
42,"42103",543,383,374,2,9,"PUM+J",0
50,"50185",140,93,92,1,1,"PUM+J",0
39,"39020",23993,15944,15792,89,152,"PUM+J",16
19,"19123",37,30,28,0,2,"PUM+J",0
49,"49104",326,218,216,0,2,"PUM+J",0
24,"24005",342,218,217,0,1,"PUM+J",0
12,"12120",149,125,121,3,4,"PUM+J",0
2,"2013",125,90,88,0,2,"PUM+J",0
18,"18906",903,641,639,2,2,"PUM+J",0
33,"33012",5085,3158,3142,27,16,"PUM+J",2
44,"44159",37,27,27,1,0,"PUM+J",0
19,"19282",138,107,106,0,1,"PUM+J",0
24,"24112",288,188,186,2,2,"PUM+J",0
10,"10064",1400,998,972,3,26,"PUM+J",0
41,"41019",4931,3323,3251,39,72,"PUM+J",3
19,"19317",124,83,82,0,1,"PUM+J",0
37,"37062",78,59,59,0,0,"PUM+J",0
34,"34211",171,154,153,2,1,"PUM+J",0
37,"37238",105,83,80,0,3,"PUM+J",1
42,"42089",57,44,43,0,1,"PUM+J",0
6,"6068",427,298,294,5,4,"PUM+J",0
41,"41048",2195,1445,1400,13,45,"PUM+J",1
22,"22204",1117,728,723,14,5,"PUM+J",1
30,"30016",153034,101232,100202,776,1030,"PUM+J",78
45,"45088",2366,1526,1501,8,25,"PUM+J",3
3,"3079",18422,13560,13378,152,182,"PUM+J",22
44,"44143",388,298,298,2,0,"PUM+J",0
18,"18001",222,147,146,0,1,"PUM+J",0
19,"19107",306,245,244,0,1,"PUM+J",0
45,"45174",300,218,217,2,1,"PUM+J",0
37,"37113",404,286,285,13,1,"PUM+J",1
5,"5061",257,193,189,1,4,"PUM+J",1
28,"28060",1585,1160,1146,5,14,"PUM+J",2
21,"21046",1729,1212,1187,14,25,"PUM+J",0
39,"39080",3477,2404,2388,4,16,"PUM+J",0
22,"22089",274,195,193,2,2,"PUM+J",0
42,"42108",10,7,7,0,0,"PUM+J",0
5,"5095",236,181,177,1,4,"PUM+J",0
24,"24176",302,232,226,0,6,"PUM+J",0
37,"37089",60,44,43,0,1,"PUM+J",0
5,"5096",76,62,62,0,0,"PUM+J",0
9,"9419",67,52,49,0,3,"PUM+J",0
45,"45200",4471,3351,3269,25,82,"PUM+J",5
50,"50262",1161,849,832,11,17,"PUM+J",0
50,"50180",107,85,85,1,0,"PUM+J",0
21,"21068",973,562,556,11,6,"PUM+J",2
23,"23902",2219,1813,1770,6,43,"PUM+J",0
26,"26024",204,157,156,1,1,"PUM+J",0
11,"11036",683,401,395,15,6,"PUM+J",0
9,"9421",240,180,180,3,0,"PUM+J",0
10,"10068",707,532,521,4,11,"PUM+J",0
34,"34081",60,45,44,0,1,"PUM+J",0
9,"9476",60,46,46,0,0,"PUM+J",0
24,"24081",121,72,72,0,0,"PUM+J",0
21,"21018",1719,1048,1029,12,19,"PUM+J",1
22,"22206",179,138,137,0,1,"PUM+J",0
26,"26037",125,98,98,3,0,"PUM+J",0
28,"28170",2495,1714,1695,13,19,"PUM+J",1
40,"40171",40,32,32,1,0,"PUM+J",0
9,"9200",48,29,29,0,0,"PUM+J",0
37,"37168",397,271,266,3,5,"PUM+J",3
44,"44251",239,187,183,1,4,"PUM+J",0
49,"49110",344,196,195,2,1,"PUM+J",1
29,"29014",218,122,121,3,1,"PUM+J",1
37,"37292",91,65,65,0,0,"PUM+J",0
44,"44099",644,422,421,2,1,"PUM+J",0
47,"47105",169,138,137,2,1,"PUM+J",0
9,"9312",89,68,68,1,0,"PUM+J",0
10,"10153",281,183,181,0,2,"PUM+J",0
22,"22061",6567,4446,4410,48,36,"PUM+J",3
4,"4067",504,340,330,4,10,"PUM+J",0
33,"33073",8096,4377,4320,59,57,"PUM+J",5
28,"28064",125,98,95,3,3,"PUM+J",0
16,"16213",34,27,26,0,1,"PUM+J",0
13,"13055",616,445,444,3,1,"PUM+J",0
5,"5099",451,350,344,3,6,"PUM+J",0
10,"10044",1405,968,955,11,13,"PUM+J",1
26,"26104",10,9,9,1,0,"PUM+J",0
45,"45204",630,453,449,1,4,"PUM+J",0
10,"10018",1605,974,948,16,26,"PUM+J",1
5,"5155",46,33,31,1,2,"PUM+J",0
5,"5100",260,193,192,3,1,"PUM+J",0
42,"42162",2298,1493,1462,18,31,"PUM+J",0
35,"35014",11962,5994,5888,60,106,"PUM+J",1
47,"47106",44,30,30,0,0,"PUM+J",0
44,"44110",37,30,30,0,0,"PUM+J",0
40,"40108",109,85,85,2,0,"PUM+J",0
10,"10032",1588,1114,1099,6,15,"PUM+J",0
18,"18078",714,546,538,5,8,"PUM+J",0
50,"50088",274,195,191,2,4,"PUM+J",0
51,"51001",59820,33614,33265,323,349,"PUM+J",43
5,"5263",162,117,115,1,2,"PUM+J",0
39,"39056",2262,1683,1671,14,12,"PUM+J",0
13,"13057",1099,858,849,2,9,"PUM+J",0
23,"23047",1558,1203,1186,8,17,"PUM+J",1
14,"14057",6157,4773,4707,59,66,"PUM+J",6
19,"19032",145,94,93,2,1,"PUM+J",0
12,"12102",518,424,417,4,7,"PUM+J",0
42,"42164",1580,1043,1029,8,14,"PUM+J",3
19,"19103",247,205,202,1,3,"PUM+J",0
34,"34182",746,558,553,9,5,"PUM+J",0
44,"44168",181,119,117,1,2,"PUM+J",0
37,"37265",198,167,163,1,4,"PUM+J",0
49,"49004",110,74,71,3,3,"PUM+J",0
6,"6033",1276,986,972,5,14,"PUM+J",1
47,"47110",445,335,327,1,8,"PUM+J",2
34,"34184",49,37,35,0,2,"PUM+J",0
16,"16217",91,72,72,0,0,"PUM+J",0
44,"44120",219,147,145,3,2,"PUM+J",0
10,"10035",1798,1201,1171,8,30,"PUM+J",0
10,"10117",238,133,130,0,3,"PUM+J",0
49,"49173",335,165,163,4,2,"PUM+J",0
3,"3058",4976,3733,3669,20,64,"PUM+J",4
16,"16070",29,27,27,0,0,"PUM+J",0
49,"49006",139,98,95,3,3,"PUM+J",0
50,"50267",565,380,375,4,5,"PUM+J",1
39,"39086",358,236,235,2,1,"PUM+J",0
46,"46024",454,343,339,1,4,"PUM+J",0
34,"34238",294,238,236,1,2,"PUM+J",0
49,"49116",356,239,234,4,5,"PUM+J",0
47,"47143",104,67,67,0,0,"PUM+J",0
9,"9265",38,31,31,1,0,"PUM+J",1
37,"37267",177,130,129,0,1,"PUM+J",1
13,"13061",5616,3679,3634,51,45,"PUM+J",7
34,"34091",118,82,82,1,0,"PUM+J",0
26,"26044",51,38,36,0,2,"PUM+J",0
19,"19326",2463,1671,1650,13,21,"PUM+J",3
10,"10159",314,207,207,2,0,"PUM+J",0
40,"40047",37,23,23,0,0,"PUM+J",0
33,"33022",802,460,452,4,8,"PUM+J",1
9,"9162",130,102,100,1,2,"PUM+J",0
37,"37268",106,62,61,1,1,"PUM+J",0
19,"19327",385,313,308,2,5,"PUM+J",0
40,"40079",229,160,159,2,1,"PUM+J",0
39,"39087",41241,29341,29084,152,257,"PUM+J",21
50,"50118",2101,1484,1477,17,7,"PUM+J",0
49,"49229",109,80,77,1,3,"PUM+J",0
23,"23028",6103,4369,4286,26,83,"PUM+J",13
7,"7062",7972,3946,3896,42,50,"PUM+J",5
18,"18916",1815,1093,1086,6,7,"PUM+J",2
14,"14060",3715,2714,2641,41,73,"PUM+J",2
50,"50170",357,245,242,6,3,"PUM+J",0
6,"6023",4138,2811,2749,12,62,"PUM+J",2
9,"9432",170,125,123,0,2,"PUM+J",0
37,"37074",136,93,90,1,3,"PUM+J",0
19,"19010",9,9,9,0,0,"PUM+J",0
5,"5201",497,404,401,0,3,"PUM+J",2
44,"44032",17,13,13,0,0,"PUM+J",0
44,"44094",127,103,103,0,0,"PUM+J",0
39,"39042",5910,4354,4315,14,39,"PUM+J",3
13,"13019",5101,3502,3468,33,34,"PUM+J",5
49,"49188",111,75,73,0,2,"PUM+J",0
40,"40113",404,308,304,2,4,"PUM+J",0
28,"28041",4805,3666,3634,38,32,"PUM+J",8
5,"5139",71,59,58,1,1,"PUM+J",0
24,"24165",317,202,199,1,3,"PUM+J",0
42,"42035",730,464,460,3,4,"PUM+J",0
19,"19223",99,66,65,1,1,"PUM+J",1
16,"16194",219,169,161,0,8,"PUM+J",0
41,"41003",2373,1747,1708,18,39,"PUM+J",1
47,"47147",103,86,82,0,4,"PUM+J",0
9,"9218",350,254,252,5,2,"PUM+J",0
47,"47083",81,63,61,0,2,"PUM+J",0
19,"19038",19,16,15,0,1,"PUM+J",0
37,"37078",781,626,603,9,23,"PUM+J",2
33,"33015",1396,849,842,7,7,"PUM+J",0
46,"46043",135,119,118,0,1,"PUM+J",1
30,"30041",14040,8999,8876,94,123,"PUM+J",6
16,"16211",335,228,227,1,1,"PUM+J",0
24,"24129",114,79,78,2,1,"PUM+J",0
47,"47051",324,261,258,6,3,"PUM+J",0
19,"19109",33,26,26,2,0,"PUM+J",0
47,"47116",396,304,302,2,2,"PUM+J",0
50,"50295",48,41,41,0,0,"PUM+J",0
50,"50197",95,69,68,2,1,"PUM+J",0
40,"40118",46,32,32,1,0,"PUM+J",0
6,"6043",677,493,488,5,5,"PUM+J",2
37,"37208",71,49,49,0,0,"PUM+J",0
40,"40181",4182,3102,3038,35,64,"PUM+J",6
49,"49121",372,239,233,1,6,"PUM+J",0
24,"24021",1595,1037,1025,7,12,"PUM+J",0
35,"35020",5941,3740,3702,27,38,"PUM+J",2
16,"16167",288,225,217,0,8,"PUM+J",0
44,"44194",103,67,64,0,3,"PUM+J",0
33,"33054",1601,1025,1010,17,15,"PUM+J",2
5,"5109",445,334,329,4,5,"PUM+J",1
44,"44175",112,76,75,1,1,"PUM+J",0
37,"37272",132,97,95,0,2,"PUM+J",1
34,"34099",53,44,42,0,2,"PUM+J",0
9,"9113",453,321,315,8,6,"PUM+J",2
3,"3064",5015,3514,3461,15,53,"PUM+J",4
2,"2052",466,371,370,6,1,"PUM+J",0
40,"40052",72,55,55,0,0,"PUM+J",0
45,"45179",493,362,357,5,5,"PUM+J",0
22,"22131",84,62,58,5,4,"PUM+J",0
45,"45130",294,222,222,1,0,"PUM+J",0
41,"41090",3489,2560,2467,27,93,"PUM+J",1
22,"22095",66,52,51,1,1,"PUM+J",0
46,"46067",1753,1356,1341,8,15,"PUM+J",0
45,"45106",7418,5380,5306,34,74,"PUM+J",11
9,"9170",207,151,150,1,1,"PUM+J",1
26,"26052",146,106,105,0,1,"PUM+J",0
41,"41034",23576,15461,15214,264,247,"PUM+J",6
37,"37273",85,58,58,2,0,"PUM+J",0
16,"16095",82,70,70,1,0,"PUM+J",0
9,"9115",90,65,63,3,2,"PUM+J",0
49,"49123",519,384,383,4,1,"PUM+J",0
44,"44206",100,73,73,3,0,"PUM+J",0
19,"19333",96,68,67,0,1,"PUM+J",0
42,"42003",65,49,47,0,2,"PUM+J",0
40,"40084",52,41,41,2,0,"PUM+J",1
10,"10087",1588,1105,1093,10,12,"PUM+J",0
14,"14066",5748,4116,4035,59,81,"PUM+J",3
21,"21001",621,431,418,0,13,"PUM+J",0
24,"24170",1806,1232,1220,9,12,"PUM+J",1
5,"5112",95,59,58,0,1,"PUM+J",0
40,"40086",656,513,496,7,17,"PUM+J",1
47,"47152",67,59,59,0,0,"PUM+J",0
37,"37245",331,221,220,4,1,"PUM+J",1
12,"12085",5081,3271,3235,17,36,"PUM+J",3
24,"24134",3287,2278,2226,18,52,"PUM+J",2
19,"19006",755,506,494,4,12,"PUM+J",1
37,"37150",34,31,31,0,0,"PUM+J",0
34,"34103",96,79,76,0,3,"PUM+J",0
39,"39066",866,616,606,6,10,"PUM+J",0
47,"47182",1328,940,934,8,6,"PUM+J",0
23,"23059",5736,4245,4119,51,126,"PUM+J",8
19,"19335",51,39,38,0,1,"PUM+J",1
49,"49150",123,95,92,3,3,"PUM+J",0
28,"28016",79,55,55,0,0,"PUM+J",0
5,"5134",47,40,40,0,0,"PUM+J",0
11,"11041",9869,6438,6295,100,143,"PUM+J",1
40,"40087",85,70,70,0,0,"PUM+J",0
22,"22064",155,100,100,2,0,"PUM+J",0
28,"28122",578,404,401,1,3,"PUM+J",0
37,"37214",120,70,68,2,2,"PUM+J",0
24,"24211",259,199,198,3,1,"PUM+J",0
5,"5013",834,658,653,2,5,"PUM+J",0
4,"4012",184,151,150,3,1,"PUM+J",0
44,"44001",65,43,43,1,0,"PUM+J",0
2,"2067",1137,808,794,2,14,"PUM+J",3
5,"5211",425,336,330,2,6,"PUM+J",0
39,"39012",6772,4807,4755,31,52,"PUM+J",1
40,"40088",272,192,192,0,0,"PUM+J",0
9,"9445",41,28,27,1,1,"PUM+J",0
47,"47184",537,411,402,1,9,"PUM+J",1
44,"44268",32,30,30,0,0,"PUM+J",0
37,"37341",47,29,29,0,0,"PUM+J",0
18,"18030",566,382,380,2,2,"PUM+J",0
39,"39096",669,451,450,1,1,"PUM+J",0
29,"29001",4207,3002,2959,40,43,"PUM+J",3
26,"26057",50,45,45,2,0,"PUM+J",0
9,"9283",39,25,24,1,1,"PUM+J",0
26,"26096",257,198,193,2,5,"PUM+J",1
45,"45111",56,47,47,1,0,"PUM+J",0
41,"41038",102752,71545,70538,980,1007,"PUM+J",96
10,"10079",848,641,632,2,9,"PUM+J",0
39,"39060",6704,4959,4887,23,72,"PUM+J",4
34,"34107",73,47,46,1,1,"PUM+J",0
44,"44003",17,15,15,0,0,"PUM+J",0
34,"34108",499,391,384,3,7,"PUM+J",3
10,"10080",353,243,238,1,5,"PUM+J",0
2,"2037",22963,14737,14588,68,149,"PUM+J",15
14,"14042",18695,13788,13514,206,274,"PUM+J",15
49,"49230",84,69,69,0,0,"PUM+J",0
33,"33061",344,174,174,1,0,"PUM+J",0
22,"22006",268,167,164,4,3,"PUM+J",0
49,"49118",193,151,151,2,0,"PUM+J",0
26,"26111",250,191,187,3,4,"PUM+J",0
10,"10053",279,171,169,1,2,"PUM+J",0
47,"47156",150,117,117,0,0,"PUM+J",0
40,"40091",109,87,85,0,2,"PUM+J",1
19,"19152",540,377,374,2,3,"PUM+J",0
5,"5117",191,155,153,1,2,"PUM+J",0
10,"10216",1518,1082,1056,11,26,"PUM+J",0
2,"2071",1027,800,795,7,5,"PUM+J",1
28,"28020",193,96,93,0,3,"PUM+J",0
46,"46239",446,357,352,1,5,"PUM+J",0
5,"5214",28,18,18,0,0,"PUM+J",0
40,"40126",67,44,42,0,2,"PUM+J",0
37,"37280",70,47,46,0,1,"PUM+J",0
47,"47092",101,81,79,0,2,"PUM+J",0
10,"10217",506,378,377,3,1,"PUM+J",1
42,"42142",42,36,36,1,0,"PUM+J",1
34,"34096",48,39,38,0,1,"PUM+J",0
46,"46004",1932,1530,1512,10,18,"PUM+J",2
39,"39015",828,559,556,3,3,"PUM+J",0
3,"3130",28,19,19,0,0,"PUM+J",0
22,"22905",287,217,217,1,0,"PUM+J",0
40,"40060",67,40,40,1,0,"PUM+J",0
34,"34112",39,31,31,0,0,"PUM+J",0
7,"7021",229,154,150,3,4,"PUM+J",0
47,"47158",859,618,608,4,10,"PUM+J",0
7,"7055",8062,4546,4492,40,54,"PUM+J",4
6,"6057",530,409,400,0,9,"PUM+J",2
50,"50077",201,140,140,1,0,"PUM+J",0
24,"24217",135,93,93,0,0,"PUM+J",0
47,"47032",147,102,102,0,0,"PUM+J",0
2,"2073",4825,3433,3394,35,39,"PUM+J",2
22,"22197",436,327,325,3,2,"PUM+J",0
30,"30026",16345,10049,9914,84,135,"PUM+J",0
21,"21008",2604,1663,1626,10,37,"PUM+J",2
50,"50255",199,152,147,3,5,"PUM+J",0
34,"34009",30,26,26,0,0,"PUM+J",0
50,"50005",228,185,184,2,1,"PUM+J",0
41,"41014",2476,1852,1799,10,53,"PUM+J",1
37,"37282",193,132,131,3,1,"PUM+J",0
9,"9454",41,34,33,1,1,"PUM+J",0
50,"50206",457,349,345,5,4,"PUM+J",0
50,"50280",290,220,216,1,4,"PUM+J",0
34,"34163",46,37,37,0,0,"PUM+J",0
44,"44052",75,54,54,0,0,"PUM+J",0
37,"37253",135,109,109,1,0,"PUM+J",1
50,"50157",289,199,196,1,3,"PUM+J",0
50,"50095",12149,8322,8239,91,83,"PUM+J",8
13,"13024",875,587,577,7,10,"PUM+J",0
21,"21040",3193,2219,2123,32,96,"PUM+J",1
18,"18005",363,232,230,3,2,"PUM+J",0
6,"6106",407,261,258,4,3,"PUM+J",1
5,"5218",104,81,79,0,2,"PUM+J",0
44,"44185",88,69,69,2,0,"PUM+J",0
12,"12093",161,111,109,2,2,"PUM+J",0
6,"6016",2937,2042,1978,12,64,"PUM+J",2
22,"22119",1267,880,871,4,9,"PUM+J",2
19,"19247",140,103,102,1,1,"PUM+J",1
40,"40194",39173,28641,28260,353,381,"PUM+J",58
16,"16236",857,615,608,1,7,"PUM+J",0
44,"44100",177,136,135,1,1,"PUM+J",0
44,"44008",1556,1109,1100,7,9,"PUM+J",0
22,"22200",239,165,164,2,1,"PUM+J",0
16,"16237",98,82,82,1,0,"PUM+J",0
46,"46220",49112,33766,33424,312,342,"PUM+J",21
42,"42192",36,22,22,2,0,"PUM+J",0
33,"33065",1077,670,657,11,13,"PUM+J",0
42,"42098",8,7,7,0,0,"PUM+J",0
35,"35030",10046,5584,5505,44,79,"PUM+J",3
24,"24181",1404,944,925,7,19,"PUM+J",0
12,"12040",119116,85613,84993,620,620,"PUM+J",113
5,"5123",106,78,78,0,0,"PUM+J",0
40,"40001",708,544,536,3,8,"PUM+J",0
50,"50007",51,34,34,1,0,"PUM+J",0
5,"5253",75,54,54,0,0,"PUM+J",0
35,"35031",7456,4938,4868,39,70,"PUM+J",7
46,"46152",90,63,63,0,0,"PUM+J",0
12,"12119",139,97,94,3,3,"PUM+J",0
50,"50282",55,38,38,1,0,"PUM+J",0
44,"44128",58,39,37,0,2,"PUM+J",0
34,"34169",371,263,259,5,4,"PUM+J",0
49,"49238",273,205,200,4,5,"PUM+J",2
22,"22909",307,219,217,0,2,"PUM+J",0
47,"47163",277,208,205,3,3,"PUM+J",0
47,"47027",2799,2059,2025,12,34,"PUM+J",4
24,"24038",3024,2121,2071,25,50,"PUM+J",0
44,"44189",44,35,35,0,0,"PUM+J",0
46,"46016",1070,827,814,10,13,"PUM+J",0
46,"46153",443,353,349,2,4,"PUM+J",0
22,"22125",39530,27358,27075,344,283,"PUM+J",47
49,"49028",108,90,89,1,1,"PUM+J",0
4,"4023",118,84,82,2,2,"PUM+J",1
5,"5124",87,67,67,2,0,"PUM+J",0
10,"10104",5123,3470,3396,21,74,"PUM+J",5
28,"28100",4482,3146,3113,21,33,"PUM+J",3
44,"44129",35,29,29,1,0,"PUM+J",0
42,"42195",86,51,51,2,0,"PUM+J",1
22,"22055",305,242,235,2,7,"PUM+J",0
5,"5125",56,47,46,0,1,"PUM+J",0
44,"44103",122,96,96,3,0,"PUM+J",0
30,"30007",6474,4354,4317,26,37,"PUM+J",2
45,"45086",483,339,332,0,7,"PUM+J",0
10,"10105",2442,1541,1515,11,26,"PUM+J",1
22,"22126",89,64,64,0,0,"PUM+J",0
6,"6067",1897,1268,1242,14,26,"PUM+J",2
42,"42105",47,40,40,2,0,"PUM+J",0
24,"24077",212,166,162,0,4,"PUM+J",0
44,"44011",47,34,34,0,0,"PUM+J",0
42,"42021",65,46,45,2,1,"PUM+J",0
42,"42155",146,83,80,2,3,"PUM+J",0
26,"26058",149,114,114,2,0,"PUM+J",0
12,"12113",90,59,59,1,0,"PUM+J",0
19,"19125",45,23,23,0,0,"PUM+J",0
9,"9249",47,35,35,3,0,"PUM+J",0
24,"24185",447,303,295,1,8,"PUM+J",0
49,"49139",149,112,112,0,0,"PUM+J",0
44,"44105",68,53,53,0,0,"PUM+J",0
34,"34125",105,80,80,2,0,"PUM+J",0
50,"50059",757,556,551,5,5,"PUM+J",0
49,"49141",290,191,191,1,0,"PUM+J",0
34,"34063",84,74,74,1,0,"PUM+J",0
45,"45113",1770,1189,1171,5,18,"PUM+J",0
30,"30040",686,564,560,1,4,"PUM+J",1
5,"5161",545,395,395,0,0,"PUM+J",1
47,"47166",251,183,181,2,2,"PUM+J",1
6,"6161",289,199,197,1,2,"PUM+J",0
22,"22205",448,294,292,0,2,"PUM+J",1
24,"24187",834,559,549,11,10,"PUM+J",0
40,"40200",38,28,28,0,0,"PUM+J",0
37,"37290",130,106,106,0,0,"PUM+J",0
5,"5029",100,73,73,1,0,"PUM+J",0
49,"49142",244,163,160,0,3,"PUM+J",0
2,"2082",98,80,80,0,0,"PUM+J",0
19,"19252",56,44,44,0,0,"PUM+J",0
50,"50060",171,126,125,1,1,"PUM+J",0
29,"29012",9718,6664,6553,85,111,"PUM+J",2
46,"46133",462,359,352,1,7,"PUM+J",1
9,"9090",49,41,39,2,2,"PUM+J",0
46,"46904",812,615,605,2,10,"PUM+J",1
49,"49096",155,113,112,2,1,"PUM+J",0
47,"47230",285,209,206,1,3,"PUM+J",0
19,"19127",88,60,60,1,0,"PUM+J",0
45,"45127",775,510,502,1,8,"PUM+J",0
49,"49256",236,183,179,0,4,"PUM+J",0
37,"37103",409,295,294,2,1,"PUM+J",0
22,"22028",358,237,233,1,4,"PUM+J",0
22,"22129",162,110,110,0,0,"PUM+J",0
26,"26153",10,10,10,1,0,"PUM+J",0
35,"35012",10862,5617,5568,40,49,"PUM+J",3
28,"28107",442,316,310,5,6,"PUM+J",0
19,"19058",7458,5705,5663,40,42,"PUM+J",8
49,"49033",655,440,434,4,6,"PUM+J",0
21,"21079",678,428,417,2,11,"PUM+J",0
46,"46226",29,20,19,0,1,"PUM+J",0
28,"28032",5090,3716,3675,22,41,"PUM+J",2
3,"3082",12941,8399,8304,51,95,"PUM+J",12
21,"21019",592,397,389,6,8,"PUM+J",0
39,"39082",1611,1108,1102,8,6,"PUM+J",1
9,"9148",77,58,58,3,0,"PUM+J",0
44,"44108",306,209,205,1,4,"PUM+J",0
16,"16196",589,490,476,3,14,"PUM+J",0
16,"16247",63,51,50,1,1,"PUM+J",0
16,"16005",234,163,160,1,3,"PUM+J",0
49,"49258",111,93,93,2,0,"PUM+J",0
50,"50013",199,158,158,0,0,"PUM+J",0
10,"10194",524,408,404,2,4,"PUM+J",0
50,"50215",20,14,14,0,0,"PUM+J",0
45,"45019",7560,5216,5135,50,81,"PUM+J",9
49,"49147",250,164,162,1,2,"PUM+J",0
12,"12068",41,22,21,0,1,"PUM+J",0
28,"28003",167,133,131,4,2,"PUM+J",0
39,"39055",1065,747,736,4,11,"PUM+J",0
5,"5131",96,64,64,1,0,"PUM+J",0
10,"10113",2231,1534,1508,14,26,"PUM+J",1
26,"26076",115,83,83,0,0,"PUM+J",0
4,"4101",4356,2818,2768,32,50,"PUM+J",1
49,"49002",58,43,40,0,3,"PUM+J",0
40,"40903",75,61,59,0,2,"PUM+J",0
26,"26157",283,222,217,0,5,"PUM+J",0
16,"16248",862,710,700,6,10,"PUM+J",0
3,"3084",501,413,413,1,0,"PUM+J",0
46,"46045",1245,984,961,3,23,"PUM+J",2
10,"10073",733,513,499,8,14,"PUM+J",0
3,"3056",8588,6219,6135,29,84,"PUM+J",8
49,"49225",122,68,68,0,0,"PUM+J",0
38,"38901",1466,908,894,4,14,"PUM+J",1
49,"49003",860,534,530,5,4,"PUM+J",1
45,"45132",2387,1765,1754,13,11,"PUM+J",2
47,"47109",161,120,120,1,0,"PUM+J",0
22,"22063",161,128,126,0,2,"PUM+J",0
37,"37359",165,105,103,0,2,"PUM+J",0
16,"16249",1938,1422,1406,6,16,"PUM+J",2
16,"16084",48,34,30,1,4,"PUM+J",0
9,"9100",55,33,33,0,0,"PUM+J",0
3,"3904",1434,1032,1022,8,10,"PUM+J",1
37,"37296",297,215,210,0,5,"PUM+J",0
9,"9901",334,228,226,4,2,"PUM+J",0
16,"16121",227,160,152,0,8,"PUM+J",0
50,"50290",360,260,255,5,5,"PUM+J",0
24,"24196",1907,1322,1299,4,23,"PUM+J",1
47,"47015",177,129,129,0,0,"PUM+J",0
22,"22246",63,43,43,0,0,"PUM+J",0
9,"9213",264,182,182,1,0,"PUM+J",0
50,"50242",99,74,74,0,0,"PUM+J",1
40,"40110",316,237,234,4,3,"PUM+J",0
19,"19198",17,14,14,0,0,"PUM+J",0
18,"18048",2494,1708,1657,18,51,"PUM+J",2
50,"50291",95,76,76,0,0,"PUM+J",0
45,"45023",2300,1700,1685,19,15,"PUM+J",3
4,"4035",8439,5822,5768,45,54,"PUM+J",4
10,"10118",278,232,231,1,1,"PUM+J",0
24,"24197",717,500,499,2,1,"PUM+J",0
26,"26043",346,243,235,2,8,"PUM+J",0
45,"45134",1622,1187,1177,8,10,"PUM+J",3
7,"7038",2046,1416,1406,12,10,"PUM+J",1
40,"40078",150,123,123,6,0,"PUM+J",0
5,"5232",104,86,83,1,3,"PUM+J",0
45,"45024",1034,742,733,1,9,"PUM+J",2
50,"50066",2903,2095,2078,19,17,"PUM+J",1
7,"7039",5019,3066,3017,23,49,"PUM+J",4
11,"11012",97338,67120,66466,861,654,"PUM+J",117
49,"49039",324,249,239,3,10,"PUM+J",0
16,"16204",237,179,177,1,2,"PUM+J",0
9,"9381",28,19,19,0,0,"PUM+J",0
19,"19291",1143,803,794,2,9,"PUM+J",2
45,"45172",640,475,462,6,13,"PUM+J",1
37,"37142",554,396,394,5,2,"PUM+J",0
16,"16011",20,14,14,0,0,"PUM+J",0
18,"18180",636,410,401,2,9,"PUM+J",0
29,"29093",2150,1543,1520,8,23,"PUM+J",0
46,"46025",2445,1875,1853,16,22,"PUM+J",3
47,"47207",256,198,195,3,3,"PUM+J",0
10,"10119",574,417,414,2,3,"PUM+J",0
4,"4904",1900,1308,1299,4,9,"PUM+J",0
40,"40208",724,546,543,5,3,"PUM+J",0
33,"33078",127,81,81,0,0,"PUM+J",0
50,"50042",19,17,17,1,0,"PUM+J",0
18,"18181",194,134,133,0,1,"PUM+J",0
37,"37008",4213,3092,3046,21,46,"PUM+J",1
18,"18084",4533,3233,3178,35,55,"PUM+J",2
28,"28114",141,97,97,0,0,"PUM+J",0
16,"16125",1607,1166,1150,11,16,"PUM+J",0
42,"42034",41,25,25,0,0,"PUM+J",1
2,"2004",597,459,455,3,4,"PUM+J",0
40,"40016",55,44,43,1,1,"PUM+J",0
16,"16012",76,66,66,0,0,"PUM+J",0
19,"19262",125,98,98,0,0,"PUM+J",0
35,"35018",13153,7742,7674,80,68,"PUM+J",3
4,"4041",344,227,222,4,5,"PUM+J",0
47,"47114",3900,2549,2514,18,35,"PUM+J",3
7,"7042",10846,6354,6299,77,55,"PUM+J",7
37,"37364",760,502,500,0,2,"PUM+J",1
35,"35019",32830,18390,18243,87,147,"PUM+J",10
44,"44262",141,104,103,0,1,"PUM+J",1
37,"37206",87,65,54,0,11,"PUM+J",0
42,"42172",28,26,26,0,0,"PUM+J",0
40,"40081",117,80,76,1,4,"PUM+J",0
34,"34004",5517,3819,3769,36,50,"PUM+J",10
46,"46232",853,661,648,7,13,"PUM+J",0
34,"34141",176,149,146,0,3,"PUM+J",0
45,"45201",3692,2198,2175,15,23,"PUM+J",5
47,"47210",399,278,275,3,3,"PUM+J",0
34,"34143",161,115,112,2,3,"PUM+J",0
5,"5236",105,69,69,1,0,"PUM+J",0
49,"49267",96,67,63,2,4,"PUM+J",0
26,"26049",156,120,115,0,5,"PUM+J",0
45,"45103",363,286,283,0,3,"PUM+J",0
50,"50044",224,159,159,2,0,"PUM+J",0
9,"9059",136870,99937,98641,1416,1296,"PUM+J",304
14,"14063",994,731,719,8,12,"PUM+J",1
50,"50147",744,508,506,5,2,"PUM+J",0
10,"10083",96,76,74,0,2,"PUM+J",0
18,"18086",338,253,247,1,6,"PUM+J",0
42,"42037",28,13,13,2,0,"PUM+J",0
5,"5237",153,125,123,0,2,"PUM+J",1
4,"4044",1542,1092,1080,8,12,"PUM+J",1
7,"7044",8812,5679,5569,67,110,"PUM+J",3
49,"49191",265,192,188,2,4,"PUM+J",0
22,"22251",327,259,256,0,3,"PUM+J",0
21,"21029",1514,1036,1003,14,33,"PUM+J",0
45,"45031",2861,1894,1858,13,36,"PUM+J",1
41,"41061",2141,1661,1621,7,40,"PUM+J",0
40,"40019",29,23,23,1,0,"PUM+J",0
37,"37012",144,111,111,0,0,"PUM+J",0
49,"49269",218,126,124,1,2,"PUM+J",0
9,"9332",137,93,91,2,2,"PUM+J",0
28,"28043",6190,4031,3969,33,62,"PUM+J",0
44,"44146",164,133,133,2,0,"PUM+J",0
22,"22184",167,132,130,4,2,"PUM+J",0
29,"29069",87188,54019,53240,633,779,"PUM+J",59
14,"14055",18411,13054,12798,192,256,"PUM+J",14
28,"28013",41661,29431,29168,241,263,"PUM+J",28
34,"34056",1926,1335,1311,10,24,"PUM+J",5
37,"37045",27,19,19,0,0,"PUM+J",0
19,"19208",39,32,32,0,0,"PUM+J",0
5,"5143",59,52,51,1,1,"PUM+J",0
22,"22186",189,148,145,3,3,"PUM+J",0
6,"6090",827,570,553,3,17,"PUM+J",0
16,"16017",336,276,270,1,6,"PUM+J",0
24,"24207",276,215,215,2,0,"PUM+J",0
10,"10004",692,482,473,8,9,"PUM+J",0
50,"50071",126,84,84,0,0,"PUM+J",1
6,"6091",3669,2581,2525,20,56,"PUM+J",1
13,"13072",727,518,510,3,8,"PUM+J",0
21,"21031",1166,773,736,11,37,"PUM+J",1
7,"7047",2399,1504,1477,20,27,"PUM+J",2
19,"19075",58,38,37,3,1,"PUM+J",0
50,"50150",624,387,384,2,3,"PUM+J",0
45,"45143",1192,877,865,9,12,"PUM+J",1
11,"11019",1757,1233,1172,13,61,"PUM+J",2
9,"9337",113,80,77,2,3,"PUM+J",0
26,"26092",104,82,81,3,1,"PUM+J",0
49,"49272",73,49,46,2,3,"PUM+J",0
5,"5209",74,58,58,1,0,"PUM+J",0
2,"2066",222,165,163,1,2,"PUM+J",0
4,"4011",2744,2010,1984,20,26,"PUM+J",6
50,"50274",64,46,43,1,3,"PUM+J",0
9,"9065",136,112,111,0,1,"PUM+J",0
46,"46076",610,500,494,1,6,"PUM+J",0
28,"28121",209,156,152,1,4,"PUM+J",4
16,"16019",187,141,141,1,0,"PUM+J",0
9,"9339",128,106,105,0,1,"PUM+J",0
45,"45145",2631,1746,1707,12,39,"PUM+J",6
34,"34012",342,237,232,3,5,"PUM+J",0
26,"26093",48,34,33,0,1,"PUM+J",0
34,"34015",37,24,24,0,0,"PUM+J",0
19,"19043",99,80,79,0,1,"PUM+J",0
3,"3067",91,78,78,0,0,"PUM+J",0
18,"18189",785,598,592,9,6,"PUM+J",1
10,"10091",351,275,271,2,4,"PUM+J",0
9,"9395",121,74,74,1,0,"PUM+J",0
21,"21063",2611,1948,1891,23,57,"PUM+J",3
18,"18158",7978,4861,4771,43,90,"PUM+J",2
19,"19078",47,37,36,0,1,"PUM+J",0
9,"9175",120,78,76,1,2,"PUM+J",0
3,"3096",5786,4355,4281,38,74,"PUM+J",4
40,"40024",823,582,575,8,7,"PUM+J",1
10,"10009",255,165,162,1,3,"PUM+J",0
37,"37017",226,169,168,4,1,"PUM+J",0
34,"34017",889,676,665,7,11,"PUM+J",1
26,"26095",93,71,68,0,3,"PUM+J",0
35,"35024",14323,8360,8289,81,71,"PUM+J",5
9,"9343",92,66,65,0,1,"PUM+J",0
44,"44092",70,53,52,0,1,"PUM+J",0
50,"50276",118,91,91,0,0,"PUM+J",0
37,"37310",166,116,115,3,1,"PUM+J",0
2,"2002",427,340,337,2,3,"PUM+J",1
39,"39040",4271,3103,3080,18,23,"PUM+J",1
50,"50227",107,62,62,1,0,"PUM+J",0
23,"23062",1410,1094,1076,0,18,"PUM+J",0
34,"34018",199,151,149,4,2,"PUM+J",0
4,"4051",404,323,319,2,4,"PUM+J",0
21,"21035",9766,6114,5998,92,116,"PUM+J",6
12,"12061",374,263,261,4,2,"PUM+J",0
42,"42046",46,32,32,0,0,"PUM+J",1
9,"9345",111,87,86,2,1,"PUM+J",2
49,"49164",141,95,92,1,3,"PUM+J",0
9,"9124",1405,946,928,6,18,"PUM+J",5
13,"13079",12233,8274,8138,93,136,"PUM+J",6
28,"28091",5491,3709,3650,20,59,"PUM+J",3
47,"47186",244314,182449,180833,1818,1616,"PUM+J",362
28,"28157",690,471,467,1,4,"PUM+J",3
26,"26176",56,43,43,0,0,"PUM+J",0
10,"10121",7882,5294,5183,42,111,"PUM+J",2
34,"34019",111,87,86,1,1,"PUM+J",1
37,"37088",199,135,133,0,2,"PUM+J",0
49,"49020",253,189,187,0,2,"PUM+J",0
21,"21036",204,128,121,1,7,"PUM+J",0
23,"23901",1125,905,895,3,10,"PUM+J",0
47,"47125",49,42,42,0,0,"PUM+J",0
9,"9347",140,111,107,1,4,"PUM+J",0
4,"4053",12545,8864,8744,67,120,"PUM+J",10
45,"45150",428,322,319,3,3,"PUM+J",0
37,"37186",94,68,68,0,0,"PUM+J",0
40,"40026",112,101,99,0,2,"PUM+J",0
18,"18033",279,179,174,0,5,"PUM+J",0
5,"5245",353,262,256,0,6,"PUM+J",1
42,"42050",27,17,17,0,0,"PUM+J",0
18,"18097",947,633,631,0,2,"PUM+J",0
19,"19183",70,59,58,0,1,"PUM+J",0
29,"29096",2757,1847,1790,19,57,"PUM+J",0
45,"45004",546,400,398,2,2,"PUM+J",2
33,"33006",1476,862,857,9,5,"PUM+J",1
50,"50230",1140,771,767,11,4,"PUM+J",0
3,"3043",2906,2360,2334,27,26,"PUM+J",0
9,"9348",131,103,101,0,2,"PUM+J",0
46,"46172",5488,3724,3674,26,50,"PUM+J",5
40,"40029",25,21,19,0,2,"PUM+J",0
49,"49167",180,131,131,2,0,"PUM+J",0
5,"5018",23,17,17,2,0,"PUM+J",0
14,"14016",1273,936,922,5,14,"PUM+J",1
47,"47188",98,73,70,0,3,"PUM+J",0
42,"42013",34,22,22,2,0,"PUM+J",0
24,"24178",60,54,54,1,0,"PUM+J",0
49,"49168",89,68,68,0,0,"PUM+J",0
9,"9130",64,39,39,2,0,"PUM+J",0
47,"47189",151,128,122,1,6,"PUM+J",0
46,"46104",1906,1422,1409,5,13,"PUM+J",2
13,"13038",1589,1162,1136,21,26,"PUM+J",0
19,"19216",127,88,88,0,0,"PUM+J",0
44,"44241",500,361,357,0,4,"PUM+J",0
22,"22117",2384,1606,1596,18,10,"PUM+J",1
37,"37221",391,259,257,2,2,"PUM+J",0
22,"22906",177,123,122,6,1,"PUM+J",1
9,"9352",102,74,74,0,0,"PUM+J",0
18,"18004",669,467,466,6,1,"PUM+J",0
29,"29079",2326,1609,1582,12,27,"PUM+J",2
26,"26181",15,14,14,0,0,"PUM+J",0
40,"40094",353,265,263,3,2,"PUM+J",2
33,"33036",11281,7240,7153,96,87,"PUM+J",10
23,"23056",3052,2279,2207,26,72,"PUM+J",4
22,"22907",1463,1016,1006,21,10,"PUM+J",1
3,"3018",12433,8582,8502,54,80,"PUM+J",14
50,"50232",160,93,92,1,1,"PUM+J",0
40,"40097",130,103,102,5,1,"PUM+J",0
16,"16145",413,333,326,6,7,"PUM+J",0
37,"37222",78,55,55,2,0,"PUM+J",0
42,"42149",386,273,270,2,3,"PUM+J",2
49,"49246",214,183,180,3,3,"PUM+J",0
44,"44126",314,222,221,0,1,"PUM+J",1
21,"21071",206,148,144,4,4,"PUM+J",0
34,"34027",1049,677,665,15,12,"PUM+J",1
9,"9354",34,31,31,2,0,"PUM+J",0
2,"2009",19495,13877,13663,134,214,"PUM+J",20
28,"28055",944,636,627,4,9,"PUM+J",0
9,"9133",38,33,33,0,0,"PUM+J",1
2,"2042",810,581,577,1,4,"PUM+J",0
6,"6107",1555,980,969,8,11,"PUM+J",1
46,"46083",15372,10939,10815,78,124,"PUM+J",2
33,"33009",878,545,542,4,3,"PUM+J",1
3,"3075",154,117,115,1,2,"PUM+J",0
9,"9078",32,27,27,0,0,"PUM+J",0
38,"38022",18630,11420,11284,87,136,"PUM+J",1
45,"45156",3334,2561,2502,23,59,"PUM+J",2
10,"10142",833,555,539,0,16,"PUM+J",1
40,"40130",127,95,87,1,8,"PUM+J",0
9,"9356",43,31,30,0,1,"PUM+J",0
22,"22022",542,405,403,2,2,"PUM+J",1
12,"12094",871,671,661,1,10,"PUM+J",0
24,"24002",224,165,162,1,3,"PUM+J",0
16,"16147",54,34,33,0,1,"PUM+J",0
50,"50081",487,355,349,5,6,"PUM+J",0
37,"37097",42,29,29,0,0,"PUM+J",0
2,"2078",891,650,642,4,8,"PUM+J",1
37,"37130",173,135,134,2,1,"PUM+J",0
45,"45195",2064,1519,1481,9,38,"PUM+J",1
10,"10143",141,109,105,0,4,"PUM+J",0
6,"6019",2010,1367,1330,23,37,"PUM+J",5
12,"12902",2250,1557,1532,16,25,"PUM+J",2
5,"5157",227,146,146,3,0,"PUM+J",0
18,"18102",8233,5424,5266,46,158,"PUM+J",3
2,"2012",1835,1462,1420,9,42,"PUM+J",1
9,"9358",247,165,161,3,4,"PUM+J",0
47,"47037",161,128,125,1,3,"PUM+J",0
44,"44038",101,85,83,1,2,"PUM+J",0
30,"30006",833,699,695,1,4,"PUM+J",0
16,"16149",147,105,105,2,0,"PUM+J",1
24,"24223",2533,1727,1705,40,22,"PUM+J",2
29,"29065",191,145,143,3,2,"PUM+J",0
40,"40164",186,131,130,0,1,"PUM+J",0
44,"44218",28,24,24,3,0,"PUM+J",0
29,"29083",2063,1471,1444,14,27,"PUM+J",0
12,"12043",570,405,397,1,8,"PUM+J",0
40,"40101",918,672,665,11,7,"PUM+J",0
7,"7061",9451,5735,5666,60,69,"PUM+J",6
46,"46245",527,407,404,2,3,"PUM+J",0
37,"37028",131,96,93,2,3,"PUM+J",0
37,"37194",229,161,160,0,1,"PUM+J",1
10,"10023",842,597,589,2,8,"PUM+J",2
5,"5256",110,88,86,1,2,"PUM+J",0
50,"50297",503800,365284,362768,3385,2516,"PUM+J",368
39,"39050",260,164,164,1,0,"PUM+J",0
41,"41020",13012,8148,7999,135,149,"PUM+J",1
50,"50187",55,42,42,0,0,"PUM+J",0
7,"7029",4393,2888,2855,37,33,"PUM+J",3
46,"46223",7776,5848,5798,36,50,"PUM+J",6
49,"49067",329,200,198,4,2,"PUM+J",0
10,"10024",672,492,480,6,12,"PUM+J",0
11,"11033",21804,13361,13133,213,228,"PUM+J",4
16,"16151",61,51,51,1,0,"PUM+J",0
9,"9471",140,108,107,1,1,"PUM+J",1
26,"26071",8644,5668,5591,53,77,"PUM+J",12
13,"13094",294,216,215,1,1,"PUM+J",0
42,"42048",60,52,52,0,0,"PUM+J",0
37,"37196",70,50,50,0,0,"PUM+J",0
23,"23005",29876,20565,20268,254,297,"PUM+J",20
30,"30008",14560,9974,9840,79,134,"PUM+J",6
13,"13004",976,698,694,6,4,"PUM+J",0
40,"40104",283,203,200,0,3,"PUM+J",0
50,"50237",100,75,75,2,0,"PUM+J",0
35,"35034",8392,3946,3908,27,38,"PUM+J",1
18,"18908",776,553,528,3,25,"PUM+J",0
50,"50011",117,90,89,3,1,"PUM+J",0
21,"21047",1878,1144,1112,12,32,"PUM+J",0
3,"3024",3937,2992,2952,19,40,"PUM+J",0
7,"7064",5566,3232,3204,18,28,"PUM+J",3
5,"5062",163,121,119,3,2,"PUM+J",0
13,"13005",23256,16610,16367,132,243,"PUM+J",38
3,"3110",312,258,258,0,0,"PUM+J",2
11,"11035",13751,8535,8396,125,139,"PUM+J",9
9,"9181",276,194,191,7,3,"PUM+J",0
40,"40138",2102,1585,1565,13,20,"PUM+J",2
18,"18043",129,74,71,0,3,"PUM+J",0
40,"40007",68,55,55,1,0,"PUM+J",0
21,"21048",318,234,229,3,5,"PUM+J",1
22,"22059",1135,765,752,2,13,"PUM+J",0
47,"47041",147,105,103,3,2,"PUM+J",1
18,"18909",514,403,403,0,0,"PUM+J",0
46,"46225",351,267,262,1,5,"PUM+J",0
9,"9144",44,31,31,0,0,"PUM+J",0
44,"44042",114,82,81,0,1,"PUM+J",0
3,"3111",5579,3777,3737,23,40,"PUM+J",3
9,"9368",29,19,19,1,0,"PUM+J",0
30,"30010",6852,5161,5106,25,55,"PUM+J",1
22,"22060",1167,817,808,14,9,"PUM+J",0
16,"16908",166,133,132,2,1,"PUM+J",0
10,"10029",380,284,276,0,8,"PUM+J",0
47,"47042",51,39,39,0,0,"PUM+J",0
49,"49223",701,498,494,7,4,"PUM+J",1
45,"45129",98,77,77,1,0,"PUM+J",0
37,"37104",24,16,16,0,0,"PUM+J",0
35,"35013",6593,4596,4516,47,80,"PUM+J",6
22,"22243",43,32,31,0,1,"PUM+J",0
5,"5130",94,77,77,1,0,"PUM+J",0
24,"24190",146,103,103,2,0,"PUM+J",0
33,"33017",2969,1787,1768,38,19,"PUM+J",0
29,"29088",2689,1817,1747,15,70,"PUM+J",0
19,"19256",46,36,36,0,0,"PUM+J",0
40,"40902",113,78,76,1,2,"PUM+J",0
49,"49180",135,82,81,5,1,"PUM+J",0
7,"7902",1091,663,645,13,18,"PUM+J",0
9,"9149",36,29,29,0,0,"PUM+J",0
28,"28033",4177,2972,2936,20,36,"PUM+J",2
49,"49224",166,102,100,0,2,"PUM+J",1
18,"18015",424,331,330,4,1,"PUM+J",0
40,"40041",966,729,716,8,13,"PUM+J",0
5,"5262",318,238,235,1,3,"PUM+J",0
24,"24084",153,105,102,2,3,"PUM+J",0
5,"5034",15,14,13,0,1,"PUM+J",0
24,"24049",1417,983,975,14,8,"PUM+J",0
50,"50063",64,49,49,0,0,"PUM+J",0
21,"21020",349,230,228,2,2,"PUM+J",0
13,"13904",496,353,342,5,11,"PUM+J",2
9,"9316",104,80,80,0,0,"PUM+J",1
28,"28110",2029,1498,1478,9,20,"PUM+J",1
44,"44196",121,88,88,0,0,"PUM+J",0
16,"16910",75,44,44,1,0,"PUM+J",0
26,"26118",71,54,53,1,1,"PUM+J",0
44,"44018",16,16,16,0,0,"PUM+J",0
18,"18016",297,200,198,3,2,"PUM+J",0
28,"28141",6284,4617,4570,42,47,"PUM+J",1
16,"16158",513,371,366,5,5,"PUM+J",0
45,"45059",1702,1315,1303,1,12,"PUM+J",2
10,"10075",238,150,148,0,2,"PUM+J",0
23,"23082",1850,1292,1279,13,13,"PUM+J",0
42,"42163",50,27,27,1,0,"PUM+J",0
7,"7036",28132,18650,18510,222,140,"PUM+J",18
10,"10033",397,269,268,0,1,"PUM+J",0
9,"9209",4404,2997,2950,31,47,"PUM+J",13
10,"10156",97,71,69,0,2,"PUM+J",0
22,"22174",462,352,350,0,2,"PUM+J",0
10,"10034",337,244,240,0,4,"PUM+J",0
30,"30013",7421,5171,5094,32,77,"PUM+J",1
46,"46069",152,112,111,1,1,"PUM+J",0
21,"21053",3306,2161,2106,11,55,"PUM+J",0
29,"29092",576,375,366,7,9,"PUM+J",1
44,"44111",78,61,61,0,0,"PUM+J",0
50,"50217",426,333,333,1,0,"PUM+J",0
9,"9321",1576,1151,1135,10,16,"PUM+J",2
37,"37036",55,36,34,0,2,"PUM+J",0
29,"29045",1679,1162,1144,5,18,"PUM+J",1
37,"37235",214,163,159,2,4,"PUM+J",0
34,"34089",141,102,101,4,1,"PUM+J",0
49,"49227",317,245,244,4,1,"PUM+J",0
40,"40207",802,593,590,11,3,"PUM+J",0
19,"19033",47,38,37,1,1,"PUM+J",0
46,"46138",361,289,287,1,2,"PUM+J",0
14,"14003",1245,925,907,5,18,"PUM+J",0
30,"30014",1587,1150,1134,4,16,"PUM+J",0
37,"37037",108,72,72,0,0,"PUM+J",0
26,"26121",30,19,19,0,0,"PUM+J",0
13,"13016",656,463,454,3,9,"PUM+J",0
34,"34185",69,36,35,0,1,"PUM+J",0
21,"21054",8175,6014,5887,41,127,"PUM+J",6
9,"9380",71,42,41,0,1,"PUM+J",0
2,"2024",3361,2444,2411,24,33,"PUM+J",3
44,"44199",39,37,37,2,0,"PUM+J",0
34,"34137",24,19,19,2,0,"PUM+J",0
22,"22248",103,73,73,0,0,"PUM+J",0
24,"24123",709,461,457,2,4,"PUM+J",0
37,"37038",756,531,517,4,14,"PUM+J",0
9,"9215",359,217,216,2,1,"PUM+J",1
47,"47048",175,124,122,0,2,"PUM+J",0
14,"14032",388,302,293,0,9,"PUM+J",1
44,"44227",72,58,58,0,0,"PUM+J",0
50,"50017",1773,1283,1265,13,18,"PUM+J",1
47,"47049",91,58,58,0,0,"PUM+J",0
28,"28146",1806,1232,1218,3,14,"PUM+J",0
28,"28039",134,93,93,1,0,"PUM+J",0
29,"29047",1082,860,846,0,14,"PUM+J",0
46,"46185",361,301,299,5,2,"PUM+J",0
44,"44228",96,75,74,0,1,"PUM+J",0
12,"12080",1883,1472,1438,8,34,"PUM+J",3
37,"37332",65,49,49,0,0,"PUM+J",0
37,"37143",384,273,273,2,0,"PUM+J",0
37,"37239",203,175,174,2,1,"PUM+J",0
19,"19201",60,44,44,0,0,"PUM+J",0
21,"21056",2914,2148,2046,29,102,"PUM+J",3
37,"37333",203,125,124,2,1,"PUM+J",0
10,"10039",400,256,217,0,39,"PUM+J",0
22,"22178",105,89,89,1,0,"PUM+J",0
3,"3005",7937,5907,5869,40,38,"PUM+J",7
22,"22217",370,274,269,4,5,"PUM+J",0
28,"28010",10649,8167,8098,76,69,"PUM+J",10
49,"49010",350,260,256,8,4,"PUM+J",1
41,"41059",35358,26408,26052,346,356,"PUM+J",55
44,"44050",3113,2173,2154,14,19,"PUM+J",0
45,"45066",7815,5540,5447,25,93,"PUM+J",10
50,"50069",66,33,33,1,0,"PUM+J",0
5,"5074",668,540,537,5,3,"PUM+J",0
30,"30017",11428,8196,8113,44,83,"PUM+J",1
19,"19296",29,24,24,0,0,"PUM+J",0
49,"49189",186,104,104,1,0,"PUM+J",1
37,"37240",928,648,637,2,11,"PUM+J",1
29,"29050",392,229,227,3,2,"PUM+J",0
2,"2028",111,81,81,0,0,"PUM+J",0
33,"33025",8956,5493,5453,81,40,"PUM+J",3
34,"34196",87,67,67,3,0,"PUM+J",0
5,"5902",286,214,211,1,3,"PUM+J",2
49,"49190",50,42,42,3,0,"PUM+J",0
3,"3035",627,485,485,2,0,"PUM+J",1
34,"34005",786,601,593,3,8,"PUM+J",0
37,"37335",384,282,279,1,3,"PUM+J",0
50,"50247",852,600,594,8,6,"PUM+J",0
14,"14035",5774,4076,4017,35,59,"PUM+J",1
23,"23019",1466,1117,1090,5,27,"PUM+J",4
13,"13023",8944,6251,6165,50,86,"PUM+J",7
18,"18120",266,204,204,4,0,"PUM+J",1
30,"30018",8399,6226,6148,28,78,"PUM+J",5
46,"46233",3766,2688,2650,14,38,"PUM+J",1
4,"4077",296,270,268,3,2,"PUM+J",1
47,"47149",46,33,32,1,1,"PUM+J",0
26,"26014",443,278,273,3,5,"PUM+J",0
39,"39063",936,618,616,4,2,"PUM+J",0
10,"10043",746,525,520,4,5,"PUM+J",0
37,"37336",56,45,43,2,2,"PUM+J",1
19,"19004",59,44,44,0,0,"PUM+J",0
3,"3122",43774,30060,29834,230,226,"PUM+J",30
45,"45068",179,129,127,0,2,"PUM+J",0
14,"14036",3677,2619,2555,39,64,"PUM+J",2
18,"18056",3382,2397,2350,30,47,"PUM+J",4
12,"12083",88,69,67,9,2,"PUM+J",0
18,"18121",119,79,79,1,0,"PUM+J",1
37,"37243",89,66,66,0,0,"PUM+J",0
41,"41005",9285,6637,6497,83,140,"PUM+J",8
39,"39064",1352,1007,990,3,17,"PUM+J",0
42,"42130",51,42,40,1,2,"PUM+J",0
9,"9224",147,113,112,0,1,"PUM+J",0
10,"10086",304,228,225,4,3,"PUM+J",0
26,"26016",28,20,18,0,2,"PUM+J",0
2,"2031",535,406,401,4,5,"PUM+J",0
40,"40151",43,31,31,0,0,"PUM+J",0
46,"46052",515,423,419,4,4,"PUM+J",0
4,"4080",196,148,147,2,1,"PUM+J",0
16,"16170",646,451,449,5,2,"PUM+J",0
19,"19176",227,172,172,0,0,"PUM+J",0
24,"24024",636,407,403,6,4,"PUM+J",0
16,"16171",1728,1334,1313,10,21,"PUM+J",1
14,"14038",32742,23345,22974,242,371,"PUM+J",27
49,"49090",190,135,134,3,1,"PUM+J",0
19,"19300",782,591,588,5,3,"PUM+J",2
19,"19111",160,128,125,0,3,"PUM+J",0
26,"26130",205,153,150,1,3,"PUM+J",0
30,"30021",9498,6251,6193,36,58,"PUM+J",2
13,"13027",3185,2112,2055,12,57,"PUM+J",3
37,"37275",98,67,67,0,0,"PUM+J",0
47,"47087",362,272,268,1,4,"PUM+J",1
18,"18028",898,723,718,3,5,"PUM+J",0
46,"46190",50042,35290,35066,284,224,"PUM+J",25
12,"12004",4149,2945,2910,25,35,"PUM+J",1
22,"22187",288,220,220,2,0,"PUM+J",0
3,"3038",330,260,254,3,6,"PUM+J",0
26,"26131",34,33,33,0,0,"PUM+J",0
37,"37047",215,89,89,0,0,"PUM+J",0
44,"44235",87,65,64,1,1,"PUM+J",0
6,"6140",612,456,451,1,5,"PUM+J",0
4,"4081",351,264,263,0,1,"PUM+J",0
18,"18123",284,202,200,5,2,"PUM+J",0
19,"19178",27,17,16,0,1,"PUM+J",0
37,"37276",125,92,92,0,0,"PUM+J",0
39,"39039",540,355,355,1,0,"PUM+J",0
44,"44028",171,136,136,0,0,"PUM+J",0
19,"19148",42,29,28,1,1,"PUM+J",0
37,"37370",316,238,237,2,1,"PUM+J",0
33,"33058",1668,1050,1035,13,15,"PUM+J",0
4,"4049",5711,3766,3732,25,34,"PUM+J",4
5,"5178",340,261,255,3,6,"PUM+J",1
29,"29055",1892,1425,1394,3,31,"PUM+J",3
19,"19114",30,22,21,1,1,"PUM+J",0
37,"37340",141,97,97,1,0,"PUM+J",0
44,"44150",28,17,17,0,0,"PUM+J",0
14,"14040",3749,2905,2845,53,60,"PUM+J",2
9,"9229",178,127,127,1,0,"PUM+J",2
42,"42088",62,45,44,0,1,"PUM+J",0
5,"5179",199,176,172,1,4,"PUM+J",0
3,"3097",1014,778,764,5,14,"PUM+J",0
22,"22151",85,60,60,0,0,"PUM+J",0
47,"47154",146,115,111,6,4,"PUM+J",0
13,"13032",1076,772,765,0,7,"PUM+J",0
37,"37050",66,52,52,1,0,"PUM+J",0
22,"22078",431,285,285,4,0,"PUM+J",0
28,"28123",62178,49883,49515,397,368,"PUM+J",55
50,"50050",87,62,62,1,0,"PUM+J",0
9,"9068",23,16,16,0,0,"PUM+J",0
45,"45186",2943,2142,2121,12,21,"PUM+J",4
22,"22079",118,85,84,1,1,"PUM+J",0
33,"33031",33775,20484,20184,276,300,"PUM+J",9
37,"37248",150,116,116,1,0,"PUM+J",0
26,"26022",177,130,128,0,2,"PUM+J",1
44,"44031",83,50,50,0,0,"PUM+J",0
4,"4085",360,291,289,0,2,"PUM+J",1
3,"3041",6132,4204,4167,22,37,"PUM+J",5
19,"19009",263,186,184,0,2,"PUM+J",0
39,"39098",1381,1088,1080,5,8,"PUM+J",0
16,"16024",121,85,84,0,1,"PUM+J",0
49,"49202",173,103,101,0,2,"PUM+J",0
44,"44060",32,25,25,0,0,"PUM+J",0
42,"42185",24,20,20,0,0,"PUM+J",0
22,"22049",73,62,62,0,0,"PUM+J",0
33,"33005",1357,832,825,11,7,"PUM+J",0
37,"37052",287,192,191,2,1,"PUM+J",0
41,"41012",3375,2259,2214,26,45,"PUM+J",3
50,"50253",379,294,290,1,4,"PUM+J",0
5,"5181",46,34,34,0,0,"PUM+J",0
18,"18002",529,387,384,1,3,"PUM+J",0
45,"45188",2770,1925,1886,12,39,"PUM+J",1
7,"7020",3707,2522,2493,40,29,"PUM+J",5
16,"16177",83,65,65,1,0,"PUM+J",0
2,"2038",262,197,193,0,4,"PUM+J",0
44,"44153",1733,1131,1125,0,6,"PUM+J",0
13,"13035",947,704,690,6,14,"PUM+J",1
39,"39071",410,251,250,1,1,"PUM+J",0
5,"5182",721,457,436,3,21,"PUM+J",0
18,"18128",332,263,260,1,3,"PUM+J",0
6,"6011",24731,16786,16538,167,248,"PUM+J",56
35,"35027",10502,6831,6750,67,81,"PUM+J",8
50,"50028",78,53,53,0,0,"PUM+J",0
46,"46126",5580,4361,4328,36,33,"PUM+J",2
34,"34067",129,80,78,1,2,"PUM+J",0
46,"46195",2000,1540,1532,3,8,"PUM+J",0
44,"44034",124,90,90,0,0,"PUM+J",0
26,"26140",239,180,177,1,3,"PUM+J",0
40,"40222",161,134,131,1,3,"PUM+J",0
2,"2006",573,425,424,1,1,"PUM+J",0
22,"22157",181,122,121,2,1,"PUM+J",0
28,"28094",988,711,707,5,4,"PUM+J",0
4,"4055",361,298,290,3,8,"PUM+J",0
3,"3101",4933,3502,3462,16,40,"PUM+J",3
6,"6012",3231,2306,2278,25,28,"PUM+J",5
9,"9407",25,19,17,0,2,"PUM+J",0
44,"44240",151,119,117,0,2,"PUM+J",1
50,"50105",277,203,198,4,5,"PUM+J",2
50,"50078",227,168,166,0,2,"PUM+J",0
9,"9408",40,29,29,0,0,"PUM+J",0
9,"9239",47,31,31,0,0,"PUM+J",0
6,"6013",261,209,204,4,5,"PUM+J",0
2,"2041",316,238,236,0,2,"PUM+J",0
6,"6014",6503,4235,4181,35,54,"PUM+J",6
40,"40223",235,177,174,1,3,"PUM+J",0
18,"18133",2101,1496,1477,6,19,"PUM+J",0
18,"18164",1790,1135,1108,11,27,"PUM+J",0
28,"28054",11943,8800,8731,72,69,"PUM+J",8
34,"34165",57,45,44,1,1,"PUM+J",0
35,"35029",4415,2498,2472,29,26,"PUM+J",1
49,"49170",99,68,68,1,0,"PUM+J",0
9,"9298",72,52,52,1,0,"PUM+J",0
47,"47191",111,81,81,0,0,"PUM+J",0
29,"29034",461,333,332,2,1,"PUM+J",1
10,"10017",775,554,545,1,9,"PUM+J",1
19,"19120",107,86,86,1,0,"PUM+J",0
7,"7024",7283,3574,3538,36,36,"PUM+J",9
12,"12011",4583,3228,3177,24,51,"PUM+J",12
45,"45192",2380,1890,1854,8,36,"PUM+J",1
16,"16066",2280,1765,1734,18,31,"PUM+J",2
13,"13087",23255,15400,15127,213,273,"PUM+J",43
16,"16067",123,91,90,1,1,"PUM+J",0
50,"50030",197,124,124,1,0,"PUM+J",0
45,"45193",586,478,469,0,9,"PUM+J",0
44,"44036",22,20,20,0,0,"PUM+J",0
50,"50056",399,296,296,3,0,"PUM+J",0
6,"6062",564,394,391,0,3,"PUM+J",0
42,"42017",131,99,96,1,3,"PUM+J",0
50,"50208",1761,1267,1250,16,17,"PUM+J",0
44,"44064",62,46,46,0,0,"PUM+J",0
12,"12012",2622,2084,2056,12,28,"PUM+J",3
30,"30029",12122,8231,8125,54,106,"PUM+J",3
22,"22163",426,338,335,0,3,"PUM+J",0
37,"37129",248,181,181,1,0,"PUM+J",1
50,"50234",242,159,154,4,5,"PUM+J",0
24,"24037",330,189,189,1,0,"PUM+J",0
22,"22201",264,188,186,3,2,"PUM+J",0
28,"28164",3230,2371,2345,28,26,"PUM+J",2
6,"6109",3821,2943,2813,16,130,"PUM+J",2
24,"24109",857,534,528,8,6,"PUM+J",2
34,"34121",187,150,150,3,0,"PUM+J",0
4,"4059",1000,676,666,3,10,"PUM+J",0
5,"5187",1714,1247,1221,9,26,"PUM+J",0
13,"13044",2582,1838,1804,13,34,"PUM+J",0
46,"46198",862,670,660,3,10,"PUM+J",0
9,"9413",405,267,263,0,4,"PUM+J",0
47,"47067",153,112,112,3,0,"PUM+J",0
45,"45085",1535,1061,1052,11,9,"PUM+J",3
10,"10184",734,520,511,4,9,"PUM+J",0
16,"16190",4930,3747,3688,26,59,"PUM+J",1
37,"37162",212,139,137,3,2,"PUM+J",0
12,"12095",950,723,712,5,11,"PUM+J",0
50,"50259",82,55,55,2,0,"PUM+J",0
19,"19220",2608,1673,1653,10,20,"PUM+J",2
18,"18007",730,490,478,3,12,"PUM+J",0
50,"50161",98,75,74,2,1,"PUM+J",0
37,"37027",239,182,179,2,3,"PUM+J",0
45,"45196",1382,1029,1005,7,24,"PUM+J",2
37,"37226",152,113,113,2,0,"PUM+J",0
33,"33040",4556,2837,2784,58,53,"PUM+J",0
37,"37163",34,24,24,0,0,"PUM+J",0
46,"46131",49805,35527,35231,298,296,"PUM+J",38
45,"45087",8180,5737,5628,41,109,"PUM+J",7
6,"6112",379,295,293,0,2,"PUM+J",0
26,"26033",162,133,132,3,1,"PUM+J",0
19,"19020",46,31,31,0,0,"PUM+J",0
45,"45197",1888,1446,1426,5,20,"PUM+J",2
50,"50186",37,26,26,1,0,"PUM+J",0
49,"49216",147,115,109,0,6,"PUM+J",0
14,"14051",1323,975,951,7,24,"PUM+J",0
45,"45051",1678,1238,1209,13,29,"PUM+J",1
28,"28134",63936,48022,47631,421,391,"PUM+J",47
18,"18040",237,146,145,0,1,"PUM+J",0
26,"26034",606,457,440,5,17,"PUM+J",2
47,"47165",6823,4999,4906,48,93,"PUM+J",9
12,"12097",62,53,51,0,2,"PUM+J",1
33,"33041",7101,4564,4513,58,51,"PUM+J",8
10,"10107",1019,766,755,12,11,"PUM+J",0
28,"28029",576,443,443,4,0,"PUM+J",0
14,"14024",1849,1417,1391,5,26,"PUM+J",0
34,"34035",97,76,75,3,1,"PUM+J",0
26,"26035",16,12,11,0,1,"PUM+J",0
6,"6024",1123,876,849,3,27,"PUM+J",0
42,"42107",70,48,47,1,1,"PUM+J",0
47,"47040",56,42,41,0,1,"PUM+J",0
34,"34228",77,59,59,1,0,"PUM+J",0
50,"50261",201,154,151,0,3,"PUM+J",0
40,"40071",39,32,26,0,6,"PUM+J",0
9,"9088",63,31,30,0,1,"PUM+J",0
9,"9250",264,195,193,3,2,"PUM+J",0
40,"40168",27,20,20,0,0,"PUM+J",0
33,"33043",656,408,401,2,7,"PUM+J",0
24,"24154",952,625,618,5,7,"PUM+J",2
44,"44161",428,294,292,2,2,"PUM+J",0
49,"49108",446,312,309,2,3,"PUM+J",1
46,"46248",4868,3434,3374,16,60,"PUM+J",4
37,"37230",220,169,168,1,1,"PUM+J",0
29,"29040",1933,1260,1235,11,25,"PUM+J",1
42,"42201",23,21,21,0,0,"PUM+J",0
44,"44250",20,15,15,0,0,"PUM+J",0
46,"46065",1584,1199,1183,11,16,"PUM+J",1
21,"21078",2641,1718,1670,10,48,"PUM+J",0
4,"4098",1424,890,885,0,5,"PUM+J",0
46,"46088",152,114,110,1,4,"PUM+J",0
19,"19319",4609,3303,3273,22,30,"PUM+J",11
24,"24156",220,135,133,0,2,"PUM+J",0
37,"37167",174,147,144,2,3,"PUM+J",0
49,"49109",561,419,415,6,4,"PUM+J",0
6,"6902",1651,1198,1174,19,24,"PUM+J",2
45,"45091",376,270,269,3,1,"PUM+J",3
50,"50189",678,494,487,6,7,"PUM+J",0
40,"40073",387,327,323,1,4,"PUM+J",0
24,"24044",150,91,89,2,2,"PUM+J",0
5,"5194",132,105,104,1,1,"PUM+J",0
40,"40008",42,36,36,1,0,"PUM+J",0
3,"3054",334,248,245,2,3,"PUM+J",0
24,"24046",893,595,583,6,12,"PUM+J",0
9,"9369",419,288,284,3,4,"PUM+J",2
12,"12124",1842,1343,1328,13,15,"PUM+J",1
3,"3112",650,503,497,3,6,"PUM+J",0
37,"37262",69,51,51,0,0,"PUM+J",0
16,"16041",334,244,243,2,1,"PUM+J",0
9,"9202",22,16,16,2,0,"PUM+J",0
47,"47075",4772,3557,3512,34,45,"PUM+J",4
13,"13054",4870,3630,3575,26,55,"PUM+J",3
37,"37263",339,215,210,0,5,"PUM+J",0
44,"44074",440,314,308,2,6,"PUM+J",0
34,"34232",725,505,492,13,13,"PUM+J",1
6,"6075",470,363,360,7,3,"PUM+J",0
14,"14056",23477,15826,15470,177,356,"PUM+J",17
6,"6029",1174,873,865,5,8,"PUM+J",0
19,"19322",26,20,19,1,1,"PUM+J",0
30,"30036",15432,10030,9879,64,151,"PUM+J",5
41,"41098",5161,3792,3732,33,60,"PUM+J",2
37,"37293",102,68,68,1,0,"PUM+J",0
21,"21050",12567,8522,8392,89,130,"PUM+J",9
50,"50038",1404,1024,1007,15,17,"PUM+J",2
34,"34042",294,224,221,1,3,"PUM+J",0
5,"5066",435,344,341,2,3,"PUM+J",0
2,"2020",425,336,332,4,4,"PUM+J",0
16,"16043",88,60,60,3,0,"PUM+J",0
9,"9098",470,318,309,3,9,"PUM+J",0
50,"50265",74,54,54,1,0,"PUM+J",0
6,"6122",6535,4204,4110,47,94,"PUM+J",16
6,"6031",462,285,280,2,5,"PUM+J",0
9,"9425",472,311,309,3,2,"PUM+J",0
26,"26158",242,184,181,1,3,"PUM+J",0
19,"19133",78,64,64,2,0,"PUM+J",0
10,"10115",3460,2584,2503,15,81,"PUM+J",3
39,"39084",868,608,605,3,3,"PUM+J",1
11,"11040",396,332,324,3,8,"PUM+J",0
38,"38030",1962,1332,1318,9,14,"PUM+J",0
16,"16199",27,18,18,0,0,"PUM+J",0
19,"19324",164,122,120,4,2,"PUM+J",0
47,"47077",234,172,170,1,2,"PUM+J",1
6,"6078",500,363,359,1,4,"PUM+J",0
41,"41099",3961,2448,2413,14,35,"PUM+J",4
50,"50116",169,124,123,0,1,"PUM+J",0
16,"16008",80,63,63,1,0,"PUM+J",0
9,"9902",439,334,326,10,8,"PUM+J",4
9,"9155",25,23,23,0,0,"PUM+J",0
16,"16045",180,128,127,0,1,"PUM+J",0
37,"37266",68,44,44,0,0,"PUM+J",0
39,"39057",2366,1636,1607,10,29,"PUM+J",4
19,"19229",58,53,53,0,0,"PUM+J",0
41,"41100",954,670,635,7,35,"PUM+J",0
46,"46001",771,562,560,3,2,"PUM+J",1
42,"42031",25,17,17,1,0,"PUM+J",0
47,"47078",157,114,107,0,7,"PUM+J",0
19,"19259",28,22,22,0,0,"PUM+J",0
19,"19169",30,27,27,0,0,"PUM+J",0
34,"34047",1711,1275,1248,18,27,"PUM+J",2
16,"16086",872,699,690,7,9,"PUM+J",2
24,"24161",294,208,204,3,4,"PUM+J",0
47,"47174",271,215,213,4,2,"PUM+J",1
16,"16251",1805,1318,1302,9,16,"PUM+J",0
9,"9266",97,71,68,1,3,"PUM+J",0
49,"49115",167,121,121,2,0,"PUM+J",1
9,"9430",25,21,21,0,0,"PUM+J",1
22,"22176",171,140,138,2,2,"PUM+J",0
26,"26008",1821,1310,1290,15,20,"PUM+J",2
6,"6128",4457,2996,2934,28,62,"PUM+J",3
46,"46116",13606,10262,10200,87,62,"PUM+J",3
24,"24053",398,250,248,1,2,"PUM+J",0
49,"49007",361,241,233,7,8,"PUM+J",0
28,"28079",2384271,1765443,1753633,13854,11810,"PUM+J",2260
28,"28008",2008,1333,1323,7,10,"PUM+J",0
47,"47175",6755,4950,4870,49,80,"PUM+J",9
37,"37362",4783,3469,3420,44,49,"PUM+J",4
41,"41029",13520,9849,9663,134,186,"PUM+J",19
18,"18049",588,418,415,4,3,"PUM+J",0
16,"16205",106,73,73,1,0,"PUM+J",0
19,"19231",10,6,6,0,0,"PUM+J",0
46,"46071",471,355,349,1,6,"PUM+J",0
41,"41102",14773,10377,10028,174,349,"PUM+J",11
12,"12105",825,602,598,6,4,"PUM+J",0
28,"28080",49866,39769,39583,346,186,"PUM+J",38
5,"5105",330,247,242,2,5,"PUM+J",1
12,"12025",116,82,79,1,3,"PUM+J",0
2,"2059",320,225,217,0,8,"PUM+J",0
44,"44261",713,553,549,3,4,"PUM+J",0
6,"6038",785,561,550,5,11,"PUM+J",1
19,"19138",215,158,154,4,4,"PUM+J",0
4,"4004",405,282,272,2,10,"PUM+J",0
41,"41030",501,376,366,9,10,"PUM+J",0
5,"5001",182,139,138,1,1,"PUM+J",0
16,"16013",26,24,24,0,0,"PUM+J",0
24,"24202",7504,4607,4538,51,69,"PUM+J",6
26,"26084",7264,5130,5059,61,71,"PUM+J",11
39,"39089",131,82,82,0,0,"PUM+J",0
18,"18051",1092,735,718,8,17,"PUM+J",0
47,"47177",104,78,78,0,0,"PUM+J",0
24,"24127",263,183,181,1,2,"PUM+J",0
34,"34242",91,65,62,2,3,"PUM+J",0
5,"5107",54,36,35,2,1,"PUM+J",0
6,"6041",456,329,321,2,8,"PUM+J",0
16,"16209",110,95,94,2,1,"PUM+J",0
41,"41902",4599,2906,2868,50,38,"PUM+J",2
26,"26048",21,21,21,0,0,"PUM+J",0
28,"28179",1451,1043,1033,6,10,"PUM+J",2
2,"2060",1268,953,939,7,14,"PUM+J",0
19,"19233",79,65,65,2,0,"PUM+J",0
40,"40180",276,215,210,2,5,"PUM+J",0
13,"13067",334,279,271,2,8,"PUM+J",0
22,"22142",94,72,70,0,2,"PUM+J",0
41,"41088",515,368,358,2,10,"PUM+J",0
29,"29067",431757,290824,287855,3289,2969,"PUM+J",451
28,"28011",417,295,292,6,3,"PUM+J",0
47,"47178",170,128,124,2,4,"PUM+J",0
23,"23055",46314,30950,30506,279,444,"PUM+J",35
19,"19331",2677,1892,1841,18,51,"PUM+J",5
28,"28180",5317,4011,3959,35,52,"PUM+J",2
28,"28084",16243,11562,11408,90,154,"PUM+J",11
49,"49086",111,89,89,1,0,"PUM+J",0
22,"22107",102,53,53,0,0,"PUM+J",0
2,"2062",382,261,256,2,5,"PUM+J",0
46,"46006",4454,3527,3486,27,41,"PUM+J",3
10,"10084",1266,755,717,7,38,"PUM+J",1
12,"12028",13004,9801,9732,74,69,"PUM+J",11
16,"16212",233,186,184,0,2,"PUM+J",0
46,"46074",2687,2033,2020,18,13,"PUM+J",0
9,"9439",1061,801,790,2,11,"PUM+J",4
47,"47084",1077,794,784,11,10,"PUM+J",1
19,"19235",98,77,76,1,1,"PUM+J",0
18,"18025",277,198,197,0,1,"PUM+J",0
28,"28181",20801,16353,16243,97,110,"PUM+J",15
50,"50198",47,32,32,0,0,"PUM+J",1
47,"47085",16330,11556,11419,121,137,"PUM+J",12
19,"19298",53,43,41,0,2,"PUM+J",0
24,"24023",264,188,185,1,3,"PUM+J",0
37,"37211",208,148,148,0,0,"PUM+J",0
24,"24060",561,297,296,2,1,"PUM+J",0
42,"42176",27,21,21,0,0,"PUM+J",0
23,"23057",727,582,572,7,10,"PUM+J",0
12,"12109",646,489,482,4,7,"PUM+J",1
50,"50199",318,206,201,1,5,"PUM+J",0
14,"14065",1820,1374,1352,13,22,"PUM+J",1
49,"49014",116,83,83,1,0,"PUM+J",0
19,"19237",39,34,34,0,0,"PUM+J",0
39,"39009",3325,2306,2293,7,13,"PUM+J",0
50,"50046",162,125,125,6,0,"PUM+J",1
22,"22012",102,75,75,2,0,"PUM+J",0
44,"44265",175,138,136,1,2,"PUM+J",0
6,"6046",1250,983,959,6,24,"PUM+J",0
9,"9442",368,265,262,1,3,"PUM+J",0
28,"28015",20885,16237,16104,134,133,"PUM+J",17
40,"40184",245,196,194,0,2,"PUM+J",2
50,"50124",394,269,266,0,3,"PUM+J",0
18,"18154",982,668,668,4,0,"PUM+J",1
50,"50200",479,389,383,5,6,"PUM+J",0
19,"19238",43,30,28,0,2,"PUM+J",0
9,"9119",42,24,24,0,0,"PUM+J",0
50,"50047",38,24,24,0,0,"PUM+J",0
33,"33057",1525,1005,988,17,17,"PUM+J",3
30,"30902",8294,5235,5174,29,61,"PUM+J",7
49,"49015",198,156,155,0,1,"PUM+J",0
3,"3066",41762,28723,28388,358,335,"PUM+J",37
45,"45108",465,343,341,0,2,"PUM+J",0
44,"44178",52,34,34,0,0,"PUM+J",0
14,"14067",3842,2863,2800,42,63,"PUM+J",2
12,"12032",23728,16870,16726,121,144,"PUM+J",20
34,"34904",300,188,186,0,2,"PUM+J",0
28,"28901",890,624,618,5,6,"PUM+J",0
14,"14011",580,444,443,3,1,"PUM+J",1
34,"34104",231,164,162,2,2,"PUM+J",0
7,"7015",22248,12375,12286,202,89,"PUM+J",13
44,"44029",585,454,451,2,3,"PUM+J",0
40,"40218",80,56,55,0,1,"PUM+J",0
12,"12060",434,366,360,1,6,"PUM+J",1
47,"47057",272,200,199,0,1,"PUM+J",1
24,"24063",362,247,245,2,2,"PUM+J",1
13,"13075",196,147,146,2,1,"PUM+J",0
44,"44090",66,49,49,0,0,"PUM+J",0
14,"14068",517,388,378,3,10,"PUM+J",0
26,"26056",404,312,301,2,11,"PUM+J",0
16,"16098",521,418,415,2,3,"PUM+J",0
34,"34106",110,92,92,3,0,"PUM+J",0
9,"9122",86,55,55,0,0,"PUM+J",0
37,"37086",107,86,85,2,1,"PUM+J",0
16,"16271",612,482,481,3,1,"PUM+J",0
42,"42008",54,41,41,0,0,"PUM+J",0
50,"50100",304,215,212,1,3,"PUM+J",0
28,"28903",35555,28875,28671,341,204,"PUM+J",42
7,"7017",899,604,596,10,8,"PUM+J",4
40,"40089",209,155,148,2,7,"PUM+J",0
26,"26174",134,100,99,3,1,"PUM+J",0
3,"3127",350,260,255,1,5,"PUM+J",0
10,"10010",2206,1308,1281,8,27,"PUM+J",0
37,"37278",793,570,567,6,3,"PUM+J",0
28,"28018",4121,3174,3151,22,23,"PUM+J",3
10,"10092",260,201,200,1,1,"PUM+J",0
16,"16100",642,518,514,2,4,"PUM+J",1
4,"4014",152,105,103,1,2,"PUM+J",0
5,"5015",68,45,44,1,1,"PUM+J",0
45,"45112",1844,1121,1086,8,35,"PUM+J",2
24,"24065",2164,1524,1492,12,32,"PUM+J",3
23,"23063",3784,2699,2664,22,35,"PUM+J",1
7,"7018",389,238,236,1,2,"PUM+J",1
6,"6008",615,522,507,2,15,"PUM+J",1
40,"40058",306,244,240,1,4,"PUM+J",0
50,"50128",26,23,23,0,0,"PUM+J",0
18,"18063",1232,687,678,9,9,"PUM+J",0
6,"6054",5452,3773,3657,34,116,"PUM+J",9
41,"41011",15462,11019,10696,183,323,"PUM+J",0
16,"16176",29,20,20,0,0,"PUM+J",0
7,"7019",161,104,102,0,2,"PUM+J",0
22,"22227",200,140,140,2,0,"PUM+J",0
50,"50129",212,129,127,0,2,"PUM+J",0
29,"29075",12886,8292,8191,63,101,"PUM+J",7
12,"12114",200,144,140,0,4,"PUM+J",0
50,"50052",81,61,61,0,0,"PUM+J",0
12,"12036",541,401,395,6,6,"PUM+J",0
22,"22115",348,263,261,3,2,"PUM+J",0
9,"9450",23,18,18,1,0,"PUM+J",0
37,"37374",1138,889,872,2,17,"PUM+J",0
46,"46148",1515,1131,1113,5,18,"PUM+J",1
35,"35004",41975,20773,20602,156,171,"PUM+J",11
40,"40092",105,75,75,2,0,"PUM+J",0
49,"49130",155,116,112,1,4,"PUM+J",0
44,"44033",243,165,165,3,0,"PUM+J",0
18,"18064",366,289,286,0,3,"PUM+J",0
2,"2039",945,745,734,8,11,"PUM+J",1
19,"19274",953,693,676,9,17,"PUM+J",1
10,"10218",1074,685,672,0,13,"PUM+J",1
37,"37187",548,407,399,0,8,"PUM+J",0
40,"40093",74,62,62,1,0,"PUM+J",0
41,"41013",4836,3174,3124,41,50,"PUM+J",2
18,"18065",588,464,451,2,13,"PUM+J",0
10,"10096",3311,2248,2201,15,47,"PUM+J",1
13,"13083",2382,1623,1587,12,36,"PUM+J",3
50,"50053",643,476,466,3,10,"PUM+J",0
49,"49058",301,222,221,1,1,"PUM+J",0
3,"3044",4608,3437,3391,13,46,"PUM+J",3
10,"10056",533,377,371,2,6,"PUM+J",0
47,"47001",52,43,42,1,1,"PUM+J",0
26,"26062",85,62,62,1,0,"PUM+J",0
26,"26141",98,70,70,0,0,"PUM+J",0
16,"16185",36,31,31,0,0,"PUM+J",0
42,"42094",596,448,436,9,12,"PUM+J",0
26,"26180",221,164,162,4,2,"PUM+J",0
49,"49132",310,220,215,2,5,"PUM+J",0
46,"46218",1043,842,829,6,13,"PUM+J",0
49,"49023",899,627,620,3,7,"PUM+J",1
42,"42145",129,105,104,1,1,"PUM+J",0
44,"44006",220,152,151,1,1,"PUM+J",0
49,"49133",287,206,203,1,3,"PUM+J",0
46,"46059",1244,1007,995,5,12,"PUM+J",0
44,"44063",63,52,52,0,0,"PUM+J",0
18,"18100",7997,5523,5367,66,156,"PUM+J",1
9,"9456",130,86,86,1,0,"PUM+J",0
10,"10140",1109,778,769,7,9,"PUM+J",0
9,"9189",123,83,78,0,5,"PUM+J",0
44,"44035",102,82,80,1,2,"PUM+J",0
5,"5056",91,71,70,0,1,"PUM+J",0
24,"24146",254,202,201,1,1,"PUM+J",0
10,"10058",979,628,599,6,29,"PUM+J",0
4,"4020",302,207,206,2,1,"PUM+J",1
49,"49099",96,67,67,0,0,"PUM+J",0
50,"50207",87,58,58,1,0,"PUM+J",0
19,"19050",15,13,13,0,0,"PUM+J",0
45,"45008",144,112,110,1,2,"PUM+J",0
37,"37024",89,60,60,0,0,"PUM+J",0
45,"45119",3499,2217,2190,3,27,"PUM+J",5
24,"24071",947,618,611,6,7,"PUM+J",0
26,"26183",66,48,48,0,0,"PUM+J",0
42,"42016",20,13,13,0,0,"PUM+J",0
34,"34028",132,95,92,2,3,"PUM+J",0
16,"16279",173,109,108,0,1,"PUM+J",0
13,"13042",880,638,626,2,12,"PUM+J",0
3,"3104",27072,19732,19477,218,255,"PUM+J",32
9,"9460",162,141,140,0,1,"PUM+J",0
50,"50133",98,76,76,0,0,"PUM+J",0
42,"42151",38,27,27,0,0,"PUM+J",0
7,"7025",443,313,310,5,3,"PUM+J",2
49,"49135",576,368,366,3,2,"PUM+J",1
44,"44101",55,41,40,1,1,"PUM+J",0
29,"29008",15249,10396,10234,108,162,"PUM+J",10
9,"9135",41,28,28,0,0,"PUM+J",1
33,"33066",42818,27780,27466,425,314,"PUM+J",23
29,"29081",250,185,182,2,3,"PUM+J",0
21,"21012",285,224,221,0,3,"PUM+J",0
28,"28131",13510,9647,9544,89,103,"PUM+J",13
26,"26031",95,83,83,0,0,"PUM+J",0
7,"7026",31129,17489,17342,178,147,"PUM+J",21
37,"37098",290,197,197,1,0,"PUM+J",0
40,"40100",262,208,204,4,4,"PUM+J",0
28,"28027",1215,836,826,8,10,"PUM+J",1
7,"7027",22101,13161,13028,140,133,"PUM+J",14
18,"18069",484,356,356,5,0,"PUM+J",0
21,"21013",10626,6990,6807,99,183,"PUM+J",7
34,"34122",83,56,56,0,0,"PUM+J",0
50,"50134",120,85,82,4,3,"PUM+J",0
45,"45122",5605,4321,4288,33,33,"PUM+J",8
40,"40196",30,24,24,0,0,"PUM+J",0
11,"11001",4360,2810,2744,32,66,"PUM+J",3
37,"37256",191,123,123,1,0,"PUM+J",0
22,"22086",194,137,137,1,0,"PUM+J",0
34,"34223",203,147,143,1,4,"PUM+J",0
45,"45158",2545,1805,1786,9,19,"PUM+J",2
5,"5221",322,231,231,0,0,"PUM+J",0
7,"7028",944,635,628,2,7,"PUM+J",0
40,"40165",73,53,52,0,1,"PUM+J",1
49,"49138",205,141,140,2,1,"PUM+J",0
19,"19160",883,535,530,11,5,"PUM+J",1
42,"42020",4170,2732,2686,35,46,"PUM+J",7
37,"37382",162,127,124,0,3,"PUM+J",0
9,"9306",94,69,69,1,0,"PUM+J",1
9,"9307",102,76,74,1,2,"PUM+J",0
46,"46154",795,619,608,5,11,"PUM+J",0
23,"23074",2984,2271,2236,20,35,"PUM+J",6
9,"9138",84,67,66,1,1,"PUM+J",0
26,"26149",42,34,34,0,0,"PUM+J",0
50,"50260",35,31,31,0,0,"PUM+J",0
44,"44160",438,287,285,4,2,"PUM+J",0
44,"44191",714,509,500,5,9,"PUM+J",0
11,"11003",1230,802,787,9,15,"PUM+J",0
49,"49252",312,240,236,7,4,"PUM+J",0
40,"40005",25,23,23,1,0,"PUM+J",0
49,"49030",79,56,56,0,0,"PUM+J",0
38,"38001",21069,10844,10777,63,67,"PUM+J",4
42,"42156",29,21,21,0,0,"PUM+J",0
21,"21077",1739,1266,1235,13,31,"PUM+J",2
30,"30032",2864,2154,2129,18,25,"PUM+J",1
23,"23041",489,378,376,1,2,"PUM+J",0
29,"29085",138,98,93,1,5,"PUM+J",0
9,"9309",293,198,193,5,5,"PUM+J",0
4,"4097",231,173,173,1,0,"PUM+J",0
22,"22239",85,67,65,0,2,"PUM+J",0
40,"40006",22,19,19,0,0,"PUM+J",0
9,"9472",52,40,38,0,2,"PUM+J",0
4,"4028",207,175,171,1,4,"PUM+J",0
37,"37195",39,31,31,0,0,"PUM+J",0
11,"11004",89919,55211,54544,830,667,"PUM+J",39
50,"50137",958,740,731,8,9,"PUM+J",1
18,"18012",2114,1519,1492,9,27,"PUM+J",0
42,"42158",97,73,73,1,0,"PUM+J",0
23,"23076",774,606,595,6,11,"PUM+J",0
24,"24080",207,155,154,1,1,"PUM+J",0
5,"5192",92,75,72,1,3,"PUM+J",0
2,"2049",778,506,496,1,10,"PUM+J",1
22,"22242",60,41,40,0,1,"PUM+J",0
37,"37166",196,134,133,1,1,"PUM+J",0
3,"3081",1492,1070,1044,12,26,"PUM+J",0
16,"16003",134,108,105,0,3,"PUM+J",0
47,"47198",64,43,43,0,0,"PUM+J",0
9,"9310",15,14,11,0,3,"PUM+J",0
44,"44107",212,135,135,0,0,"PUM+J",0
37,"37001",165,120,120,0,0,"PUM+J",0
16,"16245",396,304,298,1,6,"PUM+J",0
6,"6072",2211,1610,1586,11,24,"PUM+J",0
41,"41051",2317,1715,1688,4,27,"PUM+J",0
42,"42025",1125,741,732,12,9,"PUM+J",1
13,"13098",1946,1404,1361,13,43,"PUM+J",4
50,"50213",92,70,70,2,0,"PUM+J",0
50,"50139",318,237,237,1,0,"PUM+J",0
7,"7033",28539,15238,15070,187,168,"PUM+J",26
16,"16004",228,175,174,0,1,"PUM+J",0
50,"50114",132,108,108,0,0,"PUM+J",0
19,"19165",45,39,39,0,0,"PUM+J",0
11,"11007",18032,9872,9745,213,127,"PUM+J",11
46,"46135",9817,7596,7558,58,38,"PUM+J",6
41,"41097",3131,2197,2140,13,57,"PUM+J",1
50,"50214",18,18,14,1,4,"PUM+J",0
5,"5033",169,135,134,0,1,"PUM+J",1
49,"49145",208,113,113,1,0,"PUM+J",0
42,"42161",136,99,99,0,0,"PUM+J",0
38,"38004",4536,2914,2887,28,27,"PUM+J",1
22,"22130",10146,6505,6436,57,69,"PUM+J",11
28,"28108",3736,2681,2652,21,29,"PUM+J",3
9,"9314",90,75,75,2,0,"PUM+J",2
3,"3083",5479,3736,3674,39,62,"PUM+J",12
28,"28172",9915,7715,7652,60,63,"PUM+J",7
7,"7034",1074,796,779,9,17,"PUM+J",4
46,"46158",1047,771,763,7,8,"PUM+J",0
50,"50289",53,42,42,1,0,"PUM+J",0
2,"2086",2389,1567,1554,10,13,"PUM+J",2
42,"42027",72,48,47,1,1,"PUM+J",0
46,"46136",2598,1875,1851,14,24,"PUM+J",0
12,"12020",118,104,103,1,1,"PUM+J",0
9,"9315",384,245,242,3,3,"PUM+J",1
45,"45020",1240,905,900,5,5,"PUM+J",0
19,"19031",8,8,8,0,0,"PUM+J",0
37,"37107",10444,6997,6884,76,113,"PUM+J",13
28,"28004",6618,4502,4457,28,45,"PUM+J",3
29,"29015",32093,22044,21716,253,328,"PUM+J",24
10,"10114",964,644,637,6,7,"PUM+J",0
37,"37294",11750,8395,8280,88,115,"PUM+J",12
34,"34133",101,75,73,0,2,"PUM+J",0
21,"21021",12545,7816,7696,104,120,"PUM+J",11
37,"37004",25,18,18,0,0,"PUM+J",0
10,"10196",294,208,206,3,2,"PUM+J",0
45,"45022",395,292,292,2,0,"PUM+J",0
6,"6032",80,68,68,1,0,"PUM+J",0
30,"30037",19407,13252,13120,99,132,"PUM+J",8
16,"16250",67,52,52,1,0,"PUM+J",0
24,"24086",258,197,196,1,1,"PUM+J",0
49,"49261",1504,1044,1026,7,18,"PUM+J",1
5,"5067",73,56,54,0,2,"PUM+J",0
9,"9154",123,90,90,7,0,"PUM+J",0
24,"24121",599,422,418,3,4,"PUM+J",0
12,"12050",1226,904,891,3,13,"PUM+J",1
50,"50065",56,37,37,0,0,"PUM+J",0
45,"45169",179,114,111,1,3,"PUM+J",0
46,"46023",322,254,252,1,2,"PUM+J",0
47,"47205",355,248,244,2,4,"PUM+J",3
19,"19064",64,56,56,0,0,"PUM+J",0
24,"24087",582,431,427,3,4,"PUM+J",0
21,"21022",187,121,116,0,5,"PUM+J",0
37,"37297",394,298,297,0,1,"PUM+J",0
41,"41055",14791,10197,10000,125,197,"PUM+J",11
10,"10198",1053,897,889,4,8,"PUM+J",1
47,"47206",79,66,66,0,0,"PUM+J",0
22,"22099",490,349,343,2,6,"PUM+J",0
28,"28175",940,740,730,2,10,"PUM+J",2
9,"9103",200,168,166,1,2,"PUM+J",0
37,"37007",391,289,281,7,8,"PUM+J",0
9,"9903",3112,2087,2058,24,29,"PUM+J",6
24,"24088",996,750,745,9,5,"PUM+J",2
28,"28067",4416,3359,3311,18,48,"PUM+J",4
19,"19066",51,42,42,0,0,"PUM+J",0
6,"6081",1036,760,745,2,15,"PUM+J",1
6,"6127",2809,2105,2074,9,31,"PUM+J",0
23,"23050",90664,65260,64519,581,741,"PUM+J",107
22,"22004",123,83,83,0,0,"PUM+J",0
37,"37073",613,448,440,4,8,"PUM+J",1
38,"38008",5699,3719,3669,26,50,"PUM+J",1
46,"46162",1168,839,832,3,7,"PUM+J",0
16,"16010",134,92,88,0,4,"PUM+J",0
40,"40014",56,39,38,0,1,"PUM+J",0
16,"16254",199,159,159,0,0,"PUM+J",0
16,"16124",1807,1367,1347,14,20,"PUM+J",0
22,"22037",112,87,87,2,0,"PUM+J",0
47,"47018",36,31,31,0,0,"PUM+J",1
10,"10120",153,97,97,0,0,"PUM+J",0
40,"40015",23,19,19,0,0,"PUM+J",0
3,"3004",603,425,423,2,2,"PUM+J",1
6,"6083",46577,31113,30748,338,365,"PUM+J",169
9,"9905",373,239,238,2,1,"PUM+J",1
12,"12129",1783,1207,1184,16,23,"PUM+J",0
5,"5136",83,55,55,0,0,"PUM+J",0
37,"37300",540,355,352,7,3,"PUM+J",0
16,"16255",132,99,99,0,0,"PUM+J",0
5,"5138",283,218,217,1,1,"PUM+J",0
49,"49042",229,166,164,2,2,"PUM+J",0
7,"7041",2090,1454,1434,17,20,"PUM+J",0
5,"5040",64,47,46,0,1,"PUM+J",0
37,"37301",84,64,64,1,0,"PUM+J",0
4,"4038",3105,2020,1984,17,36,"PUM+J",0
37,"37009",197,145,144,1,1,"PUM+J",0
50,"50270",38,26,25,0,1,"PUM+J",0
33,"33052",681,418,416,3,2,"PUM+J",1
46,"46258",2617,1925,1914,5,11,"PUM+J",0
9,"9010",33,25,25,2,0,"PUM+J",0
14,"14006",1319,1088,1057,8,31,"PUM+J",1
19,"19202",16,13,13,1,0,"PUM+J",0
42,"42124",56,27,27,0,0,"PUM+J",0
5,"5235",141,97,97,2,0,"PUM+J",0
29,"29095",3285,2313,2224,39,89,"PUM+J",2
44,"44023",18,15,14,0,1,"PUM+J",0
16,"16128",50,38,38,0,0,"PUM+J",0
21,"21027",49,32,32,0,0,"PUM+J",0
19,"19173",47,40,40,0,0,"PUM+J",0
10,"10123",575,450,438,1,12,"PUM+J",0
42,"42173",29860,19581,19206,337,375,"PUM+J",44
22,"22141",115,94,93,0,1,"PUM+J",0
9,"9011",70,42,40,0,2,"PUM+J",0
23,"23091",675,516,512,1,4,"PUM+J",0
50,"50172",174,125,123,2,2,"PUM+J",0
45,"45176",3859,2694,2662,24,32,"PUM+J",6
47,"47211",48,37,37,1,0,"PUM+J",0
3,"3007",173,141,139,0,2,"PUM+J",0
44,"44024",31,26,25,0,1,"PUM+J",0
14,"14007",15016,10248,10043,99,205,"PUM+J",6
38,"38011",21655,13974,13831,106,143,"PUM+J",9
44,"44116",75,58,58,0,0,"PUM+J",0
12,"12056",257,205,199,1,6,"PUM+J",0
46,"46096",263,204,202,0,2,"PUM+J",0
6,"6089",610,470,463,2,7,"PUM+J",0
11,"11017",3198,2054,2004,37,50,"PUM+J",1
46,"46097",948,670,663,1,7,"PUM+J",0
26,"26088",39,35,34,0,1,"PUM+J",1
47,"47022",59,52,48,1,4,"PUM+J",0
10,"10003",543,350,335,0,15,"PUM+J",0
39,"39035",9142,6574,6517,24,57,"PUM+J",4
46,"46165",7349,5460,5412,39,48,"PUM+J",1
42,"42038",33,22,22,1,0,"PUM+J",0
14,"14008",2758,1880,1836,21,44,"PUM+J",3
19,"19175",29,18,17,1,1,"PUM+J",0
29,"29098",1228,902,876,11,26,"PUM+J",0
34,"34147",164,120,120,1,0,"PUM+J",0
18,"18088",1526,1000,993,10,7,"PUM+J",0
19,"19040",53,43,42,1,1,"PUM+J",0
9,"9440",80,61,61,0,0,"PUM+J",0
44,"44232",364,255,255,3,0,"PUM+J",0
34,"34149",23,20,20,0,0,"PUM+J",0
6,"6136",1489,1086,1060,11,26,"PUM+J",3
22,"22043",93,53,53,0,0,"PUM+J",0
14,"14009",2653,1658,1631,24,27,"PUM+J",1
5,"5239",215,163,163,3,0,"PUM+J",0
3,"3094",9795,6528,6481,37,47,"PUM+J",5
49,"49158",206,159,155,0,4,"PUM+J",0
44,"44026",100,73,72,0,1,"PUM+J",0
45,"45032",445,290,286,2,4,"PUM+J",0
37,"37118",117,86,86,3,0,"PUM+J",0
4,"4047",2224,1649,1627,13,22,"PUM+J",0
34,"34011",379,290,284,2,6,"PUM+J",0
24,"24209",2597,1651,1636,12,15,"PUM+J",0
9,"9016",85,54,54,0,0,"PUM+J",0
34,"34151",148,98,96,1,2,"PUM+J",0
50,"50072",183,131,129,0,2,"PUM+J",0
18,"18187",510,350,350,2,0,"PUM+J",0
46,"46235",21229,15171,15011,126,160,"PUM+J",10
44,"44054",95,82,81,0,1,"PUM+J",0
16,"16133",4399,3317,3256,34,61,"PUM+J",4
39,"39094",840,611,611,2,0,"PUM+J",0
10,"10047",938,710,694,1,16,"PUM+J",2
6,"6002",4313,2914,2804,37,110,"PUM+J",10
42,"42043",3816,2602,2540,23,62,"PUM+J",3
29,"29100",2379,1582,1551,22,31,"PUM+J",3
46,"46236",929,723,716,2,7,"PUM+J",0
47,"47215",48,43,43,0,0,"PUM+J",0
22,"22254",1084,744,735,10,9,"PUM+J",1
49,"49052",183,120,117,2,3,"PUM+J",1
41,"41064",5602,3520,3417,56,103,"PUM+J",0
46,"46031",10574,7233,7158,58,75,"PUM+J",6
6,"6094",1457,868,858,5,10,"PUM+J",0
39,"39095",2266,1637,1619,8,18,"PUM+J",1
42,"42006",154,105,103,0,2,"PUM+J",1
5,"5242",679,571,562,9,9,"PUM+J",0
35,"35001",4566,3148,3105,18,43,"PUM+J",0
19,"19008",36,30,30,0,0,"PUM+J",2
2,"2034",1323,1024,1018,6,6,"PUM+J",0
40,"40185",800,560,553,4,7,"PUM+J",0
45,"45146",101,79,79,0,0,"PUM+J",0
40,"40022",195,144,141,2,3,"PUM+J",0
22,"22150",459,325,321,8,4,"PUM+J",0
7,"7049",1479,935,918,5,17,"PUM+J",3
16,"16135",115,76,76,0,0,"PUM+J",0
29,"29027",2325,1543,1516,13,27,"PUM+J",0
23,"23098",847,704,700,0,4,"PUM+J",1
22,"22902",206,147,144,1,3,"PUM+J",0
46,"46123",1926,1392,1368,11,24,"PUM+J",1
29,"29028",1215,803,779,9,24,"PUM+J",2
3,"3068",41,38,37,0,1,"PUM+J",0
9,"9176",58,46,45,2,1,"PUM+J",0
22,"22047",248,202,201,1,1,"PUM+J",0
45,"45147",592,449,443,2,6,"PUM+J",0
24,"24100",737,506,502,9,4,"PUM+J",1
37,"37372",133,99,98,0,1,"PUM+J",0
22,"22113",478,335,333,6,2,"PUM+J",0
12,"12137",40,28,28,0,0,"PUM+J",0
47,"47217",1984,1460,1437,11,23,"PUM+J",4
47,"47123",461,360,358,2,2,"PUM+J",0
10,"10133",1159,914,893,4,21,"PUM+J",0
18,"18192",1462,1125,1103,3,22,"PUM+J",0
16,"16023",513,367,367,3,0,"PUM+J",2
47,"47029",50,37,35,1,2,"PUM+J",0
22,"22903",618,484,482,5,2,"PUM+J",0
3,"3098",523,382,378,1,4,"PUM+J",0
49,"49165",55,52,52,1,0,"PUM+J",0
37,"37373",692,451,442,4,9,"PUM+J",0
3,"3069",3329,2102,2077,11,25,"PUM+J",1
5,"5244",39,29,29,0,0,"PUM+J",0
49,"49056",285,191,190,3,1,"PUM+J",0
5,"5213",94,72,70,0,2,"PUM+J",0
19,"19151",1077,703,693,8,10,"PUM+J",1
47,"47219",39,31,28,1,3,"PUM+J",0
50,"50076",70,56,56,0,0,"PUM+J",0
40,"40125",76,48,46,0,2,"PUM+J",0
44,"44123",95,68,68,0,0,"PUM+J",0
12,"12063",41,31,31,1,0,"PUM+J",0
24,"24214",626,438,433,8,5,"PUM+J",0
29,"29904",418,328,322,1,6,"PUM+J",0
38,"38018",4466,2867,2821,21,46,"PUM+J",1
37,"37312",244,191,189,1,2,"PUM+J",0
10,"10013",265,184,182,0,2,"PUM+J",0
9,"9180",132,94,91,1,3,"PUM+J",0
29,"29031",1555,1015,986,6,29,"PUM+J",1
5,"5246",48,35,35,0,0,"PUM+J",0
37,"37218",51,25,23,0,2,"PUM+J",0
16,"16141",131,98,96,1,2,"PUM+J",0
47,"47031",191,141,140,0,1,"PUM+J",0
9,"9026",377,288,288,1,0,"PUM+J",0
4,"4087",157,115,113,0,2,"PUM+J",1
42,"42188",46,35,35,1,0,"PUM+J",0
5,"5152",644,498,496,3,2,"PUM+J",0
37,"37125",231,154,148,1,6,"PUM+J",0
47,"47220",151,106,105,1,1,"PUM+J",0
45,"45152",545,402,393,1,9,"PUM+J",1
18,"18003",14454,10162,9935,105,227,"PUM+J",8
26,"26101",31,18,17,0,1,"PUM+J",0
6,"6103",4756,3285,3224,38,61,"PUM+J",17
37,"37281",39,28,27,0,1,"PUM+J",0
45,"45116",666,492,489,4,3,"PUM+J",0
44,"44097",126,76,73,0,3,"PUM+J",0
16,"16027",691,500,495,1,5,"PUM+J",0
46,"46013",17761,13652,13548,144,104,"PUM+J",7
40,"40128",123,88,87,1,1,"PUM+J",0
26,"26102",6076,4276,4205,52,71,"PUM+J",7
6,"6104",648,470,459,2,11,"PUM+J",1
46,"46241",388,288,283,5,5,"PUM+J",1
47,"47033",205,151,150,2,1,"PUM+J",0
13,"13039",14195,10104,9933,122,171,"PUM+J",13
38,"38020",16057,9921,9809,66,112,"PUM+J",9
40,"40030",419,317,314,3,3,"PUM+J",0
19,"19185",26,15,15,1,0,"PUM+J",0
50,"50131",212,152,147,4,5,"PUM+J",0
16,"16104",53,42,42,0,0,"PUM+J",0
47,"47095",41,29,28,0,1,"PUM+J",0
7,"7057",7471,4430,4392,41,38,"PUM+J",4
5,"5154",31,23,23,0,0,"PUM+J",1
42,"42191",183,116,114,5,2,"PUM+J",0
46,"46173",1309,1029,1010,13,19,"PUM+J",0
46,"46014",3156,2324,2294,13,30,"PUM+J",1
47,"47003",206,167,166,5,1,"PUM+J",0
16,"16106",2701,2029,2001,6,28,"PUM+J",0
9,"9353",74,56,54,1,2,"PUM+J",0
10,"10100",783,494,447,5,47,"PUM+J",1
46,"46128",1569,1216,1179,7,37,"PUM+J",2
6,"6152",1273,888,867,7,21,"PUM+J",1
37,"37316",711,546,541,7,5,"PUM+J",0
49,"49207",215,144,143,1,1,"PUM+J",0
34,"34167",110,84,83,0,1,"PUM+J",0
46,"46038",302,221,220,1,1,"PUM+J",0
46,"46243",124,93,90,1,3,"PUM+J",0
22,"22053",783,494,492,6,2,"PUM+J",2
29,"29080",6940,4676,4617,36,59,"PUM+J",3
6,"6061",1074,829,819,5,10,"PUM+J",1
39,"39019",2232,1628,1603,10,25,"PUM+J",1
37,"37284",317,229,222,2,7,"PUM+J",0
11,"11030",22999,14858,14586,207,272,"PUM+J",16
42,"42055",158,113,113,1,0,"PUM+J",0
5,"5156",242,145,145,1,0,"PUM+J",0
49,"49172",474,278,271,1,7,"PUM+J",0
19,"19188",36,31,31,0,0,"PUM+J",0
21,"21042",15610,8112,8011,164,101,"PUM+J",12
12,"12069",50,38,38,0,0,"PUM+J",0
29,"29035",1478,1054,1040,3,14,"PUM+J",0
9,"9355",85,67,67,1,0,"PUM+J",0
16,"16032",284,220,220,1,0,"PUM+J",0
49,"49249",61,45,45,1,0,"PUM+J",0
9,"9463",246,174,174,4,0,"PUM+J",1
41,"41073",1684,1100,1074,7,26,"PUM+J",4
10,"10021",4987,3574,3475,31,99,"PUM+J",5
46,"46175",429,362,355,3,7,"PUM+J",0
34,"34031",26,26,26,1,0,"PUM+J",0
39,"39048",1772,1311,1295,8,16,"PUM+J",0
23,"23001",912,723,712,2,11,"PUM+J",2
33,"33011",10563,5646,5578,92,68,"PUM+J",3
49,"49065",1048,747,725,6,22,"PUM+J",2
12,"12070",505,407,398,2,9,"PUM+J",0
46,"46108",420,328,324,1,4,"PUM+J",0
28,"28132",12197,8622,8537,75,85,"PUM+J",10
46,"46176",2077,1362,1348,14,14,"PUM+J",3
44,"44010",185,144,143,0,1,"PUM+J",0
44,"44217",32,25,25,0,0,"PUM+J",0
38,"38023",126137,79423,78706,605,717,"PUM+J",66
5,"5092",145,111,107,1,4,"PUM+J",0
45,"45159",83,71,69,0,2,"PUM+J",0
28,"28101",226,174,172,1,2,"PUM+J",0
42,"42154",103,76,76,1,0,"PUM+J",0
16,"16034",155,116,113,0,3,"PUM+J",0
41,"41075",10320,7159,6972,88,187,"PUM+J",3
3,"3022",140,125,121,1,4,"PUM+J",0
42,"42059",20,14,14,0,0,"PUM+J",0
50,"50033",61,44,44,1,0,"PUM+J",0
37,"37257",51,36,36,1,0,"PUM+J",0
3,"3107",2785,1766,1746,13,20,"PUM+J",0
50,"50236",95,77,75,0,2,"PUM+J",0
6,"6113",2649,1889,1862,16,27,"PUM+J",2
18,"18907",1762,1358,1351,4,7,"PUM+J",1
10,"10147",1277,873,837,6,36,"PUM+J",2
4,"4026",57,38,37,0,1,"PUM+J",0
47,"47134",150,120,116,2,4,"PUM+J",0
40,"40035",135,110,110,2,0,"PUM+J",0
41,"41076",2134,1246,1230,11,16,"PUM+J",0
5,"5060",108,79,79,2,0,"PUM+J",0
37,"37029",186,125,124,1,1,"PUM+J",0
40,"40036",496,395,380,8,15,"PUM+J",0
33,"33013",430,294,292,1,2,"PUM+J",0
16,"16001",62,45,45,0,0,"PUM+J",0
6,"6160",3005,2083,2056,9,27,"PUM+J",3
50,"50211",236,174,173,0,1,"PUM+J",0
22,"22058",193,141,141,0,0,"PUM+J",0
16,"16152",32,26,26,3,0,"PUM+J",0
50,"50010",67,52,52,1,0,"PUM+J",0
16,"16904",453,348,345,11,3,"PUM+J",2
10,"10026",647,464,452,6,12,"PUM+J",0
40,"40037",30,17,17,0,0,"PUM+J",0
5,"5258",107,80,80,1,0,"PUM+J",0
19,"19284",10,10,10,0,0,"PUM+J",0
2,"2016",528,353,352,4,1,"PUM+J",0
49,"49177",255,145,144,1,1,"PUM+J",1
49,"49107",115,70,70,0,0,"PUM+J",0
41,"41077",8631,5788,5598,51,190,"PUM+J",6
24,"24008",8931,6291,6214,79,77,"PUM+J",15
16,"16905",1302,951,934,10,17,"PUM+J",1
46,"46110",21364,15132,15019,120,113,"PUM+J",8
40,"40105",43,35,35,0,0,"PUM+J",0
46,"46247",972,649,646,3,3,"PUM+J",0
19,"19193",22,21,21,1,0,"PUM+J",0
44,"44133",15,12,12,0,0,"PUM+J",0
2,"2017",760,498,493,1,5,"PUM+J",0
28,"28061",22757,17091,16965,115,126,"PUM+J",10
26,"26112",218,152,148,1,4,"PUM+J",0
9,"9043",172,112,111,1,1,"PUM+J",1
45,"45054",3798,2612,2587,10,25,"PUM+J",2
44,"44221",386,307,304,1,3,"PUM+J",0
10,"10151",189,145,142,2,3,"PUM+J",0
24,"24009",274,136,135,1,1,"PUM+J",0
26,"26001",199,145,141,3,4,"PUM+J",0
46,"46111",11367,7995,7908,66,87,"PUM+J",6
49,"49071",716,432,429,6,3,"PUM+J",0
18,"18108",822,604,599,2,5,"PUM+J",1
34,"34038",259,183,178,0,5,"PUM+J",0
46,"46112",533,435,432,7,3,"PUM+J",1
50,"50062",1885,1332,1308,15,24,"PUM+J",2
34,"34231",211,157,153,3,4,"PUM+J",0
34,"34130",195,154,153,5,1,"PUM+J",1
45,"45018",550,385,380,1,5,"PUM+J",1
40,"40901",413,320,315,7,5,"PUM+J",1
16,"16155",490,389,388,7,1,"PUM+J",0
37,"37232",377,303,303,2,0,"PUM+J",0
19,"19194",91,69,69,0,0,"PUM+J",0
47,"47043",306,241,240,4,1,"PUM+J",0
19,"19195",36,26,25,2,1,"PUM+J",0
16,"16156",84,64,64,0,0,"PUM+J",0
45,"45056",2341,1315,1295,11,20,"PUM+J",4
46,"46249",9136,6538,6439,73,99,"PUM+J",2
19,"19060",157,123,122,0,1,"PUM+J",0
45,"45057",224,177,173,0,4,"PUM+J",0
26,"26117",2105,1537,1500,17,37,"PUM+J",0
14,"14027",7890,5841,5726,78,115,"PUM+J",9
50,"50240",943,693,683,12,10,"PUM+J",0
18,"18109",597,430,422,5,8,"PUM+J",0
28,"28034",368,258,255,0,3,"PUM+J",0
11,"11008",17923,11702,11464,192,238,"PUM+J",6
22,"22062",154,107,107,1,0,"PUM+J",0
44,"44044",82,65,65,2,0,"PUM+J",0
45,"45131",259,219,216,1,3,"PUM+J",1
9,"9047",52,42,41,1,1,"PUM+J",0
5,"5035",92,68,68,0,0,"PUM+J",0
37,"37139",189,150,148,1,2,"PUM+J",1
19,"19196",89,70,67,1,3,"PUM+J",0
44,"44137",187,139,139,0,0,"PUM+J",0
13,"13011",4439,2762,2694,16,68,"PUM+J",7
47,"47045",732,558,549,3,9,"PUM+J",0
6,"6123",4502,2989,2894,29,95,"PUM+J",9
37,"37234",314,194,192,3,2,"PUM+J",0
11,"11039",9957,6134,6043,152,91,"PUM+J",9
28,"28143",77,58,58,0,0,"PUM+J",0
47,"47204",235,159,157,3,2,"PUM+J",0
5,"5133",61,44,43,0,1,"PUM+J",0
42,"42207",48,42,41,0,1,"PUM+J",0
12,"12077",4828,3395,3357,28,38,"PUM+J",4
45,"45168",62836,46917,46353,424,564,"PUM+J",118
29,"29016",253,196,194,0,2,"PUM+J",0
18,"18178",664,474,467,1,7,"PUM+J",1
39,"39001",2063,1474,1467,5,7,"PUM+J",0
46,"46114",552,417,412,6,5,"PUM+J",0
18,"18146",930,645,629,10,16,"PUM+J",0
29,"29091",9490,6428,6304,61,124,"PUM+J",3
37,"37140",630,395,393,0,2,"PUM+J",0
6,"6125",1644,1251,1222,7,29,"PUM+J",1
13,"13014",472,361,352,4,9,"PUM+J",0
9,"9211",1369,938,921,14,17,"PUM+J",0
10,"10157",246,163,161,0,2,"PUM+J",0
23,"23012",4004,2726,2689,21,37,"PUM+J",2
46,"46183",6036,4276,4213,21,63,"PUM+J",4
42,"42166",55,38,37,0,1,"PUM+J",0
2,"2023",504,419,412,0,7,"PUM+J",1
34,"34136",143,89,89,1,0,"PUM+J",0
40,"40013",57,47,47,0,0,"PUM+J",0
28,"28112",160,129,129,0,0,"PUM+J",0
9,"9378",31,20,19,0,1,"PUM+J",0
5,"5168",3503,2536,2511,29,25,"PUM+J",3
10,"10158",344,247,246,7,1,"PUM+J",0
44,"44258",53,46,46,0,0,"PUM+J",0
29,"29046",2494,1727,1693,13,34,"PUM+J",2
4,"4072",311,212,211,0,1,"PUM+J",0
38,"38032",13579,8941,8880,92,61,"PUM+J",6
37,"37331",186,115,114,2,1,"PUM+J",0
13,"13015",5220,3665,3629,25,36,"PUM+J",1
3,"3003",449,368,367,1,1,"PUM+J",0
10,"10037",76966,54717,53914,546,803,"PUM+J",98
18,"18020",489,318,310,2,8,"PUM+J",1
19,"19199",19,15,15,0,0,"PUM+J",0
3,"3117",377,306,302,2,4,"PUM+J",0
22,"22067",70,52,52,0,0,"PUM+J",0
3,"3031",42046,25035,24819,168,216,"PUM+J",17
23,"23015",1316,979,973,18,6,"PUM+J",0
42,"42212",57,45,45,2,0,"PUM+J",0
3,"3032",97,82,82,0,0,"PUM+J",0
18,"18021",17929,12165,11949,139,216,"PUM+J",21
49,"49082",341,273,270,12,3,"PUM+J",0
4,"4074",2910,1813,1789,15,24,"PUM+J",1
9,"9216",370,245,241,3,4,"PUM+J",0
38,"38033",3593,2277,2242,15,35,"PUM+J",1
10,"10038",83,59,59,0,0,"PUM+J",0
19,"19200",66,53,52,0,1,"PUM+J",0
23,"23016",386,313,305,4,8,"PUM+J",0
41,"41002",1421,938,911,7,27,"PUM+J",0
9,"9217",342,240,237,1,3,"PUM+J",0
28,"28147",991,702,698,4,4,"PUM+J",0
44,"44049",784,539,532,3,7,"PUM+J",0
5,"5267",103,67,67,1,0,"PUM+J",0
42,"42213",25,17,16,1,1,"PUM+J",0
10,"10162",519,401,394,4,7,"PUM+J",1
22,"22139",80,57,57,1,0,"PUM+J",0
50,"50294",65,45,45,0,0,"PUM+J",0
26,"26165",336,248,242,3,6,"PUM+J",0
45,"45102",3613,2495,2464,27,31,"PUM+J",4
13,"13020",4701,3114,3069,42,45,"PUM+J",6
6,"6040",993,679,668,3,11,"PUM+J",0
18,"18182",1926,1222,1204,8,18,"PUM+J",1
47,"47050",3908,2713,2673,39,40,"PUM+J",2
45,"45065",264,211,206,1,5,"PUM+J",0
28,"28148",89174,65500,64784,566,716,"PUM+J",66
26,"26012",37,28,28,1,0,"PUM+J",0
50,"50093",87,66,64,1,2,"PUM+J",0
19,"19108",95,78,78,0,0,"PUM+J",0
16,"16165",56,45,45,0,0,"PUM+J",0
39,"39062",1864,1395,1376,3,19,"PUM+J",1
6,"6132",823,543,533,4,10,"PUM+J",1
13,"13021",412,325,320,1,5,"PUM+J",0
9,"9219",27097,17874,17629,192,245,"PUM+J",45
12,"12027",17506,11776,11649,84,127,"PUM+J",4
44,"44203",9,9,9,0,0,"PUM+J",0
23,"23018",2243,1606,1584,17,22,"PUM+J",0
16,"16050",218,172,169,2,3,"PUM+J",0
37,"37146",106,82,76,0,6,"PUM+J",0
28,"28149",6298,4751,4699,35,52,"PUM+J",4
38,"38035",10518,5870,5819,37,51,"PUM+J",1
26,"26013",330,243,242,2,1,"PUM+J",1
50,"50094",1500,1041,1022,12,19,"PUM+J",0
2,"2029",3333,2363,2320,13,43,"PUM+J",0
40,"40149",479,345,338,3,7,"PUM+J",1
47,"47148",419,332,324,3,8,"PUM+J",1
19,"19003",36,30,30,0,0,"PUM+J",0
22,"22072",197,127,126,1,1,"PUM+J",1
34,"34201",171,131,130,1,1,"PUM+J",0
21,"21059",221,169,163,1,6,"PUM+J",0
40,"40150",60,42,42,0,0,"PUM+J",0
37,"37242",82,59,59,1,0,"PUM+J",0
4,"4078",1127,725,718,8,7,"PUM+J",0
16,"16052",539,422,419,3,3,"PUM+J",2
29,"29052",213,129,128,0,1,"PUM+J",2
42,"42218",68,44,43,0,1,"PUM+J",0
9,"9223",42,36,36,0,0,"PUM+J",0
16,"16169",49,28,28,0,0,"PUM+J",0
34,"34055",254,185,184,3,1,"PUM+J",2
4,"4079",54675,35691,35365,328,326,"PUM+J",52
49,"49193",428,261,253,3,8,"PUM+J",0
28,"28151",3274,2344,2310,16,34,"PUM+J",3
2,"2064",371,288,283,2,5,"PUM+J",0
38,"38037",12817,7582,7494,55,88,"PUM+J",2
28,"28152",16986,13444,13366,111,78,"PUM+J",15
37,"37337",137,104,103,0,1,"PUM+J",0
50,"50248",501,344,328,3,16,"PUM+J",0
14,"14037",3161,2233,2158,22,75,"PUM+J",2
45,"45070",1412,1158,1136,7,22,"PUM+J",0
44,"44053",103,87,85,1,2,"PUM+J",1
19,"19005",91,63,62,0,1,"PUM+J",0
29,"29053",1717,1133,1116,12,17,"PUM+J",0
19,"19299",100,72,71,1,1,"PUM+J",0
9,"9391",347,247,246,2,1,"PUM+J",0
13,"13026",413,333,331,2,2,"PUM+J",0
40,"40053",79,56,56,1,0,"PUM+J",0
28,"28075",6020,4521,4469,37,52,"PUM+J",3
45,"45181",2330,1693,1661,10,32,"PUM+J",2
13,"13073",501,392,385,2,7,"PUM+J",0
45,"45071",1779,1374,1342,7,32,"PUM+J",0
18,"18122",15994,11009,10773,109,236,"PUM+J",10
22,"22111",143,96,95,2,1,"PUM+J",0
44,"44177",101,68,68,1,0,"PUM+J",0
42,"42085",179,107,106,2,1,"PUM+J",0
9,"9394",668,432,429,6,3,"PUM+J",1
50,"50023",199,145,143,2,2,"PUM+J",0
19,"19112",53,35,34,0,1,"PUM+J",0
5,"5080",42,30,30,0,0,"PUM+J",0
16,"16172",325,233,228,1,5,"PUM+J",0
29,"29054",42538,28080,27814,225,266,"PUM+J",30
44,"44149",99,74,73,4,1,"PUM+J",0
28,"28078",40,38,38,0,0,"PUM+J",0
16,"16269",378,287,285,2,2,"PUM+J",0
47,"47121",517,410,398,2,12,"PUM+J",0
33,"33002",9403,5920,5839,69,81,"PUM+J",4
49,"49275",51064,34471,34017,475,454,"PUM+J",61
50,"50125",340,230,229,2,1,"PUM+J",0
21,"21003",684,476,452,4,24,"PUM+J",0
2,"2001",687,513,505,1,8,"PUM+J",0
40,"40055",31,26,26,0,0,"PUM+J",0
16,"16173",175,128,127,0,1,"PUM+J",0
50,"50177",288,196,193,0,3,"PUM+J",0
49,"49199",236,159,157,3,2,"PUM+J",0
50,"50201",449,345,344,4,1,"PUM+J",0
10,"10171",347,238,219,1,19,"PUM+J",1
34,"34208",48,40,40,1,0,"PUM+J",0
44,"44056",446,327,325,1,2,"PUM+J",0
41,"41009",1148,750,732,5,18,"PUM+J",0
13,"13076",455,359,356,0,3,"PUM+J",2
16,"16174",166,130,129,2,1,"PUM+J",0
50,"50074",6156,4100,4022,33,78,"PUM+J",4
40,"40156",272,194,190,4,4,"PUM+J",0
23,"23027",711,547,539,5,8,"PUM+J",0
6,"6142",257,203,194,1,9,"PUM+J",0
49,"49201",283,232,228,3,4,"PUM+J",0
46,"46169",32403,23890,23698,222,192,"PUM+J",11
19,"19270",14,13,13,0,0,"PUM+J",0
45,"45001",1846,1213,1181,10,32,"PUM+J",5
4,"4084",337,238,232,0,6,"PUM+J",2
50,"50025",4541,3110,3083,39,27,"PUM+J",1
19,"19303",41,32,32,0,0,"PUM+J",0
49,"49094",210,111,111,0,0,"PUM+J",0
24,"24139",2071,1371,1346,15,25,"PUM+J",2
6,"6007",1418,984,968,13,16,"PUM+J",0
10,"10174",171,112,110,0,2,"PUM+J",0
30,"30023",3874,2831,2788,18,43,"PUM+J",2
47,"47155",3454,2445,2405,26,40,"PUM+J",3
44,"44152",70,46,46,0,0,"PUM+J",0
44,"44059",562,411,407,2,4,"PUM+J",0
5,"5083",137,92,91,0,1,"PUM+J",1
10,"10052",172,114,113,3,1,"PUM+J",0
22,"22155",66,52,52,0,0,"PUM+J",0
10,"10012",553,427,421,1,6,"PUM+J",0
46,"46193",8959,6880,6824,66,56,"PUM+J",3
6,"6145",900,683,669,7,14,"PUM+J",0
42,"42090",83,65,64,1,1,"PUM+J",0
45,"45187",3967,3133,3074,16,59,"PUM+J",4
49,"49095",282,202,201,6,1,"PUM+J",0
46,"46125",852,660,650,5,10,"PUM+J",0
23,"23030",1207,998,977,7,21,"PUM+J",0
19,"19214",74,51,51,0,0,"PUM+J",0
21,"21067",406,274,271,3,3,"PUM+J",1
37,"37156",4261,2928,2869,23,59,"PUM+J",5
5,"5084",66,44,44,0,0,"PUM+J",0
40,"40158",15,11,11,0,0,"PUM+J",0
29,"29058",1542,994,979,5,15,"PUM+J",1
38,"38042",3778,2410,2386,11,24,"PUM+J",39
6,"6101",437,355,346,1,9,"PUM+J",0
50,"50003",117,89,89,1,0,"PUM+J",0
13,"13082",25917,16834,16670,137,164,"PUM+J",28
10,"10014",1816,1285,1254,13,31,"PUM+J",1
46,"46194",15852,11124,11009,86,115,"PUM+J",5
45,"45189",633,462,459,7,3,"PUM+J",1
44,"44061",77,60,58,1,2,"PUM+J",0
44,"44239",21,19,19,0,0,"PUM+J",0
34,"34215",161,126,125,6,1,"PUM+J",0
19,"19118",11,10,9,0,1,"PUM+J",0
34,"34068",29,25,24,0,1,"PUM+J",0
5,"5153",86,58,56,3,2,"PUM+J",0
34,"34160",133,107,106,0,1,"PUM+J",0
21,"21038",1082,688,676,4,12,"PUM+J",1
10,"10178",724,499,494,3,5,"PUM+J",2
45,"45190",462,361,353,3,8,"PUM+J",2
3,"3131",176,129,126,1,3,"PUM+J",1
24,"24144",621,419,412,4,7,"PUM+J",0
5,"5183",123,103,100,0,3,"PUM+J",0
10,"10179",272,209,209,2,0,"PUM+J",1
46,"46127",2748,2035,2009,6,26,"PUM+J",1
47,"47002",18,18,18,0,0,"PUM+J",0
9,"9075",104,82,82,0,0,"PUM+J",0
29,"29061",1043,803,773,9,30,"PUM+J",0
12,"12092",123,95,95,0,0,"PUM+J",0
47,"47159",825,672,661,0,11,"PUM+J",0
18,"18035",1179,882,870,7,12,"PUM+J",0
34,"34217",1269,999,983,14,16,"PUM+J",2
12,"12010",232,191,187,3,4,"PUM+J",1
37,"37315",89,65,64,0,1,"PUM+J",0
37,"37283",116,83,83,0,0,"PUM+J",0
26,"26143",260,197,192,1,5,"PUM+J",0
44,"44127",57,43,43,0,0,"PUM+J",0
30,"30003",25200,16249,16120,159,129,"PUM+J",2
37,"37127",205,139,139,1,0,"PUM+J",0
50,"50256",70,43,43,0,0,"PUM+J",0
9,"9030",116,81,81,1,0,"PUM+J",1
19,"19246",42,27,27,1,0,"PUM+J",0
2,"2075",1700,1357,1347,6,10,"PUM+J",1
38,"38045",3542,1825,1801,7,24,"PUM+J",1
29,"29006",679,461,452,4,9,"PUM+J",1
16,"16187",55,38,38,3,0,"PUM+J",0
26,"26065",63,46,43,0,3,"PUM+J",0
47,"47096",127,94,93,1,1,"PUM+J",0
24,"24107",206,147,147,1,0,"PUM+J",0
44,"44215",167,113,113,2,0,"PUM+J",0
21,"21041",113074,73295,72313,1063,982,"PUM+J",140
12,"12118",78,64,63,0,1,"PUM+J",0
45,"45047",2694,1733,1706,24,27,"PUM+J",2
9,"9134",217,142,138,1,4,"PUM+J",0
6,"6153",20252,14183,13924,154,259,"PUM+J",32
44,"44065",55,33,32,0,1,"PUM+J",0
19,"19017",56,47,47,0,0,"PUM+J",0
13,"13043",205,163,162,1,1,"PUM+J",1
37,"37161",123,86,86,0,0,"PUM+J",0
16,"16189",264,196,194,4,2,"PUM+J",1
34,"34072",145,125,123,1,2,"PUM+J",0
26,"26145",239,194,187,3,7,"PUM+J",1
37,"37349",100,61,58,0,3,"PUM+J",1
39,"39076",3512,2517,2491,13,26,"PUM+J",2
40,"40033",70,55,52,1,3,"PUM+J",0
3,"3020",94,84,84,1,0,"PUM+J",0
6,"6018",727,483,476,0,7,"PUM+J",1
38,"38047",1755,1132,1110,9,22,"PUM+J",1
34,"34222",107,71,68,1,3,"PUM+J",0
34,"34073",180,123,120,3,3,"PUM+J",0
9,"9082",36,32,32,0,0,"PUM+J",0
41,"41091",539590,389351,384943,4676,4408,"PUM+J",645
44,"44158",1153,879,872,6,7,"PUM+J",1
19,"19018",142,112,112,1,0,"PUM+J",0
13,"13045",622,459,451,0,8,"PUM+J",2
6,"6156",1170,829,814,12,15,"PUM+J",0
2,"2045",3609,2797,2752,38,45,"PUM+J",7
24,"24150",226,163,162,0,1,"PUM+J",1
46,"46244",59910,42120,41826,338,294,"PUM+J",33
9,"9246",599,381,372,2,9,"PUM+J",0
39,"39077",237,151,148,1,3,"PUM+J",0
10,"10022",409,301,291,1,10,"PUM+J",0
34,"34224",39,25,25,0,0,"PUM+J",0
40,"40230",93,66,64,0,2,"PUM+J",0
39,"39049",304,198,195,2,3,"PUM+J",0
14,"14050",2350,1774,1720,20,54,"PUM+J",1
9,"9415",275,178,178,3,0,"PUM+J",0
16,"16072",132,84,84,1,0,"PUM+J",0
6,"6158",13367,9319,9131,90,188,"PUM+J",37
2,"2079",2807,2000,1978,17,22,"PUM+J",1
40,"40004",436,330,319,2,11,"PUM+J",0
13,"13047",5782,4232,4160,27,72,"PUM+J",3
26,"26148",154,125,122,3,3,"PUM+J",1
41,"41092",7681,5408,5299,79,109,"PUM+J",2
22,"22087",60,46,46,0,0,"PUM+J",0
10,"10186",951,756,735,6,21,"PUM+J",0
50,"50162",135,100,99,3,1,"PUM+J",0
24,"24040",416,293,292,2,1,"PUM+J",0
9,"9416",52,30,30,0,0,"PUM+J",0
24,"24152",433,269,267,4,2,"PUM+J",1
5,"5190",53,44,43,0,1,"PUM+J",0
21,"21076",2153,1459,1426,31,33,"PUM+J",3
49,"49105",135,94,94,2,0,"PUM+J",0
2,"2048",1173,912,901,9,11,"PUM+J",0
40,"40199",101,76,72,2,4,"PUM+J",0
39,"39023",6563,4788,4753,14,35,"PUM+J",2
10,"10148",33054,21731,21379,231,352,"PUM+J",46
50,"50110",340,248,238,1,10,"PUM+J",0
41,"41094",6496,4733,4628,47,105,"PUM+J",6
39,"39079",8850,6247,6175,28,72,"PUM+J",2
37,"37353",122,82,80,0,2,"PUM+J",0
3,"3051",342,288,286,4,2,"PUM+J",0
19,"19021",978,678,662,3,16,"PUM+J",2
34,"34080",5231,3207,3161,35,46,"PUM+J",6
37,"37063",58,47,47,0,0,"PUM+J",0
12,"12098",529,417,413,3,4,"PUM+J",0
23,"23042",292,219,219,0,0,"PUM+J",0
45,"45053",7820,5814,5712,56,102,"PUM+J",6
47,"47167",245,198,198,1,0,"PUM+J",0
50,"50035",74,57,57,0,0,"PUM+J",0
16,"16078",41384,28809,28500,322,309,"PUM+J",59
18,"18141",382,240,237,0,3,"PUM+J",0
13,"13050",475,348,345,1,3,"PUM+J",0
3,"3139",23126,14650,14522,127,128,"PUM+J",17
6,"6901",2125,1549,1520,28,29,"PUM+J",0
2,"2050",85,66,66,1,0,"PUM+J",0
41,"41095",40187,27090,26680,512,410,"PUM+J",35
16,"16195",458,343,338,0,5,"PUM+J",0
41,"41022",4255,2735,2667,32,68,"PUM+J",1
10,"10190",513,334,325,10,9,"PUM+J",1
39,"39081",440,330,327,1,3,"PUM+J",0
46,"46202",17801,13010,12906,87,104,"PUM+J",8
12,"12017",145,111,110,2,1,"PUM+J",0
26,"26152",27,20,20,1,0,"PUM+J",0
6,"6027",645,523,513,0,10,"PUM+J",0
18,"18143",945,661,651,2,10,"PUM+J",2
9,"9255",83,58,58,0,0,"PUM+J",0
18,"18044",161,91,91,0,0,"PUM+J",0
7,"7032",21005,12039,11928,114,111,"PUM+J",15
37,"37356",84,58,58,0,0,"PUM+J",0
19,"19129",25,21,21,0,0,"PUM+J",0
10,"10070",667,493,489,1,4,"PUM+J",0
18,"18175",11793,8099,7943,62,156,"PUM+J",8
2,"2051",1654,1115,1101,13,14,"PUM+J",0
42,"42204",53,37,35,1,2,"PUM+J",1
42,"42113",510,370,366,2,4,"PUM+J",1
22,"22094",102,69,69,3,0,"PUM+J",0
45,"45092",223,193,190,1,3,"PUM+J",0
12,"12018",279,233,231,3,2,"PUM+J",0
50,"50190",669,532,518,10,14,"PUM+J",0
18,"18144",816,592,582,3,10,"PUM+J",0
16,"16197",67,44,43,0,1,"PUM+J",0
12,"12100",1273,1069,1052,5,17,"PUM+J",0
26,"26154",10,10,9,1,1,"PUM+J",0
37,"37357",248,193,192,1,1,"PUM+J",0
19,"19027",129,97,95,1,2,"PUM+J",0
37,"37068",337,240,236,1,4,"PUM+J",0
49,"49111",119,84,84,3,0,"PUM+J",0
6,"6030",168,131,128,1,3,"PUM+J",1
22,"22208",192,150,147,1,3,"PUM+J",0
12,"12101",354,274,270,5,4,"PUM+J",1
30,"30012",9085,6704,6599,46,105,"PUM+J",4
45,"45094",365,274,271,3,3,"PUM+J",0
41,"41025",2031,1409,1349,11,60,"PUM+J",1
45,"45167",1370,1078,1065,1,13,"PUM+J",0
18,"18145",10909,7925,7780,67,145,"PUM+J",8
22,"22173",219,147,141,3,6,"PUM+J",0
2,"2054",375,288,283,0,5,"PUM+J",0
18,"18046",1738,1042,1023,7,19,"PUM+J",0
44,"44167",34,26,26,0,0,"PUM+J",0
37,"37358",159,124,124,0,0,"PUM+J",0
40,"40173",140,120,118,2,2,"PUM+J",0
4,"4102",14202,9264,9139,57,125,"PUM+J",8
42,"42117",129,98,95,1,3,"PUM+J",0
5,"5196",57,43,43,0,0,"PUM+J",0
46,"46254",944,673,661,6,12,"PUM+J",0
44,"44256",36,30,30,2,0,"PUM+J",0
34,"34045",72,62,62,0,0,"PUM+J",0
13,"13058",4026,2822,2766,29,56,"PUM+J",1
3,"3057",174,138,136,0,2,"PUM+J",0
37,"37170",1361,909,884,9,25,"PUM+J",0
29,"29044",749,477,473,1,4,"PUM+J",0
3,"3028",959,780,767,7,13,"PUM+J",0
46,"46091",110,100,100,0,0,"PUM+J",0
34,"34236",147,104,104,0,0,"PUM+J",2
28,"28111",629,479,475,2,4,"PUM+J",0
14,"14058",7866,5451,5334,69,117,"PUM+J",15
10,"10197",106,74,74,0,0,"PUM+J",0
26,"26160",731,539,533,4,6,"PUM+J",0
24,"24051",389,275,269,1,6,"PUM+J",0
16,"16202",733,533,526,4,7,"PUM+J",1
44,"44257",149,92,91,0,1,"PUM+J",0
47,"47173",879,627,622,9,5,"PUM+J",0
10,"10076",791,537,525,10,12,"PUM+J",0
23,"23049",1740,1215,1183,12,32,"PUM+J",1
22,"22102",180,137,136,3,1,"PUM+J",0
37,"37360",206,135,135,1,0,"PUM+J",0
22,"22213",2918,2084,2062,20,22,"PUM+J",5
12,"12022",323,257,254,5,3,"PUM+J",0
45,"45098",2090,1488,1469,7,19,"PUM+J",0
4,"4001",1002,717,710,3,7,"PUM+J",0
39,"39030",1874,1199,1187,6,12,"PUM+J",2
49,"49228",53,36,36,0,0,"PUM+J",0
19,"19134",23,14,14,0,0,"PUM+J",0
22,"22175",184,129,128,0,1,"PUM+J",0
42,"42120",131,87,86,1,1,"PUM+J",0
47,"47079",55,44,43,1,1,"PUM+J",0
45,"45171",1329,958,940,4,18,"PUM+J",0
41,"41028",2108,1652,1632,22,20,"PUM+J",2
44,"44171",176,115,115,0,0,"PUM+J",0
6,"6037",1656,1033,1018,8,15,"PUM+J",1
45,"45099",3700,2524,2501,9,23,"PUM+J",3
9,"9431",116,85,84,2,1,"PUM+J",0
13,"13062",567,450,446,4,4,"PUM+J",1
50,"50194",80,51,51,0,0,"PUM+J",0
16,"16087",238,184,184,6,0,"PUM+J",0
7,"7006",5393,3257,3220,34,37,"PUM+J",9
39,"39004",1479,1050,1031,5,19,"PUM+J",0
26,"26163",126,104,104,1,0,"PUM+J",1
33,"33050",548,316,314,1,2,"PUM+J",0
9,"9267",117,95,93,1,2,"PUM+J",0
44,"44172",296,216,216,1,0,"PUM+J",0
46,"46257",5436,3972,3933,28,39,"PUM+J",3
13,"13018",774,625,622,0,3,"PUM+J",0
16,"16088",100,86,86,0,0,"PUM+J",0
34,"34241",17,17,16,3,1,"PUM+J",0
23,"23052",1094,920,896,6,24,"PUM+J",0
5,"5200",41,26,26,0,0,"PUM+J",0
46,"46003",948,770,757,8,13,"PUM+J",1
46,"46208",1071,854,845,2,9,"PUM+J",0
46,"46140",383,321,321,2,0,"PUM+J",0
49,"49009",382,251,251,0,0,"PUM+J",0
47,"47081",39,32,32,0,0,"PUM+J",0
9,"9109",1072,575,558,0,17,"PUM+J",1
12,"12053",2040,1587,1579,8,8,"PUM+J",2
37,"37114",74,58,55,1,3,"PUM+J",0
28,"28082",6110,4622,4581,41,41,"PUM+J",8
45,"45138",1058,813,802,5,11,"PUM+J",1
50,"50246",37,24,24,0,0,"PUM+J",0
28,"28178",1149,869,853,4,16,"PUM+J",0
12,"12106",1151,928,908,9,20,"PUM+J",1
10,"10203",4421,2810,2764,15,46,"PUM+J",2
3,"3062",228,173,172,3,1,"PUM+J",0
19,"19139",26,19,19,2,0,"PUM+J",0
37,"37176",128,99,98,1,1,"PUM+J",0
5,"5002",1905,1361,1329,11,32,"PUM+J",3
29,"29022",177,137,136,1,1,"PUM+J",0
49,"49043",256,191,189,1,2,"PUM+J",0
37,"37207",336,244,240,4,4,"PUM+J",1
9,"9329",113,76,75,5,1,"PUM+J",0
9,"9908",423,254,253,4,1,"PUM+J",1
19,"19263",21,15,15,0,0,"PUM+J",0
41,"41060",15058,10551,10302,122,249,"PUM+J",5
37,"37011",100,78,78,3,0,"PUM+J",0
5,"5108",39,21,21,0,0,"PUM+J",0
13,"13068",1023,737,722,2,15,"PUM+J",2
22,"22218",39,34,34,0,0,"PUM+J",0
33,"33053",1078,602,599,10,3,"PUM+J",0
30,"30042",2218,1645,1625,10,20,"PUM+J",0
7,"7010",5078,3353,3318,30,35,"PUM+J",1
46,"46142",778,536,524,3,12,"PUM+J",3
24,"24057",1295,909,891,7,18,"PUM+J",2
19,"19039",56,48,48,2,0,"PUM+J",0
24,"24167",703,436,430,3,6,"PUM+J",0
45,"45104",419,328,324,1,4,"PUM+J",1
50,"50272",13226,9250,9153,97,97,"PUM+J",15
28,"28085",4194,3126,3091,24,35,"PUM+J",1
37,"37178",98,70,70,0,0,"PUM+J",0
39,"39007",386,265,264,0,1,"PUM+J",0
49,"49122",761,517,505,7,12,"PUM+J",1
50,"50045",1217,891,878,10,13,"PUM+J",0
26,"26168",5584,3757,3696,35,61,"PUM+J",7
2,"2063",1358,987,973,3,14,"PUM+J",0
9,"9274",1035,774,762,8,12,"PUM+J",0
37,"37367",179,147,143,2,4,"PUM+J",0
10,"10085",310,219,219,1,0,"PUM+J",0
16,"16094",121,86,84,0,2,"PUM+J",0
47,"47180",57,41,41,1,0,"PUM+J",0
18,"18185",545,434,424,5,10,"PUM+J",1
22,"22011",98,80,79,0,1,"PUM+J",0
47,"47181",165,136,135,1,1,"PUM+J",0
33,"33055",1485,992,966,14,26,"PUM+J",1
49,"49013",219,160,159,0,1,"PUM+J",0
4,"4009",140,109,106,2,3,"PUM+J",0
44,"44176",152,114,113,1,1,"PUM+J",0
5,"5008",202,158,155,0,3,"PUM+J",0
19,"19041",163,118,117,1,1,"PUM+J",0
37,"37368",17,12,11,0,1,"PUM+J",0
46,"46075",144,125,122,2,3,"PUM+J",0
49,"49236",71,54,54,0,0,"PUM+J",0
30,"30901",10556,7862,7775,58,87,"PUM+J",2
37,"37082",733,468,456,7,12,"PUM+J",0
33,"33056",4850,3068,3044,25,24,"PUM+J",4
26,"26053",191,144,140,2,4,"PUM+J",0
10,"10046",184,144,140,0,4,"PUM+J",0
50,"50096",34,22,22,0,0,"PUM+J",0
23,"23058",8832,6528,6407,57,121,"PUM+J",11
16,"16096",278,219,217,1,2,"PUM+J",0
28,"28087",3301,2539,2519,20,20,"PUM+J",3
38,"38038",165135,101564,100807,709,757,"PUM+J",72
46,"46262",206,136,134,1,2,"PUM+J",0
19,"19042",22,18,17,0,1,"PUM+J",0
22,"22222",516,379,377,6,2,"PUM+J",0
10,"10209",259,151,149,0,2,"PUM+J",0
46,"46008",2617,1954,1931,17,23,"PUM+J",2
24,"24061",1753,1234,1223,10,11,"PUM+J",1
49,"49125",1392,883,871,11,12,"PUM+J",2
49,"49237",142,78,78,0,0,"PUM+J",0
37,"37181",265,158,158,0,0,"PUM+J",0
10,"10089",1334,864,837,8,27,"PUM+J",0
5,"5113",62,42,42,0,0,"PUM+J",0
18,"18059",4265,2960,2886,23,74,"PUM+J",5
42,"42007",108,80,80,1,0,"PUM+J",1
11,"11021",4914,3187,3069,61,118,"PUM+J",2
23,"23097",6346,4243,4194,31,49,"PUM+J",5
46,"46191",1956,1439,1414,8,25,"PUM+J",1
41,"41037",3201,2306,2260,22,46,"PUM+J",1
22,"22112",9525,6317,6245,91,72,"PUM+J",7
6,"6050",4031,3005,2934,38,71,"PUM+J",3
22,"22014",227,164,162,5,2,"PUM+J",0
29,"29901",44757,29291,28960,307,331,"PUM+J",19
37,"37277",74,55,55,0,0,"PUM+J",0
47,"47088",101,79,79,0,0,"PUM+J",0
28,"28089",3856,2866,2829,21,37,"PUM+J",4
44,"44002",47,41,41,0,0,"PUM+J",0
5,"5048",107,89,88,2,1,"PUM+J",0
18,"18094",2299,1712,1652,20,60,"PUM+J",2
46,"46237",7172,5199,5146,53,53,"PUM+J",9
23,"23061",7711,5357,5231,44,126,"PUM+J",9
12,"12112",102,79,79,1,0,"PUM+J",1
24,"24064",1501,1030,1012,2,18,"PUM+J",1
49,"49018",277,197,190,2,7,"PUM+J",0
28,"28156",1082,788,784,3,4,"PUM+J",2
9,"9067",399,232,230,3,2,"PUM+J",1
38,"38016",1174,595,589,2,6,"PUM+J",0
50,"50126",2240,1528,1509,24,19,"PUM+J",0
16,"16224",72,60,58,0,2,"PUM+J",0
50,"50051",802,551,550,2,1,"PUM+J",0
9,"9447",43,37,36,0,1,"PUM+J",0
37,"37087",911,675,665,5,10,"PUM+J",0
29,"29074",771,561,555,1,6,"PUM+J",0
5,"5116",96,68,68,0,0,"PUM+J",0
28,"28019",1272,926,914,6,12,"PUM+J",2
10,"10093",387,278,253,4,25,"PUM+J",0
49,"49241",235,178,177,1,1,"PUM+J",0
9,"9287",191,144,143,2,1,"PUM+J",0
19,"19046",22204,16001,15752,156,249,"PUM+J",50
49,"49019",232,162,152,2,10,"PUM+J",0
44,"44181",65,57,57,0,0,"PUM+J",0
2,"2070",373,306,301,6,5,"PUM+J",0
22,"22193",272,199,194,4,5,"PUM+J",0
14,"14071",874,551,540,5,11,"PUM+J",0
50,"50277",45,34,34,0,0,"PUM+J",0
50,"50278",175,133,131,2,2,"PUM+J",0
19,"19242",74,53,53,1,0,"PUM+J",0
47,"47187",71,49,49,0,0,"PUM+J",0
19,"19243",34,32,31,1,1,"PUM+J",1
44,"44004",379,275,275,2,0,"PUM+J",0
9,"9289",1353,873,861,4,12,"PUM+J",2
39,"39014",882,538,536,0,2,"PUM+J",0
18,"18162",919,664,652,3,12,"PUM+J",2
28,"28092",153631,112460,111341,913,1119,"PUM+J",119
9,"9128",76,56,56,0,0,"PUM+J",0
21,"21037",462,320,313,1,7,"PUM+J",0
40,"40190",43,37,35,0,2,"PUM+J",0
9,"9405",122,94,91,0,3,"PUM+J",0
16,"16275",12,12,12,1,0,"PUM+J",0
13,"13036",752,552,546,1,6,"PUM+J",0
21,"21007",6379,4268,4178,66,90,"PUM+J",8
44,"44005",48,36,36,0,0,"PUM+J",0
28,"28093",2177,1681,1658,11,23,"PUM+J",0
23,"23065",1530,1068,1054,7,14,"PUM+J",1
50,"50130",354,225,222,1,3,"PUM+J",0
33,"33063",375,269,267,5,2,"PUM+J",0
9,"9451",237,196,189,1,7,"PUM+J",0
29,"29076",2354,1498,1444,21,54,"PUM+J",1
45,"45005",225,170,167,3,3,"PUM+J",0
49,"49244",46,23,23,0,0,"PUM+J",0
49,"49205",359,252,251,7,1,"PUM+J",0
9,"9294",99,81,78,0,3,"PUM+J",0
19,"19048",19,14,13,1,1,"PUM+J",0
19,"19244",74,55,55,3,0,"PUM+J",0
4,"4018",245,202,197,2,5,"PUM+J",0
34,"34113",40,38,38,0,0,"PUM+J",0
45,"45007",656,502,497,0,5,"PUM+J",0
28,"28023",5159,4052,4019,27,33,"PUM+J",3
22,"22229",107,70,70,2,0,"PUM+J",0
34,"34024",25,14,14,0,0,"PUM+J",0
12,"12116",61,49,49,0,0,"PUM+J",0
28,"28095",1719,1236,1226,5,10,"PUM+J",0
10,"10219",1184,698,686,9,12,"PUM+J",1
44,"44184",44,37,37,0,0,"PUM+J",0
44,"44213",68,47,47,0,0,"PUM+J",0
5,"5120",33,26,26,0,0,"PUM+J",1
40,"40193",219,156,155,3,1,"PUM+J",0
45,"45118",2124,1403,1380,8,23,"PUM+J",2
45,"45045",1338,926,915,9,11,"PUM+J",3
6,"6060",5696,4006,3900,37,106,"PUM+J",9
50,"50055",3635,2298,2244,36,54,"PUM+J",0
46,"46151",757,560,552,2,8,"PUM+J",0
47,"47160",395,296,294,3,2,"PUM+J",0
18,"18067",682,442,437,2,5,"PUM+J",1
13,"13041",236,155,155,3,0,"PUM+J",1
19,"19217",43,36,36,0,0,"PUM+J",0
37,"37189",114,75,74,1,1,"PUM+J",1
4,"4091",318,251,250,0,1,"PUM+J",0
49,"49100",281,164,157,2,7,"PUM+J",0
14,"14047",1644,1198,1183,14,15,"PUM+J",0
28,"28162",2784,2143,2131,20,12,"PUM+J",3
7,"7035",1595,1095,1078,13,17,"PUM+J",3
23,"23070",3813,2384,2354,11,30,"PUM+J",0
45,"45009",455,277,274,2,3,"PUM+J",0
26,"26105",2188,1564,1536,24,28,"PUM+J",5
10,"10019",1412,948,934,2,14,"PUM+J",2
47,"47035",901,659,653,4,6,"PUM+J",0
37,"37379",169,133,132,0,1,"PUM+J",0
37,"37285",360,271,270,0,1,"PUM+J",0
9,"9301",658,497,488,5,9,"PUM+J",2
47,"47097",305,239,237,0,2,"PUM+J",1
13,"13088",585,413,409,3,4,"PUM+J",0
22,"22122",69,52,50,2,2,"PUM+J",0
3,"3076",8846,6105,6029,40,76,"PUM+J",6
22,"22124",183,119,119,0,0,"PUM+J",0
28,"28099",1950,1409,1404,16,5,"PUM+J",1
23,"23071",1704,1278,1258,10,20,"PUM+J",2
5,"5219",33,23,23,0,0,"PUM+J",0
3,"3105",5510,3879,3792,27,87,"PUM+J",3
10,"10905",636,443,433,7,10,"PUM+J",1
12,"12041",92,69,69,2,0,"PUM+J",1
40,"40002",32,22,21,0,1,"PUM+J",0
45,"45121",7345,4949,4899,24,50,"PUM+J",15
10,"10103",422,290,286,1,4,"PUM+J",0
5,"5024",193,127,125,2,2,"PUM+J",0
50,"50283",69,46,46,0,0,"PUM+J",0
13,"13091",537,466,464,3,2,"PUM+J",0
16,"16109",41,30,30,0,0,"PUM+J",0
23,"23072",1879,1389,1363,3,26,"PUM+J",2
39,"39021",464,370,364,1,6,"PUM+J",0
19,"19053",1906,1323,1304,12,19,"PUM+J",1
18,"18136",1778,1320,1284,14,36,"PUM+J",1
37,"37319",88,68,64,2,4,"PUM+J",0
24,"24110",1158,784,773,1,11,"PUM+J",1
19,"19019",14,11,11,1,0,"PUM+J",0
50,"50082",82,57,57,0,0,"PUM+J",0
37,"37099",63,46,46,1,0,"PUM+J",0
47,"47194",295,228,227,1,1,"PUM+J",1
37,"37287",297,204,202,2,2,"PUM+J",0
46,"46085",11089,7581,7503,60,78,"PUM+J",3
18,"18070",287,216,216,3,0,"PUM+J",0
16,"16110",90,70,70,1,0,"PUM+J",0
16,"16902",124,86,86,1,0,"PUM+J",0
12,"12096",732,526,519,4,7,"PUM+J",0
16,"16240",98,71,69,0,2,"PUM+J",0
34,"34124",60,45,45,0,0,"PUM+J",0
21,"21014",4066,3089,3029,30,60,"PUM+J",3
47,"47100",118,93,87,2,6,"PUM+J",0
2,"2080",498,358,352,0,6,"PUM+J",2
29,"29066",357,248,246,1,2,"PUM+J",0
5,"5026",183,149,147,1,2,"PUM+J",0
9,"9139",98,79,79,2,0,"PUM+J",0
37,"37100",74,59,58,1,1,"PUM+J",0
50,"50285",657,448,442,4,6,"PUM+J",0
21,"21015",645,361,356,8,5,"PUM+J",0
47,"47008",22,13,13,0,0,"PUM+J",0
45,"45014",4039,2606,2552,35,54,"PUM+J",3
22,"22236",232,190,188,2,2,"PUM+J",0
47,"47196",29,21,21,0,0,"PUM+J",0
24,"24153",228,171,171,3,0,"PUM+J",0
18,"18071",5636,3909,3807,45,102,"PUM+J",4
9,"9308",58,34,34,1,0,"PUM+J",0
21,"21016",985,703,680,5,23,"PUM+J",0
5,"5225",355,276,273,6,3,"PUM+J",0
18,"18173",8999,5958,5871,50,87,"PUM+J",4
19,"19162",67,41,41,0,0,"PUM+J",0
23,"23075",3222,2513,2475,19,38,"PUM+J",6
5,"5027",258,209,203,5,6,"PUM+J",0
4,"4027",218,130,130,0,0,"PUM+J",0
5,"5224",102,85,84,2,1,"PUM+J",0
46,"46155",972,731,716,3,15,"PUM+J",0
24,"24227",1527,1036,1032,13,4,"PUM+J",0
24,"24115",53159,35203,34784,410,419,"PUM+J",68
10,"10149",432,284,280,2,4,"PUM+J",1
37,"37102",375,260,260,4,0,"PUM+J",0
45,"45126",234,146,144,2,2,"PUM+J",2
18,"18174",435,324,320,3,4,"PUM+J",0
16,"16244",698,598,585,7,13,"PUM+J",0
28,"28031",2129,1501,1486,8,15,"PUM+J",1
38,"38002",971,577,570,8,7,"PUM+J",0
12,"12123",40,32,32,0,0,"PUM+J",0
22,"22027",311,210,209,1,1,"PUM+J",0
11,"11005",4508,2978,2900,34,78,"PUM+J",5
29,"29087",363,249,243,4,6,"PUM+J",0
9,"9311",59,45,45,0,0,"PUM+J",0
5,"5226",63,43,42,0,1,"PUM+J",0
19,"19163",60,49,49,0,0,"PUM+J",0
49,"49143",201,119,118,1,1,"PUM+J",0
33,"33072",1443,816,814,8,2,"PUM+J",0
45,"45128",2569,1676,1652,6,24,"PUM+J",2
44,"44014",2506,1828,1818,8,10,"PUM+J",1
50,"50902",77,65,62,0,3,"PUM+J",0
9,"9478",45,34,34,1,0,"PUM+J",0
10,"10111",1297,888,872,11,16,"PUM+J",1
38,"38003",1517,899,890,5,9,"PUM+J",0
10,"10192",777,567,563,3,4,"PUM+J",0
50,"50288",3440,2513,2486,26,27,"PUM+J",2
6,"6903",2011,1443,1416,18,27,"PUM+J",2
47,"47012",100,72,71,0,1,"PUM+J",0
26,"26075",315,234,229,1,5,"PUM+J",0
39,"39026",1702,1160,1151,11,9,"PUM+J",0
19,"19255",74,37,37,0,0,"PUM+J",0
46,"46089",2182,1590,1576,9,14,"PUM+J",4
42,"42026",28,25,25,0,0,"PUM+J",0
10,"10112",1495,1071,1049,7,22,"PUM+J",1
37,"37002",125,64,63,0,1,"PUM+J",0
2,"2085",306,232,226,2,6,"PUM+J",0
4,"4031",2238,1649,1645,15,4,"PUM+J",1
22,"22244",42,33,32,1,1,"PUM+J",1
24,"24083",997,659,647,9,12,"PUM+J",1
34,"34131",56,46,46,0,0,"PUM+J",0
50,"50140",153,96,95,1,1,"PUM+J",0
24,"24193",363,264,264,1,0,"PUM+J",1
23,"23081",1494,1084,1061,9,23,"PUM+J",1
9,"9095",103,54,53,3,1,"PUM+J",0
33,"33074",3366,2042,2011,35,31,"PUM+J",1
49,"49076",330,230,226,9,4,"PUM+J",1
9,"9483",189,156,155,2,1,"PUM+J",0
29,"29089",3138,2262,2186,13,76,"PUM+J",1
4,"4032",5716,3727,3696,43,31,"PUM+J",2
5,"5132",857,548,539,7,9,"PUM+J",0
9,"9151",446,352,346,3,6,"PUM+J",1
46,"46189",469,374,367,2,7,"PUM+J",1
12,"12049",415,317,305,4,12,"PUM+J",0
12,"12126",24374,17741,17553,111,188,"PUM+J",45
49,"49036",503,319,316,5,3,"PUM+J",1
41,"41054",719,562,546,3,16,"PUM+J",1
41,"41053",21693,15843,15379,171,464,"PUM+J",13
3,"3085",271,229,227,5,2,"PUM+J",0
40,"40012",241,160,156,7,4,"PUM+J",0
45,"45901",779,542,534,5,8,"PUM+J",1
14,"14001",3423,2563,2515,11,48,"PUM+J",2
5,"5230",65,57,56,1,1,"PUM+J",0
16,"16044",43,29,28,0,1,"PUM+J",0
9,"9427",1363,854,842,7,12,"PUM+J",1
28,"28065",131232,100864,99883,846,981,"PUM+J",120
22,"22133",108,71,71,3,0,"PUM+J",0
50,"50064",439,348,346,1,2,"PUM+J",0
34,"34134",44,25,25,0,0,"PUM+J",1
40,"40109",69,51,50,3,1,"PUM+J",0
50,"50142",23,16,16,1,0,"PUM+J",1
23,"23085",2171,1587,1575,7,12,"PUM+J",1
49,"49149",368,270,266,1,4,"PUM+J",0
19,"19168",265,182,175,4,7,"PUM+J",0
3,"3086",169,140,140,2,0,"PUM+J",2
5,"5231",150,123,122,2,1,"PUM+J",0
42,"42030",91,69,69,2,0,"PUM+J",1
37,"37109",178,127,126,0,1,"PUM+J",0
47,"47047",199,136,135,4,1,"PUM+J",0
18,"18082",810,503,500,3,3,"PUM+J",0
47,"47017",190,146,146,0,0,"PUM+J",0
21,"21023",2033,1215,1193,10,22,"PUM+J",2
22,"22036",84,71,71,1,0,"PUM+J",0
37,"37203",151,114,113,1,1,"PUM+J",0
40,"40206",162,126,123,0,3,"PUM+J",1
37,"37072",144,121,118,5,3,"PUM+J",0
22,"22135",173,123,121,0,2,"PUM+J",0
9,"9001",32,25,25,0,0,"PUM+J",0
37,"37151",142,109,109,1,0,"PUM+J",0
34,"34186",49,44,44,0,0,"PUM+J",0
44,"44080",281,202,199,0,3,"PUM+J",0
24,"24089",101036,71905,71305,744,600,"PUM+J",80
5,"5038",114,83,82,0,1,"PUM+J",0
9,"9160",83,63,63,1,0,"PUM+J",0
44,"44021",104,77,77,1,0,"PUM+J",0
28,"28113",36951,27912,27604,241,308,"PUM+J",29
41,"41057",258,174,170,3,4,"PUM+J",0
47,"47112",2561,1960,1933,13,27,"PUM+J",3
42,"42033",50,48,48,2,0,"PUM+J",0
7,"7040",289448,169300,167908,1594,1392,"PUM+J",216
14,"14004",1963,1465,1437,15,28,"PUM+J",5
24,"24199",398,263,256,4,7,"PUM+J",1
45,"45026",219,166,164,1,2,"PUM+J",0
21,"21025",3886,2489,2431,31,58,"PUM+J",5
19,"19067",68,46,44,0,2,"PUM+J",0
9,"9326",156,111,110,1,1,"PUM+J",2
19,"19136",11,10,10,0,0,"PUM+J",0
42,"42168",108,73,73,0,0,"PUM+J",0
44,"44200",39,26,26,0,0,"PUM+J",0
9,"9163",573,436,432,7,4,"PUM+J",0
22,"22039",813,635,634,4,1,"PUM+J",0
9,"9009",158,127,124,5,3,"PUM+J",1
22,"22040",149,119,119,3,0,"PUM+J",1
37,"37205",212,157,155,1,2,"PUM+J",1
23,"23088",6017,4529,4427,61,102,"PUM+J",5
46,"46231",2403,1670,1652,11,18,"PUM+J",0
46,"46026",1220,974,965,7,9,"PUM+J",0
50,"50120",55,42,42,1,0,"PUM+J",0
49,"49119",217,158,156,2,2,"PUM+J",0
21,"21026",262,172,168,2,4,"PUM+J",0
19,"19294",26,18,18,0,0,"PUM+J",0
46,"46072",3522,2792,2741,25,51,"PUM+J",4
11,"11014",17203,10923,10805,222,118,"PUM+J",13
2,"2027",274,209,203,1,6,"PUM+J",0
23,"23090",1204,953,938,6,15,"PUM+J",1
46,"46095",580,445,438,5,7,"PUM+J",0
6,"6086",1174,767,750,6,17,"PUM+J",1
9,"9328",70,37,37,3,0,"PUM+J",0
28,"28071",63,46,45,0,1,"PUM+J",0
44,"44144",319,225,223,0,2,"PUM+J",0
18,"18022",13875,8948,8764,98,184,"PUM+J",5
45,"45175",603,476,473,1,3,"PUM+J",0
9,"9058",394,286,284,6,2,"PUM+J",0
40,"40049",37,27,27,0,0,"PUM+J",0
47,"47021",73,57,55,0,2,"PUM+J",0
37,"37241",167,121,119,3,2,"PUM+J",0
46,"46119",761,587,580,6,7,"PUM+J",0
24,"24093",342,214,212,2,2,"PUM+J",0
45,"45140",1075,788,772,10,16,"PUM+J",2
5,"5042",141,111,111,0,0,"PUM+J",0
49,"49155",81,60,59,0,1,"PUM+J",0
7,"7043",3431,2196,2166,21,30,"PUM+J",3
12,"12132",477,391,385,3,6,"PUM+J",0
18,"18087",182877,131811,130184,1106,1627,"PUM+J",244
50,"50148",304,213,211,2,2,"PUM+J",0
24,"24205",990,678,667,6,11,"PUM+J",0
29,"29097",4160,2872,2800,56,72,"PUM+J",0
23,"23092",27717,19749,19490,217,259,"PUM+J",21
18,"18184",2193,1542,1511,16,31,"PUM+J",0
46,"46028",383,305,299,8,6,"PUM+J",0
9,"9013",42,32,32,0,0,"PUM+J",0
49,"49046",246,174,169,0,5,"PUM+J",0
5,"5174",62,51,51,1,0,"PUM+J",0
38,"38036",6857,4170,4090,37,80,"PUM+J",6
9,"9169",97,72,70,1,2,"PUM+J",0
4,"4045",1696,1268,1254,17,14,"PUM+J",5
24,"24206",1594,1104,1093,11,11,"PUM+J",1
49,"49157",188,136,133,2,3,"PUM+J",0
47,"47212",356,289,287,4,2,"PUM+J",0
28,"28073",12707,9198,9080,94,118,"PUM+J",8
37,"37080",221,164,163,1,1,"PUM+J",0
19,"19110",51,39,39,0,0,"PUM+J",0
40,"40120",195,169,163,0,6,"PUM+J",0
9,"9014",182,101,101,0,0,"PUM+J",0
41,"41062",2151,1619,1589,12,30,"PUM+J",0
16,"16131",123,84,84,0,0,"PUM+J",1
35,"35021",15072,9791,9696,80,95,"PUM+J",11
24,"24096",105,56,54,1,2,"PUM+J",0
22,"22144",255,192,190,2,2,"PUM+J",0
37,"37305",219,177,175,2,2,"PUM+J",0
47,"47118",147,97,97,2,0,"PUM+J",0
9,"9172",131,88,88,1,0,"PUM+J",0
46,"46060",9278,6796,6724,49,72,"PUM+J",4
9,"9017",89,61,60,3,1,"PUM+J",0
29,"29099",969,688,669,11,19,"PUM+J",0
6,"6092",558,438,426,2,12,"PUM+J",0
42,"42041",31,23,23,0,0,"PUM+J",0
42,"42177",61,42,41,0,1,"PUM+J",0
49,"49194",331,198,197,0,1,"PUM+J",0
24,"24133",357,256,256,1,0,"PUM+J",1
22,"22045",65,52,52,0,0,"PUM+J",0
5,"5012",117,88,88,1,0,"PUM+J",0
9,"9174",768,536,522,6,14,"PUM+J",1
10,"10129",340,234,227,2,7,"PUM+J",0
40,"40021",18,15,15,0,0,"PUM+J",0
3,"3095",4807,3453,3410,31,43,"PUM+J",5
34,"34152",124,99,94,0,5,"PUM+J",0
28,"28046",4824,3726,3707,33,19,"PUM+J",5
46,"46099",744,539,535,2,4,"PUM+J",1
10,"10210",489,314,313,2,1,"PUM+J",0
39,"39038",1512,992,983,5,9,"PUM+J",0
5,"5241",3062,2011,1977,21,34,"PUM+J",4
50,"50275",111,50,50,0,0,"PUM+J",0
9,"9019",146,105,103,4,2,"PUM+J",0
5,"5114",1257,989,968,5,21,"PUM+J",0
26,"26019",346,260,251,2,9,"PUM+J",0
10,"10211",446,303,300,0,3,"PUM+J",1
47,"47026",50,37,37,1,0,"PUM+J",0
47,"47216",111,94,91,0,3,"PUM+J",0
40,"40123",141,98,94,4,4,"PUM+J",0
22,"22901",714,433,423,6,10,"PUM+J",0
50,"50048",33,25,25,0,0,"PUM+J",0
6,"6096",206,158,153,0,5,"PUM+J",1
9,"9020",233,170,166,3,4,"PUM+J",0
46,"46168",2004,1463,1447,12,16,"PUM+J",1
10,"10008",1274,921,908,1,13,"PUM+J",0
22,"22164",42,28,28,0,0,"PUM+J",0
37,"37152",400,268,261,4,7,"PUM+J",0
49,"49200",936,679,670,9,9,"PUM+J",0
19,"19179",74,64,64,3,0,"PUM+J",0
37,"37309",36,21,21,0,0,"PUM+J",0
9,"9021",50,30,30,3,0,"PUM+J",0
47,"47028",30,17,17,0,0,"PUM+J",0
49,"49127",2402,1640,1604,18,36,"PUM+J",4
46,"46902",352,283,283,0,0,"PUM+J",0
21,"21004",1586,994,964,23,30,"PUM+J",2
46,"46101",819,670,663,8,7,"PUM+J",0
41,"41066",1307,927,898,7,29,"PUM+J",0
14,"14013",16619,11968,11719,153,249,"PUM+J",16
19,"19080",67,47,47,0,0,"PUM+J",0
45,"45148",263,184,184,0,0,"PUM+J",0
5,"5243",80,57,56,1,1,"PUM+J",0
23,"23099",4824,3523,3435,35,88,"PUM+J",0
28,"28124",73,51,50,0,1,"PUM+J",0
18,"18193",14934,10301,10127,116,174,"PUM+J",15
50,"50001",89,68,68,0,0,"PUM+J",0
37,"37216",294,234,227,5,7,"PUM+J",0
19,"19182",37,32,32,0,0,"PUM+J",0
47,"47218",981,728,723,4,5,"PUM+J",1
9,"9178",39,24,24,0,0,"PUM+J",0
41,"41067",7273,5114,5036,59,78,"PUM+J",2
22,"22016",558,384,382,5,2,"PUM+J",0
4,"4052",12882,8400,8322,93,78,"PUM+J",6
22,"22048",12635,8889,8807,98,82,"PUM+J",12
42,"42049",108,71,71,1,0,"PUM+J",0
33,"33004",65304,43473,43153,563,320,"PUM+J",48
50,"50229",65,46,46,1,0,"PUM+J",0
34,"34158",283,170,167,0,3,"PUM+J",1
49,"49203",280,218,212,1,6,"PUM+J",0
37,"37020",431,320,314,3,6,"PUM+J",0
40,"40028",103,88,87,2,1,"PUM+J",0
5,"5052",85,70,69,0,1,"PUM+J",0
10,"10136",274,205,202,1,3,"PUM+J",0
19,"19011",237,165,162,3,3,"PUM+J",0
5,"5151",83,60,60,0,0,"PUM+J",0
37,"37343",66,44,43,1,1,"PUM+J",1
28,"28051",1644,1231,1220,9,11,"PUM+J",4
22,"22050",93,77,77,0,0,"PUM+J",0
4,"4054",363,279,278,2,1,"PUM+J",0
12,"12139",299,202,200,3,2,"PUM+J",0
9,"9025",110,61,58,0,3,"PUM+J",0
37,"37021",66,45,44,0,1,"PUM+J",0
49,"49057",107,74,71,0,3,"PUM+J",0
18,"18034",484,345,342,3,3,"PUM+J",1
29,"29059",2662,1950,1895,16,55,"PUM+J",2
9,"9350",421,316,311,5,5,"PUM+J",0
47,"47126",42,35,35,1,0,"PUM+J",0
11,"11026",4700,3387,3293,17,94,"PUM+J",5
19,"19086",1371,1003,996,9,7,"PUM+J",1
22,"22018",303,216,215,3,1,"PUM+J",0
30,"30002",9701,6794,6717,27,77,"PUM+J",3
34,"34161",22,12,12,0,0,"PUM+J",0
42,"42052",16,14,14,0,0,"PUM+J",0
11,"11027",68774,45571,45137,567,434,"PUM+J",42
23,"23903",3498,2633,2601,28,32,"PUM+J",0
3,"3017",379,320,314,4,6,"PUM+J",0
44,"44125",63,41,41,0,0,"PUM+J",0
24,"24105",1512,1054,1047,10,7,"PUM+J",0
5,"5184",238,163,160,2,3,"PUM+J",0
49,"49098",200,139,138,3,1,"PUM+J",0
14,"14045",2997,2329,2287,30,42,"PUM+J",0
40,"40160",93,65,62,0,3,"PUM+J",0
29,"29033",1084,733,722,5,11,"PUM+J",1
10,"10180",4206,2609,2574,13,35,"PUM+J",0
19,"19186",76,60,60,0,0,"PUM+J",0
37,"37023",1624,1233,1211,15,22,"PUM+J",2
50,"50079",226,162,160,1,2,"PUM+J",0
12,"12039",792,665,659,2,6,"PUM+J",0
22,"22052",874,660,652,7,8,"PUM+J",1
38,"38021",1609,900,876,2,24,"PUM+J",0
24,"24219",489,334,329,7,5,"PUM+J",0
22,"22230",291,209,207,4,2,"PUM+J",0
2,"2008",1103,737,722,8,15,"PUM+J",3
13,"13086",158,122,120,0,2,"PUM+J",0
22,"22020",115,83,80,3,3,"PUM+J",0
47,"47190",95,75,75,1,0,"PUM+J",1
44,"44243",25,19,19,0,0,"PUM+J",0
5,"5217",54,42,41,0,1,"PUM+J",0
19,"19308",57,49,49,0,0,"PUM+J",0
9,"9241",244,171,169,6,2,"PUM+J",1
50,"50014",119,81,81,0,0,"PUM+J",0
42,"42069",1483,896,878,2,18,"PUM+J",2
47,"47224",93,75,75,1,0,"PUM+J",2
50,"50006",913,670,654,13,16,"PUM+J",0
4,"4021",179,132,129,2,3,"PUM+J",0
9,"9458",490,388,385,6,3,"PUM+J",1
22,"22232",88,61,61,2,0,"PUM+J",0
22,"22908",190,135,134,0,1,"PUM+J",0
44,"44037",447,288,288,1,0,"PUM+J",0
30,"30004",1129,838,833,1,5,"PUM+J",1
10,"10060",921,615,596,4,19,"PUM+J",0
26,"26106",79,67,67,0,0,"PUM+J",0
33,"33010",1722,1085,1069,15,16,"PUM+J",0
12,"12901",3339,2583,2561,25,22,"PUM+J",2
47,"47036",204,159,156,1,3,"PUM+J",0
42,"42056",28,25,24,0,1,"PUM+J",0
19,"19090",90,69,68,1,1,"PUM+J",0
44,"44244",67,40,40,0,0,"PUM+J",0
19,"19310",7,7,7,0,0,"PUM+J",0
16,"16280",163,122,119,2,3,"PUM+J",0
34,"34029",665,524,518,1,6,"PUM+J",0
47,"47225",73,61,59,1,2,"PUM+J",0
42,"42194",144,101,100,2,1,"PUM+J",0
41,"41074",2994,2154,2105,19,49,"PUM+J",2
42,"42057",145,70,70,0,0,"PUM+J",0
19,"19189",114,87,84,0,3,"PUM+J",0
34,"34170",50,30,30,1,0,"PUM+J",0
40,"40132",45,26,25,0,1,"PUM+J",0
19,"19091",23,17,17,0,0,"PUM+J",0
40,"40034",74,59,58,0,1,"PUM+J",0
47,"47132",39,32,32,1,0,"PUM+J",0
28,"28165",1917,1339,1321,2,18,"PUM+J",2
50,"50108",50,37,37,0,0,"PUM+J",0
16,"16901",624,443,438,5,5,"PUM+J",0
38,"38048",3952,2543,2519,22,24,"PUM+J",1
9,"9052",28,21,20,0,1,"PUM+J",0
44,"44130",28,23,23,0,0,"PUM+J",0
9,"9036",31,24,24,4,0,"PUM+J",0
50,"50235",2421,1721,1702,18,19,"PUM+J",1
49,"49174",127,86,85,1,1,"PUM+J",0
28,"28058",141836,104142,103011,896,1131,"PUM+J",147
9,"9247",21,18,18,0,0,"PUM+J",0
47,"47007",4051,2987,2954,27,33,"PUM+J",8
37,"37061",195,136,136,1,0,"PUM+J",0
18,"18137",968,733,731,3,2,"PUM+J",0
34,"34033",18,14,14,0,0,"PUM+J",0
49,"49066",437,276,272,2,4,"PUM+J",2
45,"45160",1097,838,824,4,14,"PUM+J",1
16,"16035",224,177,174,2,3,"PUM+J",0
47,"47228",432,324,320,2,4,"PUM+J",0
49,"49175",204,136,135,3,1,"PUM+J",0
34,"34171",928,572,562,2,10,"PUM+J",0
24,"24113",346,240,240,2,0,"PUM+J",0
21,"21045",231,177,174,4,3,"PUM+J",0
18,"18105",3827,2436,2392,22,44,"PUM+J",1
14,"14023",1999,1629,1593,11,36,"PUM+J",0
3,"3023",1377,1138,1122,9,16,"PUM+J",1
26,"26110",149,116,114,0,2,"PUM+J",0
18,"18171",2098,1521,1460,11,61,"PUM+J",0
38,"38026",33585,24091,23889,170,202,"PUM+J",15
5,"5160",289,220,213,0,7,"PUM+J",0
9,"9198",100,75,74,2,1,"PUM+J",0
22,"22167",465,358,356,8,2,"PUM+J",1
37,"37133",101,73,69,1,4,"PUM+J",0
9,"9197",144,105,103,2,2,"PUM+J",0
37,"37229",138,103,101,0,2,"PUM+J",0
47,"47135",82,65,65,3,0,"PUM+J",0
19,"19095",11,7,6,0,1,"PUM+J",0
40,"40136",102,79,77,3,2,"PUM+J",0
28,"28135",998,712,703,2,9,"PUM+J",0
50,"50188",26,23,23,0,0,"PUM+J",0
49,"49220",146,102,98,3,4,"PUM+J",0
50,"50111",181,130,130,1,0,"PUM+J",0
44,"44220",113,82,82,1,0,"PUM+J",0
45,"45162",630,448,438,1,10,"PUM+J",0
10,"10027",77,62,62,0,0,"PUM+J",0
12,"12073",133,97,97,0,0,"PUM+J",0
37,"37323",474,335,325,5,10,"PUM+J",0
16,"16039",365,241,238,3,3,"PUM+J",0
5,"5162",76,47,45,1,2,"PUM+J",0
4,"4065",365,273,271,1,2,"PUM+J",0
14,"14025",2834,2352,2299,9,53,"PUM+J",1
49,"49178",748,520,505,7,15,"PUM+J",0
5,"5063",31,26,26,0,0,"PUM+J",0
28,"28062",306,232,227,0,5,"PUM+J",1
13,"13007",1219,871,852,4,19,"PUM+J",2
24,"24116",387,227,226,3,1,"PUM+J",1
19,"19285",20,16,16,0,0,"PUM+J",0
6,"6118",155,114,112,0,2,"PUM+J",0
19,"19097",14,14,13,0,1,"PUM+J",0
13,"13053",14031,9930,9796,97,134,"PUM+J",20
10,"10069",786,566,554,3,12,"PUM+J",1
37,"37136",625,388,387,7,1,"PUM+J",2
50,"50239",63,46,45,1,1,"PUM+J",0
46,"46021",24053,17331,17194,159,137,"PUM+J",17
19,"19098",20,17,17,0,0,"PUM+J",0
5,"5227",341,230,228,1,2,"PUM+J",1
18,"18014",6938,4864,4742,64,122,"PUM+J",15
26,"26002",821,611,597,1,14,"PUM+J",0
44,"44222",125,92,92,0,0,"PUM+J",0
42,"42065",23,18,18,1,0,"PUM+J",0
40,"40040",2489,1766,1744,26,22,"PUM+J",1
37,"37137",98,60,59,2,1,"PUM+J",1
11,"11037",5656,4374,4273,24,101,"PUM+J",3
10,"10152",444,312,309,2,3,"PUM+J",0
13,"13009",1383,1081,1070,3,11,"PUM+J",1
50,"50903",2268,1685,1670,16,15,"PUM+J",1
10,"10030",455,311,305,2,6,"PUM+J",1
11,"11038",13632,10047,9812,99,235,"PUM+J",7
13,"13010",872,615,601,3,14,"PUM+J",0
5,"5065",452,339,337,2,2,"PUM+J",0
6,"6121",3276,2301,2256,30,45,"PUM+J",4
45,"45166",1575,1231,1210,5,21,"PUM+J",2
9,"9482",34,22,22,0,0,"PUM+J",0
3,"3113",4339,2978,2935,23,43,"PUM+J",3
9,"9257",85,67,67,2,0,"PUM+J",0
44,"44223",73,48,48,0,0,"PUM+J",0
16,"16157",183,150,148,0,2,"PUM+J",0
37,"37034",77,63,62,0,1,"PUM+J",0
12,"12076",72,54,54,0,0,"PUM+J",0
5,"5905",214,148,142,1,6,"PUM+J",0
28,"28014",34522,25016,24748,229,268,"PUM+J",22
44,"44045",360,271,271,0,0,"PUM+J",0
50,"50115",3279,2170,2131,27,39,"PUM+J",0
37,"37070",523,371,365,4,6,"PUM+J",0
24,"24012",278,182,180,0,2,"PUM+J",0
3,"3114",1593,1158,1142,4,16,"PUM+J",1
13,"13012",381,265,261,1,4,"PUM+J",0
18,"18912",1352,926,912,7,14,"PUM+J",0
23,"23084",902,627,621,4,6,"PUM+J",0
26,"26119",178,132,132,0,0,"PUM+J",0
18,"18017",18201,11500,11358,94,142,"PUM+J",9
19,"19228",27,17,17,1,0,"PUM+J",0
21,"21052",4403,2688,2631,26,57,"PUM+J",1
46,"46205",14237,10641,10533,77,108,"PUM+J",5
24,"24902",331,239,239,0,0,"PUM+J",0
49,"49077",157,80,80,0,0,"PUM+J",0
6,"6124",1635,1158,1119,10,39,"PUM+J",2
9,"9375",42,35,35,0,0,"PUM+J",0
44,"44138",120,92,92,0,0,"PUM+J",0
50,"50015",81,57,56,0,1,"PUM+J",0
5,"5069",73,59,59,0,0,"PUM+J",0
50,"50089",8616,6420,6364,50,56,"PUM+J",3
26,"26120",1441,1027,1011,11,16,"PUM+J",1
19,"19290",851,551,550,4,1,"PUM+J",0
42,"42208",20,12,12,1,0,"PUM+J",0
40,"40143",82,68,67,2,1,"PUM+J",1
39,"39002",3408,2360,2323,7,37,"PUM+J",2
26,"26007",482,360,348,0,12,"PUM+J",1
40,"40046",83,67,67,1,0,"PUM+J",0
37,"37330",314,227,223,2,4,"PUM+J",0
12,"12078",334,224,221,2,3,"PUM+J",0
49,"49080",622,440,437,4,3,"PUM+J",0
16,"16160",58,41,41,1,0,"PUM+J",0
33,"33077",1097,688,683,4,5,"PUM+J",0
10,"10077",626,444,441,5,3,"PUM+J",0
28,"28155",487,374,369,0,5,"PUM+J",0
46,"46009",3144,2473,2449,22,24,"PUM+J",2
44,"44141",122,88,85,0,3,"PUM+J",0
40,"40144",16,15,15,0,0,"PUM+J",0
37,"37141",149,101,100,0,1,"PUM+J",0
46,"46161",1467,1129,1113,5,16,"PUM+J",0
16,"16046",213,142,142,0,0,"PUM+J",1
16,"16047",214,154,148,3,6,"PUM+J",0
10,"10036",304,194,192,4,2,"PUM+J",0
49,"49186",230,172,170,0,2,"PUM+J",0
44,"44142",29,21,21,0,0,"PUM+J",0
42,"42075",78,50,50,1,0,"PUM+J",0
41,"41001",1558,1129,1104,6,25,"PUM+J",1
28,"28069",58,44,42,1,2,"PUM+J",0
18,"18115",2635,1766,1738,13,28,"PUM+J",3
44,"44048",52,47,47,0,0,"PUM+J",0
30,"30015",19344,13502,13347,107,155,"PUM+J",15
19,"19293",1945,1402,1388,19,14,"PUM+J",1
9,"9055",47,33,32,0,1,"PUM+J",0
46,"46048",3504,2609,2576,17,33,"PUM+J",1
12,"12052",537,409,398,5,11,"PUM+J",0
40,"40145",1098,824,820,4,4,"PUM+J",0
19,"19106",77,57,57,0,0,"PUM+J",1
18,"18116",2856,2027,1979,13,48,"PUM+J",0
9,"9056",4833,3191,3156,37,35,"PUM+J",8
11,"11902",3664,2123,2094,46,29,"PUM+J",1
6,"6130",185,152,149,0,3,"PUM+J",0
24,"24018",172,129,128,0,1,"PUM+J",1
40,"40210",97,69,69,1,0,"PUM+J",0
26,"26123",128,110,110,0,0,"PUM+J",0
3,"3033",101,82,78,0,4,"PUM+J",0
34,"34140",93,57,57,1,0,"PUM+J",0
50,"50146",189,149,149,3,0,"PUM+J",0
10,"10081",176,121,119,0,2,"PUM+J",1
44,"44085",49,29,29,0,0,"PUM+J",0
49,"49154",111,63,59,0,4,"PUM+J",0
9,"9057",147,110,108,0,2,"PUM+J",0
46,"46141",433,340,337,6,3,"PUM+J",0
29,"29049",2890,2069,2034,12,35,"PUM+J",0
23,"23017",1498,1153,1129,11,24,"PUM+J",1
9,"9386",55,43,43,0,0,"PUM+J",0
22,"22008",144,113,112,2,1,"PUM+J",0
22,"22106",20,13,13,2,0,"PUM+J",0
19,"19330",69,62,62,0,0,"PUM+J",0
12,"12055",103,77,76,2,1,"PUM+J",0
44,"44115",102,91,91,0,0,"PUM+J",0
47,"47115",276,212,211,1,1,"PUM+J",0
37,"37010",925,645,638,5,7,"PUM+J",1
49,"49131",231,149,145,1,4,"PUM+J",0
39,"39034",255,133,128,2,5,"PUM+J",0
24,"24203",88,62,62,1,0,"PUM+J",0
16,"16014",558,419,417,6,2,"PUM+J",1
21,"21058",2567,1806,1766,32,40,"PUM+J",0
13,"13022",348,244,239,1,5,"PUM+J",0
19,"19203",29,25,25,0,0,"PUM+J",0
28,"28072",6176,4716,4673,44,43,"PUM+J",8
16,"16051",128,96,96,3,0,"PUM+J",0
37,"37042",36,27,27,1,0,"PUM+J",0
5,"5903",137,84,83,0,1,"PUM+J",0
47,"47052",6781,5213,5156,50,57,"PUM+J",18
12,"12082",9602,7323,7248,53,75,"PUM+J",10
34,"34053",194,156,154,3,2,"PUM+J",0
5,"5076",468,376,367,1,9,"PUM+J",0
24,"24130",415,291,289,2,2,"PUM+J",0
40,"40051",34,25,25,0,0,"PUM+J",0
41,"41089",6621,4650,4549,64,101,"PUM+J",4
46,"46260",2685,2072,2053,14,19,"PUM+J",1
40,"40182",169,112,112,1,0,"PUM+J",1
9,"9389",63,45,45,0,0,"PUM+J",0
3,"3036",82,73,71,1,2,"PUM+J",0
9,"9390",554,455,450,6,5,"PUM+J",0
46,"46188",693,565,560,2,5,"PUM+J",0
30,"30019",25911,17485,17264,157,221,"PUM+J",6
26,"26051",213,165,165,1,0,"PUM+J",0
44,"44205",619,420,415,5,5,"PUM+J",1
37,"37179",197,167,165,0,2,"PUM+J",0
7,"7012",1908,1301,1282,12,19,"PUM+J",0
46,"46120",1179,903,880,5,23,"PUM+J",0
10,"10167",301,198,198,0,0,"PUM+J",0
23,"23021",512,406,399,2,7,"PUM+J",0
33,"33027",752,412,405,11,7,"PUM+J",1
3,"3123",7579,5491,5416,50,75,"PUM+J",3
12,"12003",954,710,702,6,8,"PUM+J",2
26,"26129",939,657,644,2,13,"PUM+J",2
21,"21070",6294,4232,4124,64,108,"PUM+J",2
46,"46196",134,111,110,0,1,"PUM+J",0
34,"34057",464,308,302,4,6,"PUM+J",2
47,"47055",188,147,147,2,0,"PUM+J",0
4,"4010",587,421,409,5,12,"PUM+J",0
42,"42084",20,15,15,0,0,"PUM+J",0
50,"50022",504,373,369,12,4,"PUM+J",1
37,"37338",77,58,58,0,0,"PUM+J",0
12,"12031",3960,2913,2869,13,44,"PUM+J",0
16,"16055",669,429,426,0,3,"PUM+J",1
37,"37244",129,97,97,1,0,"PUM+J",0
28,"28153",816,547,544,3,3,"PUM+J",2
41,"41007",12488,7657,7421,126,236,"PUM+J",11
13,"13028",10230,7682,7559,65,123,"PUM+J",13
6,"6139",498,402,395,4,7,"PUM+J",0
18,"18027",2598,1730,1706,12,24,"PUM+J",1
19,"19209",40,30,29,0,1,"PUM+J",0
3,"3124",459,360,358,0,2,"PUM+J",0
16,"16056",442,275,270,4,5,"PUM+J",1
9,"9338",225,174,172,3,2,"PUM+J",0
19,"19146",47,35,35,0,0,"PUM+J",0
10,"10007",627,457,447,3,10,"PUM+J",1
26,"26018",10443,7664,7538,80,126,"PUM+J",6
24,"24062",126,79,79,0,0,"PUM+J",1
16,"16097",139,117,116,0,1,"PUM+J",0
49,"49162",170,117,116,1,1,"PUM+J",1
47,"47183",135,100,100,1,0,"PUM+J",0
50,"50151",607,450,449,12,1,"PUM+J",0
10,"10048",202,141,139,0,2,"PUM+J",0
38,"38039",11149,7375,7326,68,49,"PUM+J",5
13,"13030",115,81,81,0,0,"PUM+J",0
49,"49016",230,155,155,0,0,"PUM+J",0
24,"24099",153,111,110,1,1,"PUM+J",0
9,"9280",26,18,18,0,0,"PUM+J",0
37,"37182",75,47,47,1,0,"PUM+J",0
12,"12087",26,16,16,0,0,"PUM+J",0
6,"6020",1752,1330,1296,6,34,"PUM+J",2
9,"9414",180,137,135,1,2,"PUM+J",0
29,"29072",3291,2360,2307,19,53,"PUM+J",3
42,"42182",49,39,39,1,0,"PUM+J",0
38,"38040",5482,3094,3060,14,34,"PUM+J",1
13,"13031",2475,1855,1834,9,21,"PUM+J",3
50,"50178",269,165,163,6,2,"PUM+J",0
19,"19079",7,6,6,0,0,"PUM+J",0
40,"40056",31,21,20,0,1,"PUM+J",0
47,"47089",133,111,111,2,0,"PUM+J",0
50,"50202",124,76,74,0,2,"PUM+J",0
49,"49240",185,125,123,3,2,"PUM+J",0
10,"10173",558,389,385,5,4,"PUM+J",0
6,"6143",3389,2430,2371,24,59,"PUM+J",4
26,"26021",2742,1967,1932,14,35,"PUM+J",5
14,"14041",3113,2234,2160,43,74,"PUM+J",1
5,"5180",76,55,53,0,2,"PUM+J",0
12,"12007",724,622,614,2,8,"PUM+J",1
46,"46124",786,638,625,1,13,"PUM+J",0
22,"22190",123,77,77,1,0,"PUM+J",0
44,"44151",180,134,134,1,0,"PUM+J",0
34,"34213",53,46,46,0,0,"PUM+J",0
34,"34062",148,94,93,0,1,"PUM+J",0
40,"40157",39,30,30,0,0,"PUM+J",0
46,"46056",176,142,142,0,0,"PUM+J",0
50,"50154",114,92,92,1,0,"PUM+J",0
23,"23029",798,595,590,0,5,"PUM+J",0
18,"18127",17005,11790,11583,150,207,"PUM+J",19
30,"30024",60389,42200,41831,281,369,"PUM+J",15
19,"19304",224,169,166,3,3,"PUM+J",0
16,"16062",25,20,20,0,0,"PUM+J",0
3,"3129",1224,934,923,4,11,"PUM+J",2
5,"5016",6355,4677,4584,28,93,"PUM+J",6
9,"9403",103,79,78,1,1,"PUM+J",0
34,"34214",176,121,120,1,1,"PUM+J",0
6,"6146",1039,764,752,7,12,"PUM+J",0
42,"42092",61,40,39,0,1,"PUM+J",0
16,"16101",137,111,109,1,2,"PUM+J",0
49,"49242",439,342,336,2,6,"PUM+J",1
37,"37155",68,48,48,0,0,"PUM+J",0
50,"50163",3846,2863,2840,25,23,"PUM+J",2
37,"37354",5479,3969,3905,37,64,"PUM+J",10
44,"44071",585,419,418,6,1,"PUM+J",1
16,"16026",91,69,68,0,1,"PUM+J",0
11,"11025",4374,2808,2759,30,49,"PUM+J",3
9,"9235",144,107,105,0,2,"PUM+J",0
16,"16063",112,81,81,1,0,"PUM+J",0
14,"14053",5918,4054,3968,92,86,"PUM+J",1
28,"28021",571,365,364,1,1,"PUM+J",1
46,"46081",9999,7486,7412,47,74,"PUM+J",1
13,"13037",776,573,563,2,10,"PUM+J",1
10,"10055",697,488,473,3,15,"PUM+J",0
18,"18132",3101,2418,2382,23,36,"PUM+J",2
24,"24143",497,344,343,3,1,"PUM+J",0
24,"24104",243,167,166,0,1,"PUM+J",0
47,"47062",155,128,128,0,0,"PUM+J",0
9,"9238",931,473,461,1,12,"PUM+J",1
19,"19215",135,109,109,0,0,"PUM+J",0
24,"24032",99,70,66,1,4,"PUM+J",0
37,"37158",230,149,149,1,0,"PUM+J",0
46,"46150",1794,1276,1272,8,4,"PUM+J",0
9,"9295",52,36,35,1,1,"PUM+J",0
45,"45006",1334,866,858,1,8,"PUM+J",0
45,"45117",718,552,548,0,4,"PUM+J",2
39,"39016",23850,17235,17106,70,129,"PUM+J",6
6,"6058",1984,1372,1331,13,41,"PUM+J",0
49,"49206",776,515,504,7,11,"PUM+J",0
49,"49245",251,174,171,1,3,"PUM+J",1
26,"26027",139,99,97,0,2,"PUM+J",0
3,"3132",512,376,373,2,3,"PUM+J",0
26,"26142",789,572,564,6,8,"PUM+J",0
12,"12141",92,72,72,0,0,"PUM+J",0
50,"50029",594,432,431,3,1,"PUM+J",0
24,"24034",3466,2382,2359,25,23,"PUM+J",2
41,"41015",5426,3778,3639,41,139,"PUM+J",2
19,"19278",24,20,20,0,0,"PUM+J",0
40,"40161",32,24,23,1,1,"PUM+J",0
40,"40031",546,410,406,3,4,"PUM+J",0
46,"46105",16126,10958,10847,76,111,"PUM+J",10
45,"45082",1145,904,893,7,11,"PUM+J",0
34,"34116",54,35,35,0,0,"PUM+J",0
47,"47064",37,30,29,1,1,"PUM+J",0
46,"46219",125,107,104,0,3,"PUM+J",0
40,"40075",152,116,116,0,0,"PUM+J",0
34,"34086",102,81,81,2,0,"PUM+J",0
9,"9259",230,178,176,2,2,"PUM+J",0
19,"19187",42,32,32,0,0,"PUM+J",0
14,"14075",552,413,391,5,22,"PUM+J",0
16,"16146",85,49,49,0,0,"PUM+J",0
3,"3019",15501,11261,11106,86,155,"PUM+J",13
46,"46174",942,746,736,1,10,"PUM+J",1
47,"47004",1135,878,872,5,6,"PUM+J",0
22,"22084",571,400,391,5,9,"PUM+J",1
50,"50106",123,78,78,0,0,"PUM+J",0
37,"37317",287,211,209,1,2,"PUM+J",0
3,"3134",139,107,107,0,0,"PUM+J",0
37,"37160",597,380,370,3,10,"PUM+J",0
50,"50258",53,25,25,1,0,"PUM+J",0
4,"4092",2791,2058,2023,4,35,"PUM+J",2
37,"37059",117,95,95,3,0,"PUM+J",0
45,"45120",113,86,86,0,0,"PUM+J",0
23,"23037",518,403,398,10,5,"PUM+J",0
41,"41017",15907,11486,11302,158,184,"PUM+J",18
47,"47162",70,57,57,2,0,"PUM+J",0
49,"49102",182,130,130,2,0,"PUM+J",0
49,"49027",125,82,81,0,1,"PUM+J",1
42,"42100",30,24,24,1,0,"PUM+J",0
29,"29064",423,291,285,2,6,"PUM+J",0
10,"10061",1591,1010,992,9,18,"PUM+J",0
5,"5188",39,33,33,0,0,"PUM+J",0
49,"49210",447,350,348,3,2,"PUM+J",0
4,"4093",1916,1143,1130,5,13,"PUM+J",0
14,"14049",16185,11561,11323,145,238,"PUM+J",8
49,"49103",392,319,316,5,3,"PUM+J",1
22,"22202",147,128,128,3,0,"PUM+J",0
5,"5158",346,263,261,0,2,"PUM+J",0
47,"47226",148,115,115,1,0,"PUM+J",0
37,"37026",180,148,147,5,1,"PUM+J",0
40,"40045",119,93,93,1,0,"PUM+J",1
4,"4071",362,286,281,2,5,"PUM+J",0
9,"9083",26,21,21,0,0,"PUM+J",0
12,"12014",164,111,111,0,0,"PUM+J",0
19,"19124",378,230,229,2,1,"PUM+J",0
19,"19221",31,22,22,1,0,"PUM+J",0
10,"10063",159,130,130,0,0,"PUM+J",0
34,"34032",38,30,30,0,0,"PUM+J",0
9,"9195",57,40,40,0,0,"PUM+J",0
26,"26069",230,166,166,0,0,"PUM+J",2
11,"11002",4218,3176,3149,16,27,"PUM+J",0
50,"50109",95,65,62,2,3,"PUM+J",0
19,"19314",44,33,33,0,0,"PUM+J",0
34,"34225",5016,3708,3650,41,58,"PUM+J",3
4,"4095",687,462,457,4,5,"PUM+J",0
9,"9248",80,62,61,1,1,"PUM+J",0
22,"22203",77,62,62,2,0,"PUM+J",0
3,"3050",19420,13210,13116,70,94,"PUM+J",13
10,"10187",431,288,281,0,7,"PUM+J",0
46,"46200",1840,1475,1455,5,20,"PUM+J",2
41,"41093",19064,14867,14700,151,167,"PUM+J",23
40,"40166",251,201,201,0,0,"PUM+J",0
12,"12015",115,94,94,0,0,"PUM+J",0
34,"34077",395,282,278,7,4,"PUM+J",0
16,"16074",30,25,25,0,0,"PUM+J",0
16,"16193",55,50,49,0,1,"PUM+J",0
10,"10066",161,121,120,1,1,"PUM+J",0
49,"49219",7196,4613,4528,64,85,"PUM+J",6
10,"10188",483,354,340,0,14,"PUM+J",0
3,"3138",3190,2244,2207,9,37,"PUM+J",4
26,"26150",97,77,77,1,0,"PUM+J",0
46,"46064",532,395,387,3,8,"PUM+J",0
45,"45089",1432,1076,1064,10,12,"PUM+J",2
28,"28104",15528,12342,12234,103,108,"PUM+J",8
10,"10189",2499,1747,1700,15,47,"PUM+J",0
24,"24079",861,601,595,9,6,"PUM+J",0
16,"16038",27,20,20,0,0,"PUM+J",0
44,"44249",40,30,30,0,0,"PUM+J",0
19,"19318",26,18,18,0,0,"PUM+J",0
50,"50084",67,47,47,1,0,"PUM+J",0
9,"9110",77,50,50,0,0,"PUM+J",0
22,"22250",346,241,241,0,0,"PUM+J",1
19,"19172",51,38,38,0,0,"PUM+J",0
9,"9253",101,77,76,0,1,"PUM+J",0
46,"46251",2465,1938,1903,19,35,"PUM+J",1
42,"42110",54,43,43,0,0,"PUM+J",0
47,"47073",116,80,79,2,1,"PUM+J",0
40,"40017",83,71,68,2,3,"PUM+J",0
26,"26073",92,68,66,1,2,"PUM+J",0
3,"3053",7568,5551,5468,40,83,"PUM+J",11
24,"24155",441,340,334,2,6,"PUM+J",0
28,"28001",70,48,47,1,1,"PUM+J",0
12,"12099",597,444,436,6,8,"PUM+J",0
37,"37067",3278,2568,2529,30,39,"PUM+J",3
42,"42063",45,31,30,1,1,"PUM+J",0
37,"37261",213,153,149,0,4,"PUM+J",0
42,"42111",274,183,181,0,2,"PUM+J",0
46,"46134",2419,1697,1678,14,19,"PUM+J",2
16,"16079",28,16,16,0,0,"PUM+J",0
47,"47074",141,110,109,0,1,"PUM+J",0
38,"38052",1283,806,794,3,12,"PUM+J",1
30,"30035",19432,13174,13013,114,161,"PUM+J",5
50,"50037",125,85,80,0,5,"PUM+J",0
41,"41023",7999,5500,5435,60,65,"PUM+J",0
16,"16081",50,37,36,0,1,"PUM+J",2
9,"9256",330,221,219,0,2,"PUM+J",1
45,"45203",2777,1986,1961,18,25,"PUM+J",3
34,"34083",1647,1089,1080,2,9,"PUM+J",2
44,"44164",19,16,16,1,0,"PUM+J",0
10,"10193",1392,1045,1025,6,20,"PUM+J",2
47,"47013",91,77,77,1,0,"PUM+J",0
28,"28171",4410,2921,2889,8,32,"PUM+J",1
7,"7001",3647,2430,2383,26,47,"PUM+J",3
45,"45093",147,115,114,0,1,"PUM+J",0
10,"10071",126,78,71,0,7,"PUM+J",0
39,"39027",3045,2231,2199,23,32,"PUM+J",1
26,"26040",64,47,47,1,0,"PUM+J",0
46,"46253",112,84,84,0,0,"PUM+J",0
13,"13056",11706,8399,8288,88,111,"PUM+J",18
10,"10154",177,117,116,0,1,"PUM+J",0
44,"44075",321,255,252,1,3,"PUM+J",0
47,"47076",17787,13484,13306,179,178,"PUM+J",33
34,"34233",128,104,104,0,0,"PUM+J",1
24,"24169",2777,1908,1880,10,28,"PUM+J",1
40,"40183",117,105,99,1,6,"PUM+J",0
49,"49271",176,128,127,3,1,"PUM+J",0
9,"9258",165,128,127,0,1,"PUM+J",0
6,"6076",825,573,562,1,11,"PUM+J",0
18,"18177",375,235,231,5,4,"PUM+J",0
5,"5195",199,125,125,1,0,"PUM+J",0
19,"19167",129,104,103,1,1,"PUM+J",0
37,"37200",190,132,131,0,1,"PUM+J",0
34,"34234",66,48,45,0,3,"PUM+J",0
45,"45096",987,748,725,9,23,"PUM+J",0
50,"50192",227,182,181,0,1,"PUM+J",0
33,"33047",1068,771,759,9,12,"PUM+J",0
10,"10155",1073,735,717,6,18,"PUM+J",0
50,"50266",120,77,76,3,1,"PUM+J",0
46,"46182",1312,908,904,5,4,"PUM+J",0
5,"5166",155,108,104,1,4,"PUM+J",0
24,"24120",305,182,181,1,1,"PUM+J",0
5,"5197",100,82,79,1,3,"PUM+J",0
42,"42118",21,11,11,0,0,"PUM+J",0
22,"22002",99,81,81,0,0,"PUM+J",1
49,"49226",240,200,198,2,2,"PUM+J",0
4,"4901",490,343,343,2,0,"PUM+J",0
39,"39085",7017,5029,4992,23,37,"PUM+J",3
6,"6034",171,114,114,2,0,"PUM+J",0
41,"41027",4007,2628,2546,33,82,"PUM+J",6
9,"9262",160,122,120,2,2,"PUM+J",1
13,"13060",274,205,202,3,3,"PUM+J",1
6,"6079",649,451,445,3,6,"PUM+J",0
37,"37172",846,530,524,6,6,"PUM+J",1
5,"5198",70,53,51,0,2,"PUM+J",0
40,"40176",372,288,287,2,1,"PUM+J",1
40,"40077",966,718,704,10,14,"PUM+J",3
9,"9003",182,134,132,1,2,"PUM+J",0
44,"44226",123,85,84,0,1,"PUM+J",0
42,"42134",2651,1875,1836,21,39,"PUM+J",4
46,"46214",16637,12113,12014,84,99,"PUM+J",5
49,"49092",115,72,72,0,0,"PUM+J",0
42,"42071",159,92,92,2,0,"PUM+J",0
46,"46047",540,428,420,1,8,"PUM+J",1
45,"45036",638,455,449,1,6,"PUM+J",0
5,"5115",509,350,344,0,6,"PUM+J",0
5,"5104",33,21,19,0,2,"PUM+J",0
10,"10078",365,271,263,7,8,"PUM+J",1
46,"46002",1253,946,940,4,6,"PUM+J",0
22,"22214",117,92,89,0,3,"PUM+J",0
50,"50268",41,32,32,1,0,"PUM+J",0
50,"50041",16,10,10,0,0,"PUM+J",0
9,"9325",177,103,101,2,2,"PUM+J",0
26,"26046",1552,1056,1027,11,29,"PUM+J",0
42,"42121",54,39,39,0,0,"PUM+J",0
50,"50269",287,172,167,2,5,"PUM+J",0
39,"39088",59,40,40,2,0,"PUM+J",0
18,"18149",5408,3926,3859,42,67,"PUM+J",3
13,"13063",3648,2464,2406,28,58,"PUM+J",4
50,"50091",39,32,32,0,0,"PUM+J",0
41,"41085",4182,3258,3181,43,77,"PUM+J",2
42,"42076",200,149,143,2,6,"PUM+J",0
46,"46094",20805,15353,15211,122,142,"PUM+J",11
50,"50195",53,42,38,0,4,"PUM+J",0
37,"37174",975,716,705,2,11,"PUM+J",0
42,"42123",157,103,102,6,1,"PUM+J",0
7,"7008",6113,4003,3961,26,42,"PUM+J",5
47,"47019",92,68,68,1,0,"PUM+J",0
33,"33023",3249,2127,2097,30,30,"PUM+J",1
37,"37269",424,280,277,2,3,"PUM+J",0
9,"9433",52,40,40,0,0,"PUM+J",1
22,"22105",102,65,65,0,0,"PUM+J",0
47,"47209",32,23,23,0,0,"PUM+J",0
45,"45028",3613,2675,2647,22,28,"PUM+J",5
12,"12081",606,454,446,2,8,"PUM+J",0
19,"19037",131,109,108,0,1,"PUM+J",0
50,"50068",1943,1299,1287,10,12,"PUM+J",0
39,"39005",1419,1039,1030,9,9,"PUM+J",0
41,"41031",1204,780,769,5,11,"PUM+J",0
12,"12090",102,79,78,1,1,"PUM+J",0
46,"46087",109,94,94,2,0,"PUM+J",0
10,"10109",1714,1030,1006,4,24,"PUM+J",0
10,"10163",348,239,238,2,1,"PUM+J",0
46,"46118",3649,2730,2701,20,29,"PUM+J",2
50,"50019",63,46,46,0,0,"PUM+J",0
42,"42080",153,108,108,1,0,"PUM+J",0
34,"34110",75,64,64,0,0,"PUM+J",0
24,"24216",666,453,445,4,8,"PUM+J",0
45,"45139",144,111,111,0,0,"PUM+J",0
46,"46050",185,141,141,1,0,"PUM+J",0
40,"40148",231,165,163,4,2,"PUM+J",0
3,"3006",493,365,360,2,5,"PUM+J",1
24,"24166",1346,929,916,14,13,"PUM+J",4
9,"9272",251,166,166,1,0,"PUM+J",0
40,"40082",104,84,84,2,0,"PUM+J",0
9,"9438",562,447,437,6,10,"PUM+J",1
45,"45030",471,346,334,4,12,"PUM+J",0
46,"46210",338,256,251,0,5,"PUM+J",0
44,"44174",402,289,288,1,1,"PUM+J",0
22,"22009",581,387,386,7,1,"PUM+J",1
26,"26167",50,34,33,1,1,"PUM+J",0
37,"37079",77,59,59,1,0,"PUM+J",0
18,"18054",820,573,569,2,4,"PUM+J",0
47,"47179",368,256,254,2,2,"PUM+J",0
9,"9273",48,40,39,0,1,"PUM+J",0
24,"24094",1320,866,852,11,14,"PUM+J",0
9,"9221",498,380,377,8,3,"PUM+J",3
16,"16093",54,45,45,0,0,"PUM+J",0
7,"7011",28971,17082,16964,164,118,"PUM+J",13
44,"44264",254,170,170,0,0,"PUM+J",0
5,"5007",109,73,72,0,1,"PUM+J",0
4,"4008",466,374,371,3,3,"PUM+J",1
16,"16016",217,157,157,1,0,"PUM+J",0
40,"40083",73,52,52,1,0,"PUM+J",0
7,"7046",16884,9184,9097,97,87,"PUM+J",4
10,"10127",4691,3044,2974,34,70,"PUM+J",4
39,"39092",863,534,533,3,1,"PUM+J",1
26,"26169",66,51,50,0,1,"PUM+J",0
49,"49235",415,300,290,4,10,"PUM+J",0
10,"10207",455,298,291,0,7,"PUM+J",0
5,"5207",645,485,478,4,7,"PUM+J",0
9,"9441",94,76,76,0,0,"PUM+J",0
46,"46143",4274,3027,2995,19,32,"PUM+J",1
50,"50182",3657,2499,2485,23,14,"PUM+J",2
37,"37347",463,349,345,9,4,"PUM+J",0
42,"42028",75,57,56,0,1,"PUM+J",0
46,"46261",1708,1259,1237,12,22,"PUM+J",3
50,"50123",430,304,297,3,7,"PUM+J",0
10,"10005",527,325,301,1,24,"PUM+J",0
37,"37180",68,45,44,1,1,"PUM+J",0
16,"16132",33,25,25,1,0,"PUM+J",0
37,"37014",1140,747,737,7,10,"PUM+J",0
18,"18101",9449,6688,6568,77,120,"PUM+J",9
10,"10903",806,555,545,8,10,"PUM+J",0
40,"40152",732,575,565,10,10,"PUM+J",1
46,"46144",628,483,478,4,5,"PUM+J",2
29,"29071",980,580,564,11,16,"PUM+J",0
26,"26171",155,109,107,2,2,"PUM+J",0
44,"44266",102,81,79,0,2,"PUM+J",0
26,"26054",291,225,223,3,2,"PUM+J",0
37,"37119",99,78,78,1,0,"PUM+J",0
21,"21002",16070,11301,11137,132,164,"PUM+J",16
12,"12111",327,259,255,8,4,"PUM+J",0
26,"26172",25,16,15,0,1,"PUM+J",0
6,"6048",821,666,653,1,13,"PUM+J",1
18,"18157",1148,843,827,7,16,"PUM+J",1
26,"26055",39,30,30,0,0,"PUM+J",0
5,"5047",4105,3004,2936,23,68,"PUM+J",5
7,"7048",18455,9929,9858,116,71,"PUM+J",10
6,"6049",956,625,604,8,21,"PUM+J",2
3,"3011",8014,5278,5212,50,66,"PUM+J",7
50,"50251",8209,5732,5658,66,74,"PUM+J",3
24,"24172",389,208,202,1,6,"PUM+J",0
37,"37085",5060,3732,3689,52,43,"PUM+J",4
28,"28047",42984,30772,30486,270,286,"PUM+J",38
16,"16057",62,45,45,0,0,"PUM+J",0
5,"5177",136,117,116,0,1,"PUM+J",0
37,"37016",563,419,411,4,8,"PUM+J",0
49,"49053",919,676,661,8,15,"PUM+J",1
35,"35008",6214,4193,4143,33,50,"PUM+J",1
7,"7060",2713,1796,1772,17,24,"PUM+J",0
21,"21074",2736,1826,1790,19,36,"PUM+J",2
4,"4083",1727,1265,1250,8,15,"PUM+J",4
3,"3040",264,227,221,1,6,"PUM+J",0
9,"9137",187,129,127,0,2,"PUM+J",1
47,"47099",154,123,118,0,5,"PUM+J",0
42,"42135",69,40,40,1,0,"PUM+J",0
18,"18061",999,781,770,5,11,"PUM+J",0
49,"49093",280,226,223,5,3,"PUM+J",0
10,"10213",533,397,385,0,12,"PUM+J",1
44,"44236",60,38,38,0,0,"PUM+J",0
45,"45185",7573,5422,5320,31,102,"PUM+J",11
46,"46146",1647,1241,1229,12,12,"PUM+J",2
46,"46078",28484,19694,19520,173,174,"PUM+J",15
6,"6052",3962,2728,2642,26,86,"PUM+J",5
50,"50203",1065,817,804,5,13,"PUM+J",0
40,"40188",83,63,60,0,3,"PUM+J",0
19,"19045",122,97,96,0,1,"PUM+J",0
42,"42139",21,16,16,2,0,"PUM+J",0
19,"19241",35,26,25,2,1,"PUM+J",0
21,"21005",15754,9502,9340,84,162,"PUM+J",15
44,"44180",74,56,56,0,0,"PUM+J",0
9,"9125",555,386,382,4,4,"PUM+J",0
16,"16139",317,226,222,1,4,"PUM+J",0
6,"6053",592,441,428,7,13,"PUM+J",1
44,"44093",78,62,61,0,1,"PUM+J",0
44,"44122",1277,939,934,5,5,"PUM+J",0
10,"10215",438,266,262,2,4,"PUM+J",1
49,"49129",810,541,527,4,14,"PUM+J",1
9,"9448",203,159,157,0,2,"PUM+J",1
24,"24066",439,274,273,3,1,"PUM+J",0
29,"29002",1143,777,766,6,11,"PUM+J",1
4,"4016",2136,1486,1467,13,19,"PUM+J",3
50,"50027",223,166,161,2,5,"PUM+J",0
6,"6055",1976,1343,1313,11,30,"PUM+J",1
35,"35003",5644,2987,2943,20,44,"PUM+J",3
50,"50204",2396,1723,1712,17,11,"PUM+J",1
40,"40189",471,344,329,1,15,"PUM+J",0
45,"45040",1247,727,715,3,12,"PUM+J",1
9,"9072",331,261,260,4,1,"PUM+J",1
6,"6070",7668,5404,5228,59,176,"PUM+J",8
3,"3091",244,194,193,2,1,"PUM+J",0
49,"49084",266,197,195,11,2,"PUM+J",0
19,"19254",43,34,34,0,0,"PUM+J",0
14,"14015",2045,1465,1418,16,47,"PUM+J",0
39,"39043",1517,1167,1154,3,13,"PUM+J",0
3,"3071",4000,2858,2813,27,45,"PUM+J",4
24,"24189",5872,3915,3873,42,42,"PUM+J",3
5,"5128",339,258,253,5,5,"PUM+J",0
50,"50155",95,65,65,0,0,"PUM+J",0
24,"24177",467,265,263,2,2,"PUM+J",0
12,"12115",205,161,161,1,0,"PUM+J",0
16,"16228",173,147,145,2,2,"PUM+J",0
24,"24068",430,289,281,0,8,"PUM+J",0
4,"4017",1276,833,818,4,15,"PUM+J",0
46,"46149",350,252,249,3,3,"PUM+J",0
5,"5215",156,120,113,0,7,"PUM+J",0
45,"45079",355,250,250,0,0,"PUM+J",0
5,"5247",231,132,131,1,1,"PUM+J",0
2,"2007",1017,757,746,5,11,"PUM+J",2
3,"3072",352,281,277,3,4,"PUM+J",0
42,"42144",419,302,298,6,4,"PUM+J",1
50,"50156",212,156,151,2,5,"PUM+J",0
10,"10016",329,242,232,2,10,"PUM+J",0
10,"10139",92,66,65,1,1,"PUM+J",1
16,"16231",45,38,38,0,0,"PUM+J",0
10,"10098",387,272,267,0,5,"PUM+J",0
6,"6150",777,592,588,0,4,"PUM+J",3
37,"37346",251,208,207,1,1,"PUM+J",0
19,"19087",17,16,16,0,0,"PUM+J",0
16,"16186",403,309,305,3,4,"PUM+J",0
28,"28053",6956,5475,5414,44,61,"PUM+J",7
10,"10901",1161,758,753,1,5,"PUM+J",0
34,"34114",200,134,134,0,0,"PUM+J",0
33,"33064",240,151,151,0,0,"PUM+J",0
21,"21010",15011,8812,8694,174,118,"PUM+J",5
16,"16234",23,17,17,0,0,"PUM+J",0
9,"9297",310,233,233,6,0,"PUM+J",0
28,"28096",20022,14440,14238,115,202,"PUM+J",24
9,"9409",117,80,80,0,0,"PUM+J",0
42,"42096",244,132,129,2,3,"PUM+J",1
37,"37377",215,174,173,0,1,"PUM+J",1
9,"9077",26,21,21,0,0,"PUM+J",0
10,"10902",744,514,498,4,16,"PUM+J",1
40,"40204",145,102,101,0,1,"PUM+J",0
45,"45058",344,245,236,1,9,"PUM+J",1
47,"47054",599,465,460,1,5,"PUM+J",2
22,"22032",102,69,68,1,1,"PUM+J",0
39,"39028",3892,2905,2878,20,27,"PUM+J",2
46,"46242",326,260,257,3,3,"PUM+J",0
50,"50281",68,52,50,0,2,"PUM+J",0
49,"49025",157,121,118,0,3,"PUM+J",0
24,"24221",738,492,485,9,7,"PUM+J",1
9,"9374",93,75,72,2,3,"PUM+J",0
9,"9485",55,41,41,0,0,"PUM+J",0
19,"19051",61,52,52,0,0,"PUM+J",0
46,"46015",7519,5575,5532,34,43,"PUM+J",4
16,"16108",44,35,34,1,1,"PUM+J",0
2,"2077",52,41,41,0,0,"PUM+J",0
22,"22021",1884,1331,1319,26,12,"PUM+J",2
37,"37191",102,57,57,1,0,"PUM+J",0
40,"40099",54,44,42,0,2,"PUM+J",0
14,"14901",932,753,750,6,3,"PUM+J",1
6,"6154",2799,1851,1782,20,69,"PUM+J",3
6,"6063",2924,2141,2108,8,33,"PUM+J",4
40,"40065",467,338,329,1,9,"PUM+J",0
47,"47005",506,358,348,3,10,"PUM+J",2
45,"45010",383,258,257,3,1,"PUM+J",0
14,"14020",336,227,225,0,2,"PUM+J",0
42,"42018",127,94,94,1,0,"PUM+J",0
19,"19157",53,37,37,0,0,"PUM+J",0
29,"29082",34683,24751,24495,263,256,"PUM+J",28
49,"49137",167,123,121,0,2,"PUM+J",0
40,"40003",116,82,79,3,3,"PUM+J",0
6,"6064",847,616,601,3,15,"PUM+J",1
14,"14902",1113,877,851,15,26,"PUM+J",1
9,"9464",33,24,24,0,0,"PUM+J",0
46,"46221",348,292,290,1,2,"PUM+J",0
9,"9303",73,58,58,0,0,"PUM+J",0
37,"37060",283,205,202,1,3,"PUM+J",0
6,"6080",1898,1336,1307,6,29,"PUM+J",2
29,"29018",2009,1421,1362,17,59,"PUM+J",0
3,"3030",559,442,433,2,9,"PUM+J",0
33,"33039",1646,1118,1110,8,8,"PUM+J",0
10,"10049",3752,2949,2864,25,85,"PUM+J",6
14,"14030",7761,5711,5588,84,123,"PUM+J",7
34,"34060",133,109,107,0,2,"PUM+J",0
28,"28133",6146,4245,4180,25,65,"PUM+J",3
19,"19092",395,286,279,2,7,"PUM+J",0
9,"9084",165,116,111,1,5,"PUM+J",0
5,"5093",362,251,249,0,2,"PUM+J",1
37,"37351",268,229,226,0,3,"PUM+J",0
49,"49251",159,116,109,2,7,"PUM+J",0
18,"18170",317,212,209,0,3,"PUM+J",0
50,"50135",85,59,59,0,0,"PUM+J",0
22,"22165",449,305,300,3,5,"PUM+J",0
22,"22024",220,159,158,1,1,"PUM+J",0
40,"40198",24,20,19,0,1,"PUM+J",0
26,"26070",152,125,122,1,3,"PUM+J",0
5,"5222",140,118,118,0,0,"PUM+J",0
50,"50136",532,366,361,3,5,"PUM+J",0
28,"28102",880,639,621,7,18,"PUM+J",0
19,"19251",39,30,30,0,0,"PUM+J",0
45,"45124",2080,1628,1595,15,33,"PUM+J",1
46,"46018",562,442,436,2,6,"PUM+J",0
16,"16112",1466,972,957,12,15,"PUM+J",1
40,"40231",100,79,76,0,3,"PUM+J",0
37,"37228",324,262,262,1,0,"PUM+J",0
42,"42198",19,9,9,1,0,"PUM+J",0
47,"47101",1634,1278,1262,7,16,"PUM+J",3
28,"28030",1832,1319,1297,13,22,"PUM+J",3
22,"22127",521,353,352,5,1,"PUM+J",3
47,"47009",98,84,84,0,0,"PUM+J",0
22,"22025",1022,705,694,14,11,"PUM+J",2
46,"46250",582242,437146,434438,3315,2708,"PUM+J",327
12,"12044",442,371,368,1,3,"PUM+J",0
6,"6114",127,105,105,0,0,"PUM+J",0
46,"46041",313,229,228,1,1,"PUM+J",0
42,"42171",111,72,71,1,1,"PUM+J",0
38,"38034",3997,2687,2648,19,39,"PUM+J",3
9,"9418",73,54,51,0,3,"PUM+J",0
42,"42215",723,468,452,10,16,"PUM+J",1
26,"26023",433,316,314,3,2,"PUM+J",0
47,"47071",396,321,316,5,5,"PUM+J",0
46,"46209",1903,1406,1383,5,23,"PUM+J",0
42,"42024",84,64,62,1,2,"PUM+J",0
12,"12045",333,243,235,2,8,"PUM+J",1
37,"37197",88,53,53,1,0,"PUM+J",0
37,"37041",71,53,53,0,0,"PUM+J",0
5,"5075",96,76,76,0,0,"PUM+J",0
46,"46179",2136,1624,1596,17,28,"PUM+J",2
37,"37291",269,186,185,1,1,"PUM+J",0
41,"41078",2445,1722,1689,12,33,"PUM+J",1
7,"7065",2319,1429,1411,15,18,"PUM+J",1
24,"24228",619,370,364,2,6,"PUM+J",0
10,"10110",2226,1431,1400,7,31,"PUM+J",3
45,"45017",264,199,196,4,3,"PUM+J",0
18,"18107",920,643,626,1,17,"PUM+J",0
21,"21028",370,265,259,2,6,"PUM+J",0
18,"18076",789,534,532,2,2,"PUM+J",0
40,"40202",56,33,33,0,0,"PUM+J",0
46,"46157",2959,2145,2126,11,19,"PUM+J",1
37,"37198",202,147,144,2,3,"PUM+J",0
4,"4030",1052,690,678,6,12,"PUM+J",0
49,"49034",408,282,281,2,1,"PUM+J",0
12,"12046",188,135,135,4,0,"PUM+J",0
24,"24082",847,615,608,16,7,"PUM+J",0
16,"16246",451,327,322,1,5,"PUM+J",0
19,"19059",73,47,47,0,0,"PUM+J",0
50,"50165",1768,1255,1222,20,33,"PUM+J",3
16,"16117",1018,723,715,9,8,"PUM+J",2
37,"37199",128,92,92,2,0,"PUM+J",0
40,"40203",987,753,740,13,13,"PUM+J",2
47,"47139",997,728,719,4,9,"PUM+J",0
44,"44016",424,299,297,1,2,"PUM+J",0
41,"41052",3032,2162,2092,6,70,"PUM+J",1
47,"47200",70,60,60,0,0,"PUM+J",1
47,"47044",323,273,270,4,3,"PUM+J",1
24,"24011",182,104,102,3,2,"PUM+J",0
18,"18176",242,164,161,2,3,"PUM+J",0
49,"49035",220,180,180,4,0,"PUM+J",0
46,"46022",15392,10624,10546,69,78,"PUM+J",11
5,"5228",168,99,98,0,1,"PUM+J",0
34,"34041",82,64,64,3,0,"PUM+J",0
49,"49259",79,59,59,0,0,"PUM+J",0
45,"45069",1820,1370,1355,1,15,"PUM+J",0
9,"9062",40,34,33,0,1,"PUM+J",0
18,"18134",6104,4049,3972,39,77,"PUM+J",9
30,"30020",6503,4521,4484,35,37,"PUM+J",0
10,"10168",320,210,206,1,4,"PUM+J",0
50,"50167",208,166,163,1,3,"PUM+J",0
19,"19227",68,42,41,1,1,"PUM+J",0
35,"35015",10752,5289,5222,39,67,"PUM+J",3
46,"46159",23038,16719,16596,127,123,"PUM+J",11
49,"49171",603,433,427,4,6,"PUM+J",0
37,"37190",189,141,139,1,2,"PUM+J",0
50,"50141",104,80,78,0,2,"PUM+J",0
9,"9317",20,18,18,0,0,"PUM+J",0
49,"49184",172,110,107,2,3,"PUM+J",0
23,"23048",817,605,599,4,6,"PUM+J",0
49,"49183",90,67,65,2,2,"PUM+J",0
46,"46068",345,283,279,2,4,"PUM+J",1
26,"26005",2483,1589,1570,13,19,"PUM+J",2
26,"26017",364,274,269,2,5,"PUM+J",0
12,"12059",220,183,183,2,0,"PUM+J",0
37,"37213",83,64,64,0,0,"PUM+J",0
3,"3001",337,260,258,0,2,"PUM+J",0
4,"4034",169,91,91,1,0,"PUM+J",0
37,"37108",98,75,75,3,0,"PUM+J",0
22,"22035",225,153,152,1,1,"PUM+J",0
26,"26079",633,503,499,2,4,"PUM+J",1
42,"42165",414,246,237,4,9,"PUM+J",1
44,"44197",51,35,35,1,0,"PUM+J",0
29,"29017",6404,4575,4468,48,107,"PUM+J",5
18,"18112",104,68,66,2,2,"PUM+J",0
11,"11011",1726,1124,1084,8,40,"PUM+J",0
22,"22136",749,524,518,5,6,"PUM+J",0
47,"47016",65,55,55,0,0,"PUM+J",0
37,"37006",116,71,70,3,1,"PUM+J",0
9,"9214",632,409,407,2,2,"PUM+J",2
37,"37120",98,78,76,0,2,"PUM+J",0
47,"47122",2007,1520,1492,8,28,"PUM+J",2
46,"46263",235,182,180,2,2,"PUM+J",0
19,"19239",93,70,70,1,0,"PUM+J",0
9,"9035",284,191,190,2,1,"PUM+J",0
6,"6005",1694,1167,1139,9,28,"PUM+J",0
44,"44246",1599,1012,1001,11,11,"PUM+J",1
11,"11022",48785,24758,24422,398,336,"PUM+J",28
28,"28038",5213,3801,3753,24,48,"PUM+J",4
23,"23086",11427,7984,7735,81,249,"PUM+J",10
45,"45025",1218,849,844,9,5,"PUM+J",0
37,"37110",104,81,79,1,2,"PUM+J",0
24,"24198",541,346,344,6,2,"PUM+J",0
50,"50218",112,88,88,1,0,"PUM+J",0
6,"6082",399,295,291,6,4,"PUM+J",1
49,"49187",1197,839,819,12,20,"PUM+J",0
44,"44113",74,51,51,0,0,"PUM+J",0
49,"49152",474,289,282,2,7,"PUM+J",1
37,"37299",230,148,147,0,1,"PUM+J",0
29,"29019",853,604,588,2,16,"PUM+J",2
24,"24090",323,200,200,2,0,"PUM+J",0
11,"11013",2352,1564,1522,13,42,"PUM+J",1
44,"44260",137,93,93,1,0,"PUM+J",1
35,"35025",1752,1113,1095,5,18,"PUM+J",1
10,"10134",550,361,354,1,7,"PUM+J",0
5,"5170",47,34,34,1,0,"PUM+J",0
9,"9906",1185,883,877,16,6,"PUM+J",1
50,"50067",13928,9831,9699,92,132,"PUM+J",13
5,"5234",45,38,38,0,0,"PUM+J",1
45,"45137",1541,1007,998,8,9,"PUM+J",1
2,"2026",834,644,633,4,11,"PUM+J",1
16,"16140",18,14,14,1,0,"PUM+J",0
23,"23101",351,238,238,3,0,"PUM+J",0
39,"39033",536,375,372,1,3,"PUM+J",0
16,"16126",720,552,545,3,7,"PUM+J",0
49,"49231",288,208,203,0,5,"PUM+J",0
4,"4005",534,422,419,3,3,"PUM+J",0
18,"18150",6964,4717,4622,51,95,"PUM+J",5
13,"13034",58768,42473,42028,359,445,"PUM+J",117
9,"9024",150,100,99,1,1,"PUM+J",0
16,"16163",64,51,51,0,0,"PUM+J",0
41,"41068",13963,9596,9407,96,189,"PUM+J",9
37,"37165",31,22,22,0,0,"PUM+J",0
37,"37334",71,30,30,0,0,"PUM+J",0
47,"47229",221,150,149,0,1,"PUM+J",0
10,"10082",1793,1333,1305,11,28,"PUM+J",2
24,"24056",2726,1803,1772,21,31,"PUM+J",1
40,"40179",620,500,490,3,10,"PUM+J",0
18,"18194",2038,1373,1348,12,25,"PUM+J",2
3,"3100",499,384,378,0,6,"PUM+J",0
37,"37250",325,212,211,0,1,"PUM+J",0
5,"5041",984,743,732,5,11,"PUM+J",2
6,"6087",1999,1472,1455,13,17,"PUM+J",0
3,"3092",6712,4924,4858,35,66,"PUM+J",9
37,"37302",262,161,161,2,0,"PUM+J",0
10,"10124",867,622,612,1,10,"PUM+J",0
18,"18183",623,380,376,0,4,"PUM+J",1
49,"49268",364,266,263,3,3,"PUM+J",0
12,"12009",17943,12389,12292,102,97,"PUM+J",12
42,"42081",126,88,88,0,0,"PUM+J",0
42,"42174",174,121,118,4,3,"PUM+J",0
19,"19264",33,25,25,0,0,"PUM+J",0
16,"16130",533,407,404,0,3,"PUM+J",0
50,"50222",1574,1024,1008,12,16,"PUM+J",0
50,"50070",50,30,29,0,1,"PUM+J",0
16,"16263",967,724,721,3,3,"PUM+J",2
45,"45141",848,626,615,0,11,"PUM+J",1
50,"50296",385,240,235,3,5,"PUM+J",0
10,"10165",252,204,201,3,3,"PUM+J",1
5,"5206",26,17,17,0,0,"PUM+J",0
34,"34246",68,52,52,0,0,"PUM+J",0
10,"10125",859,561,546,3,15,"PUM+J",0
5,"5238",728,529,525,1,4,"PUM+J",0
39,"39036",965,707,703,4,4,"PUM+J",0
23,"23093",3119,2264,2216,24,48,"PUM+J",3
12,"12002",114,96,94,1,2,"PUM+J",0
5,"5044",244,170,170,1,0,"PUM+J",0
19,"19143",1781,1278,1266,18,12,"PUM+J",2
37,"37366",40,34,33,2,1,"PUM+J",0
40,"40214",198,160,154,0,6,"PUM+J",1
28,"28119",2294,1760,1738,12,22,"PUM+J",1
37,"37209",415,276,275,2,1,"PUM+J",0
34,"34202",28,23,23,2,0,"PUM+J",0
50,"50174",80,58,57,0,1,"PUM+J",0
37,"37013",104,72,70,2,2,"PUM+J",0
6,"6015",118127,79482,78553,855,929,"PUM+J",229
22,"22199",6884,4438,4384,71,54,"PUM+J",5
28,"28109",1651,1131,1116,8,15,"PUM+J",0
42,"42068",77,58,57,0,1,"PUM+J",1
24,"24901",853,517,513,4,4,"PUM+J",0
46,"46166",8214,6093,6031,38,62,"PUM+J",3
5,"5078",95,78,78,2,0,"PUM+J",0
38,"38013",3011,1850,1829,14,21,"PUM+J",1
10,"10045",971,686,682,4,4,"PUM+J",2
22,"22001",212,147,146,0,1,"PUM+J",0
26,"26077",16,16,16,0,0,"PUM+J",0
9,"9190",86,58,54,2,4,"PUM+J",0
19,"19089",23,17,17,0,0,"PUM+J",0
35,"35022",51765,29309,29034,184,275,"PUM+J",22
18,"18089",14504,9854,9746,100,108,"PUM+J",12
21,"21032",1827,1337,1314,13,23,"PUM+J",0
9,"9018",24624,17232,16983,192,249,"PUM+J",60
12,"12135",36287,25912,25655,184,257,"PUM+J",36
9,"9033",80,64,63,1,1,"PUM+J",1
42,"42193",14,7,7,0,0,"PUM+J",0
18,"18167",1839,1243,1224,9,19,"PUM+J",0
46,"46167",342,240,239,0,1,"PUM+J",0
37,"37083",181,155,153,1,2,"PUM+J",0
13,"13074",943,759,749,5,10,"PUM+J",0
42,"42004",2290,1595,1565,30,30,"PUM+J",1
49,"49091",246,168,167,1,1,"PUM+J",0
22,"22223",77,60,59,2,1,"PUM+J",0
33,"33001",1475,758,753,15,5,"PUM+J",0
24,"24171",337,136,134,4,2,"PUM+J",1
9,"9120",41,34,33,3,1,"PUM+J",0
14,"14012",6046,4215,4120,56,95,"PUM+J",2
16,"16270",154,123,122,1,1,"PUM+J",0
23,"23026",3431,2430,2375,25,55,"PUM+J",2
35,"35023",11742,7787,7651,95,136,"PUM+J",9
19,"19113",454,327,322,4,5,"PUM+J",1
16,"16218",184,134,133,1,1,"PUM+J",0
29,"29036",614,393,387,1,6,"PUM+J",0
45,"45048",360,276,271,2,5,"PUM+J",0
50,"50090",134,96,96,0,0,"PUM+J",0
5,"5058",71,45,43,0,2,"PUM+J",0
10,"10212",1658,1113,1068,19,45,"PUM+J",3
46,"46255",3220,2361,2340,20,21,"PUM+J",4
14,"14002",10895,7599,7479,109,120,"PUM+J",7
11,"11032",54731,31560,31284,492,276,"PUM+J",26
4,"4050",742,465,464,0,1,"PUM+J",0
46,"46032",5719,4297,4262,35,35,"PUM+J",2
16,"16219",81,58,58,0,0,"PUM+J",0
18,"18124",355,232,231,1,1,"PUM+J",0
19,"19044",275,186,182,0,4,"PUM+J",0
28,"28166",357,281,276,1,5,"PUM+J",0
45,"45184",204,123,122,0,1,"PUM+J",1
13,"13077",3383,2050,1997,20,53,"PUM+J",3
19,"19181",50,34,34,0,0,"PUM+J",1
3,"3013",1063,809,794,3,15,"PUM+J",0
24,"24213",158,127,126,1,1,"PUM+J",0
44,"44237",367,267,262,0,5,"PUM+J",0
37,"37215",133,93,90,1,3,"PUM+J",3
40,"40219",573,382,366,5,16,"PUM+J",1
44,"44209",799,584,573,2,11,"PUM+J",0
44,"44068",634,497,493,2,4,"PUM+J",1
47,"47039",162,119,117,0,2,"PUM+J",0
33,"33032",11056,7052,6905,109,147,"PUM+J",7
39,"39041",1753,1285,1269,7,16,"PUM+J",0
6,"6099",1156,683,652,5,31,"PUM+J",0
9,"9231",57,35,35,2,0,"PUM+J",0
45,"45039",201,157,157,0,0,"PUM+J",0
46,"46170",3417,2618,2577,11,41,"PUM+J",1
23,"23004",407,321,315,2,6,"PUM+J",0
39,"39051",73,64,64,1,0,"PUM+J",0
34,"34020",49,37,37,1,0,"PUM+J",0
5,"5051",157,117,115,1,2,"PUM+J",0
16,"16225",55,30,30,0,0,"PUM+J",0
47,"47060",224,171,168,1,3,"PUM+J",0
3,"3042",1475,1053,1043,7,10,"PUM+J",2
24,"24006",488,356,347,4,9,"PUM+J",0
5,"5171",67,49,47,0,2,"PUM+J",0
14,"14043",7406,5323,5211,63,112,"PUM+J",2
5,"5191",121,99,99,0,0,"PUM+J",0
37,"37270",184,139,136,2,3,"PUM+J",0
22,"22080",263,188,184,3,4,"PUM+J",0
9,"9270",157,112,109,2,3,"PUM+J",0
18,"18140",42474,26967,26648,225,319,"PUM+J",30
47,"47137",29,25,25,0,0,"PUM+J",0
12,"12064",80,71,69,0,2,"PUM+J",0
37,"37031",329,241,238,3,3,"PUM+J",0
40,"40039",180,133,133,0,0,"PUM+J",0
22,"22170",672,460,456,5,4,"PUM+J",0
18,"18163",311,206,204,0,2,"PUM+J",0
37,"37313",535,395,394,1,1,"PUM+J",0
9,"9129",91,74,74,0,0,"PUM+J",0
3,"3016",88,66,66,0,0,"PUM+J",0
40,"40159",130,94,93,2,1,"PUM+J",0
6,"6102",1027,834,815,3,19,"PUM+J",1
44,"44062",31,20,20,0,0,"PUM+J",0
26,"26126",29,27,27,0,0,"PUM+J",0
33,"33062",385,194,187,4,7,"PUM+J",0
5,"5086",76,58,58,1,0,"PUM+J",0
29,"29060",665,454,450,1,4,"PUM+J",0
16,"16143",15,10,10,1,0,"PUM+J",0
10,"10138",527,386,379,2,7,"PUM+J",0
39,"39072",325,184,182,0,2,"PUM+J",0
19,"19154",58,45,45,0,0,"PUM+J",0
23,"23066",4274,3517,3460,16,57,"PUM+J",4
41,"41070",6451,4715,4632,70,83,"PUM+J",3
26,"26063",118,88,88,2,0,"PUM+J",0
50,"50054",55,37,37,2,0,"PUM+J",0
28,"28022",37338,30620,30455,229,165,"PUM+J",44
47,"47063",86,68,68,0,0,"PUM+J",0
5,"5087",147,108,107,3,1,"PUM+J",0
44,"44155",1063,779,778,3,1,"PUM+J",0
11,"11028",32829,21934,21654,310,280,"PUM+J",24
12,"12067",514,381,373,3,8,"PUM+J",0
41,"41071",5571,3608,3516,64,92,"PUM+J",4
47,"47128",53,45,43,0,2,"PUM+J",0
40,"40129",159,119,117,2,2,"PUM+J",0
23,"23905",1828,1320,1302,12,18,"PUM+J",2
47,"47129",855,660,648,7,12,"PUM+J",3
50,"50132",780,549,538,7,11,"PUM+J",4
37,"37092",1933,1342,1327,13,15,"PUM+J",2
49,"49061",143,98,97,1,1,"PUM+J",0
26,"26064",2335,1617,1584,28,33,"PUM+J",1
14,"14028",302,241,240,3,1,"PUM+J",0
37,"37327",179,148,147,2,1,"PUM+J",0
28,"28074",141137,106626,105602,885,1024,"PUM+J",102
28,"28086",5446,3643,3600,19,43,"PUM+J",2
50,"50273",33,24,24,1,0,"PUM+J",0
50,"50241",582,414,406,2,8,"PUM+J",0
49,"49112",118,72,72,2,0,"PUM+J",2
47,"47130",94,64,63,0,1,"PUM+J",0
45,"45046",2369,1679,1651,11,28,"PUM+J",2
47,"47150",253,193,187,3,6,"PUM+J",0
45,"45155",311,240,240,0,0,"PUM+J",0
40,"40043",1773,1376,1345,21,31,"PUM+J",0
37,"37035",162,115,115,1,0,"PUM+J",0
7,"7058",2866,2013,1996,24,17,"PUM+J",1
14,"14048",1199,883,866,4,17,"PUM+J",0
50,"50031",134,78,75,0,3,"PUM+J",0
49,"49063",303,228,227,3,1,"PUM+J",0
18,"18904",741,500,498,1,2,"PUM+J",0
33,"33028",1143,519,518,7,1,"PUM+J",1
50,"50224",61,44,44,2,0,"PUM+J",0
22,"22149",301,211,210,1,1,"PUM+J",0
34,"34221",168,129,127,2,2,"PUM+J",1
37,"37255",43,33,31,1,2,"PUM+J",0
2,"2044",1040,665,656,5,9,"PUM+J",0
50,"50032",243,167,164,3,3,"PUM+J",0
9,"9244",45,31,31,2,0,"PUM+J",0
24,"24149",149,123,123,0,0,"PUM+J",0
50,"50184",87,70,70,0,0,"PUM+J",0
3,"3135",195,134,131,1,3,"PUM+J",0
50,"50008",5187,3334,3288,37,46,"PUM+J",2
4,"4060",416,286,282,2,4,"PUM+J",0
46,"46107",1857,1421,1402,4,19,"PUM+J",2
26,"26107",86,65,64,1,1,"PUM+J",0
21,"21043",1853,1354,1325,23,29,"PUM+J",0
37,"37224",189,156,153,2,3,"PUM+J",0
28,"28057",1556,1155,1141,7,14,"PUM+J",2
42,"42119",141,78,78,1,0,"PUM+J",0
45,"45061",2490,1690,1669,9,21,"PUM+J",3
46,"46077",7338,5447,5356,44,91,"PUM+J",4
40,"40122",524,398,392,2,6,"PUM+J",0
41,"41083",1145,821,814,6,7,"PUM+J",2
30,"30038",15752,10987,10904,39,83,"PUM+J",5
50,"50193",664,487,475,4,12,"PUM+J",3
44,"44208",27,17,17,0,0,"PUM+J",0
46,"46199",5878,4217,4182,21,35,"PUM+J",2
10,"10185",558,376,374,2,2,"PUM+J",1
6,"6111",487,318,314,2,4,"PUM+J",0
26,"26108",309,240,231,2,9,"PUM+J",0
37,"37193",362,253,252,4,1,"PUM+J",0
4,"4903",4320,2907,2873,18,34,"PUM+J",2
23,"23039",2170,1502,1460,10,42,"PUM+J",0
19,"19190",2284,1632,1613,16,19,"PUM+J",5
39,"39078",1410,1004,997,5,7,"PUM+J",0
18,"18010",527,398,394,5,4,"PUM+J",0
50,"50009",97,61,61,1,0,"PUM+J",0
4,"4062",4457,3241,3197,22,44,"PUM+J",3
37,"37132",317,211,207,0,4,"PUM+J",1
12,"12071",1272,936,925,3,11,"PUM+J",0
37,"37320",85,65,64,1,1,"PUM+J",0
37,"37342",250,190,189,3,1,"PUM+J",0
10,"10051",421,316,308,0,8,"PUM+J",0
3,"3109",3003,2186,2151,14,35,"PUM+J",0
9,"9038",109,87,86,1,1,"PUM+J",0
19,"19222",95,70,70,2,0,"PUM+J",0
18,"18042",417,332,330,4,2,"PUM+J",2
22,"22088",143,98,97,1,1,"PUM+J",0
4,"4064",2878,1937,1924,16,13,"PUM+J",5
10,"10201",178,142,141,2,1,"PUM+J",0
45,"45076",574,361,357,1,4,"PUM+J",1
12,"12072",1083,852,827,10,25,"PUM+J",2
37,"37322",2462,1580,1537,14,43,"PUM+J",3
6,"6069",2985,1921,1874,17,47,"PUM+J",2
11,"11034",2319,1520,1487,17,33,"PUM+J",0
38,"38025",7065,4657,4590,34,67,"PUM+J",3
46,"46163",1883,1471,1460,8,11,"PUM+J",0
26,"26177",306,233,229,2,4,"PUM+J",0
22,"22007",751,527,520,1,7,"PUM+J",1
45,"45027",315,249,246,2,3,"PUM+J",0
34,"34066",54,47,47,1,0,"PUM+J",0
50,"50245",74,51,51,0,0,"PUM+J",1
34,"34094",61,45,45,2,0,"PUM+J",0
10,"10122",219,159,157,2,2,"PUM+J",0
49,"49232",85,64,64,0,0,"PUM+J",2
6,"6116",1500,1015,998,7,17,"PUM+J",1
6,"6071",238,192,187,2,5,"PUM+J",1
19,"19082",100,72,71,1,1,"PUM+J",0
19,"19002",55,45,45,0,0,"PUM+J",0
38,"38027",5581,3577,3533,22,44,"PUM+J",2
26,"26113",29,28,28,0,0,"PUM+J",0
6,"6026",804,578,562,5,16,"PUM+J",0
23,"23043",517,360,360,1,0,"PUM+J",0
47,"47168",30,26,26,1,0,"PUM+J",0
50,"50901",133,96,96,0,0,"PUM+J",0
37,"37135",1146,849,837,5,12,"PUM+J",0
14,"14072",983,692,680,6,12,"PUM+J",0
44,"44145",974,698,697,3,1,"PUM+J",0
19,"19023",119,87,85,0,2,"PUM+J",1
4,"4099",4930,3526,3462,22,64,"PUM+J",4
50,"50113",587,471,461,2,10,"PUM+J",0
5,"5064",101,77,77,0,0,"PUM+J",0
5,"5163",1702,1258,1233,5,25,"PUM+J",1
2,"2018",789,611,606,3,5,"PUM+J",2
39,"39054",4541,3271,3252,30,19,"PUM+J",2
24,"24010",8251,5357,5275,40,82,"PUM+J",4
26,"26114",72,61,61,0,0,"PUM+J",0
33,"33016",18848,12845,12737,173,108,"PUM+J",5
9,"9423",27,24,24,1,0,"PUM+J",0
6,"6120",3370,2507,2460,11,47,"PUM+J",3
23,"23008",1422,1042,1020,9,22,"PUM+J",1
3,"3027",167,142,138,1,4,"PUM+J",0
50,"50264",151,111,110,0,1,"PUM+J",0
47,"47232",96,67,65,0,2,"PUM+J",0
12,"12075",110,85,83,3,2,"PUM+J",1
41,"41080",1231,832,815,14,17,"PUM+J",1
3,"3055",5265,3741,3697,16,44,"PUM+J",3
37,"37325",88,63,63,0,0,"PUM+J",0
2,"2019",2352,1806,1766,9,40,"PUM+J",6
9,"9046",23,17,17,0,0,"PUM+J",0
33,"33018",2804,1830,1806,30,24,"PUM+J",4
5,"5165",361,266,261,4,5,"PUM+J",1
47,"47140",106,83,83,0,0,"PUM+J",1
47,"47023",3057,2369,2359,20,10,"PUM+J",5
13,"13070",747,575,556,7,19,"PUM+J",2
23,"23067",2405,1765,1724,14,41,"PUM+J",1
50,"50166",235,186,186,0,0,"PUM+J",0
23,"23046",2334,1880,1855,9,25,"PUM+J",0
29,"29025",41540,27170,26897,271,273,"PUM+J",25
9,"9063",215,184,181,2,3,"PUM+J",0
16,"16119",175,117,115,0,2,"PUM+J",0
16,"16278",61,45,45,0,0,"PUM+J",0
19,"19061",56,42,41,0,1,"PUM+J",0
41,"41072",4031,2969,2933,15,36,"PUM+J",1
14,"14019",6380,4933,4831,71,102,"PUM+J",9
41,"41081",30061,21488,21059,331,429,"PUM+J",24
37,"37264",56,39,39,0,0,"PUM+J",0
23,"23010",14264,9801,9635,120,166,"PUM+J",14
40,"40141",822,584,568,9,16,"PUM+J",1
49,"49078",138,113,109,4,4,"PUM+J",0
26,"26030",18,18,17,1,1,"PUM+J",0
29,"29063",305,244,242,2,2,"PUM+J",0
22,"22085",94,78,76,0,2,"PUM+J",0
42,"42132",140,102,101,2,1,"PUM+J",0
37,"37306",238,140,136,3,4,"PUM+J",0
49,"49185",156,120,116,0,4,"PUM+J",0
34,"34046",43,29,29,0,0,"PUM+J",0
38,"38031",29301,20926,20701,157,225,"PUM+J",14
23,"23011",2138,1536,1507,17,29,"PUM+J",1
44,"44225",105,82,81,2,1,"PUM+J",0
3,"3116",1155,819,805,5,14,"PUM+J",2
34,"34135",398,267,264,4,3,"PUM+J",0
49,"49038",88,63,58,1,5,"PUM+J",0
9,"9377",626,468,460,6,8,"PUM+J",1
28,"28144",6525,5032,4987,39,45,"PUM+J",5
14,"14031",556,462,456,5,6,"PUM+J",0
42,"42073",73,56,55,0,1,"PUM+J",0
5,"5145",43,28,28,0,0,"PUM+J",0
41,"41008",1044,788,766,3,22,"PUM+J",1
13,"13090",1005,754,733,4,21,"PUM+J",0
50,"50243",307,227,224,2,3,"PUM+J",0
6,"6095",9506,6616,6425,109,191,"PUM+J",19
50,"50040",82,66,66,1,0,"PUM+J",0
9,"9473",85,68,64,0,4,"PUM+J",0
22,"22003",135,107,107,0,0,"PUM+J",0
19,"19302",52,42,42,1,0,"PUM+J",0
12,"12006",177,133,133,2,0,"PUM+J",0
40,"40906",2149,1701,1662,18,39,"PUM+J",2
18,"18915",726,474,467,4,7,"PUM+J",0
19,"19135",90,71,69,1,2,"PUM+J",0
12,"12088",57,53,53,0,0,"PUM+J",0
19,"19105",2550,1913,1889,10,24,"PUM+J",7
4,"4073",327,224,223,0,1,"PUM+J",0
34,"34240",84,67,66,1,1,"PUM+J",0
13,"13017",240,178,176,0,2,"PUM+J",0
39,"39059",7518,5327,5287,23,40,"PUM+J",1
34,"34049",329,229,227,1,2,"PUM+J",1
2,"2025",7345,5388,5278,51,110,"PUM+J",18
11,"11901",5739,3759,3686,99,73,"PUM+J",2
34,"34189",53,33,33,0,0,"PUM+J",0
28,"28167",8640,6564,6504,51,60,"PUM+J",5
13,"13093",3901,2617,2569,16,48,"PUM+J",3
33,"33060",13991,8629,8481,109,148,"PUM+J",5
10,"10160",240,179,177,2,2,"PUM+J",0
6,"6129",577,438,416,1,22,"PUM+J",0
28,"28070",105,80,80,3,0,"PUM+J",0
50,"50144",31,24,24,0,0,"PUM+J",0
34,"34190",50,33,33,1,0,"PUM+J",0
24,"24030",4158,2746,2696,18,50,"PUM+J",2
14,"14052",9039,5579,5478,79,101,"PUM+J",4
4,"4086",1631,1128,1114,3,14,"PUM+J",2
10,"10202",583,457,453,1,4,"PUM+J",3
22,"22068",64,41,41,1,0,"PUM+J",0
47,"47020",270,212,207,5,5,"PUM+J",0
22,"22249",125,93,92,1,1,"PUM+J",0
34,"34109",60,34,34,0,0,"PUM+J",0
26,"26047",1852,1449,1434,6,15,"PUM+J",1
9,"9232",139,100,97,1,3,"PUM+J",0
12,"12008",228,195,194,1,1,"PUM+J",0
21,"21057",995,600,590,8,10,"PUM+J",0
37,"37185",539,372,363,2,9,"PUM+J",1
5,"5901",247,154,152,3,2,"PUM+J",0
46,"46186",19689,14688,14576,118,112,"PUM+J",15
30,"30028",6390,4054,3973,25,81,"PUM+J",1
9,"9434",1279,966,956,11,10,"PUM+J",1
41,"41050",5173,3954,3878,36,76,"PUM+J",0
30,"30033",10377,7330,7215,59,115,"PUM+J",5
24,"24103",274,134,134,0,0,"PUM+J",0
42,"42012",29,22,22,0,0,"PUM+J",0
45,"45151",544,413,409,0,4,"PUM+J",1
16,"16258",172,124,119,0,5,"PUM+J",0
37,"37145",236,173,170,3,3,"PUM+J",0
3,"3120",2433,1688,1652,13,36,"PUM+J",1
9,"9220",69,52,52,3,0,"PUM+J",0
9,"9091",686,479,467,4,12,"PUM+J",0
40,"40191",198,143,138,0,5,"PUM+J",0
18,"18053",1554,1001,985,9,16,"PUM+J",3
50,"50173",156,114,114,0,0,"PUM+J",0
6,"6134",526,306,301,1,5,"PUM+J",1
46,"46187",1292,924,920,4,4,"PUM+J",0
12,"12001",1028,783,768,6,15,"PUM+J",1
44,"44051",2579,1924,1901,10,23,"PUM+J",2
19,"19297",32,28,28,0,0,"PUM+J",0
46,"46211",1862,1395,1381,12,14,"PUM+J",1
44,"44231",35,30,30,0,0,"PUM+J",0
4,"4007",735,514,509,3,5,"PUM+J",0
34,"34006",79,73,69,2,4,"PUM+J",1
40,"40139",255,194,192,2,2,"PUM+J",0
13,"13069",613,438,419,2,19,"PUM+J",0
18,"18152",928,663,660,3,3,"PUM+J",0
18,"18024",837,651,639,11,12,"PUM+J",1
26,"26015",185,140,138,2,2,"PUM+J",1
24,"24168",430,325,322,6,3,"PUM+J",0
37,"37147",184,126,124,1,2,"PUM+J",0
46,"46029",20448,14673,14556,99,117,"PUM+J",6
26,"26089",111981,80365,79216,893,1149,"PUM+J",168
39,"39008",13900,9814,9734,63,80,"PUM+J",10
9,"9114",77,60,59,0,1,"PUM+J",0
42,"42219",40,34,34,1,0,"PUM+J",0
12,"12029",670,524,514,5,10,"PUM+J",1
34,"34901",1053,762,759,10,3,"PUM+J",1
9,"9076",24,19,19,1,0,"PUM+J",0
49,"49079",104,79,76,0,3,"PUM+J",0
19,"19323",36,26,26,0,0,"PUM+J",0
5,"5142",88,76,75,0,1,"PUM+J",0
41,"41006",2733,1776,1742,17,34,"PUM+J",0
10,"10195",7514,5243,5148,47,95,"PUM+J",5
45,"45205",7438,4772,4701,27,71,"PUM+J",8
34,"34902",123,91,91,0,0,"PUM+J",0
5,"5208",39,32,32,0,0,"PUM+J",0
19,"19257",3279,2233,2206,21,27,"PUM+J",9
37,"37138",222,163,159,3,4,"PUM+J",0
24,"24194",267,178,177,1,1,"PUM+J",0
9,"9048",1373,937,911,10,26,"PUM+J",3
34,"34120",63790,46117,45597,464,520,"PUM+J",126
9,"9225",80,55,55,0,0,"PUM+J",0
46,"46053",525,433,428,2,5,"PUM+J",0
6,"6138",1021,677,658,5,19,"PUM+J",2
34,"34058",182,152,152,0,0,"PUM+J",0
22,"22013",271,200,197,3,3,"PUM+J",1
9,"9277",103,84,82,1,2,"PUM+J",0
50,"50176",220,142,142,3,0,"PUM+J",0
37,"37025",245,198,196,5,2,"PUM+J",0
9,"9412",750,484,482,4,2,"PUM+J",1
47,"47025",114,85,85,3,0,"PUM+J",0
29,"29026",1021,703,698,15,5,"PUM+J",1
42,"42152",67,47,44,1,3,"PUM+J",0
13,"13089",1609,1248,1228,10,20,"PUM+J",1
46,"46213",15499,10610,10482,173,128,"PUM+J",43
42,"42086",33,19,19,1,0,"PUM+J",0
18,"18188",1646,1224,1202,10,22,"PUM+J",2
40,"40216",785,633,621,9,12,"PUM+J",2
50,"50099",3036,2137,2113,17,24,"PUM+J",1
4,"4082",275,185,182,2,3,"PUM+J",0
23,"23060",19210,13677,13495,145,182,"PUM+J",14
39,"39067",753,476,474,1,2,"PUM+J",0
26,"26094",67,51,51,0,0,"PUM+J",0
22,"22234",743,498,491,5,7,"PUM+J",0
5,"5220",364,277,274,0,3,"PUM+J",0
18,"18114",585,425,424,7,1,"PUM+J",0
41,"41065",22527,14684,14463,205,221,"PUM+J",7
42,"42209",134,86,84,4,2,"PUM+J",1
5,"5204",578,445,442,3,3,"PUM+J",2
23,"23053",9451,6038,5975,60,63,"PUM+J",7
34,"34229",58,47,47,1,0,"PUM+J",0
5,"5189",397,293,291,3,2,"PUM+J",0
29,"29037",215,156,153,1,3,"PUM+J",0
26,"26135",152,115,114,0,1,"PUM+J",0
26,"26020",449,319,313,1,6,"PUM+J",0
45,"45074",397,300,293,2,7,"PUM+J",0
16,"16111",168,114,111,2,3,"PUM+J",1
23,"23073",4363,3214,3176,24,38,"PUM+J",4
34,"34076",532,443,438,1,5,"PUM+J",0
35,"35009",20229,13378,13201,95,177,"PUM+J",9
18,"18126",1436,1024,1002,9,22,"PUM+J",0
41,"41010",4586,3218,3157,42,61,"PUM+J",6
37,"37184",289,178,177,1,1,"PUM+J",0
46,"46215",1407,1088,1068,10,20,"PUM+J",0
19,"19212",678,501,491,1,10,"PUM+J",2
50,"50219",4283,3034,2990,30,44,"PUM+J",6
35,"35002",24229,15311,15133,101,178,"PUM+J",13
4,"4096",285,222,222,0,0,"PUM+J",1
22,"22114",124,75,72,1,3,"PUM+J",0
38,"38041",7025,4729,4684,42,45,"PUM+J",5
26,"26136",90,65,64,2,1,"PUM+J",0
14,"14070",1280,911,902,4,9,"PUM+J",0
9,"9086",652,479,471,3,8,"PUM+J",0
45,"45149",517,400,393,2,7,"PUM+J",1
37,"37259",39,28,28,1,0,"PUM+J",0
18,"18032",247,164,163,1,1,"PUM+J",0
37,"37249",37,28,28,0,0,"PUM+J",0
37,"37123",159,124,123,2,1,"PUM+J",0
3,"3070",2115,1399,1376,9,23,"PUM+J",0
46,"46178",5001,3513,3477,26,36,"PUM+J",2
19,"19232",56,40,40,0,0,"PUM+J",0
6,"6085",3429,2439,2382,21,57,"PUM+J",6
21,"21006",3321,2197,2125,19,72,"PUM+J",0
47,"47082",805,641,630,3,11,"PUM+J",0
13,"13080",316,226,225,0,1,"PUM+J",0
13,"13903",498,395,394,0,1,"PUM+J",0
16,"16198",1281,938,928,6,10,"PUM+J",0
49,"49270",139,93,92,0,1,"PUM+J",1
14,"14034",302,222,215,1,7,"PUM+J",0
38,"38051",7328,5017,4969,32,48,"PUM+J",1
10,"10067",10210,7090,6946,62,144,"PUM+J",10
19,"19224",106,83,83,1,0,"PUM+J",0
3,"3052",959,747,735,4,12,"PUM+J",0
29,"29077",207,135,134,1,1,"PUM+J",0
6,"6056",447,351,340,2,11,"PUM+J",1
22,"22081",247,173,171,3,2,"PUM+J",0
46,"46012",965,689,675,4,14,"PUM+J",0
9,"9292",72,55,55,3,0,"PUM+J",0
40,"40018",73,50,50,0,0,"PUM+J",0
40,"40212",26,19,19,1,0,"PUM+J",0
6,"6148",957,682,665,1,17,"PUM+J",2
33,"33035",11214,7359,7303,102,56,"PUM+J",4
19,"19306",24,18,18,0,0,"PUM+J",0
21,"21069",1681,1073,1056,9,17,"PUM+J",3
16,"16064",651,556,550,4,6,"PUM+J",1
35,"35028",10156,5483,5425,56,58,"PUM+J",2
50,"50004",475,360,356,2,4,"PUM+J",0
38,"38019",13884,7888,7809,49,79,"PUM+J",2
37,"37091",161,104,104,0,0,"PUM+J",0
47,"47127",138,89,88,2,1,"PUM+J",0
40,"40192",134,106,105,1,1,"PUM+J",0
37,"37303",179,118,117,1,1,"PUM+J",0
37,"37056",39,28,28,0,0,"PUM+J",0
35,"35005",1009,680,668,2,12,"PUM+J",0
19,"19119",76,65,65,0,0,"PUM+J",1
3,"3045",216,176,172,1,4,"PUM+J",0
23,"23033",1325,1008,989,11,19,"PUM+J",0
4,"4090",298,229,225,1,4,"PUM+J",0
28,"28161",52164,38607,38193,306,414,"PUM+J",40
34,"34218",437,313,309,3,4,"PUM+J",1
19,"19016",57,40,40,0,0,"PUM+J",0
9,"9410",3019,1924,1898,21,26,"PUM+J",13
14,"14046",4442,3283,3190,34,93,"PUM+J",2
26,"26103",814,617,603,10,14,"PUM+J",0
26,"26028",135,111,110,3,1,"PUM+J",0
19,"19248",73,54,54,0,0,"PUM+J",1
19,"19280",3669,2622,2597,24,25,"PUM+J",6
13,"13066",2621,2029,1998,12,31,"PUM+J",2
46,"46181",16967,11951,11835,98,116,"PUM+J",4
38,"38029",1475,752,744,10,8,"PUM+J",0
44,"44147",401,264,256,7,8,"PUM+J",0
42,"42001",250,172,172,3,0,"PUM+J",0
44,"44224",21,14,14,2,0,"PUM+J",0
46,"46037",1120,891,879,7,12,"PUM+J",1
12,"12058",59,47,45,1,2,"PUM+J",0
50,"50175",907,638,632,11,6,"PUM+J",0
12,"12142",142,113,113,0,0,"PUM+J",0
39,"39047",1998,1408,1392,8,16,"PUM+J",0
9,"9152",244,161,161,0,0,"PUM+J",0
35,"35007",517,347,345,2,2,"PUM+J",0
19,"19279",54,42,42,0,0,"PUM+J",0
38,"38046",9267,6652,6594,55,58,"PUM+J",6
33,"33038",2218,1501,1477,17,24,"PUM+J",0
18,"18068",1638,1197,1167,12,30,"PUM+J",4
49,"49248",171,128,128,1,0,"PUM+J",0
26,"26066",263,201,194,5,7,"PUM+J",0
45,"45034",1290,968,948,7,20,"PUM+J",4
5,"5240",3346,2259,2232,11,27,"PUM+J",3
28,"28163",429,332,326,0,6,"PUM+J",1
19,"19219",9,8,7,0,1,"PUM+J",0
12,"12103",87,61,60,0,1,"PUM+J",1
40,"40174",319,229,227,3,2,"PUM+J",0
9,"9302",96,66,66,0,0,"PUM+J",0
16,"16238",461,380,378,1,2,"PUM+J",0
50,"50057",1331,933,922,10,11,"PUM+J",0
6,"6155",1810,1172,1140,23,32,"PUM+J",1
26,"26146",84,56,55,0,1,"PUM+J",1
23,"23038",3786,2934,2900,21,34,"PUM+J",2
10,"10062",389,303,299,2,4,"PUM+J",0
12,"12013",135,106,106,1,0,"PUM+J",0
33,"33048",132,86,85,1,1,"PUM+J",0
3,"3002",3649,2568,2542,11,26,"PUM+J",2
46,"46122",2726,1957,1934,13,23,"PUM+J",2
16,"16203",10221,6960,6883,42,77,"PUM+J",8
12,"12130",414,329,327,0,2,"PUM+J",0
50,"50220",45,38,38,0,0,"PUM+J",0
22,"22143",190,118,115,1,3,"PUM+J",0
50,"50171",99,69,69,2,0,"PUM+J",0
9,"9396",149,121,121,4,0,"PUM+J",0
42,"42087",51,45,42,1,3,"PUM+J",0
5,"5059",92,49,48,0,1,"PUM+J",0
45,"45050",505,338,332,2,6,"PUM+J",0
13,"13046",686,524,521,6,3,"PUM+J",0
37,"37112",158,110,109,2,1,"PUM+J",0
5,"5135",399,294,292,2,2,"PUM+J",0
23,"23051",2736,2066,2021,16,45,"PUM+J",1
46,"46207",6761,4966,4909,46,57,"PUM+J",2
49,"49264",529,334,329,2,5,"PUM+J",0
21,"21075",338,243,235,3,8,"PUM+J",0
47,"47069",115,87,87,0,0,"PUM+J",0
6,"6022",2635,1920,1862,15,58,"PUM+J",6
37,"37352",209,157,155,3,2,"PUM+J",1
9,"9085",481,349,342,2,7,"PUM+J",2
47,"47090",2447,1823,1784,15,39,"PUM+J",1
35,"35010",3853,2224,2194,18,30,"PUM+J",5
46,"46010",943,691,681,7,10,"PUM+J",1
6,"6159",2329,1297,1273,22,24,"PUM+J",5
19,"19191",13,12,12,0,0,"PUM+J",0
18,"18011",4403,3002,2947,24,55,"PUM+J",8
9,"9039",54,38,37,0,1,"PUM+J",0
34,"34093",83,61,60,0,1,"PUM+J",0
49,"49068",422,263,261,4,2,"PUM+J",0
18,"18161",245,199,196,0,3,"PUM+J",0
16,"16073",190,153,153,1,0,"PUM+J",1
45,"45199",3188,2077,2055,20,22,"PUM+J",9
46,"46132",2176,1725,1708,5,17,"PUM+J",2
42,"42157",10,9,9,0,0,"PUM+J",0
37,"37363",104,81,80,0,1,"PUM+J",0
24,"24091",575,368,362,5,6,"PUM+J",0
44,"44238",2278,1630,1620,3,10,"PUM+J",0
45,"45003",554,398,393,2,5,"PUM+J",0
33,"33024",224741,151660,150461,1597,1199,"PUM+J",139
46,"46216",5277,4146,4111,42,35,"PUM+J",3
16,"16118",1351,1022,1009,13,13,"PUM+J",2
5,"5110",696,469,464,2,5,"PUM+J",0
41,"41087",10557,7217,7029,67,188,"PUM+J",16
46,"46049",268,221,217,2,4,"PUM+J",0
23,"23077",604,482,477,2,5,"PUM+J",0
47,"47030",935,680,669,5,11,"PUM+J",0
28,"28126",50,36,36,0,0,"PUM+J",0
45,"45041",3967,2723,2689,18,34,"PUM+J",5
5,"5259",99,80,79,2,1,"PUM+J",0
4,"4029",8830,5546,5482,43,64,"PUM+J",5
13,"13006",552,411,406,0,5,"PUM+J",1
16,"16154",4739,3416,3379,33,37,"PUM+J",2
5,"5193",179,140,139,2,1,"PUM+J",0
41,"41041",9765,7172,6943,63,229,"PUM+J",5
16,"16906",70,44,44,1,0,"PUM+J",0
10,"10205",1934,1071,1042,4,29,"PUM+J",2
16,"16129",88,72,72,0,0,"PUM+J",0
42,"42160",246,177,175,3,2,"PUM+J",1
2,"2084",298,197,191,2,6,"PUM+J",0
9,"9093",162,131,131,1,0,"PUM+J",0
5,"5097",464,309,305,0,4,"PUM+J",0
19,"19024",8561,6015,5942,44,73,"PUM+J",11
23,"23044",4697,3495,3400,31,95,"PUM+J",5
3,"3901",1137,783,776,9,7,"PUM+J",2
46,"46252",125,89,86,1,3,"PUM+J",0
6,"6028",4098,3457,3350,22,107,"PUM+J",5
9,"9351",61,46,45,1,1,"PUM+J",0
22,"22207",121,66,65,0,1,"PUM+J",0
26,"26039",40,31,31,0,0,"PUM+J",0
19,"19225",851,618,611,2,7,"PUM+J",0
37,"37033",94,67,67,0,0,"PUM+J",0
23,"23080",1720,1313,1294,6,19,"PUM+J",1
4,"4100",9433,5599,5556,48,43,"PUM+J",9
12,"12125",215,179,179,2,0,"PUM+J",0
13,"13902",449,329,326,4,3,"PUM+J",0
44,"44136",48,43,43,1,0,"PUM+J",0
16,"16006",113,100,100,1,0,"PUM+J",0
9,"9424",31,24,23,0,1,"PUM+J",0
18,"18168",783,566,561,11,5,"PUM+J",1
6,"6126",2121,1443,1429,14,14,"PUM+J",3
23,"23069",5240,4153,4065,26,88,"PUM+J",7
34,"34051",91,72,70,0,2,"PUM+J",0
50,"50191",446,327,326,1,1,"PUM+J",1
16,"16042",1091,832,823,4,9,"PUM+J",1
46,"46090",1631,1360,1339,6,21,"PUM+J",0
45,"45180",2850,2044,2023,15,21,"PUM+J",0
37,"37233",53,39,39,1,0,"PUM+J",0
19,"19132",86,65,63,0,2,"PUM+J",0
19,"19288",21,20,20,2,0,"PUM+J",0
49,"49181",333,197,195,2,2,"PUM+J",0
42,"42115",89,68,66,0,2,"PUM+J",0
40,"40032",368,247,244,5,3,"PUM+J",0
3,"3903",2612,1838,1814,7,24,"PUM+J",0
19,"19102",88,75,73,0,2,"PUM+J",0
28,"28173",523,384,381,1,3,"PUM+J",0
44,"44089",49,41,41,0,0,"PUM+J",0
14,"14010",3992,2786,2723,14,63,"PUM+J",1
45,"45144",736,562,557,1,5,"PUM+J",0
5,"5144",65,47,46,1,1,"PUM+J",0
28,"28097",126,87,87,2,0,"PUM+J",1
9,"9079",47,38,38,0,0,"PUM+J",0
6,"6093",4325,3176,3073,26,103,"PUM+J",5
28,"28006",80903,60936,60508,482,428,"PUM+J",56
37,"37058",56,38,38,1,0,"PUM+J",0
3,"3048",4993,3549,3502,13,47,"PUM+J",7
37,"37171",396,272,270,2,2,"PUM+J",0
9,"9102",33,22,22,0,0,"PUM+J",0
50,"50117",123,93,93,4,0,"PUM+J",0
19,"19325",154,86,86,1,0,"PUM+J",0
34,"34088",265,195,191,1,4,"PUM+J",0
49,"49114",40,31,27,0,4,"PUM+J",0
45,"45097",1037,834,819,7,15,"PUM+J",0
9,"9429",53,34,34,1,0,"PUM+J",0
33,"33049",5973,3569,3518,48,51,"PUM+J",2
19,"19301",37,26,26,0,0,"PUM+J",0
9,"9066",54,37,37,0,0,"PUM+J",0
3,"3021",5573,4423,4343,23,80,"PUM+J",2
9,"9108",433,315,311,3,4,"PUM+J",0
4,"4015",113,81,81,0,0,"PUM+J",0
49,"49262",367,263,261,1,2,"PUM+J",1
42,"42148",9,9,9,0,0,"PUM+J",0
26,"26124",768,603,590,4,13,"PUM+J",0
19,"19001",43,32,32,0,0,"PUM+J",0
42,"42078",1000,653,640,5,13,"PUM+J",2
50,"50152",1351,942,932,14,10,"PUM+J",0
4,"4902",45571,29423,29169,272,254,"PUM+J",22
18,"18148",787,618,605,5,13,"PUM+J",0
22,"22247",28,18,18,0,0,"PUM+J",0
29,"29056",1047,708,696,5,12,"PUM+J",0
6,"6157",389,277,271,1,6,"PUM+J",0
46,"46086",80,66,65,1,1,"PUM+J",0
37,"37288",281,220,218,4,2,"PUM+J",1
45,"45135",4152,3118,3066,21,52,"PUM+J",6
26,"26045",11,10,10,1,0,"PUM+J",0
45,"45136",5827,3908,3864,22,44,"PUM+J",3
5,"5039",47,43,43,0,0,"PUM+J",0
10,"10200",336,243,242,0,1,"PUM+J",0
29,"29010",1637,1263,1187,2,76,"PUM+J",0
24,"24124",338,196,195,2,1,"PUM+J",0
38,"38049",2690,1406,1389,27,17,"PUM+J",0
14,"14014",2496,1962,1907,20,55,"PUM+J",3
40,"40025",129,109,107,1,2,"PUM+J",0
22,"22137",1009,671,665,1,6,"PUM+J",0
47,"47208",53,35,35,1,0,"PUM+J",0
44,"44022",464,330,325,1,5,"PUM+J",0
6,"6144",504,391,382,6,9,"PUM+J",0
39,"39032",1420,1032,1027,7,5,"PUM+J",1
9,"9363",906,660,655,5,5,"PUM+J",0
46,"46903",6306,4762,4743,44,19,"PUM+J",3
45,"45002",2619,1676,1663,14,13,"PUM+J",2
44,"44173",103,81,79,0,2,"PUM+J",0
37,"37077",251,206,204,1,2,"PUM+J",0
42,"42141",101,59,59,0,0,"PUM+J",0
9,"9907",1526,1140,1119,18,21,"PUM+J",1
28,"28040",16741,10717,10604,79,113,"PUM+J",9
28,"28158",694,501,495,2,6,"PUM+J",0
19,"19145",40,32,32,0,0,"PUM+J",0
26,"26091",147,115,114,0,1,"PUM+J",0
28,"28115",62612,50619,50431,399,188,"PUM+J",63
26,"26125",2665,1885,1853,21,32,"PUM+J",5
34,"34180",68,54,54,1,0,"PUM+J",0
18,"18165",4265,2870,2820,22,50,"PUM+J",3
5,"5185",96,63,61,1,2,"PUM+J",0
34,"34127",80,62,62,0,0,"PUM+J",0
50,"50061",190,157,155,2,2,"PUM+J",0
23,"23006",4582,3536,3461,43,75,"PUM+J",4
40,"40221",50,38,35,0,3,"PUM+J",0
40,"40234",375,278,269,3,9,"PUM+J",1
24,"24092",731,506,504,1,2,"PUM+J",0
46,"46217",900,672,667,7,5,"PUM+J",0
9,"9167",53,36,36,0,0,"PUM+J",0
50,"50164",381,245,243,3,2,"PUM+J",0
11,"11016",15079,9353,9192,137,161,"PUM+J",6
37,"37055",117,97,93,0,4,"PUM+J",1
50,"50205",72,51,49,0,2,"PUM+J",0
16,"16259",28,22,22,0,0,"PUM+J",0
44,"44263",373,267,267,2,0,"PUM+J",0
5,"5005",165,127,119,0,8,"PUM+J",0
49,"49011",214,147,146,5,1,"PUM+J",0
39,"39091",1881,1297,1291,8,6,"PUM+J",0
42,"42128",45,40,39,2,1,"PUM+J",1
49,"49233",85,51,51,0,0,"PUM+J",0
12,"12108",443,354,352,4,2,"PUM+J",0
5,"5043",73,58,58,0,0,"PUM+J",0
42,"42064",83,65,65,1,0,"PUM+J",0
47,"47169",62,52,52,0,0,"PUM+J",0
10,"10206",196,135,133,0,2,"PUM+J",1
42,"42175",22,16,16,0,0,"PUM+J",0
40,"40119",166,133,132,2,1,"PUM+J",0
24,"24131",684,416,415,2,1,"PUM+J",0
12,"12057",572,456,437,1,19,"PUM+J",0
42,"42129",678,485,480,6,5,"PUM+J",0
30,"30043",25449,18839,18477,180,362,"PUM+J",10
37,"37304",156,97,96,1,1,"PUM+J",0
50,"50149",34,25,25,0,0,"PUM+J",0
7,"7045",1317,931,928,8,3,"PUM+J",1
46,"46115",330,219,213,0,6,"PUM+J",0
28,"28007",127491,96937,96102,810,835,"PUM+J",90
6,"6151",1049,746,741,5,5,"PUM+J",1
5,"5164",18,12,12,0,0,"PUM+J",0
16,"16049",137,98,98,2,0,"PUM+J",0
37,"37144",327,233,233,2,0,"PUM+J",1
13,"13065",2777,1766,1728,10,38,"PUM+J",2
26,"26003",379,311,306,1,5,"PUM+J",1
6,"6045",467,347,346,6,1,"PUM+J",0
44,"44109",99,64,64,0,0,"PUM+J",0
21,"21061",5083,3325,3255,36,70,"PUM+J",5
10,"10072",837,545,539,5,6,"PUM+J",0
5,"5072",92,74,72,1,2,"PUM+J",0
6,"6137",934,696,693,3,3,"PUM+J",0
46,"46093",2151,1652,1640,10,12,"PUM+J",0
11,"11009",579,399,390,0,9,"PUM+J",3
46,"46106",1471,1033,1028,8,5,"PUM+J",1
44,"44234",71,49,49,0,0,"PUM+J",0
42,"42131",50,39,39,2,0,"PUM+J",0
5,"5057",2418,1785,1748,9,37,"PUM+J",1
37,"37046",10648,7396,7241,62,155,"PUM+J",9
44,"44157",61,37,37,0,0,"PUM+J",0
24,"24222",14499,10219,10076,99,143,"PUM+J",19
40,"40215",79,66,66,2,0,"PUM+J",0
34,"34205",55,38,38,0,0,"PUM+J",0
42,"42178",99,71,71,0,0,"PUM+J",0
11,"11020",166773,111205,109956,1580,1249,"PUM+J",176
45,"45194",64,45,44,1,1,"PUM+J",0
46,"46092",262,176,174,2,2,"PUM+J",0
5,"5090",73,63,62,0,1,"PUM+J",0
37,"37307",146,94,91,1,3,"PUM+J",0
39,"39010",610,457,453,1,4,"PUM+J",0
5,"5210",81,56,56,0,0,"PUM+J",0
44,"44267",70,47,46,0,1,"PUM+J",0
24,"24098",1149,753,741,8,12,"PUM+J",0
40,"40186",35,29,29,0,0,"PUM+J",0
16,"16020",9,5,5,1,0,"PUM+J",0
42,"42181",384,281,278,3,3,"PUM+J",0
42,"42153",12,10,10,0,0,"PUM+J",0
18,"18905",15688,10406,10200,122,206,"PUM+J",8
9,"9384",292,199,193,3,6,"PUM+J",1
41,"41040",11183,8351,8253,71,98,"PUM+J",14
6,"6004",1561,1130,1111,7,19,"PUM+J",1
45,"45011",279,235,233,4,2,"PUM+J",0
10,"10031",162,128,124,0,4,"PUM+J",2
42,"42039",216,144,141,1,3,"PUM+J",0
9,"9206",52,43,43,0,0,"PUM+J",0
45,"45101",3671,2842,2808,13,34,"PUM+J",6
2,"2046",1125,892,870,12,22,"PUM+J",2
22,"22189",175,142,142,1,0,"PUM+J",1
16,"16191",850,664,653,11,11,"PUM+J",1
45,"45163",8326,5835,5693,48,142,"PUM+J",10
46,"46019",8932,6721,6647,40,74,"PUM+J",1
30,"30039",20442,13299,13167,84,132,"PUM+J",9
3,"3140",26036,18637,18267,237,370,"PUM+J",23
9,"9904",464,344,339,3,5,"PUM+J",2
5,"5199",37,31,31,0,0,"PUM+J",1
22,"22015",299,218,215,1,3,"PUM+J",0
18,"18159",989,765,762,2,3,"PUM+J",0
6,"6098",530,379,376,4,3,"PUM+J",0
16,"16099",179,108,105,0,3,"PUM+J",0
23,"23087",11169,8193,8045,79,148,"PUM+J",6
37,"37122",203,162,161,3,1,"PUM+J",0
39,"39013",517,359,356,1,3,"PUM+J",0
45,"45198",1808,1442,1428,6,14,"PUM+J",0
12,"12121",1043,878,856,5,22,"PUM+J",1
47,"47124",383,302,300,3,2,"PUM+J",0
2,"2069",11401,8055,7975,30,80,"PUM+J",10
37,"37018",106,75,75,0,0,"PUM+J",0
44,"44247",291,207,206,4,1,"PUM+J",0
46,"46147",17186,11507,11399,72,108,"PUM+J",8
5,"5049",403,261,253,1,8,"PUM+J",0
41,"41049",9515,6961,6843,115,118,"PUM+J",11
34,"34126",248,177,176,3,1,"PUM+J",1
10,"10094",220,167,165,0,2,"PUM+J",0
50,"50179",255,197,197,0,0,"PUM+J",0
24,"24042",60,47,47,2,0,"PUM+J",0
2,"2081",18287,12910,12675,130,235,"PUM+J",20
46,"46011",7523,5154,5077,34,77,"PUM+J",1
23,"23064",1669,1311,1296,9,15,"PUM+J",1
5,"5021",1861,1323,1304,22,19,"PUM+J",2
42,"42015",30,20,20,0,0,"PUM+J",0
40,"40080",51,31,31,0,0,"PUM+J",0
6,"6009",221,166,166,2,0,"PUM+J",0
47,"47091",76,60,59,2,1,"PUM+J",0
9,"9164",147,112,111,0,1,"PUM+J",0
6,"6131",1057,809,800,6,9,"PUM+J",0
47,"47117",287,199,197,6,2,"PUM+J",0
39,"39024",1802,1325,1314,7,11,"PUM+J",0
46,"46224",156,125,124,0,1,"PUM+J",0
34,"34022",1022,813,798,7,15,"PUM+J",0
24,"24158",296,197,192,0,5,"PUM+J",1
46,"46204",6625,4946,4882,52,64,"PUM+J",1
3,"3025",1304,944,934,4,10,"PUM+J",0
28,"28042",1261,918,908,9,10,"PUM+J",1
34,"34037",301,206,204,1,2,"PUM+J",0
10,"10164",707,391,382,4,9,"PUM+J",1
26,"26087",180,123,123,3,0,"PUM+J",0
26,"26061",1542,1104,1079,12,25,"PUM+J",1
26,"26025",84,69,65,2,4,"PUM+J",0
10,"10015",630,429,424,1,5,"PUM+J",1
16,"16103",235,183,181,2,2,"PUM+J",0
12,"12091",171,110,108,4,2,"PUM+J",0
23,"23032",529,427,419,5,8,"PUM+J",0
22,"22019",176,128,126,1,2,"PUM+J",0
28,"28128",453,334,331,1,3,"PUM+J",0
16,"16276",20,17,17,1,0,"PUM+J",0
14,"14026",2000,1294,1253,20,41,"PUM+J",1
22,"22172",520,373,369,5,4,"PUM+J",0
13,"13084",841,652,644,6,8,"PUM+J",0
9,"9045",269,159,158,0,1,"PUM+J",1
38,"38044",2215,1270,1257,5,13,"PUM+J",0
18,"18099",1582,1184,1156,13,28,"PUM+J",0
42,"42014",57,35,35,0,0,"PUM+J",0
35,"35006",31373,20764,20476,189,288,"PUM+J",31
24,"24180",1086,767,759,9,8,"PUM+J",1
28,"28024",168,137,136,2,1,"PUM+J",0
19,"19155",64,49,49,0,0,"PUM+J",0
5,"5037",210,135,135,0,0,"PUM+J",0
45,"45072",653,469,462,1,7,"PUM+J",2
50,"50087",28,19,19,0,0,"PUM+J",0
46,"46227",893,687,675,6,12,"PUM+J",1
13,"13071",37945,24340,24091,227,249,"PUM+J",61
49,"49047",98,74,72,1,2,"PUM+J",0
37,"37057",208,151,149,0,2,"PUM+J",0
44,"44204",27,18,18,0,0,"PUM+J",0
19,"19099",286,179,175,1,4,"PUM+J",0
23,"23009",12849,9722,9572,99,150,"PUM+J",5
16,"16215",237,162,158,1,4,"PUM+J",0
18,"18083",232,181,179,1,2,"PUM+J",1
46,"46171",16446,11616,11499,94,117,"PUM+J",7
49,"49263",44,32,32,1,0,"PUM+J",0
42,"42167",235,163,161,4,2,"PUM+J",1
26,"26081",15,14,14,1,0,"PUM+J",0
37,"37223",106,75,74,0,1,"PUM+J",0
46,"46113",2558,1791,1773,7,18,"PUM+J",0
44,"44216",27003,19997,19909,80,88,"PUM+J",8
40,"40225",1085,822,809,5,13,"PUM+J",0
26,"26078",86,63,63,0,0,"PUM+J",0
19,"19054",161,136,135,3,1,"PUM+J",0
28,"28076",432,330,327,4,3,"PUM+J",0
5,"5176",221,163,159,0,4,"PUM+J",0
6,"6108",2238,1524,1478,15,46,"PUM+J",4
24,"24108",348,247,246,4,1,"PUM+J",0
46,"46129",511,389,379,9,10,"PUM+J",1
46,"46030",810,641,625,7,16,"PUM+J",1
24,"24041",513,312,305,4,7,"PUM+J",0
26,"26029",34,26,26,1,0,"PUM+J",0
39,"39029",629,476,469,1,7,"PUM+J",0
9,"9034",291,227,224,1,3,"PUM+J",1
40,"40163",42,35,35,1,0,"PUM+J",0
10,"10183",950,696,684,3,12,"PUM+J",1
41,"41046",3005,2241,2198,11,43,"PUM+J",2
50,"50209",2785,1893,1865,24,28,"PUM+J",1
9,"9136",169,129,125,2,4,"PUM+J",0
19,"19159",87,73,72,1,1,"PUM+J",0
42,"42019",519,345,341,3,4,"PUM+J",0
46,"46229",903,715,708,5,7,"PUM+J",0
34,"34192",76,59,59,0,0,"PUM+J",0
26,"26138",4504,2982,2930,32,52,"PUM+J",6
37,"37380",55,41,40,2,1,"PUM+J",0
16,"16085",131,106,106,0,0,"PUM+J",0
19,"19210",18,16,16,0,0,"PUM+J",0
44,"44229",141,99,98,1,1,"PUM+J",0
16,"16089",381,292,289,8,3,"PUM+J",0
50,"50092",290,218,214,0,4,"PUM+J",3
39,"39101",231,134,132,2,2,"PUM+J",1
44,"44121",52,42,42,1,0,"PUM+J",0
24,"24136",495,347,344,1,3,"PUM+J",0
34,"34177",178,149,149,1,0,"PUM+J",0
42,"42206",8,5,5,2,0,"PUM+J",0
37,"37217",59,43,43,3,0,"PUM+J",0
40,"40072",224,175,171,1,4,"PUM+J",0
6,"6117",1388,982,958,11,24,"PUM+J",3
4,"4002",1013,711,699,1,12,"PUM+J",0
19,"19034",25,22,21,0,1,"PUM+J",0
24,"24225",979,678,668,5,10,"PUM+J",0
13,"13002",1415,966,950,3,16,"PUM+J",1
49,"49029",609,435,419,6,16,"PUM+J",2
44,"44230",149,111,110,2,1,"PUM+J",0
16,"16060",715,519,513,3,6,"PUM+J",1
42,"42106",13,11,11,0,0,"PUM+J",0
16,"16903",992,750,732,8,18,"PUM+J",0
45,"45038",3528,2556,2521,26,35,"PUM+J",7
16,"16242",300,245,243,2,2,"PUM+J",0
5,"5126",60,47,45,0,2,"PUM+J",0
9,"9201",27,17,17,0,0,"PUM+J",1
13,"13048",495,392,391,4,1,"PUM+J",0
3,"3128",4285,2849,2819,18,30,"PUM+J",5
13,"13003",448,329,319,1,10,"PUM+J",0
5,"5094",133,105,105,0,0,"PUM+J",0
37,"37311",201,157,156,1,1,"PUM+J",0
22,"22156",289,216,213,1,3,"PUM+J",0
37,"37289",210,147,144,0,3,"PUM+J",0
13,"13095",66,56,56,3,0,"PUM+J",0
41,"41058",17956,12890,12553,200,337,"PUM+J",15
50,"50043",241,155,154,1,1,"PUM+J",0
18,"18117",497,360,354,1,6,"PUM+J",2
34,"34039",58,48,47,0,1,"PUM+J",0
18,"18911",7933,5464,5348,53,116,"PUM+J",5
9,"9269",29,24,23,0,1,"PUM+J",0
22,"22017",826,613,608,2,5,"PUM+J",0
18,"18085",690,440,432,1,8,"PUM+J",1
46,"46082",4981,3547,3523,29,24,"PUM+J",3
22,"22160",207,149,149,1,0,"PUM+J",1
19,"19287",134,100,98,2,2,"PUM+J",0
7,"7023",3776,2425,2386,34,39,"PUM+J",6
24,"24145",612,338,337,1,1,"PUM+J",0
19,"19049",8,8,7,0,1,"PUM+J",0
26,"26004",69,47,46,0,1,"PUM+J",0
44,"44106",151,107,106,0,1,"PUM+J",0
49,"49221",233,122,120,2,2,"PUM+J",0
21,"21017",2302,1469,1452,18,17,"PUM+J",1
28,"28106",78872,54111,53443,412,668,"PUM+J",73
28,"28169",1577,1214,1209,7,5,"PUM+J",2
45,"45115",2602,2013,1969,12,44,"PUM+J",0
30,"30009",12728,9487,9365,46,122,"PUM+J",3
10,"10028",83,62,61,1,1,"PUM+J",0
5,"5119",24,17,17,1,0,"PUM+J",0
9,"9173",123,96,93,2,3,"PUM+J",0
30,"30034",1067,818,801,8,17,"PUM+J",0
13,"13052",6288,4360,4278,36,82,"PUM+J",4
5,"5129",111,70,69,0,1,"PUM+J",0
49,"49257",305,186,184,0,2,"PUM+J",0
47,"47104",2816,2153,2099,20,54,"PUM+J",1
6,"6073",703,451,441,6,10,"PUM+J",1
50,"50080",34,27,27,0,0,"PUM+J",0
44,"44043",86,60,60,0,0,"PUM+J",0
26,"26050",125,92,91,1,1,"PUM+J",0
14,"14054",13775,10464,10165,105,299,"PUM+J",14
6,"6119",674,516,511,1,5,"PUM+J",0
26,"26038",76,52,52,0,0,"PUM+J",0
46,"46180",659,509,500,7,9,"PUM+J",0
19,"19286",772,585,575,3,10,"PUM+J",1
24,"24118",101,72,72,0,0,"PUM+J",0
28,"28140",3156,2359,2331,16,28,"PUM+J",2
29,"29043",2463,1508,1460,20,48,"PUM+J",1
29,"29042",14586,9793,9649,95,144,"PUM+J",11
33,"33029",315,145,142,1,3,"PUM+J",0
40,"40154",22,18,18,1,0,"PUM+J",1
28,"28044",6266,4693,4642,36,51,"PUM+J",6
34,"34100",132,96,95,1,1,"PUM+J",0
24,"24095",317,228,228,3,0,"PUM+J",0
14,"14033",1239,875,856,8,19,"PUM+J",0
3,"3061",1060,793,787,5,6,"PUM+J",2
41,"41901",2692,2101,2051,47,50,"PUM+J",1
26,"26011",7251,4807,4711,47,96,"PUM+J",11
24,"24070",3886,2677,2625,18,52,"PUM+J",3
37,"37022",242,191,190,0,1,"PUM+J",0
45,"45154",1491,1033,1024,11,9,"PUM+J",1
5,"5175",144,109,109,0,0,"PUM+J",0
38,"38053",3768,2275,2244,16,31,"PUM+J",1
13,"13097",2186,1592,1574,5,18,"PUM+J",0
22,"22253",56,40,40,1,0,"PUM+J",0
46,"46042",3335,2655,2620,12,35,"PUM+J",0
24,"24017",532,375,374,1,1,"PUM+J",0
9,"9032",103,62,62,3,0,"PUM+J",0
16,"16007",1153,857,847,3,10,"PUM+J",0
45,"45021",2639,1798,1755,22,43,"PUM+J",1
22,"22177",96,69,68,0,1,"PUM+J",0
19,"19261",33,23,23,0,0,"PUM+J",1
44,"44039",204,144,143,1,1,"PUM+J",0
10,"10169",497,370,366,0,4,"PUM+J",0
9,"9064",305,225,219,6,6,"PUM+J",1
19,"19267",20,15,14,0,1,"PUM+J",0
49,"49050",498,305,305,2,0,"PUM+J",0
13,"13078",8946,6166,6103,49,63,"PUM+J",7
21,"21055",7326,5395,5309,43,86,"PUM+J",5
10,"10011",518,385,370,2,15,"PUM+J",2
47,"47046",124,99,99,1,0,"PUM+J",0
12,"12127",63,45,44,1,1,"PUM+J",0
18,"18179",493,315,309,8,6,"PUM+J",0
35,"35016",300581,181532,179831,1458,1701,"PUM+J",305
44,"44019",70,42,42,0,0,"PUM+J",0
24,"24160",633,404,403,2,1,"PUM+J",1
3,"3039",89,65,65,0,0,"PUM+J",0
42,"42044",53,37,35,1,2,"PUM+J",0
45,"45170",194,146,140,0,6,"PUM+J",0
7,"7052",4853,2765,2743,33,22,"PUM+J",3
45,"45077",546,413,409,0,4,"PUM+J",1
11,"11031",76427,49773,49248,654,525,"PUM+J",62
37,"37236",123,85,82,1,3,"PUM+J",0
40,"40229",26,22,22,0,0,"PUM+J",0
23,"23034",2480,1923,1882,15,41,"PUM+J",1
4,"4068",170,129,128,0,1,"PUM+J",0
42,"42205",77,59,57,3,2,"PUM+J",0
19,"19074",67,57,57,1,0,"PUM+J",0
9,"9372",204,175,169,2,6,"PUM+J",0
44,"44117",327,258,258,0,0,"PUM+J",0
45,"45153",1568,1168,1162,8,6,"PUM+J",1
13,"13040",839,639,623,7,16,"PUM+J",2
26,"26115",23,22,21,3,1,"PUM+J",0
6,"6105",592,367,363,1,4,"PUM+J",2
46,"46036",558,339,331,6,8,"PUM+J",1
49,"49022",282,230,229,2,1,"PUM+J",0
19,"19260",38,27,27,1,0,"PUM+J",0
2,"2057",1947,1358,1333,15,25,"PUM+J",5
46,"46230",14116,10038,9946,63,92,"PUM+J",5
10,"10001",287,207,203,2,4,"PUM+J",0
10,"10177",1702,1241,1186,10,55,"PUM+J",2
41,"41004",57692,38578,37814,696,764,"PUM+J",61
37,"37039",279,202,197,2,5,"PUM+J",0
45,"45100",178,141,138,0,3,"PUM+J",0
19,"19161",212,158,157,3,1,"PUM+J",0
30,"30031",497,387,382,1,5,"PUM+J",0
19,"19142",263,179,179,1,0,"PUM+J",0
6,"6088",12527,8326,8198,89,128,"PUM+J",20
19,"19073",16,15,15,1,0,"PUM+J",0
45,"45161",15469,10281,10167,68,114,"PUM+J",32
16,"16272",201,149,147,2,2,"PUM+J",0
49,"49041",409,287,282,1,5,"PUM+J",0
34,"34079",1729,1296,1275,19,21,"PUM+J",2
5,"5257",132,98,95,4,3,"PUM+J",0
6,"6100",845,626,624,2,2,"PUM+J",0
29,"29020",3278,2329,2260,22,69,"PUM+J",1
37,"37279",713,488,480,4,8,"PUM+J",0
50,"50002",125,91,86,0,5,"PUM+J",0
12,"12133",59,46,45,0,1,"PUM+J",0
50,"50122",68,43,42,1,1,"PUM+J",0
12,"12026",828,577,566,11,11,"PUM+J",0
26,"26059",1109,801,791,6,10,"PUM+J",0
26,"26083",337,255,250,3,5,"PUM+J",0
19,"19104",19,15,14,0,1,"PUM+J",0
30,"30011",4702,3390,3324,8,66,"PUM+J",4
24,"24059",804,466,463,5,3,"PUM+J",0
46,"46098",2405,1778,1751,7,27,"PUM+J",0
9,"9334",51,36,34,1,2,"PUM+J",1
47,"47213",104,78,78,0,0,"PUM+J",0
46,"46234",317,247,245,1,2,"PUM+J",0
40,"40140",76,54,54,0,0,"PUM+J",0
18,"18153",8834,6174,6063,54,111,"PUM+J",6
9,"9183",42,32,32,0,0,"PUM+J",0
4,"4019",236,174,172,0,2,"PUM+J",0
9,"9029",151,111,108,2,3,"PUM+J",1
37,"37375",678,539,523,8,16,"PUM+J",0
49,"49260",693,480,473,3,7,"PUM+J",1
46,"46164",12145,8373,8248,44,125,"PUM+J",11
34,"34181",422,289,285,0,4,"PUM+J",0
37,"37328",159,112,110,1,2,"PUM+J",0
29,"29023",2330,1441,1429,11,12,"PUM+J",0
37,"37115",108,67,65,0,2,"PUM+J",0
49,"49044",78,56,53,0,3,"PUM+J",0
10,"10002",360,239,236,1,3,"PUM+J",1
18,"18135",4385,2882,2798,24,84,"PUM+J",3
49,"49159",269,182,182,2,0,"PUM+J",1
12,"12089",4555,3070,3045,22,25,"PUM+J",3
16,"16040",91,76,76,2,0,"PUM+J",1
50,"50121",270,209,208,3,1,"PUM+J",0
37,"37231",236,185,183,5,2,"PUM+J",0
45,"45055",1004,768,755,4,13,"PUM+J",0
5,"5260",95,73,73,0,0,"PUM+J",0
46,"46203",3546,2717,2689,28,28,"PUM+J",1
42,"42095",1909,1345,1326,32,19,"PUM+J",2
26,"26128",94,71,71,1,0,"PUM+J",0
37,"37116",70,50,50,0,0,"PUM+J",0
34,"34059",411,304,292,6,12,"PUM+J",0
16,"16033",1633,1199,1174,8,25,"PUM+J",1
33,"33008",1679,1140,1133,10,7,"PUM+J",0
23,"23904",2570,1583,1562,10,21,"PUM+J",4
7,"7056",5271,3429,3386,44,43,"PUM+J",7
16,"16061",939,746,727,16,19,"PUM+J",0
37,"37318",196,132,132,0,0,"PUM+J",0
23,"23094",3739,2920,2876,29,44,"PUM+J",4
40,"40095",453,341,329,2,12,"PUM+J",0
18,"18036",3986,2956,2917,22,39,"PUM+J",6
50,"50196",101,73,73,0,0,"PUM+J",0
44,"44118",154,109,106,1,3,"PUM+J",0
39,"39017",550,378,372,1,6,"PUM+J",0
44,"44025",5804,4024,3991,11,33,"PUM+J",2
40,"40224",18,15,15,0,0,"PUM+J",0
19,"19250",16,12,12,0,0,"PUM+J",0
9,"9184",6,6,6,0,0,"PUM+J",0
19,"19015",82,74,73,1,1,"PUM+J",0
47,"47010",14718,11521,11392,137,129,"PUM+J",28
18,"18013",4154,2892,2812,28,80,"PUM+J",0
49,"49062",103,58,58,0,0,"PUM+J",0
22,"22023",385,293,283,2,10,"PUM+J",0
6,"6021",898,628,617,16,11,"PUM+J",1
22,"22041",145,116,116,2,0,"PUM+J",0
26,"26009",394,282,278,1,4,"PUM+J",0
40,"40134",692,522,509,10,13,"PUM+J",0
3,"3047",9768,6220,6144,41,76,"PUM+J",13
18,"18037",535,417,410,2,7,"PUM+J",0
35,"35033",6393,4147,4072,38,75,"PUM+J",2
46,"46177",4832,3592,3539,20,53,"PUM+J",4
37,"37126",30,25,25,0,0,"PUM+J",0
42,"42060",28,16,14,0,2,"PUM+J",0
19,"19115",29,23,23,0,0,"PUM+J",0
45,"45060",152,109,109,1,0,"PUM+J",0
45,"45084",2103,1533,1508,7,25,"PUM+J",1
13,"13029",89,67,65,0,2,"PUM+J",0
50,"50073",2122,1559,1540,14,19,"PUM+J",0
49,"49160",42,27,27,0,0,"PUM+J",0
16,"16148",544,452,451,2,1,"PUM+J",0
9,"9192",54,46,45,1,1,"PUM+J",0
49,"49031",148,107,105,2,2,"PUM+J",3
10,"10065",199,135,135,0,0,"PUM+J",0
18,"18147",3655,2273,2241,16,32,"PUM+J",1
33,"33020",12981,8550,8453,120,97,"PUM+J",7
6,"6065",293,230,228,2,2,"PUM+J",1
22,"22252",118,95,91,1,4,"PUM+J",0
49,"49055",91,72,72,3,0,"PUM+J",0
49,"49273",165,90,90,0,0,"PUM+J",0
39,"39074",7050,5074,5029,26,45,"PUM+J",2
5,"5261",32,25,25,0,0,"PUM+J",0
49,"49024",626,432,426,3,6,"PUM+J",0
49,"49059",84,61,58,0,3,"PUM+J",0
24,"24218",451,310,308,3,2,"PUM+J",0
47,"47222",85,70,70,1,0,"PUM+J",0
37,"37345",150,117,113,0,4,"PUM+J",0
42,"42189",57,43,43,0,0,"PUM+J",0
18,"18006",4062,2765,2711,25,54,"PUM+J",2
49,"49169",38,33,32,0,1,"PUM+J",0
42,"42062",20,10,10,0,0,"PUM+J",0
4,"4036",239,178,176,0,2,"PUM+J",0
10,"10150",339,279,275,3,4,"PUM+J",0
47,"47034",75,58,58,2,0,"PUM+J",0
16,"16031",35,26,26,0,0,"PUM+J",0
37,"37365",162,125,121,0,4,"PUM+J",0
28,"28090",9252,7216,7153,58,63,"PUM+J",7
26,"26026",1268,986,970,4,16,"PUM+J",1
16,"16029",104,76,74,0,2,"PUM+J",0
24,"24029",686,430,428,6,2,"PUM+J",0
33,"33033",9381,5848,5770,88,78,"PUM+J",5
37,"37219",169,88,85,1,3,"PUM+J",0
50,"50181",999,748,732,3,16,"PUM+J",1
9,"9362",198,156,156,4,0,"PUM+J",1
29,"29029",383,256,254,4,2,"PUM+J",0
7,"7063",1434,1025,1016,10,9,"PUM+J",3
19,"19116",12,10,10,0,0,"PUM+J",0
6,"6115",1243,808,798,8,10,"PUM+J",1
18,"18096",340,227,226,0,1,"PUM+J",1
44,"44040",189,153,150,1,3,"PUM+J",0
3,"3102",7181,5126,5073,36,53,"PUM+J",7
39,"39044",3921,2805,2783,18,22,"PUM+J",3
19,"19177",60,45,45,0,0,"PUM+J",1
16,"16068",125,88,88,3,0,"PUM+J",0
6,"6039",1802,1375,1343,9,32,"PUM+J",0
34,"34237",579,408,400,1,8,"PUM+J",0
14,"14074",2225,1775,1743,17,32,"PUM+J",2
24,"24226",194,118,118,1,0,"PUM+J",0
42,"42053",21,17,17,0,0,"PUM+J",0
16,"16909",655,493,488,4,5,"PUM+J",0
44,"44017",269,217,216,0,1,"PUM+J",0
4,"4089",687,484,479,2,5,"PUM+J",1
13,"13085",2265,1768,1735,5,33,"PUM+J",0
47,"47093",795,585,573,7,12,"PUM+J",0
50,"50225",1532,983,971,12,12,"PUM+J",0
19,"19281",19,18,18,0,0,"PUM+J",0
34,"34179",25,18,16,0,2,"PUM+J",0
41,"41047",10449,7884,7770,119,114,"PUM+J",6
46,"46109",6248,4516,4440,37,76,"PUM+J",0
34,"34227",70,56,52,1,4,"PUM+J",0
10,"10141",284,207,205,1,2,"PUM+J",1
47,"47014",48,39,39,1,0,"PUM+J",0
12,"12024",138,107,107,1,0,"PUM+J",2
37,"37204",253,176,173,2,3,"PUM+J",0
34,"34174",172,142,136,0,6,"PUM+J",1
9,"9196",133,95,95,2,0,"PUM+J",0
49,"49209",451,274,269,7,5,"PUM+J",0
22,"22116",1342,915,905,11,10,"PUM+J",0
47,"47214",1349,1036,1019,5,17,"PUM+J",1
9,"9006",57,30,29,0,1,"PUM+J",2
49,"49192",123,93,90,2,3,"PUM+J",0
50,"50223",906,702,693,9,9,"PUM+J",0
22,"22904",751,516,511,3,5,"PUM+J",0
41,"41096",6178,4739,4655,60,84,"PUM+J",8
49,"49075",130,100,97,1,3,"PUM+J",0
21,"21049",3262,2028,1977,15,51,"PUM+J",3
50,"50012",94,76,72,0,4,"PUM+J",0
46,"46066",1274,972,970,4,2,"PUM+J",0
34,"34178",119,94,91,0,3,"PUM+J",0
46,"46070",17824,12888,12802,106,86,"PUM+J",6
19,"19289",23,16,16,0,0,"PUM+J",0
24,"24055",674,484,482,8,2,"PUM+J",1
44,"44210",750,577,572,2,5,"PUM+J",0
33,"33044",177059,121380,120421,1543,959,"PUM+J",102
50,"50086",176,106,102,1,4,"PUM+J",0
41,"41079",9285,6591,6446,101,145,"PUM+J",4
14,"14039",2577,1858,1801,29,57,"PUM+J",3
24,"24106",218,139,139,1,0,"PUM+J",1
45,"45183",2378,1555,1525,16,30,"PUM+J",5
45,"45142",7792,5717,5624,62,93,"PUM+J",10
37,"37117",1572,1103,1092,12,11,"PUM+J",2
40,"40195",776,573,565,4,8,"PUM+J",0
40,"40135",277,212,210,3,2,"PUM+J",0
39,"39031",1237,870,865,1,5,"PUM+J",0
28,"28117",99,87,86,0,1,"PUM+J",0
3,"3078",468,340,336,0,4,"PUM+J",0
33,"33030",876,632,630,8,2,"PUM+J",1
49,"49126",260,153,150,1,3,"PUM+J",0
46,"46054",11389,8266,8190,54,76,"PUM+J",5
50,"50263",171,110,108,1,2,"PUM+J",1
16,"16036",120,94,93,0,1,"PUM+J",0
21,"21024",464,328,312,1,16,"PUM+J",0
40,"40905",130,95,95,0,0,"PUM+J",0
37,"37173",1412,951,937,15,14,"PUM+J",1
5,"5140",99,83,81,0,2,"PUM+J",0
6,"6003",768,579,557,4,22,"PUM+J",0
37,"37051",79,58,58,0,0,"PUM+J",0
44,"44219",173,118,115,1,3,"PUM+J",0
9,"9094",53,42,42,0,0,"PUM+J",4
19,"19321",34,28,28,0,0,"PUM+J",0
41,"41044",7753,5636,5547,55,89,"PUM+J",5
45,"45033",297,205,201,1,4,"PUM+J",1
12,"12117",3532,2512,2479,12,33,"PUM+J",1
49,"49176",605,360,353,0,7,"PUM+J",0
50,"50101",833,557,550,5,7,"PUM+J",2
19,"19122",81,62,60,2,2,"PUM+J",0
46,"46084",1487,1136,1123,4,13,"PUM+J",0
46,"46228",2426,1819,1802,19,17,"PUM+J",1
24,"24162",1753,1259,1245,12,14,"PUM+J",2
23,"23045",2054,1423,1412,10,11,"PUM+J",0
39,"39003",261,189,187,2,2,"PUM+J",0
6,"6074",4720,3355,3271,24,84,"PUM+J",11
19,"19055",44,32,31,2,1,"PUM+J",0
2,"2015",1432,1163,1148,8,15,"PUM+J",1
9,"9411",153,105,104,0,1,"PUM+J",0
3,"3137",654,449,443,7,6,"PUM+J",0
37,"37192",361,200,198,3,2,"PUM+J",1
28,"28063",252,188,187,1,1,"PUM+J",0
26,"26067",22,18,18,3,0,"PUM+J",0
34,"34025",52,34,34,1,0,"PUM+J",0
6,"6110",138,105,102,0,3,"PUM+J",0
23,"23007",3015,2252,2229,14,23,"PUM+J",1
46,"46046",901,623,609,2,14,"PUM+J",0
47,"47138",224,169,166,0,3,"PUM+J",0
34,"34129",168,118,118,1,0,"PUM+J",0
26,"26082",101,79,79,0,0,"PUM+J",1
10,"10146",1494,924,903,1,21,"PUM+J",0
44,"44131",26,22,22,0,0,"PUM+J",0
41,"41018",9432,6463,6368,86,95,"PUM+J",7
23,"23079",3624,2661,2630,19,31,"PUM+J",0
29,"29057",330,222,218,2,4,"PUM+J",0
23,"23040",1438,1175,1159,3,16,"PUM+J",0
22,"22090",86,61,61,1,0,"PUM+J",0
46,"46063",1786,1270,1255,8,15,"PUM+J",0
37,"37019",138,111,109,0,2,"PUM+J",0
49,"49156",218,149,144,0,5,"PUM+J",0
50,"50168",29,20,20,0,0,"PUM+J",0
34,"34206",810,608,602,5,6,"PUM+J",1
46,"46061",351,276,272,6,4,"PUM+J",0
16,"16277",105,74,74,0,0,"PUM+J",0
6,"6133",1795,1308,1294,11,14,"PUM+J",2
5,"5159",224,133,132,3,1,"PUM+J",0
28,"28118",61,52,50,0,2,"PUM+J",0
37,"37164",232,176,175,3,1,"PUM+J",1
50,"50250",54,44,44,2,0,"PUM+J",0
24,"24114",2866,1753,1742,15,11,"PUM+J",0
19,"19081",27,21,21,0,0,"PUM+J",0
50,"50075",70,55,55,1,0,"PUM+J",0
34,"34082",78,59,58,0,1,"PUM+J",0
13,"13901",875,628,619,1,9,"PUM+J",0
13,"13059",193,150,150,0,0,"PUM+J",0
19,"19071",8277,5838,5763,53,75,"PUM+J",13
45,"45067",2267,1722,1675,14,47,"PUM+J",3
45,"45081",19268,13690,13516,104,174,"PUM+J",31
45,"45191",524,437,432,2,5,"PUM+J",0
5,"5141",95,79,78,1,1,"PUM+J",0
19,"19268",50,37,35,0,2,"PUM+J",0
41,"41903",6776,4616,4494,72,122,"PUM+J",3
49,"49179",337,210,209,3,1,"PUM+J",0
45,"45202",3963,2806,2771,10,35,"PUM+J",1
26,"26074",107,87,86,2,1,"PUM+J",0
9,"9236",34,25,25,1,0,"PUM+J",0
22,"22182",227,132,131,3,1,"PUM+J",0
9,"9417",42,31,31,1,0,"PUM+J",0
24,"24141",96,74,74,0,0,"PUM+J",0
10,"10175",1351,918,901,8,17,"PUM+J",0
9,"9388",31,26,25,0,1,"PUM+J",0
5,"5079",66,53,52,0,1,"PUM+J",0
24,"24101",370,219,213,4,6,"PUM+J",0
23,"23024",12215,8702,8447,69,255,"PUM+J",10
45,"45043",776,608,598,3,10,"PUM+J",0
4,"4063",1058,766,750,6,16,"PUM+J",0
24,"24102",587,403,399,7,4,"PUM+J",0
37,"37251",108,75,75,0,0,"PUM+J",0
10,"10025",377,308,299,3,9,"PUM+J",0
29,"29051",42179,27231,26724,282,507,"PUM+J",18
50,"50287",253,189,188,11,1,"PUM+J",0
46,"46246",1049,808,793,3,15,"PUM+J",0
45,"45165",62598,43750,43259,329,491,"PUM+J",92
24,"24015",2193,1532,1500,12,32,"PUM+J",0
50,"50107",988,758,755,8,3,"PUM+J",1
10,"10042",85,58,58,0,0,"PUM+J",0
18,"18902",752,589,568,3,21,"PUM+J",0
37,"37157",76,64,63,1,1,"PUM+J",0
49,"49222",369,250,247,2,3,"PUM+J",0
9,"9112",102,73,73,0,0,"PUM+J",0
40,"40142",52,39,37,0,2,"PUM+J",1
13,"13013",7056,5041,4945,52,96,"PUM+J",8
13,"13049",742,509,500,4,9,"PUM+J",0
45,"45177",1998,1557,1525,10,32,"PUM+J",0
46,"46130",862,633,625,6,8,"PUM+J",3
28,"28088",296,196,191,1,5,"PUM+J",1
16,"16065",370,287,287,3,0,"PUM+J",0
5,"5173",60,54,54,0,0,"PUM+J",0
24,"24183",748,464,460,9,4,"PUM+J",0
9,"9243",73,50,49,1,1,"PUM+J",0
34,"34034",112,82,82,1,0,"PUM+J",0
2,"2011",556,429,427,1,2,"PUM+J",0
24,"24074",97,70,70,1,0,"PUM+J",0
18,"18119",1708,1264,1240,7,24,"PUM+J",2
24,"24014",7152,4494,4448,47,46,"PUM+J",2
40,"40070",143,94,92,1,2,"PUM+J",0
46,"46005",23129,16610,16437,148,173,"PUM+J",8
46,"46058",1734,1245,1230,8,15,"PUM+J",0
47,"47199",71,57,57,2,0,"PUM+J",0
44,"44055",75,52,50,0,2,"PUM+J",0
33,"33042",4237,2862,2816,49,46,"PUM+J",0
6,"6149",10177,7582,7455,64,127,"PUM+J",15
19,"19213",67,53,52,1,1,"PUM+J",0
47,"47011",554,466,462,7,4,"PUM+J",0
34,"34216",61,41,41,0,0,"PUM+J",0
42,"42159",39,34,33,0,1,"PUM+J",0
9,"9288",87,64,64,0,0,"PUM+J",0
26,"26006",1833,1358,1335,7,23,"PUM+J",0
9,"9023",1190,891,879,17,12,"PUM+J",2
19,"19283",29,26,26,0,0,"PUM+J",0
46,"46259",457,374,371,2,3,"PUM+J",0
9,"9060",126,104,104,2,0,"PUM+J",0
10,"10116",3737,2579,2507,34,72,"PUM+J",4
44,"44009",798,593,589,4,4,"PUM+J",3
21,"21066",490,394,389,4,5,"PUM+J",0
44,"44135",99,73,73,1,0,"PUM+J",0
45,"45035",286,206,204,2,2,"PUM+J",0
37,"37252",99,65,65,1,0,"PUM+J",0
24,"24182",410,273,270,7,3,"PUM+J",0
9,"9070",33,28,27,0,1,"PUM+J",0
18,"18106",413,270,261,3,9,"PUM+J",1
40,"40076",6576,4700,4607,32,93,"PUM+J",6
9,"9051",164,125,125,0,0,"PUM+J",0
2,"2014",354,254,252,3,2,"PUM+J",0
9,"9168",270,211,210,5,1,"PUM+J",0
16,"16273",300,214,211,3,3,"PUM+J",1
13,"13008",422,280,272,2,8,"PUM+J",0
37,"37202",1004,773,763,12,10,"PUM+J",2
16,"16181",54,40,40,0,0,"PUM+J",0
37,"37149",60,50,50,0,0,"PUM+J",0
45,"45052",3132,2433,2416,29,17,"PUM+J",9
7,"7901",598,410,402,6,8,"PUM+J",0
21,"21072",10233,7374,7183,116,191,"PUM+J",9
18,"18079",3466,2391,2333,22,58,"PUM+J",0
47,"47231",4439,3359,3323,36,36,"PUM+J",11
2,"2047",110,83,81,0,2,"PUM+J",0
9,"9279",166,116,114,1,2,"PUM+J",0
19,"19307",25,23,23,0,0,"PUM+J",0
34,"34175",87,67,66,1,1,"PUM+J",0
28,"28168",1347,933,918,6,15,"PUM+J",0
21,"21073",1902,1073,1043,13,30,"PUM+J",0
2,"2022",341,243,243,2,0,"PUM+J",0
37,"37286",204,140,137,2,3,"PUM+J",0
38,"38028",22144,14312,14174,89,138,"PUM+J",4
9,"9346",90,61,60,1,1,"PUM+J",0
37,"37329",38,29,28,1,1,"PUM+J",0
3,"3121",21997,14689,14572,103,117,"PUM+J",12
37,"37321",150,118,115,0,3,"PUM+J",0
46,"46079",314,244,240,0,4,"PUM+J",0
26,"26132",106,73,70,2,3,"PUM+J",0
9,"9101",72,52,52,0,0,"PUM+J",0
18,"18138",2470,1597,1573,25,24,"PUM+J",1
31,"31006",1877,1328,1310,14,18,"PUM+J",1
31,"31091",322,201,201,3,0,"PUM+J",0
31,"31116",57,27,27,3,0,"PUM+J",0
31,"31171",670,466,462,1,4,"PUM+J",0
31,"31094",105,70,70,1,0,"PUM+J",0
31,"31055",267,192,191,0,1,"PUM+J",1
31,"31156",238,175,174,2,1,"PUM+J",0
31,"31201",151450,105649,104976,1004,673,"PUM+J",355
31,"31088",5656,3929,3893,56,36,"PUM+J",11
31,"31263",231,137,137,1,0,"PUM+J",0
31,"31150",200,120,119,1,1,"PUM+J",0
31,"31148",92,62,59,2,3,"PUM+J",0
31,"31164",542,410,408,5,2,"PUM+J",0
31,"31138",948,629,627,8,2,"PUM+J",1
31,"31159",1097,813,812,2,1,"PUM+J",2
31,"31119",35,24,24,1,0,"PUM+J",0
31,"31249",1798,1235,1227,13,8,"PUM+J",3
31,"31222",57,35,34,3,1,"PUM+J",0
31,"31125",271,173,171,3,2,"PUM+J",1
31,"31040",186,131,129,1,2,"PUM+J",0
31,"31074",394,293,292,5,1,"PUM+J",0
31,"31061",48,45,45,2,0,"PUM+J",1
31,"31199",138,86,84,0,2,"PUM+J",0
31,"31901",15487,11077,10991,117,86,"PUM+J",32
31,"31904",1559,989,972,11,17,"PUM+J",1
31,"31043",29,23,23,0,0,"PUM+J",0
31,"31223",953,667,654,4,13,"PUM+J",1
31,"31066",819,577,559,4,18,"PUM+J",1
31,"31180",202,144,143,1,1,"PUM+J",0
31,"31039",92,70,69,1,1,"PUM+J",0
31,"31078",2418,1752,1729,16,23,"PUM+J",0
31,"31026",130,108,107,0,1,"PUM+J",0
31,"31134",172,106,106,1,0,"PUM+J",0
31,"31226",572,347,343,4,4,"PUM+J",1
31,"31905",2992,1994,1984,9,10,"PUM+J",9
31,"31107",1671,1204,1182,12,22,"PUM+J",0
31,"31187",99,53,52,0,1,"PUM+J",0
31,"31030",135,94,94,0,0,"PUM+J",0
31,"31224",884,637,630,7,7,"PUM+J",0
31,"31170",44,31,30,2,1,"PUM+J",0
31,"31227",8118,5691,5636,65,55,"PUM+J",10
31,"31197",67,51,51,2,0,"PUM+J",0
31,"31179",486,315,312,3,3,"PUM+J",1
31,"31112",91,56,56,0,0,"PUM+J",0
31,"31121",62,42,42,0,0,"PUM+J",0
31,"31177",245,161,159,1,2,"PUM+J",2
31,"31140",112,73,73,1,0,"PUM+J",0
31,"31002",431,294,290,3,4,"PUM+J",0
31,"31254",1916,1336,1322,9,14,"PUM+J",4
31,"31110",83,61,61,1,0,"PUM+J",0
31,"31076",2543,1965,1956,19,9,"PUM+J",9
31,"31098",1984,1443,1428,11,15,"PUM+J",1
31,"31123",615,350,347,4,3,"PUM+J",1
31,"31126",352,223,223,3,0,"PUM+J",3
31,"31245",76,51,48,2,3,"PUM+J",0
31,"31080",486,362,361,4,1,"PUM+J",1
31,"31005",279,183,183,4,0,"PUM+J",0
31,"31265",76,43,40,0,3,"PUM+J",0
31,"31204",36,25,25,0,0,"PUM+J",0
31,"31155",246,165,161,3,4,"PUM+J",0
31,"31092",683,413,413,6,0,"PUM+J",1
31,"31019",1831,1231,1224,17,7,"PUM+J",1
31,"31160",104,83,82,1,1,"PUM+J",0
31,"31037",91,70,70,0,0,"PUM+J",0
31,"31149",2285,1531,1520,10,11,"PUM+J",0
31,"31173",845,642,636,4,6,"PUM+J",0
31,"31200",745,489,483,1,6,"PUM+J",1
31,"31014",268,168,168,2,0,"PUM+J",0
31,"31114",388,272,271,3,1,"PUM+J",0
31,"31099",51,38,38,0,0,"PUM+J",0
31,"31213",99,50,50,0,0,"PUM+J",0
31,"31067",1887,1265,1249,6,16,"PUM+J",1
31,"31230",90,66,66,0,0,"PUM+J",1
31,"31071",13,11,11,0,0,"PUM+J",0
31,"31038",1343,975,963,16,12,"PUM+J",0
31,"31135",111,73,72,3,1,"PUM+J",0
31,"31022",477,303,301,2,2,"PUM+J",0
31,"31175",66,46,46,0,0,"PUM+J",0
31,"31244",157,69,69,0,0,"PUM+J",0
31,"31161",350,261,256,1,5,"PUM+J",0
31,"31186",283,183,182,1,1,"PUM+J",0
31,"31264",179,91,90,2,1,"PUM+J",0
31,"31024",100,52,52,0,0,"PUM+J",1
31,"31128",349,217,215,4,2,"PUM+J",1
31,"31007",122,88,82,1,6,"PUM+J",0
31,"31260",1265,817,815,7,2,"PUM+J",3
31,"31181",133,87,84,1,3,"PUM+J",0
31,"31185",461,291,290,1,1,"PUM+J",0
31,"31235",156,112,108,1,4,"PUM+J",1
31,"31034",31,24,24,0,0,"PUM+J",0
31,"31233",91,62,60,2,2,"PUM+J",0
31,"31152",1255,826,817,8,9,"PUM+J",2
31,"31081",338,229,227,1,2,"PUM+J",1
31,"31162",48,28,27,1,1,"PUM+J",0
31,"31210",186,131,130,2,1,"PUM+J",0
31,"31257",915,654,642,9,12,"PUM+J",2
31,"31256",95,55,55,1,0,"PUM+J",0
31,"31025",762,497,490,1,7,"PUM+J",0
31,"31013",615,371,365,1,6,"PUM+J",1
31,"31158",248,156,151,0,5,"PUM+J",0
31,"31205",419,290,289,4,1,"PUM+J",1
31,"31184",65,41,40,0,1,"PUM+J",0
31,"31253",121,100,100,0,0,"PUM+J",0
31,"31062",1070,778,770,10,8,"PUM+J",0
31,"31027",811,527,521,1,6,"PUM+J",0
31,"31131",913,672,664,8,8,"PUM+J",1
31,"31242",258,168,167,2,1,"PUM+J",0
31,"31172",370,257,250,6,7,"PUM+J",1
31,"31050",6016,3675,3612,41,63,"PUM+J",6
31,"31031",212,134,132,2,2,"PUM+J",0
31,"31136",461,294,293,3,1,"PUM+J",2
31,"31124",207,134,134,2,0,"PUM+J",0
31,"31196",31,23,23,0,0,"PUM+J",0
31,"31193",1440,1062,1055,11,7,"PUM+J",1
31,"31059",182,121,121,1,0,"PUM+J",0
31,"31132",147,100,100,2,0,"PUM+J",0
31,"31209",149,111,110,0,1,"PUM+J",2
31,"31069",823,596,595,1,1,"PUM+J",0
31,"31165",2772,1946,1930,16,16,"PUM+J",5
31,"31144",760,442,441,4,1,"PUM+J",0
31,"31008",61,42,42,0,0,"PUM+J",0
31,"31243",300,216,213,6,3,"PUM+J",1
31,"31259",475,313,311,5,2,"PUM+J",1
31,"31145",160,121,120,2,1,"PUM+J",0
31,"31255",103,79,79,0,0,"PUM+J",0
31,"31194",328,224,222,3,2,"PUM+J",1
31,"31004",31,22,22,1,0,"PUM+J",0
31,"31103",40,28,27,0,1,"PUM+J",0
31,"31118",156,104,104,3,0,"PUM+J",0
31,"31001",79,56,56,0,0,"PUM+J",0
31,"31216",3867,2592,2566,37,26,"PUM+J",4
31,"31146",30,22,22,1,0,"PUM+J",0
31,"31211",17,15,14,3,1,"PUM+J",0
31,"31214",87,55,54,0,1,"PUM+J",0
31,"31174",100,55,55,0,0,"PUM+J",1
31,"31029",913,606,601,14,5,"PUM+J",1
31,"31236",1319,815,808,8,7,"PUM+J",5
31,"31089",236,168,167,1,1,"PUM+J",0
31,"31261",240,161,158,2,3,"PUM+J",1
31,"31102",135,60,60,1,0,"PUM+J",0
31,"31908",1076,763,762,5,1,"PUM+J",2
31,"31046",53,38,38,0,0,"PUM+J",0
31,"31221",1228,823,815,6,8,"PUM+J",3
31,"31234",146,101,101,0,0,"PUM+J",2
31,"31208",2568,1855,1835,24,20,"PUM+J",2
31,"31167",833,581,573,2,8,"PUM+J",2
31,"31237",182,138,135,2,3,"PUM+J",0
31,"31176",2919,1974,1933,27,41,"PUM+J",1
31,"31151",53,37,37,0,0,"PUM+J",0
31,"31120",376,211,209,7,2,"PUM+J",1
31,"31189",1125,702,698,6,4,"PUM+J",1
31,"31104",1751,1147,1125,8,22,"PUM+J",3
31,"31115",159,93,93,2,0,"PUM+J",0
31,"31063",84,59,59,0,0,"PUM+J",0
31,"31101",1428,986,981,6,5,"PUM+J",1
31,"31075",113,69,69,2,0,"PUM+J",1
31,"31054",453,279,276,2,3,"PUM+J",1
31,"31097",10559,6977,6919,71,58,"PUM+J",19
31,"31100",256,166,165,0,1,"PUM+J",0
31,"31015",1989,1399,1386,17,13,"PUM+J",3
31,"31247",141,99,96,1,3,"PUM+J",0
31,"31003",121,71,71,0,0,"PUM+J",1
31,"31251",3144,2197,2164,18,33,"PUM+J",1
31,"31129",388,239,238,3,1,"PUM+J",2
31,"31169",2203,1429,1415,15,14,"PUM+J",1
31,"31047",238,163,163,2,0,"PUM+J",0
31,"31907",11272,8478,8421,97,57,"PUM+J",19
31,"31154",217,107,104,0,3,"PUM+J",0
31,"31246",130,89,87,2,2,"PUM+J",0
31,"31139",152,100,100,1,0,"PUM+J",0
31,"31143",91,44,41,1,3,"PUM+J",0
31,"31021",59,42,42,1,0,"PUM+J",0
31,"31232",25687,17548,17304,243,244,"PUM+J",34
31,"31207",280,194,191,3,3,"PUM+J",0
31,"31020",435,224,222,1,2,"PUM+J",0
31,"31028",215,121,121,2,0,"PUM+J",0
31,"31166",242,172,172,2,0,"PUM+J",0
31,"31106",721,547,545,1,2,"PUM+J",2
31,"31058",199,134,133,2,1,"PUM+J",0
31,"31057",1741,1237,1219,6,18,"PUM+J",1
31,"31212",128,91,91,1,0,"PUM+J",2
31,"31113",130,77,76,0,1,"PUM+J",1
31,"31016",7790,5541,5502,56,39,"PUM+J",15
31,"31183",718,536,534,5,2,"PUM+J",4
31,"31070",2633,1714,1682,16,32,"PUM+J",2
31,"31238",119,96,95,4,1,"PUM+J",1
31,"31017",375,250,250,10,0,"PUM+J",1
31,"31163",2011,1422,1404,6,18,"PUM+J",2
31,"31262",234,190,188,0,2,"PUM+J",1
31,"31095",71,59,59,0,0,"PUM+J",1
31,"31168",238,176,174,1,2,"PUM+J",0
31,"31083",49,39,39,1,0,"PUM+J",5
31,"31010",5719,3799,3770,22,29,"PUM+J",1
31,"31157",3447,2182,2160,29,22,"PUM+J",5
31,"31241",126,86,85,2,1,"PUM+J",0
31,"31079",65,46,46,2,0,"PUM+J",3
31,"31225",35,29,28,0,1,"PUM+J",1
31,"31228",496,356,354,1,2,"PUM+J",0
31,"31023",7778,5977,5948,106,29,"PUM+J",39
31,"31035",50,30,29,0,1,"PUM+J",2
31,"31217",327,204,196,1,8,"PUM+J",0
31,"31202",4360,2806,2767,30,39,"PUM+J",4
31,"31060",14323,9547,9434,79,113,"PUM+J",30
31,"31072",5324,3733,3684,33,49,"PUM+J",4
31,"31231",104,65,65,1,0,"PUM+J",0
31,"31093",275,201,198,3,3,"PUM+J",0
31,"31033",45,25,25,2,0,"PUM+J",0
31,"31056",186,128,124,2,4,"PUM+J",0
31,"31048",166,121,119,1,2,"PUM+J",1
31,"31198",36,30,30,0,0,"PUM+J",0
31,"31147",110,79,78,1,1,"PUM+J",0
31,"31077",5416,3840,3794,38,46,"PUM+J",4
31,"31220",742,551,539,6,12,"PUM+J",2
31,"31240",514,352,352,3,0,"PUM+J",0
31,"31109",1657,1165,1160,12,5,"PUM+J",2
31,"31252",80,52,52,1,0,"PUM+J",2
31,"31053",509,354,350,4,4,"PUM+J",1
31,"31215",4670,3270,3219,33,51,"PUM+J",4
31,"31195",169,108,108,0,0,"PUM+J",0
31,"31133",34,27,27,1,0,"PUM+J",0
31,"31902",4661,3228,3201,39,27,"PUM+J",6
31,"31190",44,30,30,1,0,"PUM+J",0
31,"31036",879,601,589,5,12,"PUM+J",1
31,"31052",101,78,75,0,3,"PUM+J",0
31,"31086",13781,10133,10054,114,79,"PUM+J",40
31,"31191",3024,2156,2133,23,23,"PUM+J",5
31,"31012",763,550,542,7,8,"PUM+J",3
31,"31906",2707,1800,1781,22,19,"PUM+J",6
31,"31018",426,287,283,2,4,"PUM+J",0
31,"31250",2761,1776,1759,13,17,"PUM+J",8
31,"31087",179,124,124,3,0,"PUM+J",0
31,"31111",91,52,52,0,0,"PUM+J",0
31,"31127",131,90,86,0,4,"PUM+J",0
31,"31192",160,125,123,0,2,"PUM+J",2
31,"31065",1843,1311,1300,12,11,"PUM+J",1
31,"31045",510,347,345,8,2,"PUM+J",0
31,"31082",627,385,385,5,0,"PUM+J",0
31,"31085",500,365,362,2,3,"PUM+J",1
31,"31068",2816,2028,1989,20,39,"PUM+J",5
31,"31188",319,197,191,3,6,"PUM+J",4
31,"31122",4981,3539,3504,38,35,"PUM+J",11
31,"31108",1819,1348,1325,13,23,"PUM+J",6
31,"31229",39,32,32,0,0,"PUM+J",0
31,"31042",2707,1926,1900,11,26,"PUM+J",0
31,"31090",139,67,67,0,0,"PUM+J",0
31,"31032",1670,1158,1147,18,11,"PUM+J",1
31,"31130",321,203,203,0,0,"PUM+J",2
31,"31141",106,66,61,1,5,"PUM+J",0
31,"31049",679,461,453,2,8,"PUM+J",0
31,"31153",2174,1417,1415,12,2,"PUM+J",3
31,"31084",1946,1367,1362,9,5,"PUM+J",1
31,"31248",272,142,138,3,4,"PUM+J",0
31,"31011",715,483,481,5,2,"PUM+J",2
31,"31096",99,79,79,3,0,"PUM+J",0
31,"31064",1398,1035,1031,5,4,"PUM+J",0
31,"31206",2077,1433,1417,15,16,"PUM+J",5
31,"31041",1671,1118,1105,15,13,"PUM+J",6
31,"31203",30,19,19,2,0,"PUM+J",0
31,"31219",80,59,58,2,1,"PUM+J",0
31,"31258",7879,5668,5631,50,37,"PUM+J",31
31,"31051",241,169,167,3,2,"PUM+J",0
31,"31105",1471,1144,1124,10,20,"PUM+J",1
31,"31178",476,323,320,7,3,"PUM+J",0
31,"31142",1389,909,900,9,9,"PUM+J",1
31,"31182",29,25,25,0,0,"PUM+J",0
31,"31117",583,373,372,3,1,"PUM+J",0
31,"31009",674,455,451,2,4,"PUM+J",1
31,"31903",6950,4430,4394,39,36,"PUM+J",10
31,"31137",198,83,83,1,0,"PUM+J",0
31,"31073",298,207,206,1,1,"PUM+J",0
31,"31239",282,196,193,6,3,"PUM+J",0
31,"31044",291,227,227,1,0,"PUM+J",0
50,"50236",95,77,75,0,2,"PYLN",0
44,"44190",63,45,45,0,0,"PYLN",0
50,"50280",290,220,216,1,4,"PYLN",0
22,"22250",346,241,241,0,0,"PYLN",1
44,"44239",21,19,19,0,0,"PYLN",0
22,"22041",145,116,116,2,0,"PYLN",0
22,"22141",115,94,93,0,1,"PYLN",0
44,"44115",102,91,91,0,0,"PYLN",1
50,"50278",175,133,131,2,2,"PYLN",0
50,"50082",82,57,57,0,0,"PYLN",0
50,"50030",197,124,124,1,0,"PYLN",0
50,"50102",815,594,584,7,10,"PYLN",0
44,"44260",137,93,93,1,0,"PYLN",0
44,"44063",63,52,52,0,0,"PYLN",0
50,"50169",333,231,230,0,1,"PYLN",0
50,"50157",289,199,196,1,3,"PYLN",2
50,"50196",101,73,73,0,0,"PYLN",0
50,"50122",68,43,42,1,1,"PYLN",0
50,"50032",243,167,164,3,3,"PYLN",0
50,"50253",379,294,290,1,4,"PYLN",0
44,"44241",500,361,357,0,4,"PYLN",0
44,"44064",62,46,46,0,0,"PYLN",0
22,"22225",2606,1638,1612,20,26,"PYLN",1
22,"22907",1463,1016,1006,21,10,"PYLN",1
44,"44094",127,103,103,0,0,"PYLN",0
44,"44226",123,85,84,0,1,"PYLN",0
44,"44120",219,147,145,3,2,"PYLN",0
50,"50092",290,218,214,0,4,"PYLN",0
50,"50085",182,121,121,0,0,"PYLN",0
44,"44220",113,82,82,1,0,"PYLN",0
44,"44184",44,37,37,0,0,"PYLN",0
22,"22230",291,209,207,4,2,"PYLN",0
44,"44203",9,9,9,0,0,"PYLN",0
22,"22069",423,296,294,4,2,"PYLN",0
50,"50284",129,98,98,0,0,"PYLN",0
44,"44199",39,37,37,2,0,"PYLN",0
50,"50069",66,33,33,1,0,"PYLN",0
44,"44004",379,275,275,2,0,"PYLN",0
44,"44005",48,36,36,0,0,"PYLN",0
50,"50221",29,18,18,0,0,"PYLN",0
22,"22017",826,613,608,2,5,"PYLN",0
50,"50098",162,119,118,1,1,"PYLN",0
44,"44028",171,136,136,0,0,"PYLN",0
22,"22053",783,494,492,6,2,"PYLN",1
50,"50019",63,46,46,0,0,"PYLN",0
22,"22227",200,140,140,2,0,"PYLN",1
50,"50037",125,85,80,0,5,"PYLN",0
44,"44092",70,53,52,0,1,"PYLN",0
50,"50114",132,108,108,0,0,"PYLN",0
22,"22150",459,325,321,8,4,"PYLN",0
44,"44159",37,27,27,1,0,"PYLN",0
50,"50219",4283,3034,2990,30,44,"PYLN",3
44,"44114",233,161,159,0,2,"PYLN",0
22,"22904",751,516,511,3,5,"PYLN",0
22,"22086",194,137,137,1,0,"PYLN",0
44,"44008",1556,1109,1100,7,9,"PYLN",0
44,"44100",177,136,135,1,1,"PYLN",0
50,"50171",99,69,69,2,0,"PYLN",0
44,"44144",319,225,223,0,2,"PYLN",0
22,"22106",20,13,13,2,0,"PYLN",0
50,"50065",56,37,37,0,0,"PYLN",0
50,"50061",190,157,155,2,2,"PYLN",0
50,"50230",1140,771,767,11,4,"PYLN",1
22,"22077",362,280,272,5,8,"PYLN",0
50,"50140",153,96,95,1,1,"PYLN",0
22,"22105",102,65,65,0,0,"PYLN",0
22,"22217",370,274,269,4,5,"PYLN",0
22,"22193",272,199,194,4,5,"PYLN",1
50,"50146",189,149,149,3,0,"PYLN",0
22,"22226",761,537,530,13,7,"PYLN",0
44,"44161",428,294,292,2,2,"PYLN",0
44,"44228",96,75,74,0,1,"PYLN",0
44,"44108",306,209,205,1,4,"PYLN",0
22,"22253",56,40,40,1,0,"PYLN",0
50,"50231",253,199,195,4,4,"PYLN",0
44,"44204",27,18,18,0,0,"PYLN",0
44,"44039",204,144,143,1,1,"PYLN",1
50,"50087",28,19,19,0,0,"PYLN",0
50,"50134",120,85,82,4,3,"PYLN",0
44,"44178",52,34,34,0,0,"PYLN",0
50,"50024",543,400,397,3,3,"PYLN",0
44,"44158",1153,879,872,6,7,"PYLN",0
44,"44218",28,24,24,3,0,"PYLN",0
22,"22243",43,32,31,0,1,"PYLN",0
50,"50106",123,78,78,0,0,"PYLN",0
44,"44036",22,20,20,0,0,"PYLN",0
22,"22175",184,129,128,0,1,"PYLN",0
44,"44246",1599,1012,1001,11,11,"PYLN",2
44,"44208",27,17,17,0,0,"PYLN",0
22,"22202",147,128,128,3,0,"PYLN",0
22,"22125",39530,27358,27075,344,283,"PYLN",23
22,"22112",9525,6317,6245,91,72,"PYLN",4
44,"44017",269,217,216,0,1,"PYLN",0
44,"44065",55,33,32,0,1,"PYLN",0
44,"44197",51,35,35,1,0,"PYLN",0
50,"50152",1351,942,932,14,10,"PYLN",0
44,"44135",99,73,73,1,0,"PYLN",0
50,"50045",1217,891,878,10,13,"PYLN",0
44,"44020",22,21,21,0,0,"PYLN",0
44,"44022",464,330,325,1,5,"PYLN",0
22,"22040",149,119,119,3,0,"PYLN",0
44,"44011",47,34,34,0,0,"PYLN",0
50,"50130",354,225,222,1,3,"PYLN",0
50,"50079",226,162,160,1,2,"PYLN",3
50,"50185",140,93,92,1,1,"PYLN",0
50,"50117",123,93,93,4,0,"PYLN",0
22,"22143",190,118,115,1,3,"PYLN",0
50,"50240",943,693,683,12,10,"PYLN",1
22,"22076",285,207,203,4,4,"PYLN",0
50,"50281",68,52,50,0,2,"PYLN",0
50,"50243",307,227,224,2,3,"PYLN",0
44,"44200",39,26,26,0,0,"PYLN",0
44,"44182",203,160,158,0,2,"PYLN",0
50,"50180",107,85,85,1,0,"PYLN",1
44,"44257",149,92,91,0,1,"PYLN",0
50,"50272",13226,9250,9153,97,97,"PYLN",2
50,"50251",8209,5732,5658,66,74,"PYLN",13
50,"50125",340,230,229,2,1,"PYLN",0
50,"50225",1532,983,971,12,12,"PYLN",5
22,"22901",714,433,423,6,10,"PYLN",0
50,"50220",45,38,38,0,0,"PYLN",0
44,"44050",3113,2173,2154,14,19,"PYLN",1
22,"22249",125,93,92,1,1,"PYLN",0
50,"50246",37,24,24,0,0,"PYLN",0
44,"44086",410,302,298,3,4,"PYLN",0
50,"50105",277,203,198,4,5,"PYLN",0
44,"44132",54,49,49,0,0,"PYLN",0
44,"44181",65,57,57,0,0,"PYLN",0
50,"50195",53,42,38,0,4,"PYLN",0
22,"22135",173,123,121,0,2,"PYLN",0
50,"50016",44,31,31,0,0,"PYLN",0
50,"50229",65,46,46,1,0,"PYLN",0
44,"44198",182,138,135,0,3,"PYLN",0
50,"50018",883,622,616,5,6,"PYLN",0
22,"22059",1135,765,752,2,13,"PYLN",0
50,"50286",75,54,53,0,1,"PYLN",0
22,"22016",558,384,382,5,2,"PYLN",0
44,"44215",167,113,113,2,0,"PYLN",0
44,"44126",314,222,221,0,1,"PYLN",0
44,"44034",124,90,90,0,0,"PYLN",0
50,"50163",3846,2863,2840,25,23,"PYLN",1
44,"44023",18,15,14,0,1,"PYLN",0
50,"50218",112,88,88,1,0,"PYLN",0
44,"44047",225,103,103,0,0,"PYLN",0
44,"44002",47,41,41,0,0,"PYLN",0
50,"50048",33,25,25,0,0,"PYLN",0
22,"22236",232,190,188,2,2,"PYLN",0
44,"44128",58,39,37,0,2,"PYLN",0
50,"50038",1404,1024,1007,15,17,"PYLN",1
50,"50241",582,414,406,2,8,"PYLN",1
50,"50047",38,24,24,0,0,"PYLN",0
44,"44156",47,31,31,0,0,"PYLN",0
50,"50223",906,702,693,9,9,"PYLN",0
44,"44053",103,87,85,1,2,"PYLN",0
50,"50228",249,207,207,3,0,"PYLN",0
22,"22155",66,52,52,0,0,"PYLN",0
22,"22222",516,379,377,6,2,"PYLN",0
44,"44149",99,74,73,4,1,"PYLN",0
22,"22254",1084,744,735,10,9,"PYLN",0
44,"44223",73,48,48,0,0,"PYLN",0
50,"50289",53,42,42,1,0,"PYLN",0
44,"44040",189,153,150,1,3,"PYLN",0
22,"22035",225,153,152,1,1,"PYLN",0
44,"44207",125,98,97,2,1,"PYLN",0
44,"44077",68,52,51,0,1,"PYLN",0
50,"50176",220,142,142,3,0,"PYLN",0
22,"22009",581,387,386,7,1,"PYLN",0
50,"50151",607,450,449,12,1,"PYLN",0
50,"50206",457,349,345,5,4,"PYLN",0
22,"22199",6884,4438,4384,71,54,"PYLN",1
22,"22074",303,209,208,5,1,"PYLN",0
44,"44205",619,420,415,5,5,"PYLN",0
50,"50208",1761,1267,1250,16,17,"PYLN",0
22,"22187",288,220,220,2,0,"PYLN",0
50,"50099",3036,2137,2113,17,24,"PYLN",2
50,"50235",2421,1721,1702,18,19,"PYLN",1
44,"44066",85,62,62,0,0,"PYLN",0
44,"44245",240,177,174,0,3,"PYLN",0
22,"22014",227,164,162,5,2,"PYLN",0
22,"22176",171,140,138,2,2,"PYLN",0
22,"22151",85,60,60,0,0,"PYLN",0
44,"44056",446,327,325,1,2,"PYLN",0
44,"44201",477,399,395,1,4,"PYLN",0
50,"50009",97,61,61,1,0,"PYLN",0
50,"50161",98,75,74,2,1,"PYLN",0
44,"44195",82,58,57,0,1,"PYLN",0
22,"22003",135,107,107,0,0,"PYLN",0
50,"50249",283,202,200,0,2,"PYLN",0
50,"50175",907,638,632,11,6,"PYLN",0
22,"22062",154,107,107,1,0,"PYLN",0
44,"44236",60,38,38,0,0,"PYLN",0
44,"44171",176,115,115,0,0,"PYLN",0
22,"22165",449,305,300,3,5,"PYLN",1
50,"50001",89,68,68,0,0,"PYLN",0
44,"44031",83,50,50,0,0,"PYLN",0
44,"44131",26,22,22,0,0,"PYLN",0
44,"44267",70,47,46,0,1,"PYLN",0
22,"22188",75,50,50,1,0,"PYLN",0
22,"22215",127,81,81,0,0,"PYLN",0
44,"44160",438,287,285,4,2,"PYLN",0
50,"50242",99,74,74,0,0,"PYLN",0
22,"22068",64,41,41,1,0,"PYLN",0
44,"44093",78,62,61,0,1,"PYLN",0
44,"44151",180,134,134,1,0,"PYLN",0
22,"22903",618,484,482,5,2,"PYLN",0
22,"22190",123,77,77,1,0,"PYLN",0
44,"44164",19,16,16,1,0,"PYLN",0
44,"44169",298,216,216,0,0,"PYLN",0
22,"22036",84,71,71,1,0,"PYLN",0
22,"22054",1614,1029,1009,19,20,"PYLN",1
50,"50259",82,55,55,2,0,"PYLN",0
44,"44001",65,43,43,1,0,"PYLN",0
50,"50084",67,47,47,1,0,"PYLN",0
44,"44153",1733,1131,1125,0,6,"PYLN",0
50,"50043",241,155,154,1,1,"PYLN",0
50,"50035",74,57,57,0,0,"PYLN",8
44,"44070",55,49,49,0,0,"PYLN",0
44,"44013",11232,7872,7801,64,71,"PYLN",4
44,"44085",49,29,29,0,0,"PYLN",0
44,"44096",155,115,114,1,1,"PYLN",1
50,"50174",80,58,57,0,1,"PYLN",0
22,"22164",42,28,28,0,0,"PYLN",0
22,"22128",188,145,143,3,2,"PYLN",0
22,"22028",358,237,233,1,4,"PYLN",0
50,"50143",541,373,367,2,6,"PYLN",0
22,"22078",431,285,285,4,0,"PYLN",0
50,"50210",37,26,26,0,0,"PYLN",0
50,"50167",208,166,163,1,3,"PYLN",0
22,"22189",175,142,142,1,0,"PYLN",0
50,"50139",318,237,237,1,0,"PYLN",0
50,"50238",84,65,65,0,0,"PYLN",0
50,"50067",13928,9831,9699,92,132,"PYLN",4
44,"44003",17,15,15,0,0,"PYLN",0
44,"44174",402,289,288,1,1,"PYLN",0
50,"50059",757,556,551,5,5,"PYLN",0
44,"44219",173,118,115,1,3,"PYLN",0
44,"44049",784,539,532,3,7,"PYLN",0
50,"50170",357,245,242,6,3,"PYLN",0
44,"44187",193,147,146,0,1,"PYLN",0
44,"44235",87,65,64,1,1,"PYLN",1
22,"22039",813,635,634,4,1,"PYLN",1
44,"44054",95,82,81,0,1,"PYLN",0
44,"44090",66,49,49,0,0,"PYLN",0
44,"44155",1063,779,778,3,1,"PYLN",0
22,"22061",6567,4446,4410,48,36,"PYLN",1
50,"50062",1885,1332,1308,15,24,"PYLN",1
44,"44111",78,61,61,0,0,"PYLN",0
44,"44087",67,52,50,0,2,"PYLN",0
44,"44074",440,314,308,2,6,"PYLN",0
44,"44016",424,299,297,1,2,"PYLN",0
50,"50212",32,26,26,0,0,"PYLN",0
50,"50021",25,21,21,0,0,"PYLN",0
44,"44175",112,76,75,1,1,"PYLN",0
50,"50215",20,14,14,0,0,"PYLN",0
44,"44099",644,422,421,2,1,"PYLN",0
22,"22119",1267,880,871,4,9,"PYLN",0
50,"50265",74,54,54,1,0,"PYLN",0
22,"22075",116,71,69,1,2,"PYLN",0
44,"44035",102,82,80,1,2,"PYLN",0
50,"50005",228,185,184,2,1,"PYLN",1
50,"50100",304,215,212,1,3,"PYLN",0
44,"44193",73,60,60,1,0,"PYLN",0
44,"44130",28,23,23,0,0,"PYLN",0
44,"44067",106,75,71,0,4,"PYLN",0
22,"22004",123,83,83,0,0,"PYLN",0
44,"44148",74,56,54,0,2,"PYLN",0
50,"50216",236,169,167,0,2,"PYLN",0
22,"22902",206,147,144,1,3,"PYLN",0
50,"50150",624,387,384,2,3,"PYLN",0
50,"50141",104,80,78,0,2,"PYLN",1
44,"44127",57,43,43,0,0,"PYLN",0
44,"44243",25,19,19,0,0,"PYLN",0
44,"44018",16,16,16,0,0,"PYLN",0
44,"44137",187,139,139,0,0,"PYLN",0
22,"22015",299,218,215,1,3,"PYLN",0
44,"44122",1277,939,934,5,5,"PYLN",0
50,"50233",96,78,78,0,0,"PYLN",0
44,"44037",447,288,288,1,0,"PYLN",2
44,"44180",74,56,56,0,0,"PYLN",0
22,"22177",96,69,68,0,1,"PYLN",0
50,"50217",426,333,333,1,0,"PYLN",0
50,"50129",212,129,127,0,2,"PYLN",0
50,"50203",1065,817,804,5,13,"PYLN",3
50,"50124",394,269,266,0,3,"PYLN",0
50,"50258",53,25,25,1,0,"PYLN",0
50,"50081",487,355,349,5,6,"PYLN",0
44,"44052",75,54,54,0,0,"PYLN",0
50,"50008",5187,3334,3288,37,46,"PYLN",3
50,"50090",134,96,96,0,0,"PYLN",0
44,"44019",70,42,42,0,0,"PYLN",0
44,"44252",73,56,55,0,1,"PYLN",0
44,"44168",181,119,117,1,2,"PYLN",0
44,"44038",101,85,83,1,2,"PYLN",0
50,"50177",288,196,193,0,3,"PYLN",2
22,"22223",77,60,59,2,1,"PYLN",0
44,"44102",26,19,19,0,0,"PYLN",0
22,"22007",751,527,520,1,7,"PYLN",0
22,"22023",385,293,283,2,10,"PYLN",0
50,"50050",87,62,62,1,0,"PYLN",0
44,"44121",52,42,42,1,0,"PYLN",0
44,"44152",70,46,46,0,0,"PYLN",0
22,"22043",93,53,53,0,0,"PYLN",0
22,"22242",60,41,40,0,1,"PYLN",0
22,"22239",85,67,65,0,2,"PYLN",0
44,"44071",585,419,418,6,1,"PYLN",0
22,"22066",755,529,520,8,9,"PYLN",0
50,"50126",2240,1528,1509,24,19,"PYLN",26
50,"50022",504,373,369,12,4,"PYLN",0
50,"50118",2101,1484,1477,17,7,"PYLN",0
22,"22087",60,46,46,0,0,"PYLN",0
44,"44048",52,47,47,0,0,"PYLN",0
22,"22203",77,62,62,2,0,"PYLN",0
22,"22102",180,137,136,3,1,"PYLN",0
50,"50162",135,100,99,3,1,"PYLN",0
22,"22235",88,69,68,1,1,"PYLN",0
50,"50136",532,366,361,3,5,"PYLN",0
50,"50119",876,633,625,11,8,"PYLN",0
50,"50026",418,292,288,4,4,"PYLN",0
44,"44046",44,33,33,0,0,"PYLN",0
50,"50039",462,339,333,1,6,"PYLN",0
50,"50110",340,248,238,1,10,"PYLN",0
22,"22111",143,96,95,2,1,"PYLN",0
22,"22051",90,72,72,2,0,"PYLN",0
50,"50297",503800,365284,362768,3385,2516,"PYLN",382
50,"50078",227,168,166,0,2,"PYLN",0
44,"44059",562,411,407,2,4,"PYLN",0
22,"22063",161,128,126,0,2,"PYLN",0
22,"22172",520,373,369,5,4,"PYLN",1
44,"44249",40,30,30,0,0,"PYLN",0
50,"50120",55,42,42,1,0,"PYLN",0
50,"50291",95,76,76,0,0,"PYLN",0
44,"44143",388,298,298,2,0,"PYLN",0
44,"44192",341,274,272,2,2,"PYLN",0
22,"22049",73,62,62,0,0,"PYLN",0
50,"50002",125,91,86,0,5,"PYLN",0
50,"50027",223,166,161,2,5,"PYLN",0
50,"50288",3440,2513,2486,26,27,"PYLN",0
50,"50093",87,66,64,1,2,"PYLN",0
22,"22080",263,188,184,3,4,"PYLN",0
50,"50254",179,115,113,0,2,"PYLN",0
50,"50055",3635,2298,2244,36,54,"PYLN",0
50,"50074",6156,4100,4022,33,78,"PYLN",7
22,"22213",2918,2084,2062,20,22,"PYLN",0
44,"44258",53,46,46,0,0,"PYLN",0
44,"44150",28,17,17,0,0,"PYLN",0
50,"50178",269,165,163,6,2,"PYLN",0
44,"44029",585,454,451,2,3,"PYLN",0
44,"44133",15,12,12,0,0,"PYLN",0
22,"22090",86,61,61,1,0,"PYLN",0
50,"50003",117,89,89,1,0,"PYLN",0
50,"50279",74,49,49,0,0,"PYLN",0
22,"22116",1342,915,905,11,10,"PYLN",0
22,"22018",303,216,215,3,1,"PYLN",0
44,"44183",61,47,47,1,0,"PYLN",0
50,"50148",304,213,211,2,2,"PYLN",3
22,"22113",478,335,333,6,2,"PYLN",0
22,"22096",332,248,241,10,7,"PYLN",0
22,"22057",364,253,248,4,5,"PYLN",0
44,"44084",54,46,46,1,0,"PYLN",0
50,"50168",29,20,20,0,0,"PYLN",0
50,"50244",192,131,130,1,1,"PYLN",0
50,"50023",199,145,143,2,2,"PYLN",0
22,"22019",176,128,126,1,2,"PYLN",0
22,"22013",271,200,197,3,3,"PYLN",0
22,"22184",167,132,130,4,2,"PYLN",0
50,"50214",18,18,14,1,4,"PYLN",0
50,"50142",23,16,16,1,0,"PYLN",0
44,"44222",125,92,92,0,0,"PYLN",0
22,"22220",147,106,105,1,1,"PYLN",0
44,"44213",68,47,47,0,0,"PYLN",0
50,"50201",449,345,344,4,1,"PYLN",0
22,"22094",102,69,69,3,0,"PYLN",0
50,"50149",34,25,25,0,0,"PYLN",0
50,"50166",235,186,186,0,0,"PYLN",0
50,"50294",65,45,45,0,0,"PYLN",1
50,"50903",2268,1685,1670,16,15,"PYLN",0
44,"44185",88,69,69,2,0,"PYLN",0
44,"44118",154,109,106,1,3,"PYLN",0
22,"22099",490,349,343,2,6,"PYLN",0
44,"44123",95,68,68,0,0,"PYLN",0
50,"50060",171,126,125,1,1,"PYLN",0
50,"50262",1161,849,832,11,17,"PYLN",0
44,"44106",151,107,106,0,1,"PYLN",0
50,"50172",174,125,123,2,2,"PYLN",0
44,"44163",115,79,78,0,1,"PYLN",0
50,"50274",64,46,43,1,3,"PYLN",0
22,"22044",234,166,164,1,2,"PYLN",0
22,"22095",66,52,51,1,1,"PYLN",0
44,"44110",37,30,30,0,0,"PYLN",0
44,"44224",21,14,14,2,0,"PYLN",0
50,"50014",119,81,81,0,0,"PYLN",0
50,"50006",913,670,654,13,16,"PYLN",0
22,"22200",239,165,164,2,1,"PYLN",2
50,"50159",640,493,486,3,7,"PYLN",1
22,"22072",197,127,126,1,1,"PYLN",2
22,"22163",426,338,335,0,3,"PYLN",0
22,"22909",307,219,217,0,2,"PYLN",0
44,"44261",713,553,549,3,4,"PYLN",0
44,"44247",291,207,206,4,1,"PYLN",0
50,"50224",61,44,44,2,0,"PYLN",0
22,"22114",124,75,72,1,3,"PYLN",0
50,"50089",8616,6420,6364,50,56,"PYLN",3
44,"44089",49,41,41,0,0,"PYLN",0
50,"50239",63,46,45,1,1,"PYLN",0
22,"22064",155,100,100,2,0,"PYLN",0
44,"44129",35,29,29,1,0,"PYLN",0
22,"22046",713,555,549,9,6,"PYLN",0
50,"50154",114,92,92,1,0,"PYLN",0
44,"44268",32,30,30,0,0,"PYLN",0
22,"22234",743,498,491,5,7,"PYLN",1
50,"50057",1331,933,922,10,11,"PYLN",0
44,"44010",185,144,143,0,1,"PYLN",0
44,"44117",327,258,258,0,0,"PYLN",0
44,"44211",33,22,22,0,0,"PYLN",0
44,"44141",122,88,85,0,3,"PYLN",0
22,"22011",98,80,79,0,1,"PYLN",0
50,"50188",26,23,23,0,0,"PYLN",0
50,"50256",70,43,43,0,0,"PYLN",0
22,"22083",447,360,355,6,5,"PYLN",0
22,"22247",28,18,18,0,0,"PYLN",0
50,"50227",107,62,62,1,0,"PYLN",0
50,"50186",37,26,26,1,0,"PYLN",0
22,"22055",305,242,235,2,7,"PYLN",2
22,"22089",274,195,193,2,2,"PYLN",0
22,"22037",112,87,87,2,0,"PYLN",0
50,"50202",124,76,74,0,2,"PYLN",0
22,"22136",749,524,518,5,6,"PYLN",0
44,"44179",324,201,201,2,0,"PYLN",3
44,"44142",29,21,21,0,0,"PYLN",0
50,"50025",4541,3110,3083,39,27,"PYLN",0
50,"50091",39,32,32,0,0,"PYLN",0
44,"44209",799,584,573,2,11,"PYLN",0
50,"50033",61,44,44,1,0,"PYLN",0
22,"22024",220,159,158,1,1,"PYLN",0
50,"50211",236,174,173,0,1,"PYLN",0
44,"44172",296,216,216,1,0,"PYLN",0
22,"22084",571,400,391,5,9,"PYLN",0
44,"44237",367,267,262,0,5,"PYLN",0
50,"50200",479,389,383,5,6,"PYLN",1
50,"50075",70,55,55,1,0,"PYLN",0
50,"50131",212,152,147,4,5,"PYLN",0
22,"22130",10146,6505,6436,57,69,"PYLN",3
50,"50070",50,30,29,0,1,"PYLN",0
44,"44119",116,80,79,1,1,"PYLN",0
22,"22182",227,132,131,3,1,"PYLN",0
22,"22204",1117,728,723,14,5,"PYLN",1
50,"50052",81,61,61,0,0,"PYLN",0
44,"44189",44,35,35,0,0,"PYLN",0
50,"50204",2396,1723,1712,17,11,"PYLN",0
50,"50277",45,34,34,0,0,"PYLN",0
44,"44041",60,48,48,0,0,"PYLN",0
50,"50237",100,75,75,2,0,"PYLN",0
44,"44060",32,25,25,0,0,"PYLN",0
22,"22160",207,149,149,1,0,"PYLN",0
44,"44061",77,60,58,1,2,"PYLN",0
44,"44032",17,13,13,0,0,"PYLN",0
22,"22052",874,660,652,7,8,"PYLN",0
44,"44173",103,81,79,0,2,"PYLN",0
44,"44112",400,265,265,2,0,"PYLN",0
50,"50123",430,304,297,3,7,"PYLN",0
50,"50298",5439,4053,4007,41,46,"PYLN",1
22,"22032",102,69,68,1,1,"PYLN",0
50,"50207",87,58,58,1,0,"PYLN",0
50,"50273",33,24,24,1,0,"PYLN",0
22,"22168",22,20,19,0,1,"PYLN",0
50,"50156",212,156,151,2,5,"PYLN",0
50,"50138",45,37,37,3,0,"PYLN",0
50,"50205",72,51,49,0,2,"PYLN",0
44,"44124",71,57,57,0,0,"PYLN",0
22,"22228",532,371,364,4,7,"PYLN",0
50,"50287",253,189,188,11,1,"PYLN",0
44,"44062",31,20,20,0,0,"PYLN",0
22,"22082",288,217,214,0,3,"PYLN",0
50,"50271",246,179,173,4,6,"PYLN",0
22,"22218",39,34,34,0,0,"PYLN",0
50,"50252",5019,3486,3456,53,30,"PYLN",24
50,"50029",594,432,431,3,1,"PYLN",0
50,"50153",914,683,675,9,8,"PYLN",0
50,"50004",475,360,356,2,4,"PYLN",1
50,"50073",2122,1559,1540,14,19,"PYLN",2
50,"50072",183,131,129,0,2,"PYLN",0
44,"44206",100,73,73,3,0,"PYLN",0
22,"22042",116,91,89,1,2,"PYLN",0
50,"50283",69,46,46,0,0,"PYLN",0
44,"44138",120,92,92,0,0,"PYLN",0
50,"50054",55,37,37,2,0,"PYLN",0
50,"50187",55,42,42,0,0,"PYLN",0
22,"22085",94,78,76,0,2,"PYLN",0
50,"50198",47,32,32,0,0,"PYLN",0
50,"50095",12149,8322,8239,91,83,"PYLN",2
44,"44025",5804,4024,3991,11,33,"PYLN",1
22,"22208",192,150,147,1,3,"PYLN",1
50,"50179",255,197,197,0,0,"PYLN",0
50,"50132",780,549,538,7,11,"PYLN",0
22,"22020",115,83,80,3,3,"PYLN",0
50,"50182",3657,2499,2485,23,14,"PYLN",1
50,"50076",70,56,56,0,0,"PYLN",0
44,"44007",149,112,111,1,1,"PYLN",0
44,"44244",67,40,40,0,0,"PYLN",0
50,"50046",162,125,125,6,0,"PYLN",0
50,"50248",501,344,328,3,16,"PYLN",0
50,"50199",318,206,201,1,5,"PYLN",0
44,"44080",281,202,199,0,3,"PYLN",0
22,"22110",700,476,473,3,3,"PYLN",2
50,"50183",316,227,223,1,4,"PYLN",0
44,"44088",24,23,23,0,0,"PYLN",0
50,"50064",439,348,346,1,2,"PYLN",0
44,"44076",2089,1577,1565,8,12,"PYLN",0
50,"50109",95,65,62,2,3,"PYLN",0
44,"44075",321,255,252,1,3,"PYLN",0
22,"22021",1884,1331,1319,26,12,"PYLN",0
50,"50290",360,260,255,5,5,"PYLN",0
22,"22233",81,53,53,0,0,"PYLN",0
50,"50007",51,34,34,1,0,"PYLN",1
44,"44225",105,82,81,2,1,"PYLN",0
50,"50192",227,182,181,0,1,"PYLN",0
22,"22002",99,81,81,0,0,"PYLN",0
50,"50184",87,70,70,0,0,"PYLN",0
22,"22149",301,211,210,1,1,"PYLN",0
22,"22060",1167,817,808,14,9,"PYLN",1
44,"44006",220,152,151,1,1,"PYLN",1
22,"22229",107,70,70,2,0,"PYLN",0
44,"44266",102,81,79,0,2,"PYLN",0
44,"44264",254,170,170,0,0,"PYLN",0
44,"44082",84,66,66,0,0,"PYLN",0
22,"22246",63,43,43,0,0,"PYLN",1
44,"44157",61,37,37,0,0,"PYLN",0
50,"50269",287,172,167,2,5,"PYLN",0
50,"50108",50,37,37,0,0,"PYLN",0
50,"50250",54,44,44,2,0,"PYLN",0
50,"50275",111,50,50,0,0,"PYLN",0
22,"22167",465,358,356,8,2,"PYLN",0
50,"50264",151,111,110,0,1,"PYLN",0
50,"50011",117,90,89,3,1,"PYLN",0
44,"44229",141,99,98,1,1,"PYLN",0
44,"44262",141,104,103,0,1,"PYLN",0
22,"22079",118,85,84,1,1,"PYLN",0
22,"22252",118,95,91,1,4,"PYLN",0
50,"50041",16,10,10,0,0,"PYLN",0
22,"22144",255,192,190,2,2,"PYLN",0
50,"50083",81,64,64,2,0,"PYLN",0
50,"50071",126,84,84,0,0,"PYLN",0
22,"22131",84,62,58,5,4,"PYLN",0
22,"22027",311,210,209,1,1,"PYLN",0
22,"22181",86,55,54,2,1,"PYLN",0
44,"44221",386,307,304,1,3,"PYLN",0
50,"50058",63,45,43,0,2,"PYLN",0
22,"22129",162,110,110,0,0,"PYLN",1
50,"50260",35,31,31,0,0,"PYLN",0
22,"22905",287,217,217,1,0,"PYLN",0
50,"50173",156,114,114,0,0,"PYLN",0
22,"22248",103,73,73,0,0,"PYLN",1
22,"22174",462,352,350,0,2,"PYLN",0
22,"22137",1009,671,665,1,6,"PYLN",0
50,"50051",802,551,550,2,1,"PYLN",0
22,"22103",664,489,489,4,0,"PYLN",1
22,"22006",268,167,164,4,3,"PYLN",0
50,"50042",19,17,17,1,0,"PYLN",0
50,"50268",41,32,32,1,0,"PYLN",0
50,"50296",385,240,235,3,5,"PYLN",0
50,"50255",199,152,147,3,5,"PYLN",0
50,"50247",852,600,594,8,6,"PYLN",0
50,"50036",100,76,76,1,0,"PYLN",0
50,"50113",587,471,461,2,10,"PYLN",0
44,"44217",32,25,25,0,0,"PYLN",0
44,"44240",151,119,117,0,2,"PYLN",0
22,"22022",542,405,403,2,2,"PYLN",1
50,"50010",67,52,52,1,0,"PYLN",0
22,"22025",1022,705,694,14,11,"PYLN",0
22,"22156",289,216,213,1,3,"PYLN",0
50,"50282",55,38,38,1,0,"PYLN",0
50,"50261",201,154,151,0,3,"PYLN",0
22,"22029",118,85,83,1,2,"PYLN",0
50,"50190",669,532,518,10,14,"PYLN",0
50,"50013",199,158,158,0,0,"PYLN",0
50,"50245",74,51,51,0,0,"PYLN",0
22,"22906",177,123,122,6,1,"PYLN",0
22,"22008",144,113,112,2,1,"PYLN",0
44,"44146",164,133,133,2,0,"PYLN",0
44,"44154",240,164,161,1,3,"PYLN",0
44,"44263",373,267,267,2,0,"PYLN",0
50,"50063",64,49,49,0,0,"PYLN",0
50,"50056",399,296,296,3,0,"PYLN",0
22,"22012",102,75,75,2,0,"PYLN",0
44,"44177",101,68,68,1,0,"PYLN",0
22,"22206",179,138,137,0,1,"PYLN",0
50,"50077",201,140,140,1,0,"PYLN",0
50,"50017",1773,1283,1265,13,18,"PYLN",0
50,"50263",171,110,108,1,2,"PYLN",0
22,"22214",117,92,89,0,3,"PYLN",0
22,"22117",2384,1606,1596,18,10,"PYLN",2
22,"22067",70,52,52,0,0,"PYLN",0
44,"44256",36,30,30,2,0,"PYLN",0
22,"22088",143,98,97,1,1,"PYLN",0
22,"22197",436,327,325,3,2,"PYLN",0
44,"44230",149,111,110,2,1,"PYLN",0
50,"50197",95,69,68,2,1,"PYLN",0
44,"44194",103,67,64,0,3,"PYLN",0
44,"44125",63,41,41,0,0,"PYLN",0
50,"50144",31,24,24,0,0,"PYLN",0
50,"50044",224,159,159,2,0,"PYLN",0
44,"44231",35,30,30,0,0,"PYLN",0
22,"22081",247,173,171,3,2,"PYLN",0
44,"44116",75,58,58,0,0,"PYLN",0
50,"50165",1768,1255,1222,20,33,"PYLN",0
22,"22157",181,122,121,2,1,"PYLN",0
22,"22209",161,121,121,3,0,"PYLN",0
50,"50267",565,380,375,4,5,"PYLN",1
50,"50193",664,487,475,4,12,"PYLN",0
22,"22109",261,184,183,1,1,"PYLN",0
50,"50101",833,557,550,5,7,"PYLN",0
50,"50222",1574,1024,1008,12,16,"PYLN",1
22,"22058",193,141,141,0,0,"PYLN",0
22,"22048",12635,8889,8807,98,82,"PYLN",6
44,"44105",68,53,53,0,0,"PYLN",0
22,"22205",448,294,292,0,2,"PYLN",1
44,"44097",126,76,73,0,3,"PYLN",0
50,"50164",381,245,243,3,2,"PYLN",0
44,"44212",41,29,29,0,0,"PYLN",0
44,"44227",72,58,58,0,0,"PYLN",0
50,"50266",120,77,76,3,1,"PYLN",0
44,"44165",168,125,125,2,0,"PYLN",0
50,"50135",85,59,59,0,0,"PYLN",0
50,"50232",160,93,92,1,1,"PYLN",0
44,"44107",212,135,135,0,0,"PYLN",0
44,"44167",34,26,26,0,0,"PYLN",0
50,"50115",3279,2170,2131,27,39,"PYLN",0
44,"44026",100,73,72,0,1,"PYLN",0
44,"44176",152,114,113,1,1,"PYLN",0
50,"50155",95,65,65,0,0,"PYLN",0
22,"22047",248,202,201,1,1,"PYLN",0
44,"44051",2579,1924,1901,10,23,"PYLN",1
44,"44033",243,165,165,3,0,"PYLN",0
50,"50107",988,758,755,8,3,"PYLN",0
50,"50160",2140,1421,1394,14,27,"PYLN",1
44,"44216",27003,19997,19909,80,88,"PYLN",2
22,"22162",125,94,94,0,0,"PYLN",0
44,"44027",144,113,113,2,0,"PYLN",0
50,"50295",48,41,41,0,0,"PYLN",0
44,"44014",2506,1828,1818,8,10,"PYLN",0
50,"50901",133,96,96,0,0,"PYLN",0
22,"22045",65,52,52,0,0,"PYLN",0
44,"44145",974,698,697,3,1,"PYLN",0
50,"50257",159,128,125,2,3,"PYLN",0
50,"50094",1500,1041,1022,12,19,"PYLN",0
50,"50096",34,22,22,0,0,"PYLN",0
50,"50276",118,91,91,0,0,"PYLN",0
50,"50111",181,130,130,1,0,"PYLN",0
50,"50068",1943,1299,1287,10,12,"PYLN",2
22,"22212",69,52,52,1,0,"PYLN",0
44,"44009",798,593,589,4,4,"PYLN",0
22,"22115",348,263,261,3,2,"PYLN",0
22,"22207",121,66,65,0,1,"PYLN",0
44,"44238",2278,1630,1620,3,10,"PYLN",0
44,"44210",750,577,572,2,5,"PYLN",1
22,"22178",105,89,89,1,0,"PYLN",0
44,"44109",99,64,64,0,0,"PYLN",0
50,"50181",999,748,732,3,16,"PYLN",2
22,"22133",108,71,71,3,0,"PYLN",0
22,"22050",93,77,77,0,0,"PYLN",0
22,"22126",89,64,64,0,0,"PYLN",0
50,"50293",392,257,255,2,2,"PYLN",0
22,"22173",219,147,141,3,6,"PYLN",1
44,"44103",122,96,96,3,0,"PYLN",0
50,"50191",446,327,326,1,1,"PYLN",0
22,"22221",92,56,55,0,1,"PYLN",0
44,"44250",20,15,15,0,0,"PYLN",0
22,"22001",212,147,146,0,1,"PYLN",0
44,"44196",121,88,88,0,0,"PYLN",0
22,"22251",327,259,256,0,3,"PYLN",0
44,"44012",303,215,215,2,0,"PYLN",1
50,"50270",38,26,25,0,1,"PYLN",0
50,"50086",176,106,102,1,4,"PYLN",1
22,"22201",264,188,186,3,2,"PYLN",0
44,"44024",31,26,25,0,1,"PYLN",0
50,"50028",78,53,53,0,0,"PYLN",0
50,"50128",26,23,23,0,0,"PYLN",0
22,"22107",102,53,53,0,0,"PYLN",0
44,"44042",114,82,81,0,1,"PYLN",0
50,"50116",169,124,123,0,1,"PYLN",0
22,"22142",94,72,70,0,2,"PYLN",0
50,"50034",767,516,511,10,5,"PYLN",0
50,"50285",657,448,442,4,6,"PYLN",0
44,"44055",75,52,50,0,2,"PYLN",0
44,"44232",364,255,255,3,0,"PYLN",0
44,"44251",239,187,183,1,4,"PYLN",0
50,"50031",134,78,75,0,3,"PYLN",0
44,"44101",55,41,40,1,1,"PYLN",0
22,"22139",80,57,57,1,0,"PYLN",0
50,"50213",92,70,70,2,0,"PYLN",0
44,"44136",48,43,43,1,0,"PYLN",0
50,"50133",98,76,76,0,0,"PYLN",0
50,"50137",958,740,731,8,9,"PYLN",0
22,"22244",42,33,32,1,1,"PYLN",0
22,"22127",521,353,352,5,1,"PYLN",0
44,"44265",175,138,136,1,2,"PYLN",0
50,"50104",320,251,251,1,0,"PYLN",0
44,"44044",82,65,65,2,0,"PYLN",0
50,"50189",678,494,487,6,7,"PYLN",0
50,"50194",80,51,51,0,0,"PYLN",0
50,"50088",274,195,191,2,4,"PYLN",0
50,"50066",2903,2095,2078,19,17,"PYLN",1
50,"50015",81,57,56,0,1,"PYLN",0
22,"22245",303,222,213,3,9,"PYLN",0
22,"22158",11994,8115,8049,79,66,"PYLN",1
44,"44045",360,271,271,0,0,"PYLN",0
50,"50292",130,108,107,0,1,"PYLN",0
22,"22186",189,148,145,3,3,"PYLN",0
50,"50020",795,548,545,4,3,"PYLN",0
50,"50209",2785,1893,1865,24,28,"PYLN",1
50,"50121",270,209,208,3,1,"PYLN",0
44,"44191",714,509,500,5,9,"PYLN",1
50,"50040",82,66,66,1,0,"PYLN",0
44,"44147",401,264,256,7,8,"PYLN",1
22,"22170",672,460,456,5,4,"PYLN",1
50,"50902",77,65,62,0,3,"PYLN",0
22,"22122",69,52,50,2,2,"PYLN",0
22,"22124",183,119,119,0,0,"PYLN",0
50,"50234",242,159,154,4,5,"PYLN",0
44,"44234",71,49,49,0,0,"PYLN",0
50,"50147",744,508,506,5,2,"PYLN",1
22,"22195",238,190,186,0,4,"PYLN",0
44,"44113",74,51,51,0,0,"PYLN",0
50,"50080",34,27,27,0,0,"PYLN",0
50,"50012",94,76,72,0,4,"PYLN",0
50,"50053",643,476,466,3,10,"PYLN",0
44,"44021",104,77,77,1,0,"PYLN",0
22,"22232",88,61,61,2,0,"PYLN",0
44,"44043",86,60,60,0,0,"PYLN",0
44,"44068",634,497,493,2,4,"PYLN",0
22,"22908",190,135,134,0,1,"PYLN",0
46,"46137",248,201,197,3,4,"RECORTES CERO-GV",0
31,"31049",679,461,453,2,8,"RECORTES CERO-GV",0
25,"25139",477,348,346,3,2,"RECORTES CERO-GV",0
8,"8017",2808,2033,2016,16,17,"RECORTES CERO-GV",5
10,"10156",97,71,69,0,2,"RECORTES CERO-GV",0
8,"8222",1821,1439,1424,7,15,"RECORTES CERO-GV",3
21,"21072",10233,7374,7183,116,191,"RECORTES CERO-GV",12
3,"3082",12941,8399,8304,51,95,"RECORTES CERO-GV",6
22,"22103",664,489,489,4,0,"RECORTES CERO-GV",0
44,"44110",37,30,30,0,0,"RECORTES CERO-GV",0
31,"31085",500,365,362,2,3,"RECORTES CERO-GV",2
10,"10033",397,269,268,0,1,"RECORTES CERO-GV",0
31,"31036",879,601,589,5,12,"RECORTES CERO-GV",0
22,"22174",462,352,350,0,2,"RECORTES CERO-GV",0
3,"3075",154,117,115,1,2,"RECORTES CERO-GV",0
12,"12085",5081,3271,3235,17,36,"RECORTES CERO-GV",3
14,"14057",6157,4773,4707,59,66,"RECORTES CERO-GV",7
10,"10210",489,314,313,2,1,"RECORTES CERO-GV",0
32,"32019",11469,7336,7225,98,111,"RECORTES CERO-GV",8
10,"10102",496,378,377,1,1,"RECORTES CERO-GV",0
8,"8236",1564,1145,1133,4,12,"RECORTES CERO-GV",2
26,"26154",10,10,9,1,1,"RECORTES CERO-GV",0
32,"32044",794,547,540,2,7,"RECORTES CERO-GV",0
46,"46025",2445,1875,1853,16,22,"RECORTES CERO-GV",1
17,"17056",1780,1379,1374,13,5,"RECORTES CERO-GV",1
46,"46098",2405,1778,1751,7,27,"RECORTES CERO-GV",2
50,"50183",316,227,223,1,4,"RECORTES CERO-GV",0
8,"8290",1549,1254,1248,6,6,"RECORTES CERO-GV",5
22,"22096",332,248,241,10,7,"RECORTES CERO-GV",0
48,"48031",303,221,221,0,0,"RECORTES CERO-GV",0
8,"8060",139,110,108,1,2,"RECORTES CERO-GV",0
12,"12111",327,259,255,8,4,"RECORTES CERO-GV",0
27,"27053",497,342,334,2,8,"RECORTES CERO-GV",0
22,"22901",714,433,423,6,10,"RECORTES CERO-GV",0
22,"22909",307,219,217,0,2,"RECORTES CERO-GV",0
26,"26042",795,578,572,8,6,"RECORTES CERO-GV",0
4,"4103",1432,1003,993,10,10,"RECORTES CERO-GV",2
4,"4081",351,264,263,0,1,"RECORTES CERO-GV",0
18,"18016",297,200,198,3,2,"RECORTES CERO-GV",0
31,"31109",1657,1165,1160,12,5,"RECORTES CERO-GV",4
48,"48908",250,212,210,1,2,"RECORTES CERO-GV",0
36,"36047",2248,1379,1363,11,16,"RECORTES CERO-GV",1
26,"26005",2483,1589,1570,13,19,"RECORTES CERO-GV",1
50,"50072",183,131,129,0,2,"RECORTES CERO-GV",0
1,"1027",444,273,271,0,2,"RECORTES CERO-GV",0
46,"46222",402,329,326,0,3,"RECORTES CERO-GV",1
46,"46243",124,93,90,1,3,"RECORTES CERO-GV",0
26,"26158",242,184,181,1,3,"RECORTES CERO-GV",0
26,"26062",85,62,62,1,0,"RECORTES CERO-GV",0
18,"18112",104,68,66,2,2,"RECORTES CERO-GV",0
12,"12034",1389,1022,1002,5,20,"RECORTES CERO-GV",2
43,"43174",144,118,114,0,4,"RECORTES CERO-GV",0
29,"29054",42538,28080,27814,225,266,"RECORTES CERO-GV",53
18,"18907",1762,1358,1351,4,7,"RECORTES CERO-GV",0
17,"17196",252,200,200,1,0,"RECORTES CERO-GV",0
15,"15902",4507,2885,2837,34,48,"RECORTES CERO-GV",4
6,"6068",427,298,294,5,4,"RECORTES CERO-GV",0
23,"23075",3222,2513,2475,19,38,"RECORTES CERO-GV",3
36,"36041",13691,9022,8916,85,106,"RECORTES CERO-GV",12
8,"8020",5243,4117,4100,29,17,"RECORTES CERO-GV",8
14,"14041",3113,2234,2160,43,74,"RECORTES CERO-GV",1
52,"52001",54293,31015,30776,185,239,"RECORTES CERO-GV",19
20,"20058",740,523,522,3,1,"RECORTES CERO-GV",1
23,"23044",4697,3495,3400,31,95,"RECORTES CERO-GV",5
39,"39044",3921,2805,2783,18,22,"RECORTES CERO-GV",0
3,"3022",140,125,121,1,4,"RECORTES CERO-GV",1
50,"50178",269,165,163,6,2,"RECORTES CERO-GV",1
22,"22021",1884,1331,1319,26,12,"RECORTES CERO-GV",1
48,"48062",295,236,236,0,0,"RECORTES CERO-GV",1
25,"25121",632,380,374,3,6,"RECORTES CERO-GV",0
48,"48033",217,162,162,1,0,"RECORTES CERO-GV",0
26,"26037",125,98,98,3,0,"RECORTES CERO-GV",1
44,"44089",49,41,41,0,0,"RECORTES CERO-GV",0
26,"26047",1852,1449,1434,6,15,"RECORTES CERO-GV",2
26,"26175",47,40,38,1,2,"RECORTES CERO-GV",0
10,"10141",284,207,205,1,2,"RECORTES CERO-GV",1
43,"43022",1436,1028,1024,13,4,"RECORTES CERO-GV",1
43,"43036",869,565,557,7,8,"RECORTES CERO-GV",0
41,"41099",3961,2448,2413,14,35,"RECORTES CERO-GV",2
50,"50255",199,152,147,3,5,"RECORTES CERO-GV",0
20,"20902",14282,9670,9618,52,52,"RECORTES CERO-GV",16
17,"17136",196,150,150,0,0,"RECORTES CERO-GV",0
22,"22124",183,119,119,0,0,"RECORTES CERO-GV",0
25,"25033",1120,838,831,5,7,"RECORTES CERO-GV",0
23,"23056",3052,2279,2207,26,72,"RECORTES CERO-GV",5
38,"38030",1962,1332,1318,9,14,"RECORTES CERO-GV",0
6,"6113",2649,1889,1862,16,27,"RECORTES CERO-GV",1
27,"27021",1632,962,935,23,27,"RECORTES CERO-GV",0
31,"31102",135,60,60,1,0,"RECORTES CERO-GV",0
4,"4003",17583,11062,10941,77,121,"RECORTES CERO-GV",6
14,"14010",3992,2786,2723,14,63,"RECORTES CERO-GV",2
12,"12094",871,671,661,1,10,"RECORTES CERO-GV",0
3,"3081",1492,1070,1044,12,26,"RECORTES CERO-GV",0
32,"32051",1369,1062,1058,13,4,"RECORTES CERO-GV",0
50,"50045",1217,891,878,10,13,"RECORTES CERO-GV",3
8,"8103",652,476,474,1,2,"RECORTES CERO-GV",0
41,"41063",2735,1855,1797,30,58,"RECORTES CERO-GV",5
12,"12027",17506,11776,11649,84,127,"RECORTES CERO-GV",14
26,"26065",63,46,43,0,3,"RECORTES CERO-GV",0
6,"6049",956,625,604,8,21,"RECORTES CERO-GV",0
10,"10205",1934,1071,1042,4,29,"RECORTES CERO-GV",0
17,"17223",808,566,563,1,3,"RECORTES CERO-GV",0
38,"38046",9267,6652,6594,55,58,"RECORTES CERO-GV",6
27,"27063",1699,1131,1109,7,22,"RECORTES CERO-GV",2
21,"21042",15610,8112,8011,164,101,"RECORTES CERO-GV",9
46,"46257",5436,3972,3933,28,39,"RECORTES CERO-GV",3
15,"15030",199701,137611,136590,1540,1021,"RECORTES CERO-GV",209
8,"8151",450,351,346,5,5,"RECORTES CERO-GV",0
20,"20039",2126,1623,1618,9,5,"RECORTES CERO-GV",0
21,"21049",3262,2028,1977,15,51,"RECORTES CERO-GV",4
14,"14073",2768,1934,1880,33,54,"RECORTES CERO-GV",6
31,"31025",762,497,490,1,7,"RECORTES CERO-GV",0
50,"50152",1351,942,932,14,10,"RECORTES CERO-GV",1
14,"14020",336,227,225,0,2,"RECORTES CERO-GV",0
50,"50237",100,75,75,2,0,"RECORTES CERO-GV",0
29,"29090",1649,1138,1124,10,14,"RECORTES CERO-GV",2
10,"10073",733,513,499,8,14,"RECORTES CERO-GV",1
4,"4014",152,105,103,1,2,"RECORTES CERO-GV",0
8,"8120",7129,5649,5621,51,28,"RECORTES CERO-GV",3
50,"50159",640,493,486,3,7,"RECORTES CERO-GV",0
15,"15057",12077,8109,8018,83,91,"RECORTES CERO-GV",6
8,"8239",467,362,361,3,1,"RECORTES CERO-GV",0
10,"10191",511,374,365,5,9,"RECORTES CERO-GV",0
22,"22004",123,83,83,0,0,"RECORTES CERO-GV",0
6,"6087",1999,1472,1455,13,17,"RECORTES CERO-GV",1
18,"18050",1649,1113,1095,5,18,"RECORTES CERO-GV",1
33,"33053",1078,602,599,10,3,"RECORTES CERO-GV",0
14,"14019",6380,4933,4831,71,102,"RECORTES CERO-GV",3
41,"41064",5602,3520,3417,56,103,"RECORTES CERO-GV",2
50,"50059",757,556,551,5,5,"RECORTES CERO-GV",0
29,"29074",771,561,555,1,6,"RECORTES CERO-GV",0
3,"3013",1063,809,794,3,15,"RECORTES CERO-GV",1
32,"32040",1400,1001,990,10,11,"RECORTES CERO-GV",2
25,"25225",531,395,393,0,2,"RECORTES CERO-GV",0
39,"39075",136789,95707,95089,478,618,"RECORTES CERO-GV",80
50,"50128",26,23,23,0,0,"RECORTES CERO-GV",0
17,"17143",145,104,104,0,0,"RECORTES CERO-GV",0
50,"50086",176,106,102,1,4,"RECORTES CERO-GV",0
48,"48080",9916,6849,6793,44,56,"RECORTES CERO-GV",11
10,"10080",353,243,238,1,5,"RECORTES CERO-GV",0
23,"23019",1466,1117,1090,5,27,"RECORTES CERO-GV",1
44,"44113",74,51,51,0,0,"RECORTES CERO-GV",0
27,"27035",183,110,110,3,0,"RECORTES CERO-GV",0
30,"30012",9085,6704,6599,46,105,"RECORTES CERO-GV",2
8,"8022",12213,8594,8558,42,36,"RECORTES CERO-GV",3
31,"31145",160,121,120,2,1,"RECORTES CERO-GV",0
30,"30013",7421,5171,5094,32,77,"RECORTES CERO-GV",0
44,"44051",2579,1924,1901,10,23,"RECORTES CERO-GV",0
36,"36037",2538,1650,1625,12,25,"RECORTES CERO-GV",6
4,"4048",1499,964,957,4,7,"RECORTES CERO-GV",0
31,"31137",198,83,83,1,0,"RECORTES CERO-GV",0
4,"4044",1542,1092,1080,8,12,"RECORTES CERO-GV",3
32,"32002",2028,1349,1340,4,9,"RECORTES CERO-GV",1
6,"6032",80,68,68,1,0,"RECORTES CERO-GV",0
12,"12108",443,354,352,4,2,"RECORTES CERO-GV",1
46,"46003",948,770,757,8,13,"RECORTES CERO-GV",0
6,"6118",155,114,112,0,2,"RECORTES CERO-GV",0
3,"3057",174,138,136,0,2,"RECORTES CERO-GV",0
25,"25062",691,498,491,4,7,"RECORTES CERO-GV",0
8,"8055",542,426,424,3,2,"RECORTES CERO-GV",0
6,"6128",4457,2996,2934,28,62,"RECORTES CERO-GV",5
22,"22117",2384,1606,1596,18,10,"RECORTES CERO-GV",2
41,"41042",5872,4477,4424,42,53,"RECORTES CERO-GV",1
20,"20028",2254,1442,1441,6,1,"RECORTES CERO-GV",0
22,"22162",125,94,94,0,0,"RECORTES CERO-GV",0
30,"30035",19432,13174,13013,114,161,"RECORTES CERO-GV",27
46,"46190",50042,35290,35066,284,224,"RECORTES CERO-GV",68
18,"18010",527,398,394,5,4,"RECORTES CERO-GV",0
17,"17109",704,542,539,2,3,"RECORTES CERO-GV",0
31,"31215",4670,3270,3219,33,51,"RECORTES CERO-GV",10
8,"8128",579,428,423,4,5,"RECORTES CERO-GV",0
7,"7014",7885,3934,3893,43,41,"RECORTES CERO-GV",9
22,"22209",161,121,121,3,0,"RECORTES CERO-GV",0
22,"22200",239,165,164,2,1,"RECORTES CERO-GV",0
41,"41050",5173,3954,3878,36,76,"RECORTES CERO-GV",2
17,"17148",1550,1121,1114,15,7,"RECORTES CERO-GV",1
11,"11042",1158,806,793,6,13,"RECORTES CERO-GV",0
12,"12077",4828,3395,3357,28,38,"RECORTES CERO-GV",5
31,"31055",267,192,191,0,1,"RECORTES CERO-GV",0
3,"3056",8588,6219,6135,29,84,"RECORTES CERO-GV",4
36,"36048",5248,3429,3378,25,51,"RECORTES CERO-GV",5
22,"22129",162,110,110,0,0,"RECORTES CERO-GV",0
44,"44093",78,62,61,0,1,"RECORTES CERO-GV",0
26,"26163",126,104,104,1,0,"RECORTES CERO-GV",0
31,"31206",2077,1433,1417,15,16,"RECORTES CERO-GV",1
8,"8247",982,799,798,4,1,"RECORTES CERO-GV",0
48,"48039",254,221,220,2,1,"RECORTES CERO-GV",0
50,"50153",914,683,675,9,8,"RECORTES CERO-GV",0
8,"8014",2013,1526,1521,4,5,"RECORTES CERO-GV",3
17,"17180",8508,5977,5953,38,24,"RECORTES CERO-GV",2
17,"17208",978,723,719,6,4,"RECORTES CERO-GV",1
41,"41084",2799,2029,1937,9,92,"RECORTES CERO-GV",1
18,"18023",15717,10964,10751,132,213,"RECORTES CERO-GV",14
17,"17152",11065,6959,6927,68,32,"RECORTES CERO-GV",6
21,"21001",621,431,418,0,13,"RECORTES CERO-GV",1
44,"44122",1277,939,934,5,5,"RECORTES CERO-GV",0
7,"7065",2319,1429,1411,15,18,"RECORTES CERO-GV",3
50,"50210",37,26,26,0,0,"RECORTES CERO-GV",0
50,"50241",582,414,406,2,8,"RECORTES CERO-GV",0
22,"22213",2918,2084,2062,20,22,"RECORTES CERO-GV",0
17,"17119",71,53,52,3,1,"RECORTES CERO-GV",1
26,"26058",149,114,114,2,0,"RECORTES CERO-GV",1
33,"33012",5085,3158,3142,27,16,"RECORTES CERO-GV",2
20,"20044",355,261,261,1,0,"RECORTES CERO-GV",0
22,"22007",751,527,520,1,7,"RECORTES CERO-GV",0
44,"44261",713,553,549,3,4,"RECORTES CERO-GV",0
39,"39056",2262,1683,1671,14,12,"RECORTES CERO-GV",1
29,"29026",1021,703,698,15,5,"RECORTES CERO-GV",0
50,"50047",38,24,24,0,0,"RECORTES CERO-GV",0
46,"46144",628,483,478,4,5,"RECORTES CERO-GV",0
3,"3124",459,360,358,0,2,"RECORTES CERO-GV",0
8,"8169",48478,35283,35114,278,169,"RECORTES CERO-GV",83
46,"46010",943,691,681,7,10,"RECORTES CERO-GV",0
33,"33063",375,269,267,5,2,"RECORTES CERO-GV",1
6,"6056",447,351,340,2,11,"RECORTES CERO-GV",0
11,"11901",5739,3759,3686,99,73,"RECORTES CERO-GV",6
21,"21018",1719,1048,1029,12,19,"RECORTES CERO-GV",0
18,"18115",2635,1766,1738,13,28,"RECORTES CERO-GV",0
23,"23018",2243,1606,1584,17,22,"RECORTES CERO-GV",2
8,"8308",139,109,109,1,0,"RECORTES CERO-GV",0
50,"50274",64,46,43,1,3,"RECORTES CERO-GV",0
6,"6130",185,152,149,0,3,"RECORTES CERO-GV",0
30,"30007",6474,4354,4317,26,37,"RECORTES CERO-GV",2
8,"8209",6925,4976,4948,39,28,"RECORTES CERO-GV",6
50,"50224",61,44,44,2,0,"RECORTES CERO-GV",0
10,"10204",423,289,287,1,2,"RECORTES CERO-GV",0
26,"26073",92,68,66,1,2,"RECORTES CERO-GV",0
50,"50020",795,548,545,4,3,"RECORTES CERO-GV",0
44,"44121",52,42,42,1,0,"RECORTES CERO-GV",0
50,"50238",84,65,65,0,0,"RECORTES CERO-GV",0
46,"46096",263,204,202,0,2,"RECORTES CERO-GV",0
8,"8164",936,750,747,6,3,"RECORTES CERO-GV",1
44,"44177",101,68,68,1,0,"RECORTES CERO-GV",0
12,"12080",1883,1472,1438,8,34,"RECORTES CERO-GV",1
22,"22078",431,285,285,4,0,"RECORTES CERO-GV",2
8,"8293",227,177,177,0,0,"RECORTES CERO-GV",0
21,"21056",2914,2148,2046,29,102,"RECORTES CERO-GV",1
39,"39053",212,133,133,4,0,"RECORTES CERO-GV",0
8,"8027",724,584,582,1,2,"RECORTES CERO-GV",3
20,"20069",147446,102068,101696,564,372,"RECORTES CERO-GV",148
46,"46161",1467,1129,1113,5,16,"RECORTES CERO-GV",1
46,"46020",3757,2834,2783,16,51,"RECORTES CERO-GV",1
8,"8305",27661,20346,20221,118,125,"RECORTES CERO-GV",17
18,"18020",489,318,310,2,8,"RECORTES CERO-GV",0
12,"12055",103,77,76,2,1,"RECORTES CERO-GV",0
15,"15089",4299,2924,2887,41,37,"RECORTES CERO-GV",4
41,"41056",3687,2836,2779,37,57,"RECORTES CERO-GV",5
6,"6114",127,105,105,0,0,"RECORTES CERO-GV",0
46,"46119",761,587,580,6,7,"RECORTES CERO-GV",0
46,"46141",433,340,337,6,3,"RECORTES CERO-GV",0
3,"3064",5015,3514,3461,15,53,"RECORTES CERO-GV",5
31,"31170",44,31,30,2,1,"RECORTES CERO-GV",0
14,"14064",296,211,208,6,3,"RECORTES CERO-GV",0
32,"32031",997,684,680,5,4,"RECORTES CERO-GV",1
26,"26057",50,45,45,2,0,"RECORTES CERO-GV",0
17,"17166",547,442,440,0,2,"RECORTES CERO-GV",0
46,"46197",1930,1430,1411,11,19,"RECORTES CERO-GV",2
25,"25908",217,136,136,0,0,"RECORTES CERO-GV",0
17,"17205",209,167,166,0,1,"RECORTES CERO-GV",0
20,"20906",128,87,87,0,0,"RECORTES CERO-GV",0
43,"43004",6288,4314,4262,36,52,"RECORTES CERO-GV",2
11,"11017",3198,2054,2004,37,50,"RECORTES CERO-GV",1
10,"10085",310,219,219,1,0,"RECORTES CERO-GV",0
50,"50257",159,128,125,2,3,"RECORTES CERO-GV",0
50,"50006",913,670,654,13,16,"RECORTES CERO-GV",0
46,"46030",810,641,625,7,16,"RECORTES CERO-GV",3
27,"27014",3144,2009,1985,24,24,"RECORTES CERO-GV",2
4,"4022",356,237,236,5,1,"RECORTES CERO-GV",1
10,"10092",260,201,200,1,1,"RECORTES CERO-GV",0
33,"33068",1031,518,510,5,8,"RECORTES CERO-GV",0
18,"18151",261,167,166,4,1,"RECORTES CERO-GV",1
27,"27001",2187,1111,1102,17,9,"RECORTES CERO-GV",1
18,"18095",2054,1475,1433,14,42,"RECORTES CERO-GV",0
8,"8066",1466,1109,1104,7,5,"RECORTES CERO-GV",1
25,"25186",207,162,161,0,1,"RECORTES CERO-GV",0
46,"46083",15372,10939,10815,78,124,"RECORTES CERO-GV",11
50,"50107",988,758,755,8,3,"RECORTES CERO-GV",0
10,"10129",340,234,227,2,7,"RECORTES CERO-GV",0
50,"50025",4541,3110,3083,39,27,"RECORTES CERO-GV",4
17,"17022",7043,4940,4903,34,37,"RECORTES CERO-GV",10
44,"44124",71,57,57,0,0,"RECORTES CERO-GV",0
39,"39096",669,451,450,1,1,"RECORTES CERO-GV",0
15,"15012",3603,2484,2422,20,62,"RECORTES CERO-GV",2
25,"25911",419,298,297,3,1,"RECORTES CERO-GV",0
46,"46032",5719,4297,4262,35,35,"RECORTES CERO-GV",5
36,"36027",4401,2940,2781,20,159,"RECORTES CERO-GV",7
18,"18132",3101,2418,2382,23,36,"RECORTES CERO-GV",0
26,"26030",18,18,17,1,1,"RECORTES CERO-GV",0
8,"8237",1644,1263,1254,9,9,"RECORTES CERO-GV",0
10,"10145",123,90,84,0,6,"RECORTES CERO-GV",0
31,"31906",2707,1800,1781,22,19,"RECORTES CERO-GV",3
39,"39079",8850,6247,6175,28,72,"RECORTES CERO-GV",3
8,"8263",21208,15014,14890,111,124,"RECORTES CERO-GV",24
48,"48014",1229,845,843,8,2,"RECORTES CERO-GV",0
44,"44033",243,165,165,3,0,"RECORTES CERO-GV",0
20,"20021",185,104,104,2,0,"RECORTES CERO-GV",0
33,"33052",681,418,416,3,2,"RECORTES CERO-GV",0
36,"36021",12180,8188,8058,115,130,"RECORTES CERO-GV",15
8,"8115",3826,2777,2770,31,7,"RECORTES CERO-GV",4
18,"18135",4385,2882,2798,24,84,"RECORTES CERO-GV",2
6,"6016",2937,2042,1978,12,64,"RECORTES CERO-GV",1
17,"17036",2639,1944,1934,21,10,"RECORTES CERO-GV",2
18,"18011",4403,3002,2947,24,55,"RECORTES CERO-GV",2
26,"26123",128,110,110,0,0,"RECORTES CERO-GV",1
44,"44045",360,271,271,0,0,"RECORTES CERO-GV",0
17,"17193",4351,2945,2927,21,18,"RECORTES CERO-GV",4
15,"15046",6157,3965,3865,23,100,"RECORTES CERO-GV",8
23,"23052",1094,920,896,6,24,"RECORTES CERO-GV",0
25,"25167",223,165,164,3,1,"RECORTES CERO-GV",0
50,"50036",100,76,76,1,0,"RECORTES CERO-GV",0
50,"50243",307,227,224,2,3,"RECORTES CERO-GV",0
44,"44048",52,47,47,0,0,"RECORTES CERO-GV",0
31,"31004",31,22,22,1,0,"RECORTES CERO-GV",0
32,"32048",846,460,458,1,2,"RECORTES CERO-GV",0
26,"26109",73,68,68,0,0,"RECORTES CERO-GV",0
22,"22206",179,138,137,0,1,"RECORTES CERO-GV",0
17,"17139",1407,1128,1119,8,9,"RECORTES CERO-GV",0
18,"18043",129,74,71,0,3,"RECORTES CERO-GV",0
44,"44034",124,90,90,0,0,"RECORTES CERO-GV",0
50,"50143",541,373,367,2,6,"RECORTES CERO-GV",0
22,"22168",22,20,19,0,1,"RECORTES CERO-GV",0
25,"25251",708,526,524,1,2,"RECORTES CERO-GV",1
22,"22229",107,70,70,2,0,"RECORTES CERO-GV",0
4,"4087",157,115,113,0,2,"RECORTES CERO-GV",0
39,"39088",59,40,40,2,0,"RECORTES CERO-GV",0
22,"22908",190,135,134,0,1,"RECORTES CERO-GV",0
15,"15033",2421,1673,1655,6,18,"RECORTES CERO-GV",0
4,"4055",361,298,290,3,8,"RECORTES CERO-GV",1
48,"48905",2496,1778,1766,12,12,"RECORTES CERO-GV",0
46,"46028",383,305,299,8,6,"RECORTES CERO-GV",0
25,"25097",89,71,71,2,0,"RECORTES CERO-GV",0
48,"48037",696,497,485,0,12,"RECORTES CERO-GV",0
11,"11009",579,399,390,0,9,"RECORTES CERO-GV",0
3,"3084",501,413,413,1,0,"RECORTES CERO-GV",0
46,"46009",3144,2473,2449,22,24,"RECORTES CERO-GV",5
33,"33025",8956,5493,5453,81,40,"RECORTES CERO-GV",4
22,"22050",93,77,77,0,0,"RECORTES CERO-GV",0
46,"46066",1274,972,970,4,2,"RECORTES CERO-GV",0
38,"38051",7328,5017,4969,32,48,"RECORTES CERO-GV",3
6,"6901",2125,1549,1520,28,29,"RECORTES CERO-GV",5
27,"27062",583,403,400,2,3,"RECORTES CERO-GV",0
17,"17202",3848,2632,2615,16,17,"RECORTES CERO-GV",8
44,"44085",49,29,29,0,0,"RECORTES CERO-GV",0
43,"43133",5627,3794,3773,31,21,"RECORTES CERO-GV",2
26,"26102",6076,4276,4205,52,71,"RECORTES CERO-GV",6
31,"31033",45,25,25,2,0,"RECORTES CERO-GV",0
44,"44076",2089,1577,1565,8,12,"RECORTES CERO-GV",0
8,"8256",693,542,542,3,0,"RECORTES CERO-GV",0
4,"4018",245,202,197,2,5,"RECORTES CERO-GV",0
23,"23002",17427,12837,12542,126,295,"RECORTES CERO-GV",13
12,"12120",149,125,121,3,4,"RECORTES CERO-GV",0
21,"21052",4403,2688,2631,26,57,"RECORTES CERO-GV",2
3,"3904",1434,1032,1022,8,10,"RECORTES CERO-GV",1
36,"36038",66807,46235,45781,493,454,"RECORTES CERO-GV",60
25,"25179",169,132,132,0,0,"RECORTES CERO-GV",0
10,"10032",1588,1114,1099,6,15,"RECORTES CERO-GV",0
31,"31128",349,217,215,4,2,"RECORTES CERO-GV",0
23,"23065",1530,1068,1054,7,14,"RECORTES CERO-GV",2
36,"36040",2505,1597,1563,15,34,"RECORTES CERO-GV",0
17,"17125",136,100,100,3,0,"RECORTES CERO-GV",0
8,"8199",648,509,508,3,1,"RECORTES CERO-GV",0
26,"26174",134,100,99,3,1,"RECORTES CERO-GV",0
22,"22002",99,81,81,0,0,"RECORTES CERO-GV",0
38,"38901",1466,908,894,4,14,"RECORTES CERO-GV",0
23,"23043",517,360,360,1,0,"RECORTES CERO-GV",1
18,"18046",1738,1042,1023,7,19,"RECORTES CERO-GV",0
48,"48002",7791,5510,5471,42,39,"RECORTES CERO-GV",1
50,"50216",236,169,167,0,2,"RECORTES CERO-GV",0
15,"15009",10605,7245,7133,101,112,"RECORTES CERO-GV",7
25,"25124",160,102,101,1,1,"RECORTES CERO-GV",0
48,"48911",381,303,302,1,1,"RECORTES CERO-GV",1
48,"48089",3540,2561,2555,7,6,"RECORTES CERO-GV",2
17,"17163",2868,2281,2268,13,13,"RECORTES CERO-GV",1
21,"21037",462,320,313,1,7,"RECORTES CERO-GV",0
30,"30037",19407,13252,13120,99,132,"RECORTES CERO-GV",11
22,"22089",274,195,193,2,2,"RECORTES CERO-GV",1
33,"33043",656,408,401,2,7,"RECORTES CERO-GV",0
12,"12137",40,28,28,0,0,"RECORTES CERO-GV",0
10,"10201",178,142,141,2,1,"RECORTES CERO-GV",0
36,"36901",4154,3094,3029,21,65,"RECORTES CERO-GV",6
22,"22102",180,137,136,3,1,"RECORTES CERO-GV",0
44,"44071",585,419,418,6,1,"RECORTES CERO-GV",0
25,"25142",359,283,283,2,0,"RECORTES CERO-GV",0
17,"17117",14497,9438,9382,66,56,"RECORTES CERO-GV",15
3,"3004",603,425,423,2,2,"RECORTES CERO-GV",0
43,"43066",158,108,108,1,0,"RECORTES CERO-GV",0
48,"48024",1000,761,752,1,9,"RECORTES CERO-GV",0
50,"50161",98,75,74,2,1,"RECORTES CERO-GV",0
26,"26122",115,81,80,4,1,"RECORTES CERO-GV",0
44,"44171",176,115,115,0,0,"RECORTES CERO-GV",0
10,"10027",77,62,62,0,0,"RECORTES CERO-GV",0
31,"31177",245,161,159,1,2,"RECORTES CERO-GV",0
20,"20075",4312,2848,2845,8,3,"RECORTES CERO-GV",6
22,"22006",268,167,164,4,3,"RECORTES CERO-GV",0
31,"31100",256,166,165,0,1,"RECORTES CERO-GV",0
15,"15015",2877,1845,1821,26,24,"RECORTES CERO-GV",0
8,"8100",2083,1707,1699,13,8,"RECORTES CERO-GV",0
15,"15074",3902,2629,2589,23,40,"RECORTES CERO-GV",5
26,"26151",412,317,317,4,0,"RECORTES CERO-GV",0
22,"22069",423,296,294,4,2,"RECORTES CERO-GV",0
7,"7051",5484,3133,3094,43,39,"RECORTES CERO-GV",6
48,"48914",332,276,275,0,1,"RECORTES CERO-GV",0
29,"29092",576,375,366,7,9,"RECORTES CERO-GV",2
25,"25092",125,93,92,0,1,"RECORTES CERO-GV",0
43,"43010",334,262,262,2,0,"RECORTES CERO-GV",0
26,"26162",108,90,89,1,1,"RECORTES CERO-GV",0
31,"31209",149,111,110,0,1,"RECORTES CERO-GV",0
32,"32085",10584,6687,6611,58,76,"RECORTES CERO-GV",3
25,"25127",217,145,145,1,0,"RECORTES CERO-GV",1
36,"36043",4696,3038,3003,21,35,"RECORTES CERO-GV",3
3,"3006",493,365,360,2,5,"RECORTES CERO-GV",0
48,"48055",2603,1833,1820,14,13,"RECORTES CERO-GV",2
6,"6902",1651,1198,1174,19,24,"RECORTES CERO-GV",3
3,"3059",20710,14788,14685,89,103,"RECORTES CERO-GV",15
7,"7031",24972,14866,14757,127,109,"RECORTES CERO-GV",17
46,"46111",11367,7995,7908,66,87,"RECORTES CERO-GV",11
29,"29032",6655,4900,4775,36,125,"RECORTES CERO-GV",5
33,"33044",177059,121380,120421,1543,959,"RECORTES CERO-GV",129
41,"41088",515,368,358,2,10,"RECORTES CERO-GV",0
6,"6134",526,306,301,1,5,"RECORTES CERO-GV",0
17,"17033",5647,3879,3852,25,27,"RECORTES CERO-GV",6
12,"12046",188,135,135,4,0,"RECORTES CERO-GV",1
8,"8149",980,702,694,6,8,"RECORTES CERO-GV",2
41,"41005",9285,6637,6497,83,140,"RECORTES CERO-GV",6
50,"50206",457,349,345,5,4,"RECORTES CERO-GV",1
41,"41061",2141,1661,1621,7,40,"RECORTES CERO-GV",0
18,"18053",1554,1001,985,9,16,"RECORTES CERO-GV",2
27,"27028",78725,52642,51965,642,677,"RECORTES CERO-GV",79
29,"29098",1228,902,876,11,26,"RECORTES CERO-GV",0
1,"1060",204,159,151,0,8,"RECORTES CERO-GV",0
4,"4065",365,273,271,1,2,"RECORTES CERO-GV",1
23,"23054",375,280,272,1,8,"RECORTES CERO-GV",0
44,"44163",115,79,78,0,1,"RECORTES CERO-GV",0
32,"32076",1935,1320,1306,15,14,"RECORTES CERO-GV",7
39,"39006",1729,1207,1192,1,15,"RECORTES CERO-GV",2
17,"17030",654,460,459,1,1,"RECORTES CERO-GV",0
15,"15078",78810,55693,55183,569,510,"RECORTES CERO-GV",83
36,"36023",8258,5504,5384,44,120,"RECORTES CERO-GV",7
33,"33002",9403,5920,5839,69,81,"RECORTES CERO-GV",3
3,"3077",1391,1052,1032,10,20,"RECORTES CERO-GV",0
23,"23064",1669,1311,1296,9,15,"RECORTES CERO-GV",1
48,"48901",5160,3705,3684,16,21,"RECORTES CERO-GV",8
7,"7009",737,495,488,3,7,"RECORTES CERO-GV",1
8,"8006",11774,8375,8329,53,46,"RECORTES CERO-GV",17
18,"18148",787,618,605,5,13,"RECORTES CERO-GV",0
4,"4076",1209,873,850,7,23,"RECORTES CERO-GV",3
41,"41087",10557,7217,7029,67,188,"RECORTES CERO-GV",7
39,"39074",7050,5074,5029,26,45,"RECORTES CERO-GV",2
31,"31096",99,79,79,3,0,"RECORTES CERO-GV",0
44,"44053",103,87,85,1,2,"RECORTES CERO-GV",0
43,"43001",708,510,507,0,3,"RECORTES CERO-GV",2
12,"12110",222,156,155,3,1,"RECORTES CERO-GV",0
7,"7047",2399,1504,1477,20,27,"RECORTES CERO-GV",5
10,"10128",5618,3799,3630,37,169,"RECORTES CERO-GV",1
23,"23058",8832,6528,6407,57,121,"RECORTES CERO-GV",7
48,"48067",1133,810,805,0,5,"RECORTES CERO-GV",0
26,"26053",191,144,140,2,4,"RECORTES CERO-GV",2
15,"15082",15446,10821,10687,130,134,"RECORTES CERO-GV",25
6,"6002",4313,2914,2804,37,110,"RECORTES CERO-GV",3
46,"46262",206,136,134,1,2,"RECORTES CERO-GV",0
46,"46076",610,500,494,1,6,"RECORTES CERO-GV",0
22,"22076",285,207,203,4,4,"RECORTES CERO-GV",1
8,"8183",4573,3406,3398,14,8,"RECORTES CERO-GV",0
50,"50023",199,145,143,2,2,"RECORTES CERO-GV",1
10,"10170",231,164,162,2,2,"RECORTES CERO-GV",0
38,"38039",11149,7375,7326,68,49,"RECORTES CERO-GV",5
15,"15028",1392,944,936,4,8,"RECORTES CERO-GV",0
8,"8019",1122912,824423,821037,5287,3386,"RECORTES CERO-GV",1351
44,"44052",75,54,54,0,0,"RECORTES CERO-GV",0
31,"31104",1751,1147,1125,8,22,"RECORTES CERO-GV",5
31,"31239",282,196,193,6,3,"RECORTES CERO-GV",0
39,"39090",773,557,553,2,4,"RECORTES CERO-GV",1
38,"38027",5581,3577,3533,22,44,"RECORTES CERO-GV",4
44,"44145",974,698,697,3,1,"RECORTES CERO-GV",0
46,"46134",2419,1697,1678,14,19,"RECORTES CERO-GV",2
6,"6117",1388,982,958,11,24,"RECORTES CERO-GV",0
8,"8226",929,748,747,10,1,"RECORTES CERO-GV",0
10,"10078",365,271,263,7,8,"RECORTES CERO-GV",0
8,"8049",1309,910,903,3,7,"RECORTES CERO-GV",0
8,"8102",28940,21108,21014,157,94,"RECORTES CERO-GV",30
4,"4072",311,212,211,0,1,"RECORTES CERO-GV",0
41,"41095",40187,27090,26680,512,410,"RECORTES CERO-GV",56
3,"3021",5573,4423,4343,23,80,"RECORTES CERO-GV",4
29,"29073",1657,1082,1069,15,13,"RECORTES CERO-GV",0
46,"46118",3649,2730,2701,20,29,"RECORTES CERO-GV",1
1,"1901",2473,1633,1612,9,21,"RECORTES CERO-GV",6
29,"29062",658,557,551,2,6,"RECORTES CERO-GV",0
12,"12006",177,133,133,2,0,"RECORTES CERO-GV",0
46,"46169",32403,23890,23698,222,192,"RECORTES CERO-GV",43
23,"23061",7711,5357,5231,44,126,"RECORTES CERO-GV",1
15,"15084",3039,2002,1981,12,21,"RECORTES CERO-GV",2
48,"48042",1359,1055,1045,7,10,"RECORTES CERO-GV",1
31,"31076",2543,1965,1956,19,9,"RECORTES CERO-GV",2
8,"8161",11826,8001,7951,58,50,"RECORTES CERO-GV",10
25,"25070",817,619,617,11,2,"RECORTES CERO-GV",1
18,"18062",11226,7969,7777,88,192,"RECORTES CERO-GV",4
46,"46101",819,670,663,8,7,"RECORTES CERO-GV",0
46,"46139",4520,3486,3457,18,29,"RECORTES CERO-GV",2
3,"3041",6132,4204,4167,22,37,"RECORTES CERO-GV",5
18,"18084",4533,3233,3178,35,55,"RECORTES CERO-GV",1
39,"39013",517,359,356,1,3,"RECORTES CERO-GV",0
8,"8300",5927,4609,4589,41,20,"RECORTES CERO-GV",9
46,"46071",471,355,349,1,6,"RECORTES CERO-GV",0
25,"25103",133,88,87,0,1,"RECORTES CERO-GV",0
25,"25226",236,156,155,0,1,"RECORTES CERO-GV",0
43,"43102",458,331,324,2,7,"RECORTES CERO-GV",0
12,"12105",825,602,598,6,4,"RECORTES CERO-GV",0
32,"32009",10558,6621,6549,50,72,"RECORTES CERO-GV",10
1,"1004",1357,952,945,5,7,"RECORTES CERO-GV",4
21,"21048",318,234,229,3,5,"RECORTES CERO-GV",1
46,"46080",979,720,712,2,8,"RECORTES CERO-GV",0
25,"25024",352,248,247,0,1,"RECORTES CERO-GV",0
8,"8249",274,238,237,0,1,"RECORTES CERO-GV",0
39,"39099",3193,2363,2346,10,17,"RECORTES CERO-GV",0
1,"1046",639,433,432,2,1,"RECORTES CERO-GV",0
33,"33049",5973,3569,3518,48,51,"RECORTES CERO-GV",1
50,"50085",182,121,121,0,0,"RECORTES CERO-GV",0
50,"50292",130,108,107,0,1,"RECORTES CERO-GV",0
32,"32059",1686,1099,1082,20,17,"RECORTES CERO-GV",1
22,"22141",115,94,93,0,1,"RECORTES CERO-GV",0
3,"3103",238,196,194,2,2,"RECORTES CERO-GV",0
26,"26060",78,51,50,2,1,"RECORTES CERO-GV",0
50,"50155",95,65,65,0,0,"RECORTES CERO-GV",0
29,"29028",1215,803,779,9,24,"RECORTES CERO-GV",2
36,"36050",7645,5137,5049,48,88,"RECORTES CERO-GV",15
18,"18061",999,781,770,5,11,"RECORTES CERO-GV",0
10,"10217",506,378,377,3,1,"RECORTES CERO-GV",0
12,"12064",80,71,69,0,2,"RECORTES CERO-GV",0
38,"38043",19365,12355,12212,126,143,"RECORTES CERO-GV",21
32,"32026",2655,1762,1731,17,31,"RECORTES CERO-GV",2
22,"22195",238,190,186,0,4,"RECORTES CERO-GV",1
20,"20025",1110,791,788,4,3,"RECORTES CERO-GV",0
31,"31105",1471,1144,1124,10,20,"RECORTES CERO-GV",1
10,"10218",1074,685,672,0,13,"RECORTES CERO-GV",0
33,"33034",9979,5937,5873,64,64,"RECORTES CERO-GV",6
17,"17211",837,677,674,6,3,"RECORTES CERO-GV",0
3,"3053",7568,5551,5468,40,83,"RECORTES CERO-GV",7
26,"26050",125,92,91,1,1,"RECORTES CERO-GV",0
25,"25136",95,74,74,2,0,"RECORTES CERO-GV",0
20,"20035",480,361,361,0,0,"RECORTES CERO-GV",0
18,"18901",489,323,322,5,1,"RECORTES CERO-GV",1
6,"6149",10177,7582,7455,64,127,"RECORTES CERO-GV",12
50,"50198",47,32,32,0,0,"RECORTES CERO-GV",0
20,"20066",437,288,286,1,2,"RECORTES CERO-GV",0
46,"46142",778,536,524,3,12,"RECORTES CERO-GV",0
25,"25220",991,768,762,1,6,"RECORTES CERO-GV",2
18,"18054",820,573,569,2,4,"RECORTES CERO-GV",1
29,"29014",218,122,121,3,1,"RECORTES CERO-GV",0
27,"27009",2005,1324,1303,11,21,"RECORTES CERO-GV",2
17,"17149",370,302,300,1,2,"RECORTES CERO-GV",0
7,"7020",3707,2522,2493,40,29,"RECORTES CERO-GV",2
25,"25082",292,197,197,2,0,"RECORTES CERO-GV",0
43,"43904",2864,1881,1851,20,30,"RECORTES CERO-GV",0
26,"26139",58,43,43,2,0,"RECORTES CERO-GV",1
21,"21054",8175,6014,5887,41,127,"RECORTES CERO-GV",8
10,"10136",274,205,202,1,3,"RECORTES CERO-GV",0
7,"7006",5393,3257,3220,34,37,"RECORTES CERO-GV",4
32,"32063",1795,1135,1119,16,16,"RECORTES CERO-GV",0
25,"25239",582,330,330,3,0,"RECORTES CERO-GV",0
22,"22164",42,28,28,0,0,"RECORTES CERO-GV",0
50,"50251",8209,5732,5658,66,74,"RECORTES CERO-GV",4
39,"39046",1342,910,902,3,8,"RECORTES CERO-GV",0
18,"18165",4265,2870,2820,22,50,"RECORTES CERO-GV",2
26,"26100",54,43,43,0,0,"RECORTES CERO-GV",0
27,"27059",2035,1356,1322,7,34,"RECORTES CERO-GV",0
46,"46904",812,615,605,2,10,"RECORTES CERO-GV",0
22,"22144",255,192,190,2,2,"RECORTES CERO-GV",0
33,"33065",1077,670,657,11,13,"RECORTES CERO-GV",0
25,"25017",228,175,174,0,1,"RECORTES CERO-GV",0
29,"29006",679,461,452,4,9,"RECORTES CERO-GV",1
8,"8052",140,102,102,1,0,"RECORTES CERO-GV",0
21,"21011",3500,2371,2314,23,57,"RECORTES CERO-GV",2
31,"31231",104,65,65,1,0,"RECORTES CERO-GV",0
7,"7024",7283,3574,3538,36,36,"RECORTES CERO-GV",12
18,"18037",535,417,410,2,7,"RECORTES CERO-GV",0
48,"48021",1325,891,888,3,3,"RECORTES CERO-GV",0
17,"17047",5016,3087,3068,22,19,"RECORTES CERO-GV",2
22,"22122",69,52,50,2,2,"RECORTES CERO-GV",0
18,"18904",741,500,498,1,2,"RECORTES CERO-GV",0
25,"25232",1357,1012,1007,6,5,"RECORTES CERO-GV",0
48,"48049",543,415,414,1,1,"RECORTES CERO-GV",0
1,"1037",589,378,374,1,4,"RECORTES CERO-GV",0
29,"29081",250,185,182,2,3,"RECORTES CERO-GV",0
39,"39020",23993,15944,15792,89,152,"RECORTES CERO-GV",10
50,"50200",479,389,383,5,6,"RECORTES CERO-GV",0
6,"6094",1457,868,858,5,10,"RECORTES CERO-GV",1
31,"31135",111,73,72,3,1,"RECORTES CERO-GV",1
22,"22094",102,69,69,3,0,"RECORTES CERO-GV",0
31,"31229",39,32,32,0,0,"RECORTES CERO-GV",0
14,"14006",1319,1088,1057,8,31,"RECORTES CERO-GV",0
32,"32038",387,253,251,4,2,"RECORTES CERO-GV",0
17,"17071",1134,943,940,1,3,"RECORTES CERO-GV",1
10,"10190",513,334,325,10,9,"RECORTES CERO-GV",1
12,"12131",97,87,87,0,0,"RECORTES CERO-GV",0
39,"39031",1237,870,865,1,5,"RECORTES CERO-GV",0
15,"15067",7933,5329,5282,43,47,"RECORTES CERO-GV",7
3,"3097",1014,778,764,5,14,"RECORTES CERO-GV",1
8,"8024",357,282,282,2,0,"RECORTES CERO-GV",0
12,"12114",200,144,140,0,4,"RECORTES CERO-GV",0
17,"17041",217,150,146,1,4,"RECORTES CERO-GV",0
31,"31087",179,124,124,3,0,"RECORTES CERO-GV",0
46,"46256",7280,4996,4940,32,56,"RECORTES CERO-GV",4
43,"43117",147,119,119,0,0,"RECORTES CERO-GV",0
46,"46153",443,353,349,2,4,"RECORTES CERO-GV",0
1,"1036",14698,10207,10131,51,76,"RECORTES CERO-GV",13
36,"36030",3921,2516,2484,31,32,"RECORTES CERO-GV",3
39,"39077",237,151,148,1,3,"RECORTES CERO-GV",0
15,"15901",3334,1948,1928,27,20,"RECORTES CERO-GV",3
21,"21014",4066,3089,3029,30,60,"RECORTES CERO-GV",0
27,"27004",1143,640,625,2,15,"RECORTES CERO-GV",0
36,"36060",30431,19909,19673,206,236,"RECORTES CERO-GV",26
44,"44103",122,96,96,3,0,"RECORTES CERO-GV",0
35,"35010",3853,2224,2194,18,30,"RECORTES CERO-GV",2
11,"11002",4218,3176,3149,16,27,"RECORTES CERO-GV",0
33,"33069",3379,2249,2231,41,18,"RECORTES CERO-GV",1
41,"41020",13012,8148,7999,135,149,"RECORTES CERO-GV",3
41,"41093",19064,14867,14700,151,167,"RECORTES CERO-GV",30
7,"7018",389,238,236,1,2,"RECORTES CERO-GV",1
12,"12025",116,82,79,1,3,"RECORTES CERO-GV",0
8,"8093",25,22,22,0,0,"RECORTES CERO-GV",0
23,"23074",2984,2271,2236,20,35,"RECORTES CERO-GV",1
44,"44191",714,509,500,5,9,"RECORTES CERO-GV",0
25,"25050",3256,2260,2249,20,11,"RECORTES CERO-GV",2
27,"27901",2249,1373,1360,22,13,"RECORTES CERO-GV",2
29,"29085",138,98,93,1,5,"RECORTES CERO-GV",1
31,"31236",1319,815,808,8,7,"RECORTES CERO-GV",0
46,"46018",562,442,436,2,6,"RECORTES CERO-GV",0
33,"33048",132,86,85,1,1,"RECORTES CERO-GV",0
22,"22246",63,43,43,0,0,"RECORTES CERO-GV",0
22,"22184",167,132,130,4,2,"RECORTES CERO-GV",0
12,"12002",114,96,94,1,2,"RECORTES CERO-GV",0
48,"48092",872,614,608,3,6,"RECORTES CERO-GV",0
17,"17210",572,414,411,2,3,"RECORTES CERO-GV",1
44,"44106",151,107,106,0,1,"RECORTES CERO-GV",0
29,"29003",916,677,666,4,11,"RECORTES CERO-GV",0
17,"17199",6984,4919,4894,39,25,"RECORTES CERO-GV",10
36,"36902",5028,3453,3396,19,57,"RECORTES CERO-GV",1
8,"8155",7056,5050,5011,38,39,"RECORTES CERO-GV",2
1,"1041",150,103,102,1,1,"RECORTES CERO-GV",0
1,"1010",2315,1705,1688,6,17,"RECORTES CERO-GV",1
21,"21047",1878,1144,1112,12,32,"RECORTES CERO-GV",0
6,"6116",1500,1015,998,7,17,"RECORTES CERO-GV",1
8,"8901",240,200,195,2,5,"RECORTES CERO-GV",0
39,"39052",19005,13859,13748,83,111,"RECORTES CERO-GV",10
22,"22239",85,67,65,0,2,"RECORTES CERO-GV",0
50,"50213",92,70,70,2,0,"RECORTES CERO-GV",0
21,"21017",2302,1469,1452,18,17,"RECORTES CERO-GV",0
44,"44107",212,135,135,0,0,"RECORTES CERO-GV",0
10,"10109",1714,1030,1006,4,24,"RECORTES CERO-GV",2
32,"32039",1154,801,790,11,11,"RECORTES CERO-GV",0
50,"50061",190,157,155,2,2,"RECORTES CERO-GV",0
50,"50104",320,251,251,1,0,"RECORTES CERO-GV",0
30,"30010",6852,5161,5106,25,55,"RECORTES CERO-GV",2
44,"44042",114,82,81,0,1,"RECORTES CERO-GV",0
17,"17130",325,270,270,1,0,"RECORTES CERO-GV",1
17,"17043",165,133,133,0,0,"RECORTES CERO-GV",0
22,"22242",60,41,40,0,1,"RECORTES CERO-GV",0
29,"29087",363,249,243,4,6,"RECORTES CERO-GV",0
25,"25242",688,494,488,5,6,"RECORTES CERO-GV",0
22,"22090",86,61,61,1,0,"RECORTES CERO-GV",0
6,"6058",1984,1372,1331,13,41,"RECORTES CERO-GV",2
31,"31093",275,201,198,3,3,"RECORTES CERO-GV",1
3,"3073",222,178,178,0,0,"RECORTES CERO-GV",0
3,"3102",7181,5126,5073,36,53,"RECORTES CERO-GV",3
20,"20036",13208,9102,9056,59,46,"RECORTES CERO-GV",9
7,"7011",28971,17082,16964,164,118,"RECORTES CERO-GV",31
46,"46165",7349,5460,5412,39,48,"RECORTES CERO-GV",4
4,"4019",236,174,172,0,2,"RECORTES CERO-GV",0
22,"22135",173,123,121,0,2,"RECORTES CERO-GV",0
15,"15087",5710,3436,3392,31,44,"RECORTES CERO-GV",3
11,"11035",13751,8535,8396,125,139,"RECORTES CERO-GV",14
1,"1031",1136,844,830,1,14,"RECORTES CERO-GV",2
8,"8057",61,47,47,1,0,"RECORTES CERO-GV",0
3,"3015",12818,9127,9017,46,110,"RECORTES CERO-GV",15
26,"26056",404,312,301,2,11,"RECORTES CERO-GV",0
44,"44218",28,24,24,3,0,"RECORTES CERO-GV",0
15,"15024",4314,2859,2790,44,69,"RECORTES CERO-GV",2
10,"10026",647,464,452,6,12,"RECORTES CERO-GV",5
36,"36056",4932,3368,3310,24,58,"RECORTES CERO-GV",1
10,"10031",162,128,124,0,4,"RECORTES CERO-GV",0
26,"26183",66,48,48,0,0,"RECORTES CERO-GV",0
17,"17133",1262,976,964,7,12,"RECORTES CERO-GV",0
22,"22128",188,145,143,3,2,"RECORTES CERO-GV",0
32,"32079",1280,880,869,13,11,"RECORTES CERO-GV",3
8,"8097",1103,845,840,4,5,"RECORTES CERO-GV",0
10,"10114",964,644,637,6,7,"RECORTES CERO-GV",2
51,"51001",59820,33614,33265,323,349,"RECORTES CERO-GV",118
26,"26077",16,16,16,0,0,"RECORTES CERO-GV",0
31,"31243",300,216,213,6,3,"RECORTES CERO-GV",1
4,"4102",14202,9264,9139,57,125,"RECORTES CERO-GV",10
33,"33075",244,125,122,3,3,"RECORTES CERO-GV",0
33,"33018",2804,1830,1806,30,24,"RECORTES CERO-GV",2
10,"10155",1073,735,717,6,18,"RECORTES CERO-GV",1
44,"44018",16,16,16,0,0,"RECORTES CERO-GV",0
14,"14001",3423,2563,2515,11,48,"RECORTES CERO-GV",1
20,"20018",11231,7640,7611,33,29,"RECORTES CERO-GV",3
8,"8037",1947,1547,1543,11,4,"RECORTES CERO-GV",1
26,"26078",86,63,63,0,0,"RECORTES CERO-GV",0
1,"1008",808,546,536,6,10,"RECORTES CERO-GV",2
8,"8905",2329,1872,1863,7,9,"RECORTES CERO-GV",1
41,"41054",719,562,546,3,16,"RECORTES CERO-GV",0
50,"50266",120,77,76,3,1,"RECORTES CERO-GV",0
17,"17085",293,239,238,0,1,"RECORTES CERO-GV",0
26,"26067",22,18,18,3,0,"RECORTES CERO-GV",0
22,"22111",143,96,95,2,1,"RECORTES CERO-GV",0
43,"43028",2770,1784,1770,7,14,"RECORTES CERO-GV",2
26,"26055",39,30,30,0,0,"RECORTES CERO-GV",0
44,"44108",306,209,205,1,4,"RECORTES CERO-GV",0
3,"3901",1137,783,776,9,7,"RECORTES CERO-GV",2
26,"26152",27,20,20,1,0,"RECORTES CERO-GV",0
17,"17129",143,108,108,2,0,"RECORTES CERO-GV",0
8,"8034",820,644,640,0,4,"RECORTES CERO-GV",0
3,"3071",4000,2858,2813,27,45,"RECORTES CERO-GV",3
6,"6036",4930,3492,3394,20,98,"RECORTES CERO-GV",3
14,"14071",874,551,540,5,11,"RECORTES CERO-GV",0
7,"7064",5566,3232,3204,18,28,"RECORTES CERO-GV",13
46,"46108",420,328,324,1,4,"RECORTES CERO-GV",0
43,"43061",40,27,27,3,0,"RECORTES CERO-GV",0
14,"14040",3749,2905,2845,53,60,"RECORTES CERO-GV",1
44,"44260",137,93,93,1,0,"RECORTES CERO-GV",0
32,"32058",5247,3547,3489,30,58,"RECORTES CERO-GV",3
46,"46229",903,715,708,5,7,"RECORTES CERO-GV",0
50,"50169",333,231,230,0,1,"RECORTES CERO-GV",4
26,"26044",51,38,36,0,2,"RECORTES CERO-GV",0
35,"35017",27498,15513,15240,121,273,"RECORTES CERO-GV",17
12,"12051",437,297,295,3,2,"RECORTES CERO-GV",0
22,"22247",28,18,18,0,0,"RECORTES CERO-GV",0
3,"3088",5895,4030,3961,29,69,"RECORTES CERO-GV",6
10,"10118",278,232,231,1,1,"RECORTES CERO-GV",0
11,"11012",97338,67120,66466,861,654,"RECORTES CERO-GV",171
8,"8224",885,653,652,6,1,"RECORTES CERO-GV",1
3,"3003",449,368,367,1,1,"RECORTES CERO-GV",1
18,"18083",232,181,179,1,2,"RECORTES CERO-GV",1
41,"41057",258,174,170,3,4,"RECORTES CERO-GV",1
32,"32084",878,532,527,8,5,"RECORTES CERO-GV",0
6,"6037",1656,1033,1018,8,15,"RECORTES CERO-GV",0
29,"29093",2150,1543,1520,8,23,"RECORTES CERO-GV",0
46,"46215",1407,1088,1068,10,20,"RECORTES CERO-GV",1
17,"17217",350,287,284,0,3,"RECORTES CERO-GV",0
33,"33050",548,316,314,1,2,"RECORTES CERO-GV",1
11,"11013",2352,1564,1522,13,42,"RECORTES CERO-GV",2
48,"48034",12623,8789,8711,76,78,"RECORTES CERO-GV",11
8,"8040",11116,7923,7891,49,32,"RECORTES CERO-GV",14
39,"39032",1420,1032,1027,7,5,"RECORTES CERO-GV",0
39,"39004",1479,1050,1031,5,19,"RECORTES CERO-GV",0
25,"25249",176,129,127,2,2,"RECORTES CERO-GV",0
8,"8202",12943,9408,9358,58,50,"RECORTES CERO-GV",12
25,"25039",259,197,196,7,1,"RECORTES CERO-GV",0
6,"6125",1644,1251,1222,7,29,"RECORTES CERO-GV",0
17,"17054",342,250,250,2,0,"RECORTES CERO-GV",1
3,"3113",4339,2978,2935,23,43,"RECORTES CERO-GV",1
50,"50264",151,111,110,0,1,"RECORTES CERO-GV",0
8,"8261",2405,1726,1718,11,8,"RECORTES CERO-GV",3
3,"3080",1330,1040,1032,4,8,"RECORTES CERO-GV",0
22,"22125",39530,27358,27075,344,283,"RECORTES CERO-GV",70
25,"25086",525,410,407,3,3,"RECORTES CERO-GV",0
3,"3005",7937,5907,5869,40,38,"RECORTES CERO-GV",4
31,"31075",113,69,69,2,0,"RECORTES CERO-GV",0
17,"17201",137,103,103,0,0,"RECORTES CERO-GV",0
21,"21027",49,32,32,0,0,"RECORTES CERO-GV",0
32,"32050",2254,1630,1612,15,18,"RECORTES CERO-GV",2
8,"8042",2390,1772,1764,12,8,"RECORTES CERO-GV",4
26,"26086",15,15,15,0,0,"RECORTES CERO-GV",0
35,"35019",32830,18390,18243,87,147,"RECORTES CERO-GV",14
25,"25154",117,86,85,0,1,"RECORTES CERO-GV",0
3,"3062",228,173,172,3,1,"RECORTES CERO-GV",0
30,"30041",14040,8999,8876,94,123,"RECORTES CERO-GV",16
22,"22250",346,241,241,0,0,"RECORTES CERO-GV",0
20,"20024",395,245,245,4,0,"RECORTES CERO-GV",0
43,"43129",4607,3284,3261,21,23,"RECORTES CERO-GV",7
8,"8065",1183,920,913,8,7,"RECORTES CERO-GV",5
17,"17025",1182,943,938,5,5,"RECORTES CERO-GV",0
12,"12107",350,299,295,3,4,"RECORTES CERO-GV",1
25,"25219",146,111,111,1,0,"RECORTES CERO-GV",0
6,"6042",984,644,629,5,15,"RECORTES CERO-GV",1
8,"8287",1067,853,844,4,9,"RECORTES CERO-GV",1
27,"27008",1326,865,853,5,12,"RECORTES CERO-GV",1
39,"39035",9142,6574,6517,24,57,"RECORTES CERO-GV",2
18,"18086",338,253,247,1,6,"RECORTES CERO-GV",0
50,"50222",1574,1024,1008,12,16,"RECORTES CERO-GV",0
36,"36014",1867,1265,1243,16,22,"RECORTES CERO-GV",5
15,"15068",4824,2976,2937,54,39,"RECORTES CERO-GV",4
21,"21029",1514,1036,1003,14,33,"RECORTES CERO-GV",1
12,"12028",13004,9801,9732,74,69,"RECORTES CERO-GV",6
22,"22042",116,91,89,1,2,"RECORTES CERO-GV",0
48,"48065",3285,2341,2326,8,15,"RECORTES CERO-GV",3
43,"43034",465,365,365,5,0,"RECORTES CERO-GV",0
26,"26039",40,31,31,0,0,"RECORTES CERO-GV",0
50,"50122",68,43,42,1,1,"RECORTES CERO-GV",0
50,"50193",664,487,475,4,12,"RECORTES CERO-GV",0
27,"27051",7986,5324,5241,58,83,"RECORTES CERO-GV",7
31,"31216",3867,2592,2566,37,26,"RECORTES CERO-GV",10
31,"31022",477,303,301,2,2,"RECORTES CERO-GV",0
8,"8184",55053,38519,38323,298,196,"RECORTES CERO-GV",47
11,"11008",17923,11702,11464,192,238,"RECORTES CERO-GV",11
26,"26068",78,61,61,0,0,"RECORTES CERO-GV",0
17,"17168",373,309,308,3,1,"RECORTES CERO-GV",2
8,"8056",42897,30873,30757,259,116,"RECORTES CERO-GV",64
46,"46113",2558,1791,1773,7,18,"RECORTES CERO-GV",2
4,"4058",342,238,236,3,2,"RECORTES CERO-GV",1
46,"46261",1708,1259,1237,12,22,"RECORTES CERO-GV",0
8,"8029",3586,2868,2862,20,6,"RECORTES CERO-GV",5
10,"10140",1109,778,769,7,9,"RECORTES CERO-GV",0
4,"4020",302,207,206,2,1,"RECORTES CERO-GV",0
39,"39102",2229,1524,1514,10,10,"RECORTES CERO-GV",0
25,"25149",1377,1034,1028,9,6,"RECORTES CERO-GV",0
46,"46075",144,125,122,2,3,"RECORTES CERO-GV",0
12,"12134",135,95,95,1,0,"RECORTES CERO-GV",0
6,"6092",558,438,426,2,12,"RECORTES CERO-GV",0
41,"41035",1051,733,722,10,11,"RECORTES CERO-GV",1
6,"6046",1250,983,959,6,24,"RECORTES CERO-GV",1
22,"22253",56,40,40,1,0,"RECORTES CERO-GV",0
8,"8297",138,99,99,0,0,"RECORTES CERO-GV",0
17,"17093",913,637,634,5,3,"RECORTES CERO-GV",5
32,"32092",491,280,275,0,5,"RECORTES CERO-GV",2
8,"8009",9531,7200,7171,47,29,"RECORTES CERO-GV",16
31,"31182",29,25,25,0,0,"RECORTES CERO-GV",0
31,"31256",95,55,55,1,0,"RECORTES CERO-GV",0
6,"6093",4325,3176,3073,26,103,"RECORTES CERO-GV",7
31,"31073",298,207,206,1,1,"RECORTES CERO-GV",1
8,"8068",6863,5064,5041,40,23,"RECORTES CERO-GV",2
29,"29071",980,580,564,11,16,"RECORTES CERO-GV",1
26,"26131",34,33,33,0,0,"RECORTES CERO-GV",0
31,"31110",83,61,61,1,0,"RECORTES CERO-GV",0
22,"22045",65,52,52,0,0,"RECORTES CERO-GV",0
18,"18168",783,566,561,11,5,"RECORTES CERO-GV",0
31,"31146",30,22,22,1,0,"RECORTES CERO-GV",0
1,"1054",998,701,700,4,1,"RECORTES CERO-GV",2
1,"1055",839,557,552,11,5,"RECORTES CERO-GV",0
29,"29052",213,129,128,0,1,"RECORTES CERO-GV",0
17,"17120",823,560,558,5,2,"RECORTES CERO-GV",0
30,"30043",25449,18839,18477,180,362,"RECORTES CERO-GV",18
39,"39083",1063,619,611,2,8,"RECORTES CERO-GV",0
50,"50248",501,344,328,3,16,"RECORTES CERO-GV",0
36,"36059",4641,2844,2796,29,48,"RECORTES CERO-GV",4
46,"46133",462,359,352,1,7,"RECORTES CERO-GV",0
18,"18189",785,598,592,9,6,"RECORTES CERO-GV",1
23,"23049",1740,1215,1183,12,32,"RECORTES CERO-GV",2
25,"25140",779,540,539,2,1,"RECORTES CERO-GV",0
6,"6111",487,318,314,2,4,"RECORTES CERO-GV",0
17,"17207",2420,1920,1901,9,19,"RECORTES CERO-GV",0
10,"10104",5123,3470,3396,21,74,"RECORTES CERO-GV",5
17,"17068",253,191,191,0,0,"RECORTES CERO-GV",1
44,"44029",585,454,451,2,3,"RECORTES CERO-GV",0
31,"31112",91,56,56,0,0,"RECORTES CERO-GV",0
15,"15021",5254,3473,3422,58,51,"RECORTES CERO-GV",8
14,"14012",6046,4215,4120,56,95,"RECORTES CERO-GV",1
6,"6051",1523,1147,1137,5,10,"RECORTES CERO-GV",2
12,"12033",1953,1391,1368,6,23,"RECORTES CERO-GV",1
27,"27024",1447,1048,1032,6,16,"RECORTES CERO-GV",0
31,"31259",475,313,311,5,2,"RECORTES CERO-GV",1
31,"31039",92,70,69,1,1,"RECORTES CERO-GV",0
46,"46237",7172,5199,5146,53,53,"RECORTES CERO-GV",5
39,"39069",1934,1475,1458,2,17,"RECORTES CERO-GV",0
14,"14013",16619,11968,11719,153,249,"RECORTES CERO-GV",9
17,"17182",269,195,195,0,0,"RECORTES CERO-GV",1
22,"22047",248,202,201,1,1,"RECORTES CERO-GV",0
31,"31040",186,131,129,1,2,"RECORTES CERO-GV",0
4,"4037",1212,890,875,17,15,"RECORTES CERO-GV",0
50,"50144",31,24,24,0,0,"RECORTES CERO-GV",0
12,"12061",374,263,261,4,2,"RECORTES CERO-GV",1
35,"35002",24229,15311,15133,101,178,"RECORTES CERO-GV",11
17,"17013",2765,1999,1985,15,14,"RECORTES CERO-GV",2
44,"44003",17,15,15,0,0,"RECORTES CERO-GV",0
22,"22114",124,75,72,1,3,"RECORTES CERO-GV",0
39,"39042",5910,4354,4315,14,39,"RECORTES CERO-GV",1
43,"43110",247,178,178,2,0,"RECORTES CERO-GV",0
22,"22139",80,57,57,1,0,"RECORTES CERO-GV",0
6,"6039",1802,1375,1343,9,32,"RECORTES CERO-GV",0
17,"17206",158,111,109,0,2,"RECORTES CERO-GV",0
27,"27019",8188,5478,5395,88,83,"RECORTES CERO-GV",6
39,"39030",1874,1199,1187,6,12,"RECORTES CERO-GV",0
41,"41046",3005,2241,2198,11,43,"RECORTES CERO-GV",0
6,"6065",293,230,228,2,2,"RECORTES CERO-GV",0
8,"8181",8133,5949,5924,31,25,"RECORTES CERO-GV",5
22,"22062",154,107,107,1,0,"RECORTES CERO-GV",0
20,"20004",230,133,133,2,0,"RECORTES CERO-GV",0
26,"26177",306,233,229,2,4,"RECORTES CERO-GV",0
31,"31212",128,91,91,1,0,"RECORTES CERO-GV",1
25,"25043",800,584,581,2,3,"RECORTES CERO-GV",1
26,"26099",1220,956,931,7,25,"RECORTES CERO-GV",1
3,"3100",499,384,378,0,6,"RECORTES CERO-GV",1
17,"17157",122,104,103,0,1,"RECORTES CERO-GV",0
31,"31226",572,347,343,4,4,"RECORTES CERO-GV",0
32,"32062",784,557,550,1,7,"RECORTES CERO-GV",0
44,"44032",17,13,13,0,0,"RECORTES CERO-GV",0
6,"6101",437,355,346,1,9,"RECORTES CERO-GV",0
25,"25072",5881,4059,4031,30,28,"RECORTES CERO-GV",2
39,"39071",410,251,250,1,1,"RECORTES CERO-GV",0
7,"7054",23257,12613,12464,111,149,"RECORTES CERO-GV",41
35,"35004",41975,20773,20602,156,171,"RECORTES CERO-GV",20
48,"48073",6827,4614,4591,38,23,"RECORTES CERO-GV",1
10,"10041",1022,720,706,2,14,"RECORTES CERO-GV",1
10,"10055",697,488,473,3,15,"RECORTES CERO-GV",1
46,"46240",200,167,155,1,12,"RECORTES CERO-GV",0
36,"36054",11107,7027,6894,57,133,"RECORTES CERO-GV",12
33,"33006",1476,862,857,9,5,"RECORTES CERO-GV",0
48,"48074",3275,2308,2295,11,13,"RECORTES CERO-GV",2
21,"21038",1082,688,676,4,12,"RECORTES CERO-GV",3
18,"18098",5959,3816,3749,33,67,"RECORTES CERO-GV",2
39,"39100",849,567,565,5,2,"RECORTES CERO-GV",0
36,"36024",16335,11431,11256,99,175,"RECORTES CERO-GV",7
1,"1033",654,476,476,0,0,"RECORTES CERO-GV",3
7,"7055",8062,4546,4492,40,54,"RECORTES CERO-GV",4
41,"41014",2476,1852,1799,10,53,"RECORTES CERO-GV",0
44,"44154",240,164,161,1,3,"RECORTES CERO-GV",0
25,"25109",211,155,154,1,1,"RECORTES CERO-GV",0
1,"1061",155,116,116,1,0,"RECORTES CERO-GV",0
3,"3007",173,141,139,0,2,"RECORTES CERO-GV",0
21,"21039",303,211,210,6,1,"RECORTES CERO-GV",0
10,"10211",446,303,300,0,3,"RECORTES CERO-GV",0
36,"36015",4079,2653,2606,29,47,"RECORTES CERO-GV",0
8,"8220",2411,2010,2001,8,9,"RECORTES CERO-GV",0
18,"18088",1526,1000,993,10,7,"RECORTES CERO-GV",0
26,"26107",86,65,64,1,1,"RECORTES CERO-GV",0
43,"43046",88,69,68,1,1,"RECORTES CERO-GV",0
46,"46120",1179,903,880,5,23,"RECORTES CERO-GV",1
3,"3027",167,142,138,1,4,"RECORTES CERO-GV",1
38,"38053",3768,2275,2244,16,31,"RECORTES CERO-GV",4
27,"27030",3117,1945,1898,19,47,"RECORTES CERO-GV",1
50,"50265",74,54,54,1,0,"RECORTES CERO-GV",0
18,"18100",7997,5523,5367,66,156,"RECORTES CERO-GV",3
14,"14018",3617,2632,2568,31,64,"RECORTES CERO-GV",2
7,"7013",7353,4725,4639,43,86,"RECORTES CERO-GV",5
17,"17046",709,537,531,2,6,"RECORTES CERO-GV",0
4,"4057",1261,886,872,6,14,"RECORTES CERO-GV",2
44,"44243",25,19,19,0,0,"RECORTES CERO-GV",0
12,"12093",161,111,109,2,2,"RECORTES CERO-GV",0
8,"8304",822,655,655,5,0,"RECORTES CERO-GV",0
29,"29080",6940,4676,4617,36,59,"RECORTES CERO-GV",16
11,"11029",5442,2826,2765,44,61,"RECORTES CERO-GV",0
32,"32030",945,642,641,8,1,"RECORTES CERO-GV",0
50,"50233",96,78,78,0,0,"RECORTES CERO-GV",0
18,"18903",852,544,537,9,7,"RECORTES CERO-GV",0
38,"38022",18630,11420,11284,87,136,"RECORTES CERO-GV",3
21,"21041",113074,73295,72313,1063,982,"RECORTES CERO-GV",298
3,"3019",15501,11261,11106,86,155,"RECORTES CERO-GV",9
33,"33066",42818,27780,27466,425,314,"RECORTES CERO-GV",43
18,"18101",9449,6688,6568,77,120,"RECORTES CERO-GV",7
22,"22053",783,494,492,6,2,"RECORTES CERO-GV",1
8,"8098",2438,1781,1778,21,3,"RECORTES CERO-GV",4
3,"3104",27072,19732,19477,218,255,"RECORTES CERO-GV",32
25,"25076",131,91,91,0,0,"RECORTES CERO-GV",0
43,"43142",1069,783,774,3,9,"RECORTES CERO-GV",0
3,"3020",94,84,84,1,0,"RECORTES CERO-GV",0
8,"8053",2896,1939,1929,13,10,"RECORTES CERO-GV",1
26,"26093",48,34,33,0,1,"RECORTES CERO-GV",0
33,"33010",1722,1085,1069,15,16,"RECORTES CERO-GV",1
27,"27022",4654,2760,2696,20,64,"RECORTES CERO-GV",3
26,"26079",633,503,499,2,4,"RECORTES CERO-GV",0
43,"43113",387,305,303,1,2,"RECORTES CERO-GV",1
50,"50168",29,20,20,0,0,"RECORTES CERO-GV",0
43,"43099",284,214,214,4,0,"RECORTES CERO-GV",0
33,"33071",546,385,383,7,2,"RECORTES CERO-GV",0
22,"22083",447,360,355,6,5,"RECORTES CERO-GV",0
12,"12060",434,366,360,1,6,"RECORTES CERO-GV",1
33,"33011",10563,5646,5578,92,68,"RECORTES CERO-GV",6
41,"41065",22527,14684,14463,205,221,"RECORTES CERO-GV",14
31,"31233",91,62,60,2,2,"RECORTES CERO-GV",0
12,"12087",26,16,16,0,0,"RECORTES CERO-GV",0
31,"31234",146,101,101,0,0,"RECORTES CERO-GV",0
25,"25002",465,324,323,4,1,"RECORTES CERO-GV",0
21,"21043",1853,1354,1325,23,29,"RECORTES CERO-GV",1
15,"15032",3430,2243,2197,12,46,"RECORTES CERO-GV",1
30,"30006",833,699,695,1,4,"RECORTES CERO-GV",0
39,"39049",304,198,195,2,3,"RECORTES CERO-GV",0
6,"6066",1708,1180,1171,6,9,"RECORTES CERO-GV",0
18,"18170",317,212,209,0,3,"RECORTES CERO-GV",0
27,"27034",1010,565,558,3,7,"RECORTES CERO-GV",0
21,"21044",18061,11170,11003,123,167,"RECORTES CERO-GV",7
6,"6112",379,295,293,0,2,"RECORTES CERO-GV",0
18,"18906",903,641,639,2,2,"RECORTES CERO-GV",0
46,"46177",4832,3592,3539,20,53,"RECORTES CERO-GV",13
8,"8123",19570,15378,15316,91,62,"RECORTES CERO-GV",20
50,"50009",97,61,61,1,0,"RECORTES CERO-GV",0
20,"20041",241,143,142,2,1,"RECORTES CERO-GV",0
1,"1043",2340,1487,1468,11,19,"RECORTES CERO-GV",4
31,"31198",36,30,30,0,0,"RECORTES CERO-GV",0
3,"3098",523,382,378,1,4,"RECORTES CERO-GV",2
4,"4051",404,323,319,2,4,"RECORTES CERO-GV",0
41,"41048",2195,1445,1400,13,45,"RECORTES CERO-GV",1
23,"23003",8639,6296,6226,41,70,"RECORTES CERO-GV",6
31,"31126",352,223,223,3,0,"RECORTES CERO-GV",0
8,"8262",6945,4649,4599,38,50,"RECORTES CERO-GV",1
10,"10025",377,308,299,3,9,"RECORTES CERO-GV",1
25,"25079",276,202,202,0,0,"RECORTES CERO-GV",0
38,"38025",7065,4657,4590,34,67,"RECORTES CERO-GV",6
20,"20043",1718,1189,1183,2,6,"RECORTES CERO-GV",1
18,"18072",655,452,445,4,7,"RECORTES CERO-GV",0
50,"50040",82,66,66,1,0,"RECORTES CERO-GV",0
50,"50280",290,220,216,1,4,"RECORTES CERO-GV",4
44,"44087",67,52,50,0,2,"RECORTES CERO-GV",0
44,"44231",35,30,30,0,0,"RECORTES CERO-GV",0
11,"11001",4360,2810,2744,32,66,"RECORTES CERO-GV",7
26,"26112",218,152,148,1,4,"RECORTES CERO-GV",0
10,"10149",432,284,280,2,4,"RECORTES CERO-GV",2
23,"23005",29876,20565,20268,254,297,"RECORTES CERO-GV",20
31,"31152",1255,826,817,8,9,"RECORTES CERO-GV",3
6,"6025",5083,3543,3469,28,74,"RECORTES CERO-GV",4
32,"32074",977,642,631,2,11,"RECORTES CERO-GV",1
31,"31018",426,287,283,2,4,"RECORTES CERO-GV",1
10,"10108",203,116,116,1,0,"RECORTES CERO-GV",0
43,"43146",40,32,32,0,0,"RECORTES CERO-GV",0
6,"6162",2885,2067,2032,19,35,"RECORTES CERO-GV",5
31,"31201",151450,105649,104976,1004,673,"RECORTES CERO-GV",289
44,"44221",386,307,304,1,3,"RECORTES CERO-GV",0
3,"3025",1304,944,934,4,10,"RECORTES CERO-GV",0
8,"8125",25583,18334,18225,122,109,"RECORTES CERO-GV",36
48,"48082",37358,25328,25167,125,161,"RECORTES CERO-GV",26
12,"12073",133,97,97,0,0,"RECORTES CERO-GV",1
11,"11036",683,401,395,15,6,"RECORTES CERO-GV",0
31,"31056",186,128,124,2,4,"RECORTES CERO-GV",0
8,"8241",70,52,52,0,0,"RECORTES CERO-GV",0
8,"8902",3941,2974,2962,16,12,"RECORTES CERO-GV",6
25,"25176",307,241,238,3,3,"RECORTES CERO-GV",0
50,"50239",63,46,45,1,1,"RECORTES CERO-GV",0
29,"29013",1613,1191,1154,9,37,"RECORTES CERO-GV",0
22,"22170",672,460,456,5,4,"RECORTES CERO-GV",3
43,"43095",2583,1864,1854,12,10,"RECORTES CERO-GV",3
43,"43068",484,322,317,2,5,"RECORTES CERO-GV",0
43,"43147",528,425,420,3,5,"RECORTES CERO-GV",0
12,"12074",756,611,601,3,10,"RECORTES CERO-GV",0
26,"26074",107,87,86,2,1,"RECORTES CERO-GV",0
46,"46021",24053,17331,17194,159,137,"RECORTES CERO-GV",26
6,"6028",4098,3457,3350,22,107,"RECORTES CERO-GV",3
20,"20076",7013,5011,4991,16,20,"RECORTES CERO-GV",2
29,"29079",2326,1609,1582,12,27,"RECORTES CERO-GV",0
31,"31265",76,43,40,0,3,"RECORTES CERO-GV",0
46,"46089",2182,1590,1576,9,14,"RECORTES CERO-GV",2
46,"46228",2426,1819,1802,19,17,"RECORTES CERO-GV",0
26,"26120",1441,1027,1011,11,16,"RECORTES CERO-GV",0
8,"8106",7500,5442,5410,43,32,"RECORTES CERO-GV",6
25,"25247",142,89,89,2,0,"RECORTES CERO-GV",0
25,"25175",173,119,119,2,0,"RECORTES CERO-GV",0
44,"44252",73,56,55,0,1,"RECORTES CERO-GV",0
8,"8289",4473,3379,3371,25,8,"RECORTES CERO-GV",6
21,"21050",12567,8522,8392,89,130,"RECORTES CERO-GV",10
12,"12125",215,179,179,2,0,"RECORTES CERO-GV",0
7,"7034",1074,796,779,9,17,"RECORTES CERO-GV",1
43,"43052",927,680,674,7,6,"RECORTES CERO-GV",1
18,"18015",424,331,330,4,1,"RECORTES CERO-GV",0
38,"38029",1475,752,744,10,8,"RECORTES CERO-GV",0
6,"6106",407,261,258,4,3,"RECORTES CERO-GV",0
50,"50207",87,58,58,1,0,"RECORTES CERO-GV",0
31,"31023",7778,5977,5948,106,29,"RECORTES CERO-GV",23
39,"39028",3892,2905,2878,20,27,"RECORTES CERO-GV",1
23,"23046",2334,1880,1855,9,25,"RECORTES CERO-GV",4
22,"22095",66,52,51,1,1,"RECORTES CERO-GV",0
48,"48058",947,682,679,2,3,"RECORTES CERO-GV",0
8,"8267",6789,4975,4935,41,40,"RECORTES CERO-GV",5
31,"31060",14323,9547,9434,79,113,"RECORTES CERO-GV",39
8,"8105",9741,6946,6896,62,50,"RECORTES CERO-GV",13
31,"31169",2203,1429,1415,15,14,"RECORTES CERO-GV",1
46,"46136",2598,1875,1851,14,24,"RECORTES CERO-GV",0
3,"3028",959,780,767,7,13,"RECORTES CERO-GV",1
17,"17001",575,428,426,4,2,"RECORTES CERO-GV",0
14,"14029",4001,2855,2821,30,34,"RECORTES CERO-GV",4
36,"36005",8105,5258,5152,54,106,"RECORTES CERO-GV",5
43,"43071",896,652,647,3,5,"RECORTES CERO-GV",0
32,"32007",1413,873,862,2,11,"RECORTES CERO-GV",0
41,"41082",3354,2545,2507,11,38,"RECORTES CERO-GV",0
29,"29044",749,477,473,1,4,"RECORTES CERO-GV",2
18,"18017",18201,11500,11358,94,142,"RECORTES CERO-GV",12
46,"46205",14237,10641,10533,77,108,"RECORTES CERO-GV",4
35,"35031",7456,4938,4868,39,70,"RECORTES CERO-GV",2
1,"1009",1258,839,833,2,6,"RECORTES CERO-GV",2
3,"3029",236,174,172,2,2,"RECORTES CERO-GV",0
39,"39039",540,355,355,1,0,"RECORTES CERO-GV",0
39,"39054",4541,3271,3252,30,19,"RECORTES CERO-GV",6
38,"38004",4536,2914,2887,28,27,"RECORTES CERO-GV",2
38,"38028",22144,14312,14174,89,138,"RECORTES CERO-GV",10
10,"10901",1161,758,753,1,5,"RECORTES CERO-GV",0
20,"20077",5269,3845,3830,9,15,"RECORTES CERO-GV",4
44,"44019",70,42,42,0,0,"RECORTES CERO-GV",0
31,"31123",615,350,347,4,3,"RECORTES CERO-GV",2
4,"4071",362,286,281,2,5,"RECORTES CERO-GV",0
20,"20040",15771,10549,10481,54,68,"RECORTES CERO-GV",14
17,"17171",177,138,137,0,1,"RECORTES CERO-GV",0
31,"31050",6016,3675,3612,41,63,"RECORTES CERO-GV",7
25,"25078",995,746,743,7,3,"RECORTES CERO-GV",1
18,"18094",2299,1712,1652,20,60,"RECORTES CERO-GV",0
44,"44198",182,138,135,0,3,"RECORTES CERO-GV",0
31,"31063",84,59,59,0,0,"RECORTES CERO-GV",0
17,"17115",276,208,208,4,0,"RECORTES CERO-GV",0
31,"31136",461,294,293,3,1,"RECORTES CERO-GV",1
46,"46047",540,428,420,1,8,"RECORTES CERO-GV",0
17,"17003",103,85,85,0,0,"RECORTES CERO-GV",0
10,"10036",304,194,192,4,2,"RECORTES CERO-GV",1
30,"30014",1587,1150,1134,4,16,"RECORTES CERO-GV",1
22,"22066",755,529,520,8,9,"RECORTES CERO-GV",2
8,"8177",36,27,27,1,0,"RECORTES CERO-GV",0
3,"3117",377,306,302,2,4,"RECORTES CERO-GV",0
10,"10159",314,207,207,2,0,"RECORTES CERO-GV",0
39,"39059",7518,5327,5287,23,40,"RECORTES CERO-GV",3
46,"46207",6761,4966,4909,46,57,"RECORTES CERO-GV",3
3,"3089",9496,6617,6484,51,133,"RECORTES CERO-GV",3
29,"29047",1082,860,846,0,14,"RECORTES CERO-GV",0
4,"4073",327,224,223,0,1,"RECORTES CERO-GV",0
44,"44142",29,21,21,0,0,"RECORTES CERO-GV",0
33,"33022",802,460,452,4,8,"RECORTES CERO-GV",0
50,"50244",192,131,130,1,1,"RECORTES CERO-GV",0
14,"14004",1963,1465,1437,15,28,"RECORTES CERO-GV",0
8,"8270",19014,13635,13594,74,41,"RECORTES CERO-GV",21
6,"6129",577,438,416,1,22,"RECORTES CERO-GV",2
10,"10038",83,59,59,0,0,"RECORTES CERO-GV",0
31,"31175",66,46,46,0,0,"RECORTES CERO-GV",0
46,"46185",361,301,299,5,2,"RECORTES CERO-GV",0
17,"17170",173,140,140,2,0,"RECORTES CERO-GV",0
32,"32057",505,334,328,3,6,"RECORTES CERO-GV",0
23,"23085",2171,1587,1575,7,12,"RECORTES CERO-GV",2
46,"46145",22215,15688,15538,127,150,"RECORTES CERO-GV",10
4,"4093",1916,1143,1130,5,13,"RECORTES CERO-GV",0
22,"22049",73,62,62,0,0,"RECORTES CERO-GV",0
39,"39015",828,559,556,3,3,"RECORTES CERO-GV",1
31,"31042",2707,1926,1900,11,26,"RECORTES CERO-GV",3
22,"22059",1135,765,752,2,13,"RECORTES CERO-GV",1
10,"10122",219,159,157,2,2,"RECORTES CERO-GV",1
41,"41003",2373,1747,1708,18,39,"RECORTES CERO-GV",2
43,"43024",1545,1019,1014,14,5,"RECORTES CERO-GV",2
29,"29021",155,111,109,1,2,"RECORTES CERO-GV",0
32,"32087",1669,1158,1136,14,22,"RECORTES CERO-GV",2
8,"8271",66,48,47,2,1,"RECORTES CERO-GV",0
3,"3034",1404,1028,1010,5,18,"RECORTES CERO-GV",0
18,"18022",13875,8948,8764,98,184,"RECORTES CERO-GV",12
44,"44115",102,91,91,0,0,"RECORTES CERO-GV",0
39,"39062",1864,1395,1376,3,19,"RECORTES CERO-GV",0
8,"8203",2466,1678,1675,7,3,"RECORTES CERO-GV",2
6,"6132",823,543,533,4,10,"RECORTES CERO-GV",0
29,"29050",392,229,227,3,2,"RECORTES CERO-GV",0
39,"39034",255,133,128,2,5,"RECORTES CERO-GV",0
44,"44023",18,15,14,0,1,"RECORTES CERO-GV",0
50,"50221",29,18,18,0,0,"RECORTES CERO-GV",0
3,"3092",6712,4924,4858,35,66,"RECORTES CERO-GV",4
8,"8088",12347,9316,9270,75,46,"RECORTES CERO-GV",11
50,"50121",270,209,208,3,1,"RECORTES CERO-GV",0
15,"15047",2256,1429,1405,25,24,"RECORTES CERO-GV",0
25,"25006",319,229,229,2,0,"RECORTES CERO-GV",0
8,"8007",6795,5099,5081,29,18,"RECORTES CERO-GV",3
4,"4077",296,270,268,3,2,"RECORTES CERO-GV",0
25,"25156",765,571,567,3,4,"RECORTES CERO-GV",0
29,"29023",2330,1441,1429,11,12,"RECORTES CERO-GV",1
39,"39091",1881,1297,1291,8,6,"RECORTES CERO-GV",1
35,"35020",5941,3740,3702,27,38,"RECORTES CERO-GV",1
48,"48093",891,669,666,5,3,"RECORTES CERO-GV",1
20,"20056",4077,2796,2781,12,15,"RECORTES CERO-GV",2
36,"36002",3049,1994,1968,22,26,"RECORTES CERO-GV",3
41,"41089",6621,4650,4549,64,101,"RECORTES CERO-GV",6
20,"20026",207,172,171,4,1,"RECORTES CERO-GV",0
43,"43154",126,104,104,0,0,"RECORTES CERO-GV",0
31,"31070",2633,1714,1682,16,32,"RECORTES CERO-GV",5
18,"18144",816,592,582,3,10,"RECORTES CERO-GV",2
10,"10125",859,561,546,3,15,"RECORTES CERO-GV",0
25,"25098",227,160,158,1,2,"RECORTES CERO-GV",0
33,"33026",8201,5014,4974,74,40,"RECORTES CERO-GV",4
8,"8134",848,618,609,4,9,"RECORTES CERO-GV",1
8,"8288",1696,1103,1096,9,7,"RECORTES CERO-GV",0
17,"17150",1444,1177,1163,13,14,"RECORTES CERO-GV",1
50,"50079",226,162,160,1,2,"RECORTES CERO-GV",0
3,"3037",340,261,255,3,6,"RECORTES CERO-GV",0
31,"31034",31,24,24,0,0,"RECORTES CERO-GV",0
10,"10208",122,85,83,0,2,"RECORTES CERO-GV",0
8,"8089",34190,24548,24404,194,144,"RECORTES CERO-GV",45
44,"44205",619,420,415,5,5,"RECORTES CERO-GV",0
38,"38013",3011,1850,1829,14,21,"RECORTES CERO-GV",1
22,"22044",234,166,164,1,2,"RECORTES CERO-GV",0
21,"21031",1166,773,736,11,37,"RECORTES CERO-GV",1
22,"22012",102,75,75,2,0,"RECORTES CERO-GV",0
15,"15081",976,713,695,4,18,"RECORTES CERO-GV",0
10,"10127",4691,3044,2974,34,70,"RECORTES CERO-GV",5
48,"48095",2324,1568,1555,13,13,"RECORTES CERO-GV",0
25,"25099",1285,908,904,6,4,"RECORTES CERO-GV",0
6,"6001",664,474,460,3,14,"RECORTES CERO-GV",2
32,"32055",1216,781,764,10,17,"RECORTES CERO-GV",0
31,"31181",133,87,84,1,3,"RECORTES CERO-GV",0
46,"46212",1620,1130,1112,12,18,"RECORTES CERO-GV",3
17,"17009",4068,3061,3050,16,11,"RECORTES CERO-GV",2
33,"33028",1143,519,518,7,1,"RECORTES CERO-GV",1
18,"18089",14504,9854,9746,100,108,"RECORTES CERO-GV",7
3,"3010",332,275,268,1,7,"RECORTES CERO-GV",0
32,"32056",1490,1009,1003,10,6,"RECORTES CERO-GV",0
43,"43080",230,192,192,2,0,"RECORTES CERO-GV",1
25,"25038",1478,1057,1048,10,9,"RECORTES CERO-GV",1
50,"50225",1532,983,971,12,12,"RECORTES CERO-GV",0
50,"50250",54,44,44,2,0,"RECORTES CERO-GV",0
48,"48096",6516,4862,4816,33,46,"RECORTES CERO-GV",2
32,"32020",2428,1728,1714,10,14,"RECORTES CERO-GV",0
8,"8176",158,119,119,0,0,"RECORTES CERO-GV",0
39,"39086",358,236,235,2,1,"RECORTES CERO-GV",0
44,"44025",5804,4024,3991,11,33,"RECORTES CERO-GV",0
8,"8253",132,103,102,0,1,"RECORTES CERO-GV",0
8,"8268",975,729,723,6,6,"RECORTES CERO-GV",0
50,"50089",8616,6420,6364,50,56,"RECORTES CERO-GV",12
22,"22023",385,293,283,2,10,"RECORTES CERO-GV",0
33,"33020",12981,8550,8453,120,97,"RECORTES CERO-GV",16
31,"31038",1343,975,963,16,12,"RECORTES CERO-GV",3
30,"30022",17108,11041,10851,100,190,"RECORTES CERO-GV",11
31,"31258",7879,5668,5631,50,37,"RECORTES CERO-GV",15
3,"3040",264,227,221,1,6,"RECORTES CERO-GV",0
25,"25040",10651,7041,6987,57,54,"RECORTES CERO-GV",2
44,"44217",32,25,25,0,0,"RECORTES CERO-GV",0
18,"18124",355,232,231,1,1,"RECORTES CERO-GV",0
44,"44150",28,17,17,0,0,"RECORTES CERO-GV",0
21,"21064",6674,4503,4426,68,77,"RECORTES CERO-GV",4
27,"27055",1191,773,764,7,9,"RECORTES CERO-GV",0
4,"4083",1727,1265,1250,8,15,"RECORTES CERO-GV",3
8,"8011",1739,1360,1353,10,7,"RECORTES CERO-GV",0
43,"43056",803,566,558,6,8,"RECORTES CERO-GV",0
12,"12088",57,53,53,0,0,"RECORTES CERO-GV",0
7,"7050",3513,2036,2013,25,23,"RECORTES CERO-GV",4
10,"10050",987,707,704,4,3,"RECORTES CERO-GV",0
18,"18126",1436,1024,1002,9,22,"RECORTES CERO-GV",1
32,"32023",1130,787,782,2,5,"RECORTES CERO-GV",0
25,"25012",2349,1563,1556,17,7,"RECORTES CERO-GV",0
6,"6006",4479,2991,2934,27,57,"RECORTES CERO-GV",4
50,"50050",87,62,62,1,0,"RECORTES CERO-GV",0
15,"15085",3176,2073,2047,29,26,"RECORTES CERO-GV",3
20,"20062",941,688,683,1,5,"RECORTES CERO-GV",0
8,"8070",269,215,211,1,4,"RECORTES CERO-GV",0
27,"27056",1218,787,778,6,9,"RECORTES CERO-GV",1
50,"50100",304,215,212,1,3,"RECORTES CERO-GV",0
8,"8277",168,148,146,1,2,"RECORTES CERO-GV",0
3,"3069",3329,2102,2077,11,25,"RECORTES CERO-GV",2
15,"15023",6277,4021,3968,34,53,"RECORTES CERO-GV",3
3,"3128",4285,2849,2819,18,30,"RECORTES CERO-GV",1
6,"6054",5452,3773,3657,34,116,"RECORTES CERO-GV",6
1,"1028",1091,735,728,5,7,"RECORTES CERO-GV",2
50,"50269",287,172,167,2,5,"RECORTES CERO-GV",0
46,"46255",3220,2361,2340,20,21,"RECORTES CERO-GV",2
30,"30016",153034,101232,100202,776,1030,"RECORTES CERO-GV",209
7,"7041",2090,1454,1434,17,20,"RECORTES CERO-GV",1
14,"14015",2045,1465,1418,16,47,"RECORTES CERO-GV",1
11,"11024",6550,4500,4402,67,98,"RECORTES CERO-GV",1
18,"18107",920,643,626,1,17,"RECORTES CERO-GV",0
44,"44192",341,274,272,2,2,"RECORTES CERO-GV",0
17,"17070",110,87,87,0,0,"RECORTES CERO-GV",0
17,"17062",5982,4025,4001,19,24,"RECORTES CERO-GV",3
18,"18162",919,664,652,3,12,"RECORTES CERO-GV",1
31,"31262",234,190,188,0,2,"RECORTES CERO-GV",1
3,"3043",2906,2360,2334,27,26,"RECORTES CERO-GV",2
18,"18128",332,263,260,1,3,"RECORTES CERO-GV",0
44,"44239",21,19,19,0,0,"RECORTES CERO-GV",0
39,"39043",1517,1167,1154,3,13,"RECORTES CERO-GV",2
30,"30001",4507,3357,3331,17,26,"RECORTES CERO-GV",0
10,"10013",265,184,182,0,2,"RECORTES CERO-GV",0
6,"6147",329,234,234,1,0,"RECORTES CERO-GV",0
50,"50254",179,115,113,0,2,"RECORTES CERO-GV",0
26,"26178",72,56,56,1,0,"RECORTES CERO-GV",0
15,"15056",5615,3697,3646,31,51,"RECORTES CERO-GV",6
10,"10054",523,389,380,1,9,"RECORTES CERO-GV",0
46,"46057",463,308,304,1,4,"RECORTES CERO-GV",0
46,"46126",5580,4361,4328,36,33,"RECORTES CERO-GV",3
48,"48018",854,563,560,5,3,"RECORTES CERO-GV",0
46,"46035",6828,5155,5089,33,66,"RECORTES CERO-GV",7
43,"43085",237,190,185,1,5,"RECORTES CERO-GV",0
18,"18034",484,345,342,3,3,"RECORTES CERO-GV",0
20,"20065",2921,1983,1970,16,13,"RECORTES CERO-GV",4
39,"39072",325,184,182,0,2,"RECORTES CERO-GV",0
8,"8050",139,118,115,4,3,"RECORTES CERO-GV",0
35,"35005",1009,680,668,2,12,"RECORTES CERO-GV",0
30,"30002",9701,6794,6717,27,77,"RECORTES CERO-GV",1
6,"6012",3231,2306,2278,25,28,"RECORTES CERO-GV",2
8,"8141",4578,3369,3357,28,12,"RECORTES CERO-GV",1
25,"25105",105,88,87,4,1,"RECORTES CERO-GV",0
26,"26063",118,88,88,2,0,"RECORTES CERO-GV",0
22,"22072",197,127,126,1,1,"RECORTES CERO-GV",0
14,"14045",2997,2329,2287,30,42,"RECORTES CERO-GV",2
18,"18099",1582,1184,1156,13,28,"RECORTES CERO-GV",0
14,"14017",10953,7929,7791,84,138,"RECORTES CERO-GV",8
8,"8189",119,96,96,1,0,"RECORTES CERO-GV",0
18,"18087",182877,131811,130184,1106,1627,"RECORTES CERO-GV",168
22,"22020",115,83,80,3,3,"RECORTES CERO-GV",0
8,"8165",1680,1177,1171,7,6,"RECORTES CERO-GV",2
23,"23067",2405,1765,1724,14,41,"RECORTES CERO-GV",5
31,"31083",49,39,39,1,0,"RECORTES CERO-GV",0
17,"17177",562,426,423,1,3,"RECORTES CERO-GV",0
8,"8266",43422,32827,32696,241,131,"RECORTES CERO-GV",39
41,"41080",1231,832,815,14,17,"RECORTES CERO-GV",2
17,"17075",340,257,256,2,1,"RECORTES CERO-GV",0
30,"30003",25200,16249,16120,159,129,"RECORTES CERO-GV",15
44,"44184",44,37,37,0,0,"RECORTES CERO-GV",0
12,"12011",4583,3228,3177,24,51,"RECORTES CERO-GV",6
39,"39018",4284,3211,3177,22,34,"RECORTES CERO-GV",5
25,"25138",558,427,424,2,3,"RECORTES CERO-GV",0
15,"15091",1097,705,686,17,19,"RECORTES CERO-GV",1
6,"6061",1074,829,819,5,10,"RECORTES CERO-GV",2
36,"36026",19890,13041,12891,169,150,"RECORTES CERO-GV",19
44,"44127",57,43,43,0,0,"RECORTES CERO-GV",0
43,"43089",279,201,201,1,0,"RECORTES CERO-GV",0
23,"23070",3813,2384,2354,11,30,"RECORTES CERO-GV",0
50,"50056",399,296,296,3,0,"RECORTES CERO-GV",0
10,"10100",783,494,447,5,47,"RECORTES CERO-GV",1
21,"21071",206,148,144,4,4,"RECORTES CERO-GV",0
26,"26029",34,26,26,1,0,"RECORTES CERO-GV",0
41,"41016",7820,5523,5407,57,116,"RECORTES CERO-GV",11
22,"22084",571,400,391,5,9,"RECORTES CERO-GV",0
31,"31084",1946,1367,1362,9,5,"RECORTES CERO-GV",0
26,"26144",187,147,143,1,4,"RECORTES CERO-GV",0
17,"17188",171,134,134,1,0,"RECORTES CERO-GV",0
6,"6154",2799,1851,1782,20,69,"RECORTES CERO-GV",1
3,"3047",9768,6220,6144,41,76,"RECORTES CERO-GV",12
3,"3134",139,107,107,0,0,"RECORTES CERO-GV",0
8,"8075",4144,2951,2943,20,8,"RECORTES CERO-GV",5
8,"8214",7007,5390,5371,25,19,"RECORTES CERO-GV",6
17,"17102",556,398,396,1,2,"RECORTES CERO-GV",0
14,"14048",1199,883,866,4,17,"RECORTES CERO-GV",0
39,"39066",866,616,606,6,10,"RECORTES CERO-GV",0
10,"10047",938,710,694,1,16,"RECORTES CERO-GV",3
22,"22013",271,200,197,3,3,"RECORTES CERO-GV",0
25,"25181",172,137,137,1,0,"RECORTES CERO-GV",0
43,"43002",1890,1233,1210,12,23,"RECORTES CERO-GV",4
44,"44267",70,47,46,0,1,"RECORTES CERO-GV",0
21,"21053",3306,2161,2106,11,55,"RECORTES CERO-GV",1
50,"50235",2421,1721,1702,18,19,"RECORTES CERO-GV",2
12,"12070",505,407,398,2,9,"RECORTES CERO-GV",1
23,"23038",3786,2934,2900,21,34,"RECORTES CERO-GV",4
44,"44066",85,62,62,0,0,"RECORTES CERO-GV",0
31,"31160",104,83,82,1,1,"RECORTES CERO-GV",0
8,"8077",34690,25896,25767,164,129,"RECORTES CERO-GV",44
6,"6141",1678,1183,1158,15,25,"RECORTES CERO-GV",1
50,"50259",82,55,55,2,0,"RECORTES CERO-GV",0
17,"17103",5057,3196,3174,21,22,"RECORTES CERO-GV",7
43,"43091",125,90,90,1,0,"RECORTES CERO-GV",0
46,"46062",4552,3402,3362,27,40,"RECORTES CERO-GV",1
8,"8193",988,739,737,10,2,"RECORTES CERO-GV",1
43,"43143",50,40,39,0,1,"RECORTES CERO-GV",0
31,"31051",241,169,167,3,2,"RECORTES CERO-GV",0
26,"26032",43,36,35,0,1,"RECORTES CERO-GV",0
43,"43170",877,664,661,4,3,"RECORTES CERO-GV",1
14,"14050",2350,1774,1720,20,54,"RECORTES CERO-GV",0
50,"50033",61,44,44,1,0,"RECORTES CERO-GV",0
18,"18039",3343,2293,2252,22,41,"RECORTES CERO-GV",2
17,"17190",834,624,619,1,5,"RECORTES CERO-GV",0
22,"22087",60,46,46,0,0,"RECORTES CERO-GV",0
44,"44067",106,75,71,0,4,"RECORTES CERO-GV",0
50,"50109",95,65,62,2,3,"RECORTES CERO-GV",0
7,"7062",7972,3946,3896,42,50,"RECORTES CERO-GV",8
26,"26149",42,34,34,0,0,"RECORTES CERO-GV",0
50,"50297",503800,365284,362768,3385,2516,"RECORTES CERO-GV",651
3,"3050",19420,13210,13116,70,94,"RECORTES CERO-GV",18
50,"50110",340,248,238,1,10,"RECORTES CERO-GV",0
8,"8217",25466,19864,19773,129,91,"RECORTES CERO-GV",34
50,"50261",201,154,151,0,3,"RECORTES CERO-GV",0
17,"17106",142,114,114,0,0,"RECORTES CERO-GV",0
18,"18040",237,146,145,0,1,"RECORTES CERO-GV",0
30,"30032",2864,2154,2129,18,25,"RECORTES CERO-GV",1
44,"44219",173,118,115,1,3,"RECORTES CERO-GV",0
8,"8063",469,390,390,4,0,"RECORTES CERO-GV",0
41,"41021",21410,14369,14139,195,230,"RECORTES CERO-GV",23
3,"3079",18422,13560,13378,152,182,"RECORTES CERO-GV",23
41,"41012",3375,2259,2214,26,45,"RECORTES CERO-GV",1
27,"27027",1791,1198,1167,17,31,"RECORTES CERO-GV",1
46,"46095",580,445,438,5,7,"RECORTES CERO-GV",1
8,"8087",144,120,120,0,0,"RECORTES CERO-GV",0
36,"36053",5783,3955,3899,39,56,"RECORTES CERO-GV",6
8,"8195",75,62,62,0,0,"RECORTES CERO-GV",0
31,"31091",322,201,201,3,0,"RECORTES CERO-GV",0
50,"50011",117,90,89,3,1,"RECORTES CERO-GV",0
18,"18106",413,270,261,3,9,"RECORTES CERO-GV",0
43,"43067",526,426,424,3,2,"RECORTES CERO-GV",0
1,"1001",2020,1385,1372,5,13,"RECORTES CERO-GV",4
46,"46224",156,125,124,0,1,"RECORTES CERO-GV",0
20,"20014",1161,699,693,0,6,"RECORTES CERO-GV",0
26,"26072",287,239,235,3,4,"RECORTES CERO-GV",0
10,"10067",10210,7090,6946,62,144,"RECORTES CERO-GV",8
3,"3052",959,747,735,4,12,"RECORTES CERO-GV",0
4,"4098",1424,890,885,0,5,"RECORTES CERO-GV",0
14,"14053",5918,4054,3968,92,86,"RECORTES CERO-GV",2
41,"41022",4255,2735,2667,32,68,"RECORTES CERO-GV",1
6,"6026",804,578,562,5,16,"RECORTES CERO-GV",0
25,"25118",326,223,218,0,5,"RECORTES CERO-GV",0
3,"3140",26036,18637,18267,237,370,"RECORTES CERO-GV",11
44,"44250",20,15,15,0,0,"RECORTES CERO-GV",0
10,"10028",83,62,61,1,1,"RECORTES CERO-GV",0
48,"48027",22745,16240,16158,74,82,"RECORTES CERO-GV",20
18,"18076",789,534,532,2,2,"RECORTES CERO-GV",0
26,"26153",10,10,10,1,0,"RECORTES CERO-GV",0
18,"18044",161,91,91,0,0,"RECORTES CERO-GV",0
46,"46252",125,89,86,1,3,"RECORTES CERO-GV",0
20,"20046",1243,822,816,1,6,"RECORTES CERO-GV",0
10,"10192",777,567,563,3,4,"RECORTES CERO-GV",0
44,"44251",239,187,183,1,4,"RECORTES CERO-GV",0
15,"15006",5159,3008,2960,44,48,"RECORTES CERO-GV",3
22,"22158",11994,8115,8049,79,66,"RECORTES CERO-GV",13
26,"26002",821,611,597,1,14,"RECORTES CERO-GV",0
50,"50165",1768,1255,1222,20,33,"RECORTES CERO-GV",5
10,"10193",1392,1045,1025,6,20,"RECORTES CERO-GV",0
30,"30011",4702,3390,3324,8,66,"RECORTES CERO-GV",1
12,"12018",279,233,231,3,2,"RECORTES CERO-GV",0
43,"43043",3317,2457,2445,12,12,"RECORTES CERO-GV",2
6,"6075",470,363,360,7,3,"RECORTES CERO-GV",0
12,"12048",243,159,155,4,4,"RECORTES CERO-GV",0
7,"7001",3647,2430,2383,26,47,"RECORTES CERO-GV",6
33,"33046",480,334,329,0,5,"RECORTES CERO-GV",0
10,"10018",1605,974,948,16,26,"RECORTES CERO-GV",2
41,"41006",2733,1776,1742,17,34,"RECORTES CERO-GV",0
14,"14055",18411,13054,12798,192,256,"RECORTES CERO-GV",10
36,"36036",2546,1763,1742,14,21,"RECORTES CERO-GV",1
25,"25210",1073,791,780,3,11,"RECORTES CERO-GV",1
50,"50215",20,14,14,0,0,"RECORTES CERO-GV",0
22,"22244",42,33,32,1,1,"RECORTES CERO-GV",0
29,"29089",3138,2262,2186,13,76,"RECORTES CERO-GV",0
33,"33074",3366,2042,2011,35,31,"RECORTES CERO-GV",1
18,"18078",714,546,538,5,8,"RECORTES CERO-GV",0
17,"17142",2713,2166,2159,18,7,"RECORTES CERO-GV",2
22,"22001",212,147,146,0,1,"RECORTES CERO-GV",0
14,"14056",23477,15826,15470,177,356,"RECORTES CERO-GV",8
50,"50167",208,166,163,1,3,"RECORTES CERO-GV",0
18,"18145",10909,7925,7780,67,145,"RECORTES CERO-GV",6
12,"12126",24374,17741,17553,111,188,"RECORTES CERO-GV",12
31,"31133",34,27,27,1,0,"RECORTES CERO-GV",0
1,"1053",596,364,362,1,2,"RECORTES CERO-GV",0
38,"38005",5646,3302,3283,24,19,"RECORTES CERO-GV",3
48,"48030",591,449,447,2,2,"RECORTES CERO-GV",0
12,"12102",518,424,417,4,7,"RECORTES CERO-GV",1
43,"43098",362,274,274,1,0,"RECORTES CERO-GV",0
23,"23047",1558,1203,1186,8,17,"RECORTES CERO-GV",0
31,"31097",10559,6977,6919,71,58,"RECORTES CERO-GV",16
39,"39001",2063,1474,1467,5,7,"RECORTES CERO-GV",0
20,"20079",18151,13106,13054,58,52,"RECORTES CERO-GV",6
22,"22035",225,153,152,1,1,"RECORTES CERO-GV",0
38,"38006",41593,20823,20624,127,199,"RECORTES CERO-GV",26
44,"44077",68,52,51,0,1,"RECORTES CERO-GV",0
18,"18047",6103,3992,3922,61,70,"RECORTES CERO-GV",4
46,"46160",1922,1395,1381,4,14,"RECORTES CERO-GV",2
39,"39048",1772,1311,1295,8,16,"RECORTES CERO-GV",2
14,"14039",2577,1858,1801,29,57,"RECORTES CERO-GV",3
23,"23048",817,605,599,4,6,"RECORTES CERO-GV",1
4,"4001",1002,717,710,3,7,"RECORTES CERO-GV",0
36,"36028",4049,2783,2739,22,44,"RECORTES CERO-GV",4
41,"41100",954,670,635,7,35,"RECORTES CERO-GV",0
3,"3058",4976,3733,3669,20,64,"RECORTES CERO-GV",1
12,"12022",323,257,254,5,3,"RECORTES CERO-GV",0
44,"44258",53,46,46,0,0,"RECORTES CERO-GV",0
26,"26043",346,243,235,2,8,"RECORTES CERO-GV",0
31,"31062",1070,778,770,10,8,"RECORTES CERO-GV",1
50,"50057",1331,933,922,10,11,"RECORTES CERO-GV",1
8,"8153",573,457,452,3,5,"RECORTES CERO-GV",0
18,"18915",726,474,467,4,7,"RECORTES CERO-GV",0
17,"17198",437,307,306,0,1,"RECORTES CERO-GV",0
8,"8107",11965,8604,8554,67,50,"RECORTES CERO-GV",20
39,"39058",806,556,554,2,2,"RECORTES CERO-GV",0
46,"46138",361,289,287,1,2,"RECORTES CERO-GV",0
8,"8084",1172,902,894,9,8,"RECORTES CERO-GV",0
44,"44169",298,216,216,0,0,"RECORTES CERO-GV",0
41,"41101",6025,4299,4213,53,86,"RECORTES CERO-GV",1
41,"41028",2108,1652,1632,22,20,"RECORTES CERO-GV",4
4,"4002",1013,711,699,1,12,"RECORTES CERO-GV",0
12,"12104",6843,5181,5111,32,70,"RECORTES CERO-GV",3
1,"1011",213,162,160,3,2,"RECORTES CERO-GV",0
17,"17031",178,117,117,0,0,"RECORTES CERO-GV",0
39,"39087",41241,29341,29084,152,257,"RECORTES CERO-GV",25
30,"30015",19344,13502,13347,107,155,"RECORTES CERO-GV",9
23,"23015",1316,979,973,18,6,"RECORTES CERO-GV",0
26,"26046",1552,1056,1027,11,29,"RECORTES CERO-GV",0
26,"26045",11,10,10,1,0,"RECORTES CERO-GV",0
22,"22214",117,92,89,0,3,"RECORTES CERO-GV",0
41,"41029",13520,9849,9663,134,186,"RECORTES CERO-GV",15
23,"23051",2736,2066,2021,16,45,"RECORTES CERO-GV",3
7,"7007",416,277,275,4,2,"RECORTES CERO-GV",1
10,"10079",848,641,632,2,9,"RECORTES CERO-GV",0
30,"30040",686,564,560,1,4,"RECORTES CERO-GV",1
15,"15075",12871,8751,8637,129,114,"RECORTES CERO-GV",12
50,"50195",53,42,38,0,4,"RECORTES CERO-GV",0
50,"50042",19,17,17,1,0,"RECORTES CERO-GV",0
11,"11902",3664,2123,2094,46,29,"RECORTES CERO-GV",3
43,"43101",146,112,112,2,0,"RECORTES CERO-GV",0
15,"15044",1194,806,788,7,18,"RECORTES CERO-GV",2
36,"36009",4401,2712,2649,33,63,"RECORTES CERO-GV",2
18,"18002",529,387,384,1,3,"RECORTES CERO-GV",0
18,"18064",366,289,286,0,3,"RECORTES CERO-GV",0
6,"6100",845,626,624,2,2,"RECORTES CERO-GV",0
12,"12016",1549,1244,1234,9,10,"RECORTES CERO-GV",1
50,"50246",37,24,24,0,0,"RECORTES CERO-GV",0
50,"50093",87,66,64,1,2,"RECORTES CERO-GV",0
36,"36042",18125,11975,11775,126,200,"RECORTES CERO-GV",23
46,"46072",3522,2792,2741,25,51,"RECORTES CERO-GV",0
8,"8225",94,83,82,1,1,"RECORTES CERO-GV",0
31,"31140",112,73,73,1,0,"RECORTES CERO-GV",1
44,"44173",103,81,79,0,2,"RECORTES CERO-GV",0
15,"15077",8103,4893,4818,61,75,"RECORTES CERO-GV",8
46,"46004",1932,1530,1512,10,18,"RECORTES CERO-GV",2
32,"32014",1028,719,708,6,11,"RECORTES CERO-GV",0
43,"43903",2332,1502,1487,18,15,"RECORTES CERO-GV",3
26,"26166",144,125,124,0,1,"RECORTES CERO-GV",0
14,"14062",945,700,693,2,7,"RECORTES CERO-GV",0
10,"10082",1793,1333,1305,11,28,"RECORTES CERO-GV",2
17,"17089",5749,3973,3949,17,24,"RECORTES CERO-GV",3
27,"27049",1324,847,829,8,18,"RECORTES CERO-GV",0
8,"8110",13671,9362,9311,60,51,"RECORTES CERO-GV",16
41,"41004",57692,38578,37814,696,764,"RECORTES CERO-GV",59
4,"4006",7192,4389,4335,39,54,"RECORTES CERO-GV",1
8,"8180",27198,19822,19704,160,118,"RECORTES CERO-GV",35
1,"1017",817,537,532,3,5,"RECORTES CERO-GV",1
44,"44263",373,267,267,2,0,"RECORTES CERO-GV",0
44,"44086",410,302,298,3,4,"RECORTES CERO-GV",0
23,"23055",46314,30950,30506,279,444,"RECORTES CERO-GV",32
17,"17175",559,348,343,5,5,"RECORTES CERO-GV",0
26,"26013",330,243,242,2,1,"RECORTES CERO-GV",0
17,"17063",179,153,149,0,4,"RECORTES CERO-GV",0
50,"50247",852,600,594,8,6,"RECORTES CERO-GV",0
1,"1018",1399,953,947,1,6,"RECORTES CERO-GV",1
39,"39007",386,265,264,0,1,"RECORTES CERO-GV",0
10,"10206",196,135,133,0,2,"RECORTES CERO-GV",0
46,"46097",948,670,663,1,7,"RECORTES CERO-GV",1
22,"22009",581,387,386,7,1,"RECORTES CERO-GV",2
6,"6044",29258,19865,19594,205,271,"RECORTES CERO-GV",32
17,"17064",324,249,247,2,2,"RECORTES CERO-GV",0
6,"6135",1101,860,849,2,11,"RECORTES CERO-GV",1
44,"44146",164,133,133,2,0,"RECORTES CERO-GV",0
22,"22220",147,106,105,1,1,"RECORTES CERO-GV",1
32,"32054",86117,56997,56376,581,621,"RECORTES CERO-GV",74
39,"39008",13900,9814,9734,63,80,"RECORTES CERO-GV",6
44,"44017",269,217,216,0,1,"RECORTES CERO-GV",0
17,"17195",338,274,272,1,2,"RECORTES CERO-GV",0
39,"39092",863,534,533,3,1,"RECORTES CERO-GV",0
25,"25037",361,270,269,4,1,"RECORTES CERO-GV",0
15,"15049",1068,752,747,7,5,"RECORTES CERO-GV",0
1,"1020",323,228,224,1,4,"RECORTES CERO-GV",1
43,"43027",168,129,129,3,0,"RECORTES CERO-GV",0
18,"18153",8834,6174,6063,54,111,"RECORTES CERO-GV",7
29,"29070",43686,27672,27323,290,349,"RECORTES CERO-GV",53
39,"39009",3325,2306,2293,7,13,"RECORTES CERO-GV",1
39,"39093",297,216,214,1,2,"RECORTES CERO-GV",0
29,"29099",969,688,669,11,19,"RECORTES CERO-GV",0
29,"29025",41540,27170,26897,271,273,"RECORTES CERO-GV",43
43,"43906",2113,1490,1480,12,10,"RECORTES CERO-GV",0
31,"31217",327,204,196,1,8,"RECORTES CERO-GV",0
25,"25222",69,58,58,0,0,"RECORTES CERO-GV",0
43,"43106",784,605,598,3,7,"RECORTES CERO-GV",2
26,"26092",104,82,81,3,1,"RECORTES CERO-GV",1
46,"46007",12333,8890,8803,79,87,"RECORTES CERO-GV",10
10,"10168",320,210,206,1,4,"RECORTES CERO-GV",0
25,"25009",596,448,442,1,6,"RECORTES CERO-GV",0
1,"1021",471,321,319,3,2,"RECORTES CERO-GV",0
26,"26054",291,225,223,3,2,"RECORTES CERO-GV",0
17,"17178",1065,774,771,9,3,"RECORTES CERO-GV",0
22,"22187",288,220,220,2,0,"RECORTES CERO-GV",1
26,"26171",155,109,107,2,2,"RECORTES CERO-GV",0
44,"44054",95,82,81,0,1,"RECORTES CERO-GV",0
44,"44148",74,56,54,0,2,"RECORTES CERO-GV",0
3,"3066",41762,28723,28388,358,335,"RECORTES CERO-GV",34
17,"17037",112,86,86,1,0,"RECORTES CERO-GV",0
23,"23059",5736,4245,4119,51,126,"RECORTES CERO-GV",3
33,"33057",1525,1005,988,17,17,"RECORTES CERO-GV",3
14,"14002",10895,7599,7479,109,120,"RECORTES CERO-GV",8
21,"21022",187,121,116,0,5,"RECORTES CERO-GV",0
50,"50275",111,50,50,0,0,"RECORTES CERO-GV",0
4,"4012",184,151,150,3,1,"RECORTES CERO-GV",0
32,"32045",2346,1604,1579,20,25,"RECORTES CERO-GV",1
21,"21002",16070,11301,11137,132,164,"RECORTES CERO-GV",25
17,"17124",1593,1163,1160,8,3,"RECORTES CERO-GV",0
17,"17011",645,518,514,10,4,"RECORTES CERO-GV",0
46,"46263",235,182,180,2,2,"RECORTES CERO-GV",0
22,"22077",362,280,272,5,8,"RECORTES CERO-GV",0
15,"15020",3568,2226,2217,19,9,"RECORTES CERO-GV",0
35,"35024",14323,8360,8289,81,71,"RECORTES CERO-GV",4
17,"17095",20044,12638,12576,88,62,"RECORTES CERO-GV",9
21,"21003",684,476,452,4,24,"RECORTES CERO-GV",0
46,"46077",7338,5447,5356,44,91,"RECORTES CERO-GV",7
6,"6050",4031,3005,2934,38,71,"RECORTES CERO-GV",5
8,"8231",21269,14655,14573,111,82,"RECORTES CERO-GV",25
1,"1023",262,193,190,1,3,"RECORTES CERO-GV",0
25,"25224",122,94,94,0,0,"RECORTES CERO-GV",0
10,"10091",351,275,271,2,4,"RECORTES CERO-GV",0
31,"31222",57,35,34,3,1,"RECORTES CERO-GV",0
33,"33059",4359,2651,2625,33,26,"RECORTES CERO-GV",0
44,"44179",324,201,201,2,0,"RECORTES CERO-GV",0
44,"44002",47,41,41,0,0,"RECORTES CERO-GV",0
39,"39012",6772,4807,4755,31,52,"RECORTES CERO-GV",4
44,"44092",70,53,52,0,1,"RECORTES CERO-GV",0
31,"31003",121,71,71,0,0,"RECORTES CERO-GV",0
35,"35025",1752,1113,1095,5,18,"RECORTES CERO-GV",2
8,"8047",3751,2600,2578,26,22,"RECORTES CERO-GV",1
50,"50276",118,91,91,0,0,"RECORTES CERO-GV",0
10,"10214",216,170,170,2,0,"RECORTES CERO-GV",1
17,"17126",316,269,269,1,0,"RECORTES CERO-GV",0
48,"48043",4591,3337,3325,20,12,"RECORTES CERO-GV",3
8,"8232",1773,1368,1362,9,6,"RECORTES CERO-GV",0
50,"50051",802,551,550,2,1,"RECORTES CERO-GV",0
38,"38041",7025,4729,4684,42,45,"RECORTES CERO-GV",6
23,"23062",1410,1094,1076,0,18,"RECORTES CERO-GV",1
39,"39097",666,342,335,2,7,"RECORTES CERO-GV",1
8,"8116",557,449,449,1,0,"RECORTES CERO-GV",0
6,"6145",900,683,669,7,14,"RECORTES CERO-GV",0
50,"50277",45,34,34,0,0,"RECORTES CERO-GV",0
44,"44238",2278,1630,1620,3,10,"RECORTES CERO-GV",0
48,"48903",1800,1358,1353,4,5,"RECORTES CERO-GV",0
31,"31187",99,53,52,0,1,"RECORTES CERO-GV",0
36,"36022",9046,5834,5720,37,114,"RECORTES CERO-GV",7
18,"18097",947,633,631,0,2,"RECORTES CERO-GV",0
8,"8026",195,148,146,0,2,"RECORTES CERO-GV",0
7,"7053",1209,870,864,10,6,"RECORTES CERO-GV",4
17,"17118",12934,8723,8665,38,58,"RECORTES CERO-GV",9
29,"29030",770,618,611,4,7,"RECORTES CERO-GV",0
46,"46034",1826,1345,1335,3,10,"RECORTES CERO-GV",1
46,"46011",7523,5154,5077,34,77,"RECORTES CERO-GV",3
20,"20003",549,360,355,1,5,"RECORTES CERO-GV",0
41,"41040",11183,8351,8253,71,98,"RECORTES CERO-GV",13
25,"25135",997,675,671,3,4,"RECORTES CERO-GV",0
8,"8163",19672,13421,13364,70,57,"RECORTES CERO-GV",21
26,"26024",204,157,156,1,1,"RECORTES CERO-GV",0
17,"17184",1261,1016,1010,7,6,"RECORTES CERO-GV",1
31,"31189",1125,702,698,6,4,"RECORTES CERO-GV",2
43,"43032",462,354,350,2,4,"RECORTES CERO-GV",0
33,"33005",1357,832,825,11,7,"RECORTES CERO-GV",1
8,"8188",115,89,89,0,0,"RECORTES CERO-GV",0
29,"29076",2354,1498,1444,21,54,"RECORTES CERO-GV",3
50,"50130",354,225,222,1,3,"RECORTES CERO-GV",0
10,"10177",1702,1241,1186,10,55,"RECORTES CERO-GV",3
50,"50279",74,49,49,0,0,"RECORTES CERO-GV",0
21,"21068",973,562,556,11,6,"RECORTES CERO-GV",0
29,"29060",665,454,450,1,4,"RECORTES CERO-GV",0
44,"44005",48,36,36,0,0,"RECORTES CERO-GV",0
1,"1032",498,363,353,1,10,"RECORTES CERO-GV",0
26,"26061",1542,1104,1079,12,25,"RECORTES CERO-GV",1
6,"6057",530,409,400,0,9,"RECORTES CERO-GV",1
29,"29077",207,135,134,1,1,"RECORTES CERO-GV",0
12,"12140",1147,849,841,5,8,"RECORTES CERO-GV",0
27,"27060",2434,1458,1434,17,24,"RECORTES CERO-GV",0
39,"39016",23850,17235,17106,70,129,"RECORTES CERO-GV",12
50,"50231",253,199,195,4,4,"RECORTES CERO-GV",0
46,"46150",1794,1276,1272,8,4,"RECORTES CERO-GV",0
21,"21069",1681,1073,1056,9,17,"RECORTES CERO-GV",0
46,"46195",2000,1540,1532,3,8,"RECORTES CERO-GV",0
12,"12038",157,101,100,3,1,"RECORTES CERO-GV",0
25,"25230",1541,1105,1099,9,6,"RECORTES CERO-GV",0
44,"44006",220,152,151,1,1,"RECORTES CERO-GV",0
18,"18164",1790,1135,1108,11,27,"RECORTES CERO-GV",1
17,"17212",145,111,109,0,2,"RECORTES CERO-GV",0
50,"50232",160,93,92,1,1,"RECORTES CERO-GV",0
8,"8303",257,207,205,1,2,"RECORTES CERO-GV",0
23,"23033",1325,1008,989,11,19,"RECORTES CERO-GV",0
46,"46173",1309,1029,1010,13,19,"RECORTES CERO-GV",0
12,"12083",88,69,67,9,2,"RECORTES CERO-GV",0
17,"17159",622,459,459,1,0,"RECORTES CERO-GV",3
18,"18005",363,232,230,3,2,"RECORTES CERO-GV",0
32,"32066",547,396,396,0,0,"RECORTES CERO-GV",0
25,"25074",179,155,151,2,4,"RECORTES CERO-GV",0
25,"25169",170,117,117,5,0,"RECORTES CERO-GV",0
39,"39017",550,378,372,1,6,"RECORTES CERO-GV",0
31,"31156",238,175,174,2,1,"RECORTES CERO-GV",1
4,"4091",318,251,250,0,1,"RECORTES CERO-GV",0
25,"25110",2745,1943,1927,13,16,"RECORTES CERO-GV",1
31,"31193",1440,1062,1055,11,7,"RECORTES CERO-GV",6
26,"26064",2335,1617,1584,28,33,"RECORTES CERO-GV",1
46,"46128",1569,1216,1179,7,37,"RECORTES CERO-GV",1
32,"32067",1189,696,692,4,4,"RECORTES CERO-GV",1
48,"48076",288,211,211,1,0,"RECORTES CERO-GV",0
33,"33009",878,545,542,4,3,"RECORTES CERO-GV",1
8,"8259",6979,5362,5341,27,21,"RECORTES CERO-GV",8
44,"44100",177,136,135,1,1,"RECORTES CERO-GV",0
50,"50080",34,27,27,0,0,"RECORTES CERO-GV",0
10,"10903",806,555,545,8,10,"RECORTES CERO-GV",0
43,"43115",128,106,106,0,0,"RECORTES CERO-GV",0
22,"22232",88,61,61,2,0,"RECORTES CERO-GV",0
18,"18167",1839,1243,1224,9,19,"RECORTES CERO-GV",1
10,"10101",178,129,125,0,4,"RECORTES CERO-GV",1
50,"50282",55,38,38,1,0,"RECORTES CERO-GV",0
31,"31121",62,42,42,0,0,"RECORTES CERO-GV",0
12,"12040",119116,85613,84993,620,620,"RECORTES CERO-GV",76
12,"12118",78,64,63,0,1,"RECORTES CERO-GV",0
50,"50208",1761,1267,1250,16,17,"RECORTES CERO-GV",0
46,"46016",1070,827,814,10,13,"RECORTES CERO-GV",0
31,"31232",25687,17548,17304,243,244,"RECORTES CERO-GV",51
27,"27002",1535,990,968,13,22,"RECORTES CERO-GV",5
46,"46008",2617,1954,1931,17,23,"RECORTES CERO-GV",0
31,"31001",79,56,56,0,0,"RECORTES CERO-GV",1
10,"10143",141,109,105,0,4,"RECORTES CERO-GV",0
38,"38047",1755,1132,1110,9,22,"RECORTES CERO-GV",0
43,"43029",312,241,240,1,1,"RECORTES CERO-GV",0
50,"50134",120,85,82,4,3,"RECORTES CERO-GV",0
32,"32033",667,439,436,4,3,"RECORTES CERO-GV",0
4,"4060",416,286,282,2,4,"RECORTES CERO-GV",0
32,"32070",495,247,238,4,9,"RECORTES CERO-GV",0
44,"44102",26,19,19,0,0,"RECORTES CERO-GV",0
17,"17215",2286,1855,1844,13,11,"RECORTES CERO-GV",0
27,"27003",1743,1161,1134,18,27,"RECORTES CERO-GV",3
48,"48079",397,289,287,1,2,"RECORTES CERO-GV",0
25,"25910",91,63,63,0,0,"RECORTES CERO-GV",0
21,"21013",10626,6990,6807,99,183,"RECORTES CERO-GV",1
50,"50082",82,57,57,0,0,"RECORTES CERO-GV",0
25,"25141",154,105,104,3,1,"RECORTES CERO-GV",0
8,"8168",388,280,279,3,1,"RECORTES CERO-GV",0
18,"18070",287,216,216,3,0,"RECORTES CERO-GV",0
31,"31197",67,51,51,2,0,"RECORTES CERO-GV",0
7,"7028",944,635,628,2,7,"RECORTES CERO-GV",0
29,"29009",1435,971,957,17,14,"RECORTES CERO-GV",0
12,"12042",574,459,446,9,13,"RECORTES CERO-GV",0
50,"50058",63,45,43,0,2,"RECORTES CERO-GV",0
15,"15001",4697,3069,3022,45,47,"RECORTES CERO-GV",5
44,"44011",47,34,34,0,0,"RECORTES CERO-GV",0
17,"17216",158,122,121,0,1,"RECORTES CERO-GV",0
10,"10105",2442,1541,1515,11,26,"RECORTES CERO-GV",6
48,"48051",220,151,150,0,1,"RECORTES CERO-GV",0
50,"50284",129,98,98,0,0,"RECORTES CERO-GV",0
36,"36031",563,426,420,7,6,"RECORTES CERO-GV",1
44,"44039",204,144,143,1,1,"RECORTES CERO-GV",0
6,"6159",2329,1297,1273,22,24,"RECORTES CERO-GV",0
17,"17050",664,554,550,10,4,"RECORTES CERO-GV",0
31,"31125",271,173,171,3,2,"RECORTES CERO-GV",0
12,"12043",570,405,397,1,8,"RECORTES CERO-GV",0
27,"27005",2560,1691,1662,19,29,"RECORTES CERO-GV",0
32,"32073",1273,863,857,6,6,"RECORTES CERO-GV",1
11,"11003",1230,802,787,9,15,"RECORTES CERO-GV",0
8,"8033",13262,9887,9833,64,54,"RECORTES CERO-GV",2
18,"18171",2098,1521,1460,11,61,"RECORTES CERO-GV",2
33,"33070",3267,2211,2185,27,26,"RECORTES CERO-GV",2
33,"33042",4237,2862,2816,49,46,"RECORTES CERO-GV",3
3,"3051",342,288,286,4,2,"RECORTES CERO-GV",0
8,"8187",153822,113081,112470,758,611,"RECORTES CERO-GV",150
31,"31006",1877,1328,1310,14,18,"RECORTES CERO-GV",2
41,"41068",13963,9596,9407,96,189,"RECORTES CERO-GV",5
44,"44123",95,68,68,0,0,"RECORTES CERO-GV",0
43,"43041",216,156,156,2,0,"RECORTES CERO-GV",0
50,"50035",74,57,57,0,0,"RECORTES CERO-GV",0
46,"46156",2017,1538,1524,9,14,"RECORTES CERO-GV",2
22,"22205",448,294,292,0,2,"RECORTES CERO-GV",0
17,"17138",836,591,584,7,7,"RECORTES CERO-GV",1
20,"20013",5433,3906,3893,24,13,"RECORTES CERO-GV",4
44,"44220",113,82,82,1,0,"RECORTES CERO-GV",0
17,"17080",144,113,113,1,0,"RECORTES CERO-GV",0
25,"25913",88,72,72,1,0,"RECORTES CERO-GV",0
43,"43172",334,248,243,4,5,"RECORTES CERO-GV",1
48,"48054",25063,17705,17597,122,108,"RECORTES CERO-GV",14
39,"39024",1802,1325,1314,7,11,"RECORTES CERO-GV",0
12,"12123",40,32,32,0,0,"RECORTES CERO-GV",0
18,"18074",265,205,205,0,0,"RECORTES CERO-GV",0
11,"11005",4508,2978,2900,34,78,"RECORTES CERO-GV",3
25,"25052",1541,1183,1176,7,7,"RECORTES CERO-GV",1
7,"7032",21005,12039,11928,114,111,"RECORTES CERO-GV",23
25,"25145",75,59,59,0,0,"RECORTES CERO-GV",0
30,"30034",1067,818,801,8,17,"RECORTES CERO-GV",0
6,"6027",645,523,513,0,10,"RECORTES CERO-GV",2
50,"50113",587,471,461,2,10,"RECORTES CERO-GV",0
23,"23079",3624,2661,2630,19,31,"RECORTES CERO-GV",1
50,"50901",133,96,96,0,0,"RECORTES CERO-GV",0
15,"15005",25347,15441,15211,226,230,"RECORTES CERO-GV",26
44,"44193",73,60,60,1,0,"RECORTES CERO-GV",0
11,"11006",24558,15334,15113,231,221,"RECORTES CERO-GV",9
10,"10069",786,566,554,3,12,"RECORTES CERO-GV",4
44,"44194",103,67,64,0,3,"RECORTES CERO-GV",0
1,"1049",130,94,94,1,0,"RECORTES CERO-GV",0
17,"17026",549,421,415,3,6,"RECORTES CERO-GV",0
10,"10111",1297,888,872,11,16,"RECORTES CERO-GV",3
8,"8035",13006,8957,8918,50,39,"RECORTES CERO-GV",16
43,"43122",112,91,91,1,0,"RECORTES CERO-GV",0
41,"41052",3032,2162,2092,6,70,"RECORTES CERO-GV",3
6,"6903",2011,1443,1416,18,27,"RECORTES CERO-GV",1
25,"25053",1100,819,811,7,8,"RECORTES CERO-GV",1
20,"20016",1529,887,883,3,4,"RECORTES CERO-GV",3
36,"36003",10023,6877,6789,66,88,"RECORTES CERO-GV",6
48,"48028",682,551,548,3,3,"RECORTES CERO-GV",0
8,"8081",349,274,270,0,4,"RECORTES CERO-GV",0
17,"17027",2857,2236,2229,9,7,"RECORTES CERO-GV",0
25,"25120",92888,62740,62389,450,351,"RECORTES CERO-GV",91
43,"43044",3962,2751,2719,33,32,"RECORTES CERO-GV",7
18,"18077",471,350,343,1,7,"RECORTES CERO-GV",1
35,"35014",11962,5994,5888,60,106,"RECORTES CERO-GV",10
31,"31242",258,168,167,2,1,"RECORTES CERO-GV",0
26,"26003",379,311,306,1,5,"RECORTES CERO-GV",0
50,"50140",153,96,95,1,1,"RECORTES CERO-GV",0
31,"31205",419,290,289,4,1,"RECORTES CERO-GV",3
4,"4033",121,78,77,3,1,"RECORTES CERO-GV",0
25,"25244",374,275,270,1,5,"RECORTES CERO-GV",0
44,"44075",321,255,252,1,3,"RECORTES CERO-GV",0
50,"50064",439,348,346,1,2,"RECORTES CERO-GV",0
20,"20017",8462,5944,5917,11,27,"RECORTES CERO-GV",6
46,"46090",1631,1360,1339,6,21,"RECORTES CERO-GV",1
8,"8174",388,322,318,2,4,"RECORTES CERO-GV",0
18,"18912",1352,926,912,7,14,"RECORTES CERO-GV",0
43,"43070",243,194,193,0,1,"RECORTES CERO-GV",0
46,"46045",1245,984,961,3,23,"RECORTES CERO-GV",0
46,"46114",552,417,412,6,5,"RECORTES CERO-GV",1
3,"3114",1593,1158,1142,4,16,"RECORTES CERO-GV",2
29,"29016",253,196,194,0,2,"RECORTES CERO-GV",0
7,"7036",28132,18650,18510,222,140,"RECORTES CERO-GV",37
27,"27011",2341,1387,1362,7,25,"RECORTES CERO-GV",1
6,"6078",500,363,359,1,4,"RECORTES CERO-GV",1
50,"50141",104,80,78,0,2,"RECORTES CERO-GV",0
22,"22245",303,222,213,3,9,"RECORTES CERO-GV",0
46,"46091",110,100,100,0,0,"RECORTES CERO-GV",0
46,"46182",1312,908,904,5,4,"RECORTES CERO-GV",2
17,"17084",228,163,162,1,1,"RECORTES CERO-GV",0
32,"32081",2057,1466,1445,17,21,"RECORTES CERO-GV",3
29,"29017",6404,4575,4468,48,107,"RECORTES CERO-GV",4
22,"22064",155,100,100,2,0,"RECORTES CERO-GV",0
22,"22054",1614,1029,1009,19,20,"RECORTES CERO-GV",3
22,"22036",84,71,71,1,0,"RECORTES CERO-GV",0
48,"48059",402,299,297,0,2,"RECORTES CERO-GV",0
39,"39029",629,476,469,1,7,"RECORTES CERO-GV",0
3,"3086",169,140,140,2,0,"RECORTES CERO-GV",0
7,"7037",3448,1875,1856,18,19,"RECORTES CERO-GV",4
41,"41055",14791,10197,10000,125,197,"RECORTES CERO-GV",7
50,"50142",23,16,16,1,0,"RECORTES CERO-GV",0
35,"35016",300581,181532,179831,1458,1701,"RECORTES CERO-GV",221
8,"8038",1541,1129,1120,6,9,"RECORTES CERO-GV",1
43,"43020",2291,1712,1688,19,24,"RECORTES CERO-GV",1
44,"44020",22,21,21,0,0,"RECORTES CERO-GV",0
44,"44112",400,265,265,2,0,"RECORTES CERO-GV",0
14,"14003",1245,925,907,5,18,"RECORTES CERO-GV",0
25,"25058",4345,3058,3045,13,13,"RECORTES CERO-GV",0
33,"33021",4304,2643,2610,32,33,"RECORTES CERO-GV",6
4,"4902",45571,29423,29169,272,254,"RECORTES CERO-GV",27
38,"38007",1619,1053,1043,3,10,"RECORTES CERO-GV",1
46,"46024",454,343,339,1,4,"RECORTES CERO-GV",0
27,"27013",3690,2811,2766,30,45,"RECORTES CERO-GV",6
4,"4036",239,178,176,0,2,"RECORTES CERO-GV",0
17,"17145",1410,1040,1032,6,8,"RECORTES CERO-GV",1
22,"22136",749,524,518,5,6,"RECORTES CERO-GV",0
50,"50218",112,88,88,1,0,"RECORTES CERO-GV",0
32,"32083",805,498,494,3,4,"RECORTES CERO-GV",1
46,"46162",1168,839,832,3,7,"RECORTES CERO-GV",0
6,"6082",399,295,291,6,4,"RECORTES CERO-GV",0
44,"44199",39,37,37,2,0,"RECORTES CERO-GV",0
50,"50268",41,32,32,1,0,"RECORTES CERO-GV",0
31,"31028",215,121,121,2,0,"RECORTES CERO-GV",0
25,"25152",148,106,106,0,0,"RECORTES CERO-GV",0
50,"50293",392,257,255,2,2,"RECORTES CERO-GV",0
10,"10119",574,417,414,2,3,"RECORTES CERO-GV",0
22,"22137",1009,671,665,1,6,"RECORTES CERO-GV",0
12,"12052",537,409,398,5,11,"RECORTES CERO-GV",0
17,"17227",147,104,104,0,0,"RECORTES CERO-GV",0
22,"22039",813,635,634,4,1,"RECORTES CERO-GV",1
23,"23088",6017,4529,4427,61,102,"RECORTES CERO-GV",3
14,"14005",6298,3905,3828,71,77,"RECORTES CERO-GV",2
31,"31138",948,629,627,8,2,"RECORTES CERO-GV",3
43,"43048",768,564,554,7,10,"RECORTES CERO-GV",0
31,"31211",17,15,14,3,1,"RECORTES CERO-GV",0
25,"25060",71,42,42,0,0,"RECORTES CERO-GV",0
26,"26164",50,36,35,0,1,"RECORTES CERO-GV",0
26,"26083",337,255,250,3,5,"RECORTES CERO-GV",1
6,"6009",221,166,166,2,0,"RECORTES CERO-GV",0
31,"31237",182,138,135,2,3,"RECORTES CERO-GV",1
46,"46087",109,94,94,2,0,"RECORTES CERO-GV",0
1,"1014",366,271,266,2,5,"RECORTES CERO-GV",0
31,"31250",2761,1776,1759,13,17,"RECORTES CERO-GV",8
41,"41031",1204,780,769,5,11,"RECORTES CERO-GV",0
17,"17228",285,218,217,0,1,"RECORTES CERO-GV",0
1,"1059",189597,128849,127910,688,939,"RECORTES CERO-GV",328
31,"31030",135,94,94,0,0,"RECORTES CERO-GV",0
20,"20903",5033,3355,3341,18,14,"RECORTES CERO-GV",6
26,"26084",7264,5130,5059,61,71,"RECORTES CERO-GV",8
3,"3091",244,194,193,2,1,"RECORTES CERO-GV",0
17,"17147",7916,5672,5641,41,31,"RECORTES CERO-GV",8
44,"44201",477,399,395,1,4,"RECORTES CERO-GV",0
25,"25250",327,269,265,1,4,"RECORTES CERO-GV",0
11,"11015",64414,39635,39220,776,415,"RECORTES CERO-GV",56
25,"25155",616,446,443,2,3,"RECORTES CERO-GV",1
23,"23091",675,516,512,1,4,"RECORTES CERO-GV",0
22,"22217",370,274,269,4,5,"RECORTES CERO-GV",0
8,"8294",2093,1546,1534,11,12,"RECORTES CERO-GV",0
43,"43138",2636,1761,1745,11,16,"RECORTES CERO-GV",1
10,"10083",96,76,74,0,2,"RECORTES CERO-GV",0
50,"50147",744,508,506,5,2,"RECORTES CERO-GV",0
50,"50197",95,69,68,2,1,"RECORTES CERO-GV",0
31,"31141",106,66,61,1,5,"RECORTES CERO-GV",0
46,"46164",12145,8373,8248,44,125,"RECORTES CERO-GV",10
14,"14007",15016,10248,10043,99,205,"RECORTES CERO-GV",7
23,"23092",27717,19749,19490,217,259,"RECORTES CERO-GV",17
22,"22041",145,116,116,2,0,"RECORTES CERO-GV",0
22,"22142",94,72,70,0,2,"RECORTES CERO-GV",0
18,"18184",2193,1542,1511,16,31,"RECORTES CERO-GV",1
43,"43025",591,448,443,4,5,"RECORTES CERO-GV",0
31,"31252",80,52,52,1,0,"RECORTES CERO-GV",0
6,"6089",610,470,463,2,7,"RECORTES CERO-GV",1
17,"17232",146,111,111,0,0,"RECORTES CERO-GV",0
50,"50173",156,114,114,0,0,"RECORTES CERO-GV",0
8,"8111",216,195,194,2,1,"RECORTES CERO-GV",0
50,"50070",50,30,29,0,1,"RECORTES CERO-GV",0
18,"18024",837,651,639,11,12,"RECORTES CERO-GV",1
31,"31142",1389,909,900,9,9,"RECORTES CERO-GV",2
48,"48038",1151,829,829,1,0,"RECORTES CERO-GV",0
8,"8112",12926,9268,9230,61,38,"RECORTES CERO-GV",3
3,"3093",19702,13903,13728,113,175,"RECORTES CERO-GV",8
39,"39036",965,707,703,4,4,"RECORTES CERO-GV",4
26,"26051",213,165,165,1,0,"RECORTES CERO-GV",0
18,"18121",119,79,79,1,0,"RECORTES CERO-GV",1
1,"1062",318,221,219,2,2,"RECORTES CERO-GV",1
17,"17233",2347,1853,1840,11,13,"RECORTES CERO-GV",2
22,"22252",118,95,91,1,4,"RECORTES CERO-GV",1
4,"4046",849,617,612,6,5,"RECORTES CERO-GV",1
11,"11018",1434,1001,977,8,24,"RECORTES CERO-GV",6
14,"14065",1820,1374,1352,13,22,"RECORTES CERO-GV",0
31,"31071",13,11,11,0,0,"RECORTES CERO-GV",0
25,"25254",704,511,508,2,3,"RECORTES CERO-GV",0
44,"44118",154,109,106,1,3,"RECORTES CERO-GV",0
30,"30901",10556,7862,7775,58,87,"RECORTES CERO-GV",7
25,"25130",181,130,128,0,2,"RECORTES CERO-GV",0
25,"25067",702,500,494,8,6,"RECORTES CERO-GV",0
32,"32091",1695,1163,1156,2,7,"RECORTES CERO-GV",1
12,"12058",59,47,45,1,2,"RECORTES CERO-GV",0
50,"50150",624,387,384,2,3,"RECORTES CERO-GV",0
10,"10087",1588,1105,1093,10,12,"RECORTES CERO-GV",0
31,"31035",50,30,29,0,1,"RECORTES CERO-GV",0
43,"43053",186,135,134,0,1,"RECORTES CERO-GV",0
18,"18187",510,350,350,2,0,"RECORTES CERO-GV",0
50,"50175",907,638,632,11,6,"RECORTES CERO-GV",0
8,"8045",65,44,43,0,1,"RECORTES CERO-GV",0
31,"31219",80,59,58,2,1,"RECORTES CERO-GV",0
17,"17151",179,131,130,0,1,"RECORTES CERO-GV",0
8,"8113",52589,36864,36690,244,174,"RECORTES CERO-GV",47
17,"17123",343,286,284,2,2,"RECORTES CERO-GV",0
18,"18059",4265,2960,2886,23,74,"RECORTES CERO-GV",1
38,"38014",1342,943,930,6,13,"RECORTES CERO-GV",1
22,"22254",1084,744,735,10,9,"RECORTES CERO-GV",0
10,"10007",627,457,447,3,10,"RECORTES CERO-GV",0
31,"31037",91,70,70,0,0,"RECORTES CERO-GV",0
6,"6079",649,451,445,3,6,"RECORTES CERO-GV",0
17,"17901",987,733,725,5,8,"RECORTES CERO-GV",0
25,"25255",390,301,301,0,0,"RECORTES CERO-GV",0
22,"22150",459,325,321,8,4,"RECORTES CERO-GV",2
3,"3011",8014,5278,5212,50,66,"RECORTES CERO-GV",5
44,"44178",52,34,34,0,0,"RECORTES CERO-GV",0
26,"26094",67,51,51,0,0,"RECORTES CERO-GV",0
33,"33058",1668,1050,1035,13,15,"RECORTES CERO-GV",2
4,"4049",5711,3766,3732,25,34,"RECORTES CERO-GV",6
29,"29027",2325,1543,1516,13,27,"RECORTES CERO-GV",0
48,"48069",13131,9211,9162,55,49,"RECORTES CERO-GV",6
7,"7016",2970,1891,1865,22,26,"RECORTES CERO-GV",2
8,"8092",3713,2758,2745,9,13,"RECORTES CERO-GV",1
46,"46100",281,190,187,1,3,"RECORTES CERO-GV",0
38,"38015",4055,2635,2601,16,34,"RECORTES CERO-GV",2
41,"41009",1148,750,732,5,18,"RECORTES CERO-GV",2
17,"17902",1294,992,990,9,2,"RECORTES CERO-GV",2
44,"44208",27,17,17,0,0,"RECORTES CERO-GV",0
6,"6096",206,158,153,0,5,"RECORTES CERO-GV",0
20,"20031",185,113,112,3,1,"RECORTES CERO-GV",0
25,"25069",426,296,294,0,2,"RECORTES CERO-GV",0
10,"10009",255,165,162,1,3,"RECORTES CERO-GV",0
17,"17153",189,150,149,1,1,"RECORTES CERO-GV",1
39,"39040",4271,3103,3080,18,23,"RECORTES CERO-GV",1
26,"26095",93,71,68,0,3,"RECORTES CERO-GV",0
48,"48070",527,357,355,0,2,"RECORTES CERO-GV",0
50,"50001",89,68,68,0,0,"RECORTES CERO-GV",0
25,"25133",671,481,479,1,2,"RECORTES CERO-GV",0
22,"22151",85,60,60,0,0,"RECORTES CERO-GV",0
15,"15022",5580,3508,3472,47,36,"RECORTES CERO-GV",3
22,"22903",618,484,482,5,2,"RECORTES CERO-GV",1
41,"41066",1307,927,898,7,29,"RECORTES CERO-GV",1
50,"50075",70,55,55,1,0,"RECORTES CERO-GV",0
29,"29903",485,326,324,2,2,"RECORTES CERO-GV",0
25,"25041",525,375,370,4,5,"RECORTES CERO-GV",0
50,"50228",249,207,207,3,0,"RECORTES CERO-GV",0
46,"46102",19696,14700,14579,125,121,"RECORTES CERO-GV",21
48,"48015",33077,22441,22295,145,146,"RECORTES CERO-GV",36
15,"15086",2760,1829,1810,26,19,"RECORTES CERO-GV",0
17,"17155",14957,9519,9410,71,109,"RECORTES CERO-GV",20
18,"18161",245,199,196,0,3,"RECORTES CERO-GV",0
4,"4015",113,81,81,0,0,"RECORTES CERO-GV",0
33,"33061",344,174,174,1,0,"RECORTES CERO-GV",1
50,"50179",255,197,197,0,0,"RECORTES CERO-GV",0
8,"8117",2489,1954,1941,21,13,"RECORTES CERO-GV",1
18,"18085",690,440,432,1,8,"RECORTES CERO-GV",0
8,"8071",249,209,208,0,1,"RECORTES CERO-GV",0
30,"30024",60389,42200,41831,281,369,"RECORTES CERO-GV",29
31,"31115",159,93,93,2,0,"RECORTES CERO-GV",1
17,"17128",321,239,238,1,1,"RECORTES CERO-GV",0
12,"12063",41,31,31,1,0,"RECORTES CERO-GV",0
25,"25104",120,88,88,0,0,"RECORTES CERO-GV",0
20,"20033",858,644,638,1,6,"RECORTES CERO-GV",2
25,"25166",170,131,130,2,1,"RECORTES CERO-GV",0
25,"25197",140,109,109,0,0,"RECORTES CERO-GV",0
6,"6055",1976,1343,1313,11,30,"RECORTES CERO-GV",0
46,"46148",1515,1131,1113,5,18,"RECORTES CERO-GV",0
18,"18194",2038,1373,1348,12,25,"RECORTES CERO-GV",0
50,"50027",223,166,161,2,5,"RECORTES CERO-GV",0
29,"29059",2662,1950,1895,16,55,"RECORTES CERO-GV",0
25,"25014",246,184,178,0,6,"RECORTES CERO-GV",0
29,"29031",1555,1015,986,6,29,"RECORTES CERO-GV",0
50,"50230",1140,771,767,11,4,"RECORTES CERO-GV",0
46,"46172",5488,3724,3674,26,50,"RECORTES CERO-GV",4
10,"10068",707,532,521,4,11,"RECORTES CERO-GV",0
41,"41069",29669,20316,19848,381,468,"RECORTES CERO-GV",44
22,"22228",532,371,364,4,7,"RECORTES CERO-GV",2
4,"4054",363,279,278,2,1,"RECORTES CERO-GV",0
31,"31044",291,227,227,1,0,"RECORTES CERO-GV",0
14,"14016",1273,936,922,5,14,"RECORTES CERO-GV",0
26,"26101",31,18,17,0,1,"RECORTES CERO-GV",0
10,"10137",394,297,296,3,1,"RECORTES CERO-GV",0
46,"46149",350,252,249,3,3,"RECORTES CERO-GV",1
20,"20005",1274,822,822,1,0,"RECORTES CERO-GV",1
38,"38019",13884,7888,7809,49,79,"RECORTES CERO-GV",4
32,"32028",1537,1012,1004,5,8,"RECORTES CERO-GV",0
41,"41070",6451,4715,4632,70,83,"RECORTES CERO-GV",11
10,"10219",1184,698,686,9,12,"RECORTES CERO-GV",3
36,"36055",13585,9177,8986,115,191,"RECORTES CERO-GV",11
11,"11027",68774,45571,45137,567,434,"RECORTES CERO-GV",54
25,"25906",205,133,131,2,2,"RECORTES CERO-GV",0
6,"6104",648,470,459,2,11,"RECORTES CERO-GV",1
23,"23904",2570,1583,1562,10,21,"RECORTES CERO-GV",1
7,"7023",3776,2425,2386,34,39,"RECORTES CERO-GV",10
4,"4056",165,120,120,0,0,"RECORTES CERO-GV",0
46,"46036",558,339,331,6,8,"RECORTES CERO-GV",0
18,"18066",2095,1401,1378,12,23,"RECORTES CERO-GV",0
8,"8015",156540,109145,108440,957,705,"RECORTES CERO-GV",240
27,"27061",1018,704,683,12,21,"RECORTES CERO-GV",0
50,"50030",197,124,124,1,0,"RECORTES CERO-GV",1
11,"11028",32829,21934,21654,310,280,"RECORTES CERO-GV",42
48,"48907",343,274,273,0,1,"RECORTES CERO-GV",0
46,"46105",16126,10958,10847,76,111,"RECORTES CERO-GV",4
25,"25046",410,331,326,4,5,"RECORTES CERO-GV",0
44,"44215",167,113,113,2,0,"RECORTES CERO-GV",0
44,"44064",62,46,46,0,0,"RECORTES CERO-GV",0
31,"31230",90,66,66,0,0,"RECORTES CERO-GV",0
12,"12039",792,665,659,2,6,"RECORTES CERO-GV",0
50,"50281",68,52,50,0,2,"RECORTES CERO-GV",0
44,"44156",47,31,31,0,0,"RECORTES CERO-GV",0
46,"46219",125,107,104,0,3,"RECORTES CERO-GV",0
25,"25075",132,101,101,0,0,"RECORTES CERO-GV",0
43,"43167",391,307,307,2,0,"RECORTES CERO-GV",0
18,"18036",3986,2956,2917,22,39,"RECORTES CERO-GV",7
17,"17213",5567,3654,3630,19,24,"RECORTES CERO-GV",4
6,"6107",1555,980,969,8,11,"RECORTES CERO-GV",1
44,"44185",88,69,69,2,0,"RECORTES CERO-GV",0
14,"14047",1644,1198,1183,14,15,"RECORTES CERO-GV",1
31,"31157",3447,2182,2160,29,22,"RECORTES CERO-GV",4
41,"41072",4031,2969,2933,15,36,"RECORTES CERO-GV",0
41,"41073",1684,1100,1074,7,26,"RECORTES CERO-GV",0
6,"6108",2238,1524,1478,15,46,"RECORTES CERO-GV",5
11,"11030",22999,14858,14586,207,272,"RECORTES CERO-GV",21
8,"8260",18515,13563,13487,84,76,"RECORTES CERO-GV",21
31,"31903",6950,4430,4394,39,36,"RECORTES CERO-GV",8
29,"29035",1478,1054,1040,3,14,"RECORTES CERO-GV",0
46,"46107",1857,1421,1402,4,19,"RECORTES CERO-GV",0
30,"30005",30268,20979,20778,148,201,"RECORTES CERO-GV",27
25,"25909",138,99,98,2,1,"RECORTES CERO-GV",0
31,"31904",1559,989,972,11,17,"RECORTES CERO-GV",2
35,"35023",11742,7787,7651,95,136,"RECORTES CERO-GV",4
26,"26106",79,67,67,0,0,"RECORTES CERO-GV",0
15,"15031",23868,16113,15954,207,159,"RECORTES CERO-GV",31
29,"29008",15249,10396,10234,108,162,"RECORTES CERO-GV",7
6,"6156",1170,829,814,12,15,"RECORTES CERO-GV",1
29,"29036",614,393,387,1,6,"RECORTES CERO-GV",0
3,"3048",4993,3549,3502,13,47,"RECORTES CERO-GV",2
8,"8076",16526,11988,11893,90,95,"RECORTES CERO-GV",12
31,"31905",2992,1994,1984,9,10,"RECORTES CERO-GV",9
8,"8054",9215,6994,6943,38,51,"RECORTES CERO-GV",11
25,"25077",435,312,312,1,0,"RECORTES CERO-GV",0
46,"46039",2111,1657,1640,16,17,"RECORTES CERO-GV",1
31,"31196",31,23,23,0,0,"RECORTES CERO-GV",0
22,"22202",147,128,128,3,0,"RECORTES CERO-GV",0
17,"17077",565,395,394,2,1,"RECORTES CERO-GV",0
48,"48910",2811,1952,1942,11,10,"RECORTES CERO-GV",0
25,"25113",1114,873,863,3,10,"RECORTES CERO-GV",3
29,"29037",215,156,153,1,3,"RECORTES CERO-GV",0
4,"4094",215,156,156,0,0,"RECORTES CERO-GV",0
50,"50135",85,59,59,0,0,"RECORTES CERO-GV",0
10,"10023",842,597,589,2,8,"RECORTES CERO-GV",1
46,"46176",2077,1362,1348,14,14,"RECORTES CERO-GV",1
41,"41075",10320,7159,6972,88,187,"RECORTES CERO-GV",6
35,"35032",3331,2293,2252,23,41,"RECORTES CERO-GV",0
11,"11032",54731,31560,31284,492,276,"RECORTES CERO-GV",23
4,"4061",625,489,479,5,10,"RECORTES CERO-GV",0
43,"43065",379,281,277,4,4,"RECORTES CERO-GV",0
44,"44130",28,23,23,0,0,"RECORTES CERO-GV",0
3,"3107",2785,1766,1746,13,20,"RECORTES CERO-GV",2
46,"46063",1786,1270,1255,8,15,"RECORTES CERO-GV",0
23,"23040",1438,1175,1159,3,16,"RECORTES CERO-GV",1
44,"44247",291,207,206,4,1,"RECORTES CERO-GV",0
22,"22024",220,159,158,1,1,"RECORTES CERO-GV",0
31,"31052",101,78,75,0,3,"RECORTES CERO-GV",2
29,"29038",18908,12122,11931,197,191,"RECORTES CERO-GV",19
31,"31907",11272,8478,8421,97,57,"RECORTES CERO-GV",30
29,"29039",2759,1900,1860,23,40,"RECORTES CERO-GV",2
39,"39051",73,64,64,1,0,"RECORTES CERO-GV",0
41,"41076",2134,1246,1230,11,16,"RECORTES CERO-GV",1
17,"17164",3918,2856,2838,17,18,"RECORTES CERO-GV",0
14,"14023",1999,1629,1593,11,36,"RECORTES CERO-GV",1
46,"46223",7776,5848,5798,36,50,"RECORTES CERO-GV",9
10,"10107",1019,766,755,12,11,"RECORTES CERO-GV",1
25,"25051",1522,1066,1059,6,7,"RECORTES CERO-GV",2
3,"3138",3190,2244,2207,9,37,"RECORTES CERO-GV",4
23,"23029",798,595,590,0,5,"RECORTES CERO-GV",0
29,"29904",418,328,322,1,6,"RECORTES CERO-GV",2
3,"3024",3937,2992,2952,19,40,"RECORTES CERO-GV",1
22,"22025",1022,705,694,14,11,"RECORTES CERO-GV",0
18,"18908",776,553,528,3,25,"RECORTES CERO-GV",0
23,"23076",774,606,595,6,11,"RECORTES CERO-GV",0
14,"14024",1849,1417,1391,5,26,"RECORTES CERO-GV",5
22,"22027",311,210,209,1,1,"RECORTES CERO-GV",0
31,"31164",542,410,408,5,2,"RECORTES CERO-GV",1
46,"46178",5001,3513,3477,26,36,"RECORTES CERO-GV",6
48,"48913",1236,899,890,8,9,"RECORTES CERO-GV",1
44,"44070",55,49,49,0,0,"RECORTES CERO-GV",0
18,"18141",382,240,237,0,3,"RECORTES CERO-GV",0
17,"17051",202,161,160,0,1,"RECORTES CERO-GV",0
27,"27038",923,624,619,8,5,"RECORTES CERO-GV",1
44,"44132",54,49,49,0,0,"RECORTES CERO-GV",0
50,"50164",381,245,243,3,2,"RECORTES CERO-GV",2
46,"46042",3335,2655,2620,12,35,"RECORTES CERO-GV",1
46,"46247",972,649,646,3,3,"RECORTES CERO-GV",0
29,"29040",1933,1260,1235,11,25,"RECORTES CERO-GV",1
29,"29022",177,137,136,1,1,"RECORTES CERO-GV",0
41,"41078",2445,1722,1689,12,33,"RECORTES CERO-GV",2
46,"46088",152,114,110,1,4,"RECORTES CERO-GV",1
38,"38003",1517,899,890,5,9,"RECORTES CERO-GV",0
23,"23077",604,482,477,2,5,"RECORTES CERO-GV",0
32,"32003",863,632,619,3,13,"RECORTES CERO-GV",0
43,"43016",3470,2547,2508,15,39,"RECORTES CERO-GV",2
31,"31092",683,413,413,6,0,"RECORTES CERO-GV",1
41,"41096",6178,4739,4655,60,84,"RECORTES CERO-GV",4
4,"4099",4930,3526,3462,22,64,"RECORTES CERO-GV",1
48,"48083",6934,4800,4765,21,35,"RECORTES CERO-GV",5
8,"8126",8906,6673,6646,41,27,"RECORTES CERO-GV",7
10,"10029",380,284,276,0,8,"RECORTES CERO-GV",1
33,"33072",1443,816,814,8,2,"RECORTES CERO-GV",0
8,"8219",15755,12235,12206,72,29,"RECORTES CERO-GV",16
8,"8265",1597,1262,1260,4,2,"RECORTES CERO-GV",0
18,"18108",822,604,599,2,5,"RECORTES CERO-GV",0
50,"50139",318,237,237,1,0,"RECORTES CERO-GV",0
11,"11007",18032,9872,9745,213,127,"RECORTES CERO-GV",11
31,"31167",833,581,573,2,8,"RECORTES CERO-GV",0
50,"50240",943,693,683,12,10,"RECORTES CERO-GV",0
29,"29088",2689,1817,1747,15,70,"RECORTES CERO-GV",2
22,"22130",10146,6505,6436,57,69,"RECORTES CERO-GV",6
8,"8903",201,181,181,1,0,"RECORTES CERO-GV",0
8,"8150",258,207,207,1,0,"RECORTES CERO-GV",0
20,"20047",455,314,314,1,0,"RECORTES CERO-GV",1
12,"12075",110,85,83,3,2,"RECORTES CERO-GV",0
27,"27041",2216,1463,1445,19,18,"RECORTES CERO-GV",5
46,"46044",4159,3062,2997,26,65,"RECORTES CERO-GV",0
44,"44223",73,48,48,0,0,"RECORTES CERO-GV",0
31,"31168",238,176,174,1,2,"RECORTES CERO-GV",1
44,"44136",48,43,43,1,0,"RECORTES CERO-GV",0
6,"6121",3276,2301,2256,30,45,"RECORTES CERO-GV",1
39,"39027",3045,2231,2199,23,32,"RECORTES CERO-GV",1
46,"46181",16967,11951,11835,98,116,"RECORTES CERO-GV",12
4,"4032",5716,3727,3696,43,31,"RECORTES CERO-GV",4
25,"25087",54,45,45,0,0,"RECORTES CERO-GV",0
14,"14028",302,241,240,3,1,"RECORTES CERO-GV",0
26,"26118",71,54,53,1,1,"RECORTES CERO-GV",0
27,"27042",1639,1120,1107,8,13,"RECORTES CERO-GV",0
32,"32043",2497,1607,1582,14,25,"RECORTES CERO-GV",3
39,"39084",868,608,605,3,3,"RECORTES CERO-GV",0
31,"31132",147,100,100,2,0,"RECORTES CERO-GV",0
50,"50115",3279,2170,2131,27,39,"RECORTES CERO-GV",1
43,"43124",468,343,339,3,4,"RECORTES CERO-GV",0
15,"15040",2647,1779,1762,15,17,"RECORTES CERO-GV",1
50,"50088",274,195,191,2,4,"RECORTES CERO-GV",0
8,"8002",217,172,172,2,0,"RECORTES CERO-GV",0
43,"43150",1233,954,941,6,13,"RECORTES CERO-GV",0
27,"27043",1222,746,737,12,9,"RECORTES CERO-GV",1
23,"23010",14264,9801,9635,120,166,"RECORTES CERO-GV",7
25,"25030",117,76,76,0,0,"RECORTES CERO-GV",0
7,"7003",12521,6457,6381,60,76,"RECORTES CERO-GV",16
50,"50015",81,57,56,0,1,"RECORTES CERO-GV",0
31,"31098",1984,1443,1428,11,15,"RECORTES CERO-GV",10
44,"44168",181,119,117,1,2,"RECORTES CERO-GV",0
17,"17057",968,770,769,7,1,"RECORTES CERO-GV",1
46,"46046",901,623,609,2,14,"RECORTES CERO-GV",0
15,"15041",9569,6362,6269,104,93,"RECORTES CERO-GV",8
50,"50242",99,74,74,0,0,"RECORTES CERO-GV",0
17,"17002",578,477,474,2,3,"RECORTES CERO-GV",1
32,"32008",8647,5570,5495,56,75,"RECORTES CERO-GV",9
27,"27044",2703,1495,1463,15,32,"RECORTES CERO-GV",2
50,"50090",134,96,96,0,0,"RECORTES CERO-GV",0
8,"8129",486,399,398,0,1,"RECORTES CERO-GV",1
36,"36006",11502,8057,7927,53,130,"RECORTES CERO-GV",9
38,"38031",29301,20926,20701,157,225,"RECORTES CERO-GV",14
48,"48032",5762,4287,4262,14,25,"RECORTES CERO-GV",2
30,"30038",15752,10987,10904,39,83,"RECORTES CERO-GV",20
12,"12128",1365,990,972,16,18,"RECORTES CERO-GV",0
23,"23014",2535,1890,1861,28,29,"RECORTES CERO-GV",1
31,"31208",2568,1855,1835,24,20,"RECORTES CERO-GV",2
43,"43047",4234,2590,2564,19,26,"RECORTES CERO-GV",1
18,"18018",542,384,377,2,7,"RECORTES CERO-GV",0
25,"25182",1043,763,760,8,3,"RECORTES CERO-GV",0
29,"29046",2494,1727,1693,13,34,"RECORTES CERO-GV",1
31,"31172",370,257,250,6,7,"RECORTES CERO-GV",0
25,"25248",870,676,675,5,1,"RECORTES CERO-GV",0
50,"50066",2903,2095,2078,19,17,"RECORTES CERO-GV",1
43,"43073",80,67,65,0,2,"RECORTES CERO-GV",0
31,"31064",1398,1035,1031,5,4,"RECORTES CERO-GV",0
27,"27045",926,588,583,6,5,"RECORTES CERO-GV",0
8,"8269",2729,2114,2105,9,9,"RECORTES CERO-GV",2
10,"10037",76966,54717,53914,546,803,"RECORTES CERO-GV",94
44,"44021",104,77,77,1,0,"RECORTES CERO-GV",0
32,"32011",916,512,507,3,5,"RECORTES CERO-GV",0
48,"48005",116,80,79,0,1,"RECORTES CERO-GV",0
46,"46116",13606,10262,10200,87,62,"RECORTES CERO-GV",10
17,"17172",452,336,335,5,1,"RECORTES CERO-GV",0
22,"22067",70,52,52,0,0,"RECORTES CERO-GV",0
22,"22177",96,69,68,0,1,"RECORTES CERO-GV",0
8,"8201",455,319,318,12,1,"RECORTES CERO-GV",0
8,"8004",208,177,177,1,0,"RECORTES CERO-GV",0
10,"10161",81,50,50,0,0,"RECORTES CERO-GV",0
31,"31174",100,55,55,0,0,"RECORTES CERO-GV",0
14,"14033",1239,875,856,8,19,"RECORTES CERO-GV",1
18,"18916",1815,1093,1086,6,7,"RECORTES CERO-GV",1
6,"6038",785,561,550,5,11,"RECORTES CERO-GV",0
41,"41002",1421,938,911,7,27,"RECORTES CERO-GV",0
4,"4074",2910,1813,1789,15,24,"RECORTES CERO-GV",2
50,"50171",99,69,69,2,0,"RECORTES CERO-GV",0
17,"17005",457,322,320,3,2,"RECORTES CERO-GV",2
50,"50068",1943,1299,1287,10,12,"RECORTES CERO-GV",0
8,"8179",636,466,465,2,1,"RECORTES CERO-GV",0
46,"46231",2403,1670,1652,11,18,"RECORTES CERO-GV",1
18,"18051",1092,735,718,8,17,"RECORTES CERO-GV",1
43,"43128",910,665,658,6,7,"RECORTES CERO-GV",1
17,"17174",164,130,130,4,0,"RECORTES CERO-GV",0
8,"8132",356,265,265,1,0,"RECORTES CERO-GV",0
26,"26125",2665,1885,1853,21,32,"RECORTES CERO-GV",3
8,"8248",5687,4187,4165,21,22,"RECORTES CERO-GV",1
11,"11903",1769,1116,1101,22,15,"RECORTES CERO-GV",0
18,"18117",497,360,354,1,6,"RECORTES CERO-GV",1
25,"25005",269,193,193,3,0,"RECORTES CERO-GV",0
26,"26012",37,28,28,1,0,"RECORTES CERO-GV",0
3,"3120",2433,1688,1652,13,36,"RECORTES CERO-GV",1
44,"44229",141,99,98,1,1,"RECORTES CERO-GV",0
10,"10163",348,239,238,2,1,"RECORTES CERO-GV",0
8,"8133",123,96,94,5,2,"RECORTES CERO-GV",0
50,"50295",48,41,41,0,0,"RECORTES CERO-GV",0
8,"8095",66,49,49,0,0,"RECORTES CERO-GV",0
7,"7021",229,154,150,3,4,"RECORTES CERO-GV",1
27,"27017",952,568,562,3,6,"RECORTES CERO-GV",0
18,"18119",1708,1264,1240,7,24,"RECORTES CERO-GV",0
36,"36013",2216,1298,1290,18,8,"RECORTES CERO-GV",3
20,"20055",17300,11784,11725,43,59,"RECORTES CERO-GV",12
44,"44230",149,111,110,2,1,"RECORTES CERO-GV",0
26,"26126",29,27,27,0,0,"RECORTES CERO-GV",0
3,"3035",627,485,485,2,0,"RECORTES CERO-GV",0
17,"17007",1763,1367,1359,9,8,"RECORTES CERO-GV",1
46,"46187",1292,924,920,4,4,"RECORTES CERO-GV",0
39,"39063",936,618,616,4,2,"RECORTES CERO-GV",0
25,"25252",553,380,379,2,1,"RECORTES CERO-GV",0
10,"10042",85,58,58,0,0,"RECORTES CERO-GV",0
27,"27050",2821,1980,1954,11,26,"RECORTES CERO-GV",3
43,"43077",453,306,304,1,2,"RECORTES CERO-GV",0
43,"43051",9194,6133,6048,44,85,"RECORTES CERO-GV",12
17,"17008",3605,2595,2577,8,18,"RECORTES CERO-GV",2
25,"25189",2181,1468,1461,11,7,"RECORTES CERO-GV",0
17,"17035",544,447,447,2,0,"RECORTES CERO-GV",0
10,"10166",307,197,195,0,2,"RECORTES CERO-GV",0
26,"26088",39,35,34,0,1,"RECORTES CERO-GV",0
26,"26015",185,140,138,2,2,"RECORTES CERO-GV",0
46,"46188",693,565,560,2,5,"RECORTES CERO-GV",1
18,"18120",266,204,204,4,0,"RECORTES CERO-GV",0
14,"14036",3677,2619,2555,39,64,"RECORTES CERO-GV",4
10,"10044",1405,968,955,11,13,"RECORTES CERO-GV",0
3,"3036",82,73,71,1,2,"RECORTES CERO-GV",0
32,"32017",1193,735,724,3,11,"RECORTES CERO-GV",0
39,"39064",1352,1007,990,3,17,"RECORTES CERO-GV",1
8,"8044",4156,2991,2976,16,15,"RECORTES CERO-GV",3
3,"3123",7579,5491,5416,50,75,"RECORTES CERO-GV",5
48,"48010",476,343,343,1,0,"RECORTES CERO-GV",1
6,"6045",467,347,346,6,1,"RECORTES CERO-GV",0
4,"4009",140,109,106,2,3,"RECORTES CERO-GV",0
8,"8158",3094,2261,2251,11,10,"RECORTES CERO-GV",2
21,"21030",1887,1493,1458,12,35,"RECORTES CERO-GV",2
6,"6091",3669,2581,2525,20,56,"RECORTES CERO-GV",3
39,"39065",222,166,163,0,3,"RECORTES CERO-GV",0
50,"50249",283,202,200,0,2,"RECORTES CERO-GV",3
46,"46189",469,374,367,2,7,"RECORTES CERO-GV",0
12,"12084",17785,12557,12422,108,135,"RECORTES CERO-GV",16
27,"27052",860,564,558,7,6,"RECORTES CERO-GV",0
46,"46121",106,91,90,1,1,"RECORTES CERO-GV",1
6,"6138",1021,677,658,5,19,"RECORTES CERO-GV",0
44,"44147",401,264,256,7,8,"RECORTES CERO-GV",0
21,"21061",5083,3325,3255,36,70,"RECORTES CERO-GV",1
43,"43079",364,290,289,2,1,"RECORTES CERO-GV",0
11,"11019",1757,1233,1172,13,61,"RECORTES CERO-GV",0
18,"18122",15994,11009,10773,109,236,"RECORTES CERO-GV",15
23,"23025",2725,1894,1870,11,24,"RECORTES CERO-GV",2
18,"18027",2598,1730,1706,12,24,"RECORTES CERO-GV",1
11,"11020",166773,111205,109956,1580,1249,"RECORTES CERO-GV",159
3,"3038",330,260,254,3,6,"RECORTES CERO-GV",0
36,"36018",3033,1951,1926,9,25,"RECORTES CERO-GV",3
20,"20059",8892,6505,6490,18,15,"RECORTES CERO-GV",2
50,"50098",162,119,118,1,1,"RECORTES CERO-GV",0
41,"41036",3903,2708,2645,35,63,"RECORTES CERO-GV",2
33,"33029",315,145,142,1,3,"RECORTES CERO-GV",0
22,"22188",75,50,50,1,0,"RECORTES CERO-GV",0
25,"25192",727,527,524,4,3,"RECORTES CERO-GV",0
46,"46122",2726,1957,1934,13,23,"RECORTES CERO-GV",2
44,"44090",66,49,49,0,0,"RECORTES CERO-GV",0
11,"11021",4914,3187,3069,61,118,"RECORTES CERO-GV",7
46,"46054",11389,8266,8190,54,76,"RECORTES CERO-GV",11
20,"20060",87,75,75,0,0,"RECORTES CERO-GV",0
15,"15052",4070,2512,2488,18,24,"RECORTES CERO-GV",0
10,"10131",12803,8477,8347,77,130,"RECORTES CERO-GV",14
25,"25163",230,162,161,0,1,"RECORTES CERO-GV",0
44,"44056",446,327,325,1,2,"RECORTES CERO-GV",0
6,"6005",1694,1167,1139,9,28,"RECORTES CERO-GV",0
14,"14068",517,388,378,3,10,"RECORTES CERO-GV",0
48,"48013",79353,53591,53205,331,386,"RECORTES CERO-GV",80
26,"26020",449,319,313,1,6,"RECORTES CERO-GV",1
23,"23027",711,547,539,5,8,"RECORTES CERO-GV",0
10,"10049",3752,2949,2864,25,85,"RECORTES CERO-GV",5
39,"39068",642,442,438,1,4,"RECORTES CERO-GV",0
17,"17181",3458,2454,2443,18,11,"RECORTES CERO-GV",0
33,"33031",33775,20484,20184,276,300,"RECORTES CERO-GV",23
44,"44236",60,38,38,0,0,"RECORTES CERO-GV",0
18,"18030",566,382,380,2,2,"RECORTES CERO-GV",0
31,"31185",461,291,290,1,1,"RECORTES CERO-GV",0
14,"14069",7340,5100,5000,69,100,"RECORTES CERO-GV",9
26,"26096",257,198,193,2,5,"RECORTES CERO-GV",0
20,"20001",253,163,163,1,0,"RECORTES CERO-GV",0
46,"46078",28484,19694,19520,173,174,"RECORTES CERO-GV",26
10,"10051",421,316,308,0,8,"RECORTES CERO-GV",0
41,"41010",4586,3218,3157,42,61,"RECORTES CERO-GV",4
25,"25102",647,484,482,5,2,"RECORTES CERO-GV",0
43,"43083",146,110,109,0,1,"RECORTES CERO-GV",0
22,"22048",12635,8889,8807,98,82,"RECORTES CERO-GV",23
26,"26022",177,130,128,0,2,"RECORTES CERO-GV",0
12,"12089",4555,3070,3045,22,25,"RECORTES CERO-GV",4
48,"48902",18987,12762,12670,88,92,"RECORTES CERO-GV",15
25,"25071",41,31,30,0,1,"RECORTES CERO-GV",0
46,"46056",176,142,142,0,0,"RECORTES CERO-GV",0
15,"15054",31805,19579,19321,335,258,"RECORTES CERO-GV",25
22,"22227",200,140,140,2,0,"RECORTES CERO-GV",0
18,"18032",247,164,163,1,1,"RECORTES CERO-GV",0
10,"10215",438,266,262,2,4,"RECORTES CERO-GV",0
7,"7052",4853,2765,2743,33,22,"RECORTES CERO-GV",14
31,"31078",2418,1752,1729,16,23,"RECORTES CERO-GV",3
4,"4053",12545,8864,8744,67,120,"RECORTES CERO-GV",7
43,"43137",1890,1373,1353,8,20,"RECORTES CERO-GV",1
46,"46239",446,357,352,1,5,"RECORTES CERO-GV",4
44,"44210",750,577,572,2,5,"RECORTES CERO-GV",0
12,"12008",228,195,194,1,1,"RECORTES CERO-GV",0
4,"4016",2136,1486,1467,13,19,"RECORTES CERO-GV",1
3,"3130",28,19,19,0,0,"RECORTES CERO-GV",0
8,"8140",4816,3541,3520,25,21,"RECORTES CERO-GV",0
21,"21006",3321,2197,2125,19,72,"RECORTES CERO-GV",3
46,"46125",852,660,650,5,10,"RECORTES CERO-GV",0
43,"43084",514,388,383,2,5,"RECORTES CERO-GV",1
8,"8210",4640,3226,3200,24,26,"RECORTES CERO-GV",2
8,"8072",10769,7632,7600,56,32,"RECORTES CERO-GV",7
44,"44153",1733,1131,1125,0,6,"RECORTES CERO-GV",0
48,"48045",5207,3851,3817,9,34,"RECORTES CERO-GV",1
46,"46194",15852,11124,11009,86,115,"RECORTES CERO-GV",7
30,"30025",5016,3663,3623,22,40,"RECORTES CERO-GV",4
43,"43094",2143,1558,1541,6,17,"RECORTES CERO-GV",1
50,"50287",253,189,188,11,1,"RECORTES CERO-GV",0
23,"23031",764,660,640,6,20,"RECORTES CERO-GV",0
22,"22905",287,217,217,1,0,"RECORTES CERO-GV",0
44,"44240",151,119,117,0,2,"RECORTES CERO-GV",0
32,"32027",989,670,660,5,10,"RECORTES CERO-GV",0
26,"26140",239,180,177,1,3,"RECORTES CERO-GV",0
12,"12009",17943,12389,12292,102,97,"RECORTES CERO-GV",12
41,"41013",4836,3174,3124,41,50,"RECORTES CERO-GV",0
18,"18003",14454,10162,9935,105,227,"RECORTES CERO-GV",12
25,"25073",559,377,377,2,0,"RECORTES CERO-GV",0
46,"46058",1734,1245,1230,8,15,"RECORTES CERO-GV",0
12,"12091",171,110,108,4,2,"RECORTES CERO-GV",0
3,"3131",176,129,126,1,3,"RECORTES CERO-GV",0
25,"25015",336,234,233,3,1,"RECORTES CERO-GV",1
10,"10179",272,209,209,2,0,"RECORTES CERO-GV",0
50,"50029",594,432,431,3,1,"RECORTES CERO-GV",0
50,"50181",999,748,732,3,16,"RECORTES CERO-GV",0
8,"8073",62934,45699,45407,281,292,"RECORTES CERO-GV",84
36,"36025",2127,1235,1221,5,14,"RECORTES CERO-GV",1
31,"31118",156,104,104,3,0,"RECORTES CERO-GV",0
18,"18133",2101,1496,1477,6,19,"RECORTES CERO-GV",0
32,"32029",441,286,283,2,3,"RECORTES CERO-GV",0
15,"15058",28761,20250,20098,261,152,"RECORTES CERO-GV",30
35,"35006",31373,20764,20476,189,288,"RECORTES CERO-GV",16
8,"8051",18570,14112,14054,86,58,"RECORTES CERO-GV",12
12,"12092",123,95,95,0,0,"RECORTES CERO-GV",0
17,"17074",536,403,401,1,2,"RECORTES CERO-GV",0
44,"44099",644,422,421,2,1,"RECORTES CERO-GV",0
23,"23069",5240,4153,4065,26,88,"RECORTES CERO-GV",4
15,"15029",5354,3082,3050,46,32,"RECORTES CERO-GV",4
26,"26143",260,197,192,1,5,"RECORTES CERO-GV",1
1,"1034",152,107,107,1,0,"RECORTES CERO-GV",0
44,"44213",68,47,47,0,0,"RECORTES CERO-GV",0
4,"4090",298,229,225,1,4,"RECORTES CERO-GV",0
44,"44063",63,52,52,0,0,"RECORTES CERO-GV",0
43,"43114",370,281,278,1,3,"RECORTES CERO-GV",0
17,"17101",566,389,382,1,7,"RECORTES CERO-GV",3
17,"17187",625,496,492,3,4,"RECORTES CERO-GV",0
6,"6152",1273,888,867,7,21,"RECORTES CERO-GV",0
31,"31011",715,483,481,5,2,"RECORTES CERO-GV",1
17,"17160",14756,9892,9852,58,40,"RECORTES CERO-GV",10
14,"14075",552,413,391,5,22,"RECORTES CERO-GV",1
8,"8191",5302,3872,3860,21,12,"RECORTES CERO-GV",2
46,"46038",302,221,220,1,1,"RECORTES CERO-GV",1
25,"25203",8809,5813,5770,40,43,"RECORTES CERO-GV",4
15,"15060",5871,4044,3978,58,66,"RECORTES CERO-GV",6
6,"6153",20252,14183,13924,154,259,"RECORTES CERO-GV",25
31,"31194",328,224,222,3,2,"RECORTES CERO-GV",0
10,"10904",714,487,473,8,14,"RECORTES CERO-GV",1
6,"6017",250,202,198,0,4,"RECORTES CERO-GV",0
25,"25111",114,86,86,2,0,"RECORTES CERO-GV",0
12,"12012",2622,2084,2056,12,28,"RECORTES CERO-GV",0
10,"10183",950,696,684,3,12,"RECORTES CERO-GV",0
25,"25019",4606,2860,2829,19,31,"RECORTES CERO-GV",2
4,"4092",2791,2058,2023,4,35,"RECORTES CERO-GV",0
22,"22201",264,188,186,3,2,"RECORTES CERO-GV",0
50,"50032",243,167,164,3,3,"RECORTES CERO-GV",0
44,"44065",55,33,32,0,1,"RECORTES CERO-GV",0
33,"33039",1646,1118,1110,8,8,"RECORTES CERO-GV",1
25,"25171",2117,1539,1534,5,5,"RECORTES CERO-GV",1
6,"6019",2010,1367,1330,23,37,"RECORTES CERO-GV",2
31,"31195",169,108,108,0,0,"RECORTES CERO-GV",0
44,"44158",1153,879,872,6,7,"RECORTES CERO-GV",0
23,"23072",1879,1389,1363,3,26,"RECORTES CERO-GV",1
17,"17021",119,89,87,0,2,"RECORTES CERO-GV",0
36,"36029",16126,10936,10771,96,165,"RECORTES CERO-GV",15
18,"18038",1042,782,760,5,22,"RECORTES CERO-GV",0
15,"15062",5597,3406,3360,16,46,"RECORTES CERO-GV",10
14,"14902",1113,877,851,15,26,"RECORTES CERO-GV",2
10,"10022",409,301,291,1,10,"RECORTES CERO-GV",0
20,"20071",15062,10442,10407,47,35,"RECORTES CERO-GV",16
46,"46244",59910,42120,41826,338,294,"RECORTES CERO-GV",53
23,"23001",912,723,712,2,11,"RECORTES CERO-GV",0
46,"46130",862,633,625,6,8,"RECORTES CERO-GV",1
10,"10062",389,303,299,2,4,"RECORTES CERO-GV",1
26,"26108",309,240,231,2,9,"RECORTES CERO-GV",0
43,"43012",3700,2882,2858,20,24,"RECORTES CERO-GV",3
26,"26148",154,125,122,3,3,"RECORTES CERO-GV",0
46,"46199",5878,4217,4182,21,35,"RECORTES CERO-GV",2
12,"12014",164,111,111,0,0,"RECORTES CERO-GV",0
44,"44246",1599,1012,1001,11,11,"RECORTES CERO-GV",0
17,"17105",248,187,186,2,1,"RECORTES CERO-GV",1
15,"15064",2103,1458,1447,20,11,"RECORTES CERO-GV",1
22,"22203",77,62,62,2,0,"RECORTES CERO-GV",0
10,"10064",1400,998,972,3,26,"RECORTES CERO-GV",0
22,"22235",88,69,68,1,1,"RECORTES CERO-GV",0
4,"4095",687,462,457,4,5,"RECORTES CERO-GV",0
17,"17191",163,140,140,1,0,"RECORTES CERO-GV",0
22,"22165",449,305,300,3,5,"RECORTES CERO-GV",0
50,"50260",35,31,31,0,0,"RECORTES CERO-GV",0
4,"4026",57,38,37,0,1,"RECORTES CERO-GV",0
18,"18138",2470,1597,1573,25,24,"RECORTES CERO-GV",1
10,"10187",431,288,281,0,7,"RECORTES CERO-GV",0
50,"50034",767,516,511,10,5,"RECORTES CERO-GV",0
14,"14051",1323,975,951,7,24,"RECORTES CERO-GV",0
31,"31089",236,168,167,1,1,"RECORTES CERO-GV",0
25,"25173",1646,1180,1169,6,11,"RECORTES CERO-GV",1
23,"23041",489,378,376,1,2,"RECORTES CERO-GV",1
31,"31199",138,86,84,0,2,"RECORTES CERO-GV",3
50,"50212",32,26,26,0,0,"RECORTES CERO-GV",0
50,"50187",55,42,42,0,0,"RECORTES CERO-GV",0
17,"17165",645,502,502,2,0,"RECORTES CERO-GV",2
25,"25174",390,312,312,1,0,"RECORTES CERO-GV",0
31,"31054",453,279,276,2,3,"RECORTES CERO-GV",0
39,"39080",3477,2404,2388,4,16,"RECORTES CERO-GV",1
41,"41094",6496,4733,4628,47,105,"RECORTES CERO-GV",3
43,"43093",3863,2728,2716,22,12,"RECORTES CERO-GV",5
6,"6161",289,199,197,1,2,"RECORTES CERO-GV",0
23,"23042",292,219,219,0,0,"RECORTES CERO-GV",1
50,"50111",181,130,130,1,0,"RECORTES CERO-GV",0
25,"25240",1366,1030,1021,4,9,"RECORTES CERO-GV",1
43,"43015",115,92,91,1,1,"RECORTES CERO-GV",0
29,"29086",770,479,476,5,3,"RECORTES CERO-GV",0
8,"8148",2344,1655,1646,13,9,"RECORTES CERO-GV",1
17,"17220",801,649,647,2,2,"RECORTES CERO-GV",0
31,"31238",119,96,95,4,1,"RECORTES CERO-GV",0
27,"27007",2723,1822,1776,23,46,"RECORTES CERO-GV",3
21,"21078",2641,1718,1670,10,48,"RECORTES CERO-GV",1
17,"17024",281,203,201,4,2,"RECORTES CERO-GV",0
50,"50172",174,125,123,2,2,"RECORTES CERO-GV",0
6,"6102",1027,834,815,3,19,"RECORTES CERO-GV",1
4,"4029",8830,5546,5482,43,64,"RECORTES CERO-GV",2
10,"10110",2226,1431,1400,7,31,"RECORTES CERO-GV",4
6,"6072",2211,1610,1586,11,24,"RECORTES CERO-GV",1
27,"27039",4467,3179,3121,47,58,"RECORTES CERO-GV",1
43,"43173",98,70,68,0,2,"RECORTES CERO-GV",0
39,"39025",8637,6256,6179,33,77,"RECORTES CERO-GV",1
20,"20015",1245,880,876,5,4,"RECORTES CERO-GV",0
46,"46248",4868,3434,3374,16,60,"RECORTES CERO-GV",2
12,"12017",145,111,110,2,1,"RECORTES CERO-GV",0
12,"12099",597,444,436,6,8,"RECORTES CERO-GV",0
36,"36034",3299,2155,2132,15,23,"RECORTES CERO-GV",4
48,"48915",339,245,243,0,2,"RECORTES CERO-GV",0
25,"25119",2258,1701,1686,11,15,"RECORTES CERO-GV",1
22,"22243",43,32,31,0,1,"RECORTES CERO-GV",0
14,"14054",13775,10464,10165,105,299,"RECORTES CERO-GV",8
31,"31094",105,70,70,1,0,"RECORTES CERO-GV",2
14,"14027",7890,5841,5726,78,115,"RECORTES CERO-GV",9
46,"46180",659,509,500,7,9,"RECORTES CERO-GV",0
17,"17110",1332,990,981,3,9,"RECORTES CERO-GV",1
36,"36035",14615,10011,9880,103,131,"RECORTES CERO-GV",18
29,"29042",14586,9793,9649,95,144,"RECORTES CERO-GV",21
10,"10153",281,183,181,0,2,"RECORTES CERO-GV",0
18,"18045",1065,720,690,11,30,"RECORTES CERO-GV",3
25,"25027",978,695,690,3,5,"RECORTES CERO-GV",0
10,"10071",126,78,71,0,7,"RECORTES CERO-GV",0
50,"50114",132,108,108,0,0,"RECORTES CERO-GV",0
43,"43017",112,94,94,1,0,"RECORTES CERO-GV",0
46,"46022",15392,10624,10546,69,78,"RECORTES CERO-GV",12
46,"46135",9817,7596,7558,58,38,"RECORTES CERO-GV",9
48,"48029",8681,6057,6027,41,30,"RECORTES CERO-GV",5
3,"3055",5265,3741,3697,16,44,"RECORTES CERO-GV",3
43,"43018",384,297,297,2,0,"RECORTES CERO-GV",0
17,"17112",198,148,147,3,1,"RECORTES CERO-GV",0
25,"25029",1590,1190,1185,4,5,"RECORTES CERO-GV",0
26,"26155",145,120,119,0,1,"RECORTES CERO-GV",0
50,"50038",1404,1024,1007,15,17,"RECORTES CERO-GV",1
41,"41098",5161,3792,3732,33,60,"RECORTES CERO-GV",4
46,"46204",6625,4946,4882,52,64,"RECORTES CERO-GV",5
22,"22032",102,69,68,1,1,"RECORTES CERO-GV",1
15,"15039",1224,802,785,9,17,"RECORTES CERO-GV",1
44,"44167",34,26,26,0,0,"RECORTES CERO-GV",0
21,"21021",12545,7816,7696,104,120,"RECORTES CERO-GV",10
17,"17169",2511,1901,1890,8,11,"RECORTES CERO-GV",2
8,"8244",6099,4733,4706,39,27,"RECORTES CERO-GV",8
15,"15071",7780,4937,4848,34,89,"RECORTES CERO-GV",10
26,"26041",109,67,65,0,2,"RECORTES CERO-GV",0
3,"3903",2612,1838,1814,7,24,"RECORTES CERO-GV",1
17,"17028",297,216,214,2,2,"RECORTES CERO-GV",0
25,"25122",1929,1408,1398,21,10,"RECORTES CERO-GV",2
12,"12021",4398,3314,3277,32,37,"RECORTES CERO-GV",2
10,"10115",3460,2584,2503,15,81,"RECORTES CERO-GV",4
18,"18178",664,474,467,1,7,"RECORTES CERO-GV",1
23,"23084",902,627,621,4,6,"RECORTES CERO-GV",0
10,"10197",106,74,74,0,0,"RECORTES CERO-GV",0
3,"3001",337,260,258,0,2,"RECORTES CERO-GV",1
20,"20049",4195,2918,2901,12,17,"RECORTES CERO-GV",0
17,"17197",128,97,97,0,0,"RECORTES CERO-GV",0
41,"41027",4007,2628,2546,33,82,"RECORTES CERO-GV",9
22,"22212",69,52,52,1,0,"RECORTES CERO-GV",0
22,"22099",490,349,343,2,6,"RECORTES CERO-GV",0
26,"26160",731,539,533,4,6,"RECORTES CERO-GV",0
4,"4901",490,343,343,2,0,"RECORTES CERO-GV",0
46,"46069",152,112,111,1,1,"RECORTES CERO-GV",0
17,"17029",207,154,154,1,0,"RECORTES CERO-GV",0
32,"32046",1089,679,670,4,9,"RECORTES CERO-GV",4
39,"39002",3408,2360,2323,7,37,"RECORTES CERO-GV",1
8,"8003",7213,5425,5409,41,16,"RECORTES CERO-GV",7
10,"10117",238,133,130,0,3,"RECORTES CERO-GV",0
3,"3030",559,442,433,2,9,"RECORTES CERO-GV",0
48,"48060",3625,2429,2418,12,11,"RECORTES CERO-GV",0
17,"17225",205,150,150,1,0,"RECORTES CERO-GV",0
26,"26008",1821,1310,1290,15,20,"RECORTES CERO-GV",3
8,"8223",1897,1345,1341,10,4,"RECORTES CERO-GV",0
25,"25031",57,32,32,0,0,"RECORTES CERO-GV",0
10,"10199",154,99,99,2,0,"RECORTES CERO-GV",0
43,"43178",1435,1071,1066,2,5,"RECORTES CERO-GV",0
43,"43021",349,245,243,2,2,"RECORTES CERO-GV",0
17,"17086",1769,1116,1109,6,7,"RECORTES CERO-GV",1
14,"14059",679,527,521,11,6,"RECORTES CERO-GV",0
44,"44080",281,202,199,0,3,"RECORTES CERO-GV",0
12,"12024",138,107,107,1,0,"RECORTES CERO-GV",0
30,"30039",20442,13299,13167,84,132,"RECORTES CERO-GV",15
32,"32047",1761,1192,1175,10,17,"RECORTES CERO-GV",0
46,"46184",26514,19610,19399,180,211,"RECORTES CERO-GV",10
18,"18049",588,418,415,4,3,"RECORTES CERO-GV",0
44,"44082",84,66,66,0,0,"RECORTES CERO-GV",0
25,"25032",65,53,52,0,1,"RECORTES CERO-GV",0
39,"39003",261,189,187,2,2,"RECORTES CERO-GV",0
18,"18149",5408,3926,3859,42,67,"RECORTES CERO-GV",1
31,"31210",186,131,130,2,1,"RECORTES CERO-GV",1
31,"31101",1428,986,981,6,5,"RECORTES CERO-GV",6
12,"12129",1783,1207,1184,16,23,"RECORTES CERO-GV",1
44,"44084",54,46,46,1,0,"RECORTES CERO-GV",0
1,"1013",710,469,465,2,4,"RECORTES CERO-GV",0
41,"41102",14773,10377,10028,174,349,"RECORTES CERO-GV",12
17,"17061",180,141,139,1,2,"RECORTES CERO-GV",0
50,"50119",876,633,625,11,8,"RECORTES CERO-GV",0
29,"29094",59795,39350,38854,454,496,"RECORTES CERO-GV",44
6,"6084",1061,780,769,11,11,"RECORTES CERO-GV",2
29,"29048",1364,1053,1039,8,14,"RECORTES CERO-GV",1
8,"8005",6425,4830,4816,28,14,"RECORTES CERO-GV",6
38,"38010",3969,2463,2418,11,45,"RECORTES CERO-GV",1
32,"32086",2531,1348,1332,11,16,"RECORTES CERO-GV",0
44,"44022",464,330,325,1,5,"RECORTES CERO-GV",0
29,"29049",2890,2069,2034,12,35,"RECORTES CERO-GV",4
26,"26165",336,248,242,3,6,"RECORTES CERO-GV",0
25,"25218",88,76,75,2,1,"RECORTES CERO-GV",0
50,"50043",241,155,154,1,1,"RECORTES CERO-GV",0
50,"50270",38,26,25,0,1,"RECORTES CERO-GV",0
39,"39089",131,82,82,0,0,"RECORTES CERO-GV",0
48,"48035",406,314,314,0,0,"RECORTES CERO-GV",0
22,"22106",20,13,13,2,0,"RECORTES CERO-GV",0
46,"46209",1903,1406,1383,5,23,"RECORTES CERO-GV",0
18,"18150",6964,4717,4622,51,95,"RECORTES CERO-GV",4
15,"15014",3836,2191,2158,27,33,"RECORTES CERO-GV",4
43,"43076",454,336,335,1,1,"RECORTES CERO-GV",1
31,"31116",57,27,27,3,0,"RECORTES CERO-GV",0
3,"3139",23126,14650,14522,127,128,"RECORTES CERO-GV",19
50,"50003",117,89,89,1,0,"RECORTES CERO-GV",0
29,"29096",2757,1847,1790,19,57,"RECORTES CERO-GV",2
46,"46027",924,746,737,2,9,"RECORTES CERO-GV",0
31,"31214",87,55,54,0,1,"RECORTES CERO-GV",0
6,"6088",12527,8326,8198,89,128,"RECORTES CERO-GV",19
14,"14063",994,731,719,8,12,"RECORTES CERO-GV",1
8,"8156",11254,8440,8411,58,29,"RECORTES CERO-GV",6
41,"41903",6776,4616,4494,72,122,"RECORTES CERO-GV",7
46,"46073",1066,823,817,11,6,"RECORTES CERO-GV",1
17,"17034",7289,4880,4862,23,18,"RECORTES CERO-GV",3
6,"6043",677,493,488,5,5,"RECORTES CERO-GV",2
22,"22182",227,132,131,3,1,"RECORTES CERO-GV",0
33,"33054",1601,1025,1010,17,15,"RECORTES CERO-GV",3
22,"22107",102,53,53,0,0,"RECORTES CERO-GV",0
46,"46005",23129,16610,16437,148,173,"RECORTES CERO-GV",21
8,"8295",11290,8091,8054,72,37,"RECORTES CERO-GV",17
27,"27018",3211,1830,1800,17,30,"RECORTES CERO-GV",1
29,"29068",7833,4897,4806,50,91,"RECORTES CERO-GV",4
32,"32089",1206,740,726,8,14,"RECORTES CERO-GV",0
7,"7044",8812,5679,5569,67,110,"RECORTES CERO-GV",9
48,"48094",3121,2201,2188,7,13,"RECORTES CERO-GV",1
18,"18152",928,663,660,3,3,"RECORTES CERO-GV",0
43,"43026",756,576,574,1,2,"RECORTES CERO-GV",0
43,"43105",155,126,123,4,3,"RECORTES CERO-GV",0
44,"44175",112,76,75,1,1,"RECORTES CERO-GV",0
8,"8296",1869,1412,1408,10,4,"RECORTES CERO-GV",1
41,"41033",4958,3299,3250,38,49,"RECORTES CERO-GV",0
12,"12109",646,489,482,4,7,"RECORTES CERO-GV",0
26,"26169",66,51,50,0,1,"RECORTES CERO-GV",0
41,"41090",3489,2560,2467,27,93,"RECORTES CERO-GV",0
41,"41034",23576,15461,15214,264,247,"RECORTES CERO-GV",21
22,"22221",92,56,55,0,1,"RECORTES CERO-GV",1
44,"44176",152,114,113,1,1,"RECORTES CERO-GV",0
23,"23021",512,406,399,2,7,"RECORTES CERO-GV",0
27,"27020",3365,2544,2500,42,44,"RECORTES CERO-GV",0
31,"31107",1671,1204,1182,12,22,"RECORTES CERO-GV",0
10,"10004",692,482,473,8,9,"RECORTES CERO-GV",0
8,"8021",60,44,44,1,0,"RECORTES CERO-GV",0
44,"44088",24,23,23,0,0,"RECORTES CERO-GV",0
31,"31108",1819,1348,1325,13,23,"RECORTES CERO-GV",4
15,"15018",1087,680,670,13,10,"RECORTES CERO-GV",1
26,"26170",423,303,301,2,2,"RECORTES CERO-GV",1
8,"8182",2922,2041,2031,10,10,"RECORTES CERO-GV",4
31,"31255",103,79,79,0,0,"RECORTES CERO-GV",0
1,"1063",1852,1316,1303,6,13,"RECORTES CERO-GV",4
32,"32018",1181,883,871,5,12,"RECORTES CERO-GV",1
43,"43158",74,52,50,0,2,"RECORTES CERO-GV",0
14,"14066",5748,4116,4035,59,81,"RECORTES CERO-GV",2
4,"4010",587,421,409,5,12,"RECORTES CERO-GV",0
12,"12031",3960,2913,2869,13,44,"RECORTES CERO-GV",0
6,"6047",829,618,605,1,13,"RECORTES CERO-GV",0
41,"41007",12488,7657,7421,126,236,"RECORTES CERO-GV",11
48,"48040",1303,933,926,7,7,"RECORTES CERO-GV",0
30,"30902",8294,5235,5174,29,61,"RECORTES CERO-GV",5
6,"6048",821,666,653,1,13,"RECORTES CERO-GV",1
39,"39094",840,611,611,2,0,"RECORTES CERO-GV",0
43,"43107",387,285,285,3,0,"RECORTES CERO-GV",0
15,"15019",25981,15866,15672,207,194,"RECORTES CERO-GV",14
50,"50125",340,230,229,2,1,"RECORTES CERO-GV",0
39,"39010",610,457,453,1,4,"RECORTES CERO-GV",0
8,"8091",5428,4048,4024,20,24,"RECORTES CERO-GV",14
8,"8160",317,234,234,0,0,"RECORTES CERO-GV",0
48,"48041",687,548,547,4,1,"RECORTES CERO-GV",0
10,"10089",1334,864,837,8,27,"RECORTES CERO-GV",0
31,"31221",1228,823,815,6,8,"RECORTES CERO-GV",0
22,"22014",227,164,162,5,2,"RECORTES CERO-GV",1
10,"10090",489,307,302,1,5,"RECORTES CERO-GV",0
8,"8069",3323,2555,2540,21,15,"RECORTES CERO-GV",1
31,"31002",431,294,290,3,4,"RECORTES CERO-GV",0
18,"18158",7978,4861,4771,43,90,"RECORTES CERO-GV",1
43,"43134",281,217,215,5,2,"RECORTES CERO-GV",1
8,"8230",7648,5797,5774,40,23,"RECORTES CERO-GV",7
22,"22112",9525,6317,6245,91,72,"RECORTES CERO-GV",6
3,"3012",1138,863,846,4,17,"RECORTES CERO-GV",0
29,"29056",1047,708,696,5,12,"RECORTES CERO-GV",2
50,"50074",6156,4100,4022,33,78,"RECORTES CERO-GV",9
29,"29902",2593,1561,1533,15,28,"RECORTES CERO-GV",1
50,"50202",124,76,74,0,2,"RECORTES CERO-GV",0
4,"4050",742,465,464,0,1,"RECORTES CERO-GV",0
3,"3068",41,38,37,0,1,"RECORTES CERO-GV",0
22,"22113",478,335,333,6,2,"RECORTES CERO-GV",0
21,"21004",1586,994,964,23,30,"RECORTES CERO-GV",4
43,"43135",339,255,255,0,0,"RECORTES CERO-GV",1
15,"15053",7469,4622,4579,44,43,"RECORTES CERO-GV",2
31,"31223",953,667,654,4,13,"RECORTES CERO-GV",0
22,"22902",206,147,144,1,3,"RECORTES CERO-GV",0
17,"17040",551,440,439,5,1,"RECORTES CERO-GV",1
41,"41038",102752,71545,70538,980,1007,"RECORTES CERO-GV",135
36,"36051",14358,9408,9255,86,153,"RECORTES CERO-GV",11
20,"20032",8654,6000,5972,21,28,"RECORTES CERO-GV",5
17,"17154",101,76,76,0,0,"RECORTES CERO-GV",0
31,"31150",200,120,119,1,1,"RECORTES CERO-GV",0
17,"17903",883,681,676,3,5,"RECORTES CERO-GV",1
32,"32060",753,520,515,5,5,"RECORTES CERO-GV",0
44,"44059",562,411,407,2,4,"RECORTES CERO-GV",0
22,"22226",761,537,530,13,7,"RECORTES CERO-GV",0
14,"14070",1280,911,902,4,9,"RECORTES CERO-GV",0
32,"32024",4817,3064,3014,34,50,"RECORTES CERO-GV",6
46,"46903",6306,4762,4743,44,19,"RECORTES CERO-GV",3
41,"41011",15462,11019,10696,183,323,"RECORTES CERO-GV",13
4,"4086",1631,1128,1114,3,14,"RECORTES CERO-GV",0
3,"3099",43101,30222,29885,196,337,"RECORTES CERO-GV",16
10,"10175",1351,918,901,8,17,"RECORTES CERO-GV",0
50,"50253",379,294,290,1,4,"RECORTES CERO-GV",0
10,"10053",279,171,169,1,2,"RECORTES CERO-GV",0
50,"50204",2396,1723,1712,17,11,"RECORTES CERO-GV",0
50,"50278",175,133,131,2,2,"RECORTES CERO-GV",0
26,"26138",4504,2982,2930,32,52,"RECORTES CERO-GV",5
46,"46216",5277,4146,4111,42,35,"RECORTES CERO-GV",2
3,"3070",2115,1399,1376,9,23,"RECORTES CERO-GV",0
32,"32025",1014,731,718,5,13,"RECORTES CERO-GV",1
25,"25227",656,476,476,2,0,"RECORTES CERO-GV",0
10,"10095",317,245,239,0,6,"RECORTES CERO-GV",0
43,"43111",2129,1412,1401,8,11,"RECORTES CERO-GV",2
11,"11025",4374,2808,2759,30,49,"RECORTES CERO-GV",3
8,"8013",1287,982,972,6,10,"RECORTES CERO-GV",1
43,"43006",676,462,462,3,0,"RECORTES CERO-GV",3
43,"43058",95,78,78,0,0,"RECORTES CERO-GV",0
6,"6071",238,192,187,2,5,"RECORTES CERO-GV",0
46,"46171",16446,11616,11499,94,117,"RECORTES CERO-GV",14
36,"36033",12305,8759,8597,67,162,"RECORTES CERO-GV",10
22,"22018",303,216,215,3,1,"RECORTES CERO-GV",0
25,"25200",318,245,245,0,0,"RECORTES CERO-GV",0
25,"25044",178,144,142,0,2,"RECORTES CERO-GV",0
3,"3072",352,281,277,3,4,"RECORTES CERO-GV",1
31,"31117",583,373,372,3,1,"RECORTES CERO-GV",1
22,"22116",1342,915,905,11,10,"RECORTES CERO-GV",1
25,"25228",3143,2261,2250,18,11,"RECORTES CERO-GV",2
18,"18163",311,206,204,0,2,"RECORTES CERO-GV",0
25,"25905",366,281,276,4,5,"RECORTES CERO-GV",0
50,"50053",643,476,466,3,10,"RECORTES CERO-GV",0
3,"3101",4933,3502,3462,16,40,"RECORTES CERO-GV",4
10,"10015",630,429,424,1,5,"RECORTES CERO-GV",1
10,"10097",107,84,80,0,4,"RECORTES CERO-GV",0
22,"22019",176,128,126,1,2,"RECORTES CERO-GV",0
29,"29004",283,222,218,3,4,"RECORTES CERO-GV",0
48,"48046",12626,9300,9250,31,50,"RECORTES CERO-GV",12
31,"31008",61,42,42,0,0,"RECORTES CERO-GV",0
44,"44097",126,76,73,0,3,"RECORTES CERO-GV",0
22,"22051",90,72,72,2,0,"RECORTES CERO-GV",0
39,"39101",231,134,132,2,2,"RECORTES CERO-GV",0
50,"50055",3635,2298,2244,36,54,"RECORTES CERO-GV",4
8,"8235",3875,3004,2996,19,8,"RECORTES CERO-GV",4
6,"6151",1049,746,741,5,5,"RECORTES CERO-GV",1
10,"10057",126,90,89,1,1,"RECORTES CERO-GV",0
8,"8096",43926,32120,31960,217,160,"RECORTES CERO-GV",44
41,"41015",5426,3778,3639,41,139,"RECORTES CERO-GV",5
23,"23905",1828,1320,1302,12,18,"RECORTES CERO-GV",1
46,"46060",9278,6796,6724,49,72,"RECORTES CERO-GV",6
50,"50256",70,43,43,0,0,"RECORTES CERO-GV",0
3,"3074",1766,1347,1336,4,11,"RECORTES CERO-GV",1
10,"10017",775,554,545,1,9,"RECORTES CERO-GV",0
14,"14046",4442,3283,3190,34,93,"RECORTES CERO-GV",5
8,"8028",1125,744,743,7,1,"RECORTES CERO-GV",1
46,"46014",3156,2324,2294,13,30,"RECORTES CERO-GV",2
10,"10181",676,470,462,2,8,"RECORTES CERO-GV",1
25,"25231",483,387,385,0,2,"RECORTES CERO-GV",0
10,"10058",979,628,599,6,29,"RECORTES CERO-GV",0
43,"43035",233,182,182,5,0,"RECORTES CERO-GV",0
29,"29034",461,333,332,2,1,"RECORTES CERO-GV",0
26,"26028",135,111,110,3,1,"RECORTES CERO-GV",0
12,"12068",41,22,21,0,1,"RECORTES CERO-GV",0
31,"31120",376,211,209,7,2,"RECORTES CERO-GV",0
20,"20007",337,223,221,2,2,"RECORTES CERO-GV",0
23,"23035",1111,877,856,2,21,"RECORTES CERO-GV",1
44,"44008",1556,1109,1100,7,9,"RECORTES CERO-GV",0
20,"20008",713,424,424,5,0,"RECORTES CERO-GV",0
36,"36057",238417,165843,164264,1641,1579,"RECORTES CERO-GV",256
30,"30004",1129,838,833,1,5,"RECORTES CERO-GV",1
35,"35007",517,347,345,2,2,"RECORTES CERO-GV",0
46,"46015",7519,5575,5532,34,43,"RECORTES CERO-GV",3
22,"22233",81,53,53,0,0,"RECORTES CERO-GV",0
46,"46220",49112,33766,33424,312,342,"RECORTES CERO-GV",50
39,"39019",2232,1628,1603,10,25,"RECORTES CERO-GV",0
46,"46152",90,63,63,0,0,"RECORTES CERO-GV",0
25,"25047",956,745,736,14,9,"RECORTES CERO-GV",0
50,"50133",98,76,76,0,0,"RECORTES CERO-GV",0
44,"44187",193,147,146,0,1,"RECORTES CERO-GV",0
8,"8306",535,368,368,5,0,"RECORTES CERO-GV",2
43,"43037",18216,11749,11672,70,77,"RECORTES CERO-GV",26
3,"3076",8846,6105,6029,40,76,"RECORTES CERO-GV",5
15,"15093",4012,2413,2386,24,27,"RECORTES CERO-GV",1
8,"8099",753,529,529,4,0,"RECORTES CERO-GV",0
12,"12095",950,723,712,5,11,"RECORTES CERO-GV",0
17,"17048",6284,4077,4048,34,29,"RECORTES CERO-GV",5
44,"44189",44,35,35,0,0,"RECORTES CERO-GV",0
12,"12119",139,97,94,3,3,"RECORTES CERO-GV",0
31,"31014",268,168,168,2,0,"RECORTES CERO-GV",0
22,"22055",305,242,235,2,7,"RECORTES CERO-GV",0
30,"30030",321454,235061,233183,1744,1878,"RECORTES CERO-GV",291
44,"44129",35,29,29,1,0,"RECORTES CERO-GV",0
17,"17189",1481,1228,1223,5,5,"RECORTES CERO-GV",0
48,"48023",579,451,448,0,3,"RECORTES CERO-GV",0
14,"14049",16185,11561,11323,145,238,"RECORTES CERO-GV",21
46,"46115",330,219,213,0,6,"RECORTES CERO-GV",0
25,"25234",4139,2786,2772,13,14,"RECORTES CERO-GV",2
1,"1042",911,680,671,8,9,"RECORTES CERO-GV",0
35,"35009",20229,13378,13201,95,177,"RECORTES CERO-GV",11
39,"39021",464,370,364,1,6,"RECORTES CERO-GV",0
25,"25049",156,110,109,1,1,"RECORTES CERO-GV",0
31,"31015",1989,1399,1386,17,13,"RECORTES CERO-GV",4
31,"31235",156,112,108,1,4,"RECORTES CERO-GV",0
6,"6067",1897,1268,1242,14,26,"RECORTES CERO-GV",2
46,"46017",33041,23469,23277,173,192,"RECORTES CERO-GV",16
18,"18103",714,500,498,3,2,"RECORTES CERO-GV",0
31,"31161",350,261,256,1,5,"RECORTES CERO-GV",0
10,"10106",126,102,102,0,0,"RECORTES CERO-GV",0
43,"43118",422,338,338,0,0,"RECORTES CERO-GV",0
39,"39078",1410,1004,997,5,7,"RECORTES CERO-GV",0
3,"3078",468,340,336,0,4,"RECORTES CERO-GV",0
7,"7061",9451,5735,5666,60,69,"RECORTES CERO-GV",6
31,"31016",7790,5541,5502,56,39,"RECORTES CERO-GV",23
43,"43039",101,77,77,0,0,"RECORTES CERO-GV",0
50,"50285",657,448,442,4,6,"RECORTES CERO-GV",0
48,"48052",1562,1220,1210,5,10,"RECORTES CERO-GV",3
18,"18071",5636,3909,3807,45,102,"RECORTES CERO-GV",3
43,"43119",849,591,588,8,3,"RECORTES CERO-GV",0
12,"12121",1043,878,856,5,22,"RECORTES CERO-GV",0
26,"26070",152,125,122,1,3,"RECORTES CERO-GV",0
38,"38001",21069,10844,10777,63,67,"RECORTES CERO-GV",9
44,"44249",40,30,30,0,0,"RECORTES CERO-GV",0
31,"31090",139,67,67,0,0,"RECORTES CERO-GV",0
4,"4097",231,173,173,1,0,"RECORTES CERO-GV",0
8,"8286",2943,2051,2042,12,9,"RECORTES CERO-GV",1
12,"12044",442,371,368,1,3,"RECORTES CERO-GV",0
41,"41049",9515,6961,6843,115,118,"RECORTES CERO-GV",4
18,"18173",8999,5958,5871,50,87,"RECORTES CERO-GV",3
6,"6070",7668,5404,5228,59,176,"RECORTES CERO-GV",12
46,"46155",972,731,716,3,15,"RECORTES CERO-GV",0
27,"27006",2441,1479,1460,11,19,"RECORTES CERO-GV",1
15,"15004",4924,3333,3292,38,41,"RECORTES CERO-GV",2
32,"32001",5100,3377,3333,32,44,"RECORTES CERO-GV",5
31,"31127",131,90,86,0,4,"RECORTES CERO-GV",0
50,"50188",26,23,23,0,0,"RECORTES CERO-GV",0
12,"12098",529,417,413,3,4,"RECORTES CERO-GV",0
46,"46201",62,40,40,0,0,"RECORTES CERO-GV",0
26,"26036",16989,11463,11260,101,203,"RECORTES CERO-GV",21
31,"31200",745,489,483,1,6,"RECORTES CERO-GV",1
31,"31019",1831,1231,1224,17,7,"RECORTES CERO-GV",3
7,"7042",10846,6354,6299,77,55,"RECORTES CERO-GV",15
25,"25208",337,242,241,2,1,"RECORTES CERO-GV",0
43,"43164",310,235,231,3,4,"RECORTES CERO-GV",1
10,"10096",3311,2248,2201,15,47,"RECORTES CERO-GV",1
46,"46103",1354,993,978,8,15,"RECORTES CERO-GV",0
31,"31165",2772,1946,1930,16,16,"RECORTES CERO-GV",9
50,"50189",678,494,487,6,7,"RECORTES CERO-GV",1
50,"50138",45,37,37,3,0,"RECORTES CERO-GV",0
50,"50012",94,76,72,0,4,"RECORTES CERO-GV",0
44,"44133",15,12,12,0,0,"RECORTES CERO-GV",0
26,"26001",199,145,141,3,4,"RECORTES CERO-GV",0
8,"8264",4608,3459,3444,30,15,"RECORTES CERO-GV",2
31,"31202",4360,2806,2767,30,39,"RECORTES CERO-GV",8
20,"20045",47031,30933,30787,172,146,"RECORTES CERO-GV",61
4,"4030",1052,690,678,6,12,"RECORTES CERO-GV",0
7,"7033",28539,15238,15070,187,168,"RECORTES CERO-GV",33
8,"8080",40,27,27,3,0,"RECORTES CERO-GV",0
44,"44016",424,299,297,1,2,"RECORTES CERO-GV",0
6,"6073",703,451,441,6,10,"RECORTES CERO-GV",1
18,"18175",11793,8099,7943,62,156,"RECORTES CERO-GV",6
1,"1003",1166,843,837,6,6,"RECORTES CERO-GV",1
50,"50288",3440,2513,2486,26,27,"RECORTES CERO-GV",4
48,"48056",980,731,728,3,3,"RECORTES CERO-GV",0
21,"21019",592,397,389,6,8,"RECORTES CERO-GV",0
17,"17222",104,87,87,1,0,"RECORTES CERO-GV",0
12,"12020",118,104,103,1,1,"RECORTES CERO-GV",0
15,"15007",3164,2081,2060,24,21,"RECORTES CERO-GV",2
31,"31131",913,672,664,8,8,"RECORTES CERO-GV",1
8,"8243",154,125,125,2,0,"RECORTES CERO-GV",1
17,"17141",6019,3855,3833,43,22,"RECORTES CERO-GV",2
18,"18176",242,164,161,2,3,"RECORTES CERO-GV",0
26,"26115",23,22,21,3,1,"RECORTES CERO-GV",0
22,"22173",219,147,141,3,6,"RECORTES CERO-GV",0
32,"32078",1099,715,707,4,8,"RECORTES CERO-GV",0
44,"44109",99,64,64,0,0,"RECORTES CERO-GV",0
44,"44195",82,58,57,0,1,"RECORTES CERO-GV",0
6,"6076",825,573,562,1,11,"RECORTES CERO-GV",0
23,"23081",1494,1084,1061,9,23,"RECORTES CERO-GV",1
50,"50289",53,42,42,1,0,"RECORTES CERO-GV",0
22,"22131",84,62,58,5,4,"RECORTES CERO-GV",0
15,"15008",5646,3859,3836,52,23,"RECORTES CERO-GV",4
44,"44196",121,88,88,0,0,"RECORTES CERO-GV",0
23,"23009",12849,9722,9572,99,150,"RECORTES CERO-GV",4
22,"22208",192,150,147,1,3,"RECORTES CERO-GV",0
43,"43149",690,512,509,3,3,"RECORTES CERO-GV",1
41,"41081",30061,21488,21059,331,429,"RECORTES CERO-GV",31
8,"8904",10516,7068,7025,54,43,"RECORTES CERO-GV",14
20,"20048",183,112,112,0,0,"RECORTES CERO-GV",0
31,"31024",100,52,52,0,0,"RECORTES CERO-GV",0
6,"6077",319,234,229,2,5,"RECORTES CERO-GV",0
50,"50290",360,260,255,5,5,"RECORTES CERO-GV",0
46,"46159",23038,16719,16596,127,123,"RECORTES CERO-GV",24
46,"46068",345,283,279,2,4,"RECORTES CERO-GV",0
8,"8175",3369,2388,2372,18,16,"RECORTES CERO-GV",2
6,"6123",4502,2989,2894,29,95,"RECORTES CERO-GV",4
43,"43176",746,564,561,2,3,"RECORTES CERO-GV",0
44,"44137",187,139,139,0,0,"RECORTES CERO-GV",0
43,"43045",143,114,113,0,1,"RECORTES CERO-GV",0
6,"6033",1276,986,972,5,14,"RECORTES CERO-GV",1
44,"44197",51,35,35,1,0,"RECORTES CERO-GV",0
25,"25057",208,151,149,4,2,"RECORTES CERO-GV",0
50,"50291",95,76,76,0,0,"RECORTES CERO-GV",0
44,"44111",78,61,61,0,0,"RECORTES CERO-GV",0
25,"25150",167,132,130,2,2,"RECORTES CERO-GV",0
41,"41083",1145,821,814,6,7,"RECORTES CERO-GV",0
33,"33076",12115,7519,7456,76,63,"RECORTES CERO-GV",6
10,"10116",3737,2579,2507,34,72,"RECORTES CERO-GV",4
20,"20019",9892,6740,6717,40,23,"RECORTES CERO-GV",8
18,"18179",493,315,309,8,6,"RECORTES CERO-GV",0
20,"20020",114,64,64,0,0,"RECORTES CERO-GV",0
12,"12103",87,61,60,0,1,"RECORTES CERO-GV",0
10,"10077",626,444,441,5,3,"RECORTES CERO-GV",2
26,"26161",8,8,8,0,0,"RECORTES CERO-GV",0
4,"4035",8439,5822,5768,45,54,"RECORTES CERO-GV",5
12,"12078",334,224,221,2,3,"RECORTES CERO-GV",0
15,"15073",21725,13008,12820,126,188,"RECORTES CERO-GV",17
23,"23098",847,704,700,0,4,"RECORTES CERO-GV",0
17,"17058",176,128,128,0,0,"RECORTES CERO-GV",0
29,"29018",2009,1421,1362,17,59,"RECORTES CERO-GV",0
21,"21024",464,328,312,1,16,"RECORTES CERO-GV",0
22,"22176",171,140,138,2,2,"RECORTES CERO-GV",0
25,"25194",410,292,289,3,3,"RECORTES CERO-GV",0
23,"23086",11427,7984,7735,81,249,"RECORTES CERO-GV",20
1,"1056",202,107,107,0,0,"RECORTES CERO-GV",0
18,"18180",636,410,401,2,9,"RECORTES CERO-GV",0
7,"7039",5019,3066,3017,23,49,"RECORTES CERO-GV",6
26,"26082",101,79,79,0,0,"RECORTES CERO-GV",0
31,"31247",141,99,96,1,3,"RECORTES CERO-GV",1
8,"8108",5181,3880,3861,30,19,"RECORTES CERO-GV",7
38,"38008",5699,3719,3669,26,50,"RECORTES CERO-GV",5
46,"46093",2151,1652,1640,10,12,"RECORTES CERO-GV",0
17,"17060",409,300,298,1,2,"RECORTES CERO-GV",0
50,"50194",80,51,51,0,0,"RECORTES CERO-GV",0
46,"46230",14116,10038,9946,63,92,"RECORTES CERO-GV",7
43,"43127",775,607,606,3,1,"RECORTES CERO-GV",0
41,"41001",1558,1129,1104,6,25,"RECORTES CERO-GV",1
20,"20022",849,574,571,8,3,"RECORTES CERO-GV",0
1,"1057",235,196,194,0,2,"RECORTES CERO-GV",0
27,"27015",3995,2518,2460,25,58,"RECORTES CERO-GV",0
31,"31029",913,606,601,14,5,"RECORTES CERO-GV",2
26,"26009",394,282,278,1,4,"RECORTES CERO-GV",0
50,"50146",189,149,149,3,0,"RECORTES CERO-GV",0
48,"48006",307,242,240,3,2,"RECORTES CERO-GV",0
26,"26010",85,66,63,1,3,"RECORTES CERO-GV",0
50,"50294",65,45,45,0,0,"RECORTES CERO-GV",0
12,"12053",2040,1587,1579,8,8,"RECORTES CERO-GV",0
4,"4075",5462,3714,3676,19,38,"RECORTES CERO-GV",2
27,"27047",1517,955,940,12,15,"RECORTES CERO-GV",1
7,"7008",6113,4003,3961,26,42,"RECORTES CERO-GV",7
46,"46140",383,321,321,2,0,"RECORTES CERO-GV",2
17,"17146",3150,2243,2224,8,19,"RECORTES CERO-GV",3
22,"22249",125,93,92,1,1,"RECORTES CERO-GV",0
46,"46163",1883,1471,1460,8,11,"RECORTES CERO-GV",1
48,"48063",354,256,252,1,4,"RECORTES CERO-GV",0
11,"11014",17203,10923,10805,222,118,"RECORTES CERO-GV",13
8,"8064",1956,1439,1423,7,16,"RECORTES CERO-GV",2
43,"43050",2695,1742,1730,10,12,"RECORTES CERO-GV",2
29,"29095",3285,2313,2224,39,89,"RECORTES CERO-GV",2
50,"50069",66,33,33,1,0,"RECORTES CERO-GV",0
10,"10040",426,301,289,2,12,"RECORTES CERO-GV",0
44,"44144",319,225,223,0,2,"RECORTES CERO-GV",0
14,"14043",7406,5323,5211,63,112,"RECORTES CERO-GV",3
27,"27048",1992,1317,1285,21,32,"RECORTES CERO-GV",1
29,"29012",9718,6664,6553,85,111,"RECORTES CERO-GV",6
48,"48017",13121,8929,8886,45,43,"RECORTES CERO-GV",9
25,"25904",160,134,133,2,1,"RECORTES CERO-GV",0
46,"46232",853,661,648,7,13,"RECORTES CERO-GV",0
21,"21028",370,265,259,2,6,"RECORTES CERO-GV",0
6,"6133",1795,1308,1294,11,14,"RECORTES CERO-GV",0
44,"44203",9,9,9,0,0,"RECORTES CERO-GV",0
31,"31251",3144,2197,2164,18,33,"RECORTES CERO-GV",4
44,"44024",31,26,25,0,1,"RECORTES CERO-GV",0
10,"10001",287,207,203,2,4,"RECORTES CERO-GV",0
31,"31031",212,134,132,2,2,"RECORTES CERO-GV",0
7,"7043",3431,2196,2166,21,30,"RECORTES CERO-GV",1
15,"15016",4558,2747,2705,16,42,"RECORTES CERO-GV",2
43,"43130",169,131,130,2,1,"RECORTES CERO-GV",0
41,"41060",15058,10551,10302,122,249,"RECORTES CERO-GV",14
22,"22251",327,259,256,0,3,"RECORTES CERO-GV",0
12,"12082",9602,7323,7248,53,75,"RECORTES CERO-GV",8
29,"29051",42179,27231,26724,282,507,"RECORTES CERO-GV",48
50,"50148",304,213,211,2,2,"RECORTES CERO-GV",0
10,"10043",746,525,520,4,5,"RECORTES CERO-GV",0
26,"26014",443,278,273,3,5,"RECORTES CERO-GV",1
46,"46233",3766,2688,2650,14,38,"RECORTES CERO-GV",0
44,"44204",27,18,18,0,0,"RECORTES CERO-GV",0
31,"31253",121,100,100,0,0,"RECORTES CERO-GV",0
15,"15017",19866,13497,13344,195,153,"RECORTES CERO-GV",29
22,"22143",190,118,115,1,3,"RECORTES CERO-GV",0
12,"12133",59,46,45,0,1,"RECORTES CERO-GV",0
25,"25063",84,52,51,0,1,"RECORTES CERO-GV",0
7,"7045",1317,931,928,8,3,"RECORTES CERO-GV",4
3,"3008",158,120,118,1,2,"RECORTES CERO-GV",0
8,"8251",5130,3719,3698,20,21,"RECORTES CERO-GV",5
25,"25157",159,127,126,1,1,"RECORTES CERO-GV",0
26,"26089",111981,80365,79216,893,1149,"RECORTES CERO-GV",179
22,"22043",93,53,53,0,0,"RECORTES CERO-GV",0
26,"26052",146,106,105,0,1,"RECORTES CERO-GV",0
20,"20907",118,82,82,0,0,"RECORTES CERO-GV",0
41,"41062",2151,1619,1589,12,30,"RECORTES CERO-GV",1
26,"26129",939,657,644,2,13,"RECORTES CERO-GV",0
31,"31254",1916,1336,1322,9,14,"RECORTES CERO-GV",2
22,"22075",116,71,69,1,2,"RECORTES CERO-GV",0
25,"25158",1605,1193,1180,8,13,"RECORTES CERO-GV",1
48,"48011",9640,6753,6722,41,31,"RECORTES CERO-GV",9
23,"23095",8571,6159,6101,37,58,"RECORTES CERO-GV",4
8,"8206",744,604,599,5,5,"RECORTES CERO-GV",0
22,"22186",189,148,145,3,3,"RECORTES CERO-GV",0
23,"23024",12215,8702,8447,69,255,"RECORTES CERO-GV",61
25,"25191",321,227,222,2,5,"RECORTES CERO-GV",0
10,"10059",329,202,201,1,1,"RECORTES CERO-GV",0
30,"30020",6503,4521,4484,35,37,"RECORTES CERO-GV",0
35,"35022",51765,29309,29034,184,275,"RECORTES CERO-GV",33
44,"44206",100,73,73,3,0,"RECORTES CERO-GV",0
23,"23096",2543,2029,1986,16,43,"RECORTES CERO-GV",0
33,"33056",4850,3068,3044,25,24,"RECORTES CERO-GV",1
8,"8252",24885,18507,18383,162,124,"RECORTES CERO-GV",42
46,"46099",744,539,535,2,4,"RECORTES CERO-GV",0
44,"44207",125,98,97,2,1,"RECORTES CERO-GV",0
29,"29100",2379,1582,1551,22,31,"RECORTES CERO-GV",1
26,"26018",10443,7664,7538,80,126,"RECORTES CERO-GV",12
12,"12135",36287,25912,25655,184,257,"RECORTES CERO-GV",30
22,"22149",301,211,210,1,1,"RECORTES CERO-GV",0
31,"31257",915,654,642,9,12,"RECORTES CERO-GV",1
25,"25161",339,221,221,0,0,"RECORTES CERO-GV",0
22,"22046",713,555,549,9,6,"RECORTES CERO-GV",0
33,"33001",1475,758,753,15,5,"RECORTES CERO-GV",0
44,"44120",219,147,145,3,2,"RECORTES CERO-GV",0
43,"43055",1970,1548,1535,12,13,"RECORTES CERO-GV",1
3,"3096",5786,4355,4281,38,74,"RECORTES CERO-GV",3
20,"20030",21147,14598,14521,92,77,"RECORTES CERO-GV",20
3,"3067",91,78,78,0,0,"RECORTES CERO-GV",0
25,"25901",289,214,211,4,3,"RECORTES CERO-GV",0
46,"46168",2004,1463,1447,12,16,"RECORTES CERO-GV",2
46,"46191",1956,1439,1414,8,25,"RECORTES CERO-GV",1
46,"46146",1647,1241,1229,12,12,"RECORTES CERO-GV",2
22,"22086",194,137,137,1,0,"RECORTES CERO-GV",1
25,"25101",536,412,411,5,1,"RECORTES CERO-GV",0
27,"27023",2453,1674,1644,25,30,"RECORTES CERO-GV",2
3,"3127",350,260,255,1,5,"RECORTES CERO-GV",0
25,"25193",768,567,563,4,4,"RECORTES CERO-GV",0
25,"25205",563,412,407,3,5,"RECORTES CERO-GV",0
22,"22189",175,142,142,1,0,"RECORTES CERO-GV",1
31,"31149",2285,1531,1520,10,11,"RECORTES CERO-GV",0
25,"25011",5271,3529,3505,21,24,"RECORTES CERO-GV",7
46,"46055",1298,992,977,9,15,"RECORTES CERO-GV",2
8,"8208",5793,4267,4244,21,23,"RECORTES CERO-GV",7
18,"18159",989,765,762,2,3,"RECORTES CERO-GV",0
10,"10132",360,251,243,1,8,"RECORTES CERO-GV",0
10,"10213",533,397,385,0,12,"RECORTES CERO-GV",0
43,"43136",10489,7029,6996,47,33,"RECORTES CERO-GV",6
38,"38016",1174,595,589,2,6,"RECORTES CERO-GV",1
44,"44209",799,584,573,2,11,"RECORTES CERO-GV",0
46,"46192",786,534,519,7,15,"RECORTES CERO-GV",0
26,"26136",90,65,64,2,1,"RECORTES CERO-GV",0
50,"50252",5019,3486,3456,53,30,"RECORTES CERO-GV",0
10,"10174",171,112,110,0,2,"RECORTES CERO-GV",1
27,"27025",2731,2047,2006,18,41,"RECORTES CERO-GV",3
23,"23101",351,238,238,3,0,"RECORTES CERO-GV",0
41,"41067",7273,5114,5036,59,78,"RECORTES CERO-GV",1
22,"22155",66,52,52,0,0,"RECORTES CERO-GV",0
21,"21005",15754,9502,9340,84,162,"RECORTES CERO-GV",11
4,"4052",12882,8400,8322,93,78,"RECORTES CERO-GV",10
39,"39014",882,538,536,0,2,"RECORTES CERO-GV",1
50,"50052",81,61,61,0,0,"RECORTES CERO-GV",0
22,"22080",263,188,184,3,4,"RECORTES CERO-GV",0
50,"50129",212,129,127,0,2,"RECORTES CERO-GV",0
10,"10135",1240,834,826,3,8,"RECORTES CERO-GV",0
44,"44094",127,103,103,0,0,"RECORTES CERO-GV",0
27,"27026",2299,1385,1368,9,17,"RECORTES CERO-GV",1
22,"22156",289,216,213,1,3,"RECORTES CERO-GV",1
29,"29075",12886,8292,8191,63,101,"RECORTES CERO-GV",7
18,"18033",279,179,174,0,5,"RECORTES CERO-GV",0
48,"48016",5471,3964,3935,31,29,"RECORTES CERO-GV",5
32,"32061",1078,777,770,5,7,"RECORTES CERO-GV",1
50,"50180",107,85,85,1,0,"RECORTES CERO-GV",0
20,"20064",12395,7959,7916,42,43,"RECORTES CERO-GV",18
29,"29002",1143,777,766,6,11,"RECORTES CERO-GV",0
44,"44061",77,60,58,1,2,"RECORTES CERO-GV",0
25,"25196",108,75,75,1,0,"RECORTES CERO-GV",0
10,"10176",344,223,213,2,10,"RECORTES CERO-GV",0
15,"15036",56053,36487,36175,501,312,"RECORTES CERO-GV",69
6,"6010",1063,760,732,2,28,"RECORTES CERO-GV",2
17,"17098",308,232,230,4,2,"RECORTES CERO-GV",0
23,"23030",1207,998,977,7,21,"RECORTES CERO-GV",0
3,"3016",88,66,66,0,0,"RECORTES CERO-GV",0
22,"22157",181,122,121,2,1,"RECORTES CERO-GV",0
31,"31263",231,137,137,1,0,"RECORTES CERO-GV",1
44,"44211",33,22,22,0,0,"RECORTES CERO-GV",0
18,"18065",588,464,451,2,13,"RECORTES CERO-GV",0
11,"11026",4700,3387,3293,17,94,"RECORTES CERO-GV",5
23,"23902",2219,1813,1770,6,43,"RECORTES CERO-GV",1
8,"8211",33934,26136,26000,198,136,"RECORTES CERO-GV",32
6,"6103",4756,3285,3224,38,61,"RECORTES CERO-GV",7
26,"26141",98,70,70,0,0,"RECORTES CERO-GV",0
3,"3044",4608,3437,3391,13,46,"RECORTES CERO-GV",2
23,"23903",3498,2633,2601,28,32,"RECORTES CERO-GV",2
50,"50004",475,360,356,2,4,"RECORTES CERO-GV",0
31,"31045",510,347,345,8,2,"RECORTES CERO-GV",2
44,"44125",63,41,41,0,0,"RECORTES CERO-GV",0
8,"8257",103,82,82,0,0,"RECORTES CERO-GV",0
38,"38020",16057,9921,9809,66,112,"RECORTES CERO-GV",12
44,"44241",500,361,357,0,4,"RECORTES CERO-GV",0
31,"31155",246,165,161,3,4,"RECORTES CERO-GV",1
33,"33008",1679,1140,1133,10,7,"RECORTES CERO-GV",0
26,"26027",139,99,97,0,2,"RECORTES CERO-GV",0
46,"46013",17761,13652,13548,144,104,"RECORTES CERO-GV",17
25,"25168",496,399,399,6,0,"RECORTES CERO-GV",0
33,"33064",240,151,151,0,0,"RECORTES CERO-GV",0
26,"26103",814,617,603,10,14,"RECORTES CERO-GV",0
15,"15090",1115,711,701,19,10,"RECORTES CERO-GV",0
25,"25137",8684,5802,5757,48,45,"RECORTES CERO-GV",7
26,"26104",10,9,9,1,0,"RECORTES CERO-GV",0
48,"48020",272771,184893,183922,1227,971,"RECORTES CERO-GV",236
46,"46151",757,560,552,2,8,"RECORTES CERO-GV",0
7,"7057",7471,4430,4392,41,38,"RECORTES CERO-GV",3
20,"20067",30609,20017,19927,111,90,"RECORTES CERO-GV",35
17,"17044",6938,5245,5212,33,33,"RECORTES CERO-GV",2
25,"25202",108,72,72,2,0,"RECORTES CERO-GV",0
50,"50132",780,549,538,7,11,"RECORTES CERO-GV",3
31,"31192",160,125,123,0,2,"RECORTES CERO-GV",0
17,"17019",1780,1403,1393,5,10,"RECORTES CERO-GV",1
20,"20078",1143,819,816,1,3,"RECORTES CERO-GV",0
48,"48048",527,381,380,3,1,"RECORTES CERO-GV",0
25,"25907",500,366,364,5,2,"RECORTES CERO-GV",0
46,"46174",942,746,736,1,10,"RECORTES CERO-GV",0
31,"31048",166,121,119,1,2,"RECORTES CERO-GV",0
12,"12142",142,113,113,0,0,"RECORTES CERO-GV",1
48,"48086",2024,1371,1358,5,13,"RECORTES CERO-GV",3
27,"27031",15107,9759,9593,87,166,"RECORTES CERO-GV",11
4,"4021",179,132,129,2,3,"RECORTES CERO-GV",0
7,"7058",2866,2013,1996,24,17,"RECORTES CERO-GV",1
43,"43062",269,229,226,5,3,"RECORTES CERO-GV",0
32,"32068",1401,882,878,4,4,"RECORTES CERO-GV",2
30,"30029",12122,8231,8125,54,106,"RECORTES CERO-GV",2
10,"10020",1571,1135,1117,2,18,"RECORTES CERO-GV",0
12,"12069",50,38,38,0,0,"RECORTES CERO-GV",1
17,"17161",1023,844,843,5,1,"RECORTES CERO-GV",1
50,"50234",242,159,154,4,5,"RECORTES CERO-GV",0
6,"6109",3821,2943,2813,16,130,"RECORTES CERO-GV",4
7,"7059",3074,1973,1948,17,25,"RECORTES CERO-GV",5
29,"29082",34683,24751,24495,263,256,"RECORTES CERO-GV",51
18,"18905",15688,10406,10200,122,206,"RECORTES CERO-GV",8
44,"44037",447,288,288,1,0,"RECORTES CERO-GV",0
12,"12041",92,69,69,2,0,"RECORTES CERO-GV",0
27,"27033",591,334,328,0,6,"RECORTES CERO-GV",0
14,"14021",260521,185270,183300,2192,1970,"RECORTES CERO-GV",289
43,"43064",2027,1456,1445,19,11,"RECORTES CERO-GV",0
31,"31159",1097,813,812,2,1,"RECORTES CERO-GV",1
25,"25020",270,202,201,2,1,"RECORTES CERO-GV",0
8,"8167",6056,4520,4500,38,20,"RECORTES CERO-GV",6
6,"6020",1752,1330,1296,6,34,"RECORTES CERO-GV",2
18,"18102",8233,5424,5266,46,158,"RECORTES CERO-GV",7
29,"29064",423,291,285,2,6,"RECORTES CERO-GV",0
31,"31246",130,89,87,2,2,"RECORTES CERO-GV",1
7,"7005",6956,4042,3996,35,46,"RECORTES CERO-GV",5
43,"43169",445,388,388,3,0,"RECORTES CERO-GV",0
3,"3049",12103,8872,8785,57,87,"RECORTES CERO-GV",5
14,"14022",3881,2888,2853,15,35,"RECORTES CERO-GV",4
6,"6080",1898,1336,1307,6,29,"RECORTES CERO-GV",1
25,"25172",1762,1332,1323,8,9,"RECORTES CERO-GV",0
17,"17078",335,245,245,0,0,"RECORTES CERO-GV",0
33,"33040",4556,2837,2784,58,53,"RECORTES CERO-GV",5
46,"46131",49805,35527,35231,298,296,"RECORTES CERO-GV",27
10,"10146",1494,924,903,1,21,"RECORTES CERO-GV",0
20,"20072",4762,3175,3153,21,22,"RECORTES CERO-GV",7
26,"26033",162,133,132,3,1,"RECORTES CERO-GV",0
44,"44159",37,27,27,1,0,"RECORTES CERO-GV",0
38,"38024",15316,9131,9005,60,126,"RECORTES CERO-GV",9
32,"32072",3664,2387,2355,24,32,"RECORTES CERO-GV",3
43,"43144",1245,975,966,1,9,"RECORTES CERO-GV",2
43,"43092",7308,4703,4679,33,24,"RECORTES CERO-GV",5
11,"11033",21804,13361,13133,213,228,"RECORTES CERO-GV",20
4,"4062",4457,3241,3197,22,44,"RECORTES CERO-GV",2
35,"35033",6393,4147,4072,38,75,"RECORTES CERO-GV",3
10,"10024",672,492,480,6,12,"RECORTES CERO-GV",3
48,"48081",1903,1455,1447,7,8,"RECORTES CERO-GV",2
8,"8194",25680,16465,16376,131,89,"RECORTES CERO-GV",40
31,"31162",48,28,27,1,1,"RECORTES CERO-GV",0
31,"31908",1076,763,762,5,1,"RECORTES CERO-GV",6
3,"3109",3003,2186,2151,14,35,"RECORTES CERO-GV",0
17,"17023",27314,18677,18546,117,131,"RECORTES CERO-GV",40
25,"25143",82,63,62,0,1,"RECORTES CERO-GV",0
50,"50286",75,54,53,0,1,"RECORTES CERO-GV",0
29,"29011",2893,1763,1736,12,27,"RECORTES CERO-GV",3
21,"21046",1729,1212,1187,14,25,"RECORTES CERO-GV",1
31,"31163",2011,1422,1404,6,18,"RECORTES CERO-GV",2
4,"4064",2878,1937,1924,16,13,"RECORTES CERO-GV",3
26,"26111",250,191,187,3,4,"RECORTES CERO-GV",1
25,"25081",281,195,193,3,2,"RECORTES CERO-GV",0
46,"46110",21364,15132,15019,120,113,"RECORTES CERO-GV",26
3,"3110",312,258,258,0,0,"RECORTES CERO-GV",0
46,"46065",1584,1199,1183,11,16,"RECORTES CERO-GV",2
38,"38026",33585,24091,23889,170,202,"RECORTES CERO-GV",10
48,"48026",1132,834,832,2,2,"RECORTES CERO-GV",0
10,"10189",2499,1747,1700,15,47,"RECORTES CERO-GV",0
17,"17107",267,207,205,2,2,"RECORTES CERO-GV",0
46,"46250",582242,437146,434438,3315,2708,"RECORTES CERO-GV",523
1,"1016",428,194,192,4,2,"RECORTES CERO-GV",0
48,"48007",389,243,243,0,0,"RECORTES CERO-GV",0
38,"38002",971,577,570,8,7,"RECORTES CERO-GV",0
8,"8171",2046,1520,1510,13,10,"RECORTES CERO-GV",3
32,"32075",4362,3117,3077,30,40,"RECORTES CERO-GV",3
31,"31188",319,197,191,3,6,"RECORTES CERO-GV",0
8,"8302",9359,6483,6430,78,53,"RECORTES CERO-GV",15
35,"35012",10862,5617,5568,40,49,"RECORTES CERO-GV",6
1,"1047",982,653,642,6,11,"RECORTES CERO-GV",1
3,"3111",5579,3777,3737,23,40,"RECORTES CERO-GV",1
18,"18174",435,324,320,3,4,"RECORTES CERO-GV",0
17,"17052",135,93,92,0,1,"RECORTES CERO-GV",0
23,"23006",4582,3536,3461,43,75,"RECORTES CERO-GV",2
14,"14026",2000,1294,1253,20,41,"RECORTES CERO-GV",1
46,"46202",17801,13010,12906,87,104,"RECORTES CERO-GV",14
1,"1002",8014,5838,5786,24,52,"RECORTES CERO-GV",12
22,"22060",1167,817,808,14,9,"RECORTES CERO-GV",2
15,"15037",4026,2375,2349,10,26,"RECORTES CERO-GV",2
17,"17221",4138,2999,2988,23,11,"RECORTES CERO-GV",4
8,"8058",1808,1280,1262,6,18,"RECORTES CERO-GV",1
18,"18014",6938,4864,4742,64,122,"RECORTES CERO-GV",13
44,"44135",99,73,73,1,0,"RECORTES CERO-GV",0
17,"17140",635,506,505,2,1,"RECORTES CERO-GV",2
43,"43069",183,148,147,2,1,"RECORTES CERO-GV",0
26,"26038",76,52,52,0,0,"RECORTES CERO-GV",0
46,"46203",3546,2717,2689,28,28,"RECORTES CERO-GV",1
32,"32004",1608,835,824,5,11,"RECORTES CERO-GV",1
8,"8104",657,496,493,4,3,"RECORTES CERO-GV",1
48,"48084",21780,14368,14271,79,97,"RECORTES CERO-GV",30
44,"44043",86,60,60,0,0,"RECORTES CERO-GV",0
33,"33017",2969,1787,1768,38,19,"RECORTES CERO-GV",1
39,"39055",1065,747,736,4,11,"RECORTES CERO-GV",1
18,"18109",597,430,422,5,8,"RECORTES CERO-GV",1
17,"17055",142,124,124,0,0,"RECORTES CERO-GV",0
48,"48057",5730,4126,4115,14,11,"RECORTES CERO-GV",0
7,"7902",1091,663,645,13,18,"RECORTES CERO-GV",1
48,"48001",5899,4094,4074,19,20,"RECORTES CERO-GV",7
8,"8001",9097,6860,6818,39,42,"RECORTES CERO-GV",16
17,"17083",2971,2164,2154,13,10,"RECORTES CERO-GV",0
8,"8198",4679,3491,3469,12,22,"RECORTES CERO-GV",2
50,"50014",119,81,81,0,0,"RECORTES CERO-GV",0
26,"26004",69,47,46,0,1,"RECORTES CERO-GV",0
11,"11039",9957,6134,6043,152,91,"RECORTES CERO-GV",9
21,"21051",222,171,168,3,3,"RECORTES CERO-GV",0
33,"33027",752,412,405,11,7,"RECORTES CERO-GV",1
12,"12076",72,54,54,0,0,"RECORTES CERO-GV",0
44,"44165",168,125,125,2,0,"RECORTES CERO-GV",0
12,"12049",415,317,305,4,12,"RECORTES CERO-GV",1
6,"6122",6535,4204,4110,47,94,"RECORTES CERO-GV",10
10,"10154",177,117,116,0,1,"RECORTES CERO-GV",0
10,"10182",122,81,81,0,0,"RECORTES CERO-GV",0
50,"50039",462,339,333,1,6,"RECORTES CERO-GV",0
46,"46254",944,673,661,6,12,"RECORTES CERO-GV",0
41,"41026",4302,3355,3288,26,67,"RECORTES CERO-GV",7
31,"31244",157,69,69,0,0,"RECORTES CERO-GV",0
10,"10196",294,208,206,3,2,"RECORTES CERO-GV",0
35,"35015",10752,5289,5222,39,67,"RECORTES CERO-GV",7
8,"8136",11692,8527,8456,98,71,"RECORTES CERO-GV",7
32,"32080",284,209,209,1,0,"RECORTES CERO-GV",0
33,"33019",2844,1702,1680,11,22,"RECORTES CERO-GV",0
3,"3085",271,229,227,5,2,"RECORTES CERO-GV",0
44,"44046",44,33,33,0,0,"RECORTES CERO-GV",0
23,"23011",2138,1536,1507,17,29,"RECORTES CERO-GV",0
6,"6124",1635,1158,1119,10,39,"RECORTES CERO-GV",0
29,"29045",1679,1162,1144,5,18,"RECORTES CERO-GV",2
10,"10034",337,244,240,0,4,"RECORTES CERO-GV",0
44,"44257",149,92,91,0,1,"RECORTES CERO-GV",0
50,"50016",44,31,31,0,0,"RECORTES CERO-GV",0
8,"8200",62225,45235,44991,306,244,"RECORTES CERO-GV",109
44,"44225",105,82,81,2,1,"RECORTES CERO-GV",0
43,"43151",107,88,88,0,0,"RECORTES CERO-GV",0
25,"25089",93,70,68,1,2,"RECORTES CERO-GV",0
48,"48088",134,95,95,0,0,"RECORTES CERO-GV",0
18,"18914",1660,1255,1227,11,28,"RECORTES CERO-GV",0
26,"26080",451,347,344,0,3,"RECORTES CERO-GV",0
36,"36007",1610,1047,1016,5,31,"RECORTES CERO-GV",0
15,"15011",15501,9988,9846,78,142,"RECORTES CERO-GV",21
31,"31111",91,52,52,0,0,"RECORTES CERO-GV",0
33,"33030",876,632,630,8,2,"RECORTES CERO-GV",1
3,"3116",1155,819,805,5,14,"RECORTES CERO-GV",3
48,"48004",326,245,245,1,0,"RECORTES CERO-GV",0
38,"38032",13579,8941,8880,92,61,"RECORTES CERO-GV",15
31,"31148",92,62,59,2,3,"RECORTES CERO-GV",0
43,"43161",17103,11905,11838,82,67,"RECORTES CERO-GV",17
26,"26134",81,67,67,3,0,"RECORTES CERO-GV",0
46,"46070",17824,12888,12802,106,86,"RECORTES CERO-GV",12
17,"17004",529,411,410,3,1,"RECORTES CERO-GV",0
20,"20051",6736,4829,4804,22,25,"RECORTES CERO-GV",2
31,"31173",845,642,636,4,6,"RECORTES CERO-GV",1
25,"25003",3717,2577,2561,15,16,"RECORTES CERO-GV",1
25,"25216",244,186,186,0,0,"RECORTES CERO-GV",0
8,"8292",1074,796,790,2,6,"RECORTES CERO-GV",1
20,"20901",1399,960,957,3,3,"RECORTES CERO-GV",2
3,"3031",42046,25035,24819,168,216,"RECORTES CERO-GV",20
8,"8039",413,322,321,1,1,"RECORTES CERO-GV",0
21,"21055",7326,5395,5309,43,86,"RECORTES CERO-GV",4
50,"50017",1773,1283,1265,13,18,"RECORTES CERO-GV",3
8,"8154",697,541,539,3,2,"RECORTES CERO-GV",0
14,"14032",388,302,293,0,9,"RECORTES CERO-GV",0
44,"44049",784,539,532,3,7,"RECORTES CERO-GV",0
43,"43153",11197,7685,7649,53,36,"RECORTES CERO-GV",12
18,"18021",17929,12165,11949,139,216,"RECORTES CERO-GV",21
25,"25153",190,139,136,0,3,"RECORTES CERO-GV",0
25,"25004",582,437,432,3,5,"RECORTES CERO-GV",0
17,"17173",181,143,143,1,0,"RECORTES CERO-GV",0
31,"31248",272,142,138,3,4,"RECORTES CERO-GV",0
44,"44228",96,75,74,0,1,"RECORTES CERO-GV",0
32,"32012",708,448,440,2,8,"RECORTES CERO-GV",0
23,"23090",1204,953,938,6,15,"RECORTES CERO-GV",0
1,"1058",1414,893,884,1,9,"RECORTES CERO-GV",0
8,"8109",207,176,174,0,2,"RECORTES CERO-GV",0
31,"31139",152,100,100,1,0,"RECORTES CERO-GV",0
21,"21057",995,600,590,8,10,"RECORTES CERO-GV",0
20,"20054",461,294,294,1,0,"RECORTES CERO-GV",0
31,"31066",819,577,559,4,18,"RECORTES CERO-GV",0
33,"33024",224741,151660,150461,1597,1199,"RECORTES CERO-GV",237
12,"12081",606,454,446,2,8,"RECORTES CERO-GV",0
44,"44262",141,104,103,0,1,"RECORTES CERO-GV",0
31,"31067",1887,1265,1249,6,16,"RECORTES CERO-GV",2
30,"30017",11428,8196,8113,44,83,"RECORTES CERO-GV",6
22,"22181",86,55,54,2,1,"RECORTES CERO-GV",0
50,"50102",815,594,584,7,10,"RECORTES CERO-GV",2
33,"33033",9381,5848,5770,88,78,"RECORTES CERO-GV",3
6,"6041",456,329,321,2,8,"RECORTES CERO-GV",0
26,"26048",21,21,21,0,0,"RECORTES CERO-GV",0
12,"12106",1151,928,908,9,20,"RECORTES CERO-GV",0
25,"25094",138,96,93,2,3,"RECORTES CERO-GV",0
31,"31079",65,46,46,2,0,"RECORTES CERO-GV",1
48,"48904",3547,2563,2541,18,22,"RECORTES CERO-GV",0
41,"41059",35358,26408,26052,346,356,"RECORTES CERO-GV",36
4,"4043",517,398,395,1,3,"RECORTES CERO-GV",0
46,"46050",185,141,141,1,0,"RECORTES CERO-GV",0
8,"8204",3141,2395,2383,16,12,"RECORTES CERO-GV",2
10,"10164",707,391,382,4,9,"RECORTES CERO-GV",0
3,"3121",21997,14689,14572,103,117,"RECORTES CERO-GV",22
25,"25096",885,597,591,2,6,"RECORTES CERO-GV",1
31,"31178",476,323,320,7,3,"RECORTES CERO-GV",2
8,"8272",164,128,128,1,0,"RECORTES CERO-GV",0
43,"43156",3956,2812,2784,22,28,"RECORTES CERO-GV",5
48,"48009",774,585,578,0,7,"RECORTES CERO-GV",0
25,"25035",364,257,256,0,1,"RECORTES CERO-GV",0
12,"12056",257,205,199,1,6,"RECORTES CERO-GV",0
30,"30018",8399,6226,6148,28,78,"RECORTES CERO-GV",0
31,"31082",627,385,385,5,0,"RECORTES CERO-GV",0
32,"32053",1362,1001,989,10,12,"RECORTES CERO-GV",0
8,"8273",2390,1871,1855,14,16,"RECORTES CERO-GV",0
50,"50095",12149,8322,8239,91,83,"RECORTES CERO-GV",5
4,"4078",1127,725,718,8,7,"RECORTES CERO-GV",1
23,"23020",1510,1263,1253,16,10,"RECORTES CERO-GV",0
26,"26128",94,71,71,1,0,"RECORTES CERO-GV",0
17,"17091",391,296,290,3,6,"RECORTES CERO-GV",0
43,"43905",15100,9689,9630,43,59,"RECORTES CERO-GV",16
25,"25008",1081,803,799,4,4,"RECORTES CERO-GV",0
4,"4008",466,374,371,3,3,"RECORTES CERO-GV",0
29,"29069",87188,54019,53240,633,779,"RECORTES CERO-GV",78
21,"21060",12287,7761,7638,134,123,"RECORTES CERO-GV",10
43,"43078",835,610,605,7,5,"RECORTES CERO-GV",0
38,"38037",12817,7582,7494,55,88,"RECORTES CERO-GV",8
4,"4047",2224,1649,1627,13,22,"RECORTES CERO-GV",2
12,"12003",954,710,702,6,8,"RECORTES CERO-GV",1
14,"14037",3161,2233,2158,22,75,"RECORTES CERO-GV",0
3,"3065",169894,121210,120342,1045,868,"RECORTES CERO-GV",134
6,"6137",934,696,693,3,3,"RECORTES CERO-GV",0
50,"50046",162,125,125,6,0,"RECORTES CERO-GV",0
20,"20068",179,119,119,2,0,"RECORTES CERO-GV",0
39,"39037",2033,1431,1420,3,11,"RECORTES CERO-GV",3
26,"26016",28,20,18,0,2,"RECORTES CERO-GV",0
46,"46167",342,240,239,0,1,"RECORTES CERO-GV",0
7,"7046",16884,9184,9097,97,87,"RECORTES CERO-GV",20
25,"25190",262,202,202,2,0,"RECORTES CERO-GV",0
8,"8221",12793,10123,10079,73,44,"RECORTES CERO-GV",19
46,"46242",326,260,257,3,3,"RECORTES CERO-GV",0
29,"29007",28907,20371,20129,254,242,"RECORTES CERO-GV",34
10,"10046",184,144,140,0,4,"RECORTES CERO-GV",0
12,"12004",4149,2945,2910,25,35,"RECORTES CERO-GV",3
30,"30021",9498,6251,6193,36,58,"RECORTES CERO-GV",6
44,"44234",71,49,49,0,0,"RECORTES CERO-GV",0
43,"43141",109,85,84,0,1,"RECORTES CERO-GV",0
18,"18123",284,202,200,5,2,"RECORTES CERO-GV",0
48,"48012",2057,1610,1600,1,10,"RECORTES CERO-GV",2
21,"21062",1403,849,838,10,11,"RECORTES CERO-GV",0
43,"43159",76,60,60,0,0,"RECORTES CERO-GV",0
1,"1022",755,532,523,4,9,"RECORTES CERO-GV",2
22,"22222",516,379,377,6,2,"RECORTES CERO-GV",2
25,"25131",394,281,279,3,2,"RECORTES CERO-GV",1
21,"21063",2611,1948,1891,23,57,"RECORTES CERO-GV",3
44,"44235",87,65,64,1,1,"RECORTES CERO-GV",0
27,"27054",1135,807,782,5,25,"RECORTES CERO-GV",0
50,"50099",3036,2137,2113,17,24,"RECORTES CERO-GV",1
26,"26132",106,73,70,2,3,"RECORTES CERO-GV",0
50,"50024",543,400,397,3,3,"RECORTES CERO-GV",0
8,"8276",241,179,179,3,0,"RECORTES CERO-GV",0
3,"3125",332,226,226,2,0,"RECORTES CERO-GV",1
6,"6095",9506,6616,6425,109,191,"RECORTES CERO-GV",7
4,"4082",275,185,182,2,3,"RECORTES CERO-GV",0
18,"18029",1812,1104,1065,7,39,"RECORTES CERO-GV",1
8,"8023",7029,5027,5000,39,27,"RECORTES CERO-GV",2
50,"50008",5187,3334,3288,37,46,"RECORTES CERO-GV",7
18,"18114",585,425,424,7,1,"RECORTES CERO-GV",0
44,"44001",65,43,43,1,0,"RECORTES CERO-GV",0
38,"38040",5482,3094,3060,14,34,"RECORTES CERO-GV",1
25,"25151",731,555,549,1,6,"RECORTES CERO-GV",0
6,"6157",389,277,271,1,6,"RECORTES CERO-GV",0
38,"38048",3952,2543,2519,22,24,"RECORTES CERO-GV",1
8,"8284",12597,8244,8183,60,61,"RECORTES CERO-GV",8
32,"32022",1238,840,835,10,5,"RECORTES CERO-GV",1
12,"12112",102,79,79,1,0,"RECORTES CERO-GV",1
17,"17039",1726,1306,1297,7,9,"RECORTES CERO-GV",0
50,"50126",2240,1528,1509,24,19,"RECORTES CERO-GV",3
11,"11022",48785,24758,24422,398,336,"RECORTES CERO-GV",44
46,"46214",16637,12113,12014,84,99,"RECORTES CERO-GV",14
33,"33003",603,322,317,7,5,"RECORTES CERO-GV",0
6,"6097",2258,1631,1602,10,29,"RECORTES CERO-GV",1
29,"29057",330,222,218,2,4,"RECORTES CERO-GV",0
6,"6143",3389,2430,2371,24,59,"RECORTES CERO-GV",3
6,"6052",3962,2728,2642,26,86,"RECORTES CERO-GV",1
6,"6007",1418,984,968,13,16,"RECORTES CERO-GV",1
8,"8012",1726,1323,1309,17,14,"RECORTES CERO-GV",1
11,"11023",9386,6363,6248,116,115,"RECORTES CERO-GV",7
23,"23028",6103,4369,4286,26,83,"RECORTES CERO-GV",3
46,"46124",786,638,625,1,13,"RECORTES CERO-GV",1
22,"22190",123,77,77,1,0,"RECORTES CERO-GV",0
39,"39070",126,91,89,0,2,"RECORTES CERO-GV",0
50,"50026",418,292,288,4,4,"RECORTES CERO-GV",1
46,"46147",17186,11507,11399,72,108,"RECORTES CERO-GV",12
12,"12138",19207,13018,12891,87,127,"RECORTES CERO-GV",12
10,"10012",553,427,421,1,6,"RECORTES CERO-GV",0
22,"22904",751,516,511,3,5,"RECORTES CERO-GV",1
3,"3042",1475,1053,1043,7,10,"RECORTES CERO-GV",0
50,"50076",70,56,56,0,0,"RECORTES CERO-GV",0
43,"43163",26162,17276,17128,98,148,"RECORTES CERO-GV",17
38,"38042",3778,2410,2386,11,24,"RECORTES CERO-GV",0
31,"31151",53,37,37,0,0,"RECORTES CERO-GV",0
8,"8162",2118,1581,1576,13,5,"RECORTES CERO-GV",2
35,"35003",5644,2987,2943,20,44,"RECORTES CERO-GV",2
44,"44060",32,25,25,0,0,"RECORTES CERO-GV",0
27,"27058",3283,2275,2241,12,34,"RECORTES CERO-GV",3
10,"10094",220,167,165,0,2,"RECORTES CERO-GV",0
12,"12090",102,79,78,1,1,"RECORTES CERO-GV",0
8,"8278",4925,3820,3804,22,16,"RECORTES CERO-GV",3
31,"31213",99,50,50,0,0,"RECORTES CERO-GV",1
43,"43155",22586,15295,15204,120,91,"RECORTES CERO-GV",17
6,"6146",1039,764,752,7,12,"RECORTES CERO-GV",0
21,"21067",406,274,271,3,3,"RECORTES CERO-GV",0
31,"31103",40,28,27,0,1,"RECORTES CERO-GV",0
14,"14061",687,536,523,1,13,"RECORTES CERO-GV",0
8,"8279",156327,112605,112030,952,575,"RECORTES CERO-GV",245
12,"12139",299,202,200,3,2,"RECORTES CERO-GV",0
6,"6011",24731,16786,16538,167,248,"RECORTES CERO-GV",35
17,"17015",12829,9612,9580,51,32,"RECORTES CERO-GV",119
4,"4017",1276,833,818,4,15,"RECORTES CERO-GV",0
43,"43059",250,193,192,1,1,"RECORTES CERO-GV",0
31,"31190",44,30,30,1,0,"RECORTES CERO-GV",0
10,"10178",724,499,494,3,5,"RECORTES CERO-GV",0
26,"26179",39,27,27,0,0,"RECORTES CERO-GV",0
8,"8280",93,76,75,1,1,"RECORTES CERO-GV",0
17,"17185",2260,1657,1652,8,5,"RECORTES CERO-GV",1
43,"43007",631,479,474,1,5,"RECORTES CERO-GV",0
8,"8118",17634,13450,13402,80,48,"RECORTES CERO-GV",13
31,"31081",338,229,227,1,2,"RECORTES CERO-GV",0
17,"17099",78,55,55,0,0,"RECORTES CERO-GV",0
21,"21008",2604,1663,1626,10,37,"RECORTES CERO-GV",0
41,"41079",9285,6591,6446,101,145,"RECORTES CERO-GV",5
31,"31228",496,356,354,1,2,"RECORTES CERO-GV",2
10,"10098",387,272,267,0,5,"RECORTES CERO-GV",1
31,"31191",3024,2156,2133,23,23,"RECORTES CERO-GV",4
8,"8212",491,393,386,6,7,"RECORTES CERO-GV",0
6,"6059",1724,1084,1067,6,17,"RECORTES CERO-GV",3
43,"43008",305,171,171,7,0,"RECORTES CERO-GV",0
3,"3132",512,376,373,2,3,"RECORTES CERO-GV",1
8,"8074",11190,7698,7651,51,47,"RECORTES CERO-GV",14
39,"39073",10260,7537,7482,42,55,"RECORTES CERO-GV",6
21,"21040",3193,2219,2123,32,96,"RECORTES CERO-GV",1
43,"43009",1384,966,959,5,7,"RECORTES CERO-GV",1
50,"50105",277,203,198,4,5,"RECORTES CERO-GV",0
44,"44007",149,112,111,1,1,"RECORTES CERO-GV",0
22,"22052",874,660,652,7,8,"RECORTES CERO-GV",1
8,"8143",2727,1989,1977,19,12,"RECORTES CERO-GV",4
8,"8142",136,117,117,3,0,"RECORTES CERO-GV",0
3,"3133",41333,24527,24340,146,187,"RECORTES CERO-GV",16
31,"31119",35,24,24,1,0,"RECORTES CERO-GV",0
50,"50106",123,78,78,0,0,"RECORTES CERO-GV",0
21,"21010",15011,8812,8694,174,118,"RECORTES CERO-GV",9
6,"6031",462,285,280,2,5,"RECORTES CERO-GV",0
25,"25056",209,145,145,0,0,"RECORTES CERO-GV",0
31,"31902",4661,3228,3201,39,27,"RECORTES CERO-GV",13
18,"18111",2863,2038,2001,29,37,"RECORTES CERO-GV",3
31,"31047",238,163,163,2,0,"RECORTES CERO-GV",0
17,"17092",3462,2414,2389,14,25,"RECORTES CERO-GV",4
18,"18025",277,198,197,0,1,"RECORTES CERO-GV",0
46,"46037",1120,891,879,7,12,"RECORTES CERO-GV",0
33,"33037",33074,20693,20412,259,281,"RECORTES CERO-GV",38
4,"4059",1000,676,666,3,10,"RECORTES CERO-GV",0
8,"8121",87515,62961,62574,429,387,"RECORTES CERO-GV",106
17,"17214",714,516,511,6,5,"RECORTES CERO-GV",1
50,"50184",87,70,70,0,0,"RECORTES CERO-GV",0
10,"10088",198,112,112,1,0,"RECORTES CERO-GV",0
18,"18068",1638,1197,1167,12,30,"RECORTES CERO-GV",1
32,"32032",7900,5186,5091,48,95,"RECORTES CERO-GV",9
8,"8144",722,551,545,3,6,"RECORTES CERO-GV",0
10,"10060",921,615,596,4,19,"RECORTES CERO-GV",1
22,"22085",94,78,76,0,2,"RECORTES CERO-GV",0
6,"6018",727,483,476,0,7,"RECORTES CERO-GV",0
33,"33038",2218,1501,1477,17,24,"RECORTES CERO-GV",3
44,"44216",27003,19997,19909,80,88,"RECORTES CERO-GV",0
50,"50258",53,25,25,1,0,"RECORTES CERO-GV",0
3,"3135",195,134,131,1,3,"RECORTES CERO-GV",0
50,"50185",140,93,92,1,1,"RECORTES CERO-GV",0
22,"22234",743,498,491,5,7,"RECORTES CERO-GV",2
26,"26146",84,56,55,0,1,"RECORTES CERO-GV",0
8,"8145",2712,2060,2049,8,11,"RECORTES CERO-GV",3
44,"44245",240,177,174,0,3,"RECORTES CERO-GV",0
43,"43038",22070,15127,15018,113,109,"RECORTES CERO-GV",24
50,"50081",487,355,349,5,6,"RECORTES CERO-GV",1
12,"12902",2250,1557,1532,16,25,"RECORTES CERO-GV",1
25,"25204",1187,858,849,13,9,"RECORTES CERO-GV",0
43,"43003",349,257,255,3,2,"RECORTES CERO-GV",0
6,"6081",1036,760,745,2,15,"RECORTES CERO-GV",2
18,"18048",2494,1708,1657,18,51,"RECORTES CERO-GV",2
50,"50048",33,25,25,0,0,"RECORTES CERO-GV",0
25,"25123",189,135,133,0,2,"RECORTES CERO-GV",0
26,"26007",482,360,348,0,12,"RECORTES CERO-GV",0
29,"29083",2063,1471,1444,14,27,"RECORTES CERO-GV",0
29,"29065",191,145,143,3,2,"RECORTES CERO-GV",0
23,"23073",4363,3214,3176,24,38,"RECORTES CERO-GV",3
31,"31088",5656,3929,3893,56,36,"RECORTES CERO-GV",14
26,"26069",230,166,166,0,0,"RECORTES CERO-GV",0
12,"12096",732,526,519,4,7,"RECORTES CERO-GV",0
46,"46200",1840,1475,1455,5,20,"RECORTES CERO-GV",0
32,"32035",1352,782,768,6,14,"RECORTES CERO-GV",1
27,"27066",12588,8116,7954,109,162,"RECORTES CERO-GV",15
30,"30031",497,387,382,1,5,"RECORTES CERO-GV",0
29,"29010",1637,1263,1187,2,76,"RECORTES CERO-GV",0
8,"8032",2100,1472,1465,12,7,"RECORTES CERO-GV",0
12,"12071",1272,936,925,3,11,"RECORTES CERO-GV",0
8,"8146",1384,1030,1027,8,3,"RECORTES CERO-GV",0
50,"50186",37,26,26,1,0,"RECORTES CERO-GV",0
33,"33041",7101,4564,4513,58,51,"RECORTES CERO-GV",4
12,"12097",62,53,51,0,2,"RECORTES CERO-GV",0
15,"15065",7134,4869,4785,53,84,"RECORTES CERO-GV",6
44,"44160",438,287,285,4,2,"RECORTES CERO-GV",0
10,"10066",161,121,120,1,1,"RECORTES CERO-GV",0
21,"21015",645,361,356,8,5,"RECORTES CERO-GV",0
8,"8079",333,260,258,2,2,"RECORTES CERO-GV",0
21,"21076",2153,1459,1426,31,33,"RECORTES CERO-GV",2
50,"50084",67,47,47,1,0,"RECORTES CERO-GV",0
20,"20073",4707,3272,3260,14,12,"RECORTES CERO-GV",3
36,"36032",3527,2407,2369,24,38,"RECORTES CERO-GV",0
22,"22204",1117,728,723,14,5,"RECORTES CERO-GV",1
17,"17192",143,107,104,0,3,"RECORTES CERO-GV",1
8,"8218",8091,5899,5869,50,30,"RECORTES CERO-GV",2
44,"44161",428,294,292,2,2,"RECORTES CERO-GV",0
50,"50262",1161,849,832,11,17,"RECORTES CERO-GV",1
46,"46019",8932,6721,6647,40,74,"RECORTES CERO-GV",5
25,"25115",803,601,593,4,8,"RECORTES CERO-GV",0
43,"43120",421,256,254,1,2,"RECORTES CERO-GV",0
21,"21077",1739,1266,1235,13,31,"RECORTES CERO-GV",0
46,"46251",2465,1938,1903,19,35,"RECORTES CERO-GV",1
6,"6086",1174,767,750,6,17,"RECORTES CERO-GV",1
22,"22008",144,113,112,2,1,"RECORTES CERO-GV",0
3,"3033",101,82,78,0,4,"RECORTES CERO-GV",0
32,"32013",1985,1242,1230,16,12,"RECORTES CERO-GV",1
17,"17200",624,469,467,6,2,"RECORTES CERO-GV",1
50,"50019",63,46,46,0,0,"RECORTES CERO-GV",0
10,"10005",527,325,301,1,24,"RECORTES CERO-GV",0
12,"12115",205,161,161,1,0,"RECORTES CERO-GV",0
44,"44014",2506,1828,1818,8,10,"RECORTES CERO-GV",0
39,"39081",440,330,327,1,3,"RECORTES CERO-GV",0
36,"36001",2397,1674,1651,6,23,"RECORTES CERO-GV",1
29,"29041",3697,2406,2361,47,45,"RECORTES CERO-GV",1
3,"3063",27209,18236,18101,164,135,"RECORTES CERO-GV",15
33,"33015",1396,849,842,7,7,"RECORTES CERO-GV",0
10,"10150",339,279,275,3,4,"RECORTES CERO-GV",0
26,"26113",29,28,28,0,0,"RECORTES CERO-GV",0
17,"17194",73,56,56,0,0,"RECORTES CERO-GV",0
18,"18143",945,661,651,2,10,"RECORTES CERO-GV",1
21,"21079",678,428,417,2,11,"RECORTES CERO-GV",0
46,"46226",29,20,19,0,1,"RECORTES CERO-GV",0
25,"25146",223,158,155,3,3,"RECORTES CERO-GV",0
8,"8172",20543,15191,15140,85,51,"RECORTES CERO-GV",17
22,"22906",177,123,122,6,1,"RECORTES CERO-GV",0
50,"50190",669,532,518,10,14,"RECORTES CERO-GV",0
31,"31240",514,352,352,3,0,"RECORTES CERO-GV",0
31,"31130",321,203,203,0,0,"RECORTES CERO-GV",0
41,"41097",3131,2197,2140,13,57,"RECORTES CERO-GV",0
23,"23008",1422,1042,1020,9,22,"RECORTES CERO-GV",0
12,"12100",1273,1069,1052,5,17,"RECORTES CERO-GV",1
21,"21902",1136,744,739,2,5,"RECORTES CERO-GV",0
4,"4101",4356,2818,2768,32,50,"RECORTES CERO-GV",4
15,"15070",8778,5802,5656,131,146,"RECORTES CERO-GV",7
41,"41024",22819,14767,14455,169,312,"RECORTES CERO-GV",21
8,"8059",340,255,250,1,5,"RECORTES CERO-GV",0
46,"46249",9136,6538,6439,73,99,"RECORTES CERO-GV",5
31,"31095",71,59,59,0,0,"RECORTES CERO-GV",1
50,"50087",28,19,19,0,0,"RECORTES CERO-GV",0
41,"41025",2031,1409,1349,11,60,"RECORTES CERO-GV",0
25,"25211",680,470,470,3,0,"RECORTES CERO-GV",1
12,"12101",354,274,270,5,4,"RECORTES CERO-GV",0
8,"8082",1164,796,780,5,16,"RECORTES CERO-GV",2
7,"7002",6678,4149,4108,31,41,"RECORTES CERO-GV",11
10,"10195",7514,5243,5148,47,95,"RECORTES CERO-GV",7
31,"31144",760,442,441,4,1,"RECORTES CERO-GV",1
22,"22110",700,476,473,3,3,"RECORTES CERO-GV",0
10,"10194",524,408,404,2,4,"RECORTES CERO-GV",0
50,"50227",107,62,62,1,0,"RECORTES CERO-GV",0
10,"10072",837,545,539,5,6,"RECORTES CERO-GV",0
29,"29043",2463,1508,1460,20,48,"RECORTES CERO-GV",4
8,"8274",4640,3385,3363,24,22,"RECORTES CERO-GV",1
26,"26081",15,14,14,1,0,"RECORTES CERO-GV",0
48,"48061",789,602,601,2,1,"RECORTES CERO-GV",1
23,"23082",1850,1292,1279,13,13,"RECORTES CERO-GV",1
18,"18177",375,235,231,5,4,"RECORTES CERO-GV",0
33,"33047",1068,771,759,9,12,"RECORTES CERO-GV",0
43,"43019",1332,911,904,8,7,"RECORTES CERO-GV",0
44,"44009",798,593,589,4,4,"RECORTES CERO-GV",0
44,"44266",102,81,79,0,2,"RECORTES CERO-GV",0
4,"4011",2744,2010,1984,20,26,"RECORTES CERO-GV",1
22,"22133",108,71,71,3,0,"RECORTES CERO-GV",0
25,"25245",427,312,308,4,4,"RECORTES CERO-GV",1
50,"50124",394,269,266,0,3,"RECORTES CERO-GV",0
4,"4034",169,91,91,1,0,"RECORTES CERO-GV",0
15,"15072",9434,6304,6228,48,76,"RECORTES CERO-GV",5
18,"18146",930,645,629,10,16,"RECORTES CERO-GV",0
25,"25001",143,102,102,1,0,"RECORTES CERO-GV",0
20,"20080",7705,5276,5244,21,32,"RECORTES CERO-GV",8
18,"18147",3655,2273,2241,16,32,"RECORTES CERO-GV",2
22,"22003",135,107,107,0,0,"RECORTES CERO-GV",1
27,"27012",1264,658,650,6,8,"RECORTES CERO-GV",0
8,"8291",4972,3531,3519,23,12,"RECORTES CERO-GV",6
6,"6035",851,630,620,0,10,"RECORTES CERO-GV",0
50,"50267",565,380,375,4,5,"RECORTES CERO-GV",0
43,"43072",90,69,67,1,2,"RECORTES CERO-GV",0
43,"43100",3557,2666,2649,22,17,"RECORTES CERO-GV",7
10,"10008",1274,921,908,1,13,"RECORTES CERO-GV",0
10,"10184",734,520,511,4,9,"RECORTES CERO-GV",0
10,"10212",1658,1113,1068,19,45,"RECORTES CERO-GV",1
12,"12136",2603,2151,2119,20,32,"RECORTES CERO-GV",1
44,"44226",123,85,84,0,1,"RECORTES CERO-GV",0
10,"10158",344,247,246,7,1,"RECORTES CERO-GV",0
20,"20010",1524,1057,1053,5,4,"RECORTES CERO-GV",0
26,"26147",34,26,25,0,1,"RECORTES CERO-GV",0
43,"43082",350,276,271,5,5,"RECORTES CERO-GV",0
46,"46123",1926,1392,1368,11,24,"RECORTES CERO-GV",2
22,"22040",149,119,119,3,0,"RECORTES CERO-GV",0
17,"17116",351,261,261,2,0,"RECORTES CERO-GV",1
10,"10200",336,243,242,0,1,"RECORTES CERO-GV",0
22,"22037",112,87,87,2,0,"RECORTES CERO-GV",0
10,"10123",575,450,438,1,12,"RECORTES CERO-GV",0
10,"10124",867,622,612,1,10,"RECORTES CERO-GV",0
23,"23087",11169,8193,8045,79,148,"RECORTES CERO-GV",7
4,"4903",4320,2907,2873,18,34,"RECORTES CERO-GV",1
50,"50118",2101,1484,1477,17,7,"RECORTES CERO-GV",2
4,"4904",1900,1308,1299,4,9,"RECORTES CERO-GV",0
21,"21025",3886,2489,2431,31,58,"RECORTES CERO-GV",8
6,"6083",46577,31113,30748,338,365,"RECORTES CERO-GV",75
18,"18181",194,134,133,0,1,"RECORTES CERO-GV",0
10,"10160",240,179,177,2,2,"RECORTES CERO-GV",0
43,"43901",8796,5431,5390,41,41,"RECORTES CERO-GV",4
17,"17088",599,467,465,3,2,"RECORTES CERO-GV",0
15,"15013",6324,4132,4083,35,49,"RECORTES CERO-GV",9
20,"20052",1050,746,743,4,3,"RECORTES CERO-GV",1
3,"3032",97,82,82,0,0,"RECORTES CERO-GV",0
21,"21026",262,172,168,2,4,"RECORTES CERO-GV",2
4,"4038",3105,2020,1984,17,36,"RECORTES CERO-GV",1
38,"38033",3593,2277,2242,15,35,"RECORTES CERO-GV",1
4,"4004",405,282,272,2,10,"RECORTES CERO-GV",0
23,"23017",1498,1153,1129,11,24,"RECORTES CERO-GV",0
15,"15076",2490,1539,1517,25,22,"RECORTES CERO-GV",1
22,"22215",127,81,81,0,0,"RECORTES CERO-GV",1
10,"10203",4421,2810,2764,15,46,"RECORTES CERO-GV",2
4,"4005",534,422,419,3,3,"RECORTES CERO-GV",0
41,"41030",501,376,366,9,10,"RECORTES CERO-GV",3
46,"46258",2617,1925,1914,5,11,"RECORTES CERO-GV",0
10,"10039",400,256,217,0,39,"RECORTES CERO-GV",0
41,"41902",4599,2906,2868,50,38,"RECORTES CERO-GV",4
43,"43103",908,705,701,9,4,"RECORTES CERO-GV",2
44,"44050",3113,2173,2154,14,19,"RECORTES CERO-GV",0
43,"43075",86,65,63,0,2,"RECORTES CERO-GV",0
17,"17006",1178,826,818,9,8,"RECORTES CERO-GV",0
38,"38034",3997,2687,2648,19,39,"RECORTES CERO-GV",3
36,"36010",2825,1983,1947,19,36,"RECORTES CERO-GV",2
18,"18067",682,442,437,2,5,"RECORTES CERO-GV",0
36,"36016",1069,639,633,5,6,"RECORTES CERO-GV",0
29,"29015",32093,22044,21716,253,328,"RECORTES CERO-GV",32
15,"15025",986,529,517,6,12,"RECORTES CERO-GV",3
12,"12037",17,13,13,1,0,"RECORTES CERO-GV",0
32,"32090",734,448,441,2,7,"RECORTES CERO-GV",1
44,"44190",63,45,45,0,0,"RECORTES CERO-GV",0
29,"29067",431757,290824,287855,3289,2969,"RECORTES CERO-GV",546
44,"44096",155,115,114,1,1,"RECORTES CERO-GV",0
41,"41032",3842,2800,2704,24,96,"RECORTES CERO-GV",6
50,"50271",246,179,173,4,6,"RECORTES CERO-GV",1
30,"30042",2218,1645,1625,10,20,"RECORTES CERO-GV",0
7,"7010",5078,3353,3318,30,35,"RECORTES CERO-GV",7
17,"17203",165,126,126,0,0,"RECORTES CERO-GV",0
4,"4007",735,514,509,3,5,"RECORTES CERO-GV",0
22,"22218",39,34,34,0,0,"RECORTES CERO-GV",0
32,"32052",1817,1278,1268,12,10,"RECORTES CERO-GV",2
46,"46210",338,256,251,0,5,"RECORTES CERO-GV",0
43,"43148",91182,65076,64756,441,320,"RECORTES CERO-GV",96
44,"44183",61,47,47,1,0,"RECORTES CERO-GV",0
46,"46104",1906,1422,1409,5,13,"RECORTES CERO-GV",1
10,"10084",1266,755,717,7,38,"RECORTES CERO-GV",1
46,"46260",2685,2072,2053,14,19,"RECORTES CERO-GV",0
31,"31106",721,547,545,1,2,"RECORTES CERO-GV",2
44,"44264",254,170,170,0,0,"RECORTES CERO-GV",0
25,"25128",125,85,85,0,0,"RECORTES CERO-GV",0
8,"8228",292,234,233,0,1,"RECORTES CERO-GV",0
18,"18185",545,434,424,5,10,"RECORTES CERO-GV",1
18,"18056",3382,2397,2350,30,47,"RECORTES CERO-GV",0
8,"8250",7235,4917,4876,41,41,"RECORTES CERO-GV",2
17,"17065",321,264,263,3,1,"RECORTES CERO-GV",0
10,"10207",455,298,291,0,7,"RECORTES CERO-GV",0
44,"44265",175,138,136,1,2,"RECORTES CERO-GV",0
33,"33055",1485,992,966,14,26,"RECORTES CERO-GV",2
50,"50199",318,206,201,1,5,"RECORTES CERO-GV",1
25,"25129",161,113,112,0,1,"RECORTES CERO-GV",0
46,"46143",4274,3027,2995,19,32,"RECORTES CERO-GV",2
43,"43132",375,295,291,1,4,"RECORTES CERO-GV",2
46,"46029",20448,14673,14556,99,117,"RECORTES CERO-GV",9
8,"8213",6600,4925,4906,30,19,"RECORTES CERO-GV",2
31,"31124",207,134,134,2,0,"RECORTES CERO-GV",1
21,"21074",2736,1826,1790,19,36,"RECORTES CERO-GV",1
8,"8215",2617,1954,1946,22,8,"RECORTES CERO-GV",0
8,"8135",6770,5187,5158,42,29,"RECORTES CERO-GV",3
26,"26091",147,115,114,0,1,"RECORTES CERO-GV",0
43,"43109",2706,1751,1738,17,13,"RECORTES CERO-GV",1
46,"46081",9999,7486,7412,47,74,"RECORTES CERO-GV",3
46,"46086",80,66,65,1,1,"RECORTES CERO-GV",0
10,"10186",951,756,735,6,21,"RECORTES CERO-GV",1
43,"43030",483,356,351,2,5,"RECORTES CERO-GV",1
36,"36017",17364,11771,11598,123,173,"RECORTES CERO-GV",14
10,"10209",259,151,149,0,2,"RECORTES CERO-GV",2
17,"17010",332,252,251,2,1,"RECORTES CERO-GV",0
26,"26145",239,194,187,3,7,"RECORTES CERO-GV",0
39,"39047",1998,1408,1392,8,16,"RECORTES CERO-GV",0
8,"8159",14343,10656,10603,87,53,"RECORTES CERO-GV",18
25,"25223",890,673,666,7,7,"RECORTES CERO-GV",1
46,"46221",348,292,290,1,2,"RECORTES CERO-GV",0
8,"8229",521,418,417,3,1,"RECORTES CERO-GV",0
17,"17066",27378,16755,16644,122,111,"RECORTES CERO-GV",19
43,"43907",4386,3083,3067,24,16,"RECORTES CERO-GV",10
14,"14067",3842,2863,2800,42,63,"RECORTES CERO-GV",2
22,"22223",77,60,59,2,1,"RECORTES CERO-GV",0
18,"18157",1148,843,827,7,16,"RECORTES CERO-GV",3
36,"36049",6990,4877,4787,40,90,"RECORTES CERO-GV",6
23,"23060",19210,13677,13495,145,182,"RECORTES CERO-GV",25
7,"7015",22248,12375,12286,202,89,"RECORTES CERO-GV",23
17,"17038",377,303,301,0,2,"RECORTES CERO-GV",0
35,"35001",4566,3148,3105,18,43,"RECORTES CERO-GV",3
23,"23026",3431,2430,2375,25,55,"RECORTES CERO-GV",3
44,"44268",32,30,30,0,0,"RECORTES CERO-GV",0
8,"8299",380,301,300,4,1,"RECORTES CERO-GV",1
10,"10144",915,618,614,0,4,"RECORTES CERO-GV",0
11,"11011",1726,1124,1084,8,40,"RECORTES CERO-GV",3
31,"31099",51,38,38,0,0,"RECORTES CERO-GV",0
14,"14031",556,462,456,5,6,"RECORTES CERO-GV",1
25,"25132",141,106,105,0,1,"RECORTES CERO-GV",0
46,"46206",555,417,408,0,9,"RECORTES CERO-GV",0
43,"43126",1230,937,933,3,4,"RECORTES CERO-GV",0
44,"44047",225,103,103,0,0,"RECORTES CERO-GV",0
39,"39005",1419,1039,1030,9,9,"RECORTES CERO-GV",1
36,"36004",10109,6611,6502,79,109,"RECORTES CERO-GV",11
44,"44224",21,14,14,2,0,"RECORTES CERO-GV",0
7,"7017",899,604,596,10,8,"RECORTES CERO-GV",2
4,"4013",143819,93083,92383,893,700,"RECORTES CERO-GV",149
10,"10014",1816,1285,1254,13,31,"RECORTES CERO-GV",2
10,"10003",543,350,335,0,15,"RECORTES CERO-GV",0
31,"31153",2174,1417,1415,12,2,"RECORTES CERO-GV",2
33,"33062",385,194,187,4,7,"RECORTES CERO-GV",0
18,"18013",4154,2892,2812,28,80,"RECORTES CERO-GV",1
22,"22225",2606,1638,1612,20,26,"RECORTES CERO-GV",2
6,"6098",530,379,376,4,3,"RECORTES CERO-GV",0
25,"25902",536,406,403,1,3,"RECORTES CERO-GV",0
4,"4084",337,238,232,0,6,"RECORTES CERO-GV",0
36,"36020",2172,1435,1418,19,17,"RECORTES CERO-GV",0
10,"10133",1159,914,893,4,21,"RECORTES CERO-GV",0
17,"17069",359,270,267,2,3,"RECORTES CERO-GV",0
25,"25165",271,210,208,0,2,"RECORTES CERO-GV",0
44,"44180",74,56,56,0,0,"RECORTES CERO-GV",0
31,"31224",884,637,630,7,7,"RECORTES CERO-GV",0
18,"18193",14934,10301,10127,116,174,"RECORTES CERO-GV",18
22,"22016",558,384,382,5,2,"RECORTES CERO-GV",0
17,"17014",66,51,49,0,2,"RECORTES CERO-GV",0
6,"6008",615,522,507,2,15,"RECORTES CERO-GV",1
20,"20063",8023,5611,5597,19,14,"RECORTES CERO-GV",5
18,"18063",1232,687,678,9,9,"RECORTES CERO-GV",1
26,"26023",433,316,314,3,2,"RECORTES CERO-GV",1
36,"36052",7266,4772,4685,43,87,"RECORTES CERO-GV",2
17,"17209",615,472,471,5,1,"RECORTES CERO-GV",0
50,"50101",833,557,550,5,7,"RECORTES CERO-GV",1
44,"44152",70,46,46,0,0,"RECORTES CERO-GV",0
3,"3129",1224,934,923,4,11,"RECORTES CERO-GV",1
15,"15055",4446,2829,2762,50,67,"RECORTES CERO-GV",2
29,"29058",1542,994,979,5,15,"RECORTES CERO-GV",0
17,"17183",253,197,197,2,0,"RECORTES CERO-GV",0
46,"46186",19689,14688,14576,118,112,"RECORTES CERO-GV",19
26,"26011",7251,4807,4711,47,96,"RECORTES CERO-GV",6
32,"32049",683,375,372,3,3,"RECORTES CERO-GV",0
6,"6131",1057,809,800,6,9,"RECORTES CERO-GV",6
4,"4069",4742,3364,3325,46,39,"RECORTES CERO-GV",6
25,"25021",2513,1668,1662,17,6,"RECORTES CERO-GV",2
32,"32034",1062,763,753,6,10,"RECORTES CERO-GV",0
50,"50022",504,373,369,12,4,"RECORTES CERO-GV",0
41,"41053",21693,15843,15379,171,464,"RECORTES CERO-GV",16
46,"46067",1753,1356,1341,8,15,"RECORTES CERO-GV",1
41,"41092",7681,5408,5299,79,109,"RECORTES CERO-GV",10
50,"50170",357,245,242,6,3,"RECORTES CERO-GV",0
12,"12079",414,310,305,2,5,"RECORTES CERO-GV",0
50,"50041",16,10,10,0,0,"RECORTES CERO-GV",0
21,"21007",6379,4268,4178,66,90,"RECORTES CERO-GV",10
22,"22081",247,173,171,3,2,"RECORTES CERO-GV",0
4,"4088",2444,1587,1574,17,13,"RECORTES CERO-GV",0
44,"44174",402,289,288,1,1,"RECORTES CERO-GV",0
50,"50028",78,53,53,0,0,"RECORTES CERO-GV",1
26,"26025",84,69,65,2,4,"RECORTES CERO-GV",0
31,"31080",486,362,361,4,1,"RECORTES CERO-GV",0
17,"17073",1939,1649,1640,11,9,"RECORTES CERO-GV",0
12,"12116",61,49,49,0,0,"RECORTES CERO-GV",0
15,"15079",1437,887,868,8,19,"RECORTES CERO-GV",1
31,"31021",59,42,42,1,0,"RECORTES CERO-GV",0
6,"6074",4720,3355,3271,24,84,"RECORTES CERO-GV",6
44,"44212",41,29,29,0,0,"RECORTES CERO-GV",0
31,"31009",674,455,451,2,4,"RECORTES CERO-GV",0
23,"23032",529,427,419,5,8,"RECORTES CERO-GV",0
43,"43139",2007,1432,1419,9,13,"RECORTES CERO-GV",1
33,"33007",1382,804,795,4,9,"RECORTES CERO-GV",0
18,"18902",752,589,568,3,21,"RECORTES CERO-GV",3
22,"22907",1463,1016,1006,21,10,"RECORTES CERO-GV",1
21,"21009",834,527,508,4,19,"RECORTES CERO-GV",0
17,"17186",3834,2980,2954,17,26,"RECORTES CERO-GV",1
41,"41043",669,447,436,11,11,"RECORTES CERO-GV",0
29,"29005",4507,3012,2965,29,47,"RECORTES CERO-GV",7
31,"31901",15487,11077,10991,117,86,"RECORTES CERO-GV",53
43,"43088",2013,1429,1420,11,9,"RECORTES CERO-GV",0
10,"10902",744,514,498,4,16,"RECORTES CERO-GV",0
3,"3018",12433,8582,8502,54,80,"RECORTES CERO-GV",3
12,"12117",3532,2512,2479,12,33,"RECORTES CERO-GV",0
6,"6015",118127,79482,78553,855,929,"RECORTES CERO-GV",199
6,"6060",5696,4006,3900,37,106,"RECORTES CERO-GV",9
8,"8062",1009,778,776,9,2,"RECORTES CERO-GV",0
25,"25034",2271,1616,1600,12,16,"RECORTES CERO-GV",2
44,"44232",364,255,255,3,0,"RECORTES CERO-GV",0
6,"6142",257,203,194,1,9,"RECORTES CERO-GV",0
31,"31184",65,41,40,0,1,"RECORTES CERO-GV",0
32,"32071",1351,821,814,6,7,"RECORTES CERO-GV",0
46,"46166",8214,6093,6031,38,62,"RECORTES CERO-GV",5
46,"46043",135,119,118,0,1,"RECORTES CERO-GV",0
31,"31129",388,239,238,3,1,"RECORTES CERO-GV",0
18,"18909",514,403,403,0,0,"RECORTES CERO-GV",0
46,"46154",795,619,608,5,11,"RECORTES CERO-GV",0
6,"6062",564,394,391,0,3,"RECORTES CERO-GV",1
48,"48077",3366,2483,2467,9,16,"RECORTES CERO-GV",4
26,"26105",2188,1564,1536,24,28,"RECORTES CERO-GV",2
10,"10006",1224,907,893,7,14,"RECORTES CERO-GV",3
8,"8275",247,218,218,3,0,"RECORTES CERO-GV",0
8,"8166",964,700,697,7,3,"RECORTES CERO-GV",0
7,"7025",443,313,310,5,3,"RECORTES CERO-GV",0
3,"3095",4807,3453,3410,31,43,"RECORTES CERO-GV",10
14,"14901",932,753,750,6,3,"RECORTES CERO-GV",0
31,"31012",763,550,542,7,8,"RECORTES CERO-GV",1
48,"48050",188,141,141,0,0,"RECORTES CERO-GV",0
6,"6064",847,616,601,3,15,"RECORTES CERO-GV",1
46,"46084",1487,1136,1123,4,13,"RECORTES CERO-GV",1
4,"4023",118,84,82,2,2,"RECORTES CERO-GV",0
21,"21012",285,224,221,0,3,"RECORTES CERO-GV",0
43,"43090",1199,689,686,5,3,"RECORTES CERO-GV",4
1,"1039",188,150,147,2,3,"RECORTES CERO-GV",1
17,"17135",393,307,303,0,4,"RECORTES CERO-GV",0
8,"8031",2339,1760,1750,15,10,"RECORTES CERO-GV",1
3,"3106",559,469,465,3,4,"RECORTES CERO-GV",0
7,"7027",22101,13161,13028,140,133,"RECORTES CERO-GV",34
38,"38023",126137,79423,78706,605,717,"RECORTES CERO-GV",91
15,"15010",1805,1047,1031,19,16,"RECORTES CERO-GV",2
44,"44055",75,52,50,0,2,"RECORTES CERO-GV",0
17,"17094",1058,757,747,3,10,"RECORTES CERO-GV",2
41,"41008",1044,788,766,3,22,"RECORTES CERO-GV",0
20,"20081",7690,5382,5363,31,19,"RECORTES CERO-GV",5
31,"31183",718,536,534,5,2,"RECORTES CERO-GV",2
26,"26121",30,19,19,0,0,"RECORTES CERO-GV",0
48,"48091",1078,758,757,5,1,"RECORTES CERO-GV",1
50,"50096",34,22,22,0,0,"RECORTES CERO-GV",0
46,"46001",771,562,560,3,2,"RECORTES CERO-GV",1
10,"10045",971,686,682,4,4,"RECORTES CERO-GV",0
17,"17111",984,728,728,7,0,"RECORTES CERO-GV",1
29,"29053",1717,1133,1116,12,17,"RECORTES CERO-GV",3
32,"32010",364,271,267,2,4,"RECORTES CERO-GV",0
31,"31027",811,527,521,1,6,"RECORTES CERO-GV",0
17,"17049",3246,2527,2502,12,25,"RECORTES CERO-GV",1
4,"4024",3241,2315,2290,34,25,"RECORTES CERO-GV",2
31,"31032",1670,1158,1147,18,11,"RECORTES CERO-GV",2
22,"22126",89,64,64,0,0,"RECORTES CERO-GV",0
46,"46040",993,745,733,3,12,"RECORTES CERO-GV",0
46,"46245",527,407,404,2,3,"RECORTES CERO-GV",0
20,"20011",1624,1234,1225,3,9,"RECORTES CERO-GV",1
50,"50083",81,64,64,2,0,"RECORTES CERO-GV",0
8,"8216",25,17,17,0,0,"RECORTES CERO-GV",0
36,"36061",8613,5822,5718,56,104,"RECORTES CERO-GV",11
39,"39022",970,673,668,2,5,"RECORTES CERO-GV",1
8,"8240",9469,7351,7327,39,24,"RECORTES CERO-GV",3
18,"18105",3827,2436,2392,22,44,"RECORTES CERO-GV",1
50,"50136",532,366,361,3,5,"RECORTES CERO-GV",0
23,"23004",407,321,315,2,6,"RECORTES CERO-GV",0
7,"7063",1434,1025,1016,10,9,"RECORTES CERO-GV",1
1,"1044",232,151,148,2,3,"RECORTES CERO-GV",2
15,"15066",3995,2746,2695,29,51,"RECORTES CERO-GV",1
50,"50137",958,740,731,8,9,"RECORTES CERO-GV",0
8,"8101",175048,121359,120620,830,739,"RECORTES CERO-GV",282
12,"12122",754,608,600,3,8,"RECORTES CERO-GV",0
26,"26071",8644,5668,5591,53,77,"RECORTES CERO-GV",12
31,"31017",375,250,250,10,0,"RECORTES CERO-GV",1
44,"44013",11232,7872,7801,64,71,"RECORTES CERO-GV",0
17,"17218",576,456,451,3,5,"RECORTES CERO-GV",1
10,"10148",33054,21731,21379,231,352,"RECORTES CERO-GV",46
21,"21016",985,703,680,5,23,"RECORTES CERO-GV",0
25,"25023",4560,3350,3334,24,16,"RECORTES CERO-GV",2
31,"31176",2919,1974,1933,27,41,"RECORTES CERO-GV",8
23,"23053",9451,6038,5975,60,63,"RECORTES CERO-GV",5
20,"20053",4856,3169,3153,15,16,"RECORTES CERO-GV",1
32,"32006",1418,986,970,14,16,"RECORTES CERO-GV",0
20,"20050",275,174,174,2,0,"RECORTES CERO-GV",0
46,"46026",1220,974,965,7,9,"RECORTES CERO-GV",1
8,"8245",77841,53719,53443,430,276,"RECORTES CERO-GV",111
3,"3136",399,302,301,3,1,"RECORTES CERO-GV",0
8,"8018",2540,1862,1855,7,7,"RECORTES CERO-GV",4
31,"31059",182,121,121,1,0,"RECORTES CERO-GV",0
44,"44256",36,30,30,2,0,"RECORTES CERO-GV",0
31,"31043",29,23,23,0,0,"RECORTES CERO-GV",0
50,"50077",201,140,140,1,0,"RECORTES CERO-GV",0
15,"15043",4944,3184,3117,27,67,"RECORTES CERO-GV",2
32,"32088",1636,955,944,17,11,"RECORTES CERO-GV",0
17,"17230",504,383,382,3,1,"RECORTES CERO-GV",0
14,"14025",2834,2352,2299,9,53,"RECORTES CERO-GV",2
31,"31227",8118,5691,5636,65,55,"RECORTES CERO-GV",12
17,"17081",252,186,185,2,1,"RECORTES CERO-GV",0
14,"14035",5774,4076,4017,35,59,"RECORTES CERO-GV",0
31,"31020",435,224,222,1,2,"RECORTES CERO-GV",0
4,"4066",13438,8615,8519,78,96,"RECORTES CERO-GV",3
3,"3112",650,503,497,3,6,"RECORTES CERO-GV",0
46,"46059",1244,1007,995,5,12,"RECORTES CERO-GV",0
15,"15027",1563,1159,1140,23,19,"RECORTES CERO-GV",0
44,"44222",125,92,92,0,0,"RECORTES CERO-GV",0
22,"22029",118,85,83,1,2,"RECORTES CERO-GV",0
38,"38052",1283,806,794,3,12,"RECORTES CERO-GV",0
50,"50062",1885,1332,1308,15,24,"RECORTES CERO-GV",0
25,"25055",163,114,114,0,0,"RECORTES CERO-GV",0
10,"10112",1495,1071,1049,7,22,"RECORTES CERO-GV",3
4,"4031",2238,1649,1645,15,4,"RECORTES CERO-GV",0
33,"33073",8096,4377,4320,59,57,"RECORTES CERO-GV",3
3,"3083",5479,3736,3674,39,62,"RECORTES CERO-GV",0
31,"31241",126,86,85,2,1,"RECORTES CERO-GV",1
35,"35013",6593,4596,4516,47,80,"RECORTES CERO-GV",3
31,"31058",199,134,133,2,1,"RECORTES CERO-GV",0
15,"15038",2126,1312,1296,12,16,"RECORTES CERO-GV",2
7,"7035",1595,1095,1078,13,17,"RECORTES CERO-GV",1
21,"21020",349,230,228,2,2,"RECORTES CERO-GV",0
1,"1052",272,189,186,2,3,"RECORTES CERO-GV",0
25,"25148",224,158,158,0,0,"RECORTES CERO-GV",0
21,"21023",2033,1215,1193,10,22,"RECORTES CERO-GV",1
10,"10162",519,401,394,4,7,"RECORTES CERO-GV",1
43,"43166",1646,1183,1176,4,7,"RECORTES CERO-GV",4
17,"17100",193,147,141,0,6,"RECORTES CERO-GV",0
38,"38045",3542,1825,1801,7,24,"RECORTES CERO-GV",1
8,"8090",142,116,116,0,0,"RECORTES CERO-GV",0
18,"18137",968,733,731,3,2,"RECORTES CERO-GV",0
20,"20061",4427,3073,3053,13,20,"RECORTES CERO-GV",2
17,"17012",1175,845,842,4,3,"RECORTES CERO-GV",3
46,"46085",11089,7581,7503,60,78,"RECORTES CERO-GV",3
38,"38035",10518,5870,5819,37,51,"RECORTES CERO-GV",5
46,"46002",1253,946,940,4,6,"RECORTES CERO-GV",2
8,"8083",1672,1433,1430,6,3,"RECORTES CERO-GV",2
26,"26157",283,222,217,0,5,"RECORTES CERO-GV",1
8,"8246",1692,1345,1340,7,5,"RECORTES CERO-GV",0
44,"44036",22,20,20,0,0,"RECORTES CERO-GV",0
41,"41044",7753,5636,5547,55,89,"RECORTES CERO-GV",11
21,"21032",1827,1337,1314,13,23,"RECORTES CERO-GV",1
44,"44119",116,80,79,1,1,"RECORTES CERO-GV",0
12,"12901",3339,2583,2561,25,22,"RECORTES CERO-GV",2
12,"12059",220,183,183,2,0,"RECORTES CERO-GV",0
18,"18913",771,530,514,2,16,"RECORTES CERO-GV",1
12,"12050",1226,904,891,3,13,"RECORTES CERO-GV",0
43,"43125",884,658,645,12,13,"RECORTES CERO-GV",0
31,"31245",76,51,48,2,3,"RECORTES CERO-GV",0
39,"39085",7017,5029,4992,23,37,"RECORTES CERO-GV",2
14,"14030",7761,5711,5588,84,123,"RECORTES CERO-GV",4
17,"17114",23268,16423,16333,111,90,"RECORTES CERO-GV",16
50,"50065",56,37,37,0,0,"RECORTES CERO-GV",0
26,"26006",1833,1358,1335,7,23,"RECORTES CERO-GV",2
17,"17224",299,226,222,2,4,"RECORTES CERO-GV",0
18,"18082",810,503,500,3,3,"RECORTES CERO-GV",1
31,"31026",130,108,107,0,1,"RECORTES CERO-GV",0
10,"10076",791,537,525,10,12,"RECORTES CERO-GV",0
21,"21033",569,410,405,3,5,"RECORTES CERO-GV",0
43,"43063",544,376,374,2,2,"RECORTES CERO-GV",0
11,"11031",76427,49773,49248,654,525,"RECORTES CERO-GV",98
3,"3002",3649,2568,2542,11,26,"RECORTES CERO-GV",6
26,"26173",8,8,8,1,0,"RECORTES CERO-GV",0
7,"7038",2046,1416,1406,12,10,"RECORTES CERO-GV",1
8,"8178",444,363,361,2,2,"RECORTES CERO-GV",0
50,"50174",80,58,57,0,1,"RECORTES CERO-GV",0
46,"46183",6036,4276,4213,21,63,"RECORTES CERO-GV",3
32,"32021",872,555,550,6,5,"RECORTES CERO-GV",0
30,"30036",15432,10030,9879,64,151,"RECORTES CERO-GV",10
27,"27065",12055,7566,7379,119,187,"RECORTES CERO-GV",6
46,"46196",134,111,110,0,1,"RECORTES CERO-GV",0
4,"4068",170,129,128,0,1,"RECORTES CERO-GV",0
50,"50191",446,327,326,1,1,"RECORTES CERO-GV",0
35,"35027",10502,6831,6750,67,81,"RECORTES CERO-GV",3
23,"23050",90664,65260,64519,581,741,"RECORTES CERO-GV",115
15,"15088",3396,2047,2022,22,25,"RECORTES CERO-GV",3
17,"17226",884,603,600,4,3,"RECORTES CERO-GV",1
46,"46902",352,283,283,0,0,"RECORTES CERO-GV",2
26,"26087",180,123,123,3,0,"RECORTES CERO-GV",2
31,"31186",283,183,182,1,1,"RECORTES CERO-GV",1
8,"8131",745,552,550,3,2,"RECORTES CERO-GV",1
25,"25183",520,372,370,4,2,"RECORTES CERO-GV",0
50,"50067",13928,9831,9699,92,132,"RECORTES CERO-GV",7
33,"33078",127,81,81,0,0,"RECORTES CERO-GV",0
50,"50219",4283,3034,2990,30,44,"RECORTES CERO-GV",5
25,"25217",10891,7651,7610,63,41,"RECORTES CERO-GV",5
43,"43074",1818,1341,1336,2,5,"RECORTES CERO-GV",3
31,"31077",5416,3840,3794,38,46,"RECORTES CERO-GV",7
50,"50154",114,92,92,1,0,"RECORTES CERO-GV",0
22,"22068",64,41,41,1,0,"RECORTES CERO-GV",0
46,"46117",493,386,380,2,6,"RECORTES CERO-GV",1
38,"38009",4315,2846,2817,27,29,"RECORTES CERO-GV",3
44,"44114",233,161,159,0,2,"RECORTES CERO-GV",0
10,"10121",7882,5294,5183,42,111,"RECORTES CERO-GV",11
12,"12130",414,329,327,0,2,"RECORTES CERO-GV",0
44,"44200",39,26,26,0,0,"RECORTES CERO-GV",0
31,"31249",1798,1235,1227,13,8,"RECORTES CERO-GV",1
25,"25061",80,51,51,0,0,"RECORTES CERO-GV",0
39,"39033",536,375,372,1,3,"RECORTES CERO-GV",0
6,"6085",3429,2439,2382,21,57,"RECORTES CERO-GV",3
6,"6040",993,679,668,3,11,"RECORTES CERO-GV",2
50,"50060",171,126,125,1,1,"RECORTES CERO-GV",0
14,"14034",302,222,215,1,7,"RECORTES CERO-GV",0
50,"50120",55,42,42,1,0,"RECORTES CERO-GV",2
3,"3009",46125,33613,33319,315,294,"RECORTES CERO-GV",55
10,"10035",1798,1201,1171,8,30,"RECORTES CERO-GV",0
22,"22178",105,89,89,1,0,"RECORTES CERO-GV",0
43,"43097",407,331,328,4,3,"RECORTES CERO-GV",0
46,"46234",317,247,245,1,2,"RECORTES CERO-GV",0
43,"43175",534,363,359,5,4,"RECORTES CERO-GV",0
10,"10157",246,163,161,0,2,"RECORTES CERO-GV",0
50,"50166",235,186,186,0,0,"RECORTES CERO-GV",0
8,"8138",4461,3286,3259,27,27,"RECORTES CERO-GV",3
6,"6021",898,628,617,16,11,"RECORTES CERO-GV",0
12,"12045",333,243,235,2,8,"RECORTES CERO-GV",0
25,"25059",800,546,534,5,12,"RECORTES CERO-GV",0
50,"50205",72,51,49,0,2,"RECORTES CERO-GV",0
46,"46217",900,672,667,7,5,"RECORTES CERO-GV",0
21,"21075",338,243,235,3,8,"RECORTES CERO-GV",0
31,"31068",2816,2028,1989,20,39,"RECORTES CERO-GV",6
12,"12001",1028,783,768,6,15,"RECORTES CERO-GV",1
14,"14044",1613,1186,1164,10,22,"RECORTES CERO-GV",0
10,"10002",360,239,236,1,3,"RECORTES CERO-GV",1
50,"50094",1500,1041,1022,12,19,"RECORTES CERO-GV",4
50,"50263",171,110,108,1,2,"RECORTES CERO-GV",0
46,"46225",351,267,262,1,5,"RECORTES CERO-GV",0
22,"22028",358,237,233,1,4,"RECORTES CERO-GV",0
7,"7901",598,410,402,6,8,"RECORTES CERO-GV",0
50,"50054",55,37,37,2,0,"RECORTES CERO-GV",0
6,"6013",261,209,204,4,5,"RECORTES CERO-GV",1
30,"30019",25911,17485,17264,157,221,"RECORTES CERO-GV",7
38,"38036",6857,4170,4090,37,80,"RECORTES CERO-GV",2
29,"29097",4160,2872,2800,56,72,"RECORTES CERO-GV",3
43,"43157",339,279,279,1,0,"RECORTES CERO-GV",0
43,"43131",4827,3134,3116,32,18,"RECORTES CERO-GV",10
17,"17176",128,111,111,0,0,"RECORTES CERO-GV",0
15,"15048",5087,3426,3383,40,43,"RECORTES CERO-GV",2
1,"1019",148,112,112,0,0,"RECORTES CERO-GV",0
44,"44117",327,258,258,0,0,"RECORTES CERO-GV",0
25,"25253",147,118,117,0,1,"RECORTES CERO-GV",0
25,"25064",96,78,78,0,0,"RECORTES CERO-GV",0
46,"46052",515,423,419,4,4,"RECORTES CERO-GV",0
44,"44026",100,73,72,0,1,"RECORTES CERO-GV",0
8,"8137",272,208,207,2,1,"RECORTES CERO-GV",0
18,"18182",1926,1222,1204,8,18,"RECORTES CERO-GV",0
30,"30028",6390,4054,3973,25,81,"RECORTES CERO-GV",1
44,"44149",99,74,73,4,1,"RECORTES CERO-GV",0
20,"20057",198,148,147,1,1,"RECORTES CERO-GV",0
50,"50071",126,84,84,0,0,"RECORTES CERO-GV",0
8,"8067",5746,4299,4270,24,29,"RECORTES CERO-GV",3
46,"46253",112,84,84,0,0,"RECORTES CERO-GV",0
3,"3094",9795,6528,6481,37,47,"RECORTES CERO-GV",10
4,"4079",54675,35691,35365,328,326,"RECORTES CERO-GV",47
10,"10172",696,447,443,5,4,"RECORTES CERO-GV",0
6,"6148",957,682,665,1,17,"RECORTES CERO-GV",1
10,"10063",159,130,130,0,0,"RECORTES CERO-GV",0
10,"10010",2206,1308,1281,8,27,"RECORTES CERO-GV",2
48,"48064",608,461,461,0,0,"RECORTES CERO-GV",1
26,"26135",152,115,114,0,1,"RECORTES CERO-GV",0
8,"8307",49499,35471,35312,199,159,"RECORTES CERO-GV",55
14,"14038",32742,23345,22974,242,371,"RECORTES CERO-GV",30
46,"46235",21229,15171,15011,126,160,"RECORTES CERO-GV",8
26,"26017",364,274,269,2,5,"RECORTES CERO-GV",0
44,"44027",144,113,113,2,0,"RECORTES CERO-GV",0
43,"43168",83,55,55,1,0,"RECORTES CERO-GV",0
39,"39038",1512,992,983,5,9,"RECORTES CERO-GV",1
8,"8298",27148,19655,19568,102,87,"RECORTES CERO-GV",8
8,"8192",5701,4366,4349,15,17,"RECORTES CERO-GV",3
23,"23097",6346,4243,4194,31,49,"RECORTES CERO-GV",3
1,"1902",723,485,478,8,7,"RECORTES CERO-GV",0
44,"44028",171,136,136,0,0,"RECORTES CERO-GV",0
46,"46236",929,723,716,2,7,"RECORTES CERO-GV",0
18,"18028",898,723,718,3,5,"RECORTES CERO-GV",1
8,"8114",18838,13519,13442,81,77,"RECORTES CERO-GV",14
10,"10130",1754,1199,1189,10,10,"RECORTES CERO-GV",1
7,"7049",1479,935,918,5,17,"RECORTES CERO-GV",2
20,"20009",11369,7402,7355,32,47,"RECORTES CERO-GV",10
22,"22175",184,129,128,0,1,"RECORTES CERO-GV",0
6,"6126",2121,1443,1429,14,14,"RECORTES CERO-GV",0
39,"39011",1587,1178,1178,6,0,"RECORTES CERO-GV",0
25,"25215",339,249,249,5,0,"RECORTES CERO-GV",0
17,"17032",1745,1139,1133,6,6,"RECORTES CERO-GV",1
44,"44155",1063,779,778,3,1,"RECORTES CERO-GV",0
23,"23012",4004,2726,2689,21,37,"RECORTES CERO-GV",2
44,"44172",296,216,216,1,0,"RECORTES CERO-GV",0
46,"46031",10574,7233,7158,58,75,"RECORTES CERO-GV",10
48,"48047",147,105,105,2,0,"RECORTES CERO-GV",0
23,"23034",2480,1923,1882,15,41,"RECORTES CERO-GV",1
26,"26076",115,83,83,0,0,"RECORTES CERO-GV",0
31,"31180",202,144,143,1,1,"RECORTES CERO-GV",0
10,"10185",558,376,374,2,2,"RECORTES CERO-GV",1
26,"26040",64,47,47,1,0,"RECORTES CERO-GV",0
17,"17121",225,166,163,2,3,"RECORTES CERO-GV",0
41,"41041",9765,7172,6943,63,229,"RECORTES CERO-GV",2
38,"38011",21655,13974,13831,106,143,"RECORTES CERO-GV",22
6,"6022",2635,1920,1862,15,58,"RECORTES CERO-GV",6
43,"43033",766,555,555,4,0,"RECORTES CERO-GV",0
44,"44116",75,58,58,0,0,"RECORTES CERO-GV",0
25,"25238",212,161,160,0,1,"RECORTES CERO-GV",0
41,"41019",4931,3323,3251,39,72,"RECORTES CERO-GV",2
21,"21065",259,178,175,0,3,"RECORTES CERO-GV",0
6,"6144",504,391,382,6,9,"RECORTES CERO-GV",0
44,"44151",180,134,134,1,0,"RECORTES CERO-GV",0
46,"46033",196,155,153,0,2,"RECORTES CERO-GV",0
46,"46238",13117,9172,9088,50,84,"RECORTES CERO-GV",14
46,"46109",6248,4516,4440,37,76,"RECORTES CERO-GV",6
26,"26150",97,77,77,1,0,"RECORTES CERO-GV",0
8,"8094",1588,1258,1252,7,6,"RECORTES CERO-GV",1
8,"8025",1573,1170,1160,9,10,"RECORTES CERO-GV",3
6,"6099",1156,683,652,5,31,"RECORTES CERO-GV",1
23,"23901",1125,905,895,3,10,"RECORTES CERO-GV",1
38,"38018",4466,2867,2821,21,46,"RECORTES CERO-GV",1
18,"18096",340,227,226,0,1,"RECORTES CERO-GV",0
18,"18001",222,147,146,0,1,"RECORTES CERO-GV",0
1,"1030",141,102,102,0,0,"RECORTES CERO-GV",1
12,"12036",541,401,395,6,6,"RECORTES CERO-GV",0
26,"26059",1109,801,791,6,10,"RECORTES CERO-GV",1
10,"10216",1518,1082,1056,11,26,"RECORTES CERO-GV",0
23,"23063",3784,2699,2664,22,35,"RECORTES CERO-GV",0
3,"3119",17253,12346,12258,81,88,"RECORTES CERO-GV",11
39,"39061",3470,2605,2591,14,14,"RECORTES CERO-GV",3
25,"25201",110,81,81,0,0,"RECORTES CERO-GV",0
17,"17144",211,162,159,3,3,"RECORTES CERO-GV",0
43,"43040",325,268,267,1,1,"RECORTES CERO-GV",0
3,"3902",10640,7024,6952,36,72,"RECORTES CERO-GV",5
48,"48025",874,667,662,2,5,"RECORTES CERO-GV",0
46,"46158",1047,771,763,7,8,"RECORTES CERO-GV",1
50,"50123",430,304,297,3,7,"RECORTES CERO-GV",0
4,"4080",196,148,147,2,1,"RECORTES CERO-GV",0
1,"1006",174,124,122,1,2,"RECORTES CERO-GV",0
8,"8008",175,136,136,2,0,"RECORTES CERO-GV",0
15,"15080",1637,1009,992,11,17,"RECORTES CERO-GV",3
46,"46179",2136,1624,1596,17,28,"RECORTES CERO-GV",0
44,"44227",72,58,58,0,0,"RECORTES CERO-GV",0
46,"46012",965,689,675,4,14,"RECORTES CERO-GV",0
14,"14060",3715,2714,2641,41,73,"RECORTES CERO-GV",4
25,"25206",247,188,188,2,0,"RECORTES CERO-GV",0
11,"11016",15079,9353,9192,137,161,"RECORTES CERO-GV",14
30,"30009",12728,9487,9365,46,122,"RECORTES CERO-GV",5
22,"22197",436,327,325,3,2,"RECORTES CERO-GV",0
10,"10151",189,145,142,2,3,"RECORTES CERO-GV",0
20,"20905",160,123,123,2,0,"RECORTES CERO-GV",0
43,"43121",593,404,403,1,1,"RECORTES CERO-GV",2
36,"36044",2527,1535,1499,12,36,"RECORTES CERO-GV",2
23,"23066",4274,3517,3460,16,57,"RECORTES CERO-GV",3
25,"25085",141,109,108,2,1,"RECORTES CERO-GV",0
44,"44074",440,314,308,2,6,"RECORTES CERO-GV",0
43,"43165",571,469,467,2,2,"RECORTES CERO-GV",0
33,"33035",11214,7359,7303,102,56,"RECORTES CERO-GV",11
44,"44062",31,20,20,0,0,"RECORTES CERO-GV",0
30,"30027",50067,36417,36074,242,343,"RECORTES CERO-GV",47
21,"21070",6294,4232,4124,64,108,"RECORTES CERO-GV",4
6,"6014",6503,4235,4181,35,54,"RECORTES CERO-GV",7
35,"35029",4415,2498,2472,29,26,"RECORTES CERO-GV",3
8,"8258",815,636,632,5,4,"RECORTES CERO-GV",0
31,"31046",53,38,38,0,0,"RECORTES CERO-GV",0
8,"8016",1803,1371,1363,11,8,"RECORTES CERO-GV",2
17,"17132",1344,1019,1009,12,10,"RECORTES CERO-GV",0
50,"50157",289,199,196,1,3,"RECORTES CERO-GV",1
8,"8010",4224,3109,3090,22,19,"RECORTES CERO-GV",1
25,"25207",6443,4525,4492,31,33,"RECORTES CERO-GV",1
26,"26117",2105,1537,1500,17,37,"RECORTES CERO-GV",1
50,"50177",288,196,193,0,3,"RECORTES CERO-GV",0
20,"20006",261,154,153,1,1,"RECORTES CERO-GV",0
43,"43123",71435,49166,48873,318,293,"RECORTES CERO-GV",78
7,"7012",1908,1301,1282,12,19,"RECORTES CERO-GV",2
22,"22074",303,209,208,5,1,"RECORTES CERO-GV",0
46,"46227",893,687,675,6,12,"RECORTES CERO-GV",0
10,"10167",301,198,198,0,0,"RECORTES CERO-GV",0
32,"32042",1487,1010,1001,12,9,"RECORTES CERO-GV",1
14,"14009",2653,1658,1631,24,27,"RECORTES CERO-GV",0
44,"44182",203,160,158,0,2,"RECORTES CERO-GV",0
33,"33036",11281,7240,7153,96,87,"RECORTES CERO-GV",4
31,"31007",122,88,82,1,6,"RECORTES CERO-GV",1
48,"48008",609,415,407,4,8,"RECORTES CERO-GV",1
22,"22015",299,218,215,1,3,"RECORTES CERO-GV",1
20,"20038",387,294,293,2,1,"RECORTES CERO-GV",0
10,"10142",833,555,539,0,16,"RECORTES CERO-GV",1
31,"31072",5324,3733,3684,33,49,"RECORTES CERO-GV",4
26,"26130",205,153,150,1,3,"RECORTES CERO-GV",0
38,"38038",165135,101564,100807,709,757,"RECORTES CERO-GV",140
31,"31158",248,156,151,0,5,"RECORTES CERO-GV",0
25,"25170",262,210,210,1,0,"RECORTES CERO-GV",0
25,"25088",96,73,73,0,0,"RECORTES CERO-GV",0
39,"39057",2366,1636,1607,10,29,"RECORTES CERO-GV",0
44,"44128",58,39,37,0,2,"RECORTES CERO-GV",0
17,"17076",119,95,94,2,1,"RECORTES CERO-GV",0
41,"41074",2994,2154,2105,19,49,"RECORTES CERO-GV",2
43,"43116",465,356,352,0,4,"RECORTES CERO-GV",0
7,"7060",2713,1796,1772,17,24,"RECORTES CERO-GV",6
17,"17162",153,106,105,1,1,"RECORTES CERO-GV",0
18,"18007",730,490,478,3,12,"RECORTES CERO-GV",0
12,"12013",135,106,106,1,0,"RECORTES CERO-GV",0
8,"8122",1733,1179,1175,4,4,"RECORTES CERO-GV",0
44,"44141",122,88,85,0,3,"RECORTES CERO-GV",0
10,"10171",347,238,219,1,19,"RECORTES CERO-GV",1
36,"36019",1462,916,908,8,8,"RECORTES CERO-GV",0
32,"32082",1164,736,728,11,8,"RECORTES CERO-GV",1
31,"31114",388,272,271,3,1,"RECORTES CERO-GV",0
31,"31204",36,25,25,0,0,"RECORTES CERO-GV",0
6,"6004",1561,1130,1111,7,19,"RECORTES CERO-GV",2
8,"8285",10349,7630,7599,48,31,"RECORTES CERO-GV",7
15,"15083",1029,627,614,5,13,"RECORTES CERO-GV",0
50,"50176",220,142,142,3,0,"RECORTES CERO-GV",0
6,"6090",827,570,553,3,17,"RECORTES CERO-GV",1
14,"14074",2225,1775,1743,17,32,"RECORTES CERO-GV",0
50,"50131",212,152,147,4,5,"RECORTES CERO-GV",0
15,"15059",10229,6900,6734,85,166,"RECORTES CERO-GV",9
27,"27010",4378,2719,2670,49,49,"RECORTES CERO-GV",4
25,"25221",115,82,81,1,1,"RECORTES CERO-GV",0
17,"17204",609,429,428,6,1,"RECORTES CERO-GV",1
23,"23057",727,582,572,7,10,"RECORTES CERO-GV",0
38,"38012",2286,1520,1510,8,10,"RECORTES CERO-GV",0
6,"6127",2809,2105,2074,9,31,"RECORTES CERO-GV",3
6,"6158",13367,9319,9131,90,188,"RECORTES CERO-GV",21
43,"43112",245,179,179,3,0,"RECORTES CERO-GV",0
31,"31113",130,77,76,0,1,"RECORTES CERO-GV",0
41,"41047",10449,7884,7770,119,114,"RECORTES CERO-GV",20
36,"36008",21845,14553,14373,138,180,"RECORTES CERO-GV",19
50,"50236",95,77,75,0,2,"RECORTES CERO-GV",1
15,"15034",2712,1605,1585,15,20,"RECORTES CERO-GV",2
26,"26110",149,116,114,0,2,"RECORTES CERO-GV",0
25,"25022",105,80,79,0,1,"RECORTES CERO-GV",0
7,"7040",289448,169300,167908,1594,1392,"RECORTES CERO-GV",338
10,"10093",387,278,253,4,25,"RECORTES CERO-GV",0
38,"38050",2417,1288,1273,9,15,"RECORTES CERO-GV",3
17,"17079",65572,47740,47502,279,238,"RECORTES CERO-GV",61
8,"8170",442,322,320,0,2,"RECORTES CERO-GV",1
35,"35034",8392,3946,3908,27,38,"RECORTES CERO-GV",1
44,"44041",60,48,48,0,0,"RECORTES CERO-GV",0
50,"50010",67,52,52,1,0,"RECORTES CERO-GV",0
27,"27037",1001,714,707,11,7,"RECORTES CERO-GV",0
11,"11034",2319,1520,1487,17,33,"RECORTES CERO-GV",0
30,"30008",14560,9974,9840,79,134,"RECORTES CERO-GV",21
18,"18012",2114,1519,1492,9,27,"RECORTES CERO-GV",2
20,"20074",11520,8379,8357,19,22,"RECORTES CERO-GV",7
15,"15035",11189,7256,7165,104,91,"RECORTES CERO-GV",9
20,"20002",359,234,231,7,3,"RECORTES CERO-GV",1
48,"48085",10716,7707,7679,51,28,"RECORTES CERO-GV",12
8,"8061",1628,1154,1151,15,3,"RECORTES CERO-GV",2
10,"10081",176,121,119,0,2,"RECORTES CERO-GV",0
8,"8205",61957,49325,49196,441,129,"RECORTES CERO-GV",56
4,"4027",218,130,130,0,0,"RECORTES CERO-GV",0
20,"20012",149,104,104,1,0,"RECORTES CERO-GV",0
48,"48072",965,730,724,3,6,"RECORTES CERO-GV",1
10,"10086",304,228,225,4,3,"RECORTES CERO-GV",1
50,"50005",228,185,184,2,1,"RECORTES CERO-GV",0
6,"6030",168,131,128,1,3,"RECORTES CERO-GV",0
23,"23094",3739,2920,2876,29,44,"RECORTES CERO-GV",0
18,"18004",669,467,466,6,1,"RECORTES CERO-GV",0
6,"6136",1489,1086,1060,11,26,"RECORTES CERO-GV",1
31,"31010",5719,3799,3770,22,29,"RECORTES CERO-GV",12
20,"20034",3200,2193,2180,8,13,"RECORTES CERO-GV",6
8,"8234",3443,2561,2550,15,11,"RECORTES CERO-GV",2
21,"21034",1155,768,748,5,20,"RECORTES CERO-GV",0
43,"43104",1767,1285,1271,4,14,"RECORTES CERO-GV",4
20,"20904",87,56,55,1,1,"RECORTES CERO-GV",0
26,"26167",50,34,33,1,1,"RECORTES CERO-GV",0
26,"26127",182,149,149,1,0,"RECORTES CERO-GV",0
50,"50037",125,85,80,0,5,"RECORTES CERO-GV",0
12,"12132",477,391,385,3,6,"RECORTES CERO-GV",0
12,"12065",167,142,141,0,1,"RECORTES CERO-GV",0
17,"17167",2585,2015,1998,11,17,"RECORTES CERO-GV",0
35,"35028",10156,5483,5425,56,58,"RECORTES CERO-GV",1
31,"31154",217,107,104,0,3,"RECORTES CERO-GV",0
10,"10070",667,493,489,1,4,"RECORTES CERO-GV",2
41,"41051",2317,1715,1688,4,27,"RECORTES CERO-GV",1
4,"4067",504,340,330,4,10,"RECORTES CERO-GV",0
22,"22061",6567,4446,4410,48,36,"RECORTES CERO-GV",6
50,"50903",2268,1685,1670,16,15,"RECORTES CERO-GV",7
32,"32005",810,576,568,9,8,"RECORTES CERO-GV",0
17,"17082",435,308,307,1,1,"RECORTES CERO-GV",0
10,"10030",455,311,305,2,6,"RECORTES CERO-GV",0
18,"18911",7933,5464,5348,53,116,"RECORTES CERO-GV",9
8,"8127",2254,1548,1544,10,4,"RECORTES CERO-GV",0
44,"44044",82,65,65,2,0,"RECORTES CERO-GV",0
50,"50272",13226,9250,9153,97,97,"RECORTES CERO-GV",12
29,"29072",3291,2360,2307,19,53,"RECORTES CERO-GV",3
50,"50298",5439,4053,4007,41,46,"RECORTES CERO-GV",2
12,"12029",670,524,514,5,10,"RECORTES CERO-GV",0
29,"29055",1892,1425,1394,3,31,"RECORTES CERO-GV",2
11,"11038",13632,10047,9812,99,235,"RECORTES CERO-GV",9
50,"50223",906,702,693,9,9,"RECORTES CERO-GV",0
22,"22199",6884,4438,4384,71,54,"RECORTES CERO-GV",5
29,"29063",305,244,242,2,2,"RECORTES CERO-GV",0
46,"46211",1862,1395,1381,12,14,"RECORTES CERO-GV",1
50,"50063",64,49,49,0,0,"RECORTES CERO-GV",0
22,"22011",98,80,79,0,1,"RECORTES CERO-GV",0
12,"12057",572,456,437,1,19,"RECORTES CERO-GV",0
10,"10113",2231,1534,1508,14,26,"RECORTES CERO-GV",3
22,"22109",261,184,183,1,1,"RECORTES CERO-GV",0
10,"10016",329,242,232,2,10,"RECORTES CERO-GV",0
41,"41071",5571,3608,3516,64,92,"RECORTES CERO-GV",8
43,"43152",435,348,342,2,6,"RECORTES CERO-GV",0
17,"17042",410,299,297,5,2,"RECORTES CERO-GV",0
29,"29084",27199,18102,17800,268,302,"RECORTES CERO-GV",16
10,"10019",1412,948,934,2,14,"RECORTES CERO-GV",2
35,"35030",10046,5584,5505,44,79,"RECORTES CERO-GV",4
46,"46106",1471,1033,1028,8,5,"RECORTES CERO-GV",1
8,"8282",6731,5333,5317,40,16,"RECORTES CERO-GV",2
6,"6139",498,402,395,4,7,"RECORTES CERO-GV",0
46,"46053",525,433,428,2,5,"RECORTES CERO-GV",0
48,"48003",14518,10375,10310,49,65,"RECORTES CERO-GV",12
50,"50217",426,333,333,1,0,"RECORTES CERO-GV",0
50,"50117",123,93,93,4,0,"RECORTES CERO-GV",0
3,"3115",255,213,213,3,0,"RECORTES CERO-GV",1
43,"43177",276,229,227,2,2,"RECORTES CERO-GV",0
8,"8152",117,94,94,0,0,"RECORTES CERO-GV",0
25,"25068",515,359,358,0,1,"RECORTES CERO-GV",0
31,"31171",670,466,462,1,4,"RECORTES CERO-GV",0
15,"15042",2928,1879,1853,11,26,"RECORTES CERO-GV",4
26,"26019",346,260,251,2,9,"RECORTES CERO-GV",2
10,"10021",4987,3574,3475,31,99,"RECORTES CERO-GV",9
33,"33077",1097,688,683,4,5,"RECORTES CERO-GV",0
30,"30033",10377,7330,7215,59,115,"RECORTES CERO-GV",6
50,"50273",33,24,24,1,0,"RECORTES CERO-GV",0
50,"50151",607,450,449,12,1,"RECORTES CERO-GV",0
44,"44105",68,53,53,0,0,"RECORTES CERO-GV",0
10,"10048",202,141,139,0,2,"RECORTES CERO-GV",0
14,"14011",580,444,443,3,1,"RECORTES CERO-GV",0
3,"3105",5510,3879,3792,27,87,"RECORTES CERO-GV",3
6,"6160",3005,2083,2056,9,27,"RECORTES CERO-GV",1
17,"17018",494,377,372,4,5,"RECORTES CERO-GV",0
46,"46006",4454,3527,3486,27,41,"RECORTES CERO-GV",2
20,"20037",101,69,69,0,0,"RECORTES CERO-GV",0
20,"20027",2761,1866,1861,10,5,"RECORTES CERO-GV",0
48,"48066",344,246,246,2,0,"RECORTES CERO-GV",0
10,"10180",4206,2609,2574,13,35,"RECORTES CERO-GV",2
43,"43140",2433,1685,1674,11,11,"RECORTES CERO-GV",3
22,"22119",1267,880,871,4,9,"RECORTES CERO-GV",0
12,"12067",514,381,373,3,8,"RECORTES CERO-GV",0
31,"31261",240,161,158,2,3,"RECORTES CERO-GV",0
29,"29066",357,248,246,1,2,"RECORTES CERO-GV",0
8,"8085",986,769,767,6,2,"RECORTES CERO-GV",0
23,"23039",2170,1502,1460,10,42,"RECORTES CERO-GV",0
48,"48036",24015,16501,16425,83,76,"RECORTES CERO-GV",20
46,"46048",3504,2609,2576,17,33,"RECORTES CERO-GV",1
48,"48090",6004,4305,4254,28,51,"RECORTES CERO-GV",0
22,"22248",103,73,73,0,0,"RECORTES CERO-GV",0
22,"22079",118,85,84,1,1,"RECORTES CERO-GV",1
25,"25114",96,83,82,1,1,"RECORTES CERO-GV",0
50,"50002",125,91,86,0,5,"RECORTES CERO-GV",0
3,"3118",2446,1617,1598,8,19,"RECORTES CERO-GV",3
10,"10120",153,97,97,0,0,"RECORTES CERO-GV",2
31,"31065",1843,1311,1300,12,11,"RECORTES CERO-GV",1
50,"50245",74,51,51,0,0,"RECORTES CERO-GV",0
8,"8086",14137,9971,9912,77,59,"RECORTES CERO-GV",18
44,"44143",388,298,298,2,0,"RECORTES CERO-GV",0
41,"41086",16199,10227,10105,137,122,"RECORTES CERO-GV",13
26,"26124",768,603,590,4,13,"RECORTES CERO-GV",0
46,"46049",268,221,217,2,4,"RECORTES CERO-GV",0
15,"15045",3610,2057,2044,15,13,"RECORTES CERO-GV",3
25,"25185",680,452,451,0,1,"RECORTES CERO-GV",1
26,"26181",15,14,14,0,0,"RECORTES CERO-GV",0
8,"8130",110,81,81,2,0,"RECORTES CERO-GV",0
43,"43049",727,557,555,3,2,"RECORTES CERO-GV",2
50,"50182",3657,2499,2485,23,14,"RECORTES CERO-GV",12
46,"46208",1071,854,845,2,9,"RECORTES CERO-GV",2
32,"32037",679,454,446,6,8,"RECORTES CERO-GV",0
46,"46170",3417,2618,2577,11,41,"RECORTES CERO-GV",4
26,"26075",315,234,229,1,5,"RECORTES CERO-GV",0
50,"50209",2785,1893,1865,24,28,"RECORTES CERO-GV",4
10,"10099",563,369,358,3,11,"RECORTES CERO-GV",0
50,"50149",34,25,25,0,0,"RECORTES CERO-GV",0
46,"46082",4981,3547,3523,29,24,"RECORTES CERO-GV",3
25,"25016",2083,1404,1399,3,5,"RECORTES CERO-GV",0
50,"50296",385,240,235,3,5,"RECORTES CERO-GV",2
10,"10052",172,114,113,3,1,"RECORTES CERO-GV",0
29,"29033",1084,733,722,5,11,"RECORTES CERO-GV",0
33,"33014",8735,5744,5689,67,55,"RECORTES CERO-GV",7
32,"32065",633,422,419,8,3,"RECORTES CERO-GV",0
14,"14072",983,692,680,6,12,"RECORTES CERO-GV",0
31,"31179",486,315,312,3,3,"RECORTES CERO-GV",1
21,"21058",2567,1806,1766,32,40,"RECORTES CERO-GV",1
18,"18183",623,380,376,0,4,"RECORTES CERO-GV",1
30,"30026",16345,10049,9914,84,135,"RECORTES CERO-GV",8
50,"50044",224,159,159,2,0,"RECORTES CERO-GV",1
31,"31069",823,596,595,1,1,"RECORTES CERO-GV",0
26,"26049",156,120,115,0,5,"RECORTES CERO-GV",1
26,"26066",263,201,194,5,7,"RECORTES CERO-GV",0
8,"8242",223,159,159,0,0,"RECORTES CERO-GV",0
25,"25025",1362,909,898,15,11,"RECORTES CERO-GV",4
7,"7022",11659,7045,6965,84,80,"RECORTES CERO-GV",10
43,"43160",1324,967,956,6,11,"RECORTES CERO-GV",0
11,"11037",5656,4374,4273,24,101,"RECORTES CERO-GV",1
36,"36045",24459,16966,16735,124,231,"RECORTES CERO-GV",31
8,"8157",8574,6514,6472,47,42,"RECORTES CERO-GV",7
25,"25007",1378,1010,999,12,11,"RECORTES CERO-GV",0
26,"26168",5584,3757,3696,35,61,"RECORTES CERO-GV",12
41,"41904",1789,1125,1109,31,16,"RECORTES CERO-GV",1
23,"23093",3119,2264,2216,24,48,"RECORTES CERO-GV",5
31,"31143",91,44,41,1,3,"RECORTES CERO-GV",0
36,"36046",4073,2887,2818,31,69,"RECORTES CERO-GV",5
41,"41037",3201,2306,2260,22,46,"RECORTES CERO-GV",1
50,"50196",101,73,73,0,0,"RECORTES CERO-GV",1
48,"48075",2066,1524,1508,9,16,"RECORTES CERO-GV",2
44,"44157",61,37,37,0,0,"RECORTES CERO-GV",0
44,"44126",314,222,221,0,1,"RECORTES CERO-GV",0
48,"48097",1314,886,882,6,4,"RECORTES CERO-GV",0
38,"38021",1609,900,876,2,24,"RECORTES CERO-GV",0
50,"50108",50,37,37,0,0,"RECORTES CERO-GV",0
43,"43031",1447,1085,1072,13,13,"RECORTES CERO-GV",2
14,"14008",2758,1880,1836,21,44,"RECORTES CERO-GV",2
48,"48906",736,550,548,2,2,"RECORTES CERO-GV",0
22,"22082",288,217,214,0,3,"RECORTES CERO-GV",0
7,"7056",5271,3429,3386,44,43,"RECORTES CERO-GV",8
25,"25209",1586,1115,1102,6,13,"RECORTES CERO-GV",1
46,"46094",20805,15353,15211,122,142,"RECORTES CERO-GV",26
14,"14052",9039,5579,5478,79,101,"RECORTES CERO-GV",6
29,"29901",44757,29291,28960,307,331,"RECORTES CERO-GV",44
15,"15051",4545,2978,2945,47,33,"RECORTES CERO-GV",5
6,"6140",612,456,451,1,5,"RECORTES CERO-GV",0
31,"31074",394,293,292,5,1,"RECORTES CERO-GV",0
43,"43013",4406,3004,2975,19,29,"RECORTES CERO-GV",3
32,"32015",817,454,452,2,2,"RECORTES CERO-GV",0
10,"10173",558,389,385,5,4,"RECORTES CERO-GV",0
15,"15050",1732,931,917,15,14,"RECORTES CERO-GV",0
23,"23071",1704,1278,1258,10,20,"RECORTES CERO-GV",2
43,"43162",4436,3191,3163,24,28,"RECORTES CERO-GV",7
17,"17234",181,129,129,1,0,"RECORTES CERO-GV",0
22,"22063",161,128,126,0,2,"RECORTES CERO-GV",0
29,"29029",383,256,254,4,2,"RECORTES CERO-GV",0
10,"10188",483,354,340,0,14,"RECORTES CERO-GV",0
17,"17096",159,116,116,3,0,"RECORTES CERO-GV",0
6,"6110",138,105,102,0,3,"RECORTES CERO-GV",0
8,"8207",2026,1667,1659,12,8,"RECORTES CERO-GV",0
22,"22105",102,65,65,0,0,"RECORTES CERO-GV",0
6,"6155",1810,1172,1140,23,32,"RECORTES CERO-GV",2
25,"25010",194,138,136,0,2,"RECORTES CERO-GV",0
43,"43081",629,500,499,2,1,"RECORTES CERO-GV",0
31,"31013",615,371,365,1,6,"RECORTES CERO-GV",0
10,"10198",1053,897,889,4,8,"RECORTES CERO-GV",0
22,"22017",826,613,608,2,5,"RECORTES CERO-GV",0
50,"50013",199,158,158,0,0,"RECORTES CERO-GV",0
41,"41085",4182,3258,3181,43,77,"RECORTES CERO-GV",4
50,"50162",135,100,99,3,1,"RECORTES CERO-GV",0
10,"10126",1455,966,948,9,18,"RECORTES CERO-GV",1
3,"3014",238937,161861,160809,1308,1052,"RECORTES CERO-GV",159
21,"21073",1902,1073,1043,13,30,"RECORTES CERO-GV",1
25,"25013",2099,1430,1414,13,16,"RECORTES CERO-GV",2
8,"8190",255,184,182,1,2,"RECORTES CERO-GV",0
25,"25912",841,620,619,5,1,"RECORTES CERO-GV",0
22,"22172",520,373,369,5,4,"RECORTES CERO-GV",1
44,"44131",26,22,22,0,0,"RECORTES CERO-GV",0
46,"46241",388,288,283,5,5,"RECORTES CERO-GV",0
22,"22167",465,358,356,8,2,"RECORTES CERO-GV",0
3,"3023",1377,1138,1122,9,16,"RECORTES CERO-GV",0
7,"7026",31129,17489,17342,178,147,"RECORTES CERO-GV",45
46,"46079",314,244,240,0,4,"RECORTES CERO-GV",0
32,"32064",453,304,302,0,2,"RECORTES CERO-GV",0
41,"41058",17956,12890,12553,200,337,"RECORTES CERO-GV",20
8,"8139",172,148,147,2,1,"RECORTES CERO-GV",0
27,"27902",7122,4472,4385,43,87,"RECORTES CERO-GV",7
21,"21066",490,394,389,4,5,"RECORTES CERO-GV",2
46,"46193",8959,6880,6824,66,56,"RECORTES CERO-GV",11
46,"46259",457,374,371,2,3,"RECORTES CERO-GV",0
23,"23099",4824,3523,3435,35,88,"RECORTES CERO-GV",5
39,"39041",1753,1285,1269,7,16,"RECORTES CERO-GV",0
18,"18154",982,668,668,4,0,"RECORTES CERO-GV",1
7,"7029",4393,2888,2855,37,33,"RECORTES CERO-GV",5
18,"18057",5584,4042,3958,51,84,"RECORTES CERO-GV",4
33,"33004",65304,43473,43153,563,320,"RECORTES CERO-GV",53
35,"35021",15072,9791,9696,80,95,"RECORTES CERO-GV",10
6,"6119",674,516,511,1,5,"RECORTES CERO-GV",0
8,"8233",1872,1428,1420,15,8,"RECORTES CERO-GV",0
26,"26026",1268,986,970,4,16,"RECORTES CERO-GV",0
23,"23045",2054,1423,1412,10,11,"RECORTES CERO-GV",0
25,"25112",269,205,200,2,5,"RECORTES CERO-GV",0
27,"27057",11047,7078,6941,64,137,"RECORTES CERO-GV",8
22,"22193",272,199,194,4,5,"RECORTES CERO-GV",0
17,"17097",200,170,167,2,3,"RECORTES CERO-GV",0
18,"18134",6104,4049,3972,39,77,"RECORTES CERO-GV",6
43,"43108",1787,1293,1282,6,11,"RECORTES CERO-GV",3
17,"17158",565,296,295,2,1,"RECORTES CERO-GV",1
15,"15092",6220,3810,3756,30,54,"RECORTES CERO-GV",1
25,"25100",184,137,136,1,1,"RECORTES CERO-GV",1
8,"8197",7986,5829,5805,37,24,"RECORTES CERO-GV",7
12,"12141",92,72,72,0,0,"RECORTES CERO-GV",0
46,"46127",2748,2035,2009,6,26,"RECORTES CERO-GV",1
46,"46218",1043,842,829,6,13,"RECORTES CERO-GV",0
23,"23080",1720,1313,1294,6,19,"RECORTES CERO-GV",2
4,"4085",360,291,289,0,2,"RECORTES CERO-GV",1
33,"33051",6787,4318,4268,48,50,"RECORTES CERO-GV",7
3,"3054",334,248,245,2,3,"RECORTES CERO-GV",2
11,"11004",89919,55211,54544,830,667,"RECORTES CERO-GV",61
44,"44031",83,50,50,0,0,"RECORTES CERO-GV",0
43,"43145",4209,3193,3170,17,23,"RECORTES CERO-GV",3
50,"50214",18,18,14,1,4,"RECORTES CERO-GV",0
43,"43054",2807,1972,1957,14,15,"RECORTES CERO-GV",0
25,"25177",356,252,250,1,2,"RECORTES CERO-GV",0
31,"31086",13781,10133,10054,114,79,"RECORTES CERO-GV",43
22,"22160",207,149,149,1,0,"RECORTES CERO-GV",0
22,"22163",426,338,335,0,3,"RECORTES CERO-GV",0
10,"10139",92,66,65,1,1,"RECORTES CERO-GV",0
6,"6105",592,367,363,1,4,"RECORTES CERO-GV",1
17,"17090",539,440,440,2,0,"RECORTES CERO-GV",0
4,"4089",687,484,479,2,5,"RECORTES CERO-GV",0
3,"3137",654,449,443,7,6,"RECORTES CERO-GV",0
36,"36039",15609,10562,10341,102,221,"RECORTES CERO-GV",26
38,"38049",2690,1406,1389,27,17,"RECORTES CERO-GV",1
50,"50091",39,32,32,0,0,"RECORTES CERO-GV",0
11,"11041",9869,6438,6295,100,143,"RECORTES CERO-GV",4
50,"50116",169,124,123,0,1,"RECORTES CERO-GV",0
12,"12005",8049,5643,5552,71,91,"RECORTES CERO-GV",3
27,"27064",1505,972,951,9,21,"RECORTES CERO-GV",2
41,"41018",9432,6463,6368,86,95,"RECORTES CERO-GV",13
35,"35011",24859,15025,14833,149,192,"RECORTES CERO-GV",24
43,"43023",211,171,169,2,2,"RECORTES CERO-GV",0
38,"38044",2215,1270,1257,5,13,"RECORTES CERO-GV",0
22,"22115",348,263,261,3,2,"RECORTES CERO-GV",1
3,"3046",1636,1073,1061,7,12,"RECORTES CERO-GV",1
14,"14014",2496,1962,1907,20,55,"RECORTES CERO-GV",1
46,"46064",532,395,387,3,8,"RECORTES CERO-GV",2
8,"8036",163,122,122,0,0,"RECORTES CERO-GV",1
27,"27046",1444,945,921,7,24,"RECORTES CERO-GV",1
17,"17137",3486,2812,2808,15,4,"RECORTES CERO-GV",2
26,"26098",92,63,63,1,0,"RECORTES CERO-GV",0
22,"22022",542,405,403,2,2,"RECORTES CERO-GV",1
18,"18188",1646,1224,1202,10,22,"RECORTES CERO-GV",0
41,"41091",539590,389351,384943,4676,4408,"RECORTES CERO-GV",550
17,"17020",3677,2851,2835,14,16,"RECORTES CERO-GV",0
6,"6069",2985,1921,1874,17,47,"RECORTES CERO-GV",1
18,"18136",1778,1320,1284,14,36,"RECORTES CERO-GV",0
18,"18127",17005,11790,11583,150,207,"RECORTES CERO-GV",22
8,"8147",17389,12679,12601,102,78,"RECORTES CERO-GV",18
48,"48912",2321,1684,1670,8,14,"RECORTES CERO-GV",1
33,"33045",4359,2819,2787,32,32,"RECORTES CERO-GV",4
43,"43011",1086,862,860,5,2,"RECORTES CERO-GV",0
12,"12113",90,59,59,1,0,"RECORTES CERO-GV",0
22,"22230",291,209,207,4,2,"RECORTES CERO-GV",0
6,"6023",4138,2811,2749,12,62,"RECORTES CERO-GV",3
32,"32036",1242,856,838,14,18,"RECORTES CERO-GV",1
22,"22088",143,98,97,1,1,"RECORTES CERO-GV",1
43,"43086",5252,3811,3790,28,21,"RECORTES CERO-GV",2
7,"7004",4069,2652,2624,27,28,"RECORTES CERO-GV",6
29,"29020",3278,2329,2260,22,69,"RECORTES CERO-GV",0
18,"18069",484,356,356,5,0,"RECORTES CERO-GV",1
4,"4100",9433,5599,5556,48,43,"RECORTES CERO-GV",6
39,"39023",6563,4788,4753,14,35,"RECORTES CERO-GV",2
3,"3039",89,65,65,0,0,"RECORTES CERO-GV",0
12,"12032",23728,16870,16726,121,144,"RECORTES CERO-GV",12
12,"12026",828,577,566,11,11,"RECORTES CERO-GV",0
48,"48068",1534,1154,1149,1,5,"RECORTES CERO-GV",0
50,"50163",3846,2863,2840,25,23,"RECORTES CERO-GV",4
8,"8041",10698,7324,7258,57,66,"RECORTES CERO-GV",13
6,"6024",1123,876,849,3,27,"RECORTES CERO-GV",1
43,"43171",14849,10140,10081,76,59,"RECORTES CERO-GV",20
32,"32077",1104,703,700,9,3,"RECORTES CERO-GV",0
26,"26035",16,12,11,0,1,"RECORTES CERO-GV",0
21,"21036",204,128,121,1,7,"RECORTES CERO-GV",0
6,"6034",171,114,114,2,0,"RECORTES CERO-GV",0
22,"22207",121,66,65,0,1,"RECORTES CERO-GV",0
3,"3090",18095,12539,12412,75,127,"RECORTES CERO-GV",12
39,"39067",753,476,474,1,2,"RECORTES CERO-GV",0
44,"44244",67,40,40,0,0,"RECORTES CERO-GV",0
25,"25045",57,26,26,2,0,"RECORTES CERO-GV",0
33,"33016",18848,12845,12737,173,108,"RECORTES CERO-GV",17
50,"50078",227,168,166,0,2,"RECORTES CERO-GV",0
26,"26176",56,43,43,0,0,"RECORTES CERO-GV",0
6,"6150",777,592,588,0,4,"RECORTES CERO-GV",3
18,"18140",42474,26967,26648,225,319,"RECORTES CERO-GV",24
36,"36058",4957,3043,2994,55,49,"RECORTES CERO-GV",2
18,"18042",417,332,330,4,2,"RECORTES CERO-GV",0
44,"44164",19,16,16,1,0,"RECORTES CERO-GV",0
39,"39095",2266,1637,1619,8,18,"RECORTES CERO-GV",2
50,"50021",25,21,21,0,0,"RECORTES CERO-GV",0
25,"25126",281,211,210,1,1,"RECORTES CERO-GV",0
41,"41901",2692,2101,2051,47,50,"RECORTES CERO-GV",1
3,"3060",105,78,77,0,1,"RECORTES CERO-GV",0
31,"31147",110,79,78,1,1,"RECORTES CERO-GV",0
8,"8043",3414,2429,2422,15,7,"RECORTES CERO-GV",0
27,"27029",1425,925,910,11,15,"RECORTES CERO-GV",0
23,"23007",3015,2252,2229,14,23,"RECORTES CERO-GV",1
41,"41045",5873,3901,3802,53,99,"RECORTES CERO-GV",3
32,"32041",752,462,458,4,4,"RECORTES CERO-GV",0
22,"22127",521,353,352,5,1,"RECORTES CERO-GV",3
50,"50018",883,622,616,5,6,"RECORTES CERO-GV",0
50,"50220",45,38,38,0,0,"RECORTES CERO-GV",2
46,"46051",8469,6120,6070,40,50,"RECORTES CERO-GV",8
21,"21059",221,169,163,1,6,"RECORTES CERO-GV",0
10,"10202",583,457,453,1,4,"RECORTES CERO-GV",0
46,"46074",2687,2033,2020,18,13,"RECORTES CERO-GV",4
48,"48071",6013,4240,4205,23,35,"RECORTES CERO-GV",5
20,"20042",3180,2056,2053,7,3,"RECORTES CERO-GV",2
26,"26142",789,572,564,6,8,"RECORTES CERO-GV",0
6,"6120",3370,2507,2460,11,47,"RECORTES CERO-GV",2
3,"3026",1331,987,975,7,12,"RECORTES CERO-GV",3
50,"50092",290,218,214,0,4,"RECORTES CERO-GV",1
39,"39082",1611,1108,1102,8,6,"RECORTES CERO-GV",1
23,"23037",518,403,398,10,5,"RECORTES CERO-GV",2
46,"46132",2176,1725,1708,5,17,"RECORTES CERO-GV",0
50,"50201",449,345,344,4,1,"RECORTES CERO-GV",0
31,"31122",4981,3539,3504,38,35,"RECORTES CERO-GV",18
43,"43902",2751,1794,1776,21,18,"RECORTES CERO-GV",2
29,"29024",371,216,204,3,12,"RECORTES CERO-GV",0
17,"17067",704,551,549,6,2,"RECORTES CERO-GV",1
44,"44004",379,275,275,2,0,"RECORTES CERO-GV",0
6,"6063",2924,2141,2108,8,33,"RECORTES CERO-GV",0
50,"50192",227,182,181,0,1,"RECORTES CERO-GV",0
48,"48909",201,158,157,0,1,"RECORTES CERO-GV",0
26,"26119",178,132,132,0,0,"RECORTES CERO-GV",0
8,"8301",49348,36261,36045,292,216,"RECORTES CERO-GV",68
10,"10138",527,386,379,2,7,"RECORTES CERO-GV",0
18,"18910",710,439,434,1,5,"RECORTES CERO-GV",0
43,"43096",97,76,76,0,0,"RECORTES CERO-GV",0
33,"33060",13991,8629,8481,109,148,"RECORTES CERO-GV",8
25,"25036",180,124,124,1,0,"RECORTES CERO-GV",0
4,"4045",1696,1268,1254,17,14,"RECORTES CERO-GV",0
48,"48078",37858,25959,25819,157,140,"RECORTES CERO-GV",44
18,"18093",2751,1693,1674,18,19,"RECORTES CERO-GV",0
6,"6003",768,579,557,4,22,"RECORTES CERO-GV",0
20,"20070",1084,798,795,7,3,"RECORTES CERO-GV",2
25,"25093",629,455,443,5,12,"RECORTES CERO-GV",1
14,"14058",7866,5451,5334,69,117,"RECORTES CERO-GV",7
44,"44101",55,41,40,1,1,"RECORTES CERO-GV",0
31,"31005",279,183,183,4,0,"RECORTES CERO-GV",0
10,"10065",199,135,135,0,0,"RECORTES CERO-GV",0
10,"10134",550,361,354,1,7,"RECORTES CERO-GV",0
26,"26172",25,16,15,0,1,"RECORTES CERO-GV",0
25,"25048",1641,1207,1194,13,13,"RECORTES CERO-GV",0
8,"8238",14946,11911,11873,85,38,"RECORTES CERO-GV",12
31,"31225",35,29,28,0,1,"RECORTES CERO-GV",0
10,"10169",497,370,366,0,4,"RECORTES CERO-GV",0
33,"33013",430,294,292,1,2,"RECORTES CERO-GV",0
46,"46198",862,670,660,3,10,"RECORTES CERO-GV",0
6,"6053",592,441,428,7,13,"RECORTES CERO-GV",3
15,"15069",6604,4587,4520,55,67,"RECORTES CERO-GV",13
10,"10905",636,443,433,7,10,"RECORTES CERO-GV",0
31,"31220",742,551,539,6,12,"RECORTES CERO-GV",0
10,"10056",533,377,371,2,6,"RECORTES CERO-GV",0
44,"44068",634,497,493,2,4,"RECORTES CERO-GV",0
29,"29001",4207,3002,2959,40,43,"RECORTES CERO-GV",1
48,"48044",61957,45253,45063,299,190,"RECORTES CERO-GV",46
44,"44010",185,144,143,0,1,"RECORTES CERO-GV",0
50,"50203",1065,817,804,5,13,"RECORTES CERO-GV",2
31,"31203",30,19,19,2,0,"RECORTES CERO-GV",0
4,"4041",344,227,222,4,5,"RECORTES CERO-GV",0
25,"25903",226,169,169,1,0,"RECORTES CERO-GV",0
41,"41077",8631,5788,5598,51,190,"RECORTES CERO-GV",2
39,"39060",6704,4959,4887,23,72,"RECORTES CERO-GV",6
29,"29091",9490,6428,6304,61,124,"RECORTES CERO-GV",12
14,"14042",18695,13788,13514,206,274,"RECORTES CERO-GV",19
8,"8119",6897,5096,5052,31,44,"RECORTES CERO-GV",10
50,"50156",212,156,151,2,5,"RECORTES CERO-GV",0
46,"46041",313,229,228,1,1,"RECORTES CERO-GV",0
31,"31264",179,91,90,2,1,"RECORTES CERO-GV",0
25,"25042",204,149,149,5,0,"RECORTES CERO-GV",0
44,"44181",65,57,57,0,0,"RECORTES CERO-GV",0
26,"26021",2742,1967,1932,14,35,"RECORTES CERO-GV",1
15,"15002",24040,16302,16117,183,185,"RECORTES CERO-GV",24
25,"25134",605,457,456,5,1,"RECORTES CERO-GV",0
26,"26114",72,61,61,0,0,"RECORTES CERO-GV",0
29,"29061",1043,803,773,9,30,"RECORTES CERO-GV",2
25,"25164",353,259,255,0,4,"RECORTES CERO-GV",0
21,"21045",231,177,174,4,3,"RECORTES CERO-GV",0
10,"10165",252,204,201,3,3,"RECORTES CERO-GV",0
10,"10061",1591,1010,992,9,18,"RECORTES CERO-GV",3
31,"31166",242,172,172,2,0,"RECORTES CERO-GV",0
35,"35008",6214,4193,4143,33,50,"RECORTES CERO-GV",3
48,"48019",3429,2424,2411,14,13,"RECORTES CERO-GV",5
39,"39098",1381,1088,1080,5,8,"RECORTES CERO-GV",0
43,"43060",2672,2032,2015,7,17,"RECORTES CERO-GV",0
39,"39076",3512,2517,2491,13,26,"RECORTES CERO-GV",2
17,"17087",219,179,177,0,2,"RECORTES CERO-GV",0
17,"17016",737,570,563,2,7,"RECORTES CERO-GV",0
41,"41023",7999,5500,5435,60,65,"RECORTES CERO-GV",4
12,"12072",1083,852,827,10,25,"RECORTES CERO-GV",0
3,"3061",1060,793,787,5,6,"RECORTES CERO-GV",0
11,"11040",396,332,324,3,8,"RECORTES CERO-GV",0
8,"8078",216,154,154,2,0,"RECORTES CERO-GV",0
41,"41039",31538,22078,21717,278,361,"RECORTES CERO-GV",19
33,"33067",751,543,538,7,5,"RECORTES CERO-GV",0
39,"39045",352,238,234,0,4,"RECORTES CERO-GV",0
3,"3017",379,320,314,4,6,"RECORTES CERO-GV",0
50,"50073",2122,1559,1540,14,19,"RECORTES CERO-GV",2
8,"8227",2420,1775,1769,11,6,"RECORTES CERO-GV",1
18,"18116",2856,2027,1979,13,48,"RECORTES CERO-GV",3
50,"50902",77,65,62,0,3,"RECORTES CERO-GV",0
44,"44035",102,82,80,1,2,"RECORTES CERO-GV",0
18,"18192",1462,1125,1103,3,22,"RECORTES CERO-GV",0
6,"6115",1243,808,798,8,10,"RECORTES CERO-GV",2
46,"46023",322,254,252,1,2,"RECORTES CERO-GV",0
44,"44237",367,267,262,0,5,"RECORTES CERO-GV",0
8,"8255",133,100,100,2,0,"RECORTES CERO-GV",0
31,"31207",280,194,191,3,3,"RECORTES CERO-GV",1
8,"8281",4858,3783,3762,19,21,"RECORTES CERO-GV",8
20,"20029",4264,3116,3104,14,12,"RECORTES CERO-GV",2
48,"48053",926,704,702,6,2,"RECORTES CERO-GV",0
32,"32069",4223,3064,3023,31,41,"RECORTES CERO-GV",4
8,"8185",197,162,162,1,0,"RECORTES CERO-GV",0
35,"35018",13153,7742,7674,80,68,"RECORTES CERO-GV",7
10,"10152",444,312,309,2,3,"RECORTES CERO-GV",0
46,"46213",15499,10610,10482,173,128,"RECORTES CERO-GV",14
20,"20023",441,254,251,1,3,"RECORTES CERO-GV",1
4,"4096",285,222,222,0,0,"RECORTES CERO-GV",0
39,"39050",260,164,164,1,0,"RECORTES CERO-GV",0
43,"43042",2215,1723,1710,18,13,"RECORTES CERO-GV",0
4,"4063",1058,766,750,6,16,"RECORTES CERO-GV",0
12,"12010",232,191,187,3,4,"RECORTES CERO-GV",0
8,"8046",13541,10510,10455,73,55,"RECORTES CERO-GV",8
8,"8124",37157,27139,26994,179,145,"RECORTES CERO-GV",40
1,"1051",3569,2259,2244,3,15,"RECORTES CERO-GV",2
10,"10103",422,290,286,1,4,"RECORTES CERO-GV",1
27,"27016",6958,4697,4616,50,81,"RECORTES CERO-GV",6
48,"48022",2305,1434,1425,11,9,"RECORTES CERO-GV",0
25,"25212",219,176,176,1,0,"RECORTES CERO-GV",0
6,"6029",1174,873,865,5,8,"RECORTES CERO-GV",1
22,"22057",364,253,248,4,5,"RECORTES CERO-GV",0
50,"50031",134,78,75,0,3,"RECORTES CERO-GV",0
26,"26034",606,457,440,5,17,"RECORTES CERO-GV",0
46,"46157",2959,2145,2126,11,19,"RECORTES CERO-GV",0
8,"8030",5208,4045,4033,25,12,"RECORTES CERO-GV",3
48,"48087",437,335,332,0,3,"RECORTES CERO-GV",0
15,"15003",1675,1029,1020,9,9,"RECORTES CERO-GV",1
25,"25243",3729,2370,2349,33,21,"RECORTES CERO-GV",3
29,"29019",853,604,588,2,16,"RECORTES CERO-GV",0
25,"25125",383,265,265,3,0,"RECORTES CERO-GV",0
3,"3122",43774,30060,29834,230,226,"RECORTES CERO-GV",51
26,"26031",95,83,83,0,0,"RECORTES CERO-GV",0
38,"38017",30964,16228,16102,108,126,"RECORTES CERO-GV",19
33,"33032",11056,7052,6905,109,147,"RECORTES CERO-GV",11
12,"12127",63,45,44,1,1,"RECORTES CERO-GV",0
4,"4070",1529,1088,1076,8,12,"RECORTES CERO-GV",2
30,"30023",3874,2831,2788,18,43,"RECORTES CERO-GV",2
44,"44040",189,153,150,1,3,"RECORTES CERO-GV",0
44,"44012",303,215,215,2,0,"RECORTES CERO-GV",0
4,"4028",207,175,171,1,4,"RECORTES CERO-GV",0
39,"39026",1702,1160,1151,11,9,"RECORTES CERO-GV",0
7,"7019",161,104,102,0,2,"RECORTES CERO-GV",1
33,"33023",3249,2127,2097,30,30,"RECORTES CERO-GV",3
32,"32016",714,494,493,12,1,"RECORTES CERO-GV",0
21,"21035",9766,6114,5998,92,116,"RECORTES CERO-GV",6
43,"43057",38,32,32,1,0,"RECORTES CERO-GV",0
18,"18035",1179,882,870,7,12,"RECORTES CERO-GV",0
43,"43005",3677,2505,2493,17,12,"RECORTES CERO-GV",4
46,"46246",1049,808,793,3,15,"RECORTES CERO-GV",1
50,"50283",69,46,46,0,0,"RECORTES CERO-GV",0
8,"8196",19542,14264,14185,123,79,"RECORTES CERO-GV",18
12,"12124",1842,1343,1328,13,15,"RECORTES CERO-GV",1
7,"7030",1598,1127,1098,14,29,"RECORTES CERO-GV",1
27,"27040",3008,2071,2046,21,25,"RECORTES CERO-GV",0
50,"50160",2140,1421,1394,14,27,"RECORTES CERO-GV",4
46,"46112",533,435,432,7,3,"RECORTES CERO-GV",0
43,"43014",14386,9542,9464,74,78,"RECORTES CERO-GV",6
31,"31041",1671,1118,1105,15,13,"RECORTES CERO-GV",1
25,"25233",289,219,218,6,1,"RECORTES CERO-GV",0
17,"17134",220,175,174,1,1,"RECORTES CERO-GV",1
22,"22058",193,141,141,0,0,"RECORTES CERO-GV",0
15,"15061",5149,3221,3168,44,53,"RECORTES CERO-GV",1
12,"12015",115,94,94,0,0,"RECORTES CERO-GV",0
11,"11010",6327,3998,3928,112,70,"RECORTES CERO-GV",3
22,"22236",232,190,188,2,2,"RECORTES CERO-GV",0
44,"44138",120,92,92,0,0,"RECORTES CERO-GV",0
44,"44038",101,85,83,1,2,"RECORTES CERO-GV",0
27,"27032",3197,1979,1956,30,23,"RECORTES CERO-GV",3
18,"18006",4062,2765,2711,25,54,"RECORTES CERO-GV",2
25,"25180",227,158,155,1,3,"RECORTES CERO-GV",0
46,"46061",351,276,272,6,4,"RECORTES CERO-GV",0
26,"26180",221,164,162,4,2,"RECORTES CERO-GV",0
46,"46092",262,176,174,2,2,"RECORTES CERO-GV",2
31,"31057",1741,1237,1219,6,18,"RECORTES CERO-GV",2
41,"41017",15907,11486,11302,158,184,"RECORTES CERO-GV",14
50,"50229",65,46,46,1,0,"RECORTES CERO-GV",4
46,"46129",511,389,379,9,10,"RECORTES CERO-GV",1
18,"18079",3466,2391,2333,22,58,"RECORTES CERO-GV",1
46,"46175",429,362,355,3,7,"RECORTES CERO-GV",0
50,"50007",51,34,34,1,0,"RECORTES CERO-GV",0
10,"10011",518,385,370,2,15,"RECORTES CERO-GV",0
31,"31134",172,106,106,1,0,"RECORTES CERO-GV",0
10,"10075",238,150,148,0,2,"RECORTES CERO-GV",1
31,"31061",48,45,45,2,0,"RECORTES CERO-GV",0
3,"3045",216,176,172,1,4,"RECORTES CERO-GV",1
8,"8048",580,427,426,1,1,"RECORTES CERO-GV",1
8,"8254",1766,1433,1427,16,6,"RECORTES CERO-GV",1
35,"35026",83172,48751,48109,449,642,"RECORTES CERO-GV",53
7,"7048",18455,9929,9858,116,71,"RECORTES CERO-GV",34
31,"31260",1265,817,815,7,2,"RECORTES CERO-GV",2
10,"10147",1277,873,837,6,36,"RECORTES CERO-GV",2
31,"31053",509,354,350,4,4,"RECORTES CERO-GV",0
23,"23016",386,313,305,4,8,"RECORTES CERO-GV",0
50,"50211",236,174,173,0,1,"RECORTES CERO-GV",0
12,"12007",724,622,614,2,8,"RECORTES CERO-GV",0
8,"8283",6165,4546,4524,33,22,"RECORTES CERO-GV",3
45,"45901",779,542,534,5,8,"RECORTES CERO-GV-PCAS-TC",3
40,"40109",69,51,50,3,1,"RECORTES CERO-GV-PCAS-TC",0
47,"47025",114,85,85,3,0,"RECORTES CERO-GV-PCAS-TC",0
28,"28036",2699,1977,1957,20,20,"RECORTES CERO-GV-PCAS-TC",1
37,"37194",229,161,160,0,1,"RECORTES CERO-GV-PCAS-TC",0
40,"40020",149,112,111,1,1,"RECORTES CERO-GV-PCAS-TC",0
45,"45144",736,562,557,1,5,"RECORTES CERO-GV-PCAS-TC",0
28,"28180",5317,4011,3959,35,52,"RECORTES CERO-GV-PCAS-TC",0
24,"24163",4076,2979,2954,35,25,"RECORTES CERO-GV-PCAS-TC",0
19,"19227",68,42,41,1,1,"RECORTES CERO-GV-PCAS-TC",0
19,"19212",678,501,491,1,10,"RECORTES CERO-GV-PCAS-TC",0
5,"5105",330,247,242,2,5,"RECORTES CERO-GV-PCAS-TC",0
24,"24081",121,72,72,0,0,"RECORTES CERO-GV-PCAS-TC",0
16,"16055",669,429,426,0,3,"RECORTES CERO-GV-PCAS-TC",0
47,"47172",135,114,113,0,1,"RECORTES CERO-GV-PCAS-TC",0
42,"42212",57,45,45,2,0,"RECORTES CERO-GV-PCAS-TC",1
13,"13058",4026,2822,2766,29,56,"RECORTES CERO-GV-PCAS-TC",2
19,"19111",160,128,125,0,3,"RECORTES CERO-GV-PCAS-TC",0
37,"37264",56,39,39,0,0,"RECORTES CERO-GV-PCAS-TC",0
9,"9017",89,61,60,3,1,"RECORTES CERO-GV-PCAS-TC",1
9,"9098",470,318,309,3,9,"RECORTES CERO-GV-PCAS-TC",0
47,"47065",820,608,602,2,6,"RECORTES CERO-GV-PCAS-TC",2
45,"45186",2943,2142,2121,12,21,"RECORTES CERO-GV-PCAS-TC",1
40,"40115",142,100,100,0,0,"RECORTES CERO-GV-PCAS-TC",1
37,"37061",195,136,136,1,0,"RECORTES CERO-GV-PCAS-TC",0
5,"5079",66,53,52,0,1,"RECORTES CERO-GV-PCAS-TC",0
9,"9337",113,80,77,2,3,"RECORTES CERO-GV-PCAS-TC",0
34,"34102",197,158,156,1,2,"RECORTES CERO-GV-PCAS-TC",0
24,"24148",1602,1152,1140,11,12,"RECORTES CERO-GV-PCAS-TC",1
24,"24086",258,197,196,1,1,"RECORTES CERO-GV-PCAS-TC",0
40,"40007",68,55,55,1,0,"RECORTES CERO-GV-PCAS-TC",0
19,"19156",917,686,679,2,7,"RECORTES CERO-GV-PCAS-TC",2
28,"28169",1577,1214,1209,7,5,"RECORTES CERO-GV-PCAS-TC",4
28,"28031",2129,1501,1486,8,15,"RECORTES CERO-GV-PCAS-TC",0
34,"34052",164,127,125,1,2,"RECORTES CERO-GV-PCAS-TC",2
34,"34186",49,44,44,0,0,"RECORTES CERO-GV-PCAS-TC",0
34,"34057",464,308,302,4,6,"RECORTES CERO-GV-PCAS-TC",2
28,"28083",9836,7278,7206,64,72,"RECORTES CERO-GV-PCAS-TC",13
16,"16133",4399,3317,3256,34,61,"RECORTES CERO-GV-PCAS-TC",2
19,"19168",265,182,175,4,7,"RECORTES CERO-GV-PCAS-TC",0
9,"9173",123,96,93,2,3,"RECORTES CERO-GV-PCAS-TC",0
16,"16204",237,179,177,1,2,"RECORTES CERO-GV-PCAS-TC",1
16,"16211",335,228,227,1,1,"RECORTES CERO-GV-PCAS-TC",0
28,"28173",523,384,381,1,3,"RECORTES CERO-GV-PCAS-TC",0
42,"42097",14,9,9,1,0,"RECORTES CERO-GV-PCAS-TC",0
37,"37359",165,105,103,0,2,"RECORTES CERO-GV-PCAS-TC",0
28,"28066",7575,5771,5718,58,53,"RECORTES CERO-GV-PCAS-TC",4
19,"19217",43,36,36,0,0,"RECORTES CERO-GV-PCAS-TC",0
24,"24028",367,275,273,5,2,"RECORTES CERO-GV-PCAS-TC",0
42,"42029",131,94,94,4,0,"RECORTES CERO-GV-PCAS-TC",0
37,"37082",733,468,456,7,12,"RECORTES CERO-GV-PCAS-TC",0
19,"19177",60,45,45,0,0,"RECORTES CERO-GV-PCAS-TC",0
42,"42177",61,42,41,0,1,"RECORTES CERO-GV-PCAS-TC",0
37,"37306",238,140,136,3,4,"RECORTES CERO-GV-PCAS-TC",0
49,"49128",520,384,378,7,6,"RECORTES CERO-GV-PCAS-TC",2
16,"16170",646,451,449,5,2,"RECORTES CERO-GV-PCAS-TC",0
37,"37244",129,97,97,1,0,"RECORTES CERO-GV-PCAS-TC",0
40,"40230",93,66,64,0,2,"RECORTES CERO-GV-PCAS-TC",1
16,"16188",74,57,57,1,0,"RECORTES CERO-GV-PCAS-TC",0
28,"28049",57814,44977,44559,385,418,"RECORTES CERO-GV-PCAS-TC",61
9,"9100",55,33,33,0,0,"RECORTES CERO-GV-PCAS-TC",0
5,"5901",247,154,152,3,2,"RECORTES CERO-GV-PCAS-TC",0
2,"2022",341,243,243,2,0,"RECORTES CERO-GV-PCAS-TC",0
19,"19303",41,32,32,0,0,"RECORTES CERO-GV-PCAS-TC",0
9,"9427",1363,854,842,7,12,"RECORTES CERO-GV-PCAS-TC",5
13,"13078",8946,6166,6103,49,63,"RECORTES CERO-GV-PCAS-TC",11
19,"19160",883,535,530,11,5,"RECORTES CERO-GV-PCAS-TC",0
40,"40180",276,215,210,2,5,"RECORTES CERO-GV-PCAS-TC",0
28,"28163",429,332,326,0,6,"RECORTES CERO-GV-PCAS-TC",0
45,"45172",640,475,462,6,13,"RECORTES CERO-GV-PCAS-TC",0
9,"9091",686,479,467,4,12,"RECORTES CERO-GV-PCAS-TC",0
40,"40210",97,69,69,1,0,"RECORTES CERO-GV-PCAS-TC",0
40,"40047",37,23,23,0,0,"RECORTES CERO-GV-PCAS-TC",0
19,"19238",43,30,28,0,2,"RECORTES CERO-GV-PCAS-TC",0
2,"2036",93,66,66,0,0,"RECORTES CERO-GV-PCAS-TC",0
24,"24170",1806,1232,1220,9,12,"RECORTES CERO-GV-PCAS-TC",1
37,"37379",169,133,132,0,1,"RECORTES CERO-GV-PCAS-TC",0
40,"40142",52,39,37,0,2,"RECORTES CERO-GV-PCAS-TC",0
34,"34245",307,212,212,0,0,"RECORTES CERO-GV-PCAS-TC",0
34,"34129",168,118,118,1,0,"RECORTES CERO-GV-PCAS-TC",0
5,"5240",3346,2259,2232,11,27,"RECORTES CERO-GV-PCAS-TC",1
19,"19127",88,60,60,1,0,"RECORTES CERO-GV-PCAS-TC",0
28,"28117",99,87,86,0,1,"RECORTES CERO-GV-PCAS-TC",0
42,"42093",36,28,28,1,0,"RECORTES CERO-GV-PCAS-TC",0
16,"16060",715,519,513,3,6,"RECORTES CERO-GV-PCAS-TC",0
42,"42132",140,102,101,2,1,"RECORTES CERO-GV-PCAS-TC",1
40,"40162",380,273,265,1,8,"RECORTES CERO-GV-PCAS-TC",0
28,"28070",105,80,80,3,0,"RECORTES CERO-GV-PCAS-TC",0
40,"40122",524,398,392,2,6,"RECORTES CERO-GV-PCAS-TC",2
40,"40216",785,633,621,9,12,"RECORTES CERO-GV-PCAS-TC",2
40,"40171",40,32,32,1,0,"RECORTES CERO-GV-PCAS-TC",0
28,"28035",1404,981,966,4,15,"RECORTES CERO-GV-PCAS-TC",1
19,"19167",129,104,103,1,1,"RECORTES CERO-GV-PCAS-TC",0
16,"16266",356,269,265,4,4,"RECORTES CERO-GV-PCAS-TC",0
42,"42070",31,23,23,1,0,"RECORTES CERO-GV-PCAS-TC",0
37,"37160",597,380,370,3,10,"RECORTES CERO-GV-PCAS-TC",0
47,"47191",111,81,81,0,0,"RECORTES CERO-GV-PCAS-TC",0
42,"42024",84,64,62,1,2,"RECORTES CERO-GV-PCAS-TC",0
19,"19224",106,83,83,1,0,"RECORTES CERO-GV-PCAS-TC",0
9,"9253",101,77,76,0,1,"RECORTES CERO-GV-PCAS-TC",0
47,"47141",112,90,89,0,1,"RECORTES CERO-GV-PCAS-TC",0
47,"47109",161,120,120,1,0,"RECORTES CERO-GV-PCAS-TC",1
47,"47165",6823,4999,4906,48,93,"RECORTES CERO-GV-PCAS-TC",5
24,"24185",447,303,295,1,8,"RECORTES CERO-GV-PCAS-TC",0
19,"19232",56,40,40,0,0,"RECORTES CERO-GV-PCAS-TC",0
24,"24016",488,244,243,0,1,"RECORTES CERO-GV-PCAS-TC",0
45,"45051",1678,1238,1209,13,29,"RECORTES CERO-GV-PCAS-TC",0
34,"34071",158,128,128,2,0,"RECORTES CERO-GV-PCAS-TC",0
37,"37029",186,125,124,1,1,"RECORTES CERO-GV-PCAS-TC",0
37,"37122",203,162,161,3,1,"RECORTES CERO-GV-PCAS-TC",0
45,"45193",586,478,469,0,9,"RECORTES CERO-GV-PCAS-TC",0
34,"34003",147,104,103,0,1,"RECORTES CERO-GV-PCAS-TC",0
13,"13019",5101,3502,3468,33,34,"RECORTES CERO-GV-PCAS-TC",8
47,"47026",50,37,37,1,0,"RECORTES CERO-GV-PCAS-TC",0
28,"28026",6767,5058,5024,27,34,"RECORTES CERO-GV-PCAS-TC",5
16,"16088",100,86,86,0,0,"RECORTES CERO-GV-PCAS-TC",0
49,"49188",111,75,73,0,2,"RECORTES CERO-GV-PCAS-TC",0
34,"34133",101,75,73,0,2,"RECORTES CERO-GV-PCAS-TC",0
49,"49229",109,80,77,1,3,"RECORTES CERO-GV-PCAS-TC",0
19,"19162",67,41,41,0,0,"RECORTES CERO-GV-PCAS-TC",0
9,"9400",307,225,224,4,1,"RECORTES CERO-GV-PCAS-TC",1
37,"37237",296,212,204,1,8,"RECORTES CERO-GV-PCAS-TC",0
47,"47038",100,61,61,0,0,"RECORTES CERO-GV-PCAS-TC",0
37,"37058",56,38,38,1,0,"RECORTES CERO-GV-PCAS-TC",0
24,"24146",254,202,201,1,1,"RECORTES CERO-GV-PCAS-TC",0
9,"9152",244,161,161,0,0,"RECORTES CERO-GV-PCAS-TC",0
16,"16175",5071,3807,3732,43,75,"RECORTES CERO-GV-PCAS-TC",3
13,"13032",1076,772,765,0,7,"RECORTES CERO-GV-PCAS-TC",1
40,"40124",234,169,164,0,5,"RECORTES CERO-GV-PCAS-TC",0
16,"16199",27,18,18,0,0,"RECORTES CERO-GV-PCAS-TC",0
47,"47215",48,43,43,0,0,"RECORTES CERO-GV-PCAS-TC",0
40,"40022",195,144,141,2,3,"RECORTES CERO-GV-PCAS-TC",0
40,"40901",413,320,315,7,5,"RECORTES CERO-GV-PCAS-TC",0
9,"9419",67,52,49,0,3,"RECORTES CERO-GV-PCAS-TC",0
45,"45128",2569,1676,1652,6,24,"RECORTES CERO-GV-PCAS-TC",1
24,"24116",387,227,226,3,1,"RECORTES CERO-GV-PCAS-TC",0
9,"9195",57,40,40,0,0,"RECORTES CERO-GV-PCAS-TC",0
9,"9054",89,65,63,4,2,"RECORTES CERO-GV-PCAS-TC",0
28,"28040",16741,10717,10604,79,113,"RECORTES CERO-GV-PCAS-TC",10
40,"40055",31,26,26,0,0,"RECORTES CERO-GV-PCAS-TC",0
47,"47113",134,110,110,0,0,"RECORTES CERO-GV-PCAS-TC",0
37,"37039",279,202,197,2,5,"RECORTES CERO-GV-PCAS-TC",0
49,"49125",1392,883,871,11,12,"RECORTES CERO-GV-PCAS-TC",0
47,"47144",72,54,53,2,1,"RECORTES CERO-GV-PCAS-TC",1
19,"19105",2550,1913,1889,10,24,"RECORTES CERO-GV-PCAS-TC",1
34,"34093",83,61,60,0,1,"RECORTES CERO-GV-PCAS-TC",0
47,"47138",224,169,166,0,3,"RECORTES CERO-GV-PCAS-TC",0
13,"13069",613,438,419,2,19,"RECORTES CERO-GV-PCAS-TC",0
47,"47068",29,21,21,0,0,"RECORTES CERO-GV-PCAS-TC",0
47,"47039",162,119,117,0,2,"RECORTES CERO-GV-PCAS-TC",0
37,"37331",186,115,114,2,1,"RECORTES CERO-GV-PCAS-TC",0
24,"24224",564,381,375,5,6,"RECORTES CERO-GV-PCAS-TC",0
5,"5204",578,445,442,3,3,"RECORTES CERO-GV-PCAS-TC",0
49,"49084",266,197,195,11,2,"RECORTES CERO-GV-PCAS-TC",0
9,"9059",136870,99937,98641,1416,1296,"RECORTES CERO-GV-PCAS-TC",331
42,"42127",37,26,26,1,0,"RECORTES CERO-GV-PCAS-TC",0
9,"9138",84,67,66,1,1,"RECORTES CERO-GV-PCAS-TC",1
28,"28079",2384271,1765443,1753633,13854,11810,"RECORTES CERO-GV-PCAS-TC",2420
47,"47103",252,195,192,1,3,"RECORTES CERO-GV-PCAS-TC",0
9,"9904",464,344,339,3,5,"RECORTES CERO-GV-PCAS-TC",4
19,"19199",19,15,15,0,0,"RECORTES CERO-GV-PCAS-TC",0
47,"47083",81,63,61,0,2,"RECORTES CERO-GV-PCAS-TC",0
24,"24056",2726,1803,1772,21,31,"RECORTES CERO-GV-PCAS-TC",0
9,"9109",1072,575,558,0,17,"RECORTES CERO-GV-PCAS-TC",1
19,"19057",69,51,51,0,0,"RECORTES CERO-GV-PCAS-TC",0
42,"42058",103,74,72,1,2,"RECORTES CERO-GV-PCAS-TC",0
9,"9268",89,62,62,0,0,"RECORTES CERO-GV-PCAS-TC",0
49,"49015",198,156,155,0,1,"RECORTES CERO-GV-PCAS-TC",0
45,"45022",395,292,292,2,0,"RECORTES CERO-GV-PCAS-TC",0
5,"5138",283,218,217,1,1,"RECORTES CERO-GV-PCAS-TC",2
9,"9070",33,28,27,0,1,"RECORTES CERO-GV-PCAS-TC",0
9,"9117",71,58,58,0,0,"RECORTES CERO-GV-PCAS-TC",0
34,"34903",179,129,129,1,0,"RECORTES CERO-GV-PCAS-TC",1
34,"34011",379,290,284,2,6,"RECORTES CERO-GV-PCAS-TC",0
28,"28045",35523,26213,25966,212,247,"RECORTES CERO-GV-PCAS-TC",53
49,"49113",162,131,131,2,0,"RECORTES CERO-GV-PCAS-TC",0
2,"2032",259,183,178,2,5,"RECORTES CERO-GV-PCAS-TC",0
2,"2038",262,197,193,0,4,"RECORTES CERO-GV-PCAS-TC",0
49,"49123",519,384,383,4,1,"RECORTES CERO-GV-PCAS-TC",1
47,"47119",89,59,58,2,1,"RECORTES CERO-GV-PCAS-TC",0
13,"13011",4439,2762,2694,16,68,"RECORTES CERO-GV-PCAS-TC",3
5,"5208",39,32,32,0,0,"RECORTES CERO-GV-PCAS-TC",0
13,"13052",6288,4360,4278,36,82,"RECORTES CERO-GV-PCAS-TC",13
34,"34243",323,243,239,1,4,"RECORTES CERO-GV-PCAS-TC",0
40,"40076",6576,4700,4607,32,93,"RECORTES CERO-GV-PCAS-TC",6
47,"47131",167,122,120,2,2,"RECORTES CERO-GV-PCAS-TC",1
40,"40179",620,500,490,3,10,"RECORTES CERO-GV-PCAS-TC",0
42,"42213",25,17,16,1,1,"RECORTES CERO-GV-PCAS-TC",0
19,"19049",8,8,7,0,1,"RECORTES CERO-GV-PCAS-TC",0
37,"37163",34,24,24,0,0,"RECORTES CERO-GV-PCAS-TC",0
24,"24198",541,346,344,6,2,"RECORTES CERO-GV-PCAS-TC",0
5,"5014",5263,3699,3648,35,51,"RECORTES CERO-GV-PCAS-TC",0
34,"34047",1711,1275,1248,18,27,"RECORTES CERO-GV-PCAS-TC",1
45,"45145",2631,1746,1707,12,39,"RECORTES CERO-GV-PCAS-TC",0
49,"49118",193,151,151,2,0,"RECORTES CERO-GV-PCAS-TC",0
42,"42003",65,49,47,0,2,"RECORTES CERO-GV-PCAS-TC",0
37,"37118",117,86,86,3,0,"RECORTES CERO-GV-PCAS-TC",0
49,"49214",666,486,477,6,9,"RECORTES CERO-GV-PCAS-TC",0
5,"5169",218,171,171,1,0,"RECORTES CERO-GV-PCAS-TC",0
9,"9292",72,55,55,3,0,"RECORTES CERO-GV-PCAS-TC",1
5,"5902",286,214,211,1,3,"RECORTES CERO-GV-PCAS-TC",0
9,"9281",136,97,97,2,0,"RECORTES CERO-GV-PCAS-TC",1
19,"19017",56,47,47,0,0,"RECORTES CERO-GV-PCAS-TC",0
49,"49101",144,88,82,1,6,"RECORTES CERO-GV-PCAS-TC",0
2,"2043",1165,872,858,6,14,"RECORTES CERO-GV-PCAS-TC",0
45,"45147",592,449,443,2,6,"RECORTES CERO-GV-PCAS-TC",0
34,"34106",110,92,92,3,0,"RECORTES CERO-GV-PCAS-TC",0
47,"47048",175,124,122,0,2,"RECORTES CERO-GV-PCAS-TC",0
37,"37009",197,145,144,1,1,"RECORTES CERO-GV-PCAS-TC",0
2,"2033",1864,1352,1315,12,37,"RECORTES CERO-GV-PCAS-TC",0
42,"42088",62,45,44,0,1,"RECORTES CERO-GV-PCAS-TC",0
9,"9431",116,85,84,2,1,"RECORTES CERO-GV-PCAS-TC",0
5,"5179",199,176,172,1,4,"RECORTES CERO-GV-PCAS-TC",0
49,"49201",283,232,228,3,4,"RECORTES CERO-GV-PCAS-TC",0
34,"34211",171,154,153,2,1,"RECORTES CERO-GV-PCAS-TC",1
37,"37152",400,268,261,4,7,"RECORTES CERO-GV-PCAS-TC",0
49,"49094",210,111,111,0,0,"RECORTES CERO-GV-PCAS-TC",0
9,"9471",140,108,107,1,1,"RECORTES CERO-GV-PCAS-TC",0
16,"16125",1607,1166,1150,11,16,"RECORTES CERO-GV-PCAS-TC",1
34,"34154",77,48,48,1,0,"RECORTES CERO-GV-PCAS-TC",0
34,"34190",50,33,33,1,0,"RECORTES CERO-GV-PCAS-TC",0
13,"13047",5782,4232,4160,27,72,"RECORTES CERO-GV-PCAS-TC",8
49,"49017",247,176,176,1,0,"RECORTES CERO-GV-PCAS-TC",0
19,"19293",1945,1402,1388,19,14,"RECORTES CERO-GV-PCAS-TC",5
9,"9125",555,386,382,4,4,"RECORTES CERO-GV-PCAS-TC",1
37,"37363",104,81,80,0,1,"RECORTES CERO-GV-PCAS-TC",0
45,"45108",465,343,341,0,2,"RECORTES CERO-GV-PCAS-TC",0
42,"42006",154,105,103,0,2,"RECORTES CERO-GV-PCAS-TC",0
47,"47209",32,23,23,0,0,"RECORTES CERO-GV-PCAS-TC",0
37,"37298",170,109,109,0,0,"RECORTES CERO-GV-PCAS-TC",0
28,"28089",3856,2866,2829,21,37,"RECORTES CERO-GV-PCAS-TC",1
16,"16902",124,86,86,1,0,"RECORTES CERO-GV-PCAS-TC",0
16,"16010",134,92,88,0,4,"RECORTES CERO-GV-PCAS-TC",0
49,"49039",324,249,239,3,10,"RECORTES CERO-GV-PCAS-TC",0
49,"49206",776,515,504,7,11,"RECORTES CERO-GV-PCAS-TC",1
19,"19020",46,31,31,0,0,"RECORTES CERO-GV-PCAS-TC",0
34,"34074",690,502,490,13,12,"RECORTES CERO-GV-PCAS-TC",2
5,"5205",81,59,58,2,1,"RECORTES CERO-GV-PCAS-TC",0
37,"37041",71,53,53,0,0,"RECORTES CERO-GV-PCAS-TC",0
42,"42182",49,39,39,1,0,"RECORTES CERO-GV-PCAS-TC",0
24,"24063",362,247,245,2,2,"RECORTES CERO-GV-PCAS-TC",0
19,"19306",24,18,18,0,0,"RECORTES CERO-GV-PCAS-TC",0
49,"49080",622,440,437,4,3,"RECORTES CERO-GV-PCAS-TC",0
42,"42075",78,50,50,1,0,"RECORTES CERO-GV-PCAS-TC",0
49,"49200",936,679,670,9,9,"RECORTES CERO-GV-PCAS-TC",1
47,"47147",103,86,82,0,4,"RECORTES CERO-GV-PCAS-TC",0
5,"5075",96,76,76,0,0,"RECORTES CERO-GV-PCAS-TC",0
45,"45079",355,250,250,0,0,"RECORTES CERO-GV-PCAS-TC",1
5,"5036",118,91,90,0,1,"RECORTES CERO-GV-PCAS-TC",0
9,"9407",25,19,17,0,2,"RECORTES CERO-GV-PCAS-TC",0
49,"49204",58,44,43,1,1,"RECORTES CERO-GV-PCAS-TC",0
2,"2061",605,464,458,3,6,"RECORTES CERO-GV-PCAS-TC",1
40,"40039",180,133,133,0,0,"RECORTES CERO-GV-PCAS-TC",1
47,"47032",147,102,102,0,0,"RECORTES CERO-GV-PCAS-TC",0
9,"9200",48,29,29,0,0,"RECORTES CERO-GV-PCAS-TC",0
47,"47093",795,585,573,7,12,"RECORTES CERO-GV-PCAS-TC",2
19,"19283",29,26,26,0,0,"RECORTES CERO-GV-PCAS-TC",0
24,"24065",2164,1524,1492,12,32,"RECORTES CERO-GV-PCAS-TC",1
24,"24124",338,196,195,2,1,"RECORTES CERO-GV-PCAS-TC",0
45,"45177",1998,1557,1525,10,32,"RECORTES CERO-GV-PCAS-TC",0
34,"34216",61,41,41,0,0,"RECORTES CERO-GV-PCAS-TC",0
28,"28080",49866,39769,39583,346,186,"RECORTES CERO-GV-PCAS-TC",44
13,"13023",8944,6251,6165,50,86,"RECORTES CERO-GV-PCAS-TC",1
28,"28073",12707,9198,9080,94,118,"RECORTES CERO-GV-PCAS-TC",17
13,"13024",875,587,577,7,10,"RECORTES CERO-GV-PCAS-TC",0
37,"37113",404,286,285,13,1,"RECORTES CERO-GV-PCAS-TC",0
5,"5170",47,34,34,1,0,"RECORTES CERO-GV-PCAS-TC",0
49,"49122",761,517,505,7,12,"RECORTES CERO-GV-PCAS-TC",2
34,"34140",93,57,57,1,0,"RECORTES CERO-GV-PCAS-TC",0
5,"5135",399,294,292,2,2,"RECORTES CERO-GV-PCAS-TC",0
42,"42019",519,345,341,3,4,"RECORTES CERO-GV-PCAS-TC",0
19,"19066",51,42,42,0,0,"RECORTES CERO-GV-PCAS-TC",0
5,"5211",425,336,330,2,6,"RECORTES CERO-GV-PCAS-TC",0
42,"42118",21,11,11,0,0,"RECORTES CERO-GV-PCAS-TC",0
40,"40046",83,67,67,1,0,"RECORTES CERO-GV-PCAS-TC",0
49,"49232",85,64,64,0,0,"RECORTES CERO-GV-PCAS-TC",0
37,"37267",177,130,129,0,1,"RECORTES CERO-GV-PCAS-TC",0
45,"45171",1329,958,940,4,18,"RECORTES CERO-GV-PCAS-TC",0
34,"34051",91,72,70,0,2,"RECORTES CERO-GV-PCAS-TC",0
37,"37270",184,139,136,2,3,"RECORTES CERO-GV-PCAS-TC",1
40,"40164",186,131,130,0,1,"RECORTES CERO-GV-PCAS-TC",0
40,"40072",224,175,171,1,4,"RECORTES CERO-GV-PCAS-TC",0
45,"45189",633,462,459,7,3,"RECORTES CERO-GV-PCAS-TC",0
9,"9166",96,77,77,0,0,"RECORTES CERO-GV-PCAS-TC",0
40,"40086",656,513,496,7,17,"RECORTES CERO-GV-PCAS-TC",1
9,"9172",131,88,88,1,0,"RECORTES CERO-GV-PCAS-TC",1
19,"19309",20,15,14,0,1,"RECORTES CERO-GV-PCAS-TC",0
16,"16171",1728,1334,1313,10,21,"RECORTES CERO-GV-PCAS-TC",0
13,"13087",23255,15400,15127,213,273,"RECORTES CERO-GV-PCAS-TC",40
9,"9460",162,141,140,0,1,"RECORTES CERO-GV-PCAS-TC",0
45,"45083",568,433,429,2,4,"RECORTES CERO-GV-PCAS-TC",2
49,"49100",281,164,157,2,7,"RECORTES CERO-GV-PCAS-TC",0
19,"19121",265,205,204,0,1,"RECORTES CERO-GV-PCAS-TC",0
9,"9078",32,27,27,0,0,"RECORTES CERO-GV-PCAS-TC",0
16,"16031",35,26,26,0,0,"RECORTES CERO-GV-PCAS-TC",0
40,"40021",18,15,15,0,0,"RECORTES CERO-GV-PCAS-TC",0
24,"24194",267,178,177,1,1,"RECORTES CERO-GV-PCAS-TC",0
19,"19228",27,17,17,1,0,"RECORTES CERO-GV-PCAS-TC",0
9,"9326",156,111,110,1,1,"RECORTES CERO-GV-PCAS-TC",1
9,"9174",768,536,522,6,14,"RECORTES CERO-GV-PCAS-TC",2
9,"9056",4833,3191,3156,37,35,"RECORTES CERO-GV-PCAS-TC",7
47,"47116",396,304,302,2,2,"RECORTES CERO-GV-PCAS-TC",0
9,"9065",136,112,111,0,1,"RECORTES CERO-GV-PCAS-TC",1
5,"5264",54,32,31,4,1,"RECORTES CERO-GV-PCAS-TC",0
16,"16217",91,72,72,0,0,"RECORTES CERO-GV-PCAS-TC",0
49,"49273",165,90,90,0,0,"RECORTES CERO-GV-PCAS-TC",0
42,"42100",30,24,24,1,0,"RECORTES CERO-GV-PCAS-TC",2
47,"47056",81,57,57,0,0,"RECORTES CERO-GV-PCAS-TC",0
5,"5206",26,17,17,0,0,"RECORTES CERO-GV-PCAS-TC",0
34,"34147",164,120,120,1,0,"RECORTES CERO-GV-PCAS-TC",0
47,"47164",349,283,281,1,2,"RECORTES CERO-GV-PCAS-TC",0
24,"24173",896,590,583,2,7,"RECORTES CERO-GV-PCAS-TC",0
19,"19240",49,36,36,0,0,"RECORTES CERO-GV-PCAS-TC",0
5,"5038",114,83,82,0,1,"RECORTES CERO-GV-PCAS-TC",0
37,"37183",377,267,267,5,0,"RECORTES CERO-GV-PCAS-TC",0
19,"19033",47,38,37,1,1,"RECORTES CERO-GV-PCAS-TC",1
5,"5085",31,27,27,0,0,"RECORTES CERO-GV-PCAS-TC",0
13,"13066",2621,2029,1998,12,31,"RECORTES CERO-GV-PCAS-TC",2
24,"24004",495,387,384,10,3,"RECORTES CERO-GV-PCAS-TC",0
9,"9035",284,191,190,2,1,"RECORTES CERO-GV-PCAS-TC",0
45,"45115",2602,2013,1969,12,44,"RECORTES CERO-GV-PCAS-TC",5
42,"42098",8,7,7,0,0,"RECORTES CERO-GV-PCAS-TC",0
16,"16237",98,82,82,1,0,"RECORTES CERO-GV-PCAS-TC",0
9,"9242",66,53,52,3,1,"RECORTES CERO-GV-PCAS-TC",1
5,"5092",145,111,107,1,4,"RECORTES CERO-GV-PCAS-TC",0
16,"16191",850,664,653,11,11,"RECORTES CERO-GV-PCAS-TC",0
45,"45086",483,339,332,0,7,"RECORTES CERO-GV-PCAS-TC",1
5,"5072",92,74,72,1,2,"RECORTES CERO-GV-PCAS-TC",0
2,"2024",3361,2444,2411,24,33,"RECORTES CERO-GV-PCAS-TC",1
40,"40057",1397,1081,1067,15,14,"RECORTES CERO-GV-PCAS-TC",0
40,"40004",436,330,319,2,11,"RECORTES CERO-GV-PCAS-TC",0
49,"49093",280,226,223,5,3,"RECORTES CERO-GV-PCAS-TC",0
45,"45198",1808,1442,1428,6,14,"RECORTES CERO-GV-PCAS-TC",1
42,"42155",146,83,80,2,3,"RECORTES CERO-GV-PCAS-TC",0
16,"16192",42,28,28,0,0,"RECORTES CERO-GV-PCAS-TC",0
28,"28029",576,443,443,4,0,"RECORTES CERO-GV-PCAS-TC",1
49,"49117",431,294,289,0,5,"RECORTES CERO-GV-PCAS-TC",0
2,"2003",134196,96374,95521,913,853,"RECORTES CERO-GV-PCAS-TC",115
42,"42207",48,42,41,0,1,"RECORTES CERO-GV-PCAS-TC",0
49,"49091",246,168,167,1,1,"RECORTES CERO-GV-PCAS-TC",0
28,"28160",8709,6507,6460,62,47,"RECORTES CERO-GV-PCAS-TC",9
16,"16172",325,233,228,1,5,"RECORTES CERO-GV-PCAS-TC",0
24,"24201",1029,683,676,9,7,"RECORTES CERO-GV-PCAS-TC",1
28,"28019",1272,926,914,6,12,"RECORTES CERO-GV-PCAS-TC",3
40,"40005",25,23,23,1,0,"RECORTES CERO-GV-PCAS-TC",0
34,"34108",499,391,384,3,7,"RECORTES CERO-GV-PCAS-TC",1
42,"42090",83,65,64,1,1,"RECORTES CERO-GV-PCAS-TC",0
40,"40058",306,244,240,1,4,"RECORTES CERO-GV-PCAS-TC",0
45,"45137",1541,1007,998,8,9,"RECORTES CERO-GV-PCAS-TC",1
5,"5073",282,210,207,1,3,"RECORTES CERO-GV-PCAS-TC",0
16,"16034",155,116,113,0,3,"RECORTES CERO-GV-PCAS-TC",0
16,"16098",521,418,415,2,3,"RECORTES CERO-GV-PCAS-TC",1
37,"37017",226,169,168,4,1,"RECORTES CERO-GV-PCAS-TC",0
49,"49018",277,197,190,2,7,"RECORTES CERO-GV-PCAS-TC",0
19,"19311",85,60,59,0,1,"RECORTES CERO-GV-PCAS-TC",0
9,"9340",74,49,49,1,0,"RECORTES CERO-GV-PCAS-TC",0
5,"5147",144,101,99,0,2,"RECORTES CERO-GV-PCAS-TC",0
16,"16219",81,58,58,0,0,"RECORTES CERO-GV-PCAS-TC",0
16,"16063",112,81,81,1,0,"RECORTES CERO-GV-PCAS-TC",0
9,"9450",23,18,18,1,0,"RECORTES CERO-GV-PCAS-TC",0
19,"19065",109,86,85,1,1,"RECORTES CERO-GV-PCAS-TC",0
28,"28017",1280,975,963,10,12,"RECORTES CERO-GV-PCAS-TC",0
28,"28155",487,374,369,0,5,"RECORTES CERO-GV-PCAS-TC",0
9,"9247",21,18,18,0,0,"RECORTES CERO-GV-PCAS-TC",0
9,"9025",110,61,58,0,3,"RECORTES CERO-GV-PCAS-TC",0
19,"19243",34,32,31,1,1,"RECORTES CERO-GV-PCAS-TC",0
45,"45114",549,400,394,1,6,"RECORTES CERO-GV-PCAS-TC",1
9,"9421",240,180,180,3,0,"RECORTES CERO-GV-PCAS-TC",2
13,"13097",2186,1592,1574,5,18,"RECORTES CERO-GV-PCAS-TC",4
49,"49109",561,419,415,6,4,"RECORTES CERO-GV-PCAS-TC",0
47,"47011",554,466,462,7,4,"RECORTES CERO-GV-PCAS-TC",0
16,"16195",458,343,338,0,5,"RECORTES CERO-GV-PCAS-TC",0
16,"16154",4739,3416,3379,33,37,"RECORTES CERO-GV-PCAS-TC",0
24,"24155",441,340,334,2,6,"RECORTES CERO-GV-PCAS-TC",0
19,"19285",20,16,16,0,0,"RECORTES CERO-GV-PCAS-TC",0
9,"9350",421,316,311,5,5,"RECORTES CERO-GV-PCAS-TC",2
37,"37291",269,186,185,1,1,"RECORTES CERO-GV-PCAS-TC",0
49,"49022",282,230,229,2,1,"RECORTES CERO-GV-PCAS-TC",0
2,"2080",498,358,352,0,6,"RECORTES CERO-GV-PCAS-TC",0
34,"34139",160,117,115,2,2,"RECORTES CERO-GV-PCAS-TC",0
34,"34184",49,37,35,0,2,"RECORTES CERO-GV-PCAS-TC",0
40,"40079",229,160,159,2,1,"RECORTES CERO-GV-PCAS-TC",0
28,"28053",6956,5475,5414,44,61,"RECORTES CERO-GV-PCAS-TC",4
9,"9183",42,32,32,0,0,"RECORTES CERO-GV-PCAS-TC",0
49,"49205",359,252,251,7,1,"RECORTES CERO-GV-PCAS-TC",0
34,"34201",171,131,130,1,1,"RECORTES CERO-GV-PCAS-TC",0
16,"16052",539,422,419,3,3,"RECORTES CERO-GV-PCAS-TC",0
40,"40182",169,112,112,1,0,"RECORTES CERO-GV-PCAS-TC",0
19,"19277",15,10,10,0,0,"RECORTES CERO-GV-PCAS-TC",0
28,"28023",5159,4052,4019,27,33,"RECORTES CERO-GV-PCAS-TC",2
42,"42008",54,41,41,0,0,"RECORTES CERO-GV-PCAS-TC",0
49,"49185",156,120,116,0,4,"RECORTES CERO-GV-PCAS-TC",0
16,"16022",76,63,63,0,0,"RECORTES CERO-GV-PCAS-TC",0
37,"37131",175,125,125,0,0,"RECORTES CERO-GV-PCAS-TC",0
37,"37236",123,85,82,1,3,"RECORTES CERO-GV-PCAS-TC",0
40,"40024",823,582,575,8,7,"RECORTES CERO-GV-PCAS-TC",0
34,"34122",83,56,56,0,0,"RECORTES CERO-GV-PCAS-TC",0
9,"9110",77,50,50,0,0,"RECORTES CERO-GV-PCAS-TC",1
49,"49115",167,121,121,2,0,"RECORTES CERO-GV-PCAS-TC",0
9,"9323",57,37,36,0,1,"RECORTES CERO-GV-PCAS-TC",0
40,"40081",117,80,76,1,4,"RECORTES CERO-GV-PCAS-TC",0
5,"5214",28,18,18,0,0,"RECORTES CERO-GV-PCAS-TC",0
5,"5107",54,36,35,2,1,"RECORTES CERO-GV-PCAS-TC",0
19,"19011",237,165,162,3,3,"RECORTES CERO-GV-PCAS-TC",0
42,"42054",18,12,12,0,0,"RECORTES CERO-GV-PCAS-TC",0
49,"49124",238,170,164,2,6,"RECORTES CERO-GV-PCAS-TC",0
5,"5186",1564,1140,1125,5,15,"RECORTES CERO-GV-PCAS-TC",3
49,"49048",113,88,88,0,0,"RECORTES CERO-GV-PCAS-TC",0
24,"24181",1404,944,925,7,19,"RECORTES CERO-GV-PCAS-TC",1
45,"45205",7438,4772,4701,27,71,"RECORTES CERO-GV-PCAS-TC",5
5,"5166",155,108,104,1,4,"RECORTES CERO-GV-PCAS-TC",0
9,"9208",176,121,120,4,1,"RECORTES CERO-GV-PCAS-TC",0
37,"37004",25,18,18,0,0,"RECORTES CERO-GV-PCAS-TC",0
24,"24159",1716,1238,1216,6,22,"RECORTES CERO-GV-PCAS-TC",0
37,"37070",523,371,365,4,6,"RECORTES CERO-GV-PCAS-TC",0
2,"2054",375,288,283,0,5,"RECORTES CERO-GV-PCAS-TC",1
5,"5176",221,163,159,0,4,"RECORTES CERO-GV-PCAS-TC",0
16,"16216",272,207,204,0,3,"RECORTES CERO-GV-PCAS-TC",0
37,"37342",250,190,189,3,1,"RECORTES CERO-GV-PCAS-TC",0
34,"34157",2353,1697,1669,18,28,"RECORTES CERO-GV-PCAS-TC",3
9,"9408",40,29,29,0,0,"RECORTES CERO-GV-PCAS-TC",0
34,"34058",182,152,152,0,0,"RECORTES CERO-GV-PCAS-TC",0
16,"16044",43,29,28,0,1,"RECORTES CERO-GV-PCAS-TC",0
47,"47152",67,59,59,0,0,"RECORTES CERO-GV-PCAS-TC",0
45,"45084",2103,1533,1508,7,25,"RECORTES CERO-GV-PCAS-TC",0
40,"40174",319,229,227,3,2,"RECORTES CERO-GV-PCAS-TC",1
5,"5157",227,146,146,3,0,"RECORTES CERO-GV-PCAS-TC",0
37,"37307",146,94,91,1,3,"RECORTES CERO-GV-PCAS-TC",0
5,"5216",209,149,149,0,0,"RECORTES CERO-GV-PCAS-TC",0
49,"49157",188,136,133,2,3,"RECORTES CERO-GV-PCAS-TC",2
45,"45123",3196,2252,2218,11,34,"RECORTES CERO-GV-PCAS-TC",1
9,"9415",275,178,178,3,0,"RECORTES CERO-GV-PCAS-TC",1
47,"47017",190,146,146,0,0,"RECORTES CERO-GV-PCAS-TC",0
19,"19281",19,18,18,0,0,"RECORTES CERO-GV-PCAS-TC",0
9,"9136",169,129,125,2,4,"RECORTES CERO-GV-PCAS-TC",0
28,"28165",1917,1339,1321,2,18,"RECORTES CERO-GV-PCAS-TC",2
9,"9437",266,207,203,4,4,"RECORTES CERO-GV-PCAS-TC",3
34,"34096",48,39,38,0,1,"RECORTES CERO-GV-PCAS-TC",0
42,"42087",51,45,42,1,3,"RECORTES CERO-GV-PCAS-TC",1
34,"34031",26,26,26,1,0,"RECORTES CERO-GV-PCAS-TC",0
16,"16068",125,88,88,3,0,"RECORTES CERO-GV-PCAS-TC",1
42,"42016",20,13,13,0,0,"RECORTES CERO-GV-PCAS-TC",0
2,"2023",504,419,412,0,7,"RECORTES CERO-GV-PCAS-TC",1
34,"34136",143,89,89,1,0,"RECORTES CERO-GV-PCAS-TC",0
16,"16046",213,142,142,0,0,"RECORTES CERO-GV-PCAS-TC",0
19,"19135",90,71,69,1,2,"RECORTES CERO-GV-PCAS-TC",0
5,"5104",33,21,19,0,2,"RECORTES CERO-GV-PCAS-TC",0
37,"37320",85,65,64,1,1,"RECORTES CERO-GV-PCAS-TC",0
47,"47100",118,93,87,2,6,"RECORTES CERO-GV-PCAS-TC",0
37,"37142",554,396,394,5,2,"RECORTES CERO-GV-PCAS-TC",0
37,"37100",74,59,58,1,1,"RECORTES CERO-GV-PCAS-TC",0
5,"5266",100,79,79,1,0,"RECORTES CERO-GV-PCAS-TC",0
9,"9215",359,217,216,2,1,"RECORTES CERO-GV-PCAS-TC",0
19,"19327",385,313,308,2,5,"RECORTES CERO-GV-PCAS-TC",0
37,"37362",4783,3469,3420,44,49,"RECORTES CERO-GV-PCAS-TC",4
37,"37050",66,52,52,1,0,"RECORTES CERO-GV-PCAS-TC",0
49,"49152",474,289,282,2,7,"RECORTES CERO-GV-PCAS-TC",0
45,"45059",1702,1315,1303,1,12,"RECORTES CERO-GV-PCAS-TC",1
45,"45169",179,114,111,1,3,"RECORTES CERO-GV-PCAS-TC",0
9,"9375",42,35,35,0,0,"RECORTES CERO-GV-PCAS-TC",0
16,"16162",39,31,31,0,0,"RECORTES CERO-GV-PCAS-TC",0
40,"40112",2813,2126,2087,26,39,"RECORTES CERO-GV-PCAS-TC",7
47,"47196",29,21,21,0,0,"RECORTES CERO-GV-PCAS-TC",0
49,"49265",110,79,78,2,1,"RECORTES CERO-GV-PCAS-TC",0
2,"2025",7345,5388,5278,51,110,"RECORTES CERO-GV-PCAS-TC",7
37,"37205",212,157,155,1,2,"RECORTES CERO-GV-PCAS-TC",0
37,"37353",122,82,80,0,2,"RECORTES CERO-GV-PCAS-TC",0
9,"9105",95,65,64,1,1,"RECORTES CERO-GV-PCAS-TC",1
9,"9417",42,31,31,1,0,"RECORTES CERO-GV-PCAS-TC",0
47,"47049",91,58,58,0,0,"RECORTES CERO-GV-PCAS-TC",0
37,"37006",116,71,70,3,1,"RECORTES CERO-GV-PCAS-TC",0
37,"37099",63,46,46,1,0,"RECORTES CERO-GV-PCAS-TC",0
45,"45184",204,123,122,0,1,"RECORTES CERO-GV-PCAS-TC",1
49,"49127",2402,1640,1604,18,36,"RECORTES CERO-GV-PCAS-TC",4
42,"42020",4170,2732,2686,35,46,"RECORTES CERO-GV-PCAS-TC",1
9,"9265",38,31,31,1,0,"RECORTES CERO-GV-PCAS-TC",0
19,"19120",107,86,86,1,0,"RECORTES CERO-GV-PCAS-TC",0
37,"37096",203,144,144,2,0,"RECORTES CERO-GV-PCAS-TC",1
24,"24067",602,327,324,6,3,"RECORTES CERO-GV-PCAS-TC",1
16,"16906",70,44,44,1,0,"RECORTES CERO-GV-PCAS-TC",0
2,"2045",3609,2797,2752,38,45,"RECORTES CERO-GV-PCAS-TC",1
34,"34185",69,36,35,0,1,"RECORTES CERO-GV-PCAS-TC",0
16,"16039",365,241,238,3,3,"RECORTES CERO-GV-PCAS-TC",0
37,"37230",220,169,168,1,1,"RECORTES CERO-GV-PCAS-TC",0
9,"9386",55,43,43,0,0,"RECORTES CERO-GV-PCAS-TC",1
19,"19139",26,19,19,2,0,"RECORTES CERO-GV-PCAS-TC",0
5,"5002",1905,1361,1329,11,32,"RECORTES CERO-GV-PCAS-TC",3
45,"45176",3859,2694,2662,24,32,"RECORTES CERO-GV-PCAS-TC",5
16,"16259",28,22,22,0,0,"RECORTES CERO-GV-PCAS-TC",0
16,"16091",63,43,42,1,1,"RECORTES CERO-GV-PCAS-TC",0
42,"42125",71,55,55,0,0,"RECORTES CERO-GV-PCAS-TC",0
16,"16245",396,304,298,1,6,"RECORTES CERO-GV-PCAS-TC",2
24,"24178",60,54,54,1,0,"RECORTES CERO-GV-PCAS-TC",0
9,"9438",562,447,437,6,10,"RECORTES CERO-GV-PCAS-TC",0
37,"37355",159,121,120,1,1,"RECORTES CERO-GV-PCAS-TC",0
34,"34005",786,601,593,3,8,"RECORTES CERO-GV-PCAS-TC",0
19,"19058",7458,5705,5663,40,42,"RECORTES CERO-GV-PCAS-TC",15
49,"49041",409,287,282,1,5,"RECORTES CERO-GV-PCAS-TC",0
2,"2014",354,254,252,3,2,"RECORTES CERO-GV-PCAS-TC",0
37,"37288",281,220,218,4,2,"RECORTES CERO-GV-PCAS-TC",0
45,"45031",2861,1894,1858,13,36,"RECORTES CERO-GV-PCAS-TC",2
9,"9332",137,93,91,2,2,"RECORTES CERO-GV-PCAS-TC",0
9,"9060",126,104,104,2,0,"RECORTES CERO-GV-PCAS-TC",2
16,"16130",533,407,404,0,3,"RECORTES CERO-GV-PCAS-TC",0
37,"37157",76,64,63,1,1,"RECORTES CERO-GV-PCAS-TC",0
37,"37146",106,82,76,0,6,"RECORTES CERO-GV-PCAS-TC",0
16,"16104",53,42,42,0,0,"RECORTES CERO-GV-PCAS-TC",0
49,"49046",246,174,169,0,5,"RECORTES CERO-GV-PCAS-TC",0
49,"49269",218,126,124,1,2,"RECORTES CERO-GV-PCAS-TC",0
5,"5174",62,51,51,1,0,"RECORTES CERO-GV-PCAS-TC",0
37,"37282",193,132,131,3,1,"RECORTES CERO-GV-PCAS-TC",0
9,"9466",113,84,83,1,1,"RECORTES CERO-GV-PCAS-TC",0
34,"34123",1634,1274,1258,4,16,"RECORTES CERO-GV-PCAS-TC",1
40,"40078",150,123,123,6,0,"RECORTES CERO-GV-PCAS-TC",0
5,"5221",322,231,231,0,0,"RECORTES CERO-GV-PCAS-TC",0
37,"37007",391,289,281,7,8,"RECORTES CERO-GV-PCAS-TC",0
9,"9066",54,37,37,0,0,"RECORTES CERO-GV-PCAS-TC",0
37,"37340",141,97,97,1,0,"RECORTES CERO-GV-PCAS-TC",0
13,"13041",236,155,155,3,0,"RECORTES CERO-GV-PCAS-TC",0
16,"16278",61,45,45,0,0,"RECORTES CERO-GV-PCAS-TC",0
37,"37334",71,30,30,0,0,"RECORTES CERO-GV-PCAS-TC",0
24,"24031",207,160,158,0,2,"RECORTES CERO-GV-PCAS-TC",0
37,"37222",78,55,55,2,0,"RECORTES CERO-GV-PCAS-TC",0
45,"45192",2380,1890,1854,8,36,"RECORTES CERO-GV-PCAS-TC",1
49,"49247",412,255,252,2,3,"RECORTES CERO-GV-PCAS-TC",1
13,"13026",413,333,331,2,2,"RECORTES CERO-GV-PCAS-TC",0
34,"34220",152,133,132,1,1,"RECORTES CERO-GV-PCAS-TC",1
9,"9259",230,178,176,2,2,"RECORTES CERO-GV-PCAS-TC",1
2,"2065",441,368,361,0,7,"RECORTES CERO-GV-PCAS-TC",0
40,"40054",108,79,78,3,1,"RECORTES CERO-GV-PCAS-TC",1
9,"9063",215,184,181,2,3,"RECORTES CERO-GV-PCAS-TC",1
9,"9391",347,247,246,2,1,"RECORTES CERO-GV-PCAS-TC",2
24,"24209",2597,1651,1636,12,15,"RECORTES CERO-GV-PCAS-TC",2
5,"5045",81,58,58,0,0,"RECORTES CERO-GV-PCAS-TC",0
13,"13027",3185,2112,2055,12,57,"RECORTES CERO-GV-PCAS-TC",4
13,"13073",501,392,385,2,7,"RECORTES CERO-GV-PCAS-TC",0
37,"37200",190,132,131,0,1,"RECORTES CERO-GV-PCAS-TC",0
47,"47077",234,172,170,1,2,"RECORTES CERO-GV-PCAS-TC",0
9,"9901",334,228,226,4,2,"RECORTES CERO-GV-PCAS-TC",2
40,"40052",72,55,55,0,0,"RECORTES CERO-GV-PCAS-TC",0
47,"47036",204,159,156,1,3,"RECORTES CERO-GV-PCAS-TC",0
37,"37071",76,64,62,1,2,"RECORTES CERO-GV-PCAS-TC",0
49,"49197",155,109,104,0,5,"RECORTES CERO-GV-PCAS-TC",0
37,"37329",38,29,28,1,1,"RECORTES CERO-GV-PCAS-TC",0
2,"2066",222,165,163,1,2,"RECORTES CERO-GV-PCAS-TC",0
16,"16008",80,63,63,1,0,"RECORTES CERO-GV-PCAS-TC",1
37,"37339",295,219,219,5,0,"RECORTES CERO-GV-PCAS-TC",0
28,"28121",209,156,152,1,4,"RECORTES CERO-GV-PCAS-TC",0
40,"40185",800,560,553,4,7,"RECORTES CERO-GV-PCAS-TC",1
34,"34012",342,237,232,3,5,"RECORTES CERO-GV-PCAS-TC",0
16,"16122",244,184,182,1,2,"RECORTES CERO-GV-PCAS-TC",0
37,"37287",297,204,202,2,2,"RECORTES CERO-GV-PCAS-TC",0
5,"5125",56,47,46,0,1,"RECORTES CERO-GV-PCAS-TC",0
47,"47053",123,101,97,3,4,"RECORTES CERO-GV-PCAS-TC",0
16,"16240",98,71,69,0,2,"RECORTES CERO-GV-PCAS-TC",0
19,"19170",189,115,115,1,0,"RECORTES CERO-GV-PCAS-TC",0
5,"5182",721,457,436,3,21,"RECORTES CERO-GV-PCAS-TC",0
49,"49120",54,35,35,0,0,"RECORTES CERO-GV-PCAS-TC",0
34,"34032",38,30,30,0,0,"RECORTES CERO-GV-PCAS-TC",1
45,"45061",2490,1690,1669,9,21,"RECORTES CERO-GV-PCAS-TC",0
19,"19169",30,27,27,0,0,"RECORTES CERO-GV-PCAS-TC",0
40,"40063",6913,4948,4838,57,110,"RECORTES CERO-GV-PCAS-TC",13
19,"19901",35,27,27,0,0,"RECORTES CERO-GV-PCAS-TC",0
40,"40186",35,29,29,0,0,"RECORTES CERO-GV-PCAS-TC",0
9,"9122",86,55,55,0,0,"RECORTES CERO-GV-PCAS-TC",0
37,"37086",107,86,85,2,1,"RECORTES CERO-GV-PCAS-TC",0
37,"37371",252,156,155,0,1,"RECORTES CERO-GV-PCAS-TC",0
13,"13031",2475,1855,1834,9,21,"RECORTES CERO-GV-PCAS-TC",2
13,"13061",5616,3679,3634,51,45,"RECORTES CERO-GV-PCAS-TC",6
9,"9104",49,35,34,0,1,"RECORTES CERO-GV-PCAS-TC",0
47,"47154",146,115,111,6,4,"RECORTES CERO-GV-PCAS-TC",0
37,"37341",47,29,29,0,0,"RECORTES CERO-GV-PCAS-TC",0
9,"9068",23,16,16,0,0,"RECORTES CERO-GV-PCAS-TC",0
49,"49054",847,576,569,8,7,"RECORTES CERO-GV-PCAS-TC",2
5,"5148",22,19,19,0,0,"RECORTES CERO-GV-PCAS-TC",0
2,"2068",323,239,239,3,0,"RECORTES CERO-GV-PCAS-TC",0
47,"47028",30,17,17,0,0,"RECORTES CERO-GV-PCAS-TC",0
5,"5082",491,379,369,2,10,"RECORTES CERO-GV-PCAS-TC",0
40,"40156",272,194,190,4,4,"RECORTES CERO-GV-PCAS-TC",0
40,"40012",241,160,156,7,4,"RECORTES CERO-GV-PCAS-TC",0
37,"37372",133,99,98,0,1,"RECORTES CERO-GV-PCAS-TC",0
37,"37373",692,451,442,4,9,"RECORTES CERO-GV-PCAS-TC",1
9,"9267",117,95,93,1,2,"RECORTES CERO-GV-PCAS-TC",0
37,"37074",136,93,90,1,3,"RECORTES CERO-GV-PCAS-TC",0
37,"37184",289,178,177,1,1,"RECORTES CERO-GV-PCAS-TC",0
40,"40189",471,344,329,1,15,"RECORTES CERO-GV-PCAS-TC",0
37,"37248",150,116,116,1,0,"RECORTES CERO-GV-PCAS-TC",0
13,"13018",774,625,622,0,3,"RECORTES CERO-GV-PCAS-TC",0
16,"16176",29,20,20,0,0,"RECORTES CERO-GV-PCAS-TC",0
13,"13064",1845,1314,1298,10,16,"RECORTES CERO-GV-PCAS-TC",2
42,"42123",157,103,102,6,1,"RECORTES CERO-GV-PCAS-TC",0
9,"9213",264,182,182,1,0,"RECORTES CERO-GV-PCAS-TC",1
19,"19134",23,14,14,0,0,"RECORTES CERO-GV-PCAS-TC",0
5,"5242",679,571,562,9,9,"RECORTES CERO-GV-PCAS-TC",0
49,"49087",476,246,244,0,2,"RECORTES CERO-GV-PCAS-TC",0
37,"37072",144,121,118,5,3,"RECORTES CERO-GV-PCAS-TC",0
49,"49239",599,393,384,6,9,"RECORTES CERO-GV-PCAS-TC",0
9,"9032",103,62,62,3,0,"RECORTES CERO-GV-PCAS-TC",0
28,"28093",2177,1681,1658,11,23,"RECORTES CERO-GV-PCAS-TC",1
19,"19038",19,16,15,0,1,"RECORTES CERO-GV-PCAS-TC",0
16,"16165",56,45,45,0,0,"RECORTES CERO-GV-PCAS-TC",0
13,"13076",455,359,356,0,3,"RECORTES CERO-GV-PCAS-TC",0
45,"45127",775,510,502,1,8,"RECORTES CERO-GV-PCAS-TC",0
37,"37176",128,99,98,1,1,"RECORTES CERO-GV-PCAS-TC",0
5,"5139",71,59,58,1,1,"RECORTES CERO-GV-PCAS-TC",0
49,"49203",280,218,212,1,6,"RECORTES CERO-GV-PCAS-TC",0
49,"49130",155,116,112,1,4,"RECORTES CERO-GV-PCAS-TC",0
45,"45004",546,400,398,2,2,"RECORTES CERO-GV-PCAS-TC",0
37,"37054",233,190,186,2,4,"RECORTES CERO-GV-PCAS-TC",0
9,"9406",239,165,162,2,3,"RECORTES CERO-GV-PCAS-TC",1
37,"37251",108,75,75,0,0,"RECORTES CERO-GV-PCAS-TC",0
37,"37345",150,117,113,0,4,"RECORTES CERO-GV-PCAS-TC",0
49,"49268",364,266,263,3,3,"RECORTES CERO-GV-PCAS-TC",0
28,"28011",417,295,292,6,3,"RECORTES CERO-GV-PCAS-TC",1
34,"34112",39,31,31,0,0,"RECORTES CERO-GV-PCAS-TC",0
42,"42013",34,22,22,2,0,"RECORTES CERO-GV-PCAS-TC",0
9,"9451",237,196,189,1,7,"RECORTES CERO-GV-PCAS-TC",1
37,"37125",231,154,148,1,6,"RECORTES CERO-GV-PCAS-TC",1
28,"28127",66793,53258,53009,458,249,"RECORTES CERO-GV-PCAS-TC",60
37,"37346",251,208,207,1,1,"RECORTES CERO-GV-PCAS-TC",0
19,"19264",33,25,25,0,0,"RECORTES CERO-GV-PCAS-TC",0
13,"13038",1589,1162,1136,21,26,"RECORTES CERO-GV-PCAS-TC",1
42,"42094",596,448,436,9,12,"RECORTES CERO-GV-PCAS-TC",1
49,"49145",208,113,113,1,0,"RECORTES CERO-GV-PCAS-TC",1
5,"5087",147,108,107,3,1,"RECORTES CERO-GV-PCAS-TC",0
19,"19174",90,65,64,0,1,"RECORTES CERO-GV-PCAS-TC",0
45,"45117",718,552,548,0,4,"RECORTES CERO-GV-PCAS-TC",0
40,"40061",63,47,44,0,3,"RECORTES CERO-GV-PCAS-TC",0
13,"13039",14195,10104,9933,122,171,"RECORTES CERO-GV-PCAS-TC",13
9,"9061",147,119,119,0,0,"RECORTES CERO-GV-PCAS-TC",0
9,"9257",85,67,67,2,0,"RECORTES CERO-GV-PCAS-TC",0
9,"9095",103,54,53,3,1,"RECORTES CERO-GV-PCAS-TC",0
45,"45170",194,146,140,0,6,"RECORTES CERO-GV-PCAS-TC",0
13,"13025",290,233,231,0,2,"RECORTES CERO-GV-PCAS-TC",0
47,"47153",101,69,69,1,0,"RECORTES CERO-GV-PCAS-TC",0
19,"19091",23,17,17,0,0,"RECORTES CERO-GV-PCAS-TC",0
40,"40097",130,103,102,5,1,"RECORTES CERO-GV-PCAS-TC",1
5,"5122",118,91,89,1,2,"RECORTES CERO-GV-PCAS-TC",0
19,"19088",91,67,66,0,1,"RECORTES CERO-GV-PCAS-TC",0
45,"45188",2770,1925,1886,12,39,"RECORTES CERO-GV-PCAS-TC",2
37,"37092",1933,1342,1327,13,15,"RECORTES CERO-GV-PCAS-TC",2
9,"9077",26,21,21,0,0,"RECORTES CERO-GV-PCAS-TC",0
19,"19075",58,38,37,3,1,"RECORTES CERO-GV-PCAS-TC",1
16,"16187",55,38,38,3,0,"RECORTES CERO-GV-PCAS-TC",0
40,"40193",219,156,155,3,1,"RECORTES CERO-GV-PCAS-TC",0
24,"24024",636,407,403,6,4,"RECORTES CERO-GV-PCAS-TC",0
45,"45107",3463,2621,2585,23,36,"RECORTES CERO-GV-PCAS-TC",6
45,"45082",1145,904,893,7,11,"RECORTES CERO-GV-PCAS-TC",0
37,"37348",100,76,76,0,0,"RECORTES CERO-GV-PCAS-TC",0
16,"16067",123,91,90,1,1,"RECORTES CERO-GV-PCAS-TC",0
19,"19051",61,52,52,0,0,"RECORTES CERO-GV-PCAS-TC",0
9,"9133",38,33,33,0,0,"RECORTES CERO-GV-PCAS-TC",0
19,"19279",54,42,42,0,0,"RECORTES CERO-GV-PCAS-TC",0
42,"42192",36,22,22,2,0,"RECORTES CERO-GV-PCAS-TC",0
13,"13042",880,638,626,2,12,"RECORTES CERO-GV-PCAS-TC",2
37,"37338",77,58,58,0,0,"RECORTES CERO-GV-PCAS-TC",0
24,"24133",357,256,256,1,0,"RECORTES CERO-GV-PCAS-TC",0
49,"49090",190,135,134,3,1,"RECORTES CERO-GV-PCAS-TC",0
37,"37108",98,75,75,3,0,"RECORTES CERO-GV-PCAS-TC",1
19,"19103",247,205,202,1,3,"RECORTES CERO-GV-PCAS-TC",0
34,"34182",746,558,553,9,5,"RECORTES CERO-GV-PCAS-TC",0
40,"40044",134,101,101,3,0,"RECORTES CERO-GV-PCAS-TC",0
28,"28076",432,330,327,4,3,"RECORTES CERO-GV-PCAS-TC",0
49,"49172",474,278,271,1,7,"RECORTES CERO-GV-PCAS-TC",0
24,"24134",3287,2278,2226,18,52,"RECORTES CERO-GV-PCAS-TC",0
16,"16280",163,122,119,2,3,"RECORTES CERO-GV-PCAS-TC",0
19,"19157",53,37,37,0,0,"RECORTES CERO-GV-PCAS-TC",0
49,"49027",125,82,81,0,1,"RECORTES CERO-GV-PCAS-TC",0
28,"28088",296,196,191,1,5,"RECORTES CERO-GV-PCAS-TC",0
9,"9155",25,23,23,0,0,"RECORTES CERO-GV-PCAS-TC",0
24,"24098",1149,753,741,8,12,"RECORTES CERO-GV-PCAS-TC",1
34,"34232",725,505,492,13,13,"RECORTES CERO-GV-PCAS-TC",1
40,"40074",246,193,189,2,4,"RECORTES CERO-GV-PCAS-TC",1
9,"9101",72,52,52,0,0,"RECORTES CERO-GV-PCAS-TC",0
13,"13091",537,466,464,3,2,"RECORTES CERO-GV-PCAS-TC",0
37,"37078",781,626,603,9,23,"RECORTES CERO-GV-PCAS-TC",0
47,"47174",271,215,213,4,2,"RECORTES CERO-GV-PCAS-TC",0
19,"19007",433,316,310,1,6,"RECORTES CERO-GV-PCAS-TC",0
45,"45110",1685,1288,1274,5,14,"RECORTES CERO-GV-PCAS-TC",1
19,"19278",24,20,20,0,0,"RECORTES CERO-GV-PCAS-TC",0
47,"47132",39,32,32,1,0,"RECORTES CERO-GV-PCAS-TC",0
37,"37060",283,205,202,1,3,"RECORTES CERO-GV-PCAS-TC",0
24,"24110",1158,784,773,1,11,"RECORTES CERO-GV-PCAS-TC",0
45,"45158",2545,1805,1786,9,19,"RECORTES CERO-GV-PCAS-TC",2
5,"5188",39,33,33,0,0,"RECORTES CERO-GV-PCAS-TC",0
13,"13046",686,524,521,6,3,"RECORTES CERO-GV-PCAS-TC",1
34,"34224",39,25,25,0,0,"RECORTES CERO-GV-PCAS-TC",0
45,"45050",505,338,332,2,6,"RECORTES CERO-GV-PCAS-TC",0
24,"24112",288,188,186,2,2,"RECORTES CERO-GV-PCAS-TC",0
5,"5158",346,263,261,0,2,"RECORTES CERO-GV-PCAS-TC",0
19,"19282",138,107,106,0,1,"RECORTES CERO-GV-PCAS-TC",0
49,"49066",437,276,272,2,4,"RECORTES CERO-GV-PCAS-TC",0
13,"13093",3901,2617,2569,16,48,"RECORTES CERO-GV-PCAS-TC",0
42,"42105",47,40,40,2,0,"RECORTES CERO-GV-PCAS-TC",0
49,"49251",159,116,109,2,7,"RECORTES CERO-GV-PCAS-TC",0
28,"28102",880,639,621,7,18,"RECORTES CERO-GV-PCAS-TC",0
37,"37228",324,262,262,1,0,"RECORTES CERO-GV-PCAS-TC",0
24,"24005",342,218,217,0,1,"RECORTES CERO-GV-PCAS-TC",0
9,"9196",133,95,95,2,0,"RECORTES CERO-GV-PCAS-TC",1
42,"42021",65,46,45,2,1,"RECORTES CERO-GV-PCAS-TC",0
45,"45001",1846,1213,1181,10,32,"RECORTES CERO-GV-PCAS-TC",2
5,"5180",76,55,53,0,2,"RECORTES CERO-GV-PCAS-TC",0
28,"28091",5491,3709,3650,20,59,"RECORTES CERO-GV-PCAS-TC",4
13,"13094",294,216,215,1,1,"RECORTES CERO-GV-PCAS-TC",0
40,"40103",139,113,113,0,0,"RECORTES CERO-GV-PCAS-TC",0
5,"5127",600,472,469,7,3,"RECORTES CERO-GV-PCAS-TC",1
16,"16100",642,518,514,2,4,"RECORTES CERO-GV-PCAS-TC",0
19,"19251",39,30,30,0,0,"RECORTES CERO-GV-PCAS-TC",0
9,"9086",652,479,471,3,8,"RECORTES CERO-GV-PCAS-TC",2
19,"19161",212,158,157,3,1,"RECORTES CERO-GV-PCAS-TC",0
49,"49083",47,37,37,1,0,"RECORTES CERO-GV-PCAS-TC",0
28,"28037",1570,1135,1123,4,12,"RECORTES CERO-GV-PCAS-TC",0
24,"24197",717,500,499,2,1,"RECORTES CERO-GV-PCAS-TC",0
47,"47074",141,110,109,0,1,"RECORTES CERO-GV-PCAS-TC",0
34,"34084",158,125,125,1,0,"RECORTES CERO-GV-PCAS-TC",0
9,"9194",1970,1376,1359,15,17,"RECORTES CERO-GV-PCAS-TC",1
49,"49010",350,260,256,8,4,"RECORTES CERO-GV-PCAS-TC",0
13,"13036",752,552,546,1,6,"RECORTES CERO-GV-PCAS-TC",2
28,"28158",694,501,495,2,6,"RECORTES CERO-GV-PCAS-TC",0
2,"2046",1125,892,870,12,22,"RECORTES CERO-GV-PCAS-TC",1
37,"37365",162,125,121,0,4,"RECORTES CERO-GV-PCAS-TC",0
5,"5236",105,69,69,1,0,"RECORTES CERO-GV-PCAS-TC",0
49,"49021",14204,9429,9295,87,134,"RECORTES CERO-GV-PCAS-TC",7
28,"28092",153631,112460,111341,913,1119,"RECORTES CERO-GV-PCAS-TC",184
2,"2082",98,80,80,0,0,"RECORTES CERO-GV-PCAS-TC",0
5,"5192",92,75,72,1,3,"RECORTES CERO-GV-PCAS-TC",0
28,"28106",78872,54111,53443,412,668,"RECORTES CERO-GV-PCAS-TC",99
9,"9143",28,17,17,0,0,"RECORTES CERO-GV-PCAS-TC",0
5,"5096",76,62,62,0,0,"RECORTES CERO-GV-PCAS-TC",0
40,"40201",42,37,37,0,0,"RECORTES CERO-GV-PCAS-TC",0
42,"42110",54,43,43,0,0,"RECORTES CERO-GV-PCAS-TC",0
47,"47198",64,43,43,0,0,"RECORTES CERO-GV-PCAS-TC",0
40,"40105",43,35,35,0,0,"RECORTES CERO-GV-PCAS-TC",0
37,"37067",3278,2568,2529,30,39,"RECORTES CERO-GV-PCAS-TC",2
45,"45201",3692,2198,2175,15,23,"RECORTES CERO-GV-PCAS-TC",0
45,"45017",264,199,196,4,3,"RECORTES CERO-GV-PCAS-TC",0
37,"37231",236,185,183,5,2,"RECORTES CERO-GV-PCAS-TC",1
9,"9044",55,46,44,1,2,"RECORTES CERO-GV-PCAS-TC",0
19,"19153",22,20,20,2,0,"RECORTES CERO-GV-PCAS-TC",0
37,"37376",2130,1446,1423,18,23,"RECORTES CERO-GV-PCAS-TC",1
24,"24069",37,26,25,0,1,"RECORTES CERO-GV-PCAS-TC",0
40,"40119",166,133,132,2,1,"RECORTES CERO-GV-PCAS-TC",0
49,"49121",372,239,233,1,6,"RECORTES CERO-GV-PCAS-TC",0
49,"49156",218,149,144,0,5,"RECORTES CERO-GV-PCAS-TC",0
24,"24022",304,198,195,2,3,"RECORTES CERO-GV-PCAS-TC",0
37,"37336",56,45,43,2,2,"RECORTES CERO-GV-PCAS-TC",0
2,"2041",316,238,236,0,2,"RECORTES CERO-GV-PCAS-TC",0
13,"13901",875,628,619,1,9,"RECORTES CERO-GV-PCAS-TC",0
49,"49223",701,498,494,7,4,"RECORTES CERO-GV-PCAS-TC",0
13,"13054",4870,3630,3575,26,55,"RECORTES CERO-GV-PCAS-TC",5
5,"5249",96,63,63,0,0,"RECORTES CERO-GV-PCAS-TC",0
9,"9014",182,101,101,0,0,"RECORTES CERO-GV-PCAS-TC",1
5,"5103",63,44,44,1,0,"RECORTES CERO-GV-PCAS-TC",0
47,"47099",154,123,118,0,5,"RECORTES CERO-GV-PCAS-TC",0
2,"2012",1835,1462,1420,9,42,"RECORTES CERO-GV-PCAS-TC",1
19,"19155",64,49,49,0,0,"RECORTES CERO-GV-PCAS-TC",0
28,"28024",168,137,136,2,1,"RECORTES CERO-GV-PCAS-TC",1
34,"34027",1049,677,665,15,12,"RECORTES CERO-GV-PCAS-TC",4
5,"5172",111,83,83,1,0,"RECORTES CERO-GV-PCAS-TC",1
24,"24169",2777,1908,1880,10,28,"RECORTES CERO-GV-PCAS-TC",0
5,"5218",104,81,79,0,2,"RECORTES CERO-GV-PCAS-TC",0
9,"9184",6,6,6,0,0,"RECORTES CERO-GV-PCAS-TC",0
5,"5121",263,194,189,1,5,"RECORTES CERO-GV-PCAS-TC",2
37,"37284",317,229,222,2,7,"RECORTES CERO-GV-PCAS-TC",0
49,"49077",157,80,80,0,0,"RECORTES CERO-GV-PCAS-TC",0
16,"16107",94,56,56,0,0,"RECORTES CERO-GV-PCAS-TC",0
9,"9411",153,105,104,0,1,"RECORTES CERO-GV-PCAS-TC",0
47,"47171",375,295,290,9,5,"RECORTES CERO-GV-PCAS-TC",0
13,"13057",1099,858,849,2,9,"RECORTES CERO-GV-PCAS-TC",0
19,"19132",86,65,63,0,2,"RECORTES CERO-GV-PCAS-TC",0
28,"28065",131232,100864,99883,846,981,"RECORTES CERO-GV-PCAS-TC",137
28,"28110",2029,1498,1478,9,20,"RECORTES CERO-GV-PCAS-TC",1
45,"45095",663,496,492,2,4,"RECORTES CERO-GV-PCAS-TC",0
2,"2901",2196,1441,1419,10,22,"RECORTES CERO-GV-PCAS-TC",0
49,"49260",693,480,473,3,7,"RECORTES CERO-GV-PCAS-TC",2
47,"47204",235,159,157,3,2,"RECORTES CERO-GV-PCAS-TC",1
34,"34086",102,81,81,2,0,"RECORTES CERO-GV-PCAS-TC",0
9,"9317",20,18,18,0,0,"RECORTES CERO-GV-PCAS-TC",0
28,"28087",3301,2539,2519,20,20,"RECORTES CERO-GV-PCAS-TC",2
47,"47087",362,272,268,1,4,"RECORTES CERO-GV-PCAS-TC",1
28,"28099",1950,1409,1404,16,5,"RECORTES CERO-GV-PCAS-TC",3
49,"49148",259,119,115,1,4,"RECORTES CERO-GV-PCAS-TC",1
42,"42194",144,101,100,2,1,"RECORTES CERO-GV-PCAS-TC",0
5,"5197",100,82,79,1,3,"RECORTES CERO-GV-PCAS-TC",0
19,"19064",64,56,56,0,0,"RECORTES CERO-GV-PCAS-TC",0
47,"47142",121,85,85,0,0,"RECORTES CERO-GV-PCAS-TC",0
34,"34236",147,104,104,0,0,"RECORTES CERO-GV-PCAS-TC",0
49,"49262",367,263,261,1,2,"RECORTES CERO-GV-PCAS-TC",0
42,"42057",145,70,70,0,0,"RECORTES CERO-GV-PCAS-TC",0
24,"24171",337,136,134,4,2,"RECORTES CERO-GV-PCAS-TC",0
13,"13044",2582,1838,1804,13,34,"RECORTES CERO-GV-PCAS-TC",1
42,"42030",91,69,69,2,0,"RECORTES CERO-GV-PCAS-TC",0
49,"49111",119,84,84,3,0,"RECORTES CERO-GV-PCAS-TC",0
40,"40150",60,42,42,0,0,"RECORTES CERO-GV-PCAS-TC",0
24,"24052",139,94,93,0,1,"RECORTES CERO-GV-PCAS-TC",0
37,"37173",1412,951,937,15,14,"RECORTES CERO-GV-PCAS-TC",1
16,"16271",612,482,481,3,1,"RECORTES CERO-GV-PCAS-TC",0
40,"40003",116,82,79,3,3,"RECORTES CERO-GV-PCAS-TC",0
28,"28074",141137,106626,105602,885,1024,"RECORTES CERO-GV-PCAS-TC",210
42,"42032",138,96,96,0,0,"RECORTES CERO-GV-PCAS-TC",0
49,"49228",53,36,36,0,0,"RECORTES CERO-GV-PCAS-TC",0
28,"28145",2671,1927,1895,21,32,"RECORTES CERO-GV-PCAS-TC",2
42,"42119",141,78,78,1,0,"RECORTES CERO-GV-PCAS-TC",0
5,"5198",70,53,51,0,2,"RECORTES CERO-GV-PCAS-TC",0
37,"37037",108,72,72,0,0,"RECORTES CERO-GV-PCAS-TC",0
42,"42073",73,56,55,0,1,"RECORTES CERO-GV-PCAS-TC",0
13,"13016",656,463,454,3,9,"RECORTES CERO-GV-PCAS-TC",0
28,"28068",11740,8615,8543,72,72,"RECORTES CERO-GV-PCAS-TC",7
49,"49151",591,389,388,3,1,"RECORTES CERO-GV-PCAS-TC",0
49,"49081",1321,972,953,6,19,"RECORTES CERO-GV-PCAS-TC",0
28,"28008",2008,1333,1323,7,10,"RECORTES CERO-GV-PCAS-TC",0
47,"47080",33,25,24,0,1,"RECORTES CERO-GV-PCAS-TC",0
37,"37073",613,448,440,4,8,"RECORTES CERO-GV-PCAS-TC",0
28,"28176",13980,10765,10701,72,64,"RECORTES CERO-GV-PCAS-TC",14
2,"2058",300,186,177,1,9,"RECORTES CERO-GV-PCAS-TC",0
49,"49007",361,241,233,7,8,"RECORTES CERO-GV-PCAS-TC",0
19,"19136",11,10,10,0,0,"RECORTES CERO-GV-PCAS-TC",0
34,"34048",62,51,51,1,0,"RECORTES CERO-GV-PCAS-TC",0
28,"28069",58,44,42,1,2,"RECORTES CERO-GV-PCAS-TC",0
37,"37268",106,62,61,1,1,"RECORTES CERO-GV-PCAS-TC",0
34,"34033",18,14,14,0,0,"RECORTES CERO-GV-PCAS-TC",0
9,"9307",102,76,74,1,2,"RECORTES CERO-GV-PCAS-TC",1
16,"16011",20,14,14,0,0,"RECORTES CERO-GV-PCAS-TC",0
42,"42168",108,73,73,0,0,"RECORTES CERO-GV-PCAS-TC",0
19,"19200",66,53,52,0,1,"RECORTES CERO-GV-PCAS-TC",0
40,"40208",724,546,543,5,3,"RECORTES CERO-GV-PCAS-TC",0
34,"34001",39,27,27,1,0,"RECORTES CERO-GV-PCAS-TC",1
24,"24054",410,275,271,0,4,"RECORTES CERO-GV-PCAS-TC",0
5,"5267",103,67,67,1,0,"RECORTES CERO-GV-PCAS-TC",0
5,"5200",41,26,26,0,0,"RECORTES CERO-GV-PCAS-TC",0
28,"28177",10851,8550,8485,89,65,"RECORTES CERO-GV-PCAS-TC",13
24,"24055",674,484,482,8,2,"RECORTES CERO-GV-PCAS-TC",0
2,"2034",1323,1024,1018,6,6,"RECORTES CERO-GV-PCAS-TC",1
5,"5025",78,65,65,0,0,"RECORTES CERO-GV-PCAS-TC",0
40,"40053",79,56,56,1,0,"RECORTES CERO-GV-PCAS-TC",0
9,"9102",33,22,22,0,0,"RECORTES CERO-GV-PCAS-TC",0
45,"45122",5605,4321,4288,33,33,"RECORTES CERO-GV-PCAS-TC",7
40,"40136",102,79,77,3,2,"RECORTES CERO-GV-PCAS-TC",0
19,"19325",154,86,86,1,0,"RECORTES CERO-GV-PCAS-TC",0
49,"49243",107,74,74,0,0,"RECORTES CERO-GV-PCAS-TC",0
16,"16177",83,65,65,1,0,"RECORTES CERO-GV-PCAS-TC",1
9,"9128",76,56,56,0,0,"RECORTES CERO-GV-PCAS-TC",0
28,"28061",22757,17091,16965,115,126,"RECORTES CERO-GV-PCAS-TC",23
37,"37260",137,110,109,0,1,"RECORTES CERO-GV-PCAS-TC",0
19,"19263",21,15,15,0,0,"RECORTES CERO-GV-PCAS-TC",0
49,"49043",256,191,189,1,2,"RECORTES CERO-GV-PCAS-TC",0
9,"9329",113,76,75,5,1,"RECORTES CERO-GV-PCAS-TC",0
9,"9010",33,25,25,2,0,"RECORTES CERO-GV-PCAS-TC",0
16,"16209",110,95,94,2,1,"RECORTES CERO-GV-PCAS-TC",0
45,"45175",603,476,473,1,3,"RECORTES CERO-GV-PCAS-TC",0
42,"42173",29860,19581,19206,337,375,"RECORTES CERO-GV-PCAS-TC",54
28,"28179",1451,1043,1033,6,10,"RECORTES CERO-GV-PCAS-TC",0
40,"40148",231,165,163,4,2,"RECORTES CERO-GV-PCAS-TC",0
37,"37145",236,173,170,3,3,"RECORTES CERO-GV-PCAS-TC",0
49,"49085",904,583,579,5,4,"RECORTES CERO-GV-PCAS-TC",0
37,"37335",384,282,279,1,3,"RECORTES CERO-GV-PCAS-TC",0
24,"24129",114,79,78,2,1,"RECORTES CERO-GV-PCAS-TC",0
34,"34143",161,115,112,2,3,"RECORTES CERO-GV-PCAS-TC",0
24,"24189",5872,3915,3873,42,42,"RECORTES CERO-GV-PCAS-TC",1
2,"2017",760,498,493,1,5,"RECORTES CERO-GV-PCAS-TC",0
45,"45116",666,492,489,4,3,"RECORTES CERO-GV-PCAS-TC",2
49,"49098",200,139,138,3,1,"RECORTES CERO-GV-PCAS-TC",0
45,"45190",462,361,353,3,8,"RECORTES CERO-GV-PCAS-TC",0
24,"24033",209,149,149,0,0,"RECORTES CERO-GV-PCAS-TC",0
40,"40094",353,265,263,3,2,"RECORTES CERO-GV-PCAS-TC",3
42,"42014",57,35,35,0,0,"RECORTES CERO-GV-PCAS-TC",0
49,"49086",111,89,89,1,0,"RECORTES CERO-GV-PCAS-TC",4
24,"24167",703,436,430,3,6,"RECORTES CERO-GV-PCAS-TC",1
24,"24130",415,291,289,2,2,"RECORTES CERO-GV-PCAS-TC",0
28,"28012",929,707,698,7,9,"RECORTES CERO-GV-PCAS-TC",3
37,"37272",132,97,95,0,2,"RECORTES CERO-GV-PCAS-TC",0
28,"28095",1719,1236,1226,5,10,"RECORTES CERO-GV-PCAS-TC",3
42,"42175",22,16,16,0,0,"RECORTES CERO-GV-PCAS-TC",0
45,"45141",848,626,615,0,11,"RECORTES CERO-GV-PCAS-TC",0
40,"40013",57,47,47,0,0,"RECORTES CERO-GV-PCAS-TC",0
24,"24184",177,106,105,0,1,"RECORTES CERO-GV-PCAS-TC",0
34,"34901",1053,762,759,10,3,"RECORTES CERO-GV-PCAS-TC",1
45,"45046",2369,1679,1651,11,28,"RECORTES CERO-GV-PCAS-TC",1
9,"9180",132,94,91,1,3,"RECORTES CERO-GV-PCAS-TC",1
24,"24219",489,334,329,7,5,"RECORTES CERO-GV-PCAS-TC",1
40,"40095",453,341,329,2,12,"RECORTES CERO-GV-PCAS-TC",2
2,"2075",1700,1357,1347,6,10,"RECORTES CERO-GV-PCAS-TC",0
47,"47014",48,39,39,1,0,"RECORTES CERO-GV-PCAS-TC",0
42,"42083",26,20,20,0,0,"RECORTES CERO-GV-PCAS-TC",0
28,"28086",5446,3643,3600,19,43,"RECORTES CERO-GV-PCAS-TC",5
49,"49088",80,51,51,0,0,"RECORTES CERO-GV-PCAS-TC",0
40,"40084",52,41,41,2,0,"RECORTES CERO-GV-PCAS-TC",0
40,"40075",152,116,116,0,0,"RECORTES CERO-GV-PCAS-TC",0
16,"16018",376,290,290,2,0,"RECORTES CERO-GV-PCAS-TC",1
9,"9442",368,265,262,1,3,"RECORTES CERO-GV-PCAS-TC",1
9,"9276",390,256,244,4,12,"RECORTES CERO-GV-PCAS-TC",1
19,"19333",96,68,67,0,1,"RECORTES CERO-GV-PCAS-TC",0
24,"24060",561,297,296,2,1,"RECORTES CERO-GV-PCAS-TC",1
45,"45181",2330,1693,1661,10,32,"RECORTES CERO-GV-PCAS-TC",1
19,"19145",40,32,32,0,0,"RECORTES CERO-GV-PCAS-TC",0
19,"19208",39,32,32,0,0,"RECORTES CERO-GV-PCAS-TC",0
19,"19209",40,30,29,0,1,"RECORTES CERO-GV-PCAS-TC",0
49,"49236",71,54,54,0,0,"RECORTES CERO-GV-PCAS-TC",0
9,"9064",305,225,219,6,6,"RECORTES CERO-GV-PCAS-TC",1
19,"19197",28,22,22,1,0,"RECORTES CERO-GV-PCAS-TC",0
40,"40904",344,286,284,8,2,"RECORTES CERO-GV-PCAS-TC",0
9,"9261",446,279,271,2,8,"RECORTES CERO-GV-PCAS-TC",1
28,"28015",20885,16237,16104,134,133,"RECORTES CERO-GV-PCAS-TC",17
19,"19133",78,64,64,2,0,"RECORTES CERO-GV-PCAS-TC",0
37,"37369",126,83,81,0,2,"RECORTES CERO-GV-PCAS-TC",0
28,"28153",816,547,544,3,3,"RECORTES CERO-GV-PCAS-TC",1
34,"34103",96,79,76,0,3,"RECORTES CERO-GV-PCAS-TC",0
9,"9443",151,113,112,0,1,"RECORTES CERO-GV-PCAS-TC",0
5,"5113",62,42,42,0,0,"RECORTES CERO-GV-PCAS-TC",0
9,"9019",146,105,103,4,2,"RECORTES CERO-GV-PCAS-TC",0
49,"49160",42,27,27,0,0,"RECORTES CERO-GV-PCAS-TC",0
42,"42071",159,92,92,2,0,"RECORTES CERO-GV-PCAS-TC",1
5,"5046",38,35,35,0,0,"RECORTES CERO-GV-PCAS-TC",0
5,"5167",223,177,172,0,5,"RECORTES CERO-GV-PCAS-TC",0
45,"45203",2777,1986,1961,18,25,"RECORTES CERO-GV-PCAS-TC",4
16,"16118",1351,1022,1009,13,13,"RECORTES CERO-GV-PCAS-TC",2
5,"5134",47,40,40,0,0,"RECORTES CERO-GV-PCAS-TC",0
24,"24076",1283,926,913,10,13,"RECORTES CERO-GV-PCAS-TC",1
5,"5175",144,109,109,0,0,"RECORTES CERO-GV-PCAS-TC",0
5,"5114",1257,989,968,5,21,"RECORTES CERO-GV-PCAS-TC",2
9,"9175",120,78,76,1,2,"RECORTES CERO-GV-PCAS-TC",0
5,"5241",3062,2011,1977,21,34,"RECORTES CERO-GV-PCAS-TC",1
42,"42045",273,175,174,4,1,"RECORTES CERO-GV-PCAS-TC",0
37,"37309",36,21,21,0,0,"RECORTES CERO-GV-PCAS-TC",0
47,"47122",2007,1520,1492,8,28,"RECORTES CERO-GV-PCAS-TC",1
16,"16270",154,123,122,1,1,"RECORTES CERO-GV-PCAS-TC",0
47,"47216",111,94,91,0,3,"RECORTES CERO-GV-PCAS-TC",0
37,"37121",536,413,403,4,10,"RECORTES CERO-GV-PCAS-TC",0
37,"37277",74,55,55,0,0,"RECORTES CERO-GV-PCAS-TC",0
47,"47089",133,111,111,2,0,"RECORTES CERO-GV-PCAS-TC",0
9,"9230",33,26,26,0,0,"RECORTES CERO-GV-PCAS-TC",0
16,"16272",201,149,147,2,2,"RECORTES CERO-GV-PCAS-TC",0
24,"24137",1043,700,691,8,9,"RECORTES CERO-GV-PCAS-TC",1
9,"9021",50,30,30,3,0,"RECORTES CERO-GV-PCAS-TC",0
37,"37310",166,116,115,3,1,"RECORTES CERO-GV-PCAS-TC",0
19,"19045",122,97,96,0,1,"RECORTES CERO-GV-PCAS-TC",0
24,"24100",737,506,502,9,4,"RECORTES CERO-GV-PCAS-TC",0
40,"40089",209,155,148,2,7,"RECORTES CERO-GV-PCAS-TC",0
47,"47090",2447,1823,1784,15,39,"RECORTES CERO-GV-PCAS-TC",2
24,"24213",158,127,126,1,1,"RECORTES CERO-GV-PCAS-TC",1
40,"40025",129,109,107,1,2,"RECORTES CERO-GV-PCAS-TC",0
47,"47123",461,360,358,2,2,"RECORTES CERO-GV-PCAS-TC",0
28,"28009",14593,11026,10913,73,113,"RECORTES CERO-GV-PCAS-TC",12
13,"13079",12233,8274,8138,93,136,"RECORTES CERO-GV-PCAS-TC",9
42,"42184",55,36,33,0,3,"RECORTES CERO-GV-PCAS-TC",0
40,"40220",64,46,45,0,1,"RECORTES CERO-GV-PCAS-TC",1
9,"9346",90,61,60,1,1,"RECORTES CERO-GV-PCAS-TC",0
19,"19046",22204,16001,15752,156,249,"RECORTES CERO-GV-PCAS-TC",28
49,"49055",91,72,72,3,0,"RECORTES CERO-GV-PCAS-TC",1
16,"16224",72,60,58,0,2,"RECORTES CERO-GV-PCAS-TC",1
40,"40125",76,48,46,0,2,"RECORTES CERO-GV-PCAS-TC",0
24,"24091",575,368,362,5,6,"RECORTES CERO-GV-PCAS-TC",0
42,"42034",41,25,25,0,0,"RECORTES CERO-GV-PCAS-TC",0
19,"19138",215,158,154,4,4,"RECORTES CERO-GV-PCAS-TC",0
40,"40143",82,68,67,2,1,"RECORTES CERO-GV-PCAS-TC",0
45,"45073",288,214,210,2,4,"RECORTES CERO-GV-PCAS-TC",0
16,"16244",698,598,585,7,13,"RECORTES CERO-GV-PCAS-TC",0
5,"5037",210,135,135,0,0,"RECORTES CERO-GV-PCAS-TC",1
34,"34089",141,102,101,4,1,"RECORTES CERO-GV-PCAS-TC",0
9,"9141",617,463,456,5,7,"RECORTES CERO-GV-PCAS-TC",1
9,"9073",964,713,706,3,7,"RECORTES CERO-GV-PCAS-TC",1
37,"37102",375,260,260,4,0,"RECORTES CERO-GV-PCAS-TC",1
24,"24020",436,230,228,0,2,"RECORTES CERO-GV-PCAS-TC",0
24,"24125",416,233,231,3,2,"RECORTES CERO-GV-PCAS-TC",0
40,"40211",66,54,54,1,0,"RECORTES CERO-GV-PCAS-TC",0
42,"42050",27,17,17,0,0,"RECORTES CERO-GV-PCAS-TC",0
37,"37186",94,68,68,0,0,"RECORTES CERO-GV-PCAS-TC",0
16,"16026",91,69,68,0,1,"RECORTES CERO-GV-PCAS-TC",0
42,"42141",101,59,59,0,0,"RECORTES CERO-GV-PCAS-TC",0
16,"16102",1159,815,767,9,48,"RECORTES CERO-GV-PCAS-TC",0
2,"2039",945,745,734,8,11,"RECORTES CERO-GV-PCAS-TC",0
9,"9181",276,194,191,7,3,"RECORTES CERO-GV-PCAS-TC",0
37,"37250",325,212,211,0,1,"RECORTES CERO-GV-PCAS-TC",0
9,"9236",34,25,25,1,0,"RECORTES CERO-GV-PCAS-TC",0
28,"28159",589,455,447,4,8,"RECORTES CERO-GV-PCAS-TC",0
5,"5119",24,17,17,1,0,"RECORTES CERO-GV-PCAS-TC",0
49,"49131",231,149,145,1,4,"RECORTES CERO-GV-PCAS-TC",0
2,"2006",573,425,424,1,1,"RECORTES CERO-GV-PCAS-TC",0
40,"40191",198,143,138,0,5,"RECORTES CERO-GV-PCAS-TC",0
42,"42144",419,302,298,6,4,"RECORTES CERO-GV-PCAS-TC",0
5,"5053",76,48,48,0,0,"RECORTES CERO-GV-PCAS-TC",0
19,"19048",19,14,13,1,1,"RECORTES CERO-GV-PCAS-TC",0
5,"5141",95,79,78,1,1,"RECORTES CERO-GV-PCAS-TC",0
28,"28013",41661,29431,29168,241,263,"RECORTES CERO-GV-PCAS-TC",37
5,"5109",445,334,329,4,5,"RECORTES CERO-GV-PCAS-TC",0
47,"47200",70,60,60,0,0,"RECORTES CERO-GV-PCAS-TC",0
5,"5130",94,77,77,1,0,"RECORTES CERO-GV-PCAS-TC",0
47,"47127",138,89,88,2,1,"RECORTES CERO-GV-PCAS-TC",1
16,"16064",651,556,550,4,6,"RECORTES CERO-GV-PCAS-TC",0
34,"34113",40,38,38,0,0,"RECORTES CERO-GV-PCAS-TC",0
9,"9352",102,74,74,0,0,"RECORTES CERO-GV-PCAS-TC",0
37,"37091",161,104,104,0,0,"RECORTES CERO-GV-PCAS-TC",0
9,"9439",1061,801,790,2,11,"RECORTES CERO-GV-PCAS-TC",2
9,"9423",27,24,24,1,0,"RECORTES CERO-GV-PCAS-TC",0
24,"24179",287,207,207,2,0,"RECORTES CERO-GV-PCAS-TC",0
47,"47085",16330,11556,11419,121,137,"RECORTES CERO-GV-PCAS-TC",16
5,"5904",108,70,69,5,1,"RECORTES CERO-GV-PCAS-TC",0
37,"37033",94,67,67,0,0,"RECORTES CERO-GV-PCAS-TC",0
42,"42142",42,36,36,1,0,"RECORTES CERO-GV-PCAS-TC",0
24,"24070",3886,2677,2625,18,52,"RECORTES CERO-GV-PCAS-TC",2
28,"28119",2294,1760,1738,12,22,"RECORTES CERO-GV-PCAS-TC",3
42,"42162",2298,1493,1462,18,31,"RECORTES CERO-GV-PCAS-TC",0
24,"24180",1086,767,759,9,8,"RECORTES CERO-GV-PCAS-TC",0
42,"42219",40,34,34,1,0,"RECORTES CERO-GV-PCAS-TC",0
34,"34070",131,98,96,0,2,"RECORTES CERO-GV-PCAS-TC",0
5,"5055",532,417,413,3,4,"RECORTES CERO-GV-PCAS-TC",1
5,"5056",91,71,70,0,1,"RECORTES CERO-GV-PCAS-TC",0
5,"5143",59,52,51,1,1,"RECORTES CERO-GV-PCAS-TC",0
49,"49134",158,100,99,1,1,"RECORTES CERO-GV-PCAS-TC",0
42,"42149",386,273,270,2,3,"RECORTES CERO-GV-PCAS-TC",1
45,"45119",3499,2217,2190,3,27,"RECORTES CERO-GV-PCAS-TC",6
24,"24071",947,618,611,6,7,"RECORTES CERO-GV-PCAS-TC",1
49,"49025",157,121,118,0,3,"RECORTES CERO-GV-PCAS-TC",1
28,"28130",28569,22050,21799,187,251,"RECORTES CERO-GV-PCAS-TC",35
5,"5022",1580,1202,1193,6,9,"RECORTES CERO-GV-PCAS-TC",1
9,"9189",123,83,78,0,5,"RECORTES CERO-GV-PCAS-TC",0
40,"40130",127,95,87,1,8,"RECORTES CERO-GV-PCAS-TC",0
34,"34120",63790,46117,45597,464,520,"RECORTES CERO-GV-PCAS-TC",147
49,"49135",576,368,366,3,2,"RECORTES CERO-GV-PCAS-TC",1
9,"9225",80,55,55,0,0,"RECORTES CERO-GV-PCAS-TC",0
9,"9392",49,28,28,0,0,"RECORTES CERO-GV-PCAS-TC",0
37,"37150",34,31,31,0,0,"RECORTES CERO-GV-PCAS-TC",0
9,"9134",217,142,138,1,4,"RECORTES CERO-GV-PCAS-TC",0
16,"16056",442,275,270,4,5,"RECORTES CERO-GV-PCAS-TC",0
40,"40228",493,362,361,3,1,"RECORTES CERO-GV-PCAS-TC",0
24,"24222",14499,10219,10076,99,143,"RECORTES CERO-GV-PCAS-TC",5
16,"16147",54,34,33,0,1,"RECORTES CERO-GV-PCAS-TC",0
40,"40099",54,44,42,0,2,"RECORTES CERO-GV-PCAS-TC",0
5,"5156",242,145,145,1,0,"RECORTES CERO-GV-PCAS-TC",0
19,"19280",3669,2622,2597,24,25,"RECORTES CERO-GV-PCAS-TC",5
9,"9034",291,227,224,1,3,"RECORTES CERO-GV-PCAS-TC",1
5,"5047",4105,3004,2936,23,68,"RECORTES CERO-GV-PCAS-TC",3
45,"45157",2288,1490,1472,5,18,"RECORTES CERO-GV-PCAS-TC",1
37,"37162",212,139,137,3,2,"RECORTES CERO-GV-PCAS-TC",0
34,"34208",48,40,40,1,0,"RECORTES CERO-GV-PCAS-TC",1
19,"19220",2608,1673,1653,10,20,"RECORTES CERO-GV-PCAS-TC",3
47,"47194",295,228,227,1,1,"RECORTES CERO-GV-PCAS-TC",1
19,"19053",1906,1323,1304,12,19,"RECORTES CERO-GV-PCAS-TC",1
37,"37192",361,200,198,3,2,"RECORTES CERO-GV-PCAS-TC",0
40,"40196",30,24,24,0,0,"RECORTES CERO-GV-PCAS-TC",0
34,"34170",50,30,30,1,0,"RECORTES CERO-GV-PCAS-TC",0
49,"49250",1191,844,824,8,20,"RECORTES CERO-GV-PCAS-TC",1
37,"37256",191,123,123,1,0,"RECORTES CERO-GV-PCAS-TC",0
16,"16109",41,30,30,0,0,"RECORTES CERO-GV-PCAS-TC",0
19,"19019",14,11,11,1,0,"RECORTES CERO-GV-PCAS-TC",0
42,"42103",543,383,374,2,9,"RECORTES CERO-GV-PCAS-TC",0
16,"16901",624,443,438,5,5,"RECORTES CERO-GV-PCAS-TC",1
16,"16071",20,16,16,0,0,"RECORTES CERO-GV-PCAS-TC",0
49,"49028",108,90,89,1,1,"RECORTES CERO-GV-PCAS-TC",0
42,"42196",7,7,7,1,0,"RECORTES CERO-GV-PCAS-TC",0
34,"34225",5016,3708,3650,41,58,"RECORTES CERO-GV-PCAS-TC",5
19,"19124",378,230,229,2,1,"RECORTES CERO-GV-PCAS-TC",0
45,"45087",8180,5737,5628,41,109,"RECORTES CERO-GV-PCAS-TC",2
45,"45197",1888,1446,1426,5,20,"RECORTES CERO-GV-PCAS-TC",0
9,"9036",31,24,24,4,0,"RECORTES CERO-GV-PCAS-TC",0
37,"37382",162,127,124,0,3,"RECORTES CERO-GV-PCAS-TC",0
24,"24040",416,293,292,2,1,"RECORTES CERO-GV-PCAS-TC",0
16,"16072",132,84,84,1,0,"RECORTES CERO-GV-PCAS-TC",0
19,"19054",161,136,135,3,1,"RECORTES CERO-GV-PCAS-TC",0
45,"45013",1679,1266,1248,5,18,"RECORTES CERO-GV-PCAS-TC",0
40,"40101",918,672,665,11,7,"RECORTES CERO-GV-PCAS-TC",3
5,"5256",110,88,86,1,2,"RECORTES CERO-GV-PCAS-TC",0
16,"16023",513,367,367,3,0,"RECORTES CERO-GV-PCAS-TC",0
40,"40035",135,110,110,2,0,"RECORTES CERO-GV-PCAS-TC",1
28,"28134",63936,48022,47631,421,391,"RECORTES CERO-GV-PCAS-TC",68
49,"49030",79,56,56,0,0,"RECORTES CERO-GV-PCAS-TC",0
37,"37195",39,31,31,0,0,"RECORTES CERO-GV-PCAS-TC",0
9,"9472",52,40,38,0,2,"RECORTES CERO-GV-PCAS-TC",0
5,"5094",133,105,105,0,0,"RECORTES CERO-GV-PCAS-TC",1
37,"37164",232,176,175,3,1,"RECORTES CERO-GV-PCAS-TC",0
45,"45088",2366,1526,1501,8,25,"RECORTES CERO-GV-PCAS-TC",3
34,"34079",1729,1296,1275,19,21,"RECORTES CERO-GV-PCAS-TC",4
5,"5234",45,38,38,0,0,"RECORTES CERO-GV-PCAS-TC",1
49,"49266",66,46,45,1,1,"RECORTES CERO-GV-PCAS-TC",0
45,"45126",234,146,144,2,2,"RECORTES CERO-GV-PCAS-TC",0
16,"16243",376,316,309,4,7,"RECORTES CERO-GV-PCAS-TC",0
19,"19126",1701,1223,1207,6,16,"RECORTES CERO-GV-PCAS-TC",1
34,"34215",161,126,125,6,1,"RECORTES CERO-GV-PCAS-TC",0
42,"42187",58,44,39,1,5,"RECORTES CERO-GV-PCAS-TC",0
5,"5191",121,99,99,0,0,"RECORTES CERO-GV-PCAS-TC",0
24,"24103",274,134,134,0,0,"RECORTES CERO-GV-PCAS-TC",0
19,"19047",55,47,47,1,0,"RECORTES CERO-GV-PCAS-TC",0
16,"16227",109,78,76,0,2,"RECORTES CERO-GV-PCAS-TC",0
49,"49096",155,113,112,2,1,"RECORTES CERO-GV-PCAS-TC",0
16,"16115",49,32,32,0,0,"RECORTES CERO-GV-PCAS-TC",0
24,"24008",8931,6291,6214,79,77,"RECORTES CERO-GV-PCAS-TC",5
45,"45016",4486,3288,3251,19,37,"RECORTES CERO-GV-PCAS-TC",1
42,"42200",74,49,46,0,3,"RECORTES CERO-GV-PCAS-TC",0
9,"9043",172,112,111,1,1,"RECORTES CERO-GV-PCAS-TC",0
49,"49143",201,119,118,1,1,"RECORTES CERO-GV-PCAS-TC",0
16,"16078",41384,28809,28500,322,309,"RECORTES CERO-GV-PCAS-TC",50
49,"49256",236,183,179,0,4,"RECORTES CERO-GV-PCAS-TC",0
19,"19319",4609,3303,3273,22,30,"RECORTES CERO-GV-PCAS-TC",13
34,"34229",58,47,47,1,0,"RECORTES CERO-GV-PCAS-TC",0
42,"42159",39,34,33,0,1,"RECORTES CERO-GV-PCAS-TC",0
13,"13098",1946,1404,1361,13,43,"RECORTES CERO-GV-PCAS-TC",2
19,"19193",22,21,21,1,0,"RECORTES CERO-GV-PCAS-TC",0
34,"34037",301,206,204,1,2,"RECORTES CERO-GV-PCAS-TC",0
9,"9478",45,34,34,1,0,"RECORTES CERO-GV-PCAS-TC",0
16,"16908",166,133,132,2,1,"RECORTES CERO-GV-PCAS-TC",0
49,"49222",369,250,247,2,3,"RECORTES CERO-GV-PCAS-TC",0
13,"13083",2382,1623,1587,12,36,"RECORTES CERO-GV-PCAS-TC",3
45,"45006",1334,866,858,1,8,"RECORTES CERO-GV-PCAS-TC",0
37,"37188",158,107,105,3,2,"RECORTES CERO-GV-PCAS-TC",1
47,"47022",59,52,48,1,4,"RECORTES CERO-GV-PCAS-TC",0
19,"19142",263,179,179,1,0,"RECORTES CERO-GV-PCAS-TC",0
16,"16263",967,724,721,3,3,"RECORTES CERO-GV-PCAS-TC",0
19,"19255",74,37,37,0,0,"RECORTES CERO-GV-PCAS-TC",0
9,"9480",105,84,84,0,0,"RECORTES CERO-GV-PCAS-TC",0
5,"5194",132,105,104,1,1,"RECORTES CERO-GV-PCAS-TC",0
19,"19059",73,47,47,0,0,"RECORTES CERO-GV-PCAS-TC",0
5,"5120",33,26,26,0,0,"RECORTES CERO-GV-PCAS-TC",0
28,"28043",6190,4031,3969,33,62,"RECORTES CERO-GV-PCAS-TC",2
49,"49002",58,43,40,0,3,"RECORTES CERO-GV-PCAS-TC",0
34,"34083",1647,1089,1080,2,9,"RECORTES CERO-GV-PCAS-TC",1
28,"28171",4410,2921,2889,8,32,"RECORTES CERO-GV-PCAS-TC",4
9,"9389",63,45,45,0,0,"RECORTES CERO-GV-PCAS-TC",0
19,"19218",43,31,31,0,0,"RECORTES CERO-GV-PCAS-TC",1
34,"34132",106,73,72,0,1,"RECORTES CERO-GV-PCAS-TC",0
24,"24083",997,659,647,9,12,"RECORTES CERO-GV-PCAS-TC",0
37,"37368",17,12,11,0,1,"RECORTES CERO-GV-PCAS-TC",0
40,"40214",198,160,154,0,6,"RECORTES CERO-GV-PCAS-TC",0
45,"45155",311,240,240,0,0,"RECORTES CERO-GV-PCAS-TC",0
28,"28109",1651,1131,1116,8,15,"RECORTES CERO-GV-PCAS-TC",0
5,"5229",75,61,61,1,0,"RECORTES CERO-GV-PCAS-TC",0
28,"28034",368,258,255,0,3,"RECORTES CERO-GV-PCAS-TC",0
24,"24084",153,105,102,2,3,"RECORTES CERO-GV-PCAS-TC",0
9,"9353",74,56,54,1,2,"RECORTES CERO-GV-PCAS-TC",0
40,"40141",822,584,568,9,16,"RECORTES CERO-GV-PCAS-TC",1
45,"45168",62836,46917,46353,424,564,"RECORTES CERO-GV-PCAS-TC",106
19,"19196",89,70,67,1,3,"RECORTES CERO-GV-PCAS-TC",0
37,"37138",222,163,159,3,4,"RECORTES CERO-GV-PCAS-TC",0
40,"40173",140,120,118,2,2,"RECORTES CERO-GV-PCAS-TC",0
47,"47045",732,558,549,3,9,"RECORTES CERO-GV-PCAS-TC",0
45,"45132",2387,1765,1754,13,11,"RECORTES CERO-GV-PCAS-TC",1
42,"42069",1483,896,878,2,18,"RECORTES CERO-GV-PCAS-TC",0
49,"49078",138,113,109,4,4,"RECORTES CERO-GV-PCAS-TC",0
28,"28143",77,58,58,0,0,"RECORTES CERO-GV-PCAS-TC",0
5,"5133",61,44,43,0,1,"RECORTES CERO-GV-PCAS-TC",0
34,"34234",66,48,45,0,3,"RECORTES CERO-GV-PCAS-TC",0
9,"9485",55,41,41,0,0,"RECORTES CERO-GV-PCAS-TC",0
49,"49225",122,68,68,0,0,"RECORTES CERO-GV-PCAS-TC",1
16,"16121",227,160,152,0,8,"RECORTES CERO-GV-PCAS-TC",0
37,"37139",189,150,148,1,2,"RECORTES CERO-GV-PCAS-TC",0
19,"19258",84,63,62,0,1,"RECORTES CERO-GV-PCAS-TC",0
37,"37265",198,167,163,1,4,"RECORTES CERO-GV-PCAS-TC",0
9,"9050",57,38,38,1,0,"RECORTES CERO-GV-PCAS-TC",2
28,"28174",1858,1284,1273,1,11,"RECORTES CERO-GV-PCAS-TC",2
9,"9902",439,334,326,10,8,"RECORTES CERO-GV-PCAS-TC",1
34,"34134",44,25,25,0,0,"RECORTES CERO-GV-PCAS-TC",0
34,"34135",398,267,264,4,3,"RECORTES CERO-GV-PCAS-TC",0
37,"37026",180,148,147,5,1,"RECORTES CERO-GV-PCAS-TC",0
16,"16250",67,52,52,1,0,"RECORTES CERO-GV-PCAS-TC",1
47,"47047",199,136,135,4,1,"RECORTES CERO-GV-PCAS-TC",1
13,"13014",472,361,352,4,9,"RECORTES CERO-GV-PCAS-TC",0
37,"37297",394,298,297,0,1,"RECORTES CERO-GV-PCAS-TC",1
19,"19198",17,14,14,0,0,"RECORTES CERO-GV-PCAS-TC",0
28,"28006",80903,60936,60508,482,428,"RECORTES CERO-GV-PCAS-TC",84
40,"40176",372,288,287,2,1,"RECORTES CERO-GV-PCAS-TC",0
47,"47111",1001,738,732,5,6,"RECORTES CERO-GV-PCAS-TC",1
37,"37266",68,44,44,0,0,"RECORTES CERO-GV-PCAS-TC",0
45,"45098",2090,1488,1469,7,19,"RECORTES CERO-GV-PCAS-TC",2
5,"5232",104,86,83,1,3,"RECORTES CERO-GV-PCAS-TC",1
9,"9103",200,168,166,1,2,"RECORTES CERO-GV-PCAS-TC",1
40,"40207",802,593,590,11,3,"RECORTES CERO-GV-PCAS-TC",0
9,"9001",32,25,25,0,0,"RECORTES CERO-GV-PCAS-TC",0
34,"34237",579,408,400,1,8,"RECORTES CERO-GV-PCAS-TC",1
16,"16123",66,42,41,0,1,"RECORTES CERO-GV-PCAS-TC",0
47,"47143",104,67,67,0,0,"RECORTES CERO-GV-PCAS-TC",0
37,"37361",84,55,54,1,1,"RECORTES CERO-GV-PCAS-TC",0
9,"9380",71,42,41,0,1,"RECORTES CERO-GV-PCAS-TC",1
2,"2057",1947,1358,1333,15,25,"RECORTES CERO-GV-PCAS-TC",0
42,"42211",84,67,67,0,0,"RECORTES CERO-GV-PCAS-TC",0
19,"19230",558,409,406,1,3,"RECORTES CERO-GV-PCAS-TC",4
24,"24162",1753,1259,1245,12,14,"RECORTES CERO-GV-PCAS-TC",0
47,"47112",2561,1960,1933,13,27,"RECORTES CERO-GV-PCAS-TC",1
24,"24089",101036,71905,71305,744,600,"RECORTES CERO-GV-PCAS-TC",47
34,"34240",84,67,66,1,1,"RECORTES CERO-GV-PCAS-TC",0
13,"13062",567,450,446,4,4,"RECORTES CERO-GV-PCAS-TC",0
45,"45099",3700,2524,2501,9,23,"RECORTES CERO-GV-PCAS-TC",7
45,"45026",219,166,164,1,2,"RECORTES CERO-GV-PCAS-TC",0
37,"37204",253,176,173,2,3,"RECORTES CERO-GV-PCAS-TC",0
16,"16242",300,245,243,2,2,"RECORTES CERO-GV-PCAS-TC",1
13,"13063",3648,2464,2406,28,58,"RECORTES CERO-GV-PCAS-TC",1
37,"37174",975,716,705,2,11,"RECORTES CERO-GV-PCAS-TC",0
19,"19106",77,57,57,0,0,"RECORTES CERO-GV-PCAS-TC",0
19,"19231",10,6,6,0,0,"RECORTES CERO-GV-PCAS-TC",0
37,"37238",105,83,80,0,3,"RECORTES CERO-GV-PCAS-TC",0
5,"5039",47,43,43,0,0,"RECORTES CERO-GV-PCAS-TC",0
9,"9906",1185,883,877,16,6,"RECORTES CERO-GV-PCAS-TC",3
24,"24164",351,175,174,0,1,"RECORTES CERO-GV-PCAS-TC",0
19,"19010",9,9,9,0,0,"RECORTES CERO-GV-PCAS-TC",0
16,"16225",55,30,30,0,0,"RECORTES CERO-GV-PCAS-TC",0
37,"37143",384,273,273,2,0,"RECORTES CERO-GV-PCAS-TC",0
24,"24141",96,74,74,0,0,"RECORTES CERO-GV-PCAS-TC",0
24,"24165",317,202,199,1,3,"RECORTES CERO-GV-PCAS-TC",0
5,"5106",27,14,14,0,0,"RECORTES CERO-GV-PCAS-TC",0
13,"13050",475,348,345,1,3,"RECORTES CERO-GV-PCAS-TC",0
45,"45090",370,262,261,2,1,"RECORTES CERO-GV-PCAS-TC",0
45,"45015",656,449,438,2,11,"RECORTES CERO-GV-PCAS-TC",1
28,"28051",1644,1231,1220,9,11,"RECORTES CERO-GV-PCAS-TC",3
5,"5128",339,258,253,5,5,"RECORTES CERO-GV-PCAS-TC",0
37,"37322",2462,1580,1537,14,43,"RECORTES CERO-GV-PCAS-TC",3
40,"40200",38,28,28,0,0,"RECORTES CERO-GV-PCAS-TC",0
42,"42158",97,73,73,1,0,"RECORTES CERO-GV-PCAS-TC",0
16,"16163",64,51,51,0,0,"RECORTES CERO-GV-PCAS-TC",0
37,"37239",203,175,174,2,1,"RECORTES CERO-GV-PCAS-TC",0
16,"16128",50,38,38,0,0,"RECORTES CERO-GV-PCAS-TC",0
16,"16258",172,124,119,0,5,"RECORTES CERO-GV-PCAS-TC",1
19,"19202",16,13,13,1,0,"RECORTES CERO-GV-PCAS-TC",0
37,"37114",74,58,55,1,3,"RECORTES CERO-GV-PCAS-TC",0
34,"34004",5517,3819,3769,36,50,"RECORTES CERO-GV-PCAS-TC",6
28,"28149",6298,4751,4699,35,52,"RECORTES CERO-GV-PCAS-TC",3
19,"19002",55,45,45,0,0,"RECORTES CERO-GV-PCAS-TC",0
37,"37207",336,244,240,4,4,"RECORTES CERO-GV-PCAS-TC",2
16,"16014",558,419,417,6,2,"RECORTES CERO-GV-PCAS-TC",1
24,"24057",1295,909,891,7,18,"RECORTES CERO-GV-PCAS-TC",0
13,"13067",334,279,271,2,8,"RECORTES CERO-GV-PCAS-TC",0
47,"47178",170,128,124,2,4,"RECORTES CERO-GV-PCAS-TC",0
28,"28072",6176,4716,4673,44,43,"RECORTES CERO-GV-PCAS-TC",9
34,"34199",1150,767,754,14,13,"RECORTES CERO-GV-PCAS-TC",3
9,"9220",69,52,52,3,0,"RECORTES CERO-GV-PCAS-TC",0
5,"5064",101,77,77,0,0,"RECORTES CERO-GV-PCAS-TC",0
19,"19203",29,25,25,0,0,"RECORTES CERO-GV-PCAS-TC",0
24,"24205",990,678,667,6,11,"RECORTES CERO-GV-PCAS-TC",0
47,"47189",151,128,122,1,6,"RECORTES CERO-GV-PCAS-TC",0
40,"40128",123,88,87,1,1,"RECORTES CERO-GV-PCAS-TC",1
45,"45043",776,608,598,3,10,"RECORTES CERO-GV-PCAS-TC",0
19,"19109",33,26,26,2,0,"RECORTES CERO-GV-PCAS-TC",0
5,"5903",137,84,83,0,1,"RECORTES CERO-GV-PCAS-TC",0
47,"47179",368,256,254,2,2,"RECORTES CERO-GV-PCAS-TC",1
45,"45067",2267,1722,1675,14,47,"RECORTES CERO-GV-PCAS-TC",2
45,"45105",376,277,268,5,9,"RECORTES CERO-GV-PCAS-TC",0
37,"37315",89,65,64,0,1,"RECORTES CERO-GV-PCAS-TC",0
37,"37012",144,111,111,0,0,"RECORTES CERO-GV-PCAS-TC",0
45,"45068",179,129,127,0,2,"RECORTES CERO-GV-PCAS-TC",0
5,"5044",244,170,170,1,0,"RECORTES CERO-GV-PCAS-TC",0
24,"24230",403,268,265,3,3,"RECORTES CERO-GV-PCAS-TC",0
19,"19004",59,44,44,0,0,"RECORTES CERO-GV-PCAS-TC",0
34,"34055",254,185,184,3,1,"RECORTES CERO-GV-PCAS-TC",1
42,"42096",244,132,129,2,3,"RECORTES CERO-GV-PCAS-TC",0
34,"34116",54,35,35,0,0,"RECORTES CERO-GV-PCAS-TC",0
49,"49170",99,68,68,1,0,"RECORTES CERO-GV-PCAS-TC",0
5,"5131",96,64,64,1,0,"RECORTES CERO-GV-PCAS-TC",0
40,"40183",117,105,99,1,6,"RECORTES CERO-GV-PCAS-TC",0
47,"47024",223,170,168,1,2,"RECORTES CERO-GV-PCAS-TC",0
37,"37013",104,72,70,2,2,"RECORTES CERO-GV-PCAS-TC",0
34,"34151",148,98,96,1,2,"RECORTES CERO-GV-PCAS-TC",0
47,"47213",104,78,78,0,0,"RECORTES CERO-GV-PCAS-TC",0
19,"19005",91,63,62,0,1,"RECORTES CERO-GV-PCAS-TC",0
16,"16053",388,306,303,3,3,"RECORTES CERO-GV-PCAS-TC",1
37,"37014",1140,747,737,7,10,"RECORTES CERO-GV-PCAS-TC",0
37,"37305",219,177,175,2,2,"RECORTES CERO-GV-PCAS-TC",0
28,"28075",6020,4521,4469,37,52,"RECORTES CERO-GV-PCAS-TC",8
37,"37046",10648,7396,7241,62,155,"RECORTES CERO-GV-PCAS-TC",8
19,"19237",39,34,34,0,0,"RECORTES CERO-GV-PCAS-TC",0
37,"37211",208,148,148,0,0,"RECORTES CERO-GV-PCAS-TC",0
47,"47181",165,136,135,1,1,"RECORTES CERO-GV-PCAS-TC",0
37,"37274",118296,84144,83280,880,864,"RECORTES CERO-GV-PCAS-TC",97
49,"49014",116,83,83,1,0,"RECORTES CERO-GV-PCAS-TC",0
19,"19334",43,35,35,0,0,"RECORTES CERO-GV-PCAS-TC",0
34,"34204",50,35,35,0,0,"RECORTES CERO-GV-PCAS-TC",0
9,"9277",103,84,82,1,2,"RECORTES CERO-GV-PCAS-TC",0
40,"40215",79,66,66,2,0,"RECORTES CERO-GV-PCAS-TC",0
45,"45071",1779,1374,1342,7,32,"RECORTES CERO-GV-PCAS-TC",1
42,"42085",179,107,106,2,1,"RECORTES CERO-GV-PCAS-TC",0
24,"24025",283,190,185,3,5,"RECORTES CERO-GV-PCAS-TC",0
16,"16096",278,219,217,1,2,"RECORTES CERO-GV-PCAS-TC",0
28,"28901",890,624,618,5,6,"RECORTES CERO-GV-PCAS-TC",1
37,"37245",331,221,220,4,1,"RECORTES CERO-GV-PCAS-TC",1
37,"37212",104,76,76,0,0,"RECORTES CERO-GV-PCAS-TC",0
5,"5144",65,47,46,1,1,"RECORTES CERO-GV-PCAS-TC",0
19,"19335",51,39,38,0,1,"RECORTES CERO-GV-PCAS-TC",0
49,"49052",183,120,117,2,3,"RECORTES CERO-GV-PCAS-TC",0
34,"34059",411,304,292,6,12,"RECORTES CERO-GV-PCAS-TC",0
37,"37370",316,238,237,2,1,"RECORTES CERO-GV-PCAS-TC",0
49,"49238",273,205,200,4,5,"RECORTES CERO-GV-PCAS-TC",1
19,"19008",36,30,30,0,0,"RECORTES CERO-GV-PCAS-TC",0
5,"5081",37,21,21,3,0,"RECORTES CERO-GV-PCAS-TC",0
9,"9395",121,74,74,1,0,"RECORTES CERO-GV-PCAS-TC",0
37,"37246",5146,3791,3737,42,54,"RECORTES CERO-GV-PCAS-TC",2
49,"49199",236,159,157,3,2,"RECORTES CERO-GV-PCAS-TC",0
47,"47088",101,79,79,0,0,"RECORTES CERO-GV-PCAS-TC",1
9,"9445",41,28,27,1,1,"RECORTES CERO-GV-PCAS-TC",0
28,"28902",521,394,389,3,5,"RECORTES CERO-GV-PCAS-TC",0
42,"42135",69,40,40,1,0,"RECORTES CERO-GV-PCAS-TC",0
42,"42007",108,80,80,1,0,"RECORTES CERO-GV-PCAS-TC",0
37,"37151",142,109,109,1,0,"RECORTES CERO-GV-PCAS-TC",0
34,"34060",133,109,107,0,2,"RECORTES CERO-GV-PCAS-TC",0
45,"45074",397,300,293,2,7,"RECORTES CERO-GV-PCAS-TC",0
45,"45037",1520,1072,1055,5,17,"RECORTES CERO-GV-PCAS-TC",3
16,"16173",175,128,127,0,1,"RECORTES CERO-GV-PCAS-TC",1
9,"9123",42,36,36,0,0,"RECORTES CERO-GV-PCAS-TC",0
5,"5115",509,350,344,0,6,"RECORTES CERO-GV-PCAS-TC",0
47,"47217",1984,1460,1437,11,23,"RECORTES CERO-GV-PCAS-TC",3
2,"2035",1946,1494,1473,5,21,"RECORTES CERO-GV-PCAS-TC",3
19,"19270",14,13,13,0,0,"RECORTES CERO-GV-PCAS-TC",0
9,"9446",10,7,7,0,0,"RECORTES CERO-GV-PCAS-TC",0
16,"16099",179,108,105,0,3,"RECORTES CERO-GV-PCAS-TC",0
9,"9177",1140,790,780,7,10,"RECORTES CERO-GV-PCAS-TC",2
34,"34107",73,47,46,1,1,"RECORTES CERO-GV-PCAS-TC",0
47,"47059",94,64,64,0,0,"RECORTES CERO-GV-PCAS-TC",0
42,"42089",57,44,43,0,1,"RECORTES CERO-GV-PCAS-TC",0
19,"19115",29,23,23,0,0,"RECORTES CERO-GV-PCAS-TC",0
42,"42046",46,32,32,0,0,"RECORTES CERO-GV-PCAS-TC",0
28,"28156",1082,788,784,3,4,"RECORTES CERO-GV-PCAS-TC",1
49,"49241",235,178,177,1,1,"RECORTES CERO-GV-PCAS-TC",0
19,"19213",67,53,52,1,1,"RECORTES CERO-GV-PCAS-TC",0
37,"37123",159,124,123,2,1,"RECORTES CERO-GV-PCAS-TC",0
9,"9231",57,35,35,2,0,"RECORTES CERO-GV-PCAS-TC",0
19,"19182",37,32,32,0,0,"RECORTES CERO-GV-PCAS-TC",0
42,"42107",70,48,47,1,1,"RECORTES CERO-GV-PCAS-TC",1
49,"49141",290,191,191,1,0,"RECORTES CERO-GV-PCAS-TC",1
42,"42010",21,15,14,0,1,"RECORTES CERO-GV-PCAS-TC",0
2,"2026",834,644,633,4,11,"RECORTES CERO-GV-PCAS-TC",0
9,"9382",27,22,22,0,0,"RECORTES CERO-GV-PCAS-TC",0
5,"5074",668,540,537,5,3,"RECORTES CERO-GV-PCAS-TC",0
49,"49255",387,304,298,3,6,"RECORTES CERO-GV-PCAS-TC",0
40,"40126",67,44,42,0,2,"RECORTES CERO-GV-PCAS-TC",0
34,"34022",1022,813,798,7,15,"RECORTES CERO-GV-PCAS-TC",1
5,"5095",236,181,177,1,4,"RECORTES CERO-GV-PCAS-TC",1
45,"45066",7815,5540,5447,25,93,"RECORTES CERO-GV-PCAS-TC",9
49,"49166",1193,835,821,7,14,"RECORTES CERO-GV-PCAS-TC",1
42,"42216",26,20,20,0,0,"RECORTES CERO-GV-PCAS-TC",0
28,"28041",4805,3666,3634,38,32,"RECORTES CERO-GV-PCAS-TC",4
28,"28021",571,365,364,1,1,"RECORTES CERO-GV-PCAS-TC",0
45,"45078",1333,1084,1077,6,7,"RECORTES CERO-GV-PCAS-TC",0
5,"5052",85,70,69,0,1,"RECORTES CERO-GV-PCAS-TC",0
37,"37124",195,137,137,2,0,"RECORTES CERO-GV-PCAS-TC",0
28,"28126",50,36,36,0,0,"RECORTES CERO-GV-PCAS-TC",0
45,"45151",544,413,409,0,4,"RECORTES CERO-GV-PCAS-TC",0
13,"13081",584,412,405,0,7,"RECORTES CERO-GV-PCAS-TC",0
37,"37313",535,395,394,1,1,"RECORTES CERO-GV-PCAS-TC",0
19,"19152",540,377,374,2,3,"RECORTES CERO-GV-PCAS-TC",0
13,"13037",776,573,563,2,10,"RECORTES CERO-GV-PCAS-TC",0
37,"37156",4261,2928,2869,23,59,"RECORTES CERO-GV-PCAS-TC",0
42,"42051",15,9,9,0,0,"RECORTES CERO-GV-PCAS-TC",0
24,"24032",99,70,66,1,4,"RECORTES CERO-GV-PCAS-TC",0
16,"16228",173,147,145,2,2,"RECORTES CERO-GV-PCAS-TC",0
16,"16276",20,17,17,1,0,"RECORTES CERO-GV-PCAS-TC",0
45,"45152",545,402,393,1,9,"RECORTES CERO-GV-PCAS-TC",1
47,"47158",859,618,608,4,10,"RECORTES CERO-GV-PCAS-TC",1
37,"37314",81,65,65,0,0,"RECORTES CERO-GV-PCAS-TC",0
40,"40029",25,21,19,0,2,"RECORTES CERO-GV-PCAS-TC",0
47,"47159",825,672,661,0,11,"RECORTES CERO-GV-PCAS-TC",0
16,"16015",349,242,239,6,3,"RECORTES CERO-GV-PCAS-TC",1
5,"5033",169,135,134,0,1,"RECORTES CERO-GV-PCAS-TC",0
37,"37002",125,64,63,0,1,"RECORTES CERO-GV-PCAS-TC",0
2,"2074",5890,4054,4010,39,44,"RECORTES CERO-GV-PCAS-TC",4
49,"49132",310,220,215,2,5,"RECORTES CERO-GV-PCAS-TC",0
47,"47094",120,100,100,0,0,"RECORTES CERO-GV-PCAS-TC",1
9,"9130",64,39,39,2,0,"RECORTES CERO-GV-PCAS-TC",0
19,"19185",26,15,15,1,0,"RECORTES CERO-GV-PCAS-TC",0
9,"9013",42,32,32,0,0,"RECORTES CERO-GV-PCAS-TC",0
34,"34217",1269,999,983,14,16,"RECORTES CERO-GV-PCAS-TC",2
47,"47002",18,18,18,0,0,"RECORTES CERO-GV-PCAS-TC",0
5,"5019",44865,32917,32586,282,331,"RECORTES CERO-GV-PCAS-TC",42
19,"19204",150,105,104,3,1,"RECORTES CERO-GV-PCAS-TC",0
2,"2052",466,371,370,6,1,"RECORTES CERO-GV-PCAS-TC",0
37,"37069",981,669,657,3,12,"RECORTES CERO-GV-PCAS-TC",0
37,"37106",248,161,160,4,1,"RECORTES CERO-GV-PCAS-TC",0
47,"47106",44,30,30,0,0,"RECORTES CERO-GV-PCAS-TC",0
40,"40108",109,85,85,2,0,"RECORTES CERO-GV-PCAS-TC",0
34,"34902",123,91,91,0,0,"RECORTES CERO-GV-PCAS-TC",1
9,"9132",170,121,120,0,1,"RECORTES CERO-GV-PCAS-TC",1
49,"49133",287,206,203,1,3,"RECORTES CERO-GV-PCAS-TC",0
9,"9409",117,80,80,0,0,"RECORTES CERO-GV-PCAS-TC",0
37,"37378",92,54,54,0,0,"RECORTES CERO-GV-PCAS-TC",0
28,"28162",2784,2143,2131,20,12,"RECORTES CERO-GV-PCAS-TC",6
37,"37057",208,151,149,0,2,"RECORTES CERO-GV-PCAS-TC",0
2,"2042",810,581,577,1,4,"RECORTES CERO-GV-PCAS-TC",0
47,"47161",3970,3111,3089,24,22,"RECORTES CERO-GV-PCAS-TC",3
37,"37316",711,546,541,7,5,"RECORTES CERO-GV-PCAS-TC",1
49,"49208",352,223,214,1,9,"RECORTES CERO-GV-PCAS-TC",0
37,"37254",174,140,135,0,5,"RECORTES CERO-GV-PCAS-TC",0
24,"24107",206,147,147,1,0,"RECORTES CERO-GV-PCAS-TC",0
37,"37128",235,169,168,0,1,"RECORTES CERO-GV-PCAS-TC",0
16,"16146",85,49,49,0,0,"RECORTES CERO-GV-PCAS-TC",0
28,"28055",944,636,627,4,9,"RECORTES CERO-GV-PCAS-TC",0
9,"9190",86,58,54,2,4,"RECORTES CERO-GV-PCAS-TC",0
49,"49026",199,134,134,0,0,"RECORTES CERO-GV-PCAS-TC",0
47,"47005",506,358,348,3,10,"RECORTES CERO-GV-PCAS-TC",0
16,"16108",44,35,34,1,1,"RECORTES CERO-GV-PCAS-TC",0
34,"34168",45,39,39,1,0,"RECORTES CERO-GV-PCAS-TC",1
19,"19247",140,103,102,1,1,"RECORTES CERO-GV-PCAS-TC",0
16,"16032",284,220,220,1,0,"RECORTES CERO-GV-PCAS-TC",1
9,"9191",33,23,23,1,0,"RECORTES CERO-GV-PCAS-TC",0
47,"47097",305,239,237,0,2,"RECORTES CERO-GV-PCAS-TC",0
40,"40065",467,338,329,1,9,"RECORTES CERO-GV-PCAS-TC",1
5,"5057",2418,1785,1748,9,37,"RECORTES CERO-GV-PCAS-TC",2
34,"34073",180,123,120,3,3,"RECORTES CERO-GV-PCAS-TC",1
28,"28164",3230,2371,2345,28,26,"RECORTES CERO-GV-PCAS-TC",3
19,"19090",90,69,68,1,1,"RECORTES CERO-GV-PCAS-TC",0
34,"34029",665,524,518,1,6,"RECORTES CERO-GV-PCAS-TC",2
49,"49210",447,350,348,3,2,"RECORTES CERO-GV-PCAS-TC",0
9,"9413",405,267,263,0,4,"RECORTES CERO-GV-PCAS-TC",1
37,"37350",403,281,274,1,7,"RECORTES CERO-GV-PCAS-TC",0
16,"16070",29,27,27,0,0,"RECORTES CERO-GV-PCAS-TC",0
49,"49103",392,319,316,5,3,"RECORTES CERO-GV-PCAS-TC",0
40,"40068",22,21,21,0,0,"RECORTES CERO-GV-PCAS-TC",0
45,"45196",1382,1029,1005,7,24,"RECORTES CERO-GV-PCAS-TC",0
37,"37381",138,98,93,0,5,"RECORTES CERO-GV-PCAS-TC",0
24,"24183",748,464,460,9,4,"RECORTES CERO-GV-PCAS-TC",0
37,"37319",88,68,64,2,4,"RECORTES CERO-GV-PCAS-TC",0
13,"13090",1005,754,733,4,21,"RECORTES CERO-GV-PCAS-TC",0
9,"9358",247,165,161,3,4,"RECORTES CERO-GV-PCAS-TC",0
24,"24223",2533,1727,1705,40,22,"RECORTES CERO-GV-PCAS-TC",0
49,"49173",335,165,163,4,2,"RECORTES CERO-GV-PCAS-TC",0
24,"24039",1949,1420,1412,33,8,"RECORTES CERO-GV-PCAS-TC",1
37,"37257",51,36,36,1,0,"RECORTES CERO-GV-PCAS-TC",0
9,"9084",165,116,111,1,5,"RECORTES CERO-GV-PCAS-TC",1
24,"24077",212,166,162,0,4,"RECORTES CERO-GV-PCAS-TC",0
49,"49138",205,141,140,2,1,"RECORTES CERO-GV-PCAS-TC",0
9,"9137",187,129,127,0,2,"RECORTES CERO-GV-PCAS-TC",0
45,"45012",623,482,472,0,10,"RECORTES CERO-GV-PCAS-TC",0
19,"19221",31,22,22,1,0,"RECORTES CERO-GV-PCAS-TC",0
9,"9037",105,94,93,0,1,"RECORTES CERO-GV-PCAS-TC",2
13,"13092",1703,1327,1307,4,20,"RECORTES CERO-GV-PCAS-TC",0
47,"47007",4051,2987,2954,27,33,"RECORTES CERO-GV-PCAS-TC",8
40,"40198",24,20,19,0,1,"RECORTES CERO-GV-PCAS-TC",0
19,"19314",44,33,33,0,0,"RECORTES CERO-GV-PCAS-TC",0
49,"49105",135,94,94,2,0,"RECORTES CERO-GV-PCAS-TC",0
28,"28166",357,281,276,1,5,"RECORTES CERO-GV-PCAS-TC",0
49,"49175",204,136,135,3,1,"RECORTES CERO-GV-PCAS-TC",0
34,"34124",60,45,45,0,0,"RECORTES CERO-GV-PCAS-TC",0
9,"9085",481,349,342,2,7,"RECORTES CERO-GV-PCAS-TC",1
24,"24152",433,269,267,4,2,"RECORTES CERO-GV-PCAS-TC",0
19,"19222",95,70,70,2,0,"RECORTES CERO-GV-PCAS-TC",0
34,"34125",105,80,80,2,0,"RECORTES CERO-GV-PCAS-TC",1
49,"49139",149,112,112,0,0,"RECORTES CERO-GV-PCAS-TC",0
2,"2081",18287,12910,12675,130,235,"RECORTES CERO-GV-PCAS-TC",8
49,"49008",423,263,259,1,4,"RECORTES CERO-GV-PCAS-TC",0
24,"24101",370,219,213,4,6,"RECORTES CERO-GV-PCAS-TC",0
34,"34126",248,177,176,3,1,"RECORTES CERO-GV-PCAS-TC",0
37,"37279",713,488,480,4,8,"RECORTES CERO-GV-PCAS-TC",0
19,"19242",74,53,53,1,0,"RECORTES CERO-GV-PCAS-TC",1
45,"45077",546,413,409,0,4,"RECORTES CERO-GV-PCAS-TC",1
19,"19294",26,18,18,0,0,"RECORTES CERO-GV-PCAS-TC",0
19,"19252",56,44,44,0,0,"RECORTES CERO-GV-PCAS-TC",0
40,"40037",30,17,17,0,0,"RECORTES CERO-GV-PCAS-TC",0
9,"9347",140,111,107,1,4,"RECORTES CERO-GV-PCAS-TC",0
42,"42092",61,40,39,0,1,"RECORTES CERO-GV-PCAS-TC",1
16,"16152",32,26,26,3,0,"RECORTES CERO-GV-PCAS-TC",0
34,"34110",75,64,64,0,0,"RECORTES CERO-GV-PCAS-TC",0
37,"37312",244,191,189,1,2,"RECORTES CERO-GV-PCAS-TC",0
40,"40234",375,278,269,3,9,"RECORTES CERO-GV-PCAS-TC",0
16,"16153",924,751,741,4,10,"RECORTES CERO-GV-PCAS-TC",0
47,"47167",245,198,198,1,0,"RECORTES CERO-GV-PCAS-TC",1
42,"42201",23,21,21,0,0,"RECORTES CERO-GV-PCAS-TC",0
2,"2050",85,66,66,1,0,"RECORTES CERO-GV-PCAS-TC",0
49,"49108",446,312,309,2,3,"RECORTES CERO-GV-PCAS-TC",0
34,"34081",60,45,44,0,1,"RECORTES CERO-GV-PCAS-TC",0
37,"37065",276,167,167,2,0,"RECORTES CERO-GV-PCAS-TC",0
9,"9090",49,41,39,2,2,"RECORTES CERO-GV-PCAS-TC",0
34,"34177",178,149,149,1,0,"RECORTES CERO-GV-PCAS-TC",0
40,"40138",2102,1585,1565,13,20,"RECORTES CERO-GV-PCAS-TC",3
49,"49221",233,122,120,2,2,"RECORTES CERO-GV-PCAS-TC",0
28,"28137",1770,1300,1289,6,11,"RECORTES CERO-GV-PCAS-TC",1
34,"34230",16,11,11,0,0,"RECORTES CERO-GV-PCAS-TC",0
45,"45054",3798,2612,2587,10,25,"RECORTES CERO-GV-PCAS-TC",2
47,"47041",147,105,103,3,2,"RECORTES CERO-GV-PCAS-TC",0
5,"5129",111,70,69,0,1,"RECORTES CERO-GV-PCAS-TC",0
9,"9144",44,31,31,0,0,"RECORTES CERO-GV-PCAS-TC",0
24,"24044",150,91,89,2,2,"RECORTES CERO-GV-PCAS-TC",0
5,"5193",179,140,139,2,1,"RECORTES CERO-GV-PCAS-TC",0
2,"2040",548,476,474,1,2,"RECORTES CERO-GV-PCAS-TC",0
40,"40181",4182,3102,3038,35,64,"RECORTES CERO-GV-PCAS-TC",5
37,"37303",179,118,117,1,1,"RECORTES CERO-GV-PCAS-TC",0
28,"28107",442,316,310,5,6,"RECORTES CERO-GV-PCAS-TC",0
28,"28108",3736,2681,2652,21,29,"RECORTES CERO-GV-PCAS-TC",1
9,"9256",330,221,219,0,2,"RECORTES CERO-GV-PCAS-TC",2
49,"49257",305,186,184,0,2,"RECORTES CERO-GV-PCAS-TC",0
2,"2019",2352,1806,1766,9,40,"RECORTES CERO-GV-PCAS-TC",1
5,"5086",76,58,58,1,0,"RECORTES CERO-GV-PCAS-TC",0
13,"13055",616,445,444,3,1,"RECORTES CERO-GV-PCAS-TC",1
19,"19287",134,100,98,2,2,"RECORTES CERO-GV-PCAS-TC",0
42,"42065",23,18,18,1,0,"RECORTES CERO-GV-PCAS-TC",0
34,"34179",25,18,16,0,2,"RECORTES CERO-GV-PCAS-TC",0
16,"16094",121,86,84,0,2,"RECORTES CERO-GV-PCAS-TC",0
28,"28085",4194,3126,3091,24,35,"RECORTES CERO-GV-PCAS-TC",1
16,"16213",34,27,26,0,1,"RECORTES CERO-GV-PCAS-TC",0
47,"47150",253,193,187,3,6,"RECORTES CERO-GV-PCAS-TC",0
5,"5077",154,113,110,0,3,"RECORTES CERO-GV-PCAS-TC",0
13,"13086",158,122,120,0,2,"RECORTES CERO-GV-PCAS-TC",1
37,"37294",11750,8395,8280,88,115,"RECORTES CERO-GV-PCAS-TC",118
16,"16248",862,710,700,6,10,"RECORTES CERO-GV-PCAS-TC",2
19,"19130",61556,45926,45388,408,538,"RECORTES CERO-GV-PCAS-TC",137
5,"5034",15,14,13,0,1,"RECORTES CERO-GV-PCAS-TC",0
45,"45167",1370,1078,1065,1,13,"RECORTES CERO-GV-PCAS-TC",1
5,"5066",435,344,341,2,3,"RECORTES CERO-GV-PCAS-TC",0
42,"42028",75,57,56,0,1,"RECORTES CERO-GV-PCAS-TC",0
42,"42116",37,30,29,2,1,"RECORTES CERO-GV-PCAS-TC",0
16,"16198",1281,938,928,6,10,"RECORTES CERO-GV-PCAS-TC",0
49,"49003",860,534,530,5,4,"RECORTES CERO-GV-PCAS-TC",1
45,"45131",259,219,216,1,3,"RECORTES CERO-GV-PCAS-TC",0
49,"49181",333,197,195,2,2,"RECORTES CERO-GV-PCAS-TC",0
49,"49183",90,67,65,2,2,"RECORTES CERO-GV-PCAS-TC",0
47,"47203",54,40,40,0,0,"RECORTES CERO-GV-PCAS-TC",0
16,"16007",1153,857,847,3,10,"RECORTES CERO-GV-PCAS-TC",0
19,"19061",56,42,41,0,1,"RECORTES CERO-GV-PCAS-TC",0
5,"5101",266,206,205,1,1,"RECORTES CERO-GV-PCAS-TC",1
16,"16249",1938,1422,1406,6,16,"RECORTES CERO-GV-PCAS-TC",0
42,"42163",50,27,27,1,0,"RECORTES CERO-GV-PCAS-TC",0
49,"49261",1504,1044,1026,7,18,"RECORTES CERO-GV-PCAS-TC",4
34,"34045",72,62,62,0,0,"RECORTES CERO-GV-PCAS-TC",0
42,"42117",129,98,95,1,3,"RECORTES CERO-GV-PCAS-TC",1
5,"5067",73,56,54,0,2,"RECORTES CERO-GV-PCAS-TC",1
34,"34042",294,224,221,1,3,"RECORTES CERO-GV-PCAS-TC",0
49,"49004",110,74,71,3,3,"RECORTES CERO-GV-PCAS-TC",0
28,"28111",629,479,475,2,4,"RECORTES CERO-GV-PCAS-TC",0
34,"34087",125,99,99,2,0,"RECORTES CERO-GV-PCAS-TC",0
45,"45096",987,748,725,9,23,"RECORTES CERO-GV-PCAS-TC",1
9,"9154",123,90,90,7,0,"RECORTES CERO-GV-PCAS-TC",0
45,"45023",2300,1700,1685,19,15,"RECORTES CERO-GV-PCAS-TC",3
42,"42165",414,246,237,4,9,"RECORTES CERO-GV-PCAS-TC",0
5,"5231",150,123,122,2,1,"RECORTES CERO-GV-PCAS-TC",0
49,"49005",125,80,80,1,0,"RECORTES CERO-GV-PCAS-TC",0
47,"47046",124,99,99,1,0,"RECORTES CERO-GV-PCAS-TC",0
49,"49149",368,270,266,1,4,"RECORTES CERO-GV-PCAS-TC",0
47,"47205",355,248,244,2,4,"RECORTES CERO-GV-PCAS-TC",0
45,"45133",2798,1957,1922,11,35,"RECORTES CERO-GV-PCAS-TC",1
24,"24161",294,208,204,3,4,"RECORTES CERO-GV-PCAS-TC",0
47,"47173",879,627,622,9,5,"RECORTES CERO-GV-PCAS-TC",3
47,"47206",79,66,66,0,0,"RECORTES CERO-GV-PCAS-TC",0
9,"9429",53,34,34,1,0,"RECORTES CERO-GV-PCAS-TC",0
9,"9903",3112,2087,2058,24,29,"RECORTES CERO-GV-PCAS-TC",0
24,"24122",1292,818,810,7,8,"RECORTES CERO-GV-PCAS-TC",0
19,"19291",1143,803,794,2,9,"RECORTES CERO-GV-PCAS-TC",0
19,"19259",28,22,22,0,0,"RECORTES CERO-GV-PCAS-TC",0
9,"9377",626,468,460,6,8,"RECORTES CERO-GV-PCAS-TC",0
16,"16160",58,41,41,1,0,"RECORTES CERO-GV-PCAS-TC",0
9,"9052",28,21,20,0,1,"RECORTES CERO-GV-PCAS-TC",0
49,"49116",356,239,234,4,5,"RECORTES CERO-GV-PCAS-TC",0
9,"9003",182,134,132,1,2,"RECORTES CERO-GV-PCAS-TC",1
42,"42120",131,87,86,1,1,"RECORTES CERO-GV-PCAS-TC",0
16,"16253",308,230,228,2,2,"RECORTES CERO-GV-PCAS-TC",0
47,"47207",256,198,195,3,3,"RECORTES CERO-GV-PCAS-TC",1
16,"16087",238,184,184,6,0,"RECORTES CERO-GV-PCAS-TC",0
19,"19034",25,22,21,0,1,"RECORTES CERO-GV-PCAS-TC",0
9,"9266",97,71,68,1,3,"RECORTES CERO-GV-PCAS-TC",0
24,"24053",398,250,248,1,2,"RECORTES CERO-GV-PCAS-TC",1
28,"28146",1806,1232,1218,3,14,"RECORTES CERO-GV-PCAS-TC",1
9,"9381",28,19,19,0,0,"RECORTES CERO-GV-PCAS-TC",0
24,"24017",532,375,374,1,1,"RECORTES CERO-GV-PCAS-TC",0
34,"34092",257,189,189,1,0,"RECORTES CERO-GV-PCAS-TC",1
5,"5136",83,55,55,0,0,"RECORTES CERO-GV-PCAS-TC",0
28,"28114",141,97,97,0,0,"RECORTES CERO-GV-PCAS-TC",1
16,"16205",106,73,73,1,0,"RECORTES CERO-GV-PCAS-TC",0
37,"37300",540,355,352,7,3,"RECORTES CERO-GV-PCAS-TC",0
19,"19067",68,46,44,0,2,"RECORTES CERO-GV-PCAS-TC",0
45,"45173",9756,6811,6720,49,91,"RECORTES CERO-GV-PCAS-TC",8
34,"34241",17,17,16,3,1,"RECORTES CERO-GV-PCAS-TC",0
34,"34062",148,94,93,0,1,"RECORTES CERO-GV-PCAS-TC",1
45,"45014",4039,2606,2552,35,54,"RECORTES CERO-GV-PCAS-TC",5
34,"34158",283,170,167,0,3,"RECORTES CERO-GV-PCAS-TC",0
47,"47208",53,35,35,1,0,"RECORTES CERO-GV-PCAS-TC",1
24,"24090",323,200,200,2,0,"RECORTES CERO-GV-PCAS-TC",0
16,"16206",184,126,125,4,1,"RECORTES CERO-GV-PCAS-TC",0
37,"37249",37,28,28,0,0,"RECORTES CERO-GV-PCAS-TC",0
13,"13096",7526,5212,5131,25,81,"RECORTES CERO-GV-PCAS-TC",6
37,"37364",760,502,500,0,2,"RECORTES CERO-GV-PCAS-TC",0
45,"45199",3188,2077,2055,20,22,"RECORTES CERO-GV-PCAS-TC",6
37,"37165",31,22,22,0,0,"RECORTES CERO-GV-PCAS-TC",0
9,"9058",394,286,284,6,2,"RECORTES CERO-GV-PCAS-TC",0
9,"9088",63,31,30,0,1,"RECORTES CERO-GV-PCAS-TC",0
24,"24154",952,625,618,5,7,"RECORTES CERO-GV-PCAS-TC",0
28,"28071",63,46,45,0,1,"RECORTES CERO-GV-PCAS-TC",0
24,"24092",731,506,504,1,2,"RECORTES CERO-GV-PCAS-TC",1
19,"19233",79,65,65,2,0,"RECORTES CERO-GV-PCAS-TC",0
28,"28082",6110,4622,4581,41,41,"RECORTES CERO-GV-PCAS-TC",14
2,"2060",1268,953,939,7,14,"RECORTES CERO-GV-PCAS-TC",0
19,"19173",47,40,40,0,0,"RECORTES CERO-GV-PCAS-TC",0
37,"37240",928,648,637,2,11,"RECORTES CERO-GV-PCAS-TC",1
19,"19330",69,62,62,0,0,"RECORTES CERO-GV-PCAS-TC",0
47,"47115",276,212,211,1,1,"RECORTES CERO-GV-PCAS-TC",0
49,"49267",96,67,63,2,4,"RECORTES CERO-GV-PCAS-TC",0
19,"19071",8277,5838,5763,53,75,"RECORTES CERO-GV-PCAS-TC",16
9,"9011",70,42,40,0,2,"RECORTES CERO-GV-PCAS-TC",1
9,"9387",107,89,88,0,1,"RECORTES CERO-GV-PCAS-TC",0
34,"34196",87,67,67,3,0,"RECORTES CERO-GV-PCAS-TC",0
49,"49190",50,42,42,3,0,"RECORTES CERO-GV-PCAS-TC",0
9,"9272",251,166,166,1,0,"RECORTES CERO-GV-PCAS-TC",2
5,"5005",165,127,119,0,8,"RECORTES CERO-GV-PCAS-TC",0
5,"5042",141,111,111,0,0,"RECORTES CERO-GV-PCAS-TC",0
16,"16051",128,96,96,3,0,"RECORTES CERO-GV-PCAS-TC",0
34,"34146",53,43,43,0,0,"RECORTES CERO-GV-PCAS-TC",0
5,"5173",60,54,54,0,0,"RECORTES CERO-GV-PCAS-TC",0
42,"42052",16,14,14,0,0,"RECORTES CERO-GV-PCAS-TC",0
34,"34068",29,25,24,0,1,"RECORTES CERO-GV-PCAS-TC",0
45,"45104",419,328,324,1,4,"RECORTES CERO-GV-PCAS-TC",0
9,"9113",453,321,315,8,6,"RECORTES CERO-GV-PCAS-TC",1
16,"16093",54,45,45,0,0,"RECORTES CERO-GV-PCAS-TC",0
47,"47149",46,33,32,1,1,"RECORTES CERO-GV-PCAS-TC",0
9,"9273",48,40,39,0,1,"RECORTES CERO-GV-PCAS-TC",0
34,"34006",79,73,69,2,4,"RECORTES CERO-GV-PCAS-TC",2
19,"19143",1781,1278,1266,18,12,"RECORTES CERO-GV-PCAS-TC",0
16,"16212",233,186,184,0,2,"RECORTES CERO-GV-PCAS-TC",0
37,"37116",70,50,50,0,0,"RECORTES CERO-GV-PCAS-TC",0
9,"9221",498,380,377,8,3,"RECORTES CERO-GV-PCAS-TC",1
24,"24157",2542,1846,1809,16,37,"RECORTES CERO-GV-PCAS-TC",2
40,"40203",987,753,740,13,13,"RECORTES CERO-GV-PCAS-TC",0
16,"16909",655,493,488,4,5,"RECORTES CERO-GV-PCAS-TC",3
47,"47223",148,105,102,4,3,"RECORTES CERO-GV-PCAS-TC",0
16,"16236",857,615,608,1,7,"RECORTES CERO-GV-PCAS-TC",3
2,"2086",2389,1567,1554,10,13,"RECORTES CERO-GV-PCAS-TC",3
16,"16265",22,18,18,0,0,"RECORTES CERO-GV-PCAS-TC",0
45,"45142",7792,5717,5624,62,93,"RECORTES CERO-GV-PCAS-TC",7
45,"45069",1820,1370,1355,1,15,"RECORTES CERO-GV-PCAS-TC",3
45,"45180",2850,2044,2023,15,21,"RECORTES CERO-GV-PCAS-TC",4
40,"40120",195,169,163,0,6,"RECORTES CERO-GV-PCAS-TC",0
2,"2064",371,288,283,2,5,"RECORTES CERO-GV-PCAS-TC",1
9,"9441",94,76,76,0,0,"RECORTES CERO-GV-PCAS-TC",0
42,"42001",250,172,172,3,0,"RECORTES CERO-GV-PCAS-TC",0
49,"49235",415,300,290,4,10,"RECORTES CERO-GV-PCAS-TC",0
16,"16095",82,70,70,1,0,"RECORTES CERO-GV-PCAS-TC",0
19,"19041",163,118,117,1,1,"RECORTES CERO-GV-PCAS-TC",0
9,"9115",90,65,63,3,2,"RECORTES CERO-GV-PCAS-TC",2
49,"49194",331,198,197,0,1,"RECORTES CERO-GV-PCAS-TC",0
2,"2031",535,406,401,4,5,"RECORTES CERO-GV-PCAS-TC",0
13,"13072",727,518,510,3,8,"RECORTES CERO-GV-PCAS-TC",2
37,"37180",68,45,44,1,1,"RECORTES CERO-GV-PCAS-TC",0
47,"47086",3818,2835,2784,36,51,"RECORTES CERO-GV-PCAS-TC",0
42,"42131",50,39,39,2,0,"RECORTES CERO-GV-PCAS-TC",1
28,"28025",405,294,291,5,3,"RECORTES CERO-GV-PCAS-TC",0
40,"40152",732,575,565,10,10,"RECORTES CERO-GV-PCAS-TC",2
19,"19042",22,18,17,0,1,"RECORTES CERO-GV-PCAS-TC",0
37,"37275",98,67,67,0,0,"RECORTES CERO-GV-PCAS-TC",0
47,"47182",1328,940,934,8,6,"RECORTES CERO-GV-PCAS-TC",0
19,"19146",47,35,35,0,0,"RECORTES CERO-GV-PCAS-TC",0
49,"49237",142,78,78,0,0,"RECORTES CERO-GV-PCAS-TC",0
37,"37119",99,78,78,1,0,"RECORTES CERO-GV-PCAS-TC",0
34,"34904",300,188,186,0,2,"RECORTES CERO-GV-PCAS-TC",0
37,"37083",181,155,153,1,2,"RECORTES CERO-GV-PCAS-TC",0
37,"37181",265,158,158,0,0,"RECORTES CERO-GV-PCAS-TC",0
16,"16269",378,287,285,2,2,"RECORTES CERO-GV-PCAS-TC",0
37,"37213",83,64,64,0,0,"RECORTES CERO-GV-PCAS-TC",0
5,"5209",74,58,58,1,0,"RECORTES CERO-GV-PCAS-TC",0
9,"9227",112,89,89,1,0,"RECORTES CERO-GV-PCAS-TC",0
5,"5210",81,56,56,0,0,"RECORTES CERO-GV-PCAS-TC",0
28,"28154",5570,3999,3961,29,38,"RECORTES CERO-GV-PCAS-TC",9
40,"40056",31,21,20,0,1,"RECORTES CERO-GV-PCAS-TC",0
19,"19210",18,16,16,0,0,"RECORTES CERO-GV-PCAS-TC",0
34,"34104",231,164,162,2,2,"RECORTES CERO-GV-PCAS-TC",2
19,"19044",275,186,182,0,4,"RECORTES CERO-GV-PCAS-TC",1
24,"24026",1085,724,712,14,12,"RECORTES CERO-GV-PCAS-TC",0
47,"47027",2799,2059,2025,12,34,"RECORTES CERO-GV-PCAS-TC",5
16,"16135",115,76,76,0,0,"RECORTES CERO-GV-PCAS-TC",0
9,"9339",128,106,105,0,1,"RECORTES CERO-GV-PCAS-TC",0
34,"34015",37,24,24,0,0,"RECORTES CERO-GV-PCAS-TC",0
5,"5048",107,89,88,2,1,"RECORTES CERO-GV-PCAS-TC",0
9,"9020",233,170,166,3,4,"RECORTES CERO-GV-PCAS-TC",1
24,"24136",495,347,344,1,3,"RECORTES CERO-GV-PCAS-TC",0
37,"37214",120,70,68,2,2,"RECORTES CERO-GV-PCAS-TC",1
34,"34017",889,676,665,7,11,"RECORTES CERO-GV-PCAS-TC",1
49,"49053",919,676,661,8,15,"RECORTES CERO-GV-PCAS-TC",0
28,"28048",514,386,384,4,2,"RECORTES CERO-GV-PCAS-TC",2
49,"49163",203,139,138,3,1,"RECORTES CERO-GV-PCAS-TC",0
13,"13077",3383,2050,1997,20,53,"RECORTES CERO-GV-PCAS-TC",3
24,"24212",983,693,684,10,9,"RECORTES CERO-GV-PCAS-TC",1
40,"40219",573,382,366,5,16,"RECORTES CERO-GV-PCAS-TC",2
5,"5243",80,57,56,1,1,"RECORTES CERO-GV-PCAS-TC",0
24,"24064",1501,1030,1012,2,18,"RECORTES CERO-GV-PCAS-TC",0
37,"37278",793,570,567,6,3,"RECORTES CERO-GV-PCAS-TC",0
19,"19150",116,89,89,0,0,"RECORTES CERO-GV-PCAS-TC",0
37,"37087",911,675,665,5,10,"RECORTES CERO-GV-PCAS-TC",0
5,"5212",197,117,117,0,0,"RECORTES CERO-GV-PCAS-TC",1
9,"9447",43,37,36,0,1,"RECORTES CERO-GV-PCAS-TC",0
45,"45112",1844,1121,1086,8,35,"RECORTES CERO-GV-PCAS-TC",0
5,"5015",68,45,44,1,1,"RECORTES CERO-GV-PCAS-TC",0
16,"16024",121,85,84,0,1,"RECORTES CERO-GV-PCAS-TC",0
9,"9124",1405,946,928,6,18,"RECORTES CERO-GV-PCAS-TC",2
45,"45002",2619,1676,1663,14,13,"RECORTES CERO-GV-PCAS-TC",1
2,"2070",373,306,301,6,5,"RECORTES CERO-GV-PCAS-TC",0
40,"40166",251,201,201,0,0,"RECORTES CERO-GV-PCAS-TC",0
45,"45063",375,268,264,0,4,"RECORTES CERO-GV-PCAS-TC",0
13,"13049",742,509,500,4,9,"RECORTES CERO-GV-PCAS-TC",2
40,"40091",109,87,85,0,2,"RECORTES CERO-GV-PCAS-TC",0
45,"45003",554,398,393,2,5,"RECORTES CERO-GV-PCAS-TC",0
13,"13034",58768,42473,42028,359,445,"RECORTES CERO-GV-PCAS-TC",99
40,"40080",51,31,31,0,0,"RECORTES CERO-GV-PCAS-TC",0
49,"49107",115,70,70,0,0,"RECORTES CERO-GV-PCAS-TC",0
5,"5084",66,44,44,0,0,"RECORTES CERO-GV-PCAS-TC",0
19,"19272",66,55,55,2,0,"RECORTES CERO-GV-PCAS-TC",0
19,"19108",95,78,78,0,0,"RECORTES CERO-GV-PCAS-TC",0
37,"37089",60,44,43,0,1,"RECORTES CERO-GV-PCAS-TC",0
19,"19214",74,51,51,0,0,"RECORTES CERO-GV-PCAS-TC",0
19,"19107",306,245,244,0,1,"RECORTES CERO-GV-PCAS-TC",0
42,"42011",16,11,11,0,0,"RECORTES CERO-GV-PCAS-TC",0
24,"24176",302,232,226,0,6,"RECORTES CERO-GV-PCAS-TC",0
5,"5017",84,70,67,2,3,"RECORTES CERO-GV-PCAS-TC",0
24,"24142",24715,16839,16616,159,223,"RECORTES CERO-GV-PCAS-TC",17
37,"37020",431,320,314,3,6,"RECORTES CERO-GV-PCAS-TC",0
34,"34159",375,221,214,4,7,"RECORTES CERO-GV-PCAS-TC",1
2,"2005",554,426,419,8,7,"RECORTES CERO-GV-PCAS-TC",0
47,"47220",151,106,105,1,1,"RECORTES CERO-GV-PCAS-TC",0
2,"2083",209,181,181,0,0,"RECORTES CERO-GV-PCAS-TC",0
45,"45041",3967,2723,2689,18,34,"RECORTES CERO-GV-PCAS-TC",0
9,"9026",377,288,288,1,0,"RECORTES CERO-GV-PCAS-TC",1
9,"9348",131,103,101,0,2,"RECORTES CERO-GV-PCAS-TC",0
37,"37281",39,28,27,0,1,"RECORTES CERO-GV-PCAS-TC",0
16,"16181",54,40,40,0,0,"RECORTES CERO-GV-PCAS-TC",0
47,"47001",52,43,42,1,1,"RECORTES CERO-GV-PCAS-TC",0
16,"16142",119,90,90,0,0,"RECORTES CERO-GV-PCAS-TC",1
19,"19274",953,693,676,9,17,"RECORTES CERO-GV-PCAS-TC",1
24,"24143",497,344,343,3,1,"RECORTES CERO-GV-PCAS-TC",0
19,"19118",11,10,9,0,1,"RECORTES CERO-GV-PCAS-TC",1
19,"19184",59,47,47,0,0,"RECORTES CERO-GV-PCAS-TC",0
40,"40149",479,345,338,3,7,"RECORTES CERO-GV-PCAS-TC",4
49,"49034",408,282,281,2,1,"RECORTES CERO-GV-PCAS-TC",0
40,"40093",74,62,62,1,0,"RECORTES CERO-GV-PCAS-TC",0
5,"5153",86,58,56,3,2,"RECORTES CERO-GV-PCAS-TC",0
5,"5247",231,132,131,1,1,"RECORTES CERO-GV-PCAS-TC",0
34,"34024",25,14,14,0,0,"RECORTES CERO-GV-PCAS-TC",0
9,"9027",47,38,34,1,4,"RECORTES CERO-GV-PCAS-TC",0
9,"9029",151,111,108,2,3,"RECORTES CERO-GV-PCAS-TC",0
2,"2007",1017,757,746,5,11,"RECORTES CERO-GV-PCAS-TC",0
9,"9295",52,36,35,1,1,"RECORTES CERO-GV-PCAS-TC",0
9,"9455",45,34,33,0,1,"RECORTES CERO-GV-PCAS-TC",0
49,"49059",84,61,58,0,3,"RECORTES CERO-GV-PCAS-TC",0
37,"37080",221,164,163,1,1,"RECORTES CERO-GV-PCAS-TC",0
2,"2030",2949,2158,2122,16,36,"RECORTES CERO-GV-PCAS-TC",0
37,"37044",431,309,308,3,1,"RECORTES CERO-GV-PCAS-TC",0
24,"24047",708,462,459,1,3,"RECORTES CERO-GV-PCAS-TC",0
28,"28004",6618,4502,4457,28,45,"RECORTES CERO-GV-PCAS-TC",3
34,"34100",132,96,95,1,1,"RECORTES CERO-GV-PCAS-TC",0
47,"47190",95,75,75,1,0,"RECORTES CERO-GV-PCAS-TC",0
45,"45045",1338,926,915,9,11,"RECORTES CERO-GV-PCAS-TC",1
16,"16030",24,18,18,1,0,"RECORTES CERO-GV-PCAS-TC",0
37,"37189",114,75,74,1,1,"RECORTES CERO-GV-PCAS-TC",0
9,"9030",116,81,81,1,0,"RECORTES CERO-GV-PCAS-TC",1
9,"9298",72,52,52,1,0,"RECORTES CERO-GV-PCAS-TC",0
47,"47096",127,94,93,1,1,"RECORTES CERO-GV-PCAS-TC",0
16,"16106",2701,2029,2001,6,28,"RECORTES CERO-GV-PCAS-TC",2
28,"28096",20022,14440,14238,115,202,"RECORTES CERO-GV-PCAS-TC",8
47,"47004",1135,878,872,5,6,"RECORTES CERO-GV-PCAS-TC",0
37,"37190",189,141,139,1,2,"RECORTES CERO-GV-PCAS-TC",0
5,"5251",56,35,34,0,1,"RECORTES CERO-GV-PCAS-TC",0
37,"37170",1361,909,884,9,25,"RECORTES CERO-GV-PCAS-TC",0
5,"5155",46,33,31,1,2,"RECORTES CERO-GV-PCAS-TC",0
37,"37328",159,112,110,1,2,"RECORTES CERO-GV-PCAS-TC",0
49,"49062",103,58,58,0,0,"RECORTES CERO-GV-PCAS-TC",0
2,"2009",19495,13877,13663,134,214,"RECORTES CERO-GV-PCAS-TC",13
37,"37349",100,61,58,0,3,"RECORTES CERO-GV-PCAS-TC",0
49,"49037",174,139,136,1,3,"RECORTES CERO-GV-PCAS-TC",0
5,"5219",33,23,23,0,0,"RECORTES CERO-GV-PCAS-TC",0
13,"13089",1609,1248,1228,10,20,"RECORTES CERO-GV-PCAS-TC",0
37,"37129",248,181,181,1,0,"RECORTES CERO-GV-PCAS-TC",0
49,"49248",171,128,128,1,0,"RECORTES CERO-GV-PCAS-TC",0
47,"47192",89,78,76,3,2,"RECORTES CERO-GV-PCAS-TC",0
49,"49063",303,228,227,3,1,"RECORTES CERO-GV-PCAS-TC",0
24,"24182",410,273,270,7,3,"RECORTES CERO-GV-PCAS-TC",0
49,"49209",451,274,269,7,5,"RECORTES CERO-GV-PCAS-TC",0
9,"9463",246,174,174,4,0,"RECORTES CERO-GV-PCAS-TC",1
2,"2044",1040,665,656,5,9,"RECORTES CERO-GV-PCAS-TC",0
19,"19248",73,54,54,0,0,"RECORTES CERO-GV-PCAS-TC",0
34,"34121",187,150,150,3,0,"RECORTES CERO-GV-PCAS-TC",0
37,"37286",204,140,137,2,3,"RECORTES CERO-GV-PCAS-TC",0
40,"40132",45,26,25,0,1,"RECORTES CERO-GV-PCAS-TC",1
45,"45085",1535,1061,1052,11,9,"RECORTES CERO-GV-PCAS-TC",2
49,"49102",182,130,130,2,0,"RECORTES CERO-GV-PCAS-TC",0
9,"9082",36,32,32,0,0,"RECORTES CERO-GV-PCAS-TC",0
16,"16190",4930,3747,3688,26,59,"RECORTES CERO-GV-PCAS-TC",0
37,"37193",362,253,252,4,1,"RECORTES CERO-GV-PCAS-TC",0
24,"24150",226,163,162,0,1,"RECORTES CERO-GV-PCAS-TC",0
16,"16110",90,70,70,1,0,"RECORTES CERO-GV-PCAS-TC",0
45,"45011",279,235,233,4,2,"RECORTES CERO-GV-PCAS-TC",0
19,"19189",114,87,84,0,3,"RECORTES CERO-GV-PCAS-TC",0
34,"34223",203,147,143,1,4,"RECORTES CERO-GV-PCAS-TC",0
37,"37225",97,78,74,0,4,"RECORTES CERO-GV-PCAS-TC",0
5,"5254",184,149,147,1,2,"RECORTES CERO-GV-PCAS-TC",0
49,"49065",1048,747,725,6,22,"RECORTES CERO-GV-PCAS-TC",0
40,"40111",50,39,39,0,0,"RECORTES CERO-GV-PCAS-TC",1
49,"49174",127,86,85,1,1,"RECORTES CERO-GV-PCAS-TC",0
34,"34076",532,443,438,1,5,"RECORTES CERO-GV-PCAS-TC",0
47,"47133",2776,2096,2073,28,23,"RECORTES CERO-GV-PCAS-TC",3
47,"47227",53,36,35,0,1,"RECORTES CERO-GV-PCAS-TC",0
28,"28133",6146,4245,4180,25,65,"RECORTES CERO-GV-PCAS-TC",5
9,"9360",26,19,19,0,0,"RECORTES CERO-GV-PCAS-TC",0
49,"49029",609,435,419,6,16,"RECORTES CERO-GV-PCAS-TC",1
9,"9248",80,62,61,1,1,"RECORTES CERO-GV-PCAS-TC",0
28,"28101",226,174,172,1,2,"RECORTES CERO-GV-PCAS-TC",1
40,"40069",68,59,59,0,0,"RECORTES CERO-GV-PCAS-TC",0
2,"2047",110,83,81,0,2,"RECORTES CERO-GV-PCAS-TC",0
19,"19250",16,12,12,0,0,"RECORTES CERO-GV-PCAS-TC",0
47,"47008",22,13,13,0,0,"RECORTES CERO-GV-PCAS-TC",0
45,"45124",2080,1628,1595,15,33,"RECORTES CERO-GV-PCAS-TC",0
9,"9361",103,64,64,1,0,"RECORTES CERO-GV-PCAS-TC",0
37,"37028",131,96,93,2,3,"RECORTES CERO-GV-PCAS-TC",0
24,"24078",324,228,225,0,3,"RECORTES CERO-GV-PCAS-TC",0
49,"49216",147,115,109,0,6,"RECORTES CERO-GV-PCAS-TC",0
16,"16112",1466,972,957,12,15,"RECORTES CERO-GV-PCAS-TC",0
5,"5126",60,47,45,0,2,"RECORTES CERO-GV-PCAS-TC",0
34,"34227",70,56,52,1,4,"RECORTES CERO-GV-PCAS-TC",0
49,"49187",1197,839,819,12,20,"RECORTES CERO-GV-PCAS-TC",1
2,"2069",11401,8055,7975,30,80,"RECORTES CERO-GV-PCAS-TC",7
2,"2037",22963,14737,14588,68,149,"RECORTES CERO-GV-PCAS-TC",23
19,"19317",124,83,82,0,1,"RECORTES CERO-GV-PCAS-TC",0
40,"40071",39,32,26,0,6,"RECORTES CERO-GV-PCAS-TC",1
19,"19022",592,423,420,6,3,"RECORTES CERO-GV-PCAS-TC",0
24,"24030",4158,2746,2696,18,50,"RECORTES CERO-GV-PCAS-TC",2
28,"28010",10649,8167,8098,76,69,"RECORTES CERO-GV-PCAS-TC",6
19,"19318",26,18,18,0,0,"RECORTES CERO-GV-PCAS-TC",0
34,"34228",77,59,59,1,0,"RECORTES CERO-GV-PCAS-TC",0
47,"47060",224,171,168,1,3,"RECORTES CERO-GV-PCAS-TC",1
49,"49252",312,240,236,7,4,"RECORTES CERO-GV-PCAS-TC",0
37,"37354",5479,3969,3905,37,64,"RECORTES CERO-GV-PCAS-TC",6
42,"42049",108,71,71,1,0,"RECORTES CERO-GV-PCAS-TC",0
49,"49142",244,163,160,0,3,"RECORTES CERO-GV-PCAS-TC",1
24,"24188",3795,2877,2825,40,52,"RECORTES CERO-GV-PCAS-TC",1
2,"2049",778,506,496,1,10,"RECORTES CERO-GV-PCAS-TC",0
40,"40006",22,19,19,0,0,"RECORTES CERO-GV-PCAS-TC",0
9,"9473",85,68,64,0,4,"RECORTES CERO-GV-PCAS-TC",1
34,"34127",80,62,62,0,0,"RECORTES CERO-GV-PCAS-TC",0
5,"5029",100,73,73,1,0,"RECORTES CERO-GV-PCAS-TC",0
9,"9476",60,46,46,0,0,"RECORTES CERO-GV-PCAS-TC",0
47,"47137",29,25,25,0,0,"RECORTES CERO-GV-PCAS-TC",0
9,"9366",76,55,55,2,0,"RECORTES CERO-GV-PCAS-TC",0
13,"13006",552,411,406,0,5,"RECORTES CERO-GV-PCAS-TC",0
40,"40017",83,71,68,2,3,"RECORTES CERO-GV-PCAS-TC",0
49,"49069",337,210,201,0,9,"RECORTES CERO-GV-PCAS-TC",0
37,"37103",409,295,294,2,1,"RECORTES CERO-GV-PCAS-TC",1
9,"9368",29,19,19,1,0,"RECORTES CERO-GV-PCAS-TC",0
37,"37031",329,241,238,3,3,"RECORTES CERO-GV-PCAS-TC",0
5,"5063",31,26,26,0,0,"RECORTES CERO-GV-PCAS-TC",0
28,"28062",306,232,227,0,5,"RECORTES CERO-GV-PCAS-TC",0
37,"37197",88,53,53,1,0,"RECORTES CERO-GV-PCAS-TC",0
49,"49033",655,440,434,4,6,"RECORTES CERO-GV-PCAS-TC",0
40,"40106",179,140,139,2,1,"RECORTES CERO-GV-PCAS-TC",0
28,"28022",37338,30620,30455,229,165,"RECORTES CERO-GV-PCAS-TC",28
40,"40082",104,84,84,2,0,"RECORTES CERO-GV-PCAS-TC",0
34,"34231",211,157,153,3,4,"RECORTES CERO-GV-PCAS-TC",0
24,"24156",220,135,133,0,2,"RECORTES CERO-GV-PCAS-TC",0
19,"19165",45,39,39,0,0,"RECORTES CERO-GV-PCAS-TC",1
47,"47012",100,72,71,0,1,"RECORTES CERO-GV-PCAS-TC",0
5,"5227",341,230,228,1,2,"RECORTES CERO-GV-PCAS-TC",0
42,"42113",510,370,366,2,4,"RECORTES CERO-GV-PCAS-TC",2
5,"5099",451,350,344,3,6,"RECORTES CERO-GV-PCAS-TC",0
47,"47169",62,52,52,0,0,"RECORTES CERO-GV-PCAS-TC",0
16,"16247",63,51,50,1,1,"RECORTES CERO-GV-PCAS-TC",0
37,"37068",337,240,236,1,4,"RECORTES CERO-GV-PCAS-TC",0
16,"16197",67,44,43,0,1,"RECORTES CERO-GV-PCAS-TC",0
16,"16066",2280,1765,1734,18,31,"RECORTES CERO-GV-PCAS-TC",1
45,"45166",1575,1231,1210,5,21,"RECORTES CERO-GV-PCAS-TC",1
28,"28181",20801,16353,16243,97,110,"RECORTES CERO-GV-PCAS-TC",22
16,"16169",49,28,28,0,0,"RECORTES CERO-GV-PCAS-TC",0
47,"47064",37,30,29,1,1,"RECORTES CERO-GV-PCAS-TC",1
49,"49147",250,164,162,1,2,"RECORTES CERO-GV-PCAS-TC",0
42,"42027",72,48,47,1,1,"RECORTES CERO-GV-PCAS-TC",0
45,"45204",630,453,449,1,4,"RECORTES CERO-GV-PCAS-TC",0
24,"24158",296,197,192,0,5,"RECORTES CERO-GV-PCAS-TC",1
19,"19031",8,8,8,0,0,"RECORTES CERO-GV-PCAS-TC",0
49,"49259",79,59,59,0,0,"RECORTES CERO-GV-PCAS-TC",0
47,"47044",323,273,270,4,3,"RECORTES CERO-GV-PCAS-TC",0
45,"45058",344,245,236,1,9,"RECORTES CERO-GV-PCAS-TC",1
9,"9047",52,42,41,1,1,"RECORTES CERO-GV-PCAS-TC",0
16,"16043",88,60,60,3,0,"RECORTES CERO-GV-PCAS-TC",1
40,"40043",1773,1376,1345,21,31,"RECORTES CERO-GV-PCAS-TC",1
42,"42068",77,58,57,0,1,"RECORTES CERO-GV-PCAS-TC",0
45,"45033",297,205,201,1,4,"RECORTES CERO-GV-PCAS-TC",0
49,"49036",503,319,316,5,3,"RECORTES CERO-GV-PCAS-TC",1
5,"5010",142,102,100,2,2,"RECORTES CERO-GV-PCAS-TC",0
24,"24119",695,464,458,7,6,"RECORTES CERO-GV-PCAS-TC",0
5,"5035",92,68,68,0,0,"RECORTES CERO-GV-PCAS-TC",0
37,"37107",10444,6997,6884,76,113,"RECORTES CERO-GV-PCAS-TC",1
9,"9458",490,388,385,6,3,"RECORTES CERO-GV-PCAS-TC",3
9,"9374",93,75,72,2,3,"RECORTES CERO-GV-PCAS-TC",0
9,"9209",4404,2997,2950,31,47,"RECORTES CERO-GV-PCAS-TC",5
13,"13012",381,265,261,1,4,"RECORTES CERO-GV-PCAS-TC",0
40,"40205",228,159,157,1,2,"RECORTES CERO-GV-PCAS-TC",0
37,"37296",297,215,210,0,5,"RECORTES CERO-GV-PCAS-TC",0
47,"47015",177,129,129,0,0,"RECORTES CERO-GV-PCAS-TC",0
28,"28005",136518,101397,100485,871,912,"RECORTES CERO-GV-PCAS-TC",161
24,"24196",1907,1322,1299,4,23,"RECORTES CERO-GV-PCAS-TC",5
5,"5102",1681,1252,1228,8,24,"RECORTES CERO-GV-PCAS-TC",0
9,"9318",56,33,33,0,0,"RECORTES CERO-GV-PCAS-TC",0
37,"37201",238,170,168,0,2,"RECORTES CERO-GV-PCAS-TC",0
13,"13059",193,150,150,0,0,"RECORTES CERO-GV-PCAS-TC",0
24,"24051",389,275,269,1,6,"RECORTES CERO-GV-PCAS-TC",0
16,"16202",733,533,526,4,7,"RECORTES CERO-GV-PCAS-TC",0
5,"5069",73,59,59,0,0,"RECORTES CERO-GV-PCAS-TC",0
16,"16159",198,135,135,2,0,"RECORTES CERO-GV-PCAS-TC",0
37,"37360",206,135,135,1,0,"RECORTES CERO-GV-PCAS-TC",0
2,"2056",1640,1204,1179,11,25,"RECORTES CERO-GV-PCAS-TC",0
16,"16009",54,44,44,2,0,"RECORTES CERO-GV-PCAS-TC",0
9,"9159",62,49,47,0,2,"RECORTES CERO-GV-PCAS-TC",1
19,"19229",58,53,53,0,0,"RECORTES CERO-GV-PCAS-TC",0
42,"42166",55,38,37,0,1,"RECORTES CERO-GV-PCAS-TC",0
16,"16085",131,106,106,0,0,"RECORTES CERO-GV-PCAS-TC",0
19,"19326",2463,1671,1650,13,21,"RECORTES CERO-GV-PCAS-TC",1
42,"42209",134,86,84,4,2,"RECORTES CERO-GV-PCAS-TC",0
37,"37016",563,419,411,4,8,"RECORTES CERO-GV-PCAS-TC",1
47,"47016",65,55,55,0,0,"RECORTES CERO-GV-PCAS-TC",0
9,"9430",25,21,21,0,0,"RECORTES CERO-GV-PCAS-TC",0
37,"37141",149,101,100,0,1,"RECORTES CERO-GV-PCAS-TC",0
49,"49186",230,172,170,0,2,"RECORTES CERO-GV-PCAS-TC",0
40,"40906",2149,1701,1662,18,39,"RECORTES CERO-GV-PCAS-TC",4
24,"24123",709,461,457,2,4,"RECORTES CERO-GV-PCAS-TC",1
42,"42183",102,74,74,1,0,"RECORTES CERO-GV-PCAS-TC",1
9,"9006",57,30,29,0,1,"RECORTES CERO-GV-PCAS-TC",0
34,"34137",24,19,19,2,0,"RECORTES CERO-GV-PCAS-TC",0
40,"40014",56,39,38,0,1,"RECORTES CERO-GV-PCAS-TC",0
45,"45025",1218,849,844,9,5,"RECORTES CERO-GV-PCAS-TC",0
42,"42033",50,48,48,2,0,"RECORTES CERO-GV-PCAS-TC",0
9,"9055",47,33,32,0,1,"RECORTES CERO-GV-PCAS-TC",0
37,"37299",230,148,147,0,1,"RECORTES CERO-GV-PCAS-TC",0
47,"47175",6755,4950,4870,49,80,"RECORTES CERO-GV-PCAS-TC",11
5,"5233",223,174,173,0,1,"RECORTES CERO-GV-PCAS-TC",0
28,"28147",991,702,698,4,4,"RECORTES CERO-GV-PCAS-TC",2
37,"37008",4213,3092,3046,21,46,"RECORTES CERO-GV-PCAS-TC",1
34,"34189",53,33,33,0,0,"RECORTES CERO-GV-PCAS-TC",0
24,"24018",172,129,128,0,1,"RECORTES CERO-GV-PCAS-TC",0
49,"49082",341,273,270,12,3,"RECORTES CERO-GV-PCAS-TC",1
9,"9023",1190,891,879,17,12,"RECORTES CERO-GV-PCAS-TC",4
9,"9139",98,79,79,2,0,"RECORTES CERO-GV-PCAS-TC",0
37,"37062",78,59,59,0,0,"RECORTES CERO-GV-PCAS-TC",0
42,"42048",60,52,52,0,0,"RECORTES CERO-GV-PCAS-TC",0
16,"16273",300,214,211,3,3,"RECORTES CERO-GV-PCAS-TC",0
49,"49129",810,541,527,4,14,"RECORTES CERO-GV-PCAS-TC",0
49,"49153",150,110,107,2,3,"RECORTES CERO-GV-PCAS-TC",0
16,"16025",24,20,20,0,0,"RECORTES CERO-GV-PCAS-TC",1
16,"16255",132,99,99,0,0,"RECORTES CERO-GV-PCAS-TC",0
37,"37077",251,206,204,1,2,"RECORTES CERO-GV-PCAS-TC",0
49,"49031",148,107,105,2,2,"RECORTES CERO-GV-PCAS-TC",0
47,"47082",805,641,630,3,11,"RECORTES CERO-GV-PCAS-TC",0
19,"19070",65,45,45,0,0,"RECORTES CERO-GV-PCAS-TC",0
5,"5161",545,395,395,0,0,"RECORTES CERO-GV-PCAS-TC",0
42,"42172",28,26,26,0,0,"RECORTES CERO-GV-PCAS-TC",0
9,"9270",157,112,109,2,3,"RECORTES CERO-GV-PCAS-TC",0
47,"47051",324,261,258,6,3,"RECORTES CERO-GV-PCAS-TC",1
49,"49154",111,63,59,0,4,"RECORTES CERO-GV-PCAS-TC",0
19,"19037",131,109,108,0,1,"RECORTES CERO-GV-PCAS-TC",0
19,"19262",125,98,98,0,0,"RECORTES CERO-GV-PCAS-TC",0
47,"47210",399,278,275,3,3,"RECORTES CERO-GV-PCAS-TC",0
49,"49231",288,208,203,0,5,"RECORTES CERO-GV-PCAS-TC",0
28,"28148",89174,65500,64784,566,716,"RECORTES CERO-GV-PCAS-TC",107
42,"42036",40,33,32,1,1,"RECORTES CERO-GV-PCAS-TC",0
2,"2028",111,81,81,0,0,"RECORTES CERO-GV-PCAS-TC",0
47,"47126",42,35,35,1,0,"RECORTES CERO-GV-PCAS-TC",0
9,"9908",423,254,253,4,1,"RECORTES CERO-GV-PCAS-TC",2
47,"47148",419,332,324,3,8,"RECORTES CERO-GV-PCAS-TC",1
16,"16050",218,172,169,2,3,"RECORTES CERO-GV-PCAS-TC",0
40,"40018",73,50,50,0,0,"RECORTES CERO-GV-PCAS-TC",0
28,"28042",1261,918,908,9,10,"RECORTES CERO-GV-PCAS-TC",1
37,"37302",262,161,161,2,0,"RECORTES CERO-GV-PCAS-TC",0
5,"5108",39,21,21,0,0,"RECORTES CERO-GV-PCAS-TC",0
42,"42081",126,88,88,0,0,"RECORTES CERO-GV-PCAS-TC",0
37,"37042",36,27,27,1,0,"RECORTES CERO-GV-PCAS-TC",0
42,"42128",45,40,39,2,1,"RECORTES CERO-GV-PCAS-TC",0
19,"19013",111,89,89,0,0,"RECORTES CERO-GV-PCAS-TC",0
5,"5043",73,58,58,0,0,"RECORTES CERO-GV-PCAS-TC",0
28,"28150",3191,2423,2401,13,22,"RECORTES CERO-GV-PCAS-TC",2
28,"28118",61,52,50,0,2,"RECORTES CERO-GV-PCAS-TC",0
42,"42174",174,121,118,4,3,"RECORTES CERO-GV-PCAS-TC",0
24,"24058",189,115,114,1,1,"RECORTES CERO-GV-PCAS-TC",0
19,"19003",36,30,30,0,0,"RECORTES CERO-GV-PCAS-TC",0
37,"37178",98,70,70,0,0,"RECORTES CERO-GV-PCAS-TC",0
47,"47084",1077,794,784,11,10,"RECORTES CERO-GV-PCAS-TC",1
49,"49012",70,34,34,0,0,"RECORTES CERO-GV-PCAS-TC",0
24,"24094",1320,866,852,11,14,"RECORTES CERO-GV-PCAS-TC",0
40,"40213",93,78,78,1,0,"RECORTES CERO-GV-PCAS-TC",0
13,"13902",449,329,326,4,3,"RECORTES CERO-GV-PCAS-TC",1
37,"37337",137,104,103,0,1,"RECORTES CERO-GV-PCAS-TC",0
37,"37199",128,92,92,2,0,"RECORTES CERO-GV-PCAS-TC",0
40,"40129",159,119,117,2,2,"RECORTES CERO-GV-PCAS-TC",0
9,"9094",53,42,42,0,0,"RECORTES CERO-GV-PCAS-TC",1
49,"49158",206,159,155,0,4,"RECORTES CERO-GV-PCAS-TC",1
5,"5110",696,469,464,2,5,"RECORTES CERO-GV-PCAS-TC",0
47,"47180",57,41,41,1,0,"RECORTES CERO-GV-PCAS-TC",2
49,"49013",219,160,159,0,1,"RECORTES CERO-GV-PCAS-TC",0
42,"42130",51,42,40,1,2,"RECORTES CERO-GV-PCAS-TC",0
28,"28182",203,167,163,1,4,"RECORTES CERO-GV-PCAS-TC",1
49,"49271",176,128,127,3,1,"RECORTES CERO-GV-PCAS-TC",0
9,"9170",207,151,150,1,1,"RECORTES CERO-GV-PCAS-TC",0
16,"16017",336,276,270,1,6,"RECORTES CERO-GV-PCAS-TC",1
34,"34010",550,407,399,7,8,"RECORTES CERO-GV-PCAS-TC",2
19,"19266",229,184,182,1,2,"RECORTES CERO-GV-PCAS-TC",0
34,"34056",1926,1335,1311,10,24,"RECORTES CERO-GV-PCAS-TC",5
5,"5196",57,43,43,0,0,"RECORTES CERO-GV-PCAS-TC",0
16,"16215",237,162,158,1,4,"RECORTES CERO-GV-PCAS-TC",0
5,"5165",361,266,261,4,5,"RECORTES CERO-GV-PCAS-TC",0
5,"5239",215,163,163,3,0,"RECORTES CERO-GV-PCAS-TC",0
28,"28183",1162,823,813,9,10,"RECORTES CERO-GV-PCAS-TC",1
40,"40225",1085,822,809,5,13,"RECORTES CERO-GV-PCAS-TC",2
9,"9048",1373,937,911,10,26,"RECORTES CERO-GV-PCAS-TC",1
2,"2076",313,233,230,2,3,"RECORTES CERO-GV-PCAS-TC",0
37,"37149",60,50,50,0,0,"RECORTES CERO-GV-PCAS-TC",0
42,"42151",38,27,27,0,0,"RECORTES CERO-GV-PCAS-TC",0
19,"19076",29,23,23,0,0,"RECORTES CERO-GV-PCAS-TC",0
9,"9279",166,116,114,1,2,"RECORTES CERO-GV-PCAS-TC",0
40,"40121",249,188,178,1,10,"RECORTES CERO-GV-PCAS-TC",1
19,"19112",53,35,34,0,1,"RECORTES CERO-GV-PCAS-TC",0
49,"49159",269,182,182,2,0,"RECORTES CERO-GV-PCAS-TC",0
16,"16019",187,141,141,1,0,"RECORTES CERO-GV-PCAS-TC",0
28,"28046",4824,3726,3707,33,19,"RECORTES CERO-GV-PCAS-TC",7
42,"42181",384,281,278,3,3,"RECORTES CERO-GV-PCAS-TC",2
45,"45034",1290,968,948,7,20,"RECORTES CERO-GV-PCAS-TC",1
24,"24097",200,138,137,1,1,"RECORTES CERO-GV-PCAS-TC",0
42,"42178",99,71,71,0,0,"RECORTES CERO-GV-PCAS-TC",0
13,"13074",943,759,749,5,10,"RECORTES CERO-GV-PCAS-TC",0
45,"45072",653,469,462,1,7,"RECORTES CERO-GV-PCAS-TC",0
5,"5012",117,88,88,1,0,"RECORTES CERO-GV-PCAS-TC",0
47,"47184",537,411,402,1,9,"RECORTES CERO-GV-PCAS-TC",2
5,"5178",340,261,255,3,6,"RECORTES CERO-GV-PCAS-TC",0
19,"19302",52,42,42,1,0,"RECORTES CERO-GV-PCAS-TC",0
24,"24027",1214,841,828,6,13,"RECORTES CERO-GV-PCAS-TC",0
19,"19147",42,32,32,0,0,"RECORTES CERO-GV-PCAS-TC",0
19,"19239",93,70,70,1,0,"RECORTES CERO-GV-PCAS-TC",1
28,"28122",578,404,401,1,3,"RECORTES CERO-GV-PCAS-TC",0
49,"49016",230,155,155,0,0,"RECORTES CERO-GV-PCAS-TC",0
16,"16218",184,134,133,1,1,"RECORTES CERO-GV-PCAS-TC",0
19,"19043",99,80,79,0,1,"RECORTES CERO-GV-PCAS-TC",2
28,"28132",12197,8622,8537,75,85,"RECORTES CERO-GV-PCAS-TC",17
45,"45035",286,206,204,2,2,"RECORTES CERO-GV-PCAS-TC",0
19,"19114",30,22,21,1,1,"RECORTES CERO-GV-PCAS-TC",0
49,"49092",115,72,72,0,0,"RECORTES CERO-GV-PCAS-TC",0
9,"9067",399,232,230,3,2,"RECORTES CERO-GV-PCAS-TC",0
16,"16174",166,130,129,2,1,"RECORTES CERO-GV-PCAS-TC",0
19,"19211",350,272,269,0,3,"RECORTES CERO-GV-PCAS-TC",0
49,"49104",326,218,216,0,2,"RECORTES CERO-GV-PCAS-TC",0
37,"37247",171,129,128,0,1,"RECORTES CERO-GV-PCAS-TC",0
34,"34061",91,70,69,1,1,"RECORTES CERO-GV-PCAS-TC",0
40,"40188",83,63,60,0,3,"RECORTES CERO-GV-PCAS-TC",0
5,"5049",403,261,253,1,8,"RECORTES CERO-GV-PCAS-TC",1
19,"19179",74,64,64,3,0,"RECORTES CERO-GV-PCAS-TC",0
2,"2002",427,340,337,2,3,"RECORTES CERO-GV-PCAS-TC",0
19,"19241",35,26,25,2,1,"RECORTES CERO-GV-PCAS-TC",0
49,"49164",141,95,92,1,3,"RECORTES CERO-GV-PCAS-TC",0
28,"28124",73,51,50,0,1,"RECORTES CERO-GV-PCAS-TC",0
45,"45148",263,184,184,0,0,"RECORTES CERO-GV-PCAS-TC",0
34,"34018",199,151,149,4,2,"RECORTES CERO-GV-PCAS-TC",1
9,"9345",111,87,86,2,1,"RECORTES CERO-GV-PCAS-TC",0
37,"37216",294,234,227,5,7,"RECORTES CERO-GV-PCAS-TC",0
45,"45038",3528,2556,2521,26,35,"RECORTES CERO-GV-PCAS-TC",7
49,"49219",7196,4613,4528,64,85,"RECORTES CERO-GV-PCAS-TC",6
47,"47155",3454,2445,2405,26,40,"RECORTES CERO-GV-PCAS-TC",7
47,"47218",981,728,723,4,5,"RECORTES CERO-GV-PCAS-TC",0
40,"40070",143,94,92,1,2,"RECORTES CERO-GV-PCAS-TC",0
37,"37352",209,157,155,3,2,"RECORTES CERO-GV-PCAS-TC",0
16,"16073",190,153,153,1,0,"RECORTES CERO-GV-PCAS-TC",0
13,"13080",316,226,225,0,1,"RECORTES CERO-GV-PCAS-TC",0
42,"42035",730,464,460,3,4,"RECORTES CERO-GV-PCAS-TC",1
16,"16061",939,746,727,16,19,"RECORTES CERO-GV-PCAS-TC",1
40,"40059",109,92,91,2,1,"RECORTES CERO-GV-PCAS-TC",0
13,"13035",947,704,690,6,14,"RECORTES CERO-GV-PCAS-TC",1
47,"47187",71,49,49,0,0,"RECORTES CERO-GV-PCAS-TC",0
19,"19082",100,72,71,1,1,"RECORTES CERO-GV-PCAS-TC",2
34,"34020",49,37,37,1,0,"RECORTES CERO-GV-PCAS-TC",0
47,"47125",49,42,42,0,0,"RECORTES CERO-GV-PCAS-TC",0
37,"37344",229,157,147,2,10,"RECORTES CERO-GV-PCAS-TC",1
34,"34066",54,47,47,1,0,"RECORTES CERO-GV-PCAS-TC",0
24,"24215",149,116,115,0,1,"RECORTES CERO-GV-PCAS-TC",0
9,"9072",331,261,260,4,1,"RECORTES CERO-GV-PCAS-TC",0
47,"47157",490,398,397,2,1,"RECORTES CERO-GV-PCAS-TC",1
16,"16274",97,76,75,1,1,"RECORTES CERO-GV-PCAS-TC",0
37,"37323",474,335,325,5,10,"RECORTES CERO-GV-PCAS-TC",0
40,"40170",1302,962,948,6,14,"RECORTES CERO-GV-PCAS-TC",3
16,"16002",192,160,158,2,2,"RECORTES CERO-GV-PCAS-TC",0
37,"37218",51,25,23,0,2,"RECORTES CERO-GV-PCAS-TC",0
45,"45163",8326,5835,5693,48,142,"RECORTES CERO-GV-PCAS-TC",8
5,"5118",64,41,41,1,0,"RECORTES CERO-GV-PCAS-TC",0
24,"24216",666,453,445,4,8,"RECORTES CERO-GV-PCAS-TC",0
5,"5246",48,35,35,0,0,"RECORTES CERO-GV-PCAS-TC",0
9,"9129",91,74,74,0,0,"RECORTES CERO-GV-PCAS-TC",0
9,"9294",99,81,78,0,3,"RECORTES CERO-GV-PCAS-TC",1
13,"13082",25917,16834,16670,137,164,"RECORTES CERO-GV-PCAS-TC",19
37,"37055",117,97,93,0,4,"RECORTES CERO-GV-PCAS-TC",0
40,"40060",67,40,40,1,0,"RECORTES CERO-GV-PCAS-TC",0
37,"37187",548,407,399,0,8,"RECORTES CERO-GV-PCAS-TC",0
9,"9238",931,473,461,1,12,"RECORTES CERO-GV-PCAS-TC",0
34,"34053",194,156,154,3,2,"RECORTES CERO-GV-PCAS-TC",0
19,"19244",74,55,55,3,0,"RECORTES CERO-GV-PCAS-TC",0
34,"34161",22,12,12,0,0,"RECORTES CERO-GV-PCAS-TC",0
5,"5183",123,103,100,0,3,"RECORTES CERO-GV-PCAS-TC",0
45,"45042",172,122,121,0,1,"RECORTES CERO-GV-PCAS-TC",0
37,"37126",30,25,25,0,0,"RECORTES CERO-GV-PCAS-TC",0
16,"16231",45,38,38,0,0,"RECORTES CERO-GV-PCAS-TC",0
40,"40192",134,106,105,1,1,"RECORTES CERO-GV-PCAS-TC",0
49,"49023",899,627,620,3,7,"RECORTES CERO-GV-PCAS-TC",4
9,"9351",61,46,45,1,1,"RECORTES CERO-GV-PCAS-TC",0
42,"42190",94,61,61,1,0,"RECORTES CERO-GV-PCAS-TC",0
16,"16065",370,287,287,3,0,"RECORTES CERO-GV-PCAS-TC",0
42,"42038",33,22,22,1,0,"RECORTES CERO-GV-PCAS-TC",0
34,"34114",200,134,134,0,0,"RECORTES CERO-GV-PCAS-TC",0
24,"24059",804,466,463,5,3,"RECORTES CERO-GV-PCAS-TC",0
9,"9149",36,29,29,0,0,"RECORTES CERO-GV-PCAS-TC",0
24,"24168",430,325,322,6,3,"RECORTES CERO-GV-PCAS-TC",0
28,"28129",8589,6397,6338,46,59,"RECORTES CERO-GV-PCAS-TC",8
2,"2008",1103,737,722,8,15,"RECORTES CERO-GV-PCAS-TC",1
5,"5185",96,63,61,1,2,"RECORTES CERO-GV-PCAS-TC",0
5,"5217",54,42,41,0,1,"RECORTES CERO-GV-PCAS-TC",0
40,"40031",546,410,406,3,4,"RECORTES CERO-GV-PCAS-TC",1
40,"40062",56,43,42,0,1,"RECORTES CERO-GV-PCAS-TC",0
47,"47160",395,296,294,3,2,"RECORTES CERO-GV-PCAS-TC",0
37,"37377",215,174,173,0,1,"RECORTES CERO-GV-PCAS-TC",1
24,"24036",252,146,146,1,0,"RECORTES CERO-GV-PCAS-TC",0
5,"5088",29,22,22,0,0,"RECORTES CERO-GV-PCAS-TC",0
19,"19016",57,40,40,0,0,"RECORTES CERO-GV-PCAS-TC",0
9,"9354",34,31,31,2,0,"RECORTES CERO-GV-PCAS-TC",2
42,"42041",31,23,23,0,0,"RECORTES CERO-GV-PCAS-TC",0
13,"13904",496,353,342,5,11,"RECORTES CERO-GV-PCAS-TC",2
45,"45143",1192,877,865,9,12,"RECORTES CERO-GV-PCAS-TC",0
24,"24193",363,264,264,1,0,"RECORTES CERO-GV-PCAS-TC",0
24,"24012",278,182,180,0,2,"RECORTES CERO-GV-PCAS-TC",0
9,"9373",399,254,251,5,3,"RECORTES CERO-GV-PCAS-TC",2
9,"9151",446,352,346,3,6,"RECORTES CERO-GV-PCAS-TC",0
28,"28141",6284,4617,4570,42,47,"RECORTES CERO-GV-PCAS-TC",3
45,"45194",64,45,44,1,1,"RECORTES CERO-GV-PCAS-TC",0
2,"2077",52,41,41,0,0,"RECORTES CERO-GV-PCAS-TC",0
34,"34072",145,125,123,1,2,"RECORTES CERO-GV-PCAS-TC",0
24,"24108",348,247,246,4,1,"RECORTES CERO-GV-PCAS-TC",0
47,"47225",73,61,59,1,2,"RECORTES CERO-GV-PCAS-TC",0
28,"28131",13510,9647,9544,89,103,"RECORTES CERO-GV-PCAS-TC",16
40,"40002",32,22,21,0,1,"RECORTES CERO-GV-PCAS-TC",1
28,"28056",946,664,660,2,4,"RECORTES CERO-GV-PCAS-TC",2
49,"49136",313,218,217,5,1,"RECORTES CERO-GV-PCAS-TC",0
40,"40033",70,55,52,1,3,"RECORTES CERO-GV-PCAS-TC",0
37,"37318",196,132,132,0,0,"RECORTES CERO-GV-PCAS-TC",0
49,"49064",478,297,296,6,1,"RECORTES CERO-GV-PCAS-TC",2
24,"24003",603,374,372,0,2,"RECORTES CERO-GV-PCAS-TC",0
37,"37059",117,95,95,3,0,"RECORTES CERO-GV-PCAS-TC",0
28,"28057",1556,1155,1141,7,14,"RECORTES CERO-GV-PCAS-TC",1
5,"5090",73,63,62,0,1,"RECORTES CERO-GV-PCAS-TC",0
9,"9083",26,21,21,0,0,"RECORTES CERO-GV-PCAS-TC",0
9,"9246",599,381,372,2,9,"RECORTES CERO-GV-PCAS-TC",2
19,"19159",87,73,72,1,1,"RECORTES CERO-GV-PCAS-TC",0
45,"45195",2064,1519,1481,9,38,"RECORTES CERO-GV-PCAS-TC",3
13,"13045",622,459,451,0,8,"RECORTES CERO-GV-PCAS-TC",0
19,"19249",29,26,26,0,0,"RECORTES CERO-GV-PCAS-TC",0
47,"47226",148,115,115,1,0,"RECORTES CERO-GV-PCAS-TC",0
40,"40034",74,59,58,0,1,"RECORTES CERO-GV-PCAS-TC",0
37,"37130",173,135,134,2,1,"RECORTES CERO-GV-PCAS-TC",0
42,"42031",25,17,17,1,0,"RECORTES CERO-GV-PCAS-TC",0
13,"13015",5220,3665,3629,25,36,"RECORTES CERO-GV-PCAS-TC",4
24,"24015",2193,1532,1500,12,32,"RECORTES CERO-GV-PCAS-TC",0
19,"19123",37,30,28,0,2,"RECORTES CERO-GV-PCAS-TC",0
37,"37351",268,229,226,0,3,"RECORTES CERO-GV-PCAS-TC",0
19,"19190",2284,1632,1613,16,19,"RECORTES CERO-GV-PCAS-TC",1
28,"28028",1836,1374,1363,3,11,"RECORTES CERO-GV-PCAS-TC",1
47,"47079",55,44,43,1,1,"RECORTES CERO-GV-PCAS-TC",0
5,"5059",92,49,48,0,1,"RECORTES CERO-GV-PCAS-TC",0
9,"9467",59,46,46,2,0,"RECORTES CERO-GV-PCAS-TC",0
16,"16086",872,699,690,7,9,"RECORTES CERO-GV-PCAS-TC",1
9,"9306",94,69,69,1,0,"RECORTES CERO-GV-PCAS-TC",0
40,"40134",692,522,509,10,13,"RECORTES CERO-GV-PCAS-TC",0
37,"37132",317,211,207,0,4,"RECORTES CERO-GV-PCAS-TC",0
28,"28059",4516,3343,3299,30,44,"RECORTES CERO-GV-PCAS-TC",3
47,"47228",432,324,320,2,4,"RECORTES CERO-GV-PCAS-TC",0
16,"16111",168,114,111,2,3,"RECORTES CERO-GV-PCAS-TC",0
47,"47069",115,87,87,0,0,"RECORTES CERO-GV-PCAS-TC",0
16,"16035",224,177,174,2,3,"RECORTES CERO-GV-PCAS-TC",1
37,"37226",152,113,113,2,0,"RECORTES CERO-GV-PCAS-TC",0
28,"28167",8640,6564,6504,51,60,"RECORTES CERO-GV-PCAS-TC",10
40,"40231",100,79,76,0,3,"RECORTES CERO-GV-PCAS-TC",0
34,"34049",329,229,227,1,2,"RECORTES CERO-GV-PCAS-TC",0
5,"5222",140,118,118,0,0,"RECORTES CERO-GV-PCAS-TC",0
24,"24041",513,312,305,4,7,"RECORTES CERO-GV-PCAS-TC",0
5,"5026",183,149,147,1,2,"RECORTES CERO-GV-PCAS-TC",0
37,"37051",79,58,58,0,0,"RECORTES CERO-GV-PCAS-TC",0
49,"49020",253,189,187,0,2,"RECORTES CERO-GV-PCAS-TC",0
40,"40104",283,203,200,0,3,"RECORTES CERO-GV-PCAS-TC",0
42,"42140",15,11,11,1,0,"RECORTES CERO-GV-PCAS-TC",0
24,"24080",207,155,154,1,1,"RECORTES CERO-GV-PCAS-TC",0
37,"37290",130,106,106,0,0,"RECORTES CERO-GV-PCAS-TC",1
9,"9309",293,198,193,5,5,"RECORTES CERO-GV-PCAS-TC",1
45,"45053",7820,5814,5712,56,102,"RECORTES CERO-GV-PCAS-TC",7
9,"9250",264,195,193,3,2,"RECORTES CERO-GV-PCAS-TC",0
19,"19223",99,66,65,1,1,"RECORTES CERO-GV-PCAS-TC",0
42,"42108",10,7,7,0,0,"RECORTES CERO-GV-PCAS-TC",0
19,"19284",10,10,10,0,0,"RECORTES CERO-GV-PCAS-TC",0
16,"16038",27,20,20,0,0,"RECORTES CERO-GV-PCAS-TC",0
37,"37196",70,50,50,0,0,"RECORTES CERO-GV-PCAS-TC",0
42,"42062",20,10,10,0,0,"RECORTES CERO-GV-PCAS-TC",0
37,"37134",209,143,141,3,2,"RECORTES CERO-GV-PCAS-TC",0
9,"9199",91,68,68,0,0,"RECORTES CERO-GV-PCAS-TC",1
37,"37175",412,298,293,4,5,"RECORTES CERO-GV-PCAS-TC",2
37,"37010",925,645,638,5,7,"RECORTES CERO-GV-PCAS-TC",1
13,"13051",336,253,249,1,4,"RECORTES CERO-GV-PCAS-TC",0
16,"16003",134,108,105,0,3,"RECORTES CERO-GV-PCAS-TC",0
47,"47021",73,57,55,0,2,"RECORTES CERO-GV-PCAS-TC",0
42,"42188",46,35,35,1,0,"RECORTES CERO-GV-PCAS-TC",0
49,"49057",107,74,71,0,3,"RECORTES CERO-GV-PCAS-TC",0
28,"28001",70,48,47,1,1,"RECORTES CERO-GV-PCAS-TC",0
37,"37135",1146,849,837,5,12,"RECORTES CERO-GV-PCAS-TC",1
5,"5162",76,47,45,1,2,"RECORTES CERO-GV-PCAS-TC",0
16,"16129",88,72,72,0,0,"RECORTES CERO-GV-PCAS-TC",0
16,"16116",76,59,58,1,1,"RECORTES CERO-GV-PCAS-TC",1
5,"5030",40,32,32,0,0,"RECORTES CERO-GV-PCAS-TC",0
47,"47042",51,39,39,0,0,"RECORTES CERO-GV-PCAS-TC",0
42,"42202",19,11,10,0,1,"RECORTES CERO-GV-PCAS-TC",0
49,"49168",89,68,68,0,0,"RECORTES CERO-GV-PCAS-TC",0
45,"45129",98,77,77,1,0,"RECORTES CERO-GV-PCAS-TC",0
2,"2084",298,197,191,2,6,"RECORTES CERO-GV-PCAS-TC",0
16,"16246",451,327,322,1,5,"RECORTES CERO-GV-PCAS-TC",0
45,"45202",3963,2806,2771,10,35,"RECORTES CERO-GV-PCAS-TC",1
47,"47104",2816,2153,2099,20,54,"RECORTES CERO-GV-PCAS-TC",2
19,"19024",8561,6015,5942,44,73,"RECORTES CERO-GV-PCAS-TC",5
37,"37262",69,51,51,0,0,"RECORTES CERO-GV-PCAS-TC",0
28,"28033",4177,2972,2936,20,36,"RECORTES CERO-GV-PCAS-TC",5
47,"47105",169,138,137,2,1,"RECORTES CERO-GV-PCAS-TC",1
47,"47043",306,241,240,4,1,"RECORTES CERO-GV-PCAS-TC",0
13,"13009",1383,1081,1070,3,11,"RECORTES CERO-GV-PCAS-TC",2
19,"19195",36,26,25,2,1,"RECORTES CERO-GV-PCAS-TC",0
40,"40140",76,54,54,0,0,"RECORTES CERO-GV-PCAS-TC",0
2,"2085",306,232,226,2,6,"RECORTES CERO-GV-PCAS-TC",1
49,"49192",123,93,90,2,3,"RECORTES CERO-GV-PCAS-TC",0
9,"9239",47,31,31,0,0,"RECORTES CERO-GV-PCAS-TC",0
24,"24191",106,70,69,2,1,"RECORTES CERO-GV-PCAS-TC",0
37,"37169",177,122,122,0,0,"RECORTES CERO-GV-PCAS-TC",0
45,"45094",365,274,271,3,3,"RECORTES CERO-GV-PCAS-TC",0
13,"13903",498,395,394,0,1,"RECORTES CERO-GV-PCAS-TC",0
45,"45020",1240,905,900,5,5,"RECORTES CERO-GV-PCAS-TC",0
42,"42115",89,68,66,0,2,"RECORTES CERO-GV-PCAS-TC",0
19,"19323",36,26,26,0,0,"RECORTES CERO-GV-PCAS-TC",0
47,"47076",17787,13484,13306,179,178,"RECORTES CERO-GV-PCAS-TC",22
40,"40903",75,61,59,0,2,"RECORTES CERO-GV-PCAS-TC",0
16,"16157",183,150,148,0,2,"RECORTES CERO-GV-PCAS-TC",2
9,"9483",189,156,155,2,1,"RECORTES CERO-GV-PCAS-TC",0
49,"49112",118,72,72,2,0,"RECORTES CERO-GV-PCAS-TC",0
47,"47034",75,58,58,2,0,"RECORTES CERO-GV-PCAS-TC",0
47,"47055",188,147,147,2,0,"RECORTES CERO-GV-PCAS-TC",0
2,"2020",425,336,332,4,4,"RECORTES CERO-GV-PCAS-TC",0
19,"19176",227,172,172,0,0,"RECORTES CERO-GV-PCAS-TC",0
28,"28120",1220,910,897,5,13,"RECORTES CERO-GV-PCAS-TC",2
16,"16119",175,117,115,0,2,"RECORTES CERO-GV-PCAS-TC",0
13,"13056",11706,8399,8288,88,111,"RECORTES CERO-GV-PCAS-TC",11
40,"40032",368,247,244,5,3,"RECORTES CERO-GV-PCAS-TC",0
37,"37317",287,211,209,1,2,"RECORTES CERO-GV-PCAS-TC",0
24,"24221",738,492,485,9,7,"RECORTES CERO-GV-PCAS-TC",0
5,"5263",162,117,115,1,2,"RECORTES CERO-GV-PCAS-TC",0
24,"24902",331,239,239,0,0,"RECORTES CERO-GV-PCAS-TC",0
37,"37234",314,194,192,3,2,"RECORTES CERO-GV-PCAS-TC",0
5,"5230",65,57,56,1,1,"RECORTES CERO-GV-PCAS-TC",0
16,"16084",48,34,30,1,4,"RECORTES CERO-GV-PCAS-TC",0
24,"24050",105,77,77,2,0,"RECORTES CERO-GV-PCAS-TC",0
42,"42004",2290,1595,1565,30,30,"RECORTES CERO-GV-PCAS-TC",3
24,"24087",582,431,427,3,4,"RECORTES CERO-GV-PCAS-TC",0
49,"49226",240,200,198,2,2,"RECORTES CERO-GV-PCAS-TC",0
45,"45060",152,109,109,1,0,"RECORTES CERO-GV-PCAS-TC",0
24,"24160",633,404,403,2,1,"RECORTES CERO-GV-PCAS-TC",0
47,"47110",445,335,327,1,8,"RECORTES CERO-GV-PCAS-TC",0
49,"49079",104,79,76,0,3,"RECORTES CERO-GV-PCAS-TC",0
19,"19032",145,94,93,2,1,"RECORTES CERO-GV-PCAS-TC",1
34,"34088",265,195,191,1,4,"RECORTES CERO-GV-PCAS-TC",0
19,"19289",23,16,16,0,0,"RECORTES CERO-GV-PCAS-TC",0
16,"16045",180,128,127,0,1,"RECORTES CERO-GV-PCAS-TC",0
49,"49150",123,95,92,3,3,"RECORTES CERO-GV-PCAS-TC",0
24,"24121",599,422,418,3,4,"RECORTES CERO-GV-PCAS-TC",0
49,"49006",139,98,95,3,3,"RECORTES CERO-GV-PCAS-TC",0
28,"28175",940,740,730,2,10,"RECORTES CERO-GV-PCAS-TC",0
40,"40110",316,237,234,4,3,"RECORTES CERO-GV-PCAS-TC",0
49,"49263",44,32,32,1,0,"RECORTES CERO-GV-PCAS-TC",0
24,"24088",996,750,745,9,5,"RECORTES CERO-GV-PCAS-TC",0
34,"34155",122,95,95,0,0,"RECORTES CERO-GV-PCAS-TC",0
9,"9280",26,18,18,0,0,"RECORTES CERO-GV-PCAS-TC",0
37,"37203",151,114,113,1,1,"RECORTES CERO-GV-PCAS-TC",0
19,"19290",851,551,550,4,1,"RECORTES CERO-GV-PCAS-TC",0
28,"28007",127491,96937,96102,810,835,"RECORTES CERO-GV-PCAS-TC",162
34,"34238",294,238,236,1,2,"RECORTES CERO-GV-PCAS-TC",0
34,"34091",118,82,82,1,0,"RECORTES CERO-GV-PCAS-TC",0
28,"28018",4121,3174,3151,22,23,"RECORTES CERO-GV-PCAS-TC",0
34,"34210",98,82,82,1,0,"RECORTES CERO-GV-PCAS-TC",0
5,"5199",37,31,31,0,0,"RECORTES CERO-GV-PCAS-TC",0
34,"34156",51,42,42,0,0,"RECORTES CERO-GV-PCAS-TC",0
37,"37110",104,81,79,1,2,"RECORTES CERO-GV-PCAS-TC",0
45,"45135",4152,3118,3066,21,52,"RECORTES CERO-GV-PCAS-TC",4
9,"9160",83,63,63,1,0,"RECORTES CERO-GV-PCAS-TC",0
28,"28113",36951,27912,27604,241,308,"RECORTES CERO-GV-PCAS-TC",39
16,"16047",214,154,148,3,6,"RECORTES CERO-GV-PCAS-TC",0
45,"45136",5827,3908,3864,22,44,"RECORTES CERO-GV-PCAS-TC",3
13,"13017",240,178,176,0,2,"RECORTES CERO-GV-PCAS-TC",3
2,"2059",320,225,217,0,8,"RECORTES CERO-GV-PCAS-TC",0
16,"16048",404,300,298,2,2,"RECORTES CERO-GV-PCAS-TC",1
9,"9432",170,125,123,0,2,"RECORTES CERO-GV-PCAS-TC",2
40,"40015",23,19,19,0,0,"RECORTES CERO-GV-PCAS-TC",0
19,"19009",263,186,184,0,2,"RECORTES CERO-GV-PCAS-TC",0
42,"42121",54,39,39,0,0,"RECORTES CERO-GV-PCAS-TC",0
42,"42009",77,58,58,0,0,"RECORTES CERO-GV-PCAS-TC",0
28,"28157",690,471,467,1,4,"RECORTES CERO-GV-PCAS-TC",1
16,"16904",453,348,345,11,3,"RECORTES CERO-GV-PCAS-TC",0
9,"9362",198,156,156,4,0,"RECORTES CERO-GV-PCAS-TC",1
5,"5083",137,92,91,0,1,"RECORTES CERO-GV-PCAS-TC",0
19,"19304",224,169,166,3,3,"RECORTES CERO-GV-PCAS-TC",0
9,"9327",26,20,20,0,0,"RECORTES CERO-GV-PCAS-TC",0
42,"42171",111,72,71,1,1,"RECORTES CERO-GV-PCAS-TC",0
45,"45174",300,218,217,2,1,"RECORTES CERO-GV-PCAS-TC",0
37,"37269",424,280,277,2,3,"RECORTES CERO-GV-PCAS-TC",0
9,"9269",29,24,23,0,1,"RECORTES CERO-GV-PCAS-TC",0
16,"16089",381,292,289,8,3,"RECORTES CERO-GV-PCAS-TC",0
19,"19001",43,32,32,0,0,"RECORTES CERO-GV-PCAS-TC",0
2,"2027",274,209,203,1,6,"RECORTES CERO-GV-PCAS-TC",0
9,"9907",1526,1140,1119,18,21,"RECORTES CERO-GV-PCAS-TC",9
45,"45102",3613,2495,2464,27,31,"RECORTES CERO-GV-PCAS-TC",7
45,"45028",3613,2675,2647,22,28,"RECORTES CERO-GV-PCAS-TC",2
24,"24019",338,259,256,4,3,"RECORTES CERO-GV-PCAS-TC",0
49,"49009",382,251,251,0,0,"RECORTES CERO-GV-PCAS-TC",0
19,"19117",1632,1187,1167,12,20,"RECORTES CERO-GV-PCAS-TC",3
19,"19096",105,72,70,0,2,"RECORTES CERO-GV-PCAS-TC",0
2,"2016",528,353,352,4,1,"RECORTES CERO-GV-PCAS-TC",1
34,"34176",127,95,90,3,5,"RECORTES CERO-GV-PCAS-TC",0
24,"24115",53159,35203,34784,410,419,"RECORTES CERO-GV-PCAS-TC",34
49,"49032",282,196,196,0,0,"RECORTES CERO-GV-PCAS-TC",0
49,"49177",255,145,144,1,1,"RECORTES CERO-GV-PCAS-TC",0
45,"45139",144,111,111,0,0,"RECORTES CERO-GV-PCAS-TC",0
42,"42080",153,108,108,1,0,"RECORTES CERO-GV-PCAS-TC",0
28,"28052",3961,2700,2659,14,41,"RECORTES CERO-GV-PCAS-TC",1
37,"37090",68,47,47,0,0,"RECORTES CERO-GV-PCAS-TC",0
40,"40049",37,27,27,0,0,"RECORTES CERO-GV-PCAS-TC",1
49,"49044",78,56,53,0,3,"RECORTES CERO-GV-PCAS-TC",0
47,"47211",48,37,37,1,0,"RECORTES CERO-GV-PCAS-TC",0
5,"5140",99,83,81,0,2,"RECORTES CERO-GV-PCAS-TC",0
40,"40118",46,32,32,1,0,"RECORTES CERO-GV-PCAS-TC",0
49,"49233",85,51,51,0,0,"RECORTES CERO-GV-PCAS-TC",0
34,"34246",68,52,52,0,0,"RECORTES CERO-GV-PCAS-TC",0
34,"34099",53,44,42,0,2,"RECORTES CERO-GV-PCAS-TC",0
9,"9112",102,73,73,0,0,"RECORTES CERO-GV-PCAS-TC",1
19,"19297",32,28,28,0,0,"RECORTES CERO-GV-PCAS-TC",0
9,"9330",1481,1050,1037,17,13,"RECORTES CERO-GV-PCAS-TC",4
5,"5076",468,376,367,1,9,"RECORTES CERO-GV-PCAS-TC",0
9,"9388",31,26,25,0,1,"RECORTES CERO-GV-PCAS-TC",0
19,"19039",56,48,48,2,0,"RECORTES CERO-GV-PCAS-TC",0
19,"19086",1371,1003,996,9,7,"RECORTES CERO-GV-PCAS-TC",0
16,"16186",403,309,305,3,4,"RECORTES CERO-GV-PCAS-TC",0
16,"16264",385,311,305,1,6,"RECORTES CERO-GV-PCAS-TC",0
24,"24131",684,416,415,2,1,"RECORTES CERO-GV-PCAS-TC",1
34,"34202",28,23,23,2,0,"RECORTES CERO-GV-PCAS-TC",0
28,"28063",252,188,187,1,1,"RECORTES CERO-GV-PCAS-TC",0
45,"45130",294,222,222,1,0,"RECORTES CERO-GV-PCAS-TC",0
37,"37367",179,147,143,2,4,"RECORTES CERO-GV-PCAS-TC",0
37,"37273",85,58,58,2,0,"RECORTES CERO-GV-PCAS-TC",0
40,"40019",29,23,23,1,0,"RECORTES CERO-GV-PCAS-TC",0
24,"24207",276,215,215,2,0,"RECORTES CERO-GV-PCAS-TC",0
19,"19265",134,97,97,5,0,"RECORTES CERO-GV-PCAS-TC",1
16,"16016",217,157,157,1,0,"RECORTES CERO-GV-PCAS-TC",0
49,"49270",139,93,92,0,1,"RECORTES CERO-GV-PCAS-TC",0
40,"40151",43,31,31,0,0,"RECORTES CERO-GV-PCAS-TC",0
37,"37148",399,295,291,0,4,"RECORTES CERO-GV-PCAS-TC",0
9,"9390",554,455,450,6,5,"RECORTES CERO-GV-PCAS-TC",2
24,"24023",264,188,185,1,3,"RECORTES CERO-GV-PCAS-TC",0
5,"5078",95,78,78,2,0,"RECORTES CERO-GV-PCAS-TC",0
40,"40010",108,83,82,0,1,"RECORTES CERO-GV-PCAS-TC",0
40,"40204",145,102,101,0,1,"RECORTES CERO-GV-PCAS-TC",0
5,"5112",95,59,58,0,1,"RECORTES CERO-GV-PCAS-TC",1
37,"37034",77,63,62,0,1,"RECORTES CERO-GV-PCAS-TC",0
42,"42206",8,5,5,2,0,"RECORTES CERO-GV-PCAS-TC",0
37,"37045",27,19,19,0,0,"RECORTES CERO-GV-PCAS-TC",0
24,"24132",610,330,329,5,1,"RECORTES CERO-GV-PCAS-TC",0
5,"5132",857,548,539,7,9,"RECORTES CERO-GV-PCAS-TC",0
37,"37024",89,60,60,0,0,"RECORTES CERO-GV-PCAS-TC",0
28,"28903",35555,28875,28671,341,204,"RECORTES CERO-GV-PCAS-TC",34
40,"40001",708,544,536,3,8,"RECORTES CERO-GV-PCAS-TC",1
45,"45182",996,760,754,5,6,"RECORTES CERO-GV-PCAS-TC",0
13,"13028",10230,7682,7559,65,123,"RECORTES CERO-GV-PCAS-TC",9
9,"9226",54,45,45,2,0,"RECORTES CERO-GV-PCAS-TC",0
40,"40184",245,196,194,0,2,"RECORTES CERO-GV-PCAS-TC",1
42,"42152",67,47,44,1,3,"RECORTES CERO-GV-PCAS-TC",0
9,"9033",80,64,63,1,1,"RECORTES CERO-GV-PCAS-TC",0
47,"47214",1349,1036,1019,5,17,"RECORTES CERO-GV-PCAS-TC",1
24,"24210",524,353,353,1,0,"RECORTES CERO-GV-PCAS-TC",0
42,"42043",3816,2602,2540,23,62,"RECORTES CERO-GV-PCAS-TC",4
9,"9018",24624,17232,16983,192,249,"RECORTES CERO-GV-PCAS-TC",43
19,"19268",50,37,35,0,2,"RECORTES CERO-GV-PCAS-TC",0
19,"19310",7,7,7,0,0,"RECORTES CERO-GV-PCAS-TC",0
5,"5058",71,45,43,0,2,"RECORTES CERO-GV-PCAS-TC",0
19,"19301",37,26,26,0,0,"RECORTES CERO-GV-PCAS-TC",0
45,"45183",2378,1555,1525,16,30,"RECORTES CERO-GV-PCAS-TC",2
24,"24172",389,208,202,1,6,"RECORTES CERO-GV-PCAS-TC",1
47,"47183",135,100,100,1,0,"RECORTES CERO-GV-PCAS-TC",0
37,"37085",5060,3732,3689,52,43,"RECORTES CERO-GV-PCAS-TC",3
19,"19269",86,61,61,0,0,"RECORTES CERO-GV-PCAS-TC",0
37,"37120",98,78,76,0,2,"RECORTES CERO-GV-PCAS-TC",1
5,"5013",834,658,653,2,5,"RECORTES CERO-GV-PCAS-TC",1
40,"40218",80,56,55,0,1,"RECORTES CERO-GV-PCAS-TC",0
45,"45036",638,455,449,1,6,"RECORTES CERO-GV-PCAS-TC",1
9,"9192",54,46,45,1,1,"RECORTES CERO-GV-PCAS-TC",0
5,"5265",83,59,58,1,1,"RECORTES CERO-GV-PCAS-TC",0
19,"19078",47,37,36,0,1,"RECORTES CERO-GV-PCAS-TC",0
47,"47057",272,200,199,0,1,"RECORTES CERO-GV-PCAS-TC",0
45,"45146",101,79,79,0,0,"RECORTES CERO-GV-PCAS-TC",0
9,"9396",149,121,121,4,0,"RECORTES CERO-GV-PCAS-TC",0
49,"49275",51064,34471,34017,475,454,"RECORTES CERO-GV-PCAS-TC",54
37,"37027",239,182,179,2,3,"RECORTES CERO-GV-PCAS-TC",0
47,"47195",426,314,310,2,4,"RECORTES CERO-GV-PCAS-TC",0
9,"9343",92,66,65,0,1,"RECORTES CERO-GV-PCAS-TC",0
40,"40155",3897,2920,2880,56,40,"RECORTES CERO-GV-PCAS-TC",10
16,"16137",37,27,25,0,2,"RECORTES CERO-GV-PCAS-TC",0
28,"28123",62178,49883,49515,397,368,"RECORTES CERO-GV-PCAS-TC",56
37,"37049",125,76,76,0,0,"RECORTES CERO-GV-PCAS-TC",0
45,"45160",1097,838,824,4,14,"RECORTES CERO-GV-PCAS-TC",2
34,"34023",5103,3585,3543,45,42,"RECORTES CERO-GV-PCAS-TC",12
45,"45185",7573,5422,5320,31,102,"RECORTES CERO-GV-PCAS-TC",7
45,"45075",120,77,74,0,3,"RECORTES CERO-GV-PCAS-TC",0
9,"9283",39,25,24,1,1,"RECORTES CERO-GV-PCAS-TC",0
13,"13033",1544,1231,1196,5,35,"RECORTES CERO-GV-PCAS-TC",0
40,"40178",85,61,60,0,1,"RECORTES CERO-GV-PCAS-TC",0
47,"47029",50,37,35,1,2,"RECORTES CERO-GV-PCAS-TC",0
9,"9416",52,30,30,0,0,"RECORTES CERO-GV-PCAS-TC",1
9,"9287",191,144,143,2,1,"RECORTES CERO-GV-PCAS-TC",1
40,"40165",73,53,52,0,1,"RECORTES CERO-GV-PCAS-TC",0
42,"42197",68,54,53,0,1,"RECORTES CERO-GV-PCAS-TC",0
24,"24113",346,240,240,2,0,"RECORTES CERO-GV-PCAS-TC",0
37,"37311",201,157,156,1,1,"RECORTES CERO-GV-PCAS-TC",0
47,"47101",1634,1278,1262,7,16,"RECORTES CERO-GV-PCAS-TC",1
47,"47070",29,24,24,0,0,"RECORTES CERO-GV-PCAS-TC",0
49,"49056",285,191,190,3,1,"RECORTES CERO-GV-PCAS-TC",1
28,"28050",4406,3202,3167,29,35,"RECORTES CERO-GV-PCAS-TC",1
16,"16062",25,20,20,0,0,"RECORTES CERO-GV-PCAS-TC",0
40,"40092",105,75,75,2,0,"RECORTES CERO-GV-PCAS-TC",0
16,"16141",131,98,96,1,2,"RECORTES CERO-GV-PCAS-TC",0
49,"49095",282,202,201,6,1,"RECORTES CERO-GV-PCAS-TC",0
9,"9405",122,94,91,0,3,"RECORTES CERO-GV-PCAS-TC",0
47,"47156",150,117,117,0,0,"RECORTES CERO-GV-PCAS-TC",0
37,"37185",539,372,363,2,9,"RECORTES CERO-GV-PCAS-TC",0
9,"9289",1353,873,861,4,12,"RECORTES CERO-GV-PCAS-TC",1
47,"47061",237,185,184,0,1,"RECORTES CERO-GV-PCAS-TC",0
45,"45187",3967,3133,3074,16,59,"RECORTES CERO-GV-PCAS-TC",2
40,"40168",27,20,20,0,0,"RECORTES CERO-GV-PCAS-TC",0
16,"16194",219,169,161,0,8,"RECORTES CERO-GV-PCAS-TC",0
9,"9384",292,199,193,3,6,"RECORTES CERO-GV-PCAS-TC",1
5,"5201",497,404,401,0,3,"RECORTES CERO-GV-PCAS-TC",0
42,"42023",57,48,48,0,0,"RECORTES CERO-GV-PCAS-TC",0
9,"9310",15,14,11,0,3,"RECORTES CERO-GV-PCAS-TC",0
13,"13005",23256,16610,16367,132,243,"RECORTES CERO-GV-PCAS-TC",22
19,"19183",70,59,58,0,1,"RECORTES CERO-GV-PCAS-TC",0
5,"5152",644,498,496,3,2,"RECORTES CERO-GV-PCAS-TC",0
42,"42063",45,31,30,1,1,"RECORTES CERO-GV-PCAS-TC",0
34,"34160",133,107,106,0,1,"RECORTES CERO-GV-PCAS-TC",0
5,"5018",23,17,17,2,0,"RECORTES CERO-GV-PCAS-TC",0
45,"45021",2639,1798,1755,22,43,"RECORTES CERO-GV-PCAS-TC",2
37,"37079",77,59,59,1,0,"RECORTES CERO-GV-PCAS-TC",0
40,"40159",130,94,93,2,1,"RECORTES CERO-GV-PCAS-TC",1
28,"28094",988,711,707,5,4,"RECORTES CERO-GV-PCAS-TC",0
45,"45080",3,3,3,0,0,"RECORTES CERO-GV-PCAS-TC",0
49,"49244",46,23,23,0,0,"RECORTES CERO-GV-PCAS-TC",0
47,"47221",97,85,84,1,1,"RECORTES CERO-GV-PCAS-TC",0
16,"16103",235,183,181,2,2,"RECORTES CERO-GV-PCAS-TC",0
5,"5215",156,120,113,0,7,"RECORTES CERO-GV-PCAS-TC",0
37,"37022",242,191,190,0,1,"RECORTES CERO-GV-PCAS-TC",0
2,"2073",4825,3433,3394,35,39,"RECORTES CERO-GV-PCAS-TC",0
45,"45153",1568,1168,1162,8,6,"RECORTES CERO-GV-PCAS-TC",2
37,"37219",169,88,85,1,3,"RECORTES CERO-GV-PCAS-TC",0
28,"28002",3250,2261,2243,14,18,"RECORTES CERO-GV-PCAS-TC",0
49,"49179",337,210,209,3,1,"RECORTES CERO-GV-PCAS-TC",0
42,"42145",129,105,104,1,1,"RECORTES CERO-GV-PCAS-TC",2
9,"9131",485,390,388,7,2,"RECORTES CERO-GV-PCAS-TC",3
47,"47003",206,167,166,5,1,"RECORTES CERO-GV-PCAS-TC",0
42,"42082",8,8,8,0,0,"RECORTES CERO-GV-PCAS-TC",0
9,"9275",167,114,114,1,0,"RECORTES CERO-GV-PCAS-TC",0
47,"47129",855,660,648,7,12,"RECORTES CERO-GV-PCAS-TC",2
19,"19186",76,60,60,0,0,"RECORTES CERO-GV-PCAS-TC",0
24,"24145",612,338,337,1,1,"RECORTES CERO-GV-PCAS-TC",0
45,"45008",144,112,110,1,2,"RECORTES CERO-GV-PCAS-TC",0
28,"28054",11943,8800,8731,72,69,"RECORTES CERO-GV-PCAS-TC",10
42,"42148",9,9,9,0,0,"RECORTES CERO-GV-PCAS-TC",0
9,"9241",244,171,169,6,2,"RECORTES CERO-GV-PCAS-TC",2
42,"42015",30,20,20,0,0,"RECORTES CERO-GV-PCAS-TC",0
19,"19257",3279,2233,2206,21,27,"RECORTES CERO-GV-PCAS-TC",4
19,"19246",42,27,27,1,0,"RECORTES CERO-GV-PCAS-TC",0
37,"37347",463,349,345,9,4,"RECORTES CERO-GV-PCAS-TC",0
49,"49246",214,183,180,3,3,"RECORTES CERO-GV-PCAS-TC",0
13,"13071",37945,24340,24091,227,249,"RECORTES CERO-GV-PCAS-TC",49
45,"45070",1412,1158,1136,7,22,"RECORTES CERO-GV-PCAS-TC",0
34,"34181",422,289,285,0,4,"RECORTES CERO-GV-PCAS-TC",1
47,"47151",26,22,22,0,0,"RECORTES CERO-GV-PCAS-TC",0
19,"19299",100,72,71,1,1,"RECORTES CERO-GV-PCAS-TC",0
34,"34233",128,104,104,0,0,"RECORTES CERO-GV-PCAS-TC",0
49,"49224",166,102,100,0,2,"RECORTES CERO-GV-PCAS-TC",0
49,"49178",748,520,505,7,15,"RECORTES CERO-GV-PCAS-TC",2
16,"16166",240,173,171,0,2,"RECORTES CERO-GV-PCAS-TC",0
13,"13001",1188,865,858,4,7,"RECORTES CERO-GV-PCAS-TC",0
45,"45156",3334,2561,2502,23,59,"RECORTES CERO-GV-PCAS-TC",2
45,"45120",113,86,86,0,0,"RECORTES CERO-GV-PCAS-TC",0
28,"28097",126,87,87,2,0,"RECORTES CERO-GV-PCAS-TC",0
40,"40194",39173,28641,28260,353,381,"RECORTES CERO-GV-PCAS-TC",66
24,"24037",330,189,189,1,0,"RECORTES CERO-GV-PCAS-TC",0
37,"37015",198,127,125,2,2,"RECORTES CERO-GV-PCAS-TC",0
40,"40131",51,45,45,0,0,"RECORTES CERO-GV-PCAS-TC",0
5,"5023",174,148,145,2,3,"RECORTES CERO-GV-PCAS-TC",0
37,"37223",106,75,74,0,1,"RECORTES CERO-GV-PCAS-TC",0
34,"34222",107,71,68,1,3,"RECORTES CERO-GV-PCAS-TC",0
19,"19018",142,112,112,1,0,"RECORTES CERO-GV-PCAS-TC",0
24,"24038",3024,2121,2071,25,50,"RECORTES CERO-GV-PCAS-TC",0
2,"2055",1055,672,668,2,4,"RECORTES CERO-GV-PCAS-TC",1
9,"9428",102,73,73,1,0,"RECORTES CERO-GV-PCAS-TC",1
47,"47163",277,208,205,3,3,"RECORTES CERO-GV-PCAS-TC",0
24,"24149",149,123,123,0,0,"RECORTES CERO-GV-PCAS-TC",0
5,"5024",193,127,125,2,2,"RECORTES CERO-GV-PCAS-TC",0
9,"9464",33,24,24,0,0,"RECORTES CERO-GV-PCAS-TC",0
47,"47067",153,112,112,3,0,"RECORTES CERO-GV-PCAS-TC",0
9,"9304",198,152,149,1,3,"RECORTES CERO-GV-PCAS-TC",1
5,"5220",364,277,274,0,3,"RECORTES CERO-GV-PCAS-TC",0
19,"19122",81,62,60,2,2,"RECORTES CERO-GV-PCAS-TC",0
42,"42195",86,51,51,2,0,"RECORTES CERO-GV-PCAS-TC",0
45,"45097",1037,834,819,7,15,"RECORTES CERO-GV-PCAS-TC",1
40,"40144",16,15,15,0,0,"RECORTES CERO-GV-PCAS-TC",0
2,"2067",1137,808,794,2,14,"RECORTES CERO-GV-PCAS-TC",1
9,"9378",31,20,19,0,1,"RECORTES CERO-GV-PCAS-TC",0
40,"40905",130,95,95,0,0,"RECORTES CERO-GV-PCAS-TC",0
40,"40206",162,126,123,0,3,"RECORTES CERO-GV-PCAS-TC",2
24,"24151",433,307,304,1,3,"RECORTES CERO-GV-PCAS-TC",0
28,"28058",141836,104142,103011,896,1131,"RECORTES CERO-GV-PCAS-TC",189
9,"9229",178,127,127,1,0,"RECORTES CERO-GV-PCAS-TC",0
40,"40123",141,98,94,4,4,"RECORTES CERO-GV-PCAS-TC",0
5,"5093",362,251,249,0,2,"RECORTES CERO-GV-PCAS-TC",1
42,"42154",103,76,76,1,0,"RECORTES CERO-GV-PCAS-TC",0
28,"28038",5213,3801,3753,24,48,"RECORTES CERO-GV-PCAS-TC",4
37,"37215",133,93,90,1,3,"RECORTES CERO-GV-PCAS-TC",1
16,"16042",1091,832,823,4,9,"RECORTES CERO-GV-PCAS-TC",0
40,"40222",161,134,131,1,3,"RECORTES CERO-GV-PCAS-TC",0
5,"5259",99,80,79,2,1,"RECORTES CERO-GV-PCAS-TC",0
42,"42106",13,11,11,0,0,"RECORTES CERO-GV-PCAS-TC",0
13,"13002",1415,966,950,3,16,"RECORTES CERO-GV-PCAS-TC",1
5,"5060",108,79,79,2,0,"RECORTES CERO-GV-PCAS-TC",0
24,"24225",979,678,668,5,10,"RECORTES CERO-GV-PCAS-TC",0
49,"49240",185,125,123,3,2,"RECORTES CERO-GV-PCAS-TC",0
13,"13048",495,392,391,4,1,"RECORTES CERO-GV-PCAS-TC",1
37,"37332",65,49,49,0,0,"RECORTES CERO-GV-PCAS-TC",0
42,"42156",29,21,21,0,0,"RECORTES CERO-GV-PCAS-TC",0
9,"9022",58,46,46,1,0,"RECORTES CERO-GV-PCAS-TC",0
9,"9178",39,24,24,0,0,"RECORTES CERO-GV-PCAS-TC",0
47,"47185",82,62,61,1,1,"RECORTES CERO-GV-PCAS-TC",0
5,"5061",257,193,189,1,4,"RECORTES CERO-GV-PCAS-TC",0
5,"5244",39,29,29,0,0,"RECORTES CERO-GV-PCAS-TC",0
49,"49019",232,162,152,2,10,"RECORTES CERO-GV-PCAS-TC",0
45,"45089",1432,1076,1064,10,12,"RECORTES CERO-GV-PCAS-TC",0
34,"34080",5231,3207,3161,35,46,"RECORTES CERO-GV-PCAS-TC",4
24,"24007",735,500,496,8,4,"RECORTES CERO-GV-PCAS-TC",0
34,"34035",97,76,75,3,1,"RECORTES CERO-GV-PCAS-TC",1
16,"16193",55,50,49,0,1,"RECORTES CERO-GV-PCAS-TC",0
47,"47102",257,212,210,2,2,"RECORTES CERO-GV-PCAS-TC",0
5,"5027",258,209,203,5,6,"RECORTES CERO-GV-PCAS-TC",0
37,"37030",82,60,60,0,0,"RECORTES CERO-GV-PCAS-TC",0
9,"9365",26,17,17,0,0,"RECORTES CERO-GV-PCAS-TC",0
28,"28168",1347,933,918,6,15,"RECORTES CERO-GV-PCAS-TC",0
19,"19192",1762,1251,1240,5,11,"RECORTES CERO-GV-PCAS-TC",0
49,"49220",146,102,98,3,4,"RECORTES CERO-GV-PCAS-TC",0
49,"49119",217,158,156,2,2,"RECORTES CERO-GV-PCAS-TC",1
42,"42124",56,27,27,0,0,"RECORTES CERO-GV-PCAS-TC",0
34,"34036",230,159,158,0,1,"RECORTES CERO-GV-PCAS-TC",1
24,"24043",116,54,52,0,2,"RECORTES CERO-GV-PCAS-TC",0
16,"16074",30,25,25,0,0,"RECORTES CERO-GV-PCAS-TC",0
47,"47230",285,209,206,1,3,"RECORTES CERO-GV-PCAS-TC",0
37,"37166",196,134,133,1,1,"RECORTES CERO-GV-PCAS-TC",1
37,"37040",376,291,288,0,3,"RECORTES CERO-GV-PCAS-TC",0
40,"40028",103,88,87,2,1,"RECORTES CERO-GV-PCAS-TC",0
24,"24228",619,370,364,2,6,"RECORTES CERO-GV-PCAS-TC",0
16,"16275",12,12,12,1,0,"RECORTES CERO-GV-PCAS-TC",0
28,"28136",693,538,533,2,5,"RECORTES CERO-GV-PCAS-TC",0
19,"19226",37,22,22,0,0,"RECORTES CERO-GV-PCAS-TC",0
47,"47031",191,141,140,0,1,"RECORTES CERO-GV-PCAS-TC",0
2,"2072",1528,981,958,7,23,"RECORTES CERO-GV-PCAS-TC",0
42,"42111",274,183,181,0,2,"RECORTES CERO-GV-PCAS-TC",0
19,"19254",43,34,34,0,0,"RECORTES CERO-GV-PCAS-TC",0
34,"34082",78,59,58,0,1,"RECORTES CERO-GV-PCAS-TC",0
47,"47199",71,57,57,2,0,"RECORTES CERO-GV-PCAS-TC",0
24,"24117",410,302,301,1,1,"RECORTES CERO-GV-PCAS-TC",0
5,"5260",95,73,73,0,0,"RECORTES CERO-GV-PCAS-TC",0
24,"24082",847,615,608,16,7,"RECORTES CERO-GV-PCAS-TC",0
40,"40202",56,33,33,0,0,"RECORTES CERO-GV-PCAS-TC",0
42,"42160",246,177,175,3,2,"RECORTES CERO-GV-PCAS-TC",0
34,"34039",58,48,47,0,1,"RECORTES CERO-GV-PCAS-TC",0
19,"19129",25,21,21,0,0,"RECORTES CERO-GV-PCAS-TC",0
19,"19286",772,585,575,3,10,"RECORTES CERO-GV-PCAS-TC",1
49,"49146",265,183,181,4,2,"RECORTES CERO-GV-PCAS-TC",0
42,"42161",136,99,99,0,0,"RECORTES CERO-GV-PCAS-TC",0
9,"9148",77,58,58,3,0,"RECORTES CERO-GV-PCAS-TC",2
49,"49180",135,82,81,5,1,"RECORTES CERO-GV-PCAS-TC",0
42,"42026",28,25,25,0,0,"RECORTES CERO-GV-PCAS-TC",0
16,"16041",334,244,243,2,1,"RECORTES CERO-GV-PCAS-TC",0
34,"34131",56,46,46,0,0,"RECORTES CERO-GV-PCAS-TC",0
49,"49035",220,180,180,4,0,"RECORTES CERO-GV-PCAS-TC",0
40,"40009",41,35,34,0,1,"RECORTES CERO-GV-PCAS-TC",0
16,"16910",75,44,44,1,0,"RECORTES CERO-GV-PCAS-TC",0
16,"16082",272,194,192,1,2,"RECORTES CERO-GV-PCAS-TC",0
24,"24118",101,72,72,0,0,"RECORTES CERO-GV-PCAS-TC",0
37,"37357",248,193,192,1,1,"RECORTES CERO-GV-PCAS-TC",0
5,"5207",645,485,478,4,7,"RECORTES CERO-GV-PCAS-TC",0
19,"19027",129,97,95,1,2,"RECORTES CERO-GV-PCAS-TC",0
28,"28064",125,98,95,3,3,"RECORTES CERO-GV-PCAS-TC",0
37,"37233",53,39,39,1,0,"RECORTES CERO-GV-PCAS-TC",0
40,"40161",32,24,23,1,1,"RECORTES CERO-GV-PCAS-TC",0
37,"37253",135,109,109,1,0,"RECORTES CERO-GV-PCAS-TC",0
34,"34149",23,20,20,0,0,"RECORTES CERO-GV-PCAS-TC",0
16,"16083",44,24,24,0,0,"RECORTES CERO-GV-PCAS-TC",0
47,"47140",106,83,83,0,0,"RECORTES CERO-GV-PCAS-TC",0
24,"24096",105,56,54,1,2,"RECORTES CERO-GV-PCAS-TC",1
2,"2053",2888,2086,2042,14,44,"RECORTES CERO-GV-PCAS-TC",7
16,"16132",33,25,25,1,0,"RECORTES CERO-GV-PCAS-TC",1
45,"45032",445,290,286,2,4,"RECORTES CERO-GV-PCAS-TC",0
45,"45140",1075,788,772,10,16,"RECORTES CERO-GV-PCAS-TC",0
37,"37112",158,110,109,2,1,"RECORTES CERO-GV-PCAS-TC",1
5,"5123",106,78,78,0,0,"RECORTES CERO-GV-PCAS-TC",0
16,"16158",513,371,366,5,5,"RECORTES CERO-GV-PCAS-TC",0
24,"24120",305,182,181,1,1,"RECORTES CERO-GV-PCAS-TC",0
37,"37035",162,115,115,1,0,"RECORTES CERO-GV-PCAS-TC",0
19,"19187",42,32,32,0,0,"RECORTES CERO-GV-PCAS-TC",0
34,"34205",55,38,38,0,0,"RECORTES CERO-GV-PCAS-TC",0
49,"49050",498,305,305,2,0,"RECORTES CERO-GV-PCAS-TC",0
37,"37171",396,272,270,2,2,"RECORTES CERO-GV-PCAS-TC",0
42,"42164",1580,1043,1029,8,14,"RECORTES CERO-GV-PCAS-TC",4
37,"37005",65,44,44,1,0,"RECORTES CERO-GV-PCAS-TC",0
49,"49184",172,110,107,2,3,"RECORTES CERO-GV-PCAS-TC",0
9,"9338",225,174,172,3,2,"RECORTES CERO-GV-PCAS-TC",1
37,"37097",42,29,29,0,0,"RECORTES CERO-GV-PCAS-TC",0
5,"5168",3503,2536,2511,29,25,"RECORTES CERO-GV-PCAS-TC",2
37,"37235",214,163,159,2,4,"RECORTES CERO-GV-PCAS-TC",0
28,"28144",6525,5032,4987,39,45,"RECORTES CERO-GV-PCAS-TC",8
19,"19113",454,327,322,4,5,"RECORTES CERO-GV-PCAS-TC",1
40,"40088",272,192,192,0,0,"RECORTES CERO-GV-PCAS-TC",2
37,"37172",846,530,524,6,6,"RECORTES CERO-GV-PCAS-TC",0
13,"13060",274,205,202,3,3,"RECORTES CERO-GV-PCAS-TC",1
40,"40077",966,718,704,10,14,"RECORTES CERO-GV-PCAS-TC",3
45,"45062",1075,816,808,11,8,"RECORTES CERO-GV-PCAS-TC",0
5,"5145",43,28,28,0,0,"RECORTES CERO-GV-PCAS-TC",0
28,"28047",42984,30772,30486,270,286,"RECORTES CERO-GV-PCAS-TC",38
9,"9321",1576,1151,1135,10,16,"RECORTES CERO-GV-PCAS-TC",5
16,"16134",4368,3143,3102,22,41,"RECORTES CERO-GV-PCAS-TC",2
19,"19178",27,17,16,0,1,"RECORTES CERO-GV-PCAS-TC",2
40,"40045",119,93,93,1,0,"RECORTES CERO-GV-PCAS-TC",0
5,"5070",30,29,29,0,0,"RECORTES CERO-GV-PCAS-TC",1
40,"40177",139,106,105,0,1,"RECORTES CERO-GV-PCAS-TC",0
9,"9214",632,409,407,2,2,"RECORTES CERO-GV-PCAS-TC",0
2,"2013",125,90,88,0,2,"RECORTES CERO-GV-PCAS-TC",0
19,"19079",7,6,6,0,0,"RECORTES CERO-GV-PCAS-TC",0
16,"16058",94,71,71,1,0,"RECORTES CERO-GV-PCAS-TC",0
9,"9398",73,52,52,0,0,"RECORTES CERO-GV-PCAS-TC",0
47,"47058",199,126,125,3,1,"RECORTES CERO-GV-PCAS-TC",0
24,"24901",853,517,513,4,4,"RECORTES CERO-GV-PCAS-TC",0
9,"9316",104,80,80,0,0,"RECORTES CERO-GV-PCAS-TC",0
40,"40127",36,25,23,0,2,"RECORTES CERO-GV-PCAS-TC",0
9,"9219",27097,17874,17629,192,245,"RECORTES CERO-GV-PCAS-TC",44
42,"42076",200,149,143,2,6,"RECORTES CERO-GV-PCAS-TC",0
28,"28039",134,93,93,1,0,"RECORTES CERO-GV-PCAS-TC",0
9,"9162",130,102,100,1,2,"RECORTES CERO-GV-PCAS-TC",0
40,"40145",1098,824,820,4,4,"RECORTES CERO-GV-PCAS-TC",2
19,"19171",5380,3964,3919,22,45,"RECORTES CERO-GV-PCAS-TC",8
5,"5159",224,133,132,3,1,"RECORTES CERO-GV-PCAS-TC",0
9,"9007",54,37,35,0,2,"RECORTES CERO-GV-PCAS-TC",0
5,"5190",53,44,43,0,1,"RECORTES CERO-GV-PCAS-TC",0
45,"45100",178,141,138,0,3,"RECORTES CERO-GV-PCAS-TC",0
47,"47166",251,183,181,2,2,"RECORTES CERO-GV-PCAS-TC",0
37,"37258",134,92,92,1,0,"RECORTES CERO-GV-PCAS-TC",0
34,"34034",112,82,82,1,0,"RECORTES CERO-GV-PCAS-TC",0
9,"9448",203,159,157,0,2,"RECORTES CERO-GV-PCAS-TC",0
47,"47091",76,60,59,2,1,"RECORTES CERO-GV-PCAS-TC",0
24,"24029",686,430,428,6,2,"RECORTES CERO-GV-PCAS-TC",0
9,"9108",433,315,311,3,4,"RECORTES CERO-GV-PCAS-TC",0
47,"47176",199,110,110,0,0,"RECORTES CERO-GV-PCAS-TC",0
40,"40113",404,308,304,2,4,"RECORTES CERO-GV-PCAS-TC",3
34,"34141",176,149,146,0,3,"RECORTES CERO-GV-PCAS-TC",0
13,"13020",4701,3114,3069,42,45,"RECORTES CERO-GV-PCAS-TC",5
28,"28116",748,576,569,2,7,"RECORTES CERO-GV-PCAS-TC",1
42,"42215",723,468,452,10,16,"RECORTES CERO-GV-PCAS-TC",0
37,"37206",87,65,54,0,11,"RECORTES CERO-GV-PCAS-TC",0
24,"24127",263,183,181,1,2,"RECORTES CERO-GV-PCAS-TC",0
9,"9041",25,21,21,2,0,"RECORTES CERO-GV-PCAS-TC",0
5,"5225",355,276,273,6,3,"RECORTES CERO-GV-PCAS-TC",1
40,"40048",35,27,27,0,0,"RECORTES CERO-GV-PCAS-TC",0
5,"5001",182,139,138,1,1,"RECORTES CERO-GV-PCAS-TC",0
9,"9434",1279,966,956,11,10,"RECORTES CERO-GV-PCAS-TC",0
5,"5062",163,121,119,3,2,"RECORTES CERO-GV-PCAS-TC",0
45,"45065",264,211,206,1,5,"RECORTES CERO-GV-PCAS-TC",0
9,"9410",3019,1924,1898,21,26,"RECORTES CERO-GV-PCAS-TC",7
9,"9217",342,240,237,1,3,"RECORTES CERO-GV-PCAS-TC",1
49,"49167",180,131,131,2,0,"RECORTES CERO-GV-PCAS-TC",0
9,"9425",472,311,309,3,2,"RECORTES CERO-GV-PCAS-TC",0
37,"37179",197,167,165,0,2,"RECORTES CERO-GV-PCAS-TC",1
9,"9335",86,66,66,3,0,"RECORTES CERO-GV-PCAS-TC",1
28,"28172",9915,7715,7652,60,63,"RECORTES CERO-GV-PCAS-TC",10
42,"42012",29,22,22,0,0,"RECORTES CERO-GV-PCAS-TC",0
13,"13068",1023,737,722,2,15,"RECORTES CERO-GV-PCAS-TC",3
47,"47052",6781,5213,5156,50,57,"RECORTES CERO-GV-PCAS-TC",21
49,"49011",214,147,146,5,1,"RECORTES CERO-GV-PCAS-TC",1
24,"24093",342,214,212,2,2,"RECORTES CERO-GV-PCAS-TC",0
37,"37177",259,198,197,3,1,"RECORTES CERO-GV-PCAS-TC",0
42,"42037",28,13,13,2,0,"RECORTES CERO-GV-PCAS-TC",0
9,"9012",93,70,68,0,2,"RECORTES CERO-GV-PCAS-TC",0
34,"34098",790,562,558,3,4,"RECORTES CERO-GV-PCAS-TC",3
40,"40051",34,25,25,0,0,"RECORTES CERO-GV-PCAS-TC",0
37,"37241",167,121,119,3,2,"RECORTES CERO-GV-PCAS-TC",0
28,"28084",16243,11562,11408,90,154,"RECORTES CERO-GV-PCAS-TC",25
42,"42217",33,25,25,0,0,"RECORTES CERO-GV-PCAS-TC",0
37,"37356",84,58,58,0,0,"RECORTES CERO-GV-PCAS-TC",0
13,"13084",841,652,644,6,8,"RECORTES CERO-GV-PCAS-TC",2
24,"24144",621,419,412,4,7,"RECORTES CERO-GV-PCAS-TC",1
9,"9169",97,72,70,1,2,"RECORTES CERO-GV-PCAS-TC",1
16,"16277",105,74,74,0,0,"RECORTES CERO-GV-PCAS-TC",0
9,"9440",80,61,61,0,0,"RECORTES CERO-GV-PCAS-TC",0
42,"42218",68,44,43,0,1,"RECORTES CERO-GV-PCAS-TC",0
19,"19110",51,39,39,0,0,"RECORTES CERO-GV-PCAS-TC",0
28,"28151",3274,2344,2310,16,34,"RECORTES CERO-GV-PCAS-TC",2
5,"5007",109,73,72,0,1,"RECORTES CERO-GV-PCAS-TC",0
40,"40083",73,52,52,1,0,"RECORTES CERO-GV-PCAS-TC",0
2,"2063",1358,987,973,3,14,"RECORTES CERO-GV-PCAS-TC",0
9,"9223",42,36,36,0,0,"RECORTES CERO-GV-PCAS-TC",0
49,"49193",428,261,253,3,8,"RECORTES CERO-GV-PCAS-TC",0
9,"9076",24,19,19,1,0,"RECORTES CERO-GV-PCAS-TC",0
19,"19040",53,43,42,1,1,"RECORTES CERO-GV-PCAS-TC",0
34,"34101",48,36,36,1,0,"RECORTES CERO-GV-PCAS-TC",0
28,"28014",34522,25016,24748,229,268,"RECORTES CERO-GV-PCAS-TC",20
24,"24049",1417,983,975,14,8,"RECORTES CERO-GV-PCAS-TC",0
19,"19102",88,75,73,0,2,"RECORTES CERO-GV-PCAS-TC",0
9,"9057",147,110,108,0,2,"RECORTES CERO-GV-PCAS-TC",0
42,"42084",20,15,15,0,0,"RECORTES CERO-GV-PCAS-TC",0
9,"9062",40,34,33,0,1,"RECORTES CERO-GV-PCAS-TC",0
24,"24099",153,111,110,1,1,"RECORTES CERO-GV-PCAS-TC",0
5,"5195",199,125,125,1,0,"RECORTES CERO-GV-PCAS-TC",0
9,"9202",22,16,16,2,0,"RECORTES CERO-GV-PCAS-TC",0
9,"9206",52,43,43,0,0,"RECORTES CERO-GV-PCAS-TC",0
19,"19099",286,179,175,1,4,"RECORTES CERO-GV-PCAS-TC",0
16,"16150",98,66,66,2,0,"RECORTES CERO-GV-PCAS-TC",0
16,"16279",173,109,108,0,1,"RECORTES CERO-GV-PCAS-TC",0
2,"2010",1784,1374,1349,12,25,"RECORTES CERO-GV-PCAS-TC",0
9,"9119",42,24,24,0,0,"RECORTES CERO-GV-PCAS-TC",0
24,"24061",1753,1234,1223,10,11,"RECORTES CERO-GV-PCAS-TC",2
42,"42042",53,42,41,1,1,"RECORTES CERO-GV-PCAS-TC",0
24,"24001",165,93,93,0,0,"RECORTES CERO-GV-PCAS-TC",0
42,"42017",131,99,96,1,3,"RECORTES CERO-GV-PCAS-TC",0
49,"49272",73,49,46,2,3,"RECORTES CERO-GV-PCAS-TC",0
19,"19267",20,15,14,0,1,"RECORTES CERO-GV-PCAS-TC",0
34,"34152",124,99,94,0,5,"RECORTES CERO-GV-PCAS-TC",1
9,"9135",41,28,28,0,0,"RECORTES CERO-GV-PCAS-TC",0
45,"45010",383,258,257,3,1,"RECORTES CERO-GV-PCAS-TC",0
42,"42208",20,12,12,1,0,"RECORTES CERO-GV-PCAS-TC",0
19,"19219",9,8,7,0,1,"RECORTES CERO-GV-PCAS-TC",0
24,"24062",126,79,79,0,0,"RECORTES CERO-GV-PCAS-TC",1
37,"37276",125,92,92,0,0,"RECORTES CERO-GV-PCAS-TC",0
19,"19188",36,31,31,0,0,"RECORTES CERO-GV-PCAS-TC",0
49,"49249",61,45,45,1,0,"RECORTES CERO-GV-PCAS-TC",0
13,"13030",115,81,81,0,0,"RECORTES CERO-GV-PCAS-TC",2
40,"40154",22,18,18,1,0,"RECORTES CERO-GV-PCAS-TC",0
9,"9120",41,34,33,3,1,"RECORTES CERO-GV-PCAS-TC",0
2,"2001",687,513,505,1,8,"RECORTES CERO-GV-PCAS-TC",0
16,"16149",147,105,105,2,0,"RECORTES CERO-GV-PCAS-TC",0
37,"37109",178,127,126,0,1,"RECORTES CERO-GV-PCAS-TC",0
19,"19104",19,15,14,0,1,"RECORTES CERO-GV-PCAS-TC",0
16,"16251",1805,1318,1302,9,16,"RECORTES CERO-GV-PCAS-TC",1
28,"28067",4416,3359,3311,18,48,"RECORTES CERO-GV-PCAS-TC",3
19,"19201",60,44,44,0,0,"RECORTES CERO-GV-PCAS-TC",0
45,"45200",4471,3351,3269,25,82,"RECORTES CERO-GV-PCAS-TC",5
9,"9176",58,46,45,2,1,"RECORTES CERO-GV-PCAS-TC",0
34,"34242",91,65,62,2,3,"RECORTES CERO-GV-PCAS-TC",0
9,"9016",85,54,54,0,0,"RECORTES CERO-GV-PCAS-TC",0
45,"45159",83,71,69,0,2,"RECORTES CERO-GV-PCAS-TC",0
2,"2079",2807,2000,1978,17,22,"RECORTES CERO-GV-PCAS-TC",5
45,"45106",7418,5380,5306,34,74,"RECORTES CERO-GV-PCAS-TC",3
49,"49042",229,166,164,2,2,"RECORTES CERO-GV-PCAS-TC",0
40,"40041",966,729,716,8,13,"RECORTES CERO-GV-PCAS-TC",3
5,"5262",318,238,235,1,3,"RECORTES CERO-GV-PCAS-TC",0
9,"9224",147,113,112,0,1,"RECORTES CERO-GV-PCAS-TC",0
24,"24104",243,167,166,0,1,"RECORTES CERO-GV-PCAS-TC",0
45,"45111",56,47,47,1,0,"RECORTES CERO-GV-PCAS-TC",0
5,"5116",96,68,68,0,0,"RECORTES CERO-GV-PCAS-TC",0
37,"37018",106,75,75,0,0,"RECORTES CERO-GV-PCAS-TC",0
28,"28090",9252,7216,7153,58,63,"RECORTES CERO-GV-PCAS-TC",10
24,"24199",398,263,256,4,7,"RECORTES CERO-GV-PCAS-TC",0
47,"47145",583,430,426,6,4,"RECORTES CERO-GV-PCAS-TC",1
19,"19036",242,202,200,1,2,"RECORTES CERO-GV-PCAS-TC",1
9,"9216",370,245,241,3,4,"RECORTES CERO-GV-PCAS-TC",1
13,"13008",422,280,272,2,8,"RECORTES CERO-GV-PCAS-TC",0
24,"24174",457,294,289,3,5,"RECORTES CERO-GV-PCAS-TC",0
9,"9454",41,34,33,1,1,"RECORTES CERO-GV-PCAS-TC",0
24,"24139",2071,1371,1346,15,25,"RECORTES CERO-GV-PCAS-TC",0
5,"5051",157,117,115,1,2,"RECORTES CERO-GV-PCAS-TC",0
37,"37101",138,101,100,1,1,"RECORTES CERO-GV-PCAS-TC",1
37,"37063",58,47,47,0,0,"RECORTES CERO-GV-PCAS-TC",0
37,"37259",39,28,28,1,0,"RECORTES CERO-GV-PCAS-TC",0
24,"24214",626,438,433,8,5,"RECORTES CERO-GV-PCAS-TC",2
49,"49202",173,103,101,0,2,"RECORTES CERO-GV-PCAS-TC",0
40,"40158",15,11,11,0,0,"RECORTES CERO-GV-PCAS-TC",0
37,"37374",1138,889,872,2,17,"RECORTES CERO-GV-PCAS-TC",0
37,"37280",70,47,46,0,1,"RECORTES CERO-GV-PCAS-TC",0
47,"47092",101,81,79,0,2,"RECORTES CERO-GV-PCAS-TC",1
34,"34109",60,34,34,0,0,"RECORTES CERO-GV-PCAS-TC",0
37,"37155",68,48,48,0,0,"RECORTES CERO-GV-PCAS-TC",0
2,"2071",1027,800,795,7,5,"RECORTES CERO-GV-PCAS-TC",0
34,"34094",61,45,45,2,0,"RECORTES CERO-GV-PCAS-TC",0
19,"19296",29,24,24,0,0,"RECORTES CERO-GV-PCAS-TC",0
19,"19322",26,20,19,1,1,"RECORTES CERO-GV-PCAS-TC",0
5,"5228",168,99,98,0,1,"RECORTES CERO-GV-PCAS-TC",0
47,"47010",14718,11521,11392,137,129,"RECORTES CERO-GV-PCAS-TC",16
28,"28044",6266,4693,4642,36,51,"RECORTES CERO-GV-PCAS-TC",2
9,"9251",362,258,256,3,2,"RECORTES CERO-GV-PCAS-TC",2
16,"16006",113,100,100,1,0,"RECORTES CERO-GV-PCAS-TC",0
37,"37358",159,124,124,0,0,"RECORTES CERO-GV-PCAS-TC",0
37,"37327",179,148,147,2,1,"RECORTES CERO-GV-PCAS-TC",1
42,"42039",216,144,141,1,3,"RECORTES CERO-GV-PCAS-TC",1
37,"37088",199,135,133,0,2,"RECORTES CERO-GV-PCAS-TC",0
37,"37117",1572,1103,1092,12,11,"RECORTES CERO-GV-PCAS-TC",2
37,"37243",89,66,66,0,0,"RECORTES CERO-GV-PCAS-TC",0
49,"49155",81,60,59,0,1,"RECORTES CERO-GV-PCAS-TC",0
24,"24203",88,62,62,1,0,"RECORTES CERO-GV-PCAS-TC",0
34,"34067",129,80,78,1,2,"RECORTES CERO-GV-PCAS-TC",0
9,"9074",844,610,609,12,1,"RECORTES CERO-GV-PCAS-TC",3
47,"47062",155,128,128,0,0,"RECORTES CERO-GV-PCAS-TC",0
49,"49058",301,222,221,1,1,"RECORTES CERO-GV-PCAS-TC",1
16,"16185",36,31,31,0,0,"RECORTES CERO-GV-PCAS-TC",0
42,"42189",57,43,43,0,0,"RECORTES CERO-GV-PCAS-TC",0
9,"9182",74,54,54,0,0,"RECORTES CERO-GV-PCAS-TC",0
42,"42056",28,25,24,0,1,"RECORTES CERO-GV-PCAS-TC",0
24,"24105",1512,1054,1047,10,7,"RECORTES CERO-GV-PCAS-TC",0
13,"13043",205,163,162,1,1,"RECORTES CERO-GV-PCAS-TC",0
37,"37168",397,271,266,3,5,"RECORTES CERO-GV-PCAS-TC",0
2,"2029",3333,2363,2320,13,43,"RECORTES CERO-GV-PCAS-TC",2
42,"42064",83,65,65,1,0,"RECORTES CERO-GV-PCAS-TC",0
24,"24010",8251,5357,5275,40,82,"RECORTES CERO-GV-PCAS-TC",1
34,"34025",52,34,34,1,0,"RECORTES CERO-GV-PCAS-TC",0
9,"9369",419,288,284,3,4,"RECORTES CERO-GV-PCAS-TC",2
28,"28161",52164,38607,38193,306,414,"RECORTES CERO-GV-PCAS-TC",50
34,"34165",57,45,44,1,1,"RECORTES CERO-GV-PCAS-TC",0
49,"49207",215,144,143,1,1,"RECORTES CERO-GV-PCAS-TC",0
13,"13040",839,639,623,7,16,"RECORTES CERO-GV-PCAS-TC",1
16,"16145",413,333,326,6,7,"RECORTES CERO-GV-PCAS-TC",1
42,"42191",183,116,114,5,2,"RECORTES CERO-GV-PCAS-TC",0
37,"37159",74,59,59,0,0,"RECORTES CERO-GV-PCAS-TC",0
47,"47128",53,45,43,0,2,"RECORTES CERO-GV-PCAS-TC",0
47,"47095",41,29,28,0,1,"RECORTES CERO-GV-PCAS-TC",0
47,"47170",43,36,30,0,6,"RECORTES CERO-GV-PCAS-TC",0
49,"49038",88,63,58,1,5,"RECORTES CERO-GV-PCAS-TC",0
19,"19305",139,104,103,1,1,"RECORTES CERO-GV-PCAS-TC",0
24,"24011",182,104,102,3,2,"RECORTES CERO-GV-PCAS-TC",0
9,"9414",180,137,135,1,2,"RECORTES CERO-GV-PCAS-TC",1
42,"42205",77,59,57,3,2,"RECORTES CERO-GV-PCAS-TC",0
9,"9163",573,436,432,7,4,"RECORTES CERO-GV-PCAS-TC",0
9,"9228",155,129,129,0,0,"RECORTES CERO-GV-PCAS-TC",0
5,"5164",18,12,12,0,0,"RECORTES CERO-GV-PCAS-TC",0
42,"42198",19,9,9,1,0,"RECORTES CERO-GV-PCAS-TC",0
49,"49076",330,230,226,9,4,"RECORTES CERO-GV-PCAS-TC",0
47,"47118",147,97,97,2,0,"RECORTES CERO-GV-PCAS-TC",0
40,"40902",113,78,76,1,2,"RECORTES CERO-GV-PCAS-TC",0
37,"37221",391,259,257,2,2,"RECORTES CERO-GV-PCAS-TC",0
45,"45005",225,170,167,3,3,"RECORTES CERO-GV-PCAS-TC",3
34,"34174",172,142,136,0,6,"RECORTES CERO-GV-PCAS-TC",1
13,"13088",585,413,409,3,4,"RECORTES CERO-GV-PCAS-TC",0
49,"49171",603,433,427,4,6,"RECORTES CERO-GV-PCAS-TC",1
34,"34167",110,84,83,0,1,"RECORTES CERO-GV-PCAS-TC",0
42,"42055",158,113,113,1,0,"RECORTES CERO-GV-PCAS-TC",0
19,"19006",755,506,494,4,12,"RECORTES CERO-GV-PCAS-TC",0
37,"37025",245,198,196,5,2,"RECORTES CERO-GV-PCAS-TC",0
16,"16124",1807,1367,1347,14,20,"RECORTES CERO-GV-PCAS-TC",2
37,"37285",360,271,270,0,1,"RECORTES CERO-GV-PCAS-TC",1
42,"42167",235,163,161,4,2,"RECORTES CERO-GV-PCAS-TC",0
24,"24073",437,285,282,1,3,"RECORTES CERO-GV-PCAS-TC",0
42,"42193",14,7,7,0,0,"RECORTES CERO-GV-PCAS-TC",0
5,"5187",1714,1247,1221,9,26,"RECORTES CERO-GV-PCAS-TC",2
9,"9211",1369,938,921,14,17,"RECORTES CERO-GV-PCAS-TC",4
2,"2078",891,650,642,4,8,"RECORTES CERO-GV-PCAS-TC",0
24,"24074",97,70,70,1,0,"RECORTES CERO-GV-PCAS-TC",0
9,"9051",164,125,125,0,0,"RECORTES CERO-GV-PCAS-TC",0
37,"37182",75,47,47,1,0,"RECORTES CERO-GV-PCAS-TC",0
40,"40100",262,208,204,4,4,"RECORTES CERO-GV-PCAS-TC",0
16,"16189",264,196,194,4,2,"RECORTES CERO-GV-PCAS-TC",0
47,"47193",1625,1251,1236,10,15,"RECORTES CERO-GV-PCAS-TC",2
37,"37098",290,197,197,1,0,"RECORTES CERO-GV-PCAS-TC",0
49,"49227",317,245,244,4,1,"RECORTES CERO-GV-PCAS-TC",0
42,"42134",2651,1875,1836,21,39,"RECORTES CERO-GV-PCAS-TC",1
24,"24211",259,199,198,3,1,"RECORTES CERO-GV-PCAS-TC",0
16,"16203",10221,6960,6883,42,77,"RECORTES CERO-GV-PCAS-TC",9
47,"47071",396,321,316,5,5,"RECORTES CERO-GV-PCAS-TC",1
47,"47023",3057,2369,2359,20,10,"RECORTES CERO-GV-PCAS-TC",2
34,"34192",76,59,59,0,0,"RECORTES CERO-GV-PCAS-TC",0
47,"47050",3908,2713,2673,39,40,"RECORTES CERO-GV-PCAS-TC",5
9,"9449",91,78,76,1,2,"RECORTES CERO-GV-PCAS-TC",0
19,"19288",21,20,20,2,0,"RECORTES CERO-GV-PCAS-TC",0
5,"5008",202,158,155,0,3,"RECORTES CERO-GV-PCAS-TC",0
47,"47146",275,215,214,1,1,"RECORTES CERO-GV-PCAS-TC",0
37,"37293",102,68,68,1,0,"RECORTES CERO-GV-PCAS-TC",0
24,"24206",1594,1104,1093,11,11,"RECORTES CERO-GV-PCAS-TC",2
19,"19074",67,57,57,1,0,"RECORTES CERO-GV-PCAS-TC",1
34,"34009",30,26,26,0,0,"RECORTES CERO-GV-PCAS-TC",0
19,"19216",127,88,88,0,0,"RECORTES CERO-GV-PCAS-TC",0
49,"49169",38,33,32,0,1,"RECORTES CERO-GV-PCAS-TC",0
24,"24068",430,289,281,0,8,"RECORTES CERO-GV-PCAS-TC",1
5,"5189",397,293,291,3,2,"RECORTES CERO-GV-PCAS-TC",0
42,"42059",20,14,14,0,0,"RECORTES CERO-GV-PCAS-TC",0
9,"9905",373,239,238,2,1,"RECORTES CERO-GV-PCAS-TC",0
16,"16139",317,226,222,1,4,"RECORTES CERO-GV-PCAS-TC",0
37,"37038",756,531,517,4,14,"RECORTES CERO-GV-PCAS-TC",0
42,"42025",1125,741,732,12,9,"RECORTES CERO-GV-PCAS-TC",2
16,"16081",50,37,36,0,1,"RECORTES CERO-GV-PCAS-TC",0
9,"9168",270,211,210,5,1,"RECORTES CERO-GV-PCAS-TC",0
24,"24046",893,595,583,6,12,"RECORTES CERO-GV-PCAS-TC",0
40,"40073",387,327,323,1,4,"RECORTES CERO-GV-PCAS-TC",0
34,"34077",395,282,278,7,4,"RECORTES CERO-GV-PCAS-TC",0
37,"37167",174,147,144,2,3,"RECORTES CERO-GV-PCAS-TC",0
5,"5149",101,72,71,2,1,"RECORTES CERO-GV-PCAS-TC",0
47,"47124",383,302,300,3,2,"RECORTES CERO-GV-PCAS-TC",0
2,"2004",597,459,455,3,4,"RECORTES CERO-GV-PCAS-TC",1
2,"2048",1173,912,901,9,11,"RECORTES CERO-GV-PCAS-TC",1
9,"9308",58,34,34,1,0,"RECORTES CERO-GV-PCAS-TC",0
47,"47197",875,659,656,9,3,"RECORTES CERO-GV-PCAS-TC",0
5,"5258",107,80,80,1,0,"RECORTES CERO-GV-PCAS-TC",0
45,"45162",630,448,438,1,10,"RECORTES CERO-GV-PCAS-TC",0
2,"2015",1432,1163,1148,8,15,"RECORTES CERO-GV-PCAS-TC",0
16,"16905",1302,951,934,10,17,"RECORTES CERO-GV-PCAS-TC",3
45,"45052",3132,2433,2416,29,17,"RECORTES CERO-GV-PCAS-TC",8
24,"24227",1527,1036,1032,13,4,"RECORTES CERO-GV-PCAS-TC",0
9,"9235",144,107,105,0,2,"RECORTES CERO-GV-PCAS-TC",0
19,"19332",85,59,57,4,2,"RECORTES CERO-GV-PCAS-TC",0
37,"37140",630,395,393,0,2,"RECORTES CERO-GV-PCAS-TC",0
49,"49047",98,74,72,1,2,"RECORTES CERO-GV-PCAS-TC",0
5,"5238",728,529,525,1,4,"RECORTES CERO-GV-PCAS-TC",0
47,"47075",4772,3557,3512,34,45,"RECORTES CERO-GV-PCAS-TC",6
5,"5171",67,49,47,0,2,"RECORTES CERO-GV-PCAS-TC",0
5,"5905",214,148,142,1,6,"RECORTES CERO-GV-PCAS-TC",0
5,"5261",32,25,25,0,0,"RECORTES CERO-GV-PCAS-TC",0
19,"19271",41,22,21,1,1,"RECORTES CERO-GV-PCAS-TC",0
40,"40157",39,30,30,0,0,"RECORTES CERO-GV-PCAS-TC",0
9,"9372",204,175,169,2,6,"RECORTES CERO-GV-PCAS-TC",0
5,"5142",88,76,75,0,1,"RECORTES CERO-GV-PCAS-TC",0
37,"37325",88,63,63,0,0,"RECORTES CERO-GV-PCAS-TC",0
45,"45191",524,437,432,2,5,"RECORTES CERO-GV-PCAS-TC",0
37,"37375",678,539,523,8,16,"RECORTES CERO-GV-PCAS-TC",1
37,"37001",165,120,120,0,0,"RECORTES CERO-GV-PCAS-TC",0
37,"37324",333,247,242,3,5,"RECORTES CERO-GV-PCAS-TC",0
19,"19163",60,49,49,0,0,"RECORTES CERO-GV-PCAS-TC",0
45,"45165",62598,43750,43259,329,491,"RECORTES CERO-GV-PCAS-TC",96
34,"34130",195,154,153,5,1,"RECORTES CERO-GV-PCAS-TC",0
34,"34028",132,95,92,2,3,"RECORTES CERO-GV-PCAS-TC",0
37,"37366",40,34,33,2,1,"RECORTES CERO-GV-PCAS-TC",0
47,"47035",901,659,653,4,6,"RECORTES CERO-GV-PCAS-TC",0
47,"47162",70,57,57,2,0,"RECORTES CERO-GV-PCAS-TC",0
24,"24002",224,165,162,1,3,"RECORTES CERO-GV-PCAS-TC",0
16,"16027",691,500,495,1,5,"RECORTES CERO-GV-PCAS-TC",0
5,"5089",455,342,324,0,18,"RECORTES CERO-GV-PCAS-TC",1
49,"49110",344,196,195,2,1,"RECORTES CERO-GV-PCAS-TC",0
16,"16143",15,10,10,1,0,"RECORTES CERO-GV-PCAS-TC",0
45,"45056",2341,1315,1295,11,20,"RECORTES CERO-GV-PCAS-TC",1
19,"19073",16,15,15,1,0,"RECORTES CERO-GV-PCAS-TC",0
19,"19256",46,36,36,0,0,"RECORTES CERO-GV-PCAS-TC",0
37,"37137",98,60,59,2,1,"RECORTES CERO-GV-PCAS-TC",0
40,"40008",42,36,36,1,0,"RECORTES CERO-GV-PCAS-TC",0
9,"9046",23,17,17,0,0,"RECORTES CERO-GV-PCAS-TC",0
9,"9314",90,75,75,2,0,"RECORTES CERO-GV-PCAS-TC",1
9,"9424",31,24,23,0,1,"RECORTES CERO-GV-PCAS-TC",0
28,"28003",167,133,131,4,2,"RECORTES CERO-GV-PCAS-TC",0
37,"37003",104,75,75,2,0,"RECORTES CERO-GV-PCAS-TC",0
5,"5100",260,193,192,3,1,"RECORTES CERO-GV-PCAS-TC",0
47,"47121",517,410,398,2,12,"RECORTES CERO-GV-PCAS-TC",1
40,"40146",260,206,204,0,2,"RECORTES CERO-GV-PCAS-TC",1
9,"9218",350,254,252,5,2,"RECORTES CERO-GV-PCAS-TC",0
34,"34050",187,136,136,1,0,"RECORTES CERO-GV-PCAS-TC",0
49,"49242",439,342,336,2,6,"RECORTES CERO-GV-PCAS-TC",0
28,"28152",16986,13444,13366,111,78,"RECORTES CERO-GV-PCAS-TC",14
16,"16140",18,14,14,1,0,"RECORTES CERO-GV-PCAS-TC",0
9,"9403",103,79,78,1,1,"RECORTES CERO-GV-PCAS-TC",0
16,"16029",104,76,74,0,2,"RECORTES CERO-GV-PCAS-TC",0
45,"45093",147,115,114,0,1,"RECORTES CERO-GV-PCAS-TC",1
49,"49068",422,263,261,4,2,"RECORTES CERO-GV-PCAS-TC",0
45,"45154",1491,1033,1024,11,9,"RECORTES CERO-GV-PCAS-TC",0
19,"19245",1138,798,778,6,20,"RECORTES CERO-GV-PCAS-TC",1
37,"37229",138,103,101,0,2,"RECORTES CERO-GV-PCAS-TC",0
34,"34163",46,37,37,0,0,"RECORTES CERO-GV-PCAS-TC",0
49,"49264",529,334,329,2,5,"RECORTES CERO-GV-PCAS-TC",1
9,"9325",177,103,101,2,2,"RECORTES CERO-GV-PCAS-TC",0
2,"2021",1013,806,798,6,8,"RECORTES CERO-GV-PCAS-TC",0
19,"19300",782,591,588,5,3,"RECORTES CERO-GV-PCAS-TC",0
47,"47224",93,75,75,1,0,"RECORTES CERO-GV-PCAS-TC",0
42,"42139",21,16,16,2,0,"RECORTES CERO-GV-PCAS-TC",0
19,"19261",33,23,23,0,0,"RECORTES CERO-GV-PCAS-TC",0
49,"49191",265,192,188,2,4,"RECORTES CERO-GV-PCAS-TC",0
28,"28138",60,43,42,0,1,"RECORTES CERO-GV-PCAS-TC",0
16,"16167",288,225,217,0,8,"RECORTES CERO-GV-PCAS-TC",0
34,"34221",168,129,127,2,2,"RECORTES CERO-GV-PCAS-TC",0
9,"9249",47,35,35,3,0,"RECORTES CERO-GV-PCAS-TC",0
37,"37255",43,33,31,1,2,"RECORTES CERO-GV-PCAS-TC",0
47,"47066",1482,1096,1086,14,10,"RECORTES CERO-GV-PCAS-TC",3
9,"9262",160,122,120,2,2,"RECORTES CERO-GV-PCAS-TC",0
49,"49114",40,31,27,0,4,"RECORTES CERO-GV-PCAS-TC",0
9,"9394",668,432,429,6,3,"RECORTES CERO-GV-PCAS-TC",0
9,"9079",47,38,38,0,0,"RECORTES CERO-GV-PCAS-TC",0
28,"28078",40,38,38,0,0,"RECORTES CERO-GV-PCAS-TC",0
37,"37202",1004,773,763,12,10,"RECORTES CERO-GV-PCAS-TC",0
28,"28112",160,129,129,0,0,"RECORTES CERO-GV-PCAS-TC",0
45,"45134",1622,1187,1177,8,10,"RECORTES CERO-GV-PCAS-TC",0
49,"49162",170,117,116,1,1,"RECORTES CERO-GV-PCAS-TC",0
28,"28027",1215,836,826,8,10,"RECORTES CERO-GV-PCAS-TC",2
19,"19052",21,16,16,0,0,"RECORTES CERO-GV-PCAS-TC",0
24,"24153",228,171,171,3,0,"RECORTES CERO-GV-PCAS-TC",0
16,"16234",23,17,17,0,0,"RECORTES CERO-GV-PCAS-TC",0
34,"34218",437,313,309,3,4,"RECORTES CERO-GV-PCAS-TC",2
9,"9258",165,128,127,0,1,"RECORTES CERO-GV-PCAS-TC",0
47,"47054",599,465,460,1,5,"RECORTES CERO-GV-PCAS-TC",1
47,"47114",3900,2549,2514,18,35,"RECORTES CERO-GV-PCAS-TC",6
34,"34041",82,64,64,3,0,"RECORTES CERO-GV-PCAS-TC",0
49,"49245",251,174,171,1,3,"RECORTES CERO-GV-PCAS-TC",0
45,"45039",201,157,157,0,0,"RECORTES CERO-GV-PCAS-TC",0
40,"40036",496,395,380,8,15,"RECORTES CERO-GV-PCAS-TC",0
37,"37209",415,276,275,2,1,"RECORTES CERO-GV-PCAS-TC",0
19,"19015",82,74,73,1,1,"RECORTES CERO-GV-PCAS-TC",0
28,"28060",1585,1160,1146,5,14,"RECORTES CERO-GV-PCAS-TC",0
37,"37321",150,118,115,0,3,"RECORTES CERO-GV-PCAS-TC",0
37,"37133",101,73,69,1,4,"RECORTES CERO-GV-PCAS-TC",0
47,"47188",98,73,70,0,3,"RECORTES CERO-GV-PCAS-TC",0
37,"37115",108,67,65,0,2,"RECORTES CERO-GV-PCAS-TC",0
49,"49040",109,89,87,2,2,"RECORTES CERO-GV-PCAS-TC",0
47,"47018",36,31,31,0,0,"RECORTES CERO-GV-PCAS-TC",0
16,"16254",199,159,159,0,0,"RECORTES CERO-GV-PCAS-TC",0
37,"37208",71,49,49,0,0,"RECORTES CERO-GV-PCAS-TC",0
19,"19215",135,109,109,0,0,"RECORTES CERO-GV-PCAS-TC",0
16,"16004",228,175,174,0,1,"RECORTES CERO-GV-PCAS-TC",0
19,"19089",23,17,17,0,0,"RECORTES CERO-GV-PCAS-TC",0
9,"9244",45,31,31,2,0,"RECORTES CERO-GV-PCAS-TC",0
24,"24217",135,93,93,0,0,"RECORTES CERO-GV-PCAS-TC",0
19,"19225",851,618,611,2,7,"RECORTES CERO-GV-PCAS-TC",1
45,"45055",1004,768,755,4,13,"RECORTES CERO-GV-PCAS-TC",1
42,"42022",206,147,146,6,1,"RECORTES CERO-GV-PCAS-TC",1
47,"47009",98,84,84,0,0,"RECORTES CERO-GV-PCAS-TC",0
49,"49165",55,52,52,1,0,"RECORTES CERO-GV-PCAS-TC",0
16,"16012",76,66,66,0,0,"RECORTES CERO-GV-PCAS-TC",0
9,"9164",147,112,111,0,1,"RECORTES CERO-GV-PCAS-TC",0
49,"49230",84,69,69,0,0,"RECORTES CERO-GV-PCAS-TC",0
16,"16013",26,24,24,0,0,"RECORTES CERO-GV-PCAS-TC",0
19,"19172",51,38,38,0,0,"RECORTES CERO-GV-PCAS-TC",1
49,"49189",186,104,104,1,0,"RECORTES CERO-GV-PCAS-TC",0
47,"47177",104,78,78,0,0,"RECORTES CERO-GV-PCAS-TC",0
37,"37333",203,125,124,2,1,"RECORTES CERO-GV-PCAS-TC",0
37,"37081",879,680,674,2,6,"RECORTES CERO-GV-PCAS-TC",0
37,"37224",189,156,153,2,3,"RECORTES CERO-GV-PCAS-TC",0
24,"24109",857,534,528,8,6,"RECORTES CERO-GV-PCAS-TC",1
28,"28125",3208,2275,2252,5,23,"RECORTES CERO-GV-PCAS-TC",4
37,"37144",327,233,233,2,0,"RECORTES CERO-GV-PCAS-TC",1
28,"28140",3156,2359,2331,16,28,"RECORTES CERO-GV-PCAS-TC",2
16,"16049",137,98,98,2,0,"RECORTES CERO-GV-PCAS-TC",0
9,"9024",150,100,99,1,1,"RECORTES CERO-GV-PCAS-TC",0
45,"45118",2124,1403,1380,8,23,"RECORTES CERO-GV-PCAS-TC",0
9,"9482",34,22,22,0,0,"RECORTES CERO-GV-PCAS-TC",1
13,"13003",448,329,319,1,10,"RECORTES CERO-GV-PCAS-TC",1
24,"24175",1821,1316,1305,15,11,"RECORTES CERO-GV-PCAS-TC",0
42,"42060",28,16,14,0,2,"RECORTES CERO-GV-PCAS-TC",0
49,"49176",605,360,353,0,7,"RECORTES CERO-GV-PCAS-TC",0
40,"40163",42,35,35,1,0,"RECORTES CERO-GV-PCAS-TC",3
5,"5054",1192,871,856,6,15,"RECORTES CERO-GV-PCAS-TC",1
2,"2051",1654,1115,1101,13,14,"RECORTES CERO-GV-PCAS-TC",0
37,"37271",349,262,258,2,4,"RECORTES CERO-GV-PCAS-TC",0
45,"45030",471,346,334,4,12,"RECORTES CERO-GV-PCAS-TC",0
24,"24021",1595,1037,1025,7,12,"RECORTES CERO-GV-PCAS-TC",0
49,"49097",67,44,44,0,0,"RECORTES CERO-GV-PCAS-TC",0
9,"9311",59,45,45,0,0,"RECORTES CERO-GV-PCAS-TC",0
37,"37261",213,153,149,0,4,"RECORTES CERO-GV-PCAS-TC",0
28,"28128",453,334,331,1,3,"RECORTES CERO-GV-PCAS-TC",0
19,"19331",2677,1892,1841,18,51,"RECORTES CERO-GV-PCAS-TC",3
16,"16238",461,380,378,1,2,"RECORTES CERO-GV-PCAS-TC",0
5,"5252",56,46,45,0,1,"RECORTES CERO-GV-PCAS-TC",0
47,"47078",157,114,107,0,7,"RECORTES CERO-GV-PCAS-TC",0
49,"49258",111,93,93,2,0,"RECORTES CERO-GV-PCAS-TC",0
40,"40190",43,37,35,0,2,"RECORTES CERO-GV-PCAS-TC",0
2,"2018",789,611,606,3,5,"RECORTES CERO-GV-PCAS-TC",0
37,"37158",230,149,149,1,0,"RECORTES CERO-GV-PCAS-TC",1
19,"19307",25,23,23,0,0,"RECORTES CERO-GV-PCAS-TC",0
37,"37147",184,126,124,1,2,"RECORTES CERO-GV-PCAS-TC",0
19,"19298",53,43,41,0,2,"RECORTES CERO-GV-PCAS-TC",0
42,"42129",678,485,480,6,5,"RECORTES CERO-GV-PCAS-TC",0
9,"9274",1035,774,762,8,12,"RECORTES CERO-GV-PCAS-TC",4
13,"13070",747,575,556,7,19,"RECORTES CERO-GV-PCAS-TC",0
42,"42176",27,21,21,0,0,"RECORTES CERO-GV-PCAS-TC",0
47,"47117",287,199,197,6,2,"RECORTES CERO-GV-PCAS-TC",0
37,"37198",202,147,144,2,3,"RECORTES CERO-GV-PCAS-TC",0
28,"28178",1149,869,853,4,16,"RECORTES CERO-GV-PCAS-TC",0
40,"40139",255,194,192,2,2,"RECORTES CERO-GV-PCAS-TC",1
13,"13010",872,615,601,3,14,"RECORTES CERO-GV-PCAS-TC",0
9,"9334",51,36,34,1,2,"RECORTES CERO-GV-PCAS-TC",0
42,"42079",21,17,17,1,0,"RECORTES CERO-GV-PCAS-TC",0
47,"47212",356,289,287,4,2,"RECORTES CERO-GV-PCAS-TC",0
37,"37304",156,97,96,1,1,"RECORTES CERO-GV-PCAS-TC",0
24,"24202",7504,4607,4538,51,69,"RECORTES CERO-GV-PCAS-TC",1
9,"9456",130,86,86,1,0,"RECORTES CERO-GV-PCAS-TC",0
47,"47033",205,151,150,2,1,"RECORTES CERO-GV-PCAS-TC",0
16,"16036",120,94,93,0,1,"RECORTES CERO-GV-PCAS-TC",0
19,"19260",38,27,27,1,0,"RECORTES CERO-GV-PCAS-TC",0
2,"2062",382,261,256,2,5,"RECORTES CERO-GV-PCAS-TC",0
9,"9297",310,233,233,6,0,"RECORTES CERO-GV-PCAS-TC",0
19,"19324",164,122,120,4,2,"RECORTES CERO-GV-PCAS-TC",0
19,"19092",395,286,279,2,7,"RECORTES CERO-GV-PCAS-TC",0
45,"45009",455,277,274,2,3,"RECORTES CERO-GV-PCAS-TC",1
9,"9301",658,497,488,5,9,"RECORTES CERO-GV-PCAS-TC",6
9,"9355",85,67,67,1,0,"RECORTES CERO-GV-PCAS-TC",0
37,"37021",66,45,44,0,1,"RECORTES CERO-GV-PCAS-TC",0
13,"13022",348,244,239,1,5,"RECORTES CERO-GV-PCAS-TC",1
45,"45164",166,143,142,1,1,"RECORTES CERO-GV-PCAS-TC",0
49,"49075",130,100,97,1,3,"RECORTES CERO-GV-PCAS-TC",0
45,"45092",223,193,190,1,3,"RECORTES CERO-GV-PCAS-TC",0
5,"5097",464,309,305,0,4,"RECORTES CERO-GV-PCAS-TC",0
24,"24066",439,274,273,3,1,"RECORTES CERO-GV-PCAS-TC",0
9,"9243",73,50,49,1,1,"RECORTES CERO-GV-PCAS-TC",0
19,"19166",154,110,108,0,2,"RECORTES CERO-GV-PCAS-TC",0
9,"9412",750,484,482,4,2,"RECORTES CERO-GV-PCAS-TC",0
5,"5080",42,30,30,0,0,"RECORTES CERO-GV-PCAS-TC",0
9,"9356",43,31,30,0,1,"RECORTES CERO-GV-PCAS-TC",0
24,"24014",7152,4494,4448,47,46,"RECORTES CERO-GV-PCAS-TC",1
16,"16148",544,452,451,2,1,"RECORTES CERO-GV-PCAS-TC",0
19,"19148",42,29,28,1,1,"RECORTES CERO-GV-PCAS-TC",0
45,"45109",2791,2123,2072,20,51,"RECORTES CERO-GV-PCAS-TC",1
16,"16020",9,5,5,1,0,"RECORTES CERO-GV-PCAS-TC",0
45,"45049",419,303,295,1,8,"RECORTES CERO-GV-PCAS-TC",0
5,"5151",83,60,60,0,0,"RECORTES CERO-GV-PCAS-TC",0
45,"45047",2694,1733,1706,24,27,"RECORTES CERO-GV-PCAS-TC",2
37,"37283",116,83,83,0,0,"RECORTES CERO-GV-PCAS-TC",0
9,"9093",162,131,131,1,0,"RECORTES CERO-GV-PCAS-TC",0
9,"9039",54,38,37,0,1,"RECORTES CERO-GV-PCAS-TC",0
9,"9009",158,127,124,5,3,"RECORTES CERO-GV-PCAS-TC",0
13,"13085",2265,1768,1735,5,33,"RECORTES CERO-GV-PCAS-TC",3
47,"47020",270,212,207,5,5,"RECORTES CERO-GV-PCAS-TC",0
16,"16101",137,111,109,1,2,"RECORTES CERO-GV-PCAS-TC",0
45,"45057",224,177,173,0,4,"RECORTES CERO-GV-PCAS-TC",0
5,"5154",31,23,23,0,0,"RECORTES CERO-GV-PCAS-TC",0
9,"9197",144,105,103,2,2,"RECORTES CERO-GV-PCAS-TC",0
5,"5160",289,220,213,0,7,"RECORTES CERO-GV-PCAS-TC",1
37,"37289",210,147,144,0,3,"RECORTES CERO-GV-PCAS-TC",0
37,"37217",59,43,43,3,0,"RECORTES CERO-GV-PCAS-TC",0
19,"19234",44,30,30,0,0,"RECORTES CERO-GV-PCAS-TC",0
5,"5253",75,54,54,0,0,"RECORTES CERO-GV-PCAS-TC",0
47,"47231",4439,3359,3323,36,36,"RECORTES CERO-GV-PCAS-TC",9
9,"9167",53,36,36,0,0,"RECORTES CERO-GV-PCAS-TC",0
34,"34171",928,572,562,2,10,"RECORTES CERO-GV-PCAS-TC",1
45,"45029",186,154,154,2,0,"RECORTES CERO-GV-PCAS-TC",0
40,"40212",26,19,19,1,0,"RECORTES CERO-GV-PCAS-TC",0
9,"9179",39,30,30,1,0,"RECORTES CERO-GV-PCAS-TC",0
9,"9127",52,36,35,0,1,"RECORTES CERO-GV-PCAS-TC",0
37,"37011",100,78,78,3,0,"RECORTES CERO-GV-PCAS-TC",0
45,"45103",363,286,283,0,3,"RECORTES CERO-GV-PCAS-TC",0
40,"40030",419,317,314,3,3,"RECORTES CERO-GV-PCAS-TC",0
5,"5237",153,125,123,0,2,"RECORTES CERO-GV-PCAS-TC",0
16,"16092",149,108,108,1,0,"RECORTES CERO-GV-PCAS-TC",0
45,"45024",1034,742,733,1,9,"RECORTES CERO-GV-PCAS-TC",0
19,"19080",67,47,47,0,0,"RECORTES CERO-GV-PCAS-TC",0
45,"45113",1770,1189,1171,5,18,"RECORTES CERO-GV-PCAS-TC",1
24,"24042",60,47,47,2,0,"RECORTES CERO-GV-PCAS-TC",0
45,"45076",574,361,357,1,4,"RECORTES CERO-GV-PCAS-TC",0
9,"9114",77,60,59,0,1,"RECORTES CERO-GV-PCAS-TC",0
37,"37301",84,64,64,1,0,"RECORTES CERO-GV-PCAS-TC",0
40,"40221",50,38,35,0,3,"RECORTES CERO-GV-PCAS-TC",0
47,"47219",39,31,28,1,3,"RECORTES CERO-GV-PCAS-TC",0
5,"5224",102,85,84,2,1,"RECORTES CERO-GV-PCAS-TC",0
37,"37023",1624,1233,1211,15,22,"RECORTES CERO-GV-PCAS-TC",1
49,"49137",167,123,121,0,2,"RECORTES CERO-GV-PCAS-TC",0
37,"37380",55,41,40,2,1,"RECORTES CERO-GV-PCAS-TC",0
34,"34178",119,94,91,0,3,"RECORTES CERO-GV-PCAS-TC",0
16,"16131",123,84,84,0,0,"RECORTES CERO-GV-PCAS-TC",0
19,"19050",15,13,13,0,0,"RECORTES CERO-GV-PCAS-TC",0
34,"34063",84,74,74,1,0,"RECORTES CERO-GV-PCAS-TC",0
37,"37263",339,215,210,0,5,"RECORTES CERO-GV-PCAS-TC",1
13,"13021",412,325,320,1,5,"RECORTES CERO-GV-PCAS-TC",0
45,"45007",656,502,497,0,5,"RECORTES CERO-GV-PCAS-TC",1
34,"34213",53,46,46,0,0,"RECORTES CERO-GV-PCAS-TC",0
24,"24034",3466,2382,2359,25,23,"RECORTES CERO-GV-PCAS-TC",1
5,"5124",87,67,67,2,0,"RECORTES CERO-GV-PCAS-TC",0
16,"16239",118,88,87,0,1,"RECORTES CERO-GV-PCAS-TC",0
16,"16113",3065,2142,2108,13,34,"RECORTES CERO-GV-PCAS-TC",4
28,"28032",5090,3716,3675,22,41,"RECORTES CERO-GV-PCAS-TC",10
5,"5235",141,97,97,2,0,"RECORTES CERO-GV-PCAS-TC",0
24,"24190",146,103,103,2,0,"RECORTES CERO-GV-PCAS-TC",1
16,"16196",589,490,476,3,14,"RECORTES CERO-GV-PCAS-TC",0
5,"5226",63,43,42,0,1,"RECORTES CERO-GV-PCAS-TC",0
47,"47130",94,64,63,0,1,"RECORTES CERO-GV-PCAS-TC",0
19,"19098",20,17,17,0,0,"RECORTES CERO-GV-PCAS-TC",0
5,"5245",353,262,256,0,6,"RECORTES CERO-GV-PCAS-TC",1
19,"19119",76,65,65,0,0,"RECORTES CERO-GV-PCAS-TC",0
47,"47222",85,70,70,1,0,"RECORTES CERO-GV-PCAS-TC",0
24,"24226",194,118,118,1,0,"RECORTES CERO-GV-PCAS-TC",0
5,"5181",46,34,34,0,0,"RECORTES CERO-GV-PCAS-TC",0
47,"47134",150,120,116,2,4,"RECORTES CERO-GV-PCAS-TC",0
37,"37330",314,227,223,2,4,"RECORTES CERO-GV-PCAS-TC",0
37,"37292",91,65,65,0,0,"RECORTES CERO-GV-PCAS-TC",0
5,"5213",94,72,70,0,2,"RECORTES CERO-GV-PCAS-TC",0
42,"42018",127,94,94,1,0,"RECORTES CERO-GV-PCAS-TC",0
19,"19194",91,69,69,0,0,"RECORTES CERO-GV-PCAS-TC",3
40,"40040",2489,1766,1744,26,22,"RECORTES CERO-GV-PCAS-TC",3
45,"45138",1058,813,802,5,11,"RECORTES CERO-GV-PCAS-TC",2
37,"37036",55,36,34,0,2,"RECORTES CERO-GV-PCAS-TC",0
37,"37252",99,65,65,1,0,"RECORTES CERO-GV-PCAS-TC",0
34,"34069",2184,1555,1517,17,38,"RECORTES CERO-GV-PCAS-TC",3
42,"42061",270,188,186,5,2,"RECORTES CERO-GV-PCAS-TC",0
47,"47135",82,65,65,3,0,"RECORTES CERO-GV-PCAS-TC",0
37,"37127",205,139,139,1,0,"RECORTES CERO-GV-PCAS-TC",0
9,"9140",117,78,77,1,1,"RECORTES CERO-GV-PCAS-TC",0
5,"5257",132,98,95,4,3,"RECORTES CERO-GV-PCAS-TC",0
45,"45018",550,385,380,1,5,"RECORTES CERO-GV-PCAS-TC",0
16,"16079",28,16,16,0,0,"RECORTES CERO-GV-PCAS-TC",0
5,"5117",191,155,153,1,2,"RECORTES CERO-GV-PCAS-TC",0
49,"49024",626,432,426,3,6,"RECORTES CERO-GV-PCAS-TC",0
16,"16161",51,44,44,1,0,"RECORTES CERO-GV-PCAS-TC",0
16,"16156",84,64,64,0,0,"RECORTES CERO-GV-PCAS-TC",0
13,"13029",89,67,65,0,2,"RECORTES CERO-GV-PCAS-TC",0
34,"34206",810,608,602,5,6,"RECORTES CERO-GV-PCAS-TC",0
47,"47040",56,42,41,0,1,"RECORTES CERO-GV-PCAS-TC",0
9,"9198",100,75,74,2,1,"RECORTES CERO-GV-PCAS-TC",0
9,"9038",109,87,86,1,1,"RECORTES CERO-GV-PCAS-TC",0
9,"9312",89,68,68,1,0,"RECORTES CERO-GV-PCAS-TC",1
24,"24009",274,136,135,1,1,"RECORTES CERO-GV-PCAS-TC",0
9,"9315",384,245,242,3,3,"RECORTES CERO-GV-PCAS-TC",0
34,"34180",68,54,54,1,0,"RECORTES CERO-GV-PCAS-TC",0
9,"9255",83,58,58,0,0,"RECORTES CERO-GV-PCAS-TC",0
24,"24177",467,265,263,2,2,"RECORTES CERO-GV-PCAS-TC",0
2,"2011",556,429,427,1,2,"RECORTES CERO-GV-PCAS-TC",0
24,"24166",1346,929,916,14,13,"RECORTES CERO-GV-PCAS-TC",0
42,"42095",1909,1345,1326,32,19,"RECORTES CERO-GV-PCAS-TC",3
40,"40026",112,101,99,0,2,"RECORTES CERO-GV-PCAS-TC",0
9,"9045",269,159,158,0,1,"RECORTES CERO-GV-PCAS-TC",0
47,"47139",997,728,719,4,9,"RECORTES CERO-GV-PCAS-TC",1
37,"37161",123,86,86,0,0,"RECORTES CERO-GV-PCAS-TC",0
47,"47006",182,149,145,1,4,"RECORTES CERO-GV-PCAS-TC",0
42,"42157",10,9,9,0,0,"RECORTES CERO-GV-PCAS-TC",0
19,"19060",157,123,122,0,1,"RECORTES CERO-GV-PCAS-TC",0
42,"42086",33,19,19,1,0,"RECORTES CERO-GV-PCAS-TC",0
47,"47081",39,32,32,0,0,"RECORTES CERO-GV-PCAS-TC",0
37,"37191",102,57,57,1,0,"RECORTES CERO-GV-PCAS-TC",0
45,"45150",428,322,319,3,3,"RECORTES CERO-GV-PCAS-TC",0
49,"49067",329,200,198,4,2,"RECORTES CERO-GV-PCAS-TC",0
9,"9418",73,54,51,0,3,"RECORTES CERO-GV-PCAS-TC",0
19,"19021",978,678,662,3,16,"RECORTES CERO-GV-PCAS-TC",0
42,"42053",21,17,17,0,0,"RECORTES CERO-GV-PCAS-TC",0
24,"24006",488,356,347,4,9,"RECORTES CERO-GV-PCAS-TC",0
37,"37019",138,111,109,0,2,"RECORTES CERO-GV-PCAS-TC",0
47,"47186",244314,182449,180833,1818,1616,"RECORTES CERO-GV-PCAS-TC",378
47,"47013",91,77,77,1,0,"RECORTES CERO-GV-PCAS-TC",0
45,"45019",7560,5216,5135,50,81,"RECORTES CERO-GV-PCAS-TC",11
16,"16097",139,117,116,0,1,"RECORTES CERO-GV-PCAS-TC",0
49,"49071",716,432,429,6,3,"RECORTES CERO-GV-PCAS-TC",0
49,"49061",143,98,97,1,1,"RECORTES CERO-GV-PCAS-TC",0
19,"19181",50,34,34,0,0,"RECORTES CERO-GV-PCAS-TC",0
40,"40172",47,33,32,0,1,"RECORTES CERO-GV-PCAS-TC",0
28,"28115",62612,50619,50431,399,188,"RECORTES CERO-GV-PCAS-TC",50
9,"9363",906,660,655,5,5,"RECORTES CERO-GV-PCAS-TC",4
34,"34046",43,29,29,0,0,"RECORTES CERO-GV-PCAS-TC",0
40,"40223",235,177,174,1,3,"RECORTES CERO-GV-PCAS-TC",0
28,"28170",2495,1714,1695,13,19,"RECORTES CERO-GV-PCAS-TC",2
28,"28016",79,55,55,0,0,"RECORTES CERO-GV-PCAS-TC",1
37,"37047",215,89,89,0,0,"RECORTES CERO-GV-PCAS-TC",1
40,"40087",85,70,70,0,0,"RECORTES CERO-GV-PCAS-TC",0
40,"40229",26,22,22,0,0,"RECORTES CERO-GV-PCAS-TC",0
34,"34038",259,183,178,0,5,"RECORTES CERO-GV-PCAS-TC",0
9,"9303",73,58,58,0,0,"RECORTES CERO-GV-PCAS-TC",0
13,"13053",14031,9930,9796,97,134,"RECORTES CERO-GV-PCAS-TC",24
19,"19321",34,28,28,0,0,"RECORTES CERO-GV-PCAS-TC",0
47,"47232",96,67,65,0,2,"RECORTES CERO-GV-PCAS-TC",0
45,"45040",1247,727,715,3,12,"RECORTES CERO-GV-PCAS-TC",0
16,"16126",720,552,545,3,7,"RECORTES CERO-GV-PCAS-TC",1
9,"9422",19,13,13,0,0,"RECORTES CERO-GV-PCAS-TC",0
42,"42185",24,20,20,0,0,"RECORTES CERO-GV-PCAS-TC",0
37,"37343",66,44,43,1,1,"RECORTES CERO-GV-PCAS-TC",0
42,"42078",1000,653,640,5,13,"RECORTES CERO-GV-PCAS-TC",0
9,"9433",52,40,40,0,0,"RECORTES CERO-GV-PCAS-TC",0
5,"5041",984,743,732,5,11,"RECORTES CERO-GV-PCAS-TC",0
24,"24095",317,228,228,3,0,"RECORTES CERO-GV-PCAS-TC",1
13,"13075",196,147,146,2,1,"RECORTES CERO-GV-PCAS-TC",0
5,"5040",64,47,46,0,1,"RECORTES CERO-GV-PCAS-TC",0
45,"45101",3671,2842,2808,13,34,"RECORTES CERO-GV-PCAS-TC",0
19,"19175",29,18,17,1,1,"RECORTES CERO-GV-PCAS-TC",0
5,"5163",1702,1258,1233,5,25,"RECORTES CERO-GV-PCAS-TC",0
37,"37154",129,97,94,1,3,"RECORTES CERO-GV-PCAS-TC",0
28,"28135",998,712,703,2,9,"RECORTES CERO-GV-PCAS-TC",0
47,"47168",30,26,26,1,0,"RECORTES CERO-GV-PCAS-TC",0
37,"37136",625,388,387,7,1,"RECORTES CERO-GV-PCAS-TC",1
16,"16155",490,389,388,7,1,"RECORTES CERO-GV-PCAS-TC",1
37,"37032",553,388,388,2,0,"RECORTES CERO-GV-PCAS-TC",0
19,"19329",58,46,46,0,0,"RECORTES CERO-GV-PCAS-TC",0
34,"34214",176,121,120,1,1,"RECORTES CERO-GV-PCAS-TC",1
49,"49234",394,282,277,0,5,"RECORTES CERO-GV-PCAS-TC",0
16,"16151",61,51,51,1,0,"RECORTES CERO-GV-PCAS-TC",0
45,"45091",376,270,269,3,1,"RECORTES CERO-GV-PCAS-TC",0
19,"19023",119,87,85,0,2,"RECORTES CERO-GV-PCAS-TC",0
19,"19151",1077,703,693,8,10,"RECORTES CERO-GV-PCAS-TC",0
49,"49099",96,67,67,0,0,"RECORTES CERO-GV-PCAS-TC",0
28,"28020",193,96,93,0,3,"RECORTES CERO-GV-PCAS-TC",0
24,"24218",451,310,308,3,2,"RECORTES CERO-GV-PCAS-TC",0
40,"40195",776,573,565,4,8,"RECORTES CERO-GV-PCAS-TC",0
16,"16903",992,750,732,8,18,"RECORTES CERO-GV-PCAS-TC",0
13,"13013",7056,5041,4945,52,96,"RECORTES CERO-GV-PCAS-TC",10
45,"45027",315,249,246,2,3,"RECORTES CERO-GV-PCAS-TC",0
37,"37242",82,59,59,1,0,"RECORTES CERO-GV-PCAS-TC",0
16,"16033",1633,1199,1174,8,25,"RECORTES CERO-GV-PCAS-TC",0
28,"28100",4482,3146,3113,21,33,"RECORTES CERO-GV-PCAS-TC",1
40,"40107",90,67,67,0,0,"RECORTES CERO-GV-PCAS-TC",0
16,"16005",234,163,160,1,3,"RECORTES CERO-GV-PCAS-TC",1
9,"9328",70,37,37,3,0,"RECORTES CERO-GV-PCAS-TC",1
5,"5021",1861,1323,1304,22,19,"RECORTES CERO-GV-PCAS-TC",2
9,"9444",63,40,40,1,0,"RECORTES CERO-GV-PCAS-TC",0
19,"19154",58,45,45,0,0,"RECORTES CERO-GV-PCAS-TC",0
40,"40160",93,65,62,0,3,"RECORTES CERO-GV-PCAS-TC",0
19,"19097",14,14,13,0,1,"RECORTES CERO-GV-PCAS-TC",0
47,"47073",116,80,79,2,1,"RECORTES CERO-GV-PCAS-TC",0
9,"9075",104,82,82,0,0,"RECORTES CERO-GV-PCAS-TC",0
19,"19235",98,77,76,1,1,"RECORTES CERO-GV-PCAS-TC",0
47,"47037",161,128,125,1,3,"RECORTES CERO-GV-PCAS-TC",0
9,"9232",139,100,97,1,3,"RECORTES CERO-GV-PCAS-TC",0
40,"40224",18,15,15,0,0,"RECORTES CERO-GV-PCAS-TC",0
34,"34169",371,263,259,5,4,"RECORTES CERO-GV-PCAS-TC",1
40,"40135",277,212,210,3,2,"RECORTES CERO-GV-PCAS-TC",0
45,"45179",493,362,357,5,5,"RECORTES CERO-GV-PCAS-TC",0
45,"45121",7345,4949,4899,24,50,"RECORTES CERO-GV-PCAS-TC",11
9,"9288",87,64,64,0,0,"RECORTES CERO-GV-PCAS-TC",0
13,"13095",66,56,56,3,0,"RECORTES CERO-GV-PCAS-TC",0
16,"16001",62,45,45,0,0,"RECORTES CERO-GV-PCAS-TC",0
45,"45064",3987,2918,2880,33,38,"RECORTES CERO-GV-PCAS-TC",5
45,"45125",2256,1711,1689,16,22,"RECORTES CERO-GV-PCAS-TC",6
5,"5184",238,163,160,2,3,"RECORTES CERO-GV-PCAS-TC",0
47,"47098",567,452,446,4,6,"RECORTES CERO-GV-PCAS-TC",0
37,"37052",287,192,191,2,1,"RECORTES CERO-GV-PCAS-TC",0
19,"19116",12,10,10,0,0,"RECORTES CERO-GV-PCAS-TC",0
16,"16057",62,45,45,0,0,"RECORTES CERO-GV-PCAS-TC",0
42,"42044",53,37,35,1,2,"RECORTES CERO-GV-PCAS-TC",0
16,"16117",1018,723,715,9,8,"RECORTES CERO-GV-PCAS-TC",0
5,"5065",452,339,337,2,2,"RECORTES CERO-GV-PCAS-TC",1
40,"40016",55,44,43,1,1,"RECORTES CERO-GV-PCAS-TC",0
24,"24079",861,601,595,9,6,"RECORTES CERO-GV-PCAS-TC",1
37,"37104",24,16,16,0,0,"RECORTES CERO-GV-PCAS-TC",0
47,"47229",221,150,149,0,1,"RECORTES CERO-GV-PCAS-TC",0
24,"24187",834,559,549,11,10,"RECORTES CERO-GV-PCAS-TC",0
45,"45048",360,276,271,2,5,"RECORTES CERO-GV-PCAS-TC",2
19,"19081",27,21,21,0,0,"RECORTES CERO-GV-PCAS-TC",0
9,"9071",39,29,29,1,0,"RECORTES CERO-GV-PCAS-TC",0
45,"45081",19268,13690,13516,104,174,"RECORTES CERO-GV-PCAS-TC",34
19,"19308",57,49,49,0,0,"RECORTES CERO-GV-PCAS-TC",0
24,"24114",2866,1753,1742,15,11,"RECORTES CERO-GV-PCAS-TC",0
19,"19095",11,7,6,0,1,"RECORTES CERO-GV-PCAS-TC",0
13,"13004",976,698,694,6,4,"RECORTES CERO-GV-PCAS-TC",0
42,"42153",12,10,10,0,0,"RECORTES CERO-GV-PCAS-TC",0
19,"19087",17,16,16,0,0,"RECORTES CERO-GV-PCAS-TC",1
40,"40199",101,76,72,2,4,"RECORTES CERO-GV-PCAS-TC",0
5,"5016",6355,4677,4584,28,93,"RECORTES CERO-GV-PCAS-TC",9
34,"34175",87,67,66,1,1,"RECORTES CERO-GV-PCAS-TC",0
37,"37232",377,303,303,2,0,"RECORTES CERO-GV-PCAS-TC",0
9,"9302",96,66,66,0,0,"RECORTES CERO-GV-PCAS-TC",1
9,"9201",27,17,17,0,0,"RECORTES CERO-GV-PCAS-TC",0
37,"37056",39,28,28,0,0,"RECORTES CERO-GV-PCAS-TC",0
49,"49126",260,153,150,1,3,"RECORTES CERO-GV-PCAS-TC",0
19,"19055",44,32,31,2,1,"RECORTES CERO-GV-PCAS-TC",0
13,"13065",2777,1766,1728,10,38,"RECORTES CERO-GV-PCAS-TC",3
45,"45149",517,400,393,2,7,"RECORTES CERO-GV-PCAS-TC",0
45,"45161",15469,10281,10167,68,114,"RECORTES CERO-GV-PCAS-TC",27
24,"24106",218,139,139,1,0,"RECORTES CERO-GV-PCAS-TC",0
19,"19191",13,12,12,0,0,"RECORTES CERO-GV-PCAS-TC",0
28,"28104",15528,12342,12234,103,108,"RECORTES CERO-GV-PCAS-TC",16
47,"47063",86,68,68,0,0,"RECORTES CERO-GV-PCAS-TC",1
13,"13007",1219,871,852,4,19,"RECORTES CERO-GV-PCAS-TC",0
16,"16040",91,76,76,2,0,"RECORTES CERO-GV-PCAS-TC",0
28,"28030",1832,1319,1297,13,22,"RECORTES CERO-GV-PCAS-TC",5
40,"40233",399,279,273,0,6,"RECORTES CERO-GV-PCAS-TC",1
5,"5177",136,117,116,0,1,"RECORTES CERO-GV-PCAS-TC",1
47,"47019",92,68,68,1,0,"RECORTES CERO-GV-PCAS-TC",0
24,"24229",376,275,269,2,6,"RECORTES CERO-GV-PCAS-TC",0
34,"34019",111,87,86,1,1,"RECORTES CERO-GV-PCAS-TC",0
24,"24102",587,403,399,7,4,"RECORTES CERO-GV-PCAS-TC",1
19,"19125",45,23,23,0,0,"RECORTES CERO-GV-PCAS-TC",0
47,"47030",935,680,669,5,11,"RECORTES CERO-GV-PCAS-TC",0
42,"42204",53,37,35,1,2,"RECORTES CERO-GV-PCAS-TC",0
23,"23038",3786,2934,2900,21,34,"RISA",4
23,"23069",5240,4153,4065,26,88,"RISA",4
23,"23902",2219,1813,1770,6,43,"RISA",0
23,"23086",11427,7984,7735,81,249,"RISA",5
23,"23012",4004,2726,2689,21,37,"RISA",1
23,"23094",3739,2920,2876,29,44,"RISA",2
23,"23033",1325,1008,989,11,19,"RISA",0
23,"23039",2170,1502,1460,10,42,"RISA",0
23,"23063",3784,2699,2664,22,35,"RISA",1
23,"23056",3052,2279,2207,26,72,"RISA",0
23,"23072",1879,1389,1363,3,26,"RISA",0
23,"23084",902,627,621,4,6,"RISA",1
23,"23005",29876,20565,20268,254,297,"RISA",24
23,"23080",1720,1313,1294,6,19,"RISA",1
23,"23079",3624,2661,2630,19,31,"RISA",1
23,"23091",675,516,512,1,4,"RISA",0
23,"23017",1498,1153,1129,11,24,"RISA",0
23,"23093",3119,2264,2216,24,48,"RISA",1
23,"23031",764,660,640,6,20,"RISA",0
23,"23002",17427,12837,12542,126,295,"RISA",9
23,"23049",1740,1215,1183,12,32,"RISA",0
23,"23026",3431,2430,2375,25,55,"RISA",0
23,"23053",9451,6038,5975,60,63,"RISA",2
23,"23052",1094,920,896,6,24,"RISA",0
23,"23007",3015,2252,2229,14,23,"RISA",1
23,"23901",1125,905,895,3,10,"RISA",0
23,"23035",1111,877,856,2,21,"RISA",1
23,"23060",19210,13677,13495,145,182,"RISA",10
23,"23032",529,427,419,5,8,"RISA",0
23,"23062",1410,1094,1076,0,18,"RISA",0
23,"23001",912,723,712,2,11,"RISA",0
23,"23085",2171,1587,1575,7,12,"RISA",0
23,"23008",1422,1042,1020,9,22,"RISA",0
23,"23021",512,406,399,2,7,"RISA",0
23,"23905",1828,1320,1302,12,18,"RISA",1
23,"23045",2054,1423,1412,10,11,"RISA",0
23,"23904",2570,1583,1562,10,21,"RISA",0
23,"23059",5736,4245,4119,51,126,"RISA",2
23,"23043",517,360,360,1,0,"RISA",1
23,"23011",2138,1536,1507,17,29,"RISA",1
23,"23097",6346,4243,4194,31,49,"RISA",0
23,"23066",4274,3517,3460,16,57,"RISA",3
23,"23028",6103,4369,4286,26,83,"RISA",3
23,"23090",1204,953,938,6,15,"RISA",0
23,"23081",1494,1084,1061,9,23,"RISA",1
23,"23040",1438,1175,1159,3,16,"RISA",1
23,"23034",2480,1923,1882,15,41,"RISA",2
23,"23046",2334,1880,1855,9,25,"RISA",0
23,"23042",292,219,219,0,0,"RISA",0
23,"23070",3813,2384,2354,11,30,"RISA",0
23,"23076",774,606,595,6,11,"RISA",0
23,"23006",4582,3536,3461,43,75,"RISA",2
23,"23096",2543,2029,1986,16,43,"RISA",0
23,"23903",3498,2633,2601,28,32,"RISA",2
23,"23048",817,605,599,4,6,"RISA",0
23,"23067",2405,1765,1724,14,41,"RISA",0
23,"23050",90664,65260,64519,581,741,"RISA",48
23,"23020",1510,1263,1253,16,10,"RISA",0
23,"23015",1316,979,973,18,6,"RISA",0
23,"23037",518,403,398,10,5,"RISA",0
23,"23101",351,238,238,3,0,"RISA",0
23,"23003",8639,6296,6226,41,70,"RISA",7
23,"23030",1207,998,977,7,21,"RISA",0
23,"23087",11169,8193,8045,79,148,"RISA",4
23,"23098",847,704,700,0,4,"RISA",0
23,"23009",12849,9722,9572,99,150,"RISA",4
23,"23019",1466,1117,1090,5,27,"RISA",2
23,"23082",1850,1292,1279,13,13,"RISA",0
23,"23092",27717,19749,19490,217,259,"RISA",9
23,"23024",12215,8702,8447,69,255,"RISA",10
23,"23027",711,547,539,5,8,"RISA",0
23,"23004",407,321,315,2,6,"RISA",0
23,"23016",386,313,305,4,8,"RISA",0
23,"23029",798,595,590,0,5,"RISA",1
23,"23051",2736,2066,2021,16,45,"RISA",0
23,"23099",4824,3523,3435,35,88,"RISA",1
23,"23088",6017,4529,4427,61,102,"RISA",6
23,"23014",2535,1890,1861,28,29,"RISA",1
23,"23010",14264,9801,9635,120,166,"RISA",6
23,"23077",604,482,477,2,5,"RISA",0
23,"23025",2725,1894,1870,11,24,"RISA",0
23,"23065",1530,1068,1054,7,14,"RISA",0
23,"23047",1558,1203,1186,8,17,"RISA",1
23,"23071",1704,1278,1258,10,20,"RISA",1
23,"23095",8571,6159,6101,37,58,"RISA",0
23,"23073",4363,3214,3176,24,38,"RISA",5
23,"23055",46314,30950,30506,279,444,"RISA",23
23,"23075",3222,2513,2475,19,38,"RISA",2
23,"23044",4697,3495,3400,31,95,"RISA",2
23,"23041",489,378,376,1,2,"RISA",1
23,"23018",2243,1606,1584,17,22,"RISA",0
23,"23058",8832,6528,6407,57,121,"RISA",3
23,"23064",1669,1311,1296,9,15,"RISA",0
23,"23054",375,280,272,1,8,"RISA",0
23,"23057",727,582,572,7,10,"RISA",0
23,"23074",2984,2271,2236,20,35,"RISA",0
23,"23061",7711,5357,5231,44,126,"RISA",5
48,"48901",5160,3705,3684,16,21,"SOLIDARIA",1
48,"48020",272771,184893,183922,1227,971,"SOLIDARIA",85
48,"48031",303,221,221,0,0,"SOLIDARIA",0
48,"48010",476,343,343,1,0,"SOLIDARIA",0
48,"48081",1903,1455,1447,7,8,"SOLIDARIA",1
48,"48001",5899,4094,4074,19,20,"SOLIDARIA",1
48,"48025",874,667,662,2,5,"SOLIDARIA",0
48,"48910",2811,1952,1942,11,10,"SOLIDARIA",0
48,"48070",527,357,355,0,2,"SOLIDARIA",0
48,"48038",1151,829,829,1,0,"SOLIDARIA",1
48,"48051",220,151,150,0,1,"SOLIDARIA",0
48,"48054",25063,17705,17597,122,108,"SOLIDARIA",5
48,"48096",6516,4862,4816,33,46,"SOLIDARIA",2
48,"48085",10716,7707,7679,51,28,"SOLIDARIA",2
48,"48053",926,704,702,6,2,"SOLIDARIA",0
48,"48907",343,274,273,0,1,"SOLIDARIA",0
48,"48094",3121,2201,2188,7,13,"SOLIDARIA",0
48,"48084",21780,14368,14271,79,97,"SOLIDARIA",3
48,"48011",9640,6753,6722,41,31,"SOLIDARIA",5
48,"48091",1078,758,757,5,1,"SOLIDARIA",0
48,"48043",4591,3337,3325,20,12,"SOLIDARIA",0
48,"48013",79353,53591,53205,331,386,"SOLIDARIA",26
48,"48015",33077,22441,22295,145,146,"SOLIDARIA",6
48,"48035",406,314,314,0,0,"SOLIDARIA",0
48,"48029",8681,6057,6027,41,30,"SOLIDARIA",2
48,"48033",217,162,162,1,0,"SOLIDARIA",0
48,"48086",2024,1371,1358,5,13,"SOLIDARIA",0
48,"48902",18987,12762,12670,88,92,"SOLIDARIA",20
48,"48019",3429,2424,2411,14,13,"SOLIDARIA",0
48,"48041",687,548,547,4,1,"SOLIDARIA",0
48,"48012",2057,1610,1600,1,10,"SOLIDARIA",2
48,"48026",1132,834,832,2,2,"SOLIDARIA",0
48,"48023",579,451,448,0,3,"SOLIDARIA",0
48,"48030",591,449,447,2,2,"SOLIDARIA",0
48,"48057",5730,4126,4115,14,11,"SOLIDARIA",1
48,"48018",854,563,560,5,3,"SOLIDARIA",0
48,"48915",339,245,243,0,2,"SOLIDARIA",0
48,"48024",1000,761,752,1,9,"SOLIDARIA",0
48,"48039",254,221,220,2,1,"SOLIDARIA",0
48,"48004",326,245,245,1,0,"SOLIDARIA",0
48,"48075",2066,1524,1508,9,16,"SOLIDARIA",0
48,"48009",774,585,578,0,7,"SOLIDARIA",0
48,"48082",37358,25328,25167,125,161,"SOLIDARIA",8
48,"48063",354,256,252,1,4,"SOLIDARIA",0
48,"48087",437,335,332,0,3,"SOLIDARIA",0
48,"48047",147,105,105,2,0,"SOLIDARIA",0
48,"48065",3285,2341,2326,8,15,"SOLIDARIA",0
48,"48028",682,551,548,3,3,"SOLIDARIA",0
48,"48083",6934,4800,4765,21,35,"SOLIDARIA",1
48,"48092",872,614,608,3,6,"SOLIDARIA",0
48,"48911",381,303,302,1,1,"SOLIDARIA",0
48,"48040",1303,933,926,7,7,"SOLIDARIA",0
48,"48062",295,236,236,0,0,"SOLIDARIA",0
48,"48017",13121,8929,8886,45,43,"SOLIDARIA",3
48,"48007",389,243,243,0,0,"SOLIDARIA",0
48,"48906",736,550,548,2,2,"SOLIDARIA",1
48,"48912",2321,1684,1670,8,14,"SOLIDARIA",1
48,"48067",1133,810,805,0,5,"SOLIDARIA",0
48,"48074",3275,2308,2295,11,13,"SOLIDARIA",2
48,"48042",1359,1055,1045,7,10,"SOLIDARIA",0
48,"48058",947,682,679,2,3,"SOLIDARIA",0
48,"48908",250,212,210,1,2,"SOLIDARIA",0
48,"48905",2496,1778,1766,12,12,"SOLIDARIA",1
48,"48913",1236,899,890,8,9,"SOLIDARIA",0
48,"48073",6827,4614,4591,38,23,"SOLIDARIA",0
48,"48904",3547,2563,2541,18,22,"SOLIDARIA",1
48,"48003",14518,10375,10310,49,65,"SOLIDARIA",4
48,"48016",5471,3964,3935,31,29,"SOLIDARIA",1
48,"48005",116,80,79,0,1,"SOLIDARIA",0
48,"48008",609,415,407,4,8,"SOLIDARIA",0
48,"48097",1314,886,882,6,4,"SOLIDARIA",0
48,"48045",5207,3851,3817,9,34,"SOLIDARIA",3
48,"48061",789,602,601,2,1,"SOLIDARIA",0
48,"48093",891,669,666,5,3,"SOLIDARIA",0
48,"48089",3540,2561,2555,7,6,"SOLIDARIA",1
48,"48002",7791,5510,5471,42,39,"SOLIDARIA",0
48,"48077",3366,2483,2467,9,16,"SOLIDARIA",1
48,"48059",402,299,297,0,2,"SOLIDARIA",0
48,"48095",2324,1568,1555,13,13,"SOLIDARIA",0
48,"48050",188,141,141,0,0,"SOLIDARIA",0
48,"48048",527,381,380,3,1,"SOLIDARIA",0
48,"48072",965,730,724,3,6,"SOLIDARIA",0
48,"48036",24015,16501,16425,83,76,"SOLIDARIA",8
48,"48079",397,289,287,1,2,"SOLIDARIA",0
48,"48056",980,731,728,3,3,"SOLIDARIA",0
48,"48014",1229,845,843,8,2,"SOLIDARIA",0
48,"48027",22745,16240,16158,74,82,"SOLIDARIA",7
48,"48034",12623,8789,8711,76,78,"SOLIDARIA",5
48,"48064",608,461,461,0,0,"SOLIDARIA",0
48,"48080",9916,6849,6793,44,56,"SOLIDARIA",0
48,"48060",3625,2429,2418,12,11,"SOLIDARIA",0
48,"48914",332,276,275,0,1,"SOLIDARIA",0
48,"48069",13131,9211,9162,55,49,"SOLIDARIA",2
48,"48078",37858,25959,25819,157,140,"SOLIDARIA",11
48,"48066",344,246,246,2,0,"SOLIDARIA",0
48,"48090",6004,4305,4254,28,51,"SOLIDARIA",1
48,"48088",134,95,95,0,0,"SOLIDARIA",0
48,"48076",288,211,211,1,0,"SOLIDARIA",0
48,"48068",1534,1154,1149,1,5,"SOLIDARIA",1
48,"48022",2305,1434,1425,11,9,"SOLIDARIA",0
48,"48046",12626,9300,9250,31,50,"SOLIDARIA",9
48,"48052",1562,1220,1210,5,10,"SOLIDARIA",0
48,"48021",1325,891,888,3,3,"SOLIDARIA",0
48,"48006",307,242,240,3,2,"SOLIDARIA",1
48,"48032",5762,4287,4262,14,25,"SOLIDARIA",0
48,"48071",6013,4240,4205,23,35,"SOLIDARIA",0
48,"48055",2603,1833,1820,14,13,"SOLIDARIA",0
48,"48037",696,497,485,0,12,"SOLIDARIA",0
48,"48044",61957,45253,45063,299,190,"SOLIDARIA",25
48,"48049",543,415,414,1,1,"SOLIDARIA",0
48,"48909",201,158,157,0,1,"SOLIDARIA",0
48,"48903",1800,1358,1353,4,5,"SOLIDARIA",1
30,"30014",1587,1150,1134,4,16,"SOMOS REGIÓ",0
30,"30028",6390,4054,3973,25,81,"SOMOS REGIÓ",7
30,"30022",17108,11041,10851,100,190,"SOMOS REGIÓ",32
30,"30038",15752,10987,10904,39,83,"SOMOS REGIÓ",22
30,"30041",14040,8999,8876,94,123,"SOMOS REGIÓ",29
30,"30039",20442,13299,13167,84,132,"SOMOS REGIÓ",35
30,"30016",153034,101232,100202,776,1030,"SOMOS REGIÓ",292
30,"30013",7421,5171,5094,32,77,"SOMOS REGIÓ",3
30,"30031",497,387,382,1,5,"SOMOS REGIÓ",1
30,"30024",60389,42200,41831,281,369,"SOMOS REGIÓ",141
30,"30025",5016,3663,3623,22,40,"SOMOS REGIÓ",3
30,"30007",6474,4354,4317,26,37,"SOMOS REGIÓ",5
30,"30034",1067,818,801,8,17,"SOMOS REGIÓ",0
30,"30033",10377,7330,7215,59,115,"SOMOS REGIÓ",21
30,"30017",11428,8196,8113,44,83,"SOMOS REGIÓ",9
30,"30001",4507,3357,3331,17,26,"SOMOS REGIÓ",14
30,"30040",686,564,560,1,4,"SOMOS REGIÓ",2
30,"30015",19344,13502,13347,107,155,"SOMOS REGIÓ",11
30,"30030",321454,235061,233183,1744,1878,"SOMOS REGIÓ",1079
30,"30011",4702,3390,3324,8,66,"SOMOS REGIÓ",7
30,"30009",12728,9487,9365,46,122,"SOMOS REGIÓ",20
30,"30005",30268,20979,20778,148,201,"SOMOS REGIÓ",87
30,"30012",9085,6704,6599,46,105,"SOMOS REGIÓ",6
30,"30004",1129,838,833,1,5,"SOMOS REGIÓ",0
30,"30020",6503,4521,4484,35,37,"SOMOS REGIÓ",2
30,"30002",9701,6794,6717,27,77,"SOMOS REGIÓ",17
30,"30026",16345,10049,9914,84,135,"SOMOS REGIÓ",12
30,"30021",9498,6251,6193,36,58,"SOMOS REGIÓ",11
30,"30003",25200,16249,16120,159,129,"SOMOS REGIÓ",14
30,"30032",2864,2154,2129,18,25,"SOMOS REGIÓ",3
30,"30037",19407,13252,13120,99,132,"SOMOS REGIÓ",73
30,"30036",15432,10030,9879,64,151,"SOMOS REGIÓ",17
30,"30023",3874,2831,2788,18,43,"SOMOS REGIÓ",9
30,"30010",6852,5161,5106,25,55,"SOMOS REGIÓ",14
30,"30027",50067,36417,36074,242,343,"SOMOS REGIÓ",91
30,"30901",10556,7862,7775,58,87,"SOMOS REGIÓ",19
30,"30018",8399,6226,6148,28,78,"SOMOS REGIÓ",11
30,"30043",25449,18839,18477,180,362,"SOMOS REGIÓ",9
30,"30008",14560,9974,9840,79,134,"SOMOS REGIÓ",30
30,"30042",2218,1645,1625,10,20,"SOMOS REGIÓ",3
30,"30902",8294,5235,5174,29,61,"SOMOS REGIÓ",8
30,"30019",25911,17485,17264,157,221,"SOMOS REGIÓ",44
30,"30029",12122,8231,8125,54,106,"SOMOS REGIÓ",12
30,"30035",19432,13174,13013,114,161,"SOMOS REGIÓ",80
30,"30006",833,699,695,1,4,"SOMOS REGIÓ",0
44,"44041",60,48,48,0,0,"¡TERUEL EXI",11
44,"44258",53,46,46,0,0,"¡TERUEL EXI",7
44,"44007",149,112,111,1,1,"¡TERUEL EXI",21
44,"44010",185,144,143,0,1,"¡TERUEL EXI",14
44,"44157",61,37,37,0,0,"¡TERUEL EXI",8
44,"44149",99,74,73,4,1,"¡TERUEL EXI",12
44,"44246",1599,1012,1001,11,11,"¡TERUEL EXI",127
44,"44173",103,81,79,0,2,"¡TERUEL EXI",23
44,"44232",364,255,255,3,0,"¡TERUEL EXI",82
44,"44002",47,41,41,0,0,"¡TERUEL EXI",0
44,"44070",55,49,49,0,0,"¡TERUEL EXI",7
44,"44243",25,19,19,0,0,"¡TERUEL EXI",4
44,"44229",141,99,98,1,1,"¡TERUEL EXI",39
44,"44201",477,399,395,1,4,"¡TERUEL EXI",113
44,"44038",101,85,83,1,2,"¡TERUEL EXI",10
44,"44262",141,104,103,0,1,"¡TERUEL EXI",45
44,"44124",71,57,57,0,0,"¡TERUEL EXI",19
44,"44099",644,422,421,2,1,"¡TERUEL EXI",109
44,"44223",73,48,48,0,0,"¡TERUEL EXI",7
44,"44093",78,62,61,0,1,"¡TERUEL EXI",20
44,"44004",379,275,275,2,0,"¡TERUEL EXI",54
44,"44106",151,107,106,0,1,"¡TERUEL EXI",23
44,"44143",388,298,298,2,0,"¡TERUEL EXI",55
44,"44257",149,92,91,0,1,"¡TERUEL EXI",16
44,"44092",70,53,52,0,1,"¡TERUEL EXI",9
44,"44028",171,136,136,0,0,"¡TERUEL EXI",38
44,"44040",189,153,150,1,3,"¡TERUEL EXI",31
44,"44090",66,49,49,0,0,"¡TERUEL EXI",3
44,"44075",321,255,252,1,3,"¡TERUEL EXI",60
44,"44211",33,22,22,0,0,"¡TERUEL EXI",4
44,"44096",155,115,114,1,1,"¡TERUEL EXI",43
44,"44129",35,29,29,1,0,"¡TERUEL EXI",1
44,"44239",21,19,19,0,0,"¡TERUEL EXI",5
44,"44181",65,57,57,0,0,"¡TERUEL EXI",12
44,"44023",18,15,14,0,1,"¡TERUEL EXI",1
44,"44220",113,82,82,1,0,"¡TERUEL EXI",26
44,"44115",102,91,91,0,0,"¡TERUEL EXI",15
44,"44252",73,56,55,0,1,"¡TERUEL EXI",5
44,"44123",95,68,68,0,0,"¡TERUEL EXI",19
44,"44071",585,419,418,6,1,"¡TERUEL EXI",131
44,"44163",115,79,78,0,1,"¡TERUEL EXI",12
44,"44158",1153,879,872,6,7,"¡TERUEL EXI",257
44,"44035",102,82,80,1,2,"¡TERUEL EXI",19
44,"44049",784,539,532,3,7,"¡TERUEL EXI",29
44,"44197",51,35,35,1,0,"¡TERUEL EXI",4
44,"44018",16,16,16,0,0,"¡TERUEL EXI",0
44,"44050",3113,2173,2154,14,19,"¡TERUEL EXI",622
44,"44247",291,207,206,4,1,"¡TERUEL EXI",26
44,"44228",96,75,74,0,1,"¡TERUEL EXI",15
44,"44055",75,52,50,0,2,"¡TERUEL EXI",13
44,"44063",63,52,52,0,0,"¡TERUEL EXI",14
44,"44138",120,92,92,0,0,"¡TERUEL EXI",24
44,"44047",225,103,103,0,0,"¡TERUEL EXI",18
44,"44153",1733,1131,1125,0,6,"¡TERUEL EXI",397
44,"44236",60,38,38,0,0,"¡TERUEL EXI",5
44,"44184",44,37,37,0,0,"¡TERUEL EXI",2
44,"44267",70,47,46,0,1,"¡TERUEL EXI",2
44,"44169",298,216,216,0,0,"¡TERUEL EXI",77
44,"44144",319,225,223,0,2,"¡TERUEL EXI",34
44,"44012",303,215,215,2,0,"¡TERUEL EXI",18
44,"44189",44,35,35,0,0,"¡TERUEL EXI",5
44,"44060",32,25,25,0,0,"¡TERUEL EXI",1
44,"44155",1063,779,778,3,1,"¡TERUEL EXI",214
44,"44062",31,20,20,0,0,"¡TERUEL EXI",4
44,"44130",28,23,23,0,0,"¡TERUEL EXI",7
44,"44022",464,330,325,1,5,"¡TERUEL EXI",122
44,"44121",52,42,42,1,0,"¡TERUEL EXI",4
44,"44112",400,265,265,2,0,"¡TERUEL EXI",93
44,"44080",281,202,199,0,3,"¡TERUEL EXI",46
44,"44226",123,85,84,0,1,"¡TERUEL EXI",34
44,"44218",28,24,24,3,0,"¡TERUEL EXI",2
44,"44061",77,60,58,1,2,"¡TERUEL EXI",12
44,"44066",85,62,62,0,0,"¡TERUEL EXI",14
44,"44227",72,58,58,0,0,"¡TERUEL EXI",7
44,"44171",176,115,115,0,0,"¡TERUEL EXI",23
44,"44086",410,302,298,3,4,"¡TERUEL EXI",35
44,"44165",168,125,125,2,0,"¡TERUEL EXI",22
44,"44131",26,22,22,0,0,"¡TERUEL EXI",5
44,"44231",35,30,30,0,0,"¡TERUEL EXI",5
44,"44102",26,19,19,0,0,"¡TERUEL EXI",7
44,"44217",32,25,25,0,0,"¡TERUEL EXI",4
44,"44179",324,201,201,2,0,"¡TERUEL EXI",23
44,"44174",402,289,288,1,1,"¡TERUEL EXI",65
44,"44013",11232,7872,7801,64,71,"¡TERUEL EXI",1328
44,"44027",144,113,113,2,0,"¡TERUEL EXI",5
44,"44219",173,118,115,1,3,"¡TERUEL EXI",12
44,"44212",41,29,29,0,0,"¡TERUEL EXI",8
44,"44119",116,80,79,1,1,"¡TERUEL EXI",33
44,"44077",68,52,51,0,1,"¡TERUEL EXI",5
44,"44172",296,216,216,1,0,"¡TERUEL EXI",33
44,"44225",105,82,81,2,1,"¡TERUEL EXI",14
44,"44100",177,136,135,1,1,"¡TERUEL EXI",33
44,"44146",164,133,133,2,0,"¡TERUEL EXI",21
44,"44085",49,29,29,0,0,"¡TERUEL EXI",2
44,"44250",20,15,15,0,0,"¡TERUEL EXI",6
44,"44135",99,73,73,1,0,"¡TERUEL EXI",15
44,"44176",152,114,113,1,1,"¡TERUEL EXI",11
44,"44249",40,30,30,0,0,"¡TERUEL EXI",2
44,"44235",87,65,64,1,1,"¡TERUEL EXI",12
44,"44132",54,49,49,0,0,"¡TERUEL EXI",8
44,"44161",428,294,292,2,2,"¡TERUEL EXI",49
44,"44025",5804,4024,3991,11,33,"¡TERUEL EXI",1058
44,"44026",100,73,72,0,1,"¡TERUEL EXI",8
44,"44213",68,47,47,0,0,"¡TERUEL EXI",10
44,"44120",219,147,145,3,2,"¡TERUEL EXI",53
44,"44039",204,144,143,1,1,"¡TERUEL EXI",21
44,"44016",424,299,297,1,2,"¡TERUEL EXI",96
44,"44182",203,160,158,0,2,"¡TERUEL EXI",54
44,"44208",27,17,17,0,0,"¡TERUEL EXI",0
44,"44244",67,40,40,0,0,"¡TERUEL EXI",5
44,"44044",82,65,65,2,0,"¡TERUEL EXI",11
44,"44147",401,264,256,7,8,"¡TERUEL EXI",36
44,"44167",34,26,26,0,0,"¡TERUEL EXI",11
44,"44266",102,81,79,0,2,"¡TERUEL EXI",22
44,"44260",137,93,93,1,0,"¡TERUEL EXI",10
44,"44137",187,139,139,0,0,"¡TERUEL EXI",11
44,"44103",122,96,96,3,0,"¡TERUEL EXI",22
44,"44193",73,60,60,1,0,"¡TERUEL EXI",6
44,"44125",63,41,41,0,0,"¡TERUEL EXI",14
44,"44037",447,288,288,1,0,"¡TERUEL EXI",50
44,"44087",67,52,50,0,2,"¡TERUEL EXI",6
44,"44020",22,21,21,0,0,"¡TERUEL EXI",5
44,"44207",125,98,97,2,1,"¡TERUEL EXI",18
44,"44154",240,164,161,1,3,"¡TERUEL EXI",17
44,"44046",44,33,33,0,0,"¡TERUEL EXI",16
44,"44034",124,90,90,0,0,"¡TERUEL EXI",14
44,"44045",360,271,271,0,0,"¡TERUEL EXI",68
44,"44051",2579,1924,1901,10,23,"¡TERUEL EXI",231
44,"44160",438,287,285,4,2,"¡TERUEL EXI",61
44,"44006",220,152,151,1,1,"¡TERUEL EXI",35
44,"44191",714,509,500,5,9,"¡TERUEL EXI",64
44,"44190",63,45,45,0,0,"¡TERUEL EXI",17
44,"44059",562,411,407,2,4,"¡TERUEL EXI",84
44,"44056",446,327,325,1,2,"¡TERUEL EXI",60
44,"44029",585,454,451,2,3,"¡TERUEL EXI",60
44,"44221",386,307,304,1,3,"¡TERUEL EXI",36
44,"44052",75,54,54,0,0,"¡TERUEL EXI",15
44,"44178",52,34,34,0,0,"¡TERUEL EXI",8
44,"44084",54,46,46,1,0,"¡TERUEL EXI",3
44,"44032",17,13,13,0,0,"¡TERUEL EXI",1
44,"44094",127,103,103,0,0,"¡TERUEL EXI",18
44,"44192",341,274,272,2,2,"¡TERUEL EXI",71
44,"44064",62,46,46,0,0,"¡TERUEL EXI",7
44,"44238",2278,1630,1620,3,10,"¡TERUEL EXI",231
44,"44105",68,53,53,0,0,"¡TERUEL EXI",6
44,"44024",31,26,25,0,1,"¡TERUEL EXI",4
44,"44043",86,60,60,0,0,"¡TERUEL EXI",4
44,"44264",254,170,170,0,0,"¡TERUEL EXI",46
44,"44122",1277,939,934,5,5,"¡TERUEL EXI",115
44,"44053",103,87,85,1,2,"¡TERUEL EXI",16
44,"44261",713,553,549,3,4,"¡TERUEL EXI",116
44,"44195",82,58,57,0,1,"¡TERUEL EXI",18
44,"44185",88,69,69,2,0,"¡TERUEL EXI",27
44,"44118",154,109,106,1,3,"¡TERUEL EXI",9
44,"44127",57,43,43,0,0,"¡TERUEL EXI",12
44,"44199",39,37,37,2,0,"¡TERUEL EXI",21
44,"44224",21,14,14,2,0,"¡TERUEL EXI",0
44,"44005",48,36,36,0,0,"¡TERUEL EXI",10
44,"44042",114,82,81,0,1,"¡TERUEL EXI",26
44,"44241",500,361,357,0,4,"¡TERUEL EXI",85
44,"44205",619,420,415,5,5,"¡TERUEL EXI",46
44,"44126",314,222,221,0,1,"¡TERUEL EXI",52
44,"44114",233,161,159,0,2,"¡TERUEL EXI",24
44,"44001",65,43,43,1,0,"¡TERUEL EXI",10
44,"44209",799,584,573,2,11,"¡TERUEL EXI",197
44,"44168",181,119,117,1,2,"¡TERUEL EXI",31
44,"44068",634,497,493,2,4,"¡TERUEL EXI",61
44,"44088",24,23,23,0,0,"¡TERUEL EXI",1
44,"44180",74,56,56,0,0,"¡TERUEL EXI",3
44,"44116",75,58,58,0,0,"¡TERUEL EXI",19
44,"44203",9,9,9,0,0,"¡TERUEL EXI",0
44,"44164",19,16,16,1,0,"¡TERUEL EXI",2
44,"44206",100,73,73,3,0,"¡TERUEL EXI",17
44,"44222",125,92,92,0,0,"¡TERUEL EXI",22
44,"44150",28,17,17,0,0,"¡TERUEL EXI",5
44,"44117",327,258,258,0,0,"¡TERUEL EXI",54
44,"44198",182,138,135,0,3,"¡TERUEL EXI",28
44,"44245",240,177,174,0,3,"¡TERUEL EXI",11
44,"44210",750,577,572,2,5,"¡TERUEL EXI",153
44,"44237",367,267,262,0,5,"¡TERUEL EXI",18
44,"44194",103,67,64,0,3,"¡TERUEL EXI",17
44,"44003",17,15,15,0,0,"¡TERUEL EXI",3
44,"44110",37,30,30,0,0,"¡TERUEL EXI",2
44,"44082",84,66,66,0,0,"¡TERUEL EXI",21
44,"44234",71,49,49,0,0,"¡TERUEL EXI",18
44,"44215",167,113,113,2,0,"¡TERUEL EXI",35
44,"44033",243,165,165,3,0,"¡TERUEL EXI",27
44,"44200",39,26,26,0,0,"¡TERUEL EXI",3
44,"44265",175,138,136,1,2,"¡TERUEL EXI",12
44,"44089",49,41,41,0,0,"¡TERUEL EXI",13
44,"44177",101,68,68,1,0,"¡TERUEL EXI",12
44,"44196",121,88,88,0,0,"¡TERUEL EXI",24
44,"44111",78,61,61,0,0,"¡TERUEL EXI",12
44,"44183",61,47,47,1,0,"¡TERUEL EXI",6
44,"44011",47,34,34,0,0,"¡TERUEL EXI",6
44,"44145",974,698,697,3,1,"¡TERUEL EXI",142
44,"44107",212,135,135,0,0,"¡TERUEL EXI",9
44,"44263",373,267,267,2,0,"¡TERUEL EXI",106
44,"44133",15,12,12,0,0,"¡TERUEL EXI",5
44,"44067",106,75,71,0,4,"¡TERUEL EXI",4
44,"44141",122,88,85,0,3,"¡TERUEL EXI",5
44,"44128",58,39,37,0,2,"¡TERUEL EXI",6
44,"44175",112,76,75,1,1,"¡TERUEL EXI",13
44,"44019",70,42,42,0,0,"¡TERUEL EXI",9
44,"44074",440,314,308,2,6,"¡TERUEL EXI",62
44,"44021",104,77,77,1,0,"¡TERUEL EXI",32
44,"44148",74,56,54,0,2,"¡TERUEL EXI",10
44,"44268",32,30,30,0,0,"¡TERUEL EXI",5
44,"44142",29,21,21,0,0,"¡TERUEL EXI",3
44,"44230",149,111,110,2,1,"¡TERUEL EXI",20
44,"44136",48,43,43,1,0,"¡TERUEL EXI",4
44,"44240",151,119,117,0,2,"¡TERUEL EXI",33
44,"44256",36,30,30,2,0,"¡TERUEL EXI",7
44,"44097",126,76,73,0,3,"¡TERUEL EXI",11
44,"44251",239,187,183,1,4,"¡TERUEL EXI",20
44,"44101",55,41,40,1,1,"¡TERUEL EXI",12
44,"44065",55,33,32,0,1,"¡TERUEL EXI",2
44,"44152",70,46,46,0,0,"¡TERUEL EXI",14
44,"44216",27003,19997,19909,80,88,"¡TERUEL EXI",8477
44,"44113",74,51,51,0,0,"¡TERUEL EXI",8
44,"44156",47,31,31,0,0,"¡TERUEL EXI",8
44,"44009",798,593,589,4,4,"¡TERUEL EXI",164
44,"44054",95,82,81,0,1,"¡TERUEL EXI",13
44,"44076",2089,1577,1565,8,12,"¡TERUEL EXI",402
44,"44108",306,209,205,1,4,"¡TERUEL EXI",22
44,"44008",1556,1109,1100,7,9,"¡TERUEL EXI",122
44,"44109",99,64,64,0,0,"¡TERUEL EXI",7
44,"44187",193,147,146,0,1,"¡TERUEL EXI",14
44,"44017",269,217,216,0,1,"¡TERUEL EXI",81
44,"44036",22,20,20,0,0,"¡TERUEL EXI",6
44,"44031",83,50,50,0,0,"¡TERUEL EXI",3
44,"44014",2506,1828,1818,8,10,"¡TERUEL EXI",513
44,"44159",37,27,27,1,0,"¡TERUEL EXI",1
44,"44151",180,134,134,1,0,"¡TERUEL EXI",25
44,"44204",27,18,18,0,0,"¡TERUEL EXI",2
44,"44048",52,47,47,0,0,"¡TERUEL EXI",7
44,"44225",105,82,81,2,1,"UDT",1
44,"44023",18,15,14,0,1,"UDT",0
44,"44243",25,19,19,0,0,"UDT",0
44,"44261",713,553,549,3,4,"UDT",1
44,"44026",100,73,72,0,1,"UDT",0
44,"44066",85,62,62,0,0,"UDT",0
44,"44190",63,45,45,0,0,"UDT",0
44,"44144",319,225,223,0,2,"UDT",0
44,"44138",120,92,92,0,0,"UDT",0
44,"44220",113,82,82,1,0,"UDT",0
44,"44080",281,202,199,0,3,"UDT",0
44,"44084",54,46,46,1,0,"UDT",0
44,"44257",149,92,91,0,1,"UDT",0
44,"44077",68,52,51,0,1,"UDT",0
44,"44088",24,23,23,0,0,"UDT",0
44,"44181",65,57,57,0,0,"UDT",0
44,"44094",127,103,103,0,0,"UDT",0
44,"44063",63,52,52,0,0,"UDT",0
44,"44179",324,201,201,2,0,"UDT",1
44,"44121",52,42,42,1,0,"UDT",0
44,"44085",49,29,29,0,0,"UDT",0
44,"44035",102,82,80,1,2,"UDT",0
44,"44020",22,21,21,0,0,"UDT",0
44,"44096",155,115,114,1,1,"UDT",0
44,"44047",225,103,103,0,0,"UDT",0
44,"44109",99,64,64,0,0,"UDT",0
44,"44141",122,88,85,0,3,"UDT",0
44,"44115",102,91,91,0,0,"UDT",0
44,"44017",269,217,216,0,1,"UDT",0
44,"44244",67,40,40,0,0,"UDT",0
44,"44001",65,43,43,1,0,"UDT",0
44,"44105",68,53,53,0,0,"UDT",0
44,"44265",175,138,136,1,2,"UDT",0
44,"44236",60,38,38,0,0,"UDT",0
44,"44151",180,134,134,1,0,"UDT",0
44,"44223",73,48,48,0,0,"UDT",0
44,"44239",21,19,19,0,0,"UDT",0
44,"44123",95,68,68,0,0,"UDT",0
44,"44168",181,119,117,1,2,"UDT",1
44,"44050",3113,2173,2154,14,19,"UDT",0
44,"44262",141,104,103,0,1,"UDT",0
44,"44189",44,35,35,0,0,"UDT",0
44,"44241",500,361,357,0,4,"UDT",0
44,"44060",32,25,25,0,0,"UDT",0
44,"44152",70,46,46,0,0,"UDT",0
44,"44210",750,577,572,2,5,"UDT",0
44,"44158",1153,879,872,6,7,"UDT",3
44,"44052",75,54,54,0,0,"UDT",0
44,"44232",364,255,255,3,0,"UDT",0
44,"44090",66,49,49,0,0,"UDT",0
44,"44022",464,330,325,1,5,"UDT",1
44,"44129",35,29,29,1,0,"UDT",0
44,"44228",96,75,74,0,1,"UDT",0
44,"44143",388,298,298,2,0,"UDT",0
44,"44249",40,30,30,0,0,"UDT",0
44,"44163",115,79,78,0,1,"UDT",0
44,"44173",103,81,79,0,2,"UDT",0
44,"44198",182,138,135,0,3,"UDT",0
44,"44011",47,34,34,0,0,"UDT",0
44,"44268",32,30,30,0,0,"UDT",0
44,"44155",1063,779,778,3,1,"UDT",0
44,"44258",53,46,46,0,0,"UDT",0
44,"44160",438,287,285,4,2,"UDT",0
44,"44106",151,107,106,0,1,"UDT",1
44,"44149",99,74,73,4,1,"UDT",0
44,"44238",2278,1630,1620,3,10,"UDT",0
44,"44184",44,37,37,0,0,"UDT",0
44,"44146",164,133,133,2,0,"UDT",0
44,"44003",17,15,15,0,0,"UDT",0
44,"44196",121,88,88,0,0,"UDT",0
44,"44203",9,9,9,0,0,"UDT",0
44,"44087",67,52,50,0,2,"UDT",0
44,"44009",798,593,589,4,4,"UDT",0
44,"44007",149,112,111,1,1,"UDT",0
44,"44208",27,17,17,0,0,"UDT",0
44,"44055",75,52,50,0,2,"UDT",0
44,"44099",644,422,421,2,1,"UDT",0
44,"44136",48,43,43,1,0,"UDT",0
44,"44247",291,207,206,4,1,"UDT",0
44,"44171",176,115,115,0,0,"UDT",0
44,"44126",314,222,221,0,1,"UDT",0
44,"44252",73,56,55,0,1,"UDT",0
44,"44062",31,20,20,0,0,"UDT",0
44,"44131",26,22,22,0,0,"UDT",0
44,"44165",168,125,125,2,0,"UDT",0
44,"44130",28,23,23,0,0,"UDT",0
44,"44038",101,85,83,1,2,"UDT",0
44,"44056",446,327,325,1,2,"UDT",0
44,"44191",714,509,500,5,9,"UDT",0
44,"44113",74,51,51,0,0,"UDT",0
44,"44033",243,165,165,3,0,"UDT",0
44,"44226",123,85,84,0,1,"UDT",0
44,"44217",32,25,25,0,0,"UDT",0
44,"44068",634,497,493,2,4,"UDT",0
44,"44012",303,215,215,2,0,"UDT",0
44,"44041",60,48,48,0,0,"UDT",0
44,"44195",82,58,57,0,1,"UDT",0
44,"44122",1277,939,934,5,5,"UDT",0
44,"44034",124,90,90,0,0,"UDT",2
44,"44135",99,73,73,1,0,"UDT",0
44,"44231",35,30,30,0,0,"UDT",0
44,"44204",27,18,18,0,0,"UDT",0
44,"44132",54,49,49,0,0,"UDT",0
44,"44097",126,76,73,0,3,"UDT",0
44,"44118",154,109,106,1,3,"UDT",0
44,"44127",57,43,43,0,0,"UDT",0
44,"44245",240,177,174,0,3,"UDT",0
44,"44201",477,399,395,1,4,"UDT",0
44,"44193",73,60,60,1,0,"UDT",0
44,"44263",373,267,267,2,0,"UDT",1
44,"44016",424,299,297,1,2,"UDT",0
44,"44086",410,302,298,3,4,"UDT",0
44,"44108",306,209,205,1,4,"UDT",0
44,"44043",86,60,60,0,0,"UDT",0
44,"44153",1733,1131,1125,0,6,"UDT",1
44,"44251",239,187,183,1,4,"UDT",0
44,"44102",26,19,19,0,0,"UDT",0
44,"44237",367,267,262,0,5,"UDT",0
44,"44051",2579,1924,1901,10,23,"UDT",0
44,"44101",55,41,40,1,1,"UDT",0
44,"44018",16,16,16,0,0,"UDT",0
44,"44125",63,41,41,0,0,"UDT",0
44,"44164",19,16,16,1,0,"UDT",0
44,"44100",177,136,135,1,1,"UDT",0
44,"44071",585,419,418,6,1,"UDT",0
44,"44119",116,80,79,1,1,"UDT",0
44,"44067",106,75,71,0,4,"UDT",0
44,"44250",20,15,15,0,0,"UDT",0
44,"44213",68,47,47,0,0,"UDT",0
44,"44082",84,66,66,0,0,"UDT",0
44,"44176",152,114,113,1,1,"UDT",0
44,"44229",141,99,98,1,1,"UDT",0
44,"44192",341,274,272,2,2,"UDT",0
44,"44114",233,161,159,0,2,"UDT",0
44,"44070",55,49,49,0,0,"UDT",0
44,"44075",321,255,252,1,3,"UDT",0
44,"44004",379,275,275,2,0,"UDT",0
44,"44218",28,24,24,3,0,"UDT",0
44,"44185",88,69,69,2,0,"UDT",0
44,"44175",112,76,75,1,1,"UDT",0
44,"44172",296,216,216,1,0,"UDT",0
44,"44169",298,216,216,0,0,"UDT",0
44,"44267",70,47,46,0,1,"UDT",0
44,"44211",33,22,22,0,0,"UDT",0
44,"44053",103,87,85,1,2,"UDT",0
44,"44215",167,113,113,2,0,"UDT",0
44,"44156",47,31,31,0,0,"UDT",0
44,"44103",122,96,96,3,0,"UDT",0
44,"44110",37,30,30,0,0,"UDT",0
44,"44246",1599,1012,1001,11,11,"UDT",1
44,"44039",204,144,143,1,1,"UDT",0
44,"44133",15,12,12,0,0,"UDT",0
44,"44092",70,53,52,0,1,"UDT",1
44,"44117",327,258,258,0,0,"UDT",0
44,"44010",185,144,143,0,1,"UDT",0
44,"44182",203,160,158,0,2,"UDT",0
44,"44240",151,119,117,0,2,"UDT",0
44,"44116",75,58,58,0,0,"UDT",0
44,"44183",61,47,47,1,0,"UDT",0
44,"44006",220,152,151,1,1,"UDT",0
44,"44042",114,82,81,0,1,"UDT",0
44,"44145",974,698,697,3,1,"UDT",0
44,"44074",440,314,308,2,6,"UDT",0
44,"44230",149,111,110,2,1,"UDT",0
44,"44205",619,420,415,5,5,"UDT",0
44,"44124",71,57,57,0,0,"UDT",0
44,"44107",212,135,135,0,0,"UDT",0
44,"44200",39,26,26,0,0,"UDT",0
44,"44219",173,118,115,1,3,"UDT",0
44,"44025",5804,4024,3991,11,33,"UDT",0
44,"44019",70,42,42,0,0,"UDT",0
44,"44111",78,61,61,0,0,"UDT",0
44,"44028",171,136,136,0,0,"UDT",0
44,"44076",2089,1577,1565,8,12,"UDT",0
44,"44256",36,30,30,2,0,"UDT",0
44,"44036",22,20,20,0,0,"UDT",0
44,"44064",62,46,46,0,0,"UDT",0
44,"44128",58,39,37,0,2,"UDT",0
44,"44112",400,265,265,2,0,"UDT",0
44,"44154",240,164,161,1,3,"UDT",1
44,"44222",125,92,92,0,0,"UDT",0
44,"44014",2506,1828,1818,8,10,"UDT",0
44,"44147",401,264,256,7,8,"UDT",0
44,"44150",28,17,17,0,0,"UDT",0
44,"44157",61,37,37,0,0,"UDT",0
44,"44045",360,271,271,0,0,"UDT",0
44,"44024",31,26,25,0,1,"UDT",0
44,"44212",41,29,29,0,0,"UDT",0
44,"44199",39,37,37,2,0,"UDT",0
44,"44021",104,77,77,1,0,"UDT",0
44,"44197",51,35,35,1,0,"UDT",0
44,"44167",34,26,26,0,0,"UDT",0
44,"44061",77,60,58,1,2,"UDT",0
44,"44046",44,33,33,0,0,"UDT",0
44,"44049",784,539,532,3,7,"UDT",0
44,"44093",78,62,61,0,1,"UDT",0
44,"44177",101,68,68,1,0,"UDT",0
44,"44266",102,81,79,0,2,"UDT",1
44,"44174",402,289,288,1,1,"UDT",0
44,"44013",11232,7872,7801,64,71,"UDT",0
44,"44031",83,50,50,0,0,"UDT",0
44,"44044",82,65,65,2,0,"UDT",0
44,"44209",799,584,573,2,11,"UDT",0
44,"44224",21,14,14,2,0,"UDT",0
44,"44264",254,170,170,0,0,"UDT",0
44,"44235",87,65,64,1,1,"UDT",0
44,"44065",55,33,32,0,1,"UDT",0
44,"44059",562,411,407,2,4,"UDT",0
44,"44040",189,153,150,1,3,"UDT",0
44,"44161",428,294,292,2,2,"UDT",1
44,"44234",71,49,49,0,0,"UDT",0
44,"44032",17,13,13,0,0,"UDT",0
44,"44206",100,73,73,3,0,"UDT",0
44,"44005",48,36,36,0,0,"UDT",0
44,"44142",29,21,21,0,0,"UDT",0
44,"44227",72,58,58,0,0,"UDT",0
44,"44037",447,288,288,1,0,"UDT",0
44,"44120",219,147,145,3,2,"UDT",0
44,"44194",103,67,64,0,3,"UDT",0
44,"44137",187,139,139,0,0,"UDT",0
44,"44216",27003,19997,19909,80,88,"UDT",4
44,"44027",144,113,113,2,0,"UDT",0
44,"44048",52,47,47,0,0,"UDT",0
44,"44178",52,34,34,0,0,"UDT",0
44,"44260",137,93,93,1,0,"UDT",0
44,"44159",37,27,27,1,0,"UDT",0
44,"44207",125,98,97,2,1,"UDT",0
44,"44029",585,454,451,2,3,"UDT",3
44,"44221",386,307,304,1,3,"UDT",0
44,"44054",95,82,81,0,1,"UDT",0
44,"44002",47,41,41,0,0,"UDT",0
44,"44089",49,41,41,0,0,"UDT",0
44,"44148",74,56,54,0,2,"UDT",0
44,"44008",1556,1109,1100,7,9,"UDT",1
44,"44180",74,56,56,0,0,"UDT",0
44,"44187",193,147,146,0,1,"UDT",0
46,"46133",462,359,352,1,7,"UIG-SOM-CUIDES",0
46,"46110",21364,15132,15019,120,113,"UIG-SOM-CUIDES",20
46,"46095",580,445,438,5,7,"UIG-SOM-CUIDES",1
46,"46012",965,689,675,4,14,"UIG-SOM-CUIDES",0
46,"46077",7338,5447,5356,44,91,"UIG-SOM-CUIDES",2
46,"46148",1515,1131,1113,5,18,"UIG-SOM-CUIDES",0
46,"46130",862,633,625,6,8,"UIG-SOM-CUIDES",2
46,"46024",454,343,339,1,4,"UIG-SOM-CUIDES",3
46,"46224",156,125,124,0,1,"UIG-SOM-CUIDES",0
46,"46014",3156,2324,2294,13,30,"UIG-SOM-CUIDES",4
46,"46143",4274,3027,2995,19,32,"UIG-SOM-CUIDES",5
46,"46196",134,111,110,0,1,"UIG-SOM-CUIDES",0
46,"46161",1467,1129,1113,5,16,"UIG-SOM-CUIDES",1
46,"46084",1487,1136,1123,4,13,"UIG-SOM-CUIDES",2
46,"46117",493,386,380,2,6,"UIG-SOM-CUIDES",3
46,"46194",15852,11124,11009,86,115,"UIG-SOM-CUIDES",24
46,"46258",2617,1925,1914,5,11,"UIG-SOM-CUIDES",4
46,"46092",262,176,174,2,2,"UIG-SOM-CUIDES",0
46,"46153",443,353,349,2,4,"UIG-SOM-CUIDES",0
46,"46191",1956,1439,1414,8,25,"UIG-SOM-CUIDES",2
46,"46100",281,190,187,1,3,"UIG-SOM-CUIDES",0
46,"46151",757,560,552,2,8,"UIG-SOM-CUIDES",0
46,"46158",1047,771,763,7,8,"UIG-SOM-CUIDES",0
46,"46186",19689,14688,14576,118,112,"UIG-SOM-CUIDES",25
46,"46173",1309,1029,1010,13,19,"UIG-SOM-CUIDES",1
46,"46253",112,84,84,0,0,"UIG-SOM-CUIDES",0
46,"46229",903,715,708,5,7,"UIG-SOM-CUIDES",0
46,"46065",1584,1199,1183,11,16,"UIG-SOM-CUIDES",8
46,"46247",972,649,646,3,3,"UIG-SOM-CUIDES",1
46,"46118",3649,2730,2701,20,29,"UIG-SOM-CUIDES",1
46,"46251",2465,1938,1903,19,35,"UIG-SOM-CUIDES",4
46,"46138",361,289,287,1,2,"UIG-SOM-CUIDES",1
46,"46004",1932,1530,1512,10,18,"UIG-SOM-CUIDES",3
46,"46125",852,660,650,5,10,"UIG-SOM-CUIDES",0
46,"46046",901,623,609,2,14,"UIG-SOM-CUIDES",0
46,"46213",15499,10610,10482,173,128,"UIG-SOM-CUIDES",1
46,"46008",2617,1954,1931,17,23,"UIG-SOM-CUIDES",0
46,"46040",993,745,733,3,12,"UIG-SOM-CUIDES",1
46,"46171",16446,11616,11499,94,117,"UIG-SOM-CUIDES",37
46,"46206",555,417,408,0,9,"UIG-SOM-CUIDES",1
46,"46115",330,219,213,0,6,"UIG-SOM-CUIDES",0
46,"46097",948,670,663,1,7,"UIG-SOM-CUIDES",1
46,"46209",1903,1406,1383,5,23,"UIG-SOM-CUIDES",2
46,"46208",1071,854,845,2,9,"UIG-SOM-CUIDES",1
46,"46263",235,182,180,2,2,"UIG-SOM-CUIDES",0
46,"46201",62,40,40,0,0,"UIG-SOM-CUIDES",0
46,"46034",1826,1345,1335,3,10,"UIG-SOM-CUIDES",3
46,"46056",176,142,142,0,0,"UIG-SOM-CUIDES",0
46,"46137",248,201,197,3,4,"UIG-SOM-CUIDES",0
46,"46099",744,539,535,2,4,"UIG-SOM-CUIDES",0
46,"46113",2558,1791,1773,7,18,"UIG-SOM-CUIDES",0
46,"46070",17824,12888,12802,106,86,"UIG-SOM-CUIDES",13
46,"46042",3335,2655,2620,12,35,"UIG-SOM-CUIDES",1
46,"46160",1922,1395,1381,4,14,"UIG-SOM-CUIDES",1
46,"46057",463,308,304,1,4,"UIG-SOM-CUIDES",0
46,"46120",1179,903,880,5,23,"UIG-SOM-CUIDES",1
46,"46079",314,244,240,0,4,"UIG-SOM-CUIDES",0
46,"46003",948,770,757,8,13,"UIG-SOM-CUIDES",1
46,"46170",3417,2618,2577,11,41,"UIG-SOM-CUIDES",0
46,"46249",9136,6538,6439,73,99,"UIG-SOM-CUIDES",1
46,"46019",8932,6721,6647,40,74,"UIG-SOM-CUIDES",11
46,"46239",446,357,352,1,5,"UIG-SOM-CUIDES",0
46,"46067",1753,1356,1341,8,15,"UIG-SOM-CUIDES",0
46,"46096",263,204,202,0,2,"UIG-SOM-CUIDES",1
46,"46241",388,288,283,5,5,"UIG-SOM-CUIDES",1
46,"46044",4159,3062,2997,26,65,"UIG-SOM-CUIDES",0
46,"46093",2151,1652,1640,10,12,"UIG-SOM-CUIDES",3
46,"46244",59910,42120,41826,338,294,"UIG-SOM-CUIDES",103
46,"46135",9817,7596,7558,58,38,"UIG-SOM-CUIDES",11
46,"46156",2017,1538,1524,9,14,"UIG-SOM-CUIDES",4
46,"46022",15392,10624,10546,69,78,"UIG-SOM-CUIDES",18
46,"46240",200,167,155,1,12,"UIG-SOM-CUIDES",0
46,"46167",342,240,239,0,1,"UIG-SOM-CUIDES",0
46,"46073",1066,823,817,11,6,"UIG-SOM-CUIDES",2
46,"46169",32403,23890,23698,222,192,"UIG-SOM-CUIDES",27
46,"46029",20448,14673,14556,99,117,"UIG-SOM-CUIDES",19
46,"46904",812,615,605,2,10,"UIG-SOM-CUIDES",2
46,"46166",8214,6093,6031,38,62,"UIG-SOM-CUIDES",14
46,"46188",693,565,560,2,5,"UIG-SOM-CUIDES",1
46,"46001",771,562,560,3,2,"UIG-SOM-CUIDES",0
46,"46183",6036,4276,4213,21,63,"UIG-SOM-CUIDES",4
46,"46205",14237,10641,10533,77,108,"UIG-SOM-CUIDES",8
46,"46035",6828,5155,5089,33,66,"UIG-SOM-CUIDES",7
46,"46016",1070,827,814,10,13,"UIG-SOM-CUIDES",0
46,"46190",50042,35290,35066,284,224,"UIG-SOM-CUIDES",37
46,"46023",322,254,252,1,2,"UIG-SOM-CUIDES",0
46,"46109",6248,4516,4440,37,76,"UIG-SOM-CUIDES",1
46,"46127",2748,2035,2009,6,26,"UIG-SOM-CUIDES",3
46,"46903",6306,4762,4743,44,19,"UIG-SOM-CUIDES",6
46,"46041",313,229,228,1,1,"UIG-SOM-CUIDES",1
46,"46009",3144,2473,2449,22,24,"UIG-SOM-CUIDES",5
46,"46054",11389,8266,8190,54,76,"UIG-SOM-CUIDES",9
46,"46236",929,723,716,2,7,"UIG-SOM-CUIDES",1
46,"46114",552,417,412,6,5,"UIG-SOM-CUIDES",1
46,"46178",5001,3513,3477,26,36,"UIG-SOM-CUIDES",9
46,"46232",853,661,648,7,13,"UIG-SOM-CUIDES",0
46,"46049",268,221,217,2,4,"UIG-SOM-CUIDES",2
46,"46216",5277,4146,4111,42,35,"UIG-SOM-CUIDES",3
46,"46227",893,687,675,6,12,"UIG-SOM-CUIDES",1
46,"46072",3522,2792,2741,25,51,"UIG-SOM-CUIDES",2
46,"46126",5580,4361,4328,36,33,"UIG-SOM-CUIDES",7
46,"46211",1862,1395,1381,12,14,"UIG-SOM-CUIDES",1
46,"46055",1298,992,977,9,15,"UIG-SOM-CUIDES",0
46,"46152",90,63,63,0,0,"UIG-SOM-CUIDES",0
46,"46124",786,638,625,1,13,"UIG-SOM-CUIDES",0
46,"46011",7523,5154,5077,34,77,"UIG-SOM-CUIDES",4
46,"46050",185,141,141,1,0,"UIG-SOM-CUIDES",0
46,"46187",1292,924,920,4,4,"UIG-SOM-CUIDES",0
46,"46179",2136,1624,1596,17,28,"UIG-SOM-CUIDES",0
46,"46192",786,534,519,7,15,"UIG-SOM-CUIDES",0
46,"46030",810,641,625,7,16,"UIG-SOM-CUIDES",0
46,"46228",2426,1819,1802,19,17,"UIG-SOM-CUIDES",2
46,"46063",1786,1270,1255,8,15,"UIG-SOM-CUIDES",1
46,"46214",16637,12113,12014,84,99,"UIG-SOM-CUIDES",19
46,"46145",22215,15688,15538,127,150,"UIG-SOM-CUIDES",19
46,"46231",2403,1670,1652,11,18,"UIG-SOM-CUIDES",1
46,"46257",5436,3972,3933,28,39,"UIG-SOM-CUIDES",2
46,"46200",1840,1475,1455,5,20,"UIG-SOM-CUIDES",1
46,"46033",196,155,153,0,2,"UIG-SOM-CUIDES",0
46,"46021",24053,17331,17194,159,137,"UIG-SOM-CUIDES",22
46,"46226",29,20,19,0,1,"UIG-SOM-CUIDES",0
46,"46018",562,442,436,2,6,"UIG-SOM-CUIDES",0
46,"46089",2182,1590,1576,9,14,"UIG-SOM-CUIDES",0
46,"46104",1906,1422,1409,5,13,"UIG-SOM-CUIDES",5
46,"46082",4981,3547,3523,29,24,"UIG-SOM-CUIDES",5
46,"46180",659,509,500,7,9,"UIG-SOM-CUIDES",0
46,"46203",3546,2717,2689,28,28,"UIG-SOM-CUIDES",5
46,"46090",1631,1360,1339,6,21,"UIG-SOM-CUIDES",1
46,"46080",979,720,712,2,8,"UIG-SOM-CUIDES",0
46,"46165",7349,5460,5412,39,48,"UIG-SOM-CUIDES",16
46,"46027",924,746,737,2,9,"UIG-SOM-CUIDES",0
46,"46026",1220,974,965,7,9,"UIG-SOM-CUIDES",2
46,"46064",532,395,387,3,8,"UIG-SOM-CUIDES",1
46,"46163",1883,1471,1460,8,11,"UIG-SOM-CUIDES",2
46,"46006",4454,3527,3486,27,41,"UIG-SOM-CUIDES",2
46,"46007",12333,8890,8803,79,87,"UIG-SOM-CUIDES",18
46,"46172",5488,3724,3674,26,50,"UIG-SOM-CUIDES",1
46,"46230",14116,10038,9946,63,92,"UIG-SOM-CUIDES",21
46,"46025",2445,1875,1853,16,22,"UIG-SOM-CUIDES",12
46,"46219",125,107,104,0,3,"UIG-SOM-CUIDES",0
46,"46242",326,260,257,3,3,"UIG-SOM-CUIDES",1
46,"46039",2111,1657,1640,16,17,"UIG-SOM-CUIDES",3
46,"46181",16967,11951,11835,98,116,"UIG-SOM-CUIDES",17
46,"46102",19696,14700,14579,125,121,"UIG-SOM-CUIDES",13
46,"46085",11089,7581,7503,60,78,"UIG-SOM-CUIDES",12
46,"46032",5719,4297,4262,35,35,"UIG-SOM-CUIDES",13
46,"46017",33041,23469,23277,173,192,"UIG-SOM-CUIDES",42
46,"46212",1620,1130,1112,12,18,"UIG-SOM-CUIDES",6
46,"46223",7776,5848,5798,36,50,"UIG-SOM-CUIDES",19
46,"46122",2726,1957,1934,13,23,"UIG-SOM-CUIDES",0
46,"46185",361,301,299,5,2,"UIG-SOM-CUIDES",0
46,"46195",2000,1540,1532,3,8,"UIG-SOM-CUIDES",2
46,"46164",12145,8373,8248,44,125,"UIG-SOM-CUIDES",19
46,"46052",515,423,419,4,4,"UIG-SOM-CUIDES",2
46,"46047",540,428,420,1,8,"UIG-SOM-CUIDES",0
46,"46140",383,321,321,2,0,"UIG-SOM-CUIDES",0
46,"46069",152,112,111,1,1,"UIG-SOM-CUIDES",0
46,"46252",125,89,86,1,3,"UIG-SOM-CUIDES",0
46,"46091",110,100,100,0,0,"UIG-SOM-CUIDES",0
46,"46076",610,500,494,1,6,"UIG-SOM-CUIDES",1
46,"46250",582242,437146,434438,3315,2708,"UIG-SOM-CUIDES",871
46,"46207",6761,4966,4909,46,57,"UIG-SOM-CUIDES",7
46,"46141",433,340,337,6,3,"UIG-SOM-CUIDES",0
46,"46088",152,114,110,1,4,"UIG-SOM-CUIDES",0
46,"46175",429,362,355,3,7,"UIG-SOM-CUIDES",0
46,"46031",10574,7233,7158,58,75,"UIG-SOM-CUIDES",28
46,"46037",1120,891,879,7,12,"UIG-SOM-CUIDES",1
46,"46036",558,339,331,6,8,"UIG-SOM-CUIDES",0
46,"46248",4868,3434,3374,16,60,"UIG-SOM-CUIDES",0
46,"46255",3220,2361,2340,20,21,"UIG-SOM-CUIDES",2
46,"46168",2004,1463,1447,12,16,"UIG-SOM-CUIDES",1
46,"46184",26514,19610,19399,180,211,"UIG-SOM-CUIDES",16
46,"46134",2419,1697,1678,14,19,"UIG-SOM-CUIDES",2
46,"46237",7172,5199,5146,53,53,"UIG-SOM-CUIDES",18
46,"46119",761,587,580,6,7,"UIG-SOM-CUIDES",1
46,"46132",2176,1725,1708,5,17,"UIG-SOM-CUIDES",3
46,"46112",533,435,432,7,3,"UIG-SOM-CUIDES",0
46,"46121",106,91,90,1,1,"UIG-SOM-CUIDES",0
46,"46105",16126,10958,10847,76,111,"UIG-SOM-CUIDES",11
46,"46062",4552,3402,3362,27,40,"UIG-SOM-CUIDES",4
46,"46234",317,247,245,1,2,"UIG-SOM-CUIDES",0
46,"46094",20805,15353,15211,122,142,"UIG-SOM-CUIDES",45
46,"46066",1274,972,970,4,2,"UIG-SOM-CUIDES",1
46,"46256",7280,4996,4940,32,56,"UIG-SOM-CUIDES",20
46,"46262",206,136,134,1,2,"UIG-SOM-CUIDES",0
46,"46028",383,305,299,8,6,"UIG-SOM-CUIDES",0
46,"46210",338,256,251,0,5,"UIG-SOM-CUIDES",0
46,"46087",109,94,94,2,0,"UIG-SOM-CUIDES",0
46,"46045",1245,984,961,3,23,"UIG-SOM-CUIDES",1
46,"46174",942,746,736,1,10,"UIG-SOM-CUIDES",0
46,"46218",1043,842,829,6,13,"UIG-SOM-CUIDES",4
46,"46098",2405,1778,1751,7,27,"UIG-SOM-CUIDES",0
46,"46068",345,283,279,2,4,"UIG-SOM-CUIDES",0
46,"46243",124,93,90,1,3,"UIG-SOM-CUIDES",0
46,"46038",302,221,220,1,1,"UIG-SOM-CUIDES",1
46,"46193",8959,6880,6824,66,56,"UIG-SOM-CUIDES",10
46,"46238",13117,9172,9088,50,84,"UIG-SOM-CUIDES",6
46,"46233",3766,2688,2650,14,38,"UIG-SOM-CUIDES",26
46,"46261",1708,1259,1237,12,22,"UIG-SOM-CUIDES",2
46,"46123",1926,1392,1368,11,24,"UIG-SOM-CUIDES",4
46,"46217",900,672,667,7,5,"UIG-SOM-CUIDES",0
46,"46150",1794,1276,1272,8,4,"UIG-SOM-CUIDES",4
46,"46147",17186,11507,11399,72,108,"UIG-SOM-CUIDES",12
46,"46131",49805,35527,35231,298,296,"UIG-SOM-CUIDES",38
46,"46051",8469,6120,6070,40,50,"UIG-SOM-CUIDES",8
46,"46142",778,536,524,3,12,"UIG-SOM-CUIDES",0
46,"46074",2687,2033,2020,18,13,"UIG-SOM-CUIDES",1
46,"46177",4832,3592,3539,20,53,"UIG-SOM-CUIDES",17
46,"46246",1049,808,793,3,15,"UIG-SOM-CUIDES",0
46,"46198",862,670,660,3,10,"UIG-SOM-CUIDES",0
46,"46071",471,355,349,1,6,"UIG-SOM-CUIDES",0
46,"46107",1857,1421,1402,4,19,"UIG-SOM-CUIDES",2
46,"46182",1312,908,904,5,4,"UIG-SOM-CUIDES",0
46,"46128",1569,1216,1179,7,37,"UIG-SOM-CUIDES",0
46,"46108",420,328,324,1,4,"UIG-SOM-CUIDES",1
46,"46222",402,329,326,0,3,"UIG-SOM-CUIDES",1
46,"46902",352,283,283,0,0,"UIG-SOM-CUIDES",0
46,"46002",1253,946,940,4,6,"UIG-SOM-CUIDES",1
46,"46061",351,276,272,6,4,"UIG-SOM-CUIDES",0
46,"46260",2685,2072,2053,14,19,"UIG-SOM-CUIDES",5
46,"46221",348,292,290,1,2,"UIG-SOM-CUIDES",1
46,"46199",5878,4217,4182,21,35,"UIG-SOM-CUIDES",6
46,"46189",469,374,367,2,7,"UIG-SOM-CUIDES",0
46,"46225",351,267,262,1,5,"UIG-SOM-CUIDES",0
46,"46086",80,66,65,1,1,"UIG-SOM-CUIDES",0
46,"46081",9999,7486,7412,47,74,"UIG-SOM-CUIDES",12
46,"46103",1354,993,978,8,15,"UIG-SOM-CUIDES",5
46,"46013",17761,13652,13548,144,104,"UIG-SOM-CUIDES",19
46,"46159",23038,16719,16596,127,123,"UIG-SOM-CUIDES",38
46,"46053",525,433,428,2,5,"UIG-SOM-CUIDES",0
46,"46254",944,673,661,6,12,"UIG-SOM-CUIDES",0
46,"46220",49112,33766,33424,312,342,"UIG-SOM-CUIDES",33
46,"46111",11367,7995,7908,66,87,"UIG-SOM-CUIDES",13
46,"46136",2598,1875,1851,14,24,"UIG-SOM-CUIDES",3
46,"46059",1244,1007,995,5,12,"UIG-SOM-CUIDES",0
46,"46146",1647,1241,1229,12,12,"UIG-SOM-CUIDES",0
46,"46157",2959,2145,2126,11,19,"UIG-SOM-CUIDES",0
46,"46075",144,125,122,2,3,"UIG-SOM-CUIDES",0
46,"46060",9278,6796,6724,49,72,"UIG-SOM-CUIDES",13
46,"46078",28484,19694,19520,173,174,"UIG-SOM-CUIDES",35
46,"46005",23129,16610,16437,148,173,"UIG-SOM-CUIDES",28
46,"46245",527,407,404,2,3,"UIG-SOM-CUIDES",0
46,"46162",1168,839,832,3,7,"UIG-SOM-CUIDES",2
46,"46139",4520,3486,3457,18,29,"UIG-SOM-CUIDES",2
46,"46129",511,389,379,9,10,"UIG-SOM-CUIDES",0
46,"46101",819,670,663,8,7,"UIG-SOM-CUIDES",1
46,"46259",457,374,371,2,3,"UIG-SOM-CUIDES",1
46,"46149",350,252,249,3,3,"UIG-SOM-CUIDES",0
46,"46015",7519,5575,5532,34,43,"UIG-SOM-CUIDES",20
46,"46204",6625,4946,4882,52,64,"UIG-SOM-CUIDES",13
46,"46144",628,483,478,4,5,"UIG-SOM-CUIDES",0
46,"46116",13606,10262,10200,87,62,"UIG-SOM-CUIDES",9
46,"46058",1734,1245,1230,8,15,"UIG-SOM-CUIDES",2
46,"46048",3504,2609,2576,17,33,"UIG-SOM-CUIDES",7
46,"46154",795,619,608,5,11,"UIG-SOM-CUIDES",2
46,"46176",2077,1362,1348,14,14,"UIG-SOM-CUIDES",4
46,"46197",1930,1430,1411,11,19,"UIG-SOM-CUIDES",0
46,"46202",17801,13010,12906,87,104,"UIG-SOM-CUIDES",18
46,"46215",1407,1088,1068,10,20,"UIG-SOM-CUIDES",0
46,"46106",1471,1033,1028,8,5,"UIG-SOM-CUIDES",0
46,"46020",3757,2834,2783,16,51,"UIG-SOM-CUIDES",5
46,"46235",21229,15171,15011,126,160,"UIG-SOM-CUIDES",18
46,"46155",972,731,716,3,15,"UIG-SOM-CUIDES",0
46,"46083",15372,10939,10815,78,124,"UIG-SOM-CUIDES",9
46,"46043",135,119,118,0,1,"UIG-SOM-CUIDES",1
46,"46010",943,691,681,7,10,"UIG-SOM-CUIDES",1
46,"46210",338,256,251,0,5,"UNIDOS SÍ-A",0
46,"46194",15852,11124,11009,86,115,"UNIDOS SÍ-A",6
46,"46175",429,362,355,3,7,"UNIDOS SÍ-A",0
46,"46158",1047,771,763,7,8,"UNIDOS SÍ-A",1
46,"46206",555,417,408,0,9,"UNIDOS SÍ-A",0
46,"46176",2077,1362,1348,14,14,"UNIDOS SÍ-A",0
46,"46077",7338,5447,5356,44,91,"UNIDOS SÍ-A",5
46,"46128",1569,1216,1179,7,37,"UNIDOS SÍ-A",0
46,"46047",540,428,420,1,8,"UNIDOS SÍ-A",0
46,"46171",16446,11616,11499,94,117,"UNIDOS SÍ-A",14
46,"46079",314,244,240,0,4,"UNIDOS SÍ-A",0
46,"46219",125,107,104,0,3,"UNIDOS SÍ-A",0
46,"46097",948,670,663,1,7,"UNIDOS SÍ-A",0
46,"46118",3649,2730,2701,20,29,"UNIDOS SÍ-A",0
46,"46096",263,204,202,0,2,"UNIDOS SÍ-A",0
46,"46169",32403,23890,23698,222,192,"UNIDOS SÍ-A",13
46,"46201",62,40,40,0,0,"UNIDOS SÍ-A",0
46,"46095",580,445,438,5,7,"UNIDOS SÍ-A",0
46,"46260",2685,2072,2053,14,19,"UNIDOS SÍ-A",0
46,"46209",1903,1406,1383,5,23,"UNIDOS SÍ-A",1
46,"46009",3144,2473,2449,22,24,"UNIDOS SÍ-A",3
46,"46249",9136,6538,6439,73,99,"UNIDOS SÍ-A",4
46,"46153",443,353,349,2,4,"UNIDOS SÍ-A",1
46,"46122",2726,1957,1934,13,23,"UNIDOS SÍ-A",3
46,"46019",8932,6721,6647,40,74,"UNIDOS SÍ-A",0
46,"46189",469,374,367,2,7,"UNIDOS SÍ-A",0
46,"46005",23129,16610,16437,148,173,"UNIDOS SÍ-A",13
46,"46087",109,94,94,2,0,"UNIDOS SÍ-A",0
46,"46004",1932,1530,1512,10,18,"UNIDOS SÍ-A",0
46,"46133",462,359,352,1,7,"UNIDOS SÍ-A",0
46,"46163",1883,1471,1460,8,11,"UNIDOS SÍ-A",2
46,"46221",348,292,290,1,2,"UNIDOS SÍ-A",0
46,"46110",21364,15132,15019,120,113,"UNIDOS SÍ-A",16
46,"46147",17186,11507,11399,72,108,"UNIDOS SÍ-A",8
46,"46062",4552,3402,3362,27,40,"UNIDOS SÍ-A",1
46,"46148",1515,1131,1113,5,18,"UNIDOS SÍ-A",1
46,"46240",200,167,155,1,12,"UNIDOS SÍ-A",0
46,"46115",330,219,213,0,6,"UNIDOS SÍ-A",0
46,"46014",3156,2324,2294,13,30,"UNIDOS SÍ-A",0
46,"46226",29,20,19,0,1,"UNIDOS SÍ-A",0
46,"46161",1467,1129,1113,5,16,"UNIDOS SÍ-A",0
46,"46092",262,176,174,2,2,"UNIDOS SÍ-A",0
46,"46186",19689,14688,14576,118,112,"UNIDOS SÍ-A",8
46,"46229",903,715,708,5,7,"UNIDOS SÍ-A",0
46,"46223",7776,5848,5798,36,50,"UNIDOS SÍ-A",1
46,"46196",134,111,110,0,1,"UNIDOS SÍ-A",0
46,"46190",50042,35290,35066,284,224,"UNIDOS SÍ-A",48
46,"46018",562,442,436,2,6,"UNIDOS SÍ-A",0
46,"46185",361,301,299,5,2,"UNIDOS SÍ-A",0
46,"46061",351,276,272,6,4,"UNIDOS SÍ-A",0
46,"46180",659,509,500,7,9,"UNIDOS SÍ-A",0
46,"46100",281,190,187,1,3,"UNIDOS SÍ-A",0
46,"46085",11089,7581,7503,60,78,"UNIDOS SÍ-A",5
46,"46059",1244,1007,995,5,12,"UNIDOS SÍ-A",0
46,"46224",156,125,124,0,1,"UNIDOS SÍ-A",0
46,"46024",454,343,339,1,4,"UNIDOS SÍ-A",0
46,"46072",3522,2792,2741,25,51,"UNIDOS SÍ-A",2
46,"46263",235,182,180,2,2,"UNIDOS SÍ-A",1
46,"46132",2176,1725,1708,5,17,"UNIDOS SÍ-A",1
46,"46178",5001,3513,3477,26,36,"UNIDOS SÍ-A",1
46,"46258",2617,1925,1914,5,11,"UNIDOS SÍ-A",2
46,"46078",28484,19694,19520,173,174,"UNIDOS SÍ-A",14
46,"46067",1753,1356,1341,8,15,"UNIDOS SÍ-A",1
46,"46074",2687,2033,2020,18,13,"UNIDOS SÍ-A",5
46,"46020",3757,2834,2783,16,51,"UNIDOS SÍ-A",0
46,"46065",1584,1199,1183,11,16,"UNIDOS SÍ-A",1
46,"46181",16967,11951,11835,98,116,"UNIDOS SÍ-A",11
46,"46001",771,562,560,3,2,"UNIDOS SÍ-A",0
46,"46094",20805,15353,15211,122,142,"UNIDOS SÍ-A",19
46,"46137",248,201,197,3,4,"UNIDOS SÍ-A",0
46,"46211",1862,1395,1381,12,14,"UNIDOS SÍ-A",1
46,"46179",2136,1624,1596,17,28,"UNIDOS SÍ-A",1
46,"46902",352,283,283,0,0,"UNIDOS SÍ-A",0
46,"46164",12145,8373,8248,44,125,"UNIDOS SÍ-A",8
46,"46051",8469,6120,6070,40,50,"UNIDOS SÍ-A",2
46,"46259",457,374,371,2,3,"UNIDOS SÍ-A",0
46,"46191",1956,1439,1414,8,25,"UNIDOS SÍ-A",1
46,"46204",6625,4946,4882,52,64,"UNIDOS SÍ-A",3
46,"46166",8214,6093,6031,38,62,"UNIDOS SÍ-A",2
46,"46093",2151,1652,1640,10,12,"UNIDOS SÍ-A",0
46,"46244",59910,42120,41826,338,294,"UNIDOS SÍ-A",40
46,"46039",2111,1657,1640,16,17,"UNIDOS SÍ-A",1
46,"46057",463,308,304,1,4,"UNIDOS SÍ-A",0
46,"46159",23038,16719,16596,127,123,"UNIDOS SÍ-A",12
46,"46008",2617,1954,1931,17,23,"UNIDOS SÍ-A",0
46,"46257",5436,3972,3933,28,39,"UNIDOS SÍ-A",2
46,"46213",15499,10610,10482,173,128,"UNIDOS SÍ-A",6
46,"46173",1309,1029,1010,13,19,"UNIDOS SÍ-A",1
46,"46238",13117,9172,9088,50,84,"UNIDOS SÍ-A",8
46,"46104",1906,1422,1409,5,13,"UNIDOS SÍ-A",0
46,"46105",16126,10958,10847,76,111,"UNIDOS SÍ-A",12
46,"46168",2004,1463,1447,12,16,"UNIDOS SÍ-A",0
46,"46237",7172,5199,5146,53,53,"UNIDOS SÍ-A",8
46,"46120",1179,903,880,5,23,"UNIDOS SÍ-A",1
46,"46242",326,260,257,3,3,"UNIDOS SÍ-A",0
46,"46239",446,357,352,1,5,"UNIDOS SÍ-A",0
46,"46216",5277,4146,4111,42,35,"UNIDOS SÍ-A",3
46,"46253",112,84,84,0,0,"UNIDOS SÍ-A",0
46,"46192",786,534,519,7,15,"UNIDOS SÍ-A",0
46,"46102",19696,14700,14579,125,121,"UNIDOS SÍ-A",13
46,"46203",3546,2717,2689,28,28,"UNIDOS SÍ-A",4
46,"46127",2748,2035,2009,6,26,"UNIDOS SÍ-A",1
46,"46149",350,252,249,3,3,"UNIDOS SÍ-A",0
46,"46232",853,661,648,7,13,"UNIDOS SÍ-A",0
46,"46054",11389,8266,8190,54,76,"UNIDOS SÍ-A",4
46,"46141",433,340,337,6,3,"UNIDOS SÍ-A",1
46,"46183",6036,4276,4213,21,63,"UNIDOS SÍ-A",3
46,"46217",900,672,667,7,5,"UNIDOS SÍ-A",0
46,"46129",511,389,379,9,10,"UNIDOS SÍ-A",0
46,"46088",152,114,110,1,4,"UNIDOS SÍ-A",0
46,"46056",176,142,142,0,0,"UNIDOS SÍ-A",0
46,"46197",1930,1430,1411,11,19,"UNIDOS SÍ-A",5
46,"46082",4981,3547,3523,29,24,"UNIDOS SÍ-A",0
46,"46138",361,289,287,1,2,"UNIDOS SÍ-A",0
46,"46130",862,633,625,6,8,"UNIDOS SÍ-A",0
46,"46037",1120,891,879,7,12,"UNIDOS SÍ-A",0
46,"46021",24053,17331,17194,159,137,"UNIDOS SÍ-A",13
46,"46152",90,63,63,0,0,"UNIDOS SÍ-A",0
46,"46017",33041,23469,23277,173,192,"UNIDOS SÍ-A",21
46,"46243",124,93,90,1,3,"UNIDOS SÍ-A",0
46,"46228",2426,1819,1802,19,17,"UNIDOS SÍ-A",0
46,"46003",948,770,757,8,13,"UNIDOS SÍ-A",0
46,"46234",317,247,245,1,2,"UNIDOS SÍ-A",0
46,"46029",20448,14673,14556,99,117,"UNIDOS SÍ-A",12
46,"46013",17761,13652,13548,144,104,"UNIDOS SÍ-A",12
46,"46066",1274,972,970,4,2,"UNIDOS SÍ-A",0
46,"46099",744,539,535,2,4,"UNIDOS SÍ-A",0
46,"46214",16637,12113,12014,84,99,"UNIDOS SÍ-A",10
46,"46027",924,746,737,2,9,"UNIDOS SÍ-A",1
46,"46904",812,615,605,2,10,"UNIDOS SÍ-A",1
46,"46255",3220,2361,2340,20,21,"UNIDOS SÍ-A",1
46,"46205",14237,10641,10533,77,108,"UNIDOS SÍ-A",9
46,"46034",1826,1345,1335,3,10,"UNIDOS SÍ-A",4
46,"46135",9817,7596,7558,58,38,"UNIDOS SÍ-A",4
46,"46006",4454,3527,3486,27,41,"UNIDOS SÍ-A",0
46,"46035",6828,5155,5089,33,66,"UNIDOS SÍ-A",4
46,"46073",1066,823,817,11,6,"UNIDOS SÍ-A",1
46,"46103",1354,993,978,8,15,"UNIDOS SÍ-A",1
46,"46245",527,407,404,2,3,"UNIDOS SÍ-A",0
46,"46044",4159,3062,2997,26,65,"UNIDOS SÍ-A",3
46,"46089",2182,1590,1576,9,14,"UNIDOS SÍ-A",1
46,"46170",3417,2618,2577,11,41,"UNIDOS SÍ-A",0
46,"46016",1070,827,814,10,13,"UNIDOS SÍ-A",2
46,"46256",7280,4996,4940,32,56,"UNIDOS SÍ-A",10
46,"46188",693,565,560,2,5,"UNIDOS SÍ-A",0
46,"46225",351,267,262,1,5,"UNIDOS SÍ-A",0
46,"46050",185,141,141,1,0,"UNIDOS SÍ-A",0
46,"46184",26514,19610,19399,180,211,"UNIDOS SÍ-A",30
46,"46150",1794,1276,1272,8,4,"UNIDOS SÍ-A",0
46,"46114",552,417,412,6,5,"UNIDOS SÍ-A",0
46,"46109",6248,4516,4440,37,76,"UNIDOS SÍ-A",2
46,"46252",125,89,86,1,3,"UNIDOS SÍ-A",0
46,"46030",810,641,625,7,16,"UNIDOS SÍ-A",0
46,"46157",2959,2145,2126,11,19,"UNIDOS SÍ-A",2
46,"46142",778,536,524,3,12,"UNIDOS SÍ-A",0
46,"46052",515,423,419,4,4,"UNIDOS SÍ-A",0
46,"46032",5719,4297,4262,35,35,"UNIDOS SÍ-A",9
46,"46080",979,720,712,2,8,"UNIDOS SÍ-A",0
46,"46124",786,638,625,1,13,"UNIDOS SÍ-A",0
46,"46145",22215,15688,15538,127,150,"UNIDOS SÍ-A",7
46,"46086",80,66,65,1,1,"UNIDOS SÍ-A",0
46,"46049",268,221,217,2,4,"UNIDOS SÍ-A",0
46,"46011",7523,5154,5077,34,77,"UNIDOS SÍ-A",7
46,"46007",12333,8890,8803,79,87,"UNIDOS SÍ-A",8
46,"46233",3766,2688,2650,14,38,"UNIDOS SÍ-A",3
46,"46207",6761,4966,4909,46,57,"UNIDOS SÍ-A",2
46,"46068",345,283,279,2,4,"UNIDOS SÍ-A",0
46,"46123",1926,1392,1368,11,24,"UNIDOS SÍ-A",0
46,"46200",1840,1475,1455,5,20,"UNIDOS SÍ-A",0
46,"46041",313,229,228,1,1,"UNIDOS SÍ-A",0
46,"46236",929,723,716,2,7,"UNIDOS SÍ-A",0
46,"46031",10574,7233,7158,58,75,"UNIDOS SÍ-A",10
46,"46251",2465,1938,1903,19,35,"UNIDOS SÍ-A",1
46,"46045",1245,984,961,3,23,"UNIDOS SÍ-A",1
46,"46218",1043,842,829,6,13,"UNIDOS SÍ-A",0
46,"46235",21229,15171,15011,126,160,"UNIDOS SÍ-A",14
46,"46151",757,560,552,2,8,"UNIDOS SÍ-A",0
46,"46060",9278,6796,6724,49,72,"UNIDOS SÍ-A",5
46,"46254",944,673,661,6,12,"UNIDOS SÍ-A",0
46,"46231",2403,1670,1652,11,18,"UNIDOS SÍ-A",0
46,"46026",1220,974,965,7,9,"UNIDOS SÍ-A",1
46,"46108",420,328,324,1,4,"UNIDOS SÍ-A",0
46,"46227",893,687,675,6,12,"UNIDOS SÍ-A",0
46,"46112",533,435,432,7,3,"UNIDOS SÍ-A",0
46,"46262",206,136,134,1,2,"UNIDOS SÍ-A",0
46,"46071",471,355,349,1,6,"UNIDOS SÍ-A",0
46,"46247",972,649,646,3,3,"UNIDOS SÍ-A",1
46,"46195",2000,1540,1532,3,8,"UNIDOS SÍ-A",5
46,"46126",5580,4361,4328,36,33,"UNIDOS SÍ-A",1
46,"46040",993,745,733,3,12,"UNIDOS SÍ-A",1
46,"46046",901,623,609,2,14,"UNIDOS SÍ-A",0
46,"46143",4274,3027,2995,19,32,"UNIDOS SÍ-A",4
46,"46069",152,112,111,1,1,"UNIDOS SÍ-A",0
46,"46165",7349,5460,5412,39,48,"UNIDOS SÍ-A",3
46,"46167",342,240,239,0,1,"UNIDOS SÍ-A",1
46,"46139",4520,3486,3457,18,29,"UNIDOS SÍ-A",1
46,"46140",383,321,321,2,0,"UNIDOS SÍ-A",0
46,"46117",493,386,380,2,6,"UNIDOS SÍ-A",1
46,"46113",2558,1791,1773,7,18,"UNIDOS SÍ-A",3
46,"46202",17801,13010,12906,87,104,"UNIDOS SÍ-A",5
46,"46146",1647,1241,1229,12,12,"UNIDOS SÍ-A",4
46,"46119",761,587,580,6,7,"UNIDOS SÍ-A",0
46,"46091",110,100,100,0,0,"UNIDOS SÍ-A",0
46,"46212",1620,1130,1112,12,18,"UNIDOS SÍ-A",1
46,"46053",525,433,428,2,5,"UNIDOS SÍ-A",0
46,"46162",1168,839,832,3,7,"UNIDOS SÍ-A",2
46,"46198",862,670,660,3,10,"UNIDOS SÍ-A",0
46,"46193",8959,6880,6824,66,56,"UNIDOS SÍ-A",6
46,"46070",17824,12888,12802,106,86,"UNIDOS SÍ-A",4
46,"46136",2598,1875,1851,14,24,"UNIDOS SÍ-A",1
46,"46012",965,689,675,4,14,"UNIDOS SÍ-A",0
46,"46250",582242,437146,434438,3315,2708,"UNIDOS SÍ-A",280
46,"46155",972,731,716,3,15,"UNIDOS SÍ-A",0
46,"46134",2419,1697,1678,14,19,"UNIDOS SÍ-A",2
46,"46015",7519,5575,5532,34,43,"UNIDOS SÍ-A",1
46,"46131",49805,35527,35231,298,296,"UNIDOS SÍ-A",25
46,"46002",1253,946,940,4,6,"UNIDOS SÍ-A",1
46,"46083",15372,10939,10815,78,124,"UNIDOS SÍ-A",7
46,"46208",1071,854,845,2,9,"UNIDOS SÍ-A",0
46,"46076",610,500,494,1,6,"UNIDOS SÍ-A",0
46,"46048",3504,2609,2576,17,33,"UNIDOS SÍ-A",2
46,"46038",302,221,220,1,1,"UNIDOS SÍ-A",0
46,"46023",322,254,252,1,2,"UNIDOS SÍ-A",0
46,"46028",383,305,299,8,6,"UNIDOS SÍ-A",0
46,"46125",852,660,650,5,10,"UNIDOS SÍ-A",0
46,"46022",15392,10624,10546,69,78,"UNIDOS SÍ-A",13
46,"46172",5488,3724,3674,26,50,"UNIDOS SÍ-A",5
46,"46121",106,91,90,1,1,"UNIDOS SÍ-A",0
46,"46156",2017,1538,1524,9,14,"UNIDOS SÍ-A",0
46,"46222",402,329,326,0,3,"UNIDOS SÍ-A",0
46,"46177",4832,3592,3539,20,53,"UNIDOS SÍ-A",4
46,"46246",1049,808,793,3,15,"UNIDOS SÍ-A",0
46,"46160",1922,1395,1381,4,14,"UNIDOS SÍ-A",0
46,"46064",532,395,387,3,8,"UNIDOS SÍ-A",2
46,"46090",1631,1360,1339,6,21,"UNIDOS SÍ-A",1
46,"46261",1708,1259,1237,12,22,"UNIDOS SÍ-A",0
46,"46098",2405,1778,1751,7,27,"UNIDOS SÍ-A",1
46,"46055",1298,992,977,9,15,"UNIDOS SÍ-A",0
46,"46081",9999,7486,7412,47,74,"UNIDOS SÍ-A",1
46,"46036",558,339,331,6,8,"UNIDOS SÍ-A",0
46,"46116",13606,10262,10200,87,62,"UNIDOS SÍ-A",9
46,"46187",1292,924,920,4,4,"UNIDOS SÍ-A",0
46,"46111",11367,7995,7908,66,87,"UNIDOS SÍ-A",5
46,"46075",144,125,122,2,3,"UNIDOS SÍ-A",0
46,"46033",196,155,153,0,2,"UNIDOS SÍ-A",0
46,"46042",3335,2655,2620,12,35,"UNIDOS SÍ-A",0
46,"46025",2445,1875,1853,16,22,"UNIDOS SÍ-A",0
46,"46058",1734,1245,1230,8,15,"UNIDOS SÍ-A",2
46,"46182",1312,908,904,5,4,"UNIDOS SÍ-A",0
46,"46199",5878,4217,4182,21,35,"UNIDOS SÍ-A",0
46,"46241",388,288,283,5,5,"UNIDOS SÍ-A",1
46,"46101",819,670,663,8,7,"UNIDOS SÍ-A",0
46,"46063",1786,1270,1255,8,15,"UNIDOS SÍ-A",1
46,"46215",1407,1088,1068,10,20,"UNIDOS SÍ-A",1
46,"46154",795,619,608,5,11,"UNIDOS SÍ-A",2
46,"46230",14116,10038,9946,63,92,"UNIDOS SÍ-A",5
46,"46043",135,119,118,0,1,"UNIDOS SÍ-A",0
46,"46107",1857,1421,1402,4,19,"UNIDOS SÍ-A",2
46,"46174",942,746,736,1,10,"UNIDOS SÍ-A",1
46,"46084",1487,1136,1123,4,13,"UNIDOS SÍ-A",1
46,"46106",1471,1033,1028,8,5,"UNIDOS SÍ-A",1
46,"46010",943,691,681,7,10,"UNIDOS SÍ-A",2
46,"46144",628,483,478,4,5,"UNIDOS SÍ-A",0
46,"46903",6306,4762,4743,44,19,"UNIDOS SÍ-A",3
46,"46220",49112,33766,33424,312,342,"UNIDOS SÍ-A",72
46,"46248",4868,3434,3374,16,60,"UNIDOS SÍ-A",1
47,"47144",72,54,53,2,1,"UNIÓN REGIO",0
47,"47230",285,209,206,1,3,"UNIÓN REGIO",0
47,"47190",95,75,75,1,0,"UNIÓN REGIO",0
47,"47170",43,36,30,0,6,"UNIÓN REGIO",0
47,"47039",162,119,117,0,2,"UNIÓN REGIO",0
47,"47115",276,212,211,1,1,"UNIÓN REGIO",0
47,"47129",855,660,648,7,12,"UNIÓN REGIO",12
47,"47089",133,111,111,2,0,"UNIÓN REGIO",0
47,"47151",26,22,22,0,0,"UNIÓN REGIO",0
47,"47132",39,32,32,1,0,"UNIÓN REGIO",0
47,"47154",146,115,111,6,4,"UNIÓN REGIO",0
47,"47217",1984,1460,1437,11,23,"UNIÓN REGIO",0
47,"47043",306,241,240,4,1,"UNIÓN REGIO",0
47,"47075",4772,3557,3512,34,45,"UNIÓN REGIO",5
47,"47142",121,85,85,0,0,"UNIÓN REGIO",0
47,"47159",825,672,661,0,11,"UNIÓN REGIO",3
47,"47229",221,150,149,0,1,"UNIÓN REGIO",0
47,"47181",165,136,135,1,1,"UNIÓN REGIO",0
47,"47184",537,411,402,1,9,"UNIÓN REGIO",1
47,"47106",44,30,30,0,0,"UNIÓN REGIO",0
47,"47011",554,466,462,7,4,"UNIÓN REGIO",0
47,"47013",91,77,77,1,0,"UNIÓN REGIO",0
47,"47147",103,86,82,0,4,"UNIÓN REGIO",0
47,"47071",396,321,316,5,5,"UNIÓN REGIO",0
47,"47223",148,105,102,4,3,"UNIÓN REGIO",0
47,"47102",257,212,210,2,2,"UNIÓN REGIO",0
47,"47189",151,128,122,1,6,"UNIÓN REGIO",0
47,"47027",2799,2059,2025,12,34,"UNIÓN REGIO",4
47,"47095",41,29,28,0,1,"UNIÓN REGIO",0
47,"47146",275,215,214,1,1,"UNIÓN REGIO",0
47,"47174",271,215,213,4,2,"UNIÓN REGIO",0
47,"47094",120,100,100,0,0,"UNIÓN REGIO",0
47,"47078",157,114,107,0,7,"UNIÓN REGIO",1
47,"47122",2007,1520,1492,8,28,"UNIÓN REGIO",1
47,"47167",245,198,198,1,0,"UNIÓN REGIO",0
47,"47186",244314,182449,180833,1818,1616,"UNIÓN REGIO",308
47,"47070",29,24,24,0,0,"UNIÓN REGIO",0
47,"47049",91,58,58,0,0,"UNIÓN REGIO",0
47,"47098",567,452,446,4,6,"UNIÓN REGIO",0
47,"47040",56,42,41,0,1,"UNIÓN REGIO",0
47,"47203",54,40,40,0,0,"UNIÓN REGIO",0
47,"47164",349,283,281,1,2,"UNIÓN REGIO",1
47,"47020",270,212,207,5,5,"UNIÓN REGIO",0
47,"47212",356,289,287,4,2,"UNIÓN REGIO",0
47,"47010",14718,11521,11392,137,129,"UNIÓN REGIO",13
47,"47088",101,79,79,0,0,"UNIÓN REGIO",0
47,"47178",170,128,124,2,4,"UNIÓN REGIO",0
47,"47177",104,78,78,0,0,"UNIÓN REGIO",0
47,"47051",324,261,258,6,3,"UNIÓN REGIO",1
47,"47194",295,228,227,1,1,"UNIÓN REGIO",0
47,"47023",3057,2369,2359,20,10,"UNIÓN REGIO",2
47,"47135",82,65,65,3,0,"UNIÓN REGIO",0
47,"47101",1634,1278,1262,7,16,"UNIÓN REGIO",0
47,"47012",100,72,71,0,1,"UNIÓN REGIO",0
47,"47200",70,60,60,0,0,"UNIÓN REGIO",0
47,"47007",4051,2987,2954,27,33,"UNIÓN REGIO",3
47,"47150",253,193,187,3,6,"UNIÓN REGIO",0
47,"47143",104,67,67,0,0,"UNIÓN REGIO",0
47,"47048",175,124,122,0,2,"UNIÓN REGIO",0
47,"47111",1001,738,732,5,6,"UNIÓN REGIO",0
47,"47082",805,641,630,3,11,"UNIÓN REGIO",1
47,"47166",251,183,181,2,2,"UNIÓN REGIO",1
47,"47031",191,141,140,0,1,"UNIÓN REGIO",0
47,"47152",67,59,59,0,0,"UNIÓN REGIO",0
47,"47091",76,60,59,2,1,"UNIÓN REGIO",0
47,"47219",39,31,28,1,3,"UNIÓN REGIO",0
47,"47009",98,84,84,0,0,"UNIÓN REGIO",0
47,"47185",82,62,61,1,1,"UNIÓN REGIO",0
47,"47063",86,68,68,0,0,"UNIÓN REGIO",1
47,"47004",1135,878,872,5,6,"UNIÓN REGIO",0
47,"47161",3970,3111,3089,24,22,"UNIÓN REGIO",5
47,"47222",85,70,70,1,0,"UNIÓN REGIO",0
47,"47163",277,208,205,3,3,"UNIÓN REGIO",0
47,"47047",199,136,135,4,1,"UNIÓN REGIO",0
47,"47064",37,30,29,1,1,"UNIÓN REGIO",0
47,"47097",305,239,237,0,2,"UNIÓN REGIO",0
47,"47060",224,171,168,1,3,"UNIÓN REGIO",1
47,"47092",101,81,79,0,2,"UNIÓN REGIO",0
47,"47100",118,93,87,2,6,"UNIÓN REGIO",0
47,"47083",81,63,61,0,2,"UNIÓN REGIO",1
47,"47079",55,44,43,1,1,"UNIÓN REGIO",0
47,"47158",859,618,608,4,10,"UNIÓN REGIO",0
47,"47038",100,61,61,0,0,"UNIÓN REGIO",2
47,"47226",148,115,115,1,0,"UNIÓN REGIO",1
47,"47118",147,97,97,2,0,"UNIÓN REGIO",0
47,"47057",272,200,199,0,1,"UNIÓN REGIO",0
47,"47172",135,114,113,0,1,"UNIÓN REGIO",1
47,"47191",111,81,81,0,0,"UNIÓN REGIO",0
47,"47216",111,94,91,0,3,"UNIÓN REGIO",0
47,"47171",375,295,290,9,5,"UNIÓN REGIO",1
47,"47155",3454,2445,2405,26,40,"UNIÓN REGIO",4
47,"47066",1482,1096,1086,14,10,"UNIÓN REGIO",2
47,"47069",115,87,87,0,0,"UNIÓN REGIO",0
47,"47032",147,102,102,0,0,"UNIÓN REGIO",0
47,"47126",42,35,35,1,0,"UNIÓN REGIO",0
47,"47056",81,57,57,0,0,"UNIÓN REGIO",0
47,"47014",48,39,39,1,0,"UNIÓN REGIO",0
47,"47128",53,45,43,0,2,"UNIÓN REGIO",0
47,"47085",16330,11556,11419,121,137,"UNIÓN REGIO",14
47,"47153",101,69,69,1,0,"UNIÓN REGIO",0
47,"47061",237,185,184,0,1,"UNIÓN REGIO",0
47,"47077",234,172,170,1,2,"UNIÓN REGIO",1
47,"47029",50,37,35,1,2,"UNIÓN REGIO",0
47,"47228",432,324,320,2,4,"UNIÓN REGIO",0
47,"47117",287,199,197,6,2,"UNIÓN REGIO",0
47,"47209",32,23,23,0,0,"UNIÓN REGIO",0
47,"47148",419,332,324,3,8,"UNIÓN REGIO",0
47,"47179",368,256,254,2,2,"UNIÓN REGIO",0
47,"47123",461,360,358,2,2,"UNIÓN REGIO",1
47,"47214",1349,1036,1019,5,17,"UNIÓN REGIO",0
47,"47213",104,78,78,0,0,"UNIÓN REGIO",0
47,"47016",65,55,55,0,0,"UNIÓN REGIO",0
47,"47210",399,278,275,3,3,"UNIÓN REGIO",0
47,"47218",981,728,723,4,5,"UNIÓN REGIO",0
47,"47173",879,627,622,9,5,"UNIÓN REGIO",0
47,"47183",135,100,100,1,0,"UNIÓN REGIO",0
47,"47180",57,41,41,1,0,"UNIÓN REGIO",0
47,"47137",29,25,25,0,0,"UNIÓN REGIO",0
47,"47001",52,43,42,1,1,"UNIÓN REGIO",0
47,"47002",18,18,18,0,0,"UNIÓN REGIO",0
47,"47188",98,73,70,0,3,"UNIÓN REGIO",0
47,"47195",426,314,310,2,4,"UNIÓN REGIO",0
47,"47104",2816,2153,2099,20,54,"UNIÓN REGIO",4
47,"47080",33,25,24,0,1,"UNIÓN REGIO",0
47,"47024",223,170,168,1,2,"UNIÓN REGIO",1
47,"47053",123,101,97,3,4,"UNIÓN REGIO",1
47,"47149",46,33,32,1,1,"UNIÓN REGIO",0
47,"47041",147,105,103,3,2,"UNIÓN REGIO",0
47,"47227",53,36,35,0,1,"UNIÓN REGIO",0
47,"47058",199,126,125,3,1,"UNIÓN REGIO",1
47,"47119",89,59,58,2,1,"UNIÓN REGIO",2
47,"47221",97,85,84,1,1,"UNIÓN REGIO",0
47,"47139",997,728,719,4,9,"UNIÓN REGIO",0
47,"47140",106,83,83,0,0,"UNIÓN REGIO",0
47,"47220",151,106,105,1,1,"UNIÓN REGIO",0
47,"47192",89,78,76,3,2,"UNIÓN REGIO",0
47,"47084",1077,794,784,11,10,"UNIÓN REGIO",0
47,"47156",150,117,117,0,0,"UNIÓN REGIO",1
47,"47044",323,273,270,4,3,"UNIÓN REGIO",0
47,"47175",6755,4950,4870,49,80,"UNIÓN REGIO",16
47,"47008",22,13,13,0,0,"UNIÓN REGIO",0
47,"47145",583,430,426,6,4,"UNIÓN REGIO",2
47,"47169",62,52,52,0,0,"UNIÓN REGIO",0
47,"47037",161,128,125,1,3,"UNIÓN REGIO",2
47,"47157",490,398,397,2,1,"UNIÓN REGIO",0
47,"47141",112,90,89,0,1,"UNIÓN REGIO",0
47,"47114",3900,2549,2514,18,35,"UNIÓN REGIO",1
47,"47168",30,26,26,1,0,"UNIÓN REGIO",0
47,"47109",161,120,120,1,0,"UNIÓN REGIO",0
47,"47224",93,75,75,1,0,"UNIÓN REGIO",0
47,"47130",94,64,63,0,1,"UNIÓN REGIO",0
47,"47019",92,68,68,1,0,"UNIÓN REGIO",0
47,"47067",153,112,112,3,0,"UNIÓN REGIO",0
47,"47206",79,66,66,0,0,"UNIÓN REGIO",0
47,"47121",517,410,398,2,12,"UNIÓN REGIO",0
47,"47030",935,680,669,5,11,"UNIÓN REGIO",0
47,"47198",64,43,43,0,0,"UNIÓN REGIO",0
47,"47052",6781,5213,5156,50,57,"UNIÓN REGIO",16
47,"47022",59,52,48,1,4,"UNIÓN REGIO",1
47,"47125",49,42,42,0,0,"UNIÓN REGIO",0
47,"47093",795,585,573,7,12,"UNIÓN REGIO",0
47,"47065",820,608,602,2,6,"UNIÓN REGIO",0
47,"47232",96,67,65,0,2,"UNIÓN REGIO",0
47,"47225",73,61,59,1,2,"UNIÓN REGIO",0
47,"47105",169,138,137,2,1,"UNIÓN REGIO",1
47,"47026",50,37,37,1,0,"UNIÓN REGIO",0
47,"47208",53,35,35,1,0,"UNIÓN REGIO",0
47,"47055",188,147,147,2,0,"UNIÓN REGIO",0
47,"47021",73,57,55,0,2,"UNIÓN REGIO",0
47,"47182",1328,940,934,8,6,"UNIÓN REGIO",0
47,"47176",199,110,110,0,0,"UNIÓN REGIO",0
47,"47054",599,465,460,1,5,"UNIÓN REGIO",1
47,"47059",94,64,64,0,0,"UNIÓN REGIO",0
47,"47138",224,169,166,0,3,"UNIÓN REGIO",1
47,"47034",75,58,58,2,0,"UNIÓN REGIO",0
47,"47068",29,21,21,0,0,"UNIÓN REGIO",0
47,"47015",177,129,129,0,0,"UNIÓN REGIO",0
47,"47204",235,159,157,3,2,"UNIÓN REGIO",0
47,"47215",48,43,43,0,0,"UNIÓN REGIO",0
47,"47160",395,296,294,3,2,"UNIÓN REGIO",0
47,"47231",4439,3359,3323,36,36,"UNIÓN REGIO",5
47,"47112",2561,1960,1933,13,27,"UNIÓN REGIO",1
47,"47033",205,151,150,2,1,"UNIÓN REGIO",1
47,"47197",875,659,656,9,3,"UNIÓN REGIO",0
47,"47017",190,146,146,0,0,"UNIÓN REGIO",1
47,"47018",36,31,31,0,0,"UNIÓN REGIO",0
47,"47165",6823,4999,4906,48,93,"UNIÓN REGIO",10
47,"47133",2776,2096,2073,28,23,"UNIÓN REGIO",3
47,"47062",155,128,128,0,0,"UNIÓN REGIO",2
47,"47096",127,94,93,1,1,"UNIÓN REGIO",0
47,"47113",134,110,110,0,0,"UNIÓN REGIO",0
47,"47076",17787,13484,13306,179,178,"UNIÓN REGIO",24
47,"47134",150,120,116,2,4,"UNIÓN REGIO",1
47,"47187",71,49,49,0,0,"UNIÓN REGIO",0
47,"47086",3818,2835,2784,36,51,"UNIÓN REGIO",1
47,"47090",2447,1823,1784,15,39,"UNIÓN REGIO",1
47,"47045",732,558,549,3,9,"UNIÓN REGIO",2
47,"47205",355,248,244,2,4,"UNIÓN REGIO",0
47,"47199",71,57,57,2,0,"UNIÓN REGIO",0
47,"47005",506,358,348,3,10,"UNIÓN REGIO",6
47,"47042",51,39,39,0,0,"UNIÓN REGIO",0
47,"47103",252,195,192,1,3,"UNIÓN REGIO",0
47,"47127",138,89,88,2,1,"UNIÓN REGIO",1
47,"47006",182,149,145,1,4,"UNIÓN REGIO",0
47,"47099",154,123,118,0,5,"UNIÓN REGIO",0
47,"47035",901,659,653,4,6,"UNIÓN REGIO",0
47,"47196",29,21,21,0,0,"UNIÓN REGIO",0
47,"47081",39,32,32,0,0,"UNIÓN REGIO",0
47,"47003",206,167,166,5,1,"UNIÓN REGIO",0
47,"47207",256,198,195,3,3,"UNIÓN REGIO",0
47,"47193",1625,1251,1236,10,15,"UNIÓN REGIO",4
47,"47025",114,85,85,3,0,"UNIÓN REGIO",0
47,"47110",445,335,327,1,8,"UNIÓN REGIO",0
47,"47074",141,110,109,0,1,"UNIÓN REGIO",0
47,"47028",30,17,17,0,0,"UNIÓN REGIO",0
47,"47131",167,122,120,2,2,"UNIÓN REGIO",0
47,"47087",362,272,268,1,4,"UNIÓN REGIO",0
47,"47162",70,57,57,2,0,"UNIÓN REGIO",0
47,"47124",383,302,300,3,2,"UNIÓN REGIO",1
47,"47073",116,80,79,2,1,"UNIÓN REGIO",0
47,"47036",204,159,156,1,3,"UNIÓN REGIO",0
47,"47211",48,37,37,1,0,"UNIÓN REGIO",0
47,"47050",3908,2713,2673,39,40,"UNIÓN REGIO",3
47,"47116",396,304,302,2,2,"UNIÓN REGIO",4
47,"47046",124,99,99,1,0,"UNIÓN REGIO",0
37,"37036",55,36,34,0,2,"UPL",0
37,"37127",205,139,139,1,0,"UPL",0
37,"37162",212,139,137,3,2,"UPL",0
49,"49042",229,166,164,2,2,"UPL",1
37,"37158",230,149,149,1,0,"UPL",0
37,"37355",159,121,120,1,1,"UPL",0
37,"37365",162,125,121,0,4,"UPL",1
24,"24203",88,62,62,1,0,"UPL",5
24,"24112",288,188,186,2,2,"UPL",1
24,"24015",2193,1532,1500,12,32,"UPL",49
24,"24110",1158,784,773,1,11,"UPL",1
49,"49057",107,74,71,0,3,"UPL",0
37,"37298",170,109,109,0,0,"UPL",0
24,"24184",177,106,105,0,1,"UPL",1
37,"37294",11750,8395,8280,88,115,"UPL",12
49,"49242",439,342,336,2,6,"UPL",0
24,"24102",587,403,399,7,4,"UPL",2
37,"37186",94,68,68,0,0,"UPL",0
49,"49204",58,44,43,1,1,"UPL",0
37,"37077",251,206,204,1,2,"UPL",0
49,"49243",107,74,74,0,0,"UPL",0
24,"24062",126,79,79,0,0,"UPL",1
37,"37114",74,58,55,1,3,"UPL",0
37,"37118",117,86,86,3,0,"UPL",0
49,"49188",111,75,73,0,2,"UPL",1
49,"49081",1321,972,953,6,19,"UPL",2
37,"37207",336,244,240,4,4,"UPL",2
37,"37183",377,267,267,5,0,"UPL",0
49,"49017",247,176,176,1,0,"UPL",0
49,"49241",235,178,177,1,1,"UPL",0
37,"37307",146,94,91,1,3,"UPL",0
49,"49154",111,63,59,0,4,"UPL",0
24,"24173",896,590,583,2,7,"UPL",18
37,"37052",287,192,191,2,1,"UPL",0
24,"24137",1043,700,691,8,9,"UPL",72
37,"37343",66,44,43,1,1,"UPL",0
49,"49151",591,389,388,3,1,"UPL",1
37,"37331",186,115,114,2,1,"UPL",0
24,"24219",489,334,329,7,5,"UPL",7
24,"24145",612,338,337,1,1,"UPL",9
37,"37320",85,65,64,1,1,"UPL",0
37,"37276",125,92,92,0,0,"UPL",0
49,"49031",148,107,105,2,2,"UPL",0
49,"49118",193,151,151,2,0,"UPL",1
24,"24018",172,129,128,0,1,"UPL",0
37,"37185",539,372,363,2,9,"UPL",0
24,"24165",317,202,199,1,3,"UPL",0
37,"37277",74,55,55,0,0,"UPL",0
49,"49084",266,197,195,11,2,"UPL",1
24,"24005",342,218,217,0,1,"UPL",4
37,"37312",244,191,189,1,2,"UPL",0
24,"24020",436,230,228,0,2,"UPL",29
49,"49021",14204,9429,9295,87,134,"UPL",47
24,"24106",218,139,139,1,0,"UPL",0
37,"37038",756,531,517,4,14,"UPL",0
24,"24193",363,264,264,1,0,"UPL",15
49,"49053",919,676,661,8,15,"UPL",2
49,"49141",290,191,191,1,0,"UPL",1
37,"37257",51,36,36,1,0,"UPL",0
37,"37297",394,298,297,0,1,"UPL",0
37,"37099",63,46,46,1,0,"UPL",0
24,"24100",737,506,502,9,4,"UPL",1
37,"37334",71,30,30,0,0,"UPL",0
49,"49203",280,218,212,1,6,"UPL",0
49,"49264",529,334,329,2,5,"UPL",0
37,"37216",294,234,227,5,7,"UPL",0
49,"49036",503,319,316,5,3,"UPL",0
24,"24131",684,416,415,2,1,"UPL",14
24,"24179",287,207,207,2,0,"UPL",10
49,"49082",341,273,270,12,3,"UPL",0
49,"49174",127,86,85,1,1,"UPL",0
24,"24134",3287,2278,2226,18,52,"UPL",113
49,"49025",157,121,118,0,3,"UPL",0
37,"37245",331,221,220,4,1,"UPL",3
24,"24226",194,118,118,1,0,"UPL",7
49,"49165",55,52,52,1,0,"UPL",1
37,"37317",287,211,209,1,2,"UPL",0
49,"49226",240,200,198,2,2,"UPL",0
24,"24211",259,199,198,3,1,"UPL",5
37,"37109",178,127,126,0,1,"UPL",0
37,"37197",88,53,53,1,0,"UPL",0
49,"49221",233,122,120,2,2,"UPL",0
49,"49199",236,159,157,3,2,"UPL",0
24,"24171",337,136,134,4,2,"UPL",0
37,"37106",248,161,160,4,1,"UPL",0
37,"37300",540,355,352,7,3,"UPL",0
37,"37085",5060,3732,3689,52,43,"UPL",7
37,"37003",104,75,75,2,0,"UPL",0
49,"49062",103,58,58,0,0,"UPL",0
37,"37074",136,93,90,1,3,"UPL",0
37,"37024",89,60,60,0,0,"UPL",0
49,"49039",324,249,239,3,10,"UPL",0
24,"24059",804,466,463,5,3,"UPL",0
49,"49102",182,130,130,2,0,"UPL",0
24,"24038",3024,2121,2071,25,50,"UPL",12
37,"37027",239,182,179,2,3,"UPL",0
24,"24063",362,247,245,2,2,"UPL",24
37,"37062",78,59,59,0,0,"UPL",0
37,"37319",88,68,64,2,4,"UPL",0
37,"37039",279,202,197,2,5,"UPL",0
37,"37061",195,136,136,1,0,"UPL",0
37,"37194",229,161,160,0,1,"UPL",0
37,"37253",135,109,109,1,0,"UPL",0
24,"24174",457,294,289,3,5,"UPL",11
37,"37035",162,115,115,1,0,"UPL",0
49,"49004",110,74,71,3,3,"UPL",3
37,"37341",47,29,29,0,0,"UPL",0
37,"37267",177,130,129,0,1,"UPL",0
24,"24051",389,275,269,1,6,"UPL",6
49,"49091",246,168,167,1,1,"UPL",1
24,"24092",731,506,504,1,2,"UPL",5
37,"37369",126,83,81,0,2,"UPL",0
49,"49214",666,486,477,6,9,"UPL",6
49,"49038",88,63,58,1,5,"UPL",0
37,"37047",215,89,89,0,0,"UPL",0
24,"24050",105,77,77,2,0,"UPL",2
24,"24046",893,595,583,6,12,"UPL",18
37,"37373",692,451,442,4,9,"UPL",0
37,"37113",404,286,285,13,1,"UPL",0
49,"49095",282,202,201,6,1,"UPL",0
49,"49056",285,191,190,3,1,"UPL",0
37,"37037",108,72,72,0,0,"UPL",0
37,"37147",184,126,124,1,2,"UPL",0
49,"49273",165,90,90,0,0,"UPL",1
24,"24207",276,215,215,2,0,"UPL",8
37,"37181",265,158,158,0,0,"UPL",1
37,"37138",222,163,159,3,4,"UPL",0
37,"37193",362,253,252,4,1,"UPL",0
49,"49250",1191,844,824,8,20,"UPL",0
37,"37225",97,78,74,0,4,"UPL",1
49,"49119",217,158,156,2,2,"UPL",0
37,"37270",184,139,136,2,3,"UPL",1
49,"49263",44,32,32,1,0,"UPL",0
24,"24067",602,327,324,6,3,"UPL",2
24,"24091",575,368,362,5,6,"UPL",8
24,"24081",121,72,72,0,0,"UPL",0
37,"37286",204,140,137,2,3,"UPL",0
37,"37291",269,186,185,1,1,"UPL",0
37,"37214",120,70,68,2,2,"UPL",0
37,"37050",66,52,52,1,0,"UPL",0
37,"37351",268,229,226,0,3,"UPL",1
49,"49093",280,226,223,5,3,"UPL",0
37,"37132",317,211,207,0,4,"UPL",0
24,"24044",150,91,89,2,2,"UPL",1
37,"37226",152,113,113,2,0,"UPL",0
37,"37122",203,162,161,3,1,"UPL",0
49,"49015",198,156,155,0,1,"UPL",0
24,"24143",497,344,343,3,1,"UPL",1
49,"49266",66,46,45,1,1,"UPL",1
24,"24028",367,275,273,5,2,"UPL",26
24,"24078",324,228,225,0,3,"UPL",6
24,"24113",346,240,240,2,0,"UPL",5
49,"49117",431,294,289,0,5,"UPL",1
24,"24163",4076,2979,2954,35,25,"UPL",183
24,"24114",2866,1753,1742,15,11,"UPL",77
49,"49008",423,263,259,1,4,"UPL",1
37,"37321",150,118,115,0,3,"UPL",1
37,"37032",553,388,388,2,0,"UPL",2
49,"49223",701,498,494,7,4,"UPL",0
37,"37293",102,68,68,1,0,"UPL",0
37,"37242",82,59,59,1,0,"UPL",1
24,"24154",952,625,618,5,7,"UPL",13
37,"37019",138,111,109,0,2,"UPL",0
49,"49099",96,67,67,0,0,"UPL",0
37,"37182",75,47,47,1,0,"UPL",0
49,"49142",244,163,160,0,3,"UPL",0
37,"37213",83,64,64,0,0,"UPL",0
37,"37033",94,67,67,0,0,"UPL",1
37,"37054",233,190,186,2,4,"UPL",0
24,"24031",207,160,158,0,2,"UPL",8
49,"49100",281,164,157,2,7,"UPL",2
37,"37378",92,54,54,0,0,"UPL",1
24,"24176",302,232,226,0,6,"UPL",13
37,"37069",981,669,657,3,12,"UPL",0
37,"37325",88,63,63,0,0,"UPL",0
24,"24070",3886,2677,2625,18,52,"UPL",7
49,"49155",81,60,59,0,1,"UPL",0
24,"24151",433,307,304,1,3,"UPL",10
49,"49175",204,136,135,3,1,"UPL",0
49,"49201",283,232,228,3,4,"UPL",0
37,"37125",231,154,148,1,6,"UPL",0
37,"37107",10444,6997,6884,76,113,"UPL",14
37,"37310",166,116,115,3,1,"UPL",0
49,"49050",498,305,305,2,0,"UPL",1
24,"24181",1404,944,925,7,19,"UPL",6
24,"24086",258,197,196,1,1,"UPL",6
37,"37228",324,262,262,1,0,"UPL",0
24,"24096",105,56,54,1,2,"UPL",2
24,"24060",561,297,296,2,1,"UPL",38
24,"24167",703,436,430,3,6,"UPL",10
49,"49011",214,147,146,5,1,"UPL",0
24,"24182",410,273,270,7,3,"UPL",9
24,"24222",14499,10219,10076,99,143,"UPL",546
49,"49016",230,155,155,0,0,"UPL",0
24,"24098",1149,753,741,8,12,"UPL",28
37,"37359",165,105,103,0,2,"UPL",0
49,"49125",1392,883,871,11,12,"UPL",2
49,"49079",104,79,76,0,3,"UPL",0
37,"37329",38,29,28,1,1,"UPL",0
37,"37140",630,395,393,0,2,"UPL",0
49,"49197",155,109,104,0,5,"UPL",0
49,"49005",125,80,80,1,0,"UPL",0
49,"49238",273,205,200,4,5,"UPL",1
49,"49080",622,440,437,4,3,"UPL",0
49,"49087",476,246,244,0,2,"UPL",2
49,"49234",394,282,277,0,5,"UPL",0
24,"24011",182,104,102,3,2,"UPL",0
37,"37098",290,197,197,1,0,"UPL",0
37,"37367",179,147,143,2,4,"UPL",1
24,"24034",3466,2382,2359,25,23,"UPL",5
49,"49162",170,117,116,1,1,"UPL",0
37,"37247",171,129,128,0,1,"UPL",0
24,"24198",541,346,344,6,2,"UPL",1
37,"37309",36,21,21,0,0,"UPL",0
49,"49275",51064,34471,34017,475,454,"UPL",169
37,"37246",5146,3791,3737,42,54,"UPL",7
37,"37086",107,86,85,2,1,"UPL",0
49,"49267",96,67,63,2,4,"UPL",2
37,"37100",74,59,58,1,1,"UPL",0
49,"49029",609,435,419,6,16,"UPL",0
37,"37139",189,150,148,1,2,"UPL",0
37,"37073",613,448,440,4,8,"UPL",0
37,"37288",281,220,218,4,2,"UPL",0
24,"24213",158,127,126,1,1,"UPL",12
24,"24225",979,678,668,5,10,"UPL",42
37,"37268",106,62,61,1,1,"UPL",1
37,"37097",42,29,29,0,0,"UPL",0
37,"37265",198,167,163,1,4,"UPL",0
49,"49261",1504,1044,1026,7,18,"UPL",8
49,"49136",313,218,217,5,1,"UPL",0
49,"49105",135,94,94,2,0,"UPL",0
24,"24006",488,356,347,4,9,"UPL",36
49,"49219",7196,4613,4528,64,85,"UPL",8
24,"24054",410,275,271,0,4,"UPL",7
37,"37018",106,75,75,0,0,"UPL",0
37,"37363",104,81,80,0,1,"UPL",0
49,"49067",329,200,198,4,2,"UPL",0
37,"37269",424,280,277,2,3,"UPL",0
24,"24055",674,484,482,8,2,"UPL",20
37,"37051",79,58,58,0,0,"UPL",0
37,"37238",105,83,80,0,3,"UPL",0
37,"37205",212,157,155,1,2,"UPL",1
49,"49129",810,541,527,4,14,"UPL",0
49,"49130",155,116,112,1,4,"UPL",0
24,"24099",153,111,110,1,1,"UPL",1
37,"37192",361,200,198,3,2,"UPL",1
24,"24076",1283,926,913,10,13,"UPL",43
37,"37364",760,502,500,0,2,"UPL",0
24,"24172",389,208,202,1,6,"UPL",3
37,"37371",252,156,155,0,1,"UPL",0
37,"37344",229,157,147,2,10,"UPL",0
37,"37240",928,648,637,2,11,"UPL",0
24,"24008",8931,6291,6214,79,77,"UPL",143
37,"37322",2462,1580,1537,14,43,"UPL",0
37,"37078",781,626,603,9,23,"UPL",0
37,"37280",70,47,46,0,1,"UPL",0
37,"37230",220,169,168,1,1,"UPL",0
37,"37381",138,98,93,0,5,"UPL",1
24,"24228",619,370,364,2,6,"UPL",23
37,"37187",548,407,399,0,8,"UPL",0
49,"49229",109,80,77,1,3,"UPL",0
37,"37031",329,241,238,3,3,"UPL",0
37,"37021",66,45,44,0,1,"UPL",1
37,"37251",108,75,75,0,0,"UPL",0
24,"24116",387,227,226,3,1,"UPL",8
49,"49131",231,149,145,1,4,"UPL",0
24,"24077",212,166,162,0,4,"UPL",5
49,"49007",361,241,233,7,8,"UPL",0
37,"37278",793,570,567,6,3,"UPL",0
49,"49191",265,192,188,2,4,"UPL",0
49,"49034",408,282,281,2,1,"UPL",0
24,"24021",1595,1037,1025,7,12,"UPL",54
37,"37356",84,58,58,0,0,"UPL",0
37,"37167",174,147,144,2,3,"UPL",0
49,"49169",38,33,32,0,1,"UPL",0
24,"24230",403,268,265,3,3,"UPL",7
37,"37199",128,92,92,2,0,"UPL",0
24,"24010",8251,5357,5275,40,82,"UPL",145
49,"49086",111,89,89,1,0,"UPL",0
37,"37262",69,51,51,0,0,"UPL",0
37,"37092",1933,1342,1327,13,15,"UPL",1
37,"37056",39,28,28,0,0,"UPL",0
37,"37178",98,70,70,0,0,"UPL",0
24,"24168",430,325,322,6,3,"UPL",13
37,"37243",89,66,66,0,0,"UPL",1
37,"37252",99,65,65,1,0,"UPL",0
37,"37290",130,106,106,0,0,"UPL",0
24,"24083",997,659,647,9,12,"UPL",13
37,"37209",415,276,275,2,1,"UPL",1
49,"49220",146,102,98,3,4,"UPL",0
24,"24901",853,517,513,4,4,"UPL",29
49,"49259",79,59,59,0,0,"UPL",0
37,"37222",78,55,55,2,0,"UPL",0
24,"24146",254,202,201,1,1,"UPL",6
49,"49193",428,261,253,3,8,"UPL",0
24,"24194",267,178,177,1,1,"UPL",3
37,"37233",53,39,39,1,0,"UPL",0
37,"37065",276,167,167,2,0,"UPL",0
37,"37152",400,268,261,4,7,"UPL",0
37,"37287",297,204,202,2,2,"UPL",0
24,"24080",207,155,154,1,1,"UPL",4
24,"24209",2597,1651,1636,12,15,"UPL",4
37,"37306",238,140,136,3,4,"UPL",1
37,"37348",100,76,76,0,0,"UPL",0
49,"49159",269,182,182,2,0,"UPL",0
49,"49088",80,51,51,0,0,"UPL",1
37,"37046",10648,7396,7241,62,155,"UPL",20
37,"37170",1361,909,884,9,25,"UPL",1
37,"37079",77,59,59,1,0,"UPL",0
24,"24133",357,256,256,1,0,"UPL",4
49,"49113",162,131,131,2,0,"UPL",0
24,"24037",330,189,189,1,0,"UPL",3
37,"37380",55,41,40,2,1,"UPL",0
37,"37025",245,198,196,5,2,"UPL",0
37,"37071",76,64,62,1,2,"UPL",0
37,"37201",238,170,168,0,2,"UPL",3
37,"37150",34,31,31,0,0,"UPL",0
37,"37015",198,127,125,2,2,"UPL",0
37,"37339",295,219,219,5,0,"UPL",2
37,"37171",396,272,270,2,2,"UPL",0
49,"49172",474,278,271,1,7,"UPL",1
24,"24223",2533,1727,1705,40,22,"UPL",54
49,"49185",156,120,116,0,4,"UPL",0
49,"49173",335,165,163,4,2,"UPL",1
37,"37318",196,132,132,0,0,"UPL",0
37,"37026",180,148,147,5,1,"UPL",1
49,"49061",143,98,97,1,1,"UPL",1
24,"24197",717,500,499,2,1,"UPL",11
37,"37049",125,76,76,0,0,"UPL",0
24,"24157",2542,1846,1809,16,37,"UPL",170
49,"49065",1048,747,725,6,22,"UPL",0
37,"37256",191,123,123,1,0,"UPL",0
24,"24224",564,381,375,5,6,"UPL",16
49,"49127",2402,1640,1604,18,36,"UPL",6
49,"49150",123,95,92,3,3,"UPL",0
37,"37110",104,81,79,1,2,"UPL",0
37,"37007",391,289,281,7,8,"UPL",0
24,"24123",709,461,457,2,4,"UPL",13
24,"24115",53159,35203,34784,410,419,"UPL",125
24,"24189",5872,3915,3873,42,42,"UPL",202
37,"37274",118296,84144,83280,880,864,"UPL",109
24,"24064",1501,1030,1012,2,18,"UPL",5
37,"37184",289,178,177,1,1,"UPL",0
49,"49018",277,197,190,2,7,"UPL",3
37,"37382",162,127,124,0,3,"UPL",0
37,"37362",4783,3469,3420,44,49,"UPL",6
24,"24040",416,293,292,2,1,"UPL",5
24,"24053",398,250,248,1,2,"UPL",5
24,"24025",283,190,185,3,5,"UPL",14
37,"37028",131,96,93,2,3,"UPL",0
37,"37258",134,92,92,1,0,"UPL",0
49,"49030",79,56,56,0,0,"UPL",0
37,"37029",186,125,124,1,1,"UPL",0
49,"49152",474,289,282,2,7,"UPL",1
37,"37143",384,273,273,2,0,"UPL",0
49,"49187",1197,839,819,12,20,"UPL",1
37,"37087",911,675,665,5,10,"UPL",1
49,"49153",150,110,107,2,3,"UPL",0
24,"24175",1821,1316,1305,15,11,"UPL",74
37,"37342",250,190,189,3,1,"UPL",1
24,"24214",626,438,433,8,5,"UPL",4
24,"24153",228,171,171,3,0,"UPL",6
37,"37063",58,47,47,0,0,"UPL",0
24,"24164",351,175,174,0,1,"UPL",8
24,"24202",7504,4607,4538,51,69,"UPL",52
49,"49083",47,37,37,1,0,"UPL",0
49,"49262",367,263,261,1,2,"UPL",0
24,"24141",96,74,74,0,0,"UPL",4
37,"37030",82,60,60,0,0,"UPL",0
49,"49210",447,350,348,3,2,"UPL",0
37,"37354",5479,3969,3905,37,64,"UPL",4
37,"37259",39,28,28,1,0,"UPL",0
37,"37089",60,44,43,0,1,"UPL",0
49,"49010",350,260,256,8,4,"UPL",2
37,"37010",925,645,638,5,7,"UPL",0
49,"49166",1193,835,821,7,14,"UPL",1
37,"37260",137,110,109,0,1,"UPL",0
37,"37206",87,65,54,0,11,"UPL",0
37,"37173",1412,951,937,15,14,"UPL",1
49,"49138",205,141,140,2,1,"UPL",0
49,"49104",326,218,216,0,2,"UPL",0
24,"24104",243,167,166,0,1,"UPL",5
37,"37145",236,173,170,3,3,"UPL",0
37,"37345",150,117,113,0,4,"UPL",0
37,"37103",409,295,294,2,1,"UPL",1
24,"24216",666,453,445,4,8,"UPL",13
37,"37323",474,335,325,5,10,"UPL",0
49,"49109",561,419,415,6,4,"UPL",1
37,"37215",133,93,90,1,3,"UPL",0
24,"24178",60,54,54,1,0,"UPL",2
49,"49233",85,51,51,0,0,"UPL",0
49,"49156",218,149,144,0,5,"UPL",2
49,"49033",655,440,434,4,6,"UPL",2
37,"37271",349,262,258,2,4,"UPL",1
49,"49110",344,196,195,2,1,"UPL",0
49,"49222",369,250,247,2,3,"UPL",0
49,"49098",200,139,138,3,1,"UPL",0
37,"37376",2130,1446,1423,18,23,"UPL",2
24,"24033",209,149,149,0,0,"UPL",4
49,"49046",246,174,169,0,5,"UPL",0
37,"37198",202,147,144,2,3,"UPL",2
37,"37346",251,208,207,1,1,"UPL",0
24,"24156",220,135,133,0,2,"UPL",2
37,"37221",391,259,257,2,2,"UPL",2
24,"24218",451,310,308,3,2,"UPL",22
49,"49206",776,515,504,7,11,"UPL",1
49,"49122",761,517,505,7,12,"UPL",1
49,"49013",219,160,159,0,1,"UPL",0
49,"49157",188,136,133,2,3,"UPL",1
37,"37315",89,65,64,0,1,"UPL",0
49,"49123",519,384,383,4,1,"UPL",1
37,"37159",74,59,59,0,0,"UPL",0
49,"49024",626,432,426,3,6,"UPL",1
37,"37128",235,169,168,0,1,"UPL",0
24,"24180",1086,767,759,9,8,"UPL",17
24,"24107",206,147,147,1,0,"UPL",4
37,"37337",137,104,103,0,1,"UPL",0
24,"24084",153,105,102,2,3,"UPL",1
49,"49032",282,196,196,0,0,"UPL",1
49,"49120",54,35,35,0,0,"UPL",0
24,"24166",1346,929,916,14,13,"UPL",24
49,"49135",576,368,366,3,2,"UPL",2
24,"24001",165,93,93,0,0,"UPL",5
49,"49171",603,433,427,4,6,"UPL",1
37,"37119",99,78,78,1,0,"UPL",0
37,"37190",189,141,139,1,2,"UPL",0
37,"37129",248,181,181,1,0,"UPL",0
37,"37223",106,75,74,0,1,"UPL",0
37,"37285",360,271,270,0,1,"UPL",0
37,"37096",203,144,144,2,0,"UPL",0
49,"49026",199,134,134,0,0,"UPL",0
37,"37083",181,155,153,1,2,"UPL",0
37,"37005",65,44,44,1,0,"UPL",0
37,"37235",214,163,159,2,4,"UPL",0
49,"49114",40,31,27,0,4,"UPL",0
37,"37108",98,75,75,3,0,"UPL",0
49,"49184",172,110,107,2,3,"UPL",1
49,"49160",42,27,27,0,0,"UPL",0
24,"24097",200,138,137,1,1,"UPL",14
24,"24061",1753,1234,1223,10,11,"UPL",53
37,"37161",123,86,86,0,0,"UPL",0
24,"24101",370,219,213,4,6,"UPL",3
24,"24121",599,422,418,3,4,"UPL",9
49,"49126",260,153,150,1,3,"UPL",0
49,"49052",183,120,117,2,3,"UPL",1
24,"24003",603,374,372,0,2,"UPL",3
24,"24087",582,431,427,3,4,"UPL",22
49,"49103",392,319,316,5,3,"UPL",0
37,"37131",175,125,125,0,0,"UPL",0
49,"49137",167,123,121,0,2,"UPL",1
37,"37330",314,227,223,2,4,"UPL",1
37,"37072",144,121,118,5,3,"UPL",0
24,"24027",1214,841,828,6,13,"UPL",1
37,"37350",403,281,274,1,7,"UPL",0
37,"37203",151,114,113,1,1,"UPL",0
37,"37141",149,101,100,0,1,"UPL",0
24,"24162",1753,1259,1245,12,14,"UPL",88
49,"49200",936,679,670,9,9,"UPL",1
49,"49163",203,139,138,3,1,"UPL",0
37,"37017",226,169,168,4,1,"UPL",0
37,"37166",196,134,133,1,1,"UPL",0
24,"24004",495,387,384,10,3,"UPL",10
37,"37163",34,24,24,0,0,"UPL",0
49,"49178",748,520,505,7,15,"UPL",4
49,"49054",847,576,569,8,7,"UPL",0
37,"37299",230,148,147,0,1,"UPL",0
49,"49256",236,183,179,0,4,"UPL",0
49,"49040",109,89,87,2,2,"UPL",0
24,"24017",532,375,374,1,1,"UPL",12
37,"37332",65,49,49,0,0,"UPL",0
49,"49265",110,79,78,2,1,"UPL",0
37,"37112",158,110,109,2,1,"UPL",0
37,"37101",138,101,100,1,1,"UPL",1
49,"49164",141,95,92,1,3,"UPL",0
24,"24029",686,430,428,6,2,"UPL",20
37,"37164",232,176,175,3,1,"UPL",0
49,"49055",91,72,72,3,0,"UPL",0
49,"49019",232,162,152,2,10,"UPL",1
24,"24152",433,269,267,4,2,"UPL",2
37,"37279",713,488,480,4,8,"UPL",0
49,"49176",605,360,353,0,7,"UPL",0
37,"37168",397,271,266,3,5,"UPL",0
37,"37248",150,116,116,1,0,"UPL",1
49,"49252",312,240,236,7,4,"UPL",1
37,"37311",201,157,156,1,1,"UPL",0
49,"49202",173,103,101,0,2,"UPL",0
37,"37217",59,43,43,3,0,"UPL",0
49,"49255",387,304,298,3,6,"UPL",0
49,"49068",422,263,261,4,2,"UPL",0
24,"24066",439,274,273,3,1,"UPL",8
37,"37196",70,50,50,0,0,"UPL",0
37,"37175",412,298,293,4,5,"UPL",2
24,"24215",149,116,115,0,1,"UPL",5
37,"37040",376,291,288,0,3,"UPL",0
24,"24043",116,54,52,0,2,"UPL",3
37,"37250",325,212,211,0,1,"UPL",0
49,"49177",255,145,144,1,1,"UPL",0
49,"49009",382,251,251,0,0,"UPL",2
37,"37148",399,295,291,0,4,"UPL",0
49,"49108",446,312,309,2,3,"UPL",0
24,"24221",738,492,485,9,7,"UPL",15
49,"49069",337,210,201,0,9,"UPL",1
37,"37135",1146,849,837,5,12,"UPL",1
49,"49014",116,83,83,1,0,"UPL",0
37,"37335",384,282,279,1,3,"UPL",1
37,"37241",167,121,119,3,2,"UPL",0
49,"49078",138,113,109,4,4,"UPL",0
24,"24032",99,70,66,1,4,"UPL",0
37,"37313",535,395,394,1,1,"UPL",0
49,"49097",67,44,44,0,0,"UPL",0
24,"24144",621,419,412,4,7,"UPL",11
37,"37055",117,97,93,0,4,"UPL",0
49,"49145",208,113,113,1,0,"UPL",1
49,"49268",364,266,263,3,3,"UPL",1
49,"49258",111,93,93,2,0,"UPL",0
37,"37177",259,198,197,3,1,"UPL",0
49,"49179",337,210,209,3,1,"UPL",1
24,"24105",1512,1054,1047,10,7,"UPL",52
24,"24069",37,26,25,0,1,"UPL",0
37,"37219",169,88,85,1,3,"UPL",0
49,"49168",89,68,68,0,0,"UPL",0
37,"37154",129,97,94,1,3,"UPL",0
37,"37232",377,303,303,2,0,"UPL",0
24,"24082",847,615,608,16,7,"UPL",17
24,"24094",1320,866,852,11,14,"UPL",37
24,"24191",106,70,69,2,1,"UPL",5
49,"49111",119,84,84,3,0,"UPL",0
49,"49245",251,174,171,1,3,"UPL",1
49,"49047",98,74,72,1,2,"UPL",1
49,"49270",139,93,92,0,1,"UPL",0
49,"49035",220,180,180,4,0,"UPL",0
37,"37169",177,122,122,0,0,"UPL",0
37,"37013",104,72,70,2,2,"UPL",0
49,"49224",166,102,100,0,2,"UPL",0
24,"24118",101,72,72,0,0,"UPL",7
49,"49134",158,100,99,1,1,"UPL",0
49,"49002",58,43,40,0,3,"UPL",0
37,"37357",248,193,192,1,1,"UPL",2
49,"49186",230,172,170,0,2,"UPL",0
49,"49048",113,88,88,0,0,"UPL",0
37,"37361",84,55,54,1,1,"UPL",0
37,"37160",597,380,370,3,10,"UPL",1
49,"49247",412,255,252,2,3,"UPL",0
37,"37254",174,140,135,0,5,"UPL",0
24,"24170",1806,1232,1220,9,12,"UPL",26
24,"24071",947,618,611,6,7,"UPL",0
49,"49240",185,125,123,3,2,"UPL",0
37,"37368",17,12,11,0,1,"UPL",0
24,"24002",224,165,162,1,3,"UPL",1
37,"37296",297,215,210,0,5,"UPL",0
37,"37275",98,67,67,0,0,"UPL",0
37,"37004",25,18,18,0,0,"UPL",0
24,"24014",7152,4494,4448,47,46,"UPL",29
49,"49149",368,270,266,1,4,"UPL",0
37,"37130",173,135,134,2,1,"UPL",0
49,"49248",171,128,128,1,0,"UPL",0
24,"24108",348,247,246,4,1,"UPL",6
37,"37212",104,76,76,0,0,"UPL",0
37,"37328",159,112,110,1,2,"UPL",0
49,"49272",73,49,46,2,3,"UPL",0
49,"49230",84,69,69,0,0,"UPL",0
24,"24117",410,302,301,1,1,"UPL",4
24,"24065",2164,1524,1492,12,32,"UPL",78
37,"37224",189,156,153,2,3,"UPL",0
49,"49249",61,45,45,1,0,"UPL",0
24,"24150",226,163,162,0,1,"UPL",7
37,"37165",31,22,22,0,0,"UPL",0
37,"37059",117,95,95,3,0,"UPL",0
37,"37120",98,78,76,0,2,"UPL",0
37,"37016",563,419,411,4,8,"UPL",0
37,"37172",846,530,524,6,6,"UPL",0
37,"37370",316,238,237,2,1,"UPL",2
49,"49092",115,72,72,0,0,"UPL",0
24,"24088",996,750,745,9,5,"UPL",19
37,"37236",123,85,82,1,3,"UPL",0
24,"24016",488,244,243,0,1,"UPL",1
37,"37360",206,135,135,1,0,"UPL",1
37,"37340",141,97,97,1,0,"UPL",2
37,"37189",114,75,74,1,1,"UPL",0
24,"24052",139,94,93,0,1,"UPL",6
37,"37358",159,124,124,0,0,"UPL",1
49,"49260",693,480,473,3,7,"UPL",1
37,"37060",283,205,202,1,3,"UPL",1
37,"37034",77,63,62,0,1,"UPL",0
49,"49190",50,42,42,3,0,"UPL",0
49,"49232",85,64,64,0,0,"UPL",0
37,"37156",4261,2928,2869,23,59,"UPL",4
49,"49044",78,56,53,0,3,"UPL",0
49,"49143",201,119,118,1,1,"UPL",0
37,"37142",554,396,394,5,2,"UPL",2
49,"49066",437,276,272,2,4,"UPL",2
37,"37237",296,212,204,1,8,"UPL",0
49,"49216",147,115,109,0,6,"UPL",1
24,"24139",2071,1371,1346,15,25,"UPL",51
37,"37352",209,157,155,3,2,"UPL",2
49,"49139",149,112,112,0,0,"UPL",0
24,"24090",323,200,200,2,0,"UPL",5
24,"24124",338,196,195,2,1,"UPL",5
37,"37282",193,132,131,3,1,"UPL",0
37,"37174",975,716,705,2,11,"UPL",0
49,"49192",123,93,90,2,3,"UPL",0
37,"37022",242,191,190,0,1,"UPL",1
37,"37303",179,118,117,1,1,"UPL",1
49,"49094",210,111,111,0,0,"UPL",0
37,"37002",125,64,63,0,1,"UPL",0
37,"37133",101,73,69,1,4,"UPL",0
24,"24206",1594,1104,1093,11,11,"UPL",0
24,"24201",1029,683,676,9,7,"UPL",35
37,"37009",197,145,144,1,1,"UPL",0
24,"24125",416,233,231,3,2,"UPL",1
37,"37195",39,31,31,0,0,"UPL",0
49,"49043",256,191,189,1,2,"UPL",1
37,"37249",37,28,28,0,0,"UPL",0
37,"37333",203,125,124,2,1,"UPL",0
49,"49096",155,113,112,2,1,"UPL",0
24,"24056",2726,1803,1772,21,31,"UPL",251
37,"37124",195,137,137,2,0,"UPL",1
49,"49231",288,208,203,0,5,"UPL",3
37,"37266",68,44,44,0,0,"UPL",0
37,"37316",711,546,541,7,5,"UPL",2
24,"24212",983,693,684,10,9,"UPL",53
49,"49028",108,90,89,1,1,"UPL",1
37,"37057",208,151,149,0,2,"UPL",0
49,"49147",250,164,162,1,2,"UPL",0
49,"49208",352,223,214,1,9,"UPL",0
24,"24148",1602,1152,1140,11,12,"UPL",28
37,"37082",733,468,456,7,12,"UPL",0
37,"37180",68,45,44,1,1,"UPL",0
37,"37305",219,177,175,2,2,"UPL",1
24,"24012",278,182,180,0,2,"UPL",12
49,"49244",46,23,23,0,0,"UPL",0
37,"37090",68,47,47,0,0,"UPL",0
49,"49121",372,239,233,1,6,"UPL",2
37,"37116",70,50,50,0,0,"UPL",0
24,"24190",146,103,103,2,0,"UPL",5
37,"37146",106,82,76,0,6,"UPL",0
37,"37157",76,64,63,1,1,"UPL",0
49,"49059",84,61,58,0,3,"UPL",0
37,"37379",169,133,132,0,1,"UPL",2
37,"37091",161,104,104,0,0,"UPL",0
49,"49101",144,88,82,1,6,"UPL",0
49,"49128",520,384,378,7,6,"UPL",0
37,"37044",431,309,308,3,1,"UPL",0
49,"49012",70,34,34,0,0,"UPL",0
37,"37231",236,185,183,5,2,"UPL",1
37,"37136",625,388,387,7,1,"UPL",0
37,"37349",100,61,58,0,3,"UPL",3
37,"37272",132,97,95,0,2,"UPL",0
37,"37080",221,164,163,1,1,"UPL",0
37,"37068",337,240,236,1,4,"UPL",0
24,"24023",264,188,185,1,3,"UPL",5
24,"24047",708,462,459,1,3,"UPL",64
37,"37263",339,215,210,0,5,"UPL",0
49,"49180",135,82,81,5,1,"UPL",1
49,"49246",214,183,180,3,3,"UPL",2
37,"37273",85,58,58,2,0,"UPL",0
37,"37117",1572,1103,1092,12,11,"UPL",3
49,"49158",206,159,155,0,4,"UPL",0
37,"37155",68,48,48,0,0,"UPL",0
49,"49006",139,98,95,3,3,"UPL",0
24,"24122",1292,818,810,7,8,"UPL",0
49,"49228",53,36,36,0,0,"UPL",0
37,"37327",179,148,147,2,1,"UPL",0
37,"37151",142,109,109,1,0,"UPL",0
37,"37244",129,97,97,1,0,"UPL",0
49,"49236",71,54,54,0,0,"UPL",0
37,"37041",71,53,53,0,0,"UPL",0
49,"49239",599,393,384,6,9,"UPL",0
24,"24177",467,265,263,2,2,"UPL",10
49,"49167",180,131,131,2,0,"UPL",0
37,"37058",56,38,38,1,0,"UPL",0
49,"49181",333,197,195,2,2,"UPL",1
49,"49237",142,78,78,0,0,"UPL",0
37,"37338",77,58,58,0,0,"UPL",1
49,"49037",174,139,136,1,3,"UPL",0
24,"24160",633,404,403,2,1,"UPL",8
37,"37234",314,194,192,3,2,"UPL",0
24,"24073",437,285,282,1,3,"UPL",16
24,"24217",135,93,93,0,0,"UPL",4
24,"24210",524,353,353,1,0,"UPL",12
37,"37123",159,124,123,2,1,"UPL",0
49,"49205",359,252,251,7,1,"UPL",0
37,"37336",56,45,43,2,2,"UPL",0
24,"24022",304,198,195,2,3,"UPL",1
24,"24019",338,259,256,4,3,"UPL",0
24,"24109",857,534,528,8,6,"UPL",7
24,"24041",513,312,305,4,7,"UPL",0
37,"37353",122,82,80,0,2,"UPL",0
24,"24149",149,123,123,0,0,"UPL",4
24,"24030",4158,2746,2696,18,50,"UPL",9
37,"37374",1138,889,872,2,17,"UPL",0
24,"24026",1085,724,712,14,12,"UPL",26
24,"24074",97,70,70,1,0,"UPL",5
49,"49027",125,82,81,0,1,"UPL",0
37,"37202",1004,773,763,12,10,"UPL",3
49,"49115",167,121,121,2,0,"UPL",0
49,"49227",317,245,244,4,1,"UPL",0
37,"37176",128,99,98,1,1,"UPL",0
37,"37283",116,83,83,0,0,"UPL",0
49,"49235",415,300,290,4,10,"UPL",0
49,"49022",282,230,229,2,1,"UPL",0
49,"49251",159,116,109,2,7,"UPL",0
24,"24161",294,208,204,3,4,"UPL",4
24,"24185",447,303,295,1,8,"UPL",12
24,"24119",695,464,458,7,6,"UPL",1
24,"24049",1417,983,975,14,8,"UPL",3
37,"37014",1140,747,737,7,10,"UPL",1
49,"49071",716,432,429,6,3,"UPL",3
24,"24169",2777,1908,1880,10,28,"UPL",9
24,"24902",331,239,239,0,0,"UPL",9
37,"37208",71,49,49,0,0,"UPL",0
24,"24089",101036,71905,71305,744,600,"UPL",3868
49,"49116",356,239,234,4,5,"UPL",1
37,"37292",91,65,65,0,0,"UPL",0
49,"49133",287,206,203,1,3,"UPL",3
49,"49041",409,287,282,1,5,"UPL",0
49,"49023",899,627,620,3,7,"UPL",2
49,"49257",305,186,184,0,2,"UPL",0
37,"37001",165,120,120,0,0,"UPL",0
37,"37188",158,107,105,3,2,"UPL",0
24,"24229",376,275,269,2,6,"UPL",17
49,"49063",303,228,227,3,1,"UPL",1
37,"37314",81,65,65,0,0,"UPL",0
24,"24103",274,134,134,0,0,"UPL",0
49,"49207",215,144,143,1,1,"UPL",2
24,"24058",189,115,114,1,1,"UPL",6
49,"49085",904,583,579,5,4,"UPL",7
37,"37149",60,50,50,0,0,"UPL",0
37,"37229",138,103,101,0,2,"UPL",0
37,"37121",536,413,403,4,10,"UPL",0
24,"24227",1527,1036,1032,13,4,"UPL",77
49,"49020",253,189,187,0,2,"UPL",0
37,"37102",375,260,260,4,0,"UPL",0
49,"49189",186,104,104,1,0,"UPL",0
37,"37144",327,233,233,2,0,"UPL",2
37,"37020",431,320,314,3,6,"UPL",2
24,"24155",441,340,334,2,6,"UPL",14
49,"49183",90,67,65,2,2,"UPL",0
37,"37264",56,39,39,0,0,"UPL",0
49,"49269",218,126,124,1,2,"UPL",0
37,"37255",43,33,31,1,2,"UPL",0
37,"37281",39,28,27,0,1,"UPL",0
37,"37011",100,78,78,3,0,"UPL",0
37,"37261",213,153,149,0,4,"UPL",0
49,"49209",451,274,269,7,5,"UPL",1
24,"24158",296,197,192,0,5,"UPL",3
37,"37081",879,680,674,2,6,"UPL",0
37,"37284",317,229,222,2,7,"UPL",0
37,"37302",262,161,161,2,0,"UPL",1
24,"24095",317,228,228,3,0,"UPL",11
49,"49132",310,220,215,2,5,"UPL",0
37,"37239",203,175,174,2,1,"UPL",0
49,"49058",301,222,221,1,1,"UPL",1
37,"37008",4213,3092,3046,21,46,"UPL",1
49,"49064",478,297,296,6,1,"UPL",2
49,"49170",99,68,68,1,0,"UPL",0
24,"24079",861,601,595,9,6,"UPL",24
37,"37104",24,16,16,0,0,"UPL",0
49,"49148",259,119,115,1,4,"UPL",0
37,"37067",3278,2568,2529,30,39,"UPL",6
49,"49090",190,135,134,3,1,"UPL",0
49,"49146",265,183,181,4,2,"UPL",0
37,"37211",208,148,148,0,0,"UPL",0
37,"37347",463,349,345,9,4,"UPL",0
37,"37045",27,19,19,0,0,"UPL",0
49,"49076",330,230,226,9,4,"UPL",1
24,"24024",636,407,403,6,4,"UPL",18
24,"24199",398,263,256,4,7,"UPL",8
37,"37126",30,25,25,0,0,"UPL",0
37,"37070",523,371,365,4,6,"UPL",0
24,"24196",1907,1322,1299,4,23,"UPL",3
24,"24007",735,500,496,8,4,"UPL",2
37,"37137",98,60,59,2,1,"UPL",0
37,"37006",116,71,70,3,1,"UPL",0
49,"49271",176,128,127,3,1,"UPL",1
24,"24136",495,347,344,1,3,"UPL",10
24,"24036",252,146,146,1,0,"UPL",0
37,"37301",84,64,64,1,0,"UPL",0
37,"37023",1624,1233,1211,15,22,"UPL",1
49,"49075",130,100,97,1,3,"UPL",0
37,"37218",51,25,23,0,2,"UPL",0
37,"37179",197,167,165,0,2,"UPL",0
37,"37304",156,97,96,1,1,"UPL",0
24,"24009",274,136,135,1,1,"UPL",1
37,"37204",253,176,173,2,3,"UPL",0
37,"37366",40,34,33,2,1,"UPL",0
49,"49112",118,72,72,2,0,"UPL",0
49,"49225",122,68,68,0,0,"UPL",2
24,"24132",610,330,329,5,1,"UPL",15
24,"24183",748,464,460,9,4,"UPL",18
24,"24127",263,183,181,1,2,"UPL",10
24,"24205",990,678,667,6,11,"UPL",16
24,"24068",430,289,281,0,8,"UPL",21
37,"37289",210,147,144,0,3,"UPL",1
49,"49077",157,80,80,0,0,"UPL",0
37,"37200",190,132,131,0,1,"UPL",0
24,"24142",24715,16839,16616,159,223,"UPL",958
24,"24093",342,214,212,2,2,"UPL",3
24,"24042",60,47,47,2,0,"UPL",0
37,"37324",333,247,242,3,5,"UPL",0
24,"24039",1949,1420,1412,33,8,"UPL",29
37,"37191",102,57,57,1,0,"UPL",0
49,"49003",860,534,530,5,4,"UPL",1
49,"49107",115,70,70,0,0,"UPL",0
37,"37375",678,539,523,8,16,"UPL",0
24,"24159",1716,1238,1216,6,22,"UPL",43
37,"37372",133,99,98,0,1,"UPL",0
24,"24129",114,79,78,2,1,"UPL",3
24,"24057",1295,909,891,7,18,"UPL",4
37,"37134",209,143,141,3,2,"UPL",0
24,"24187",834,559,549,11,10,"UPL",16
37,"37115",108,67,65,0,2,"UPL",0
37,"37088",199,135,133,0,2,"UPL",0
24,"24130",415,291,289,2,2,"UPL",34
24,"24188",3795,2877,2825,40,52,"UPL",100
24,"24120",305,182,181,1,1,"UPL",13
37,"37042",36,27,27,1,0,"UPL",0
37,"37012",144,111,111,0,0,"UPL",0
37,"37377",215,174,173,0,1,"UPL",2
49,"49124",238,170,164,2,6,"UPL",0
49,"49194",331,198,197,0,1,"UPL",4
38,"38015",4055,2635,2601,16,34,"VERDES",3
38,"38036",6857,4170,4090,37,80,"VERDES",15
35,"35013",6593,4596,4516,47,80,"VERDES",4
38,"38029",1475,752,744,10,8,"VERDES",1
38,"38034",3997,2687,2648,19,39,"VERDES",3
35,"35003",5644,2987,2943,20,44,"VERDES",8
35,"35034",8392,3946,3908,27,38,"VERDES",7
35,"35016",300581,181532,179831,1458,1701,"VERDES",846
35,"35009",20229,13378,13201,95,177,"VERDES",20
38,"38020",16057,9921,9809,66,112,"VERDES",25
35,"35004",41975,20773,20602,156,171,"VERDES",104
35,"35019",32830,18390,18243,87,147,"VERDES",52
35,"35006",31373,20764,20476,189,288,"VERDES",64
38,"38001",21069,10844,10777,63,67,"VERDES",38
38,"38027",5581,3577,3533,22,44,"VERDES",6
38,"38022",18630,11420,11284,87,136,"VERDES",12
35,"35022",51765,29309,29034,184,275,"VERDES",89
38,"38002",971,577,570,8,7,"VERDES",1
38,"38050",2417,1288,1273,9,15,"VERDES",1
38,"38043",19365,12355,12212,126,143,"VERDES",33
38,"38023",126137,79423,78706,605,717,"VERDES",317
35,"35028",10156,5483,5425,56,58,"VERDES",14
35,"35030",10046,5584,5505,44,79,"VERDES",15
38,"38039",11149,7375,7326,68,49,"VERDES",16
38,"38051",7328,5017,4969,32,48,"VERDES",7
38,"38042",3778,2410,2386,11,24,"VERDES",1
38,"38014",1342,943,930,6,13,"VERDES",0
35,"35008",6214,4193,4143,33,50,"VERDES",10
38,"38052",1283,806,794,3,12,"VERDES",4
38,"38006",41593,20823,20624,127,199,"VERDES",50
38,"38049",2690,1406,1389,27,17,"VERDES",5
38,"38037",12817,7582,7494,55,88,"VERDES",16
38,"38038",165135,101564,100807,709,757,"VERDES",345
35,"35025",1752,1113,1095,5,18,"VERDES",3
38,"38026",33585,24091,23889,170,202,"VERDES",42
38,"38018",4466,2867,2821,21,46,"VERDES",3
35,"35020",5941,3740,3702,27,38,"VERDES",5
38,"38025",7065,4657,4590,34,67,"VERDES",15
38,"38010",3969,2463,2418,11,45,"VERDES",2
35,"35017",27498,15513,15240,121,273,"VERDES",41
38,"38040",5482,3094,3060,14,34,"VERDES",4
38,"38032",13579,8941,8880,92,61,"VERDES",49
35,"35024",14323,8360,8289,81,71,"VERDES",20
35,"35031",7456,4938,4868,39,70,"VERDES",24
38,"38003",1517,899,890,5,9,"VERDES",2
38,"38011",21655,13974,13831,106,143,"VERDES",38
38,"38019",13884,7888,7809,49,79,"VERDES",17
35,"35033",6393,4147,4072,38,75,"VERDES",13
35,"35023",11742,7787,7651,95,136,"VERDES",23
38,"38041",7025,4729,4684,42,45,"VERDES",10
38,"38004",4536,2914,2887,28,27,"VERDES",7
38,"38016",1174,595,589,2,6,"VERDES",1
38,"38007",1619,1053,1043,3,10,"VERDES",0
38,"38028",22144,14312,14174,89,138,"VERDES",32
35,"35032",3331,2293,2252,23,41,"VERDES",6
35,"35002",24229,15311,15133,101,178,"VERDES",46
35,"35014",11962,5994,5888,60,106,"VERDES",27
38,"38045",3542,1825,1801,7,24,"VERDES",2
38,"38030",1962,1332,1318,9,14,"VERDES",2
38,"38035",10518,5870,5819,37,51,"VERDES",18
38,"38046",9267,6652,6594,55,58,"VERDES",18
38,"38053",3768,2275,2244,16,31,"VERDES",7
35,"35005",1009,680,668,2,12,"VERDES",1
35,"35001",4566,3148,3105,18,43,"VERDES",8
38,"38024",15316,9131,9005,60,126,"VERDES",18
38,"38901",1466,908,894,4,14,"VERDES",0
35,"35021",15072,9791,9696,80,95,"VERDES",42
35,"35027",10502,6831,6750,67,81,"VERDES",14
38,"38031",29301,20926,20701,157,225,"VERDES",32
38,"38008",5699,3719,3669,26,50,"VERDES",9
38,"38005",5646,3302,3283,24,19,"VERDES",4
38,"38048",3952,2543,2519,22,24,"VERDES",5
38,"38009",4315,2846,2817,27,29,"VERDES",7
35,"35015",10752,5289,5222,39,67,"VERDES",20
35,"35007",517,347,345,2,2,"VERDES",0
35,"35029",4415,2498,2472,29,26,"VERDES",8
38,"38013",3011,1850,1829,14,21,"VERDES",10
38,"38033",3593,2277,2242,15,35,"VERDES",2
38,"38044",2215,1270,1257,5,13,"VERDES",1
38,"38017",30964,16228,16102,108,126,"VERDES",41
35,"35011",24859,15025,14833,149,192,"VERDES",40
38,"38012",2286,1520,1510,8,10,"VERDES",4
35,"35010",3853,2224,2194,18,30,"VERDES",6
35,"35018",13153,7742,7674,80,68,"VERDES",29
38,"38021",1609,900,876,2,24,"VERDES",3
35,"35012",10862,5617,5568,40,49,"VERDES",12
35,"35026",83172,48751,48109,449,642,"VERDES",217
38,"38047",1755,1132,1110,9,22,"VERDES",0
52,"52001",54293,31015,30776,185,239,"LOS VERDES",99
1,"1001",2020,1385,1372,5,13,"VOX",54
17,"17107",267,207,205,2,2,"VOX",5
10,"10190",513,334,325,10,9,"VOX",52
26,"26036",16989,11463,11260,101,203,"VOX",1647
25,"25024",352,248,247,0,1,"VOX",1
17,"17109",704,542,539,2,3,"VOX",10
34,"34229",58,47,47,1,0,"VOX",1
13,"13051",336,253,249,1,4,"VOX",42
43,"43173",98,70,68,0,2,"VOX",1
46,"46251",2465,1938,1903,19,35,"VOX",239
38,"38051",7328,5017,4969,32,48,"VOX",834
32,"32039",1154,801,790,11,11,"VOX",50
21,"21078",2641,1718,1670,10,48,"VOX",134
10,"10191",511,374,365,5,9,"VOX",64
1,"1002",8014,5838,5786,24,52,"VOX",154
50,"50189",678,494,487,6,7,"VOX",78
17,"17193",4351,2945,2927,21,18,"VOX",221
3,"3140",26036,18637,18267,237,370,"VOX",3545
32,"32040",1400,1001,990,10,11,"VOX",55
10,"10192",777,567,563,3,4,"VOX",74
17,"17110",1332,990,981,3,9,"VOX",74
40,"40171",40,32,32,1,0,"VOX",5
21,"21079",678,428,417,2,11,"VOX",46
18,"18143",945,661,651,2,10,"VOX",70
33,"33044",177059,121380,120421,1543,959,"VOX",21775
50,"50190",669,532,518,10,14,"VOX",83
46,"46252",125,89,86,1,3,"VOX",12
38,"38052",1283,806,794,3,12,"VOX",139
43,"43174",144,118,114,0,4,"VOX",0
32,"32041",752,462,458,4,4,"VOX",20
1,"1003",1166,843,837,6,6,"VOX",5
9,"9256",330,221,219,0,2,"VOX",31
38,"38053",3768,2275,2244,16,31,"VOX",197
10,"10193",1392,1045,1025,6,20,"VOX",275
21,"21902",1136,744,739,2,5,"VOX",48
26,"26039",40,31,31,0,0,"VOX",5
13,"13055",616,445,444,3,1,"VOX",75
10,"10194",524,408,404,2,4,"VOX",78
46,"46135",9817,7596,7558,58,38,"VOX",1202
34,"34232",725,505,492,13,13,"VOX",71
22,"22001",212,147,146,0,1,"VOX",22
17,"17111",984,728,728,7,0,"VOX",29
1,"1004",1357,952,945,5,7,"VOX",33
46,"46253",112,84,84,0,0,"VOX",11
32,"32042",1487,1010,1001,12,9,"VOX",84
18,"18145",10909,7925,7780,67,145,"VOX",1872
32,"32043",2497,1607,1582,14,25,"VOX",132
13,"13056",11706,8399,8288,88,111,"VOX",1666
1,"1006",174,124,122,1,2,"VOX",18
43,"43176",746,564,561,2,3,"VOX",14
8,"8221",12793,10123,10079,73,44,"VOX",470
17,"17112",198,148,147,3,1,"VOX",0
10,"10195",7514,5243,5148,47,95,"VOX",1009
1,"1008",808,546,536,6,10,"VOX",15
40,"40173",140,120,118,2,2,"VOX",21
26,"26041",109,67,65,0,2,"VOX",11
38,"38901",1466,908,894,4,14,"VOX",59
46,"46254",944,673,661,6,12,"VOX",119
26,"26042",795,578,572,8,6,"VOX",53
32,"32044",794,547,540,2,7,"VOX",31
10,"10196",294,208,206,3,2,"VOX",15
22,"22002",99,81,81,0,0,"VOX",11
23,"23048",817,605,599,4,6,"VOX",188
16,"16084",48,34,30,1,4,"VOX",7
50,"50192",227,182,181,0,1,"VOX",52
34,"34236",147,104,104,0,0,"VOX",11
49,"49226",240,200,198,2,2,"VOX",30
8,"8222",1821,1439,1424,7,15,"VOX",68
39,"39001",2063,1474,1467,5,7,"VOX",221
43,"43177",276,229,227,2,2,"VOX",14
1,"1009",1258,839,833,2,6,"VOX",10
17,"17114",23268,16423,16333,111,90,"VOX",496
46,"46255",3220,2361,2340,20,21,"VOX",336
32,"32045",2346,1604,1579,20,25,"VOX",125
34,"34237",579,408,400,1,8,"VOX",53
39,"39002",3408,2360,2323,7,37,"VOX",329
8,"8223",1897,1345,1341,10,4,"VOX",61
13,"13060",274,205,202,3,3,"VOX",29
10,"10198",1053,897,889,4,8,"VOX",81
1,"1010",2315,1705,1688,6,17,"VOX",45
43,"43178",1435,1071,1066,2,5,"VOX",60
17,"17115",276,208,208,4,0,"VOX",3
26,"26044",51,38,36,0,2,"VOX",7
32,"32046",1089,679,670,4,9,"VOX",25
40,"40177",139,106,105,0,1,"VOX",21
5,"5199",37,31,31,0,0,"VOX",4
12,"12024",138,107,107,1,0,"VOX",26
32,"32047",1761,1192,1175,10,17,"VOX",55
46,"46256",7280,4996,4940,32,56,"VOX",961
17,"17116",351,261,261,2,0,"VOX",5
50,"50194",80,51,51,0,0,"VOX",11
30,"30039",20442,13299,13167,84,132,"VOX",4029
28,"28079",2384271,1765443,1753633,13854,11810,"VOX",281211
22,"22006",268,167,164,4,3,"VOX",17
39,"39003",261,189,187,2,2,"VOX",32
1,"1011",213,162,160,3,2,"VOX",18
43,"43901",8796,5431,5390,41,41,"VOX",203
34,"34240",84,67,66,1,1,"VOX",19
44,"44260",137,93,93,1,0,"VOX",30
39,"39004",1479,1050,1031,5,19,"VOX",135
1,"1013",710,469,465,2,4,"VOX",1
23,"23051",2736,2066,2021,16,45,"VOX",407
32,"32048",846,460,458,1,2,"VOX",32
46,"46257",5436,3972,3933,28,39,"VOX",499
49,"49230",84,69,69,0,0,"VOX",7
26,"26047",1852,1449,1434,6,15,"VOX",168
43,"43902",2751,1794,1776,21,18,"VOX",94
17,"17117",14497,9438,9382,66,56,"VOX",580
23,"23052",1094,920,896,6,24,"VOX",59
48,"48034",12623,8789,8711,76,78,"VOX",243
50,"50195",53,42,38,0,4,"VOX",4
1,"1014",366,271,266,2,5,"VOX",17
50,"50196",101,73,73,0,0,"VOX",11
32,"32049",683,375,372,3,3,"VOX",16
18,"18150",6964,4717,4622,51,95,"VOX",972
48,"48035",406,314,314,0,0,"VOX",0
1,"1016",428,194,192,4,2,"VOX",5
13,"13066",2621,2029,1998,12,31,"VOX",389
46,"46258",2617,1925,1914,5,11,"VOX",266
17,"17118",12934,8723,8665,38,58,"VOX",489
9,"9270",157,112,109,2,3,"VOX",15
26,"26048",21,21,21,0,0,"VOX",1
32,"32050",2254,1630,1612,15,18,"VOX",75
10,"10204",423,289,287,1,2,"VOX",33
25,"25034",2271,1616,1600,12,16,"VOX",51
13,"13067",334,279,271,2,8,"VOX",27
43,"43903",2332,1502,1487,18,15,"VOX",38
50,"50197",95,69,68,2,1,"VOX",15
9,"9272",251,166,166,1,0,"VOX",17
16,"16091",63,43,42,1,1,"VOX",0
22,"22008",144,113,112,2,1,"VOX",14
32,"32051",1369,1062,1058,13,4,"VOX",34
39,"39006",1729,1207,1192,1,15,"VOX",213
26,"26049",156,120,115,0,5,"VOX",15
46,"46259",457,374,371,2,3,"VOX",83
17,"17119",71,53,52,3,1,"VOX",2
1,"1017",817,537,532,3,5,"VOX",12
41,"41032",3842,2800,2704,24,96,"VOX",382
13,"13068",1023,737,722,2,15,"VOX",189
43,"43904",2864,1881,1851,20,30,"VOX",108
48,"48037",696,497,485,0,12,"VOX",3
17,"17120",823,560,558,5,2,"VOX",31
32,"32052",1817,1278,1268,12,10,"VOX",88
49,"49233",85,51,51,0,0,"VOX",12
39,"39007",386,265,264,0,1,"VOX",38
19,"19235",98,77,76,1,1,"VOX",5
1,"1018",1399,953,947,1,6,"VOX",32
46,"46260",2685,2072,2053,14,19,"VOX",300
18,"18152",928,663,660,3,3,"VOX",46
43,"43905",15100,9689,9630,43,59,"VOX",1339
26,"26051",213,165,165,1,0,"VOX",30
46,"46261",1708,1259,1237,12,22,"VOX",227
32,"32053",1362,1001,989,10,12,"VOX",52
4,"4008",466,374,371,3,3,"VOX",88
40,"40182",169,112,112,1,0,"VOX",8
1,"1019",148,112,112,0,0,"VOX",0
32,"32054",86117,56997,56376,581,621,"VOX",4420
39,"39008",13900,9814,9734,63,80,"VOX",1345
23,"23057",727,582,572,7,10,"VOX",72
50,"50199",318,206,201,1,5,"VOX",59
1,"1020",323,228,224,1,4,"VOX",1
8,"8021",60,44,44,1,0,"VOX",3
39,"39009",3325,2306,2293,7,13,"VOX",353
4,"4009",140,109,106,2,3,"VOX",22
50,"50273",33,24,24,1,0,"VOX",4
17,"17121",225,166,163,2,3,"VOX",2
10,"10208",122,85,83,0,2,"VOX",6
34,"34903",179,129,129,1,0,"VOX",28
43,"43906",2113,1490,1480,12,10,"VOX",66
32,"32055",1216,781,764,10,17,"VOX",42
17,"17123",343,286,284,2,2,"VOX",7
10,"10209",259,151,149,0,2,"VOX",20
22,"22012",102,75,75,2,0,"VOX",16
32,"32056",1490,1009,1003,10,6,"VOX",42
4,"4010",587,421,409,5,12,"VOX",37
1,"1021",471,321,319,3,2,"VOX",17
26,"26054",291,225,223,3,2,"VOX",23
4,"4011",2744,2010,1984,20,26,"VOX",362
10,"10210",489,314,313,2,1,"VOX",42
43,"43907",4386,3083,3067,24,16,"VOX",398
48,"48040",1303,933,926,7,7,"VOX",17
40,"40184",245,196,194,0,2,"VOX",25
46,"46262",206,136,134,1,2,"VOX",27
39,"39010",610,457,453,1,4,"VOX",63
22,"22013",271,200,197,3,3,"VOX",28
1,"1022",755,532,523,4,9,"VOX",21
17,"17124",1593,1163,1160,8,3,"VOX",25
18,"18157",1148,843,827,7,16,"VOX",184
10,"10211",446,303,300,0,3,"VOX",31
44,"44267",70,47,46,0,1,"VOX",0
32,"32057",505,334,328,3,6,"VOX",14
22,"22014",227,164,162,5,2,"VOX",15
12,"12032",23728,16870,16726,121,144,"VOX",3823
26,"26055",39,30,30,0,0,"VOX",5
48,"48041",687,548,547,4,1,"VOX",6
28,"28089",3856,2866,2829,21,37,"VOX",815
13,"13075",196,147,146,2,1,"VOX",39
1,"1023",262,193,190,1,3,"VOX",9
46,"46263",235,182,180,2,2,"VOX",17
35,"35001",4566,3148,3105,18,43,"VOX",207
32,"32058",5247,3547,3489,30,58,"VOX",308
26,"26056",404,312,301,2,11,"VOX",34
5,"5211",425,336,330,2,6,"VOX",58
8,"8231",21269,14655,14573,111,82,"VOX",1165
2,"2068",323,239,239,3,0,"VOX",38
1,"1027",444,273,271,0,2,"VOX",3
8,"8024",357,282,282,2,0,"VOX",3
48,"48042",1359,1055,1045,7,10,"VOX",22
17,"17125",136,100,100,3,0,"VOX",0
32,"32059",1686,1099,1082,20,17,"VOX",71
39,"39012",6772,4807,4755,31,52,"VOX",661
50,"50202",124,76,74,0,2,"VOX",14
17,"17126",316,269,269,1,0,"VOX",0
32,"32060",753,520,515,5,5,"VOX",40
46,"46902",352,283,283,0,0,"VOX",37
8,"8232",1773,1368,1362,9,6,"VOX",32
44,"44003",17,15,15,0,0,"VOX",2
13,"13078",8946,6166,6103,49,63,"VOX",1447
28,"28091",5491,3709,3650,20,59,"VOX",807
4,"4014",152,105,103,1,2,"VOX",9
39,"39013",517,359,356,1,3,"VOX",63
9,"9287",191,144,143,2,1,"VOX",36
25,"25041",525,375,370,4,5,"VOX",10
8,"8025",1573,1170,1160,9,10,"VOX",80
1,"1028",1091,735,728,5,7,"VOX",26
39,"39014",882,538,536,0,2,"VOX",88
50,"50203",1065,817,804,5,13,"VOX",173
10,"10215",438,266,262,2,4,"VOX",23
44,"44004",379,275,275,2,0,"VOX",37
22,"22016",558,384,382,5,2,"VOX",27
32,"32061",1078,777,770,5,7,"VOX",60
1,"1030",141,102,102,0,0,"VOX",0
17,"17128",321,239,238,1,1,"VOX",7
26,"26059",1109,801,791,6,10,"VOX",132
23,"23064",1669,1311,1296,9,15,"VOX",259
4,"4016",2136,1486,1467,13,19,"VOX",411
18,"18162",919,664,652,3,12,"VOX",119
5,"5214",28,18,18,0,0,"VOX",2
25,"25043",800,584,581,2,3,"VOX",3
50,"50278",175,133,131,2,2,"VOX",39
17,"17129",143,108,108,2,0,"VOX",10
32,"32062",784,557,550,1,7,"VOX",23
4,"4017",1276,833,818,4,15,"VOX",241
45,"45004",546,400,398,2,2,"VOX",85
40,"40190",43,37,35,0,2,"VOX",7
23,"23065",1530,1068,1054,7,14,"VOX",174
46,"46904",812,615,605,2,10,"VOX",110
1,"1031",1136,844,830,1,14,"VOX",50
39,"39015",828,559,556,3,3,"VOX",107
1,"1032",498,363,353,1,10,"VOX",4
35,"35004",41975,20773,20602,156,171,"VOX",2778
32,"32063",1795,1135,1119,16,16,"VOX",59
22,"22018",303,216,215,3,1,"VOX",35
44,"44005",48,36,36,0,0,"VOX",5
32,"32064",453,304,302,0,2,"VOX",29
50,"50205",72,51,49,0,2,"VOX",8
42,"42144",419,302,298,6,4,"VOX",44
8,"8234",3443,2561,2550,15,11,"VOX",123
47,"47001",52,43,42,1,1,"VOX",12
1,"1033",654,476,476,0,0,"VOX",17
44,"44006",220,152,151,1,1,"VOX",7
39,"39016",23850,17235,17106,70,129,"VOX",2616
28,"28094",988,711,707,5,4,"VOX",174
17,"17130",325,270,270,1,0,"VOX",3
22,"22019",176,128,126,1,2,"VOX",12
32,"32065",633,422,419,8,3,"VOX",38
31,"31009",674,455,451,2,4,"VOX",6
13,"13084",841,652,644,6,8,"VOX",117
45,"45006",1334,866,858,1,8,"VOX",214
8,"8028",1125,744,743,7,1,"VOX",90
44,"44007",149,112,111,1,1,"VOX",19
39,"39017",550,378,372,1,6,"VOX",87
47,"47003",206,167,166,5,1,"VOX",41
23,"23067",2405,1765,1724,14,41,"VOX",206
22,"22020",115,83,80,3,3,"VOX",18
1,"1034",152,107,107,1,0,"VOX",4
32,"32066",547,396,396,0,0,"VOX",12
26,"26064",2335,1617,1584,28,33,"VOX",179
50,"50207",87,58,58,1,0,"VOX",10
45,"45008",144,112,110,1,2,"VOX",14
46,"46082",4981,3547,3523,29,24,"VOX",644
39,"39018",4284,3211,3177,22,34,"VOX",462
12,"12039",792,665,659,2,6,"VOX",48
1,"1036",14698,10207,10131,51,76,"VOX",216
4,"4020",302,207,206,2,1,"VOX",55
17,"17133",1262,976,964,7,12,"VOX",10
48,"48048",527,381,380,3,1,"VOX",0
22,"22021",1884,1331,1319,26,12,"VOX",186
8,"8236",1564,1145,1133,4,12,"VOX",39
47,"47004",1135,878,872,5,6,"VOX",198
10,"10903",806,555,545,8,10,"VOX",66
26,"26065",63,46,43,0,3,"VOX",7
32,"32067",1189,696,692,4,4,"VOX",48
23,"23070",3813,2384,2354,11,30,"VOX",694
8,"8029",3586,2868,2862,20,6,"VOX",118
32,"32068",1401,882,878,4,4,"VOX",45
47,"47005",506,358,348,3,10,"VOX",95
1,"1037",589,378,374,1,4,"VOX",10
39,"39019",2232,1628,1603,10,25,"VOX",276
18,"18167",1839,1243,1224,9,19,"VOX",207
26,"26066",263,201,194,5,7,"VOX",18
35,"35008",6214,4193,4143,33,50,"VOX",511
37,"37191",102,57,57,1,0,"VOX",7
10,"10905",636,443,433,7,10,"VOX",120
17,"17134",220,175,174,1,1,"VOX",1
50,"50208",1761,1267,1250,16,17,"VOX",206
32,"32069",4223,3064,3023,31,41,"VOX",169
47,"47006",182,149,145,1,4,"VOX",25
39,"39020",23993,15944,15792,89,152,"VOX",1702
22,"22022",542,405,403,2,2,"VOX",51
50,"50209",2785,1893,1865,24,28,"VOX",474
17,"17135",393,307,303,0,4,"VOX",21
48,"48050",188,141,141,0,0,"VOX",0
1,"1039",188,150,147,2,3,"VOX",2
32,"32070",495,247,238,4,9,"VOX",9
44,"44010",185,144,143,0,1,"VOX",36
26,"26068",78,61,61,0,0,"VOX",8
8,"8031",2339,1760,1750,15,10,"VOX",71
16,"16110",90,70,70,1,0,"VOX",32
39,"39021",464,370,364,1,6,"VOX",92
11,"11001",4360,2810,2744,32,66,"VOX",536
36,"36059",4641,2844,2796,29,48,"VOX",212
17,"17136",196,150,150,0,0,"VOX",6
1,"1041",150,103,102,1,1,"VOX",3
22,"22125",39530,27358,27075,344,283,"VOX",4065
23,"23073",4363,3214,3176,24,38,"VOX",681
47,"47007",4051,2987,2954,27,33,"VOX",691
5,"5221",322,231,231,0,0,"VOX",32
1,"1042",911,680,671,8,9,"VOX",16
39,"39022",970,673,668,2,5,"VOX",131
8,"8032",2100,1472,1465,12,7,"VOX",57
26,"26069",230,166,166,0,0,"VOX",21
47,"47008",22,13,13,0,0,"VOX",2
45,"45013",1679,1266,1248,5,18,"VOX",269
23,"23074",2984,2271,2236,20,35,"VOX",339
19,"19250",16,12,12,0,0,"VOX",1
26,"26070",152,125,122,1,3,"VOX",9
1,"1043",2340,1487,1468,11,19,"VOX",96
48,"48052",1562,1220,1210,5,10,"VOX",7
28,"28102",880,639,621,7,18,"VOX",125
4,"4026",57,38,37,0,1,"VOX",6
22,"22024",220,159,158,1,1,"VOX",7
32,"32072",3664,2387,2355,24,32,"VOX",144
11,"11003",1230,802,787,9,15,"VOX",205
32,"32073",1273,863,857,6,6,"VOX",68
26,"26071",8644,5668,5591,53,77,"VOX",706
13,"13094",294,216,215,1,1,"VOX",45
17,"17137",3486,2812,2808,15,4,"VOX",53
1,"1044",232,151,148,2,3,"VOX",1
8,"8033",13262,9887,9833,64,54,"VOX",495
50,"50211",236,174,173,0,1,"VOX",38
47,"47009",98,84,84,0,0,"VOX",18
50,"50212",32,26,26,0,0,"VOX",9
11,"11004",89919,55211,54544,830,667,"VOX",15492
9,"9309",293,198,193,5,5,"VOX",62
17,"17138",836,591,584,7,7,"VOX",32
22,"22025",1022,705,694,14,11,"VOX",91
18,"18173",8999,5958,5871,50,87,"VOX",993
13,"13096",7526,5212,5131,25,81,"VOX",1132
32,"32074",977,642,631,2,11,"VOX",44
22,"22027",311,210,209,1,1,"VOX",32
48,"48054",25063,17705,17597,122,108,"VOX",507
8,"8102",28940,21108,21014,157,94,"VOX",903
39,"39024",1802,1325,1314,7,11,"VOX",127
17,"17139",1407,1128,1119,8,9,"VOX",18
32,"32075",4362,3117,3077,30,40,"VOX",267
1,"1046",639,433,432,2,1,"VOX",25
13,"13097",2186,1592,1574,5,18,"VOX",321
49,"49256",236,183,179,0,4,"VOX",40
25,"25052",1541,1183,1176,7,7,"VOX",18
23,"23077",604,482,477,2,5,"VOX",81
1,"1047",982,653,642,6,11,"VOX",60
26,"26073",92,68,66,1,2,"VOX",1
4,"4029",8830,5546,5482,43,64,"VOX",1423
44,"44014",2506,1828,1818,8,10,"VOX",169
50,"50213",92,70,70,2,0,"VOX",12
47,"47011",554,466,462,7,4,"VOX",93
32,"32076",1935,1320,1306,15,14,"VOX",95
48,"48055",2603,1833,1820,14,13,"VOX",20
47,"47104",2816,2153,2099,20,54,"VOX",473
1,"1049",130,94,94,1,0,"VOX",3
45,"45018",550,385,380,1,5,"VOX",145
8,"8035",13006,8957,8918,50,39,"VOX",525
46,"46089",2182,1590,1576,9,14,"VOX",330
17,"17140",635,506,505,2,1,"VOX",8
44,"44016",424,299,297,1,2,"VOX",31
19,"19255",74,37,37,0,0,"VOX",1
39,"39026",1702,1160,1151,11,9,"VOX",243
26,"26075",315,234,229,1,5,"VOX",23
23,"23080",1720,1313,1294,6,19,"VOX",216
32,"32077",1104,703,700,9,3,"VOX",63
8,"8036",163,122,122,0,0,"VOX",1
17,"17141",6019,3855,3833,43,22,"VOX",260
32,"32078",1099,715,707,4,8,"VOX",46
47,"47013",91,77,77,1,0,"VOX",8
26,"26076",115,83,83,0,0,"VOX",6
1,"1051",3569,2259,2244,3,15,"VOX",39
39,"39027",3045,2231,2199,23,32,"VOX",380
37,"37199",128,92,92,2,0,"VOX",16
18,"18176",242,164,161,2,3,"VOX",8
50,"50215",20,14,14,0,0,"VOX",1
22,"22032",102,69,68,1,1,"VOX",13
11,"11008",17923,11702,11464,192,238,"VOX",3085
40,"40204",145,102,101,0,1,"VOX",16
4,"4032",5716,3727,3696,43,31,"VOX",949
32,"32079",1280,880,869,13,11,"VOX",65
48,"48057",5730,4126,4115,14,11,"VOX",7
49,"49260",693,480,473,3,7,"VOX",74
44,"44017",269,217,216,0,1,"VOX",17
1,"1052",272,189,186,2,3,"VOX",1
8,"8037",1947,1547,1543,11,4,"VOX",39
2,"2901",2196,1441,1419,10,22,"VOX",329
47,"47014",48,39,39,1,0,"VOX",6
11,"11009",579,399,390,0,9,"VOX",68
39,"39028",3892,2905,2878,20,27,"VOX",541
47,"47015",177,129,129,0,0,"VOX",15
17,"17142",2713,2166,2159,18,7,"VOX",112
4,"4033",121,78,77,3,1,"VOX",10
1,"1053",596,364,362,1,2,"VOX",4
32,"32080",284,209,209,1,0,"VOX",10
17,"17143",145,104,104,0,0,"VOX",2
49,"49261",1504,1044,1026,7,18,"VOX",198
22,"22035",225,153,152,1,1,"VOX",11
45,"45022",395,292,292,2,0,"VOX",76
28,"28111",629,479,475,2,4,"VOX",117
8,"8038",1541,1129,1120,6,9,"VOX",44
44,"44019",70,42,42,0,0,"VOX",7
22,"22036",84,71,71,1,0,"VOX",14
49,"49262",367,263,261,1,2,"VOX",33
1,"1054",998,701,700,4,1,"VOX",21
26,"26079",633,503,499,2,4,"VOX",77
50,"50217",426,333,333,1,0,"VOX",53
35,"35016",300581,181532,179831,1458,1701,"VOX",22075
32,"32082",1164,736,728,11,8,"VOX",56
17,"17225",205,150,150,1,0,"VOX",2
23,"23085",2171,1587,1575,7,12,"VOX",187
1,"1055",839,557,552,11,5,"VOX",23
47,"47016",65,55,55,0,0,"VOX",8
45,"45023",2300,1700,1685,19,15,"VOX",466
17,"17144",211,162,159,3,3,"VOX",3
11,"11011",1726,1124,1084,8,40,"VOX",244
47,"47017",190,146,146,0,0,"VOX",39
26,"26080",451,347,344,0,3,"VOX",41
39,"39030",1874,1199,1187,6,12,"VOX",148
6,"6081",1036,760,745,2,15,"VOX",58
44,"44020",22,21,21,0,0,"VOX",3
1,"1056",202,107,107,0,0,"VOX",1
32,"32083",805,498,494,3,4,"VOX",22
22,"22037",112,87,87,2,0,"VOX",13
8,"8039",413,322,321,1,1,"VOX",4
4,"4036",239,178,176,0,2,"VOX",31
14,"14003",1245,925,907,5,18,"VOX",135
11,"11012",97338,67120,66466,861,654,"VOX",8280
17,"17145",1410,1040,1032,6,8,"VOX",32
39,"39031",1237,870,865,1,5,"VOX",185
50,"50218",112,88,88,1,0,"VOX",13
32,"32084",878,532,527,8,5,"VOX",32
47,"47018",36,31,31,0,0,"VOX",10
44,"44021",104,77,77,1,0,"VOX",3
48,"48061",789,602,601,2,1,"VOX",6
40,"40208",724,546,543,5,3,"VOX",88
22,"22039",813,635,634,4,1,"VOX",66
1,"1057",235,196,194,0,2,"VOX",4
28,"28114",141,97,97,0,0,"VOX",17
45,"45026",219,166,164,1,2,"VOX",39
8,"8040",11116,7923,7891,49,32,"VOX",450
42,"42168",108,73,73,0,0,"VOX",13
49,"49265",110,79,78,2,1,"VOX",12
14,"14005",6298,3905,3828,71,77,"VOX",592
22,"22040",149,119,119,3,0,"VOX",13
47,"47019",92,68,68,1,0,"VOX",14
40,"40210",97,69,69,1,0,"VOX",19
17,"17146",3150,2243,2224,8,19,"VOX",140
50,"50220",45,38,38,0,0,"VOX",5
32,"32086",2531,1348,1332,11,16,"VOX",90
44,"44022",464,330,325,1,5,"VOX",48
28,"28115",62612,50619,50431,399,188,"VOX",11270
39,"39033",536,375,372,1,3,"VOX",54
1,"1058",1414,893,884,1,9,"VOX",20
47,"47020",270,212,207,5,5,"VOX",55
17,"17147",7916,5672,5641,41,31,"VOX",217
26,"26084",7264,5130,5059,61,71,"VOX",779
1,"1059",189597,128849,127910,688,939,"VOX",5096
5,"5235",141,97,97,2,0,"VOX",17
42,"42172",28,26,26,0,0,"VOX",5
44,"44023",18,15,14,0,1,"VOX",2
28,"28116",748,576,569,2,7,"VOX",174
8,"8249",274,238,237,0,1,"VOX",3
37,"37010",925,645,638,5,7,"VOX",119
14,"14006",1319,1088,1057,8,31,"VOX",141
1,"1060",204,159,151,0,8,"VOX",8
32,"32087",1669,1158,1136,14,22,"VOX",87
3,"3006",493,365,360,2,5,"VOX",43
26,"26086",15,15,15,0,0,"VOX",2
22,"22041",145,116,116,2,0,"VOX",21
32,"32088",1636,955,944,17,11,"VOX",84
17,"17148",1550,1121,1114,15,7,"VOX",65
39,"39034",255,133,128,2,5,"VOX",39
47,"47021",73,57,55,0,2,"VOX",12
45,"45030",471,346,334,4,12,"VOX",49
42,"42174",174,121,118,4,3,"VOX",8
1,"1061",155,116,116,1,0,"VOX",1
11,"11016",15079,9353,9192,137,161,"VOX",2436
44,"44024",31,26,25,0,1,"VOX",2
4,"4044",1542,1092,1080,8,12,"VOX",228
22,"22042",116,91,89,1,2,"VOX",11
32,"32089",1206,740,726,8,14,"VOX",35
16,"16130",533,407,404,0,3,"VOX",73
5,"5237",153,125,123,0,2,"VOX",28
11,"11017",3198,2054,2004,37,50,"VOX",261
47,"47022",59,52,48,1,4,"VOX",14
8,"8250",7235,4917,4876,41,41,"VOX",474
23,"23093",3119,2264,2216,24,48,"VOX",221
22,"22043",93,53,53,0,0,"VOX",5
39,"39036",965,707,703,4,4,"VOX",87
32,"32090",734,448,441,2,7,"VOX",37
17,"17149",370,302,300,1,2,"VOX",5
35,"35021",15072,9791,9696,80,95,"VOX",1230
1,"1062",318,221,219,2,2,"VOX",18
17,"17150",1444,1177,1163,13,14,"VOX",35
26,"26089",111981,80365,79216,893,1149,"VOX",8717
11,"11018",1434,1001,977,8,24,"VOX",198
44,"44025",5804,4024,3991,11,33,"VOX",542
8,"8044",4156,2991,2976,16,15,"VOX",123
34,"34149",23,20,20,0,0,"VOX",5
39,"39037",2033,1431,1420,3,11,"VOX",229
22,"22044",234,166,164,1,2,"VOX",12
25,"25064",96,78,78,0,0,"VOX",1
49,"49271",176,128,127,3,1,"VOX",15
1,"1063",1852,1316,1303,6,13,"VOX",52
47,"47024",223,170,168,1,2,"VOX",14
35,"35022",51765,29309,29034,184,275,"VOX",4834
32,"32091",1695,1163,1156,2,7,"VOX",69
11,"11019",1757,1233,1172,13,61,"VOX",206
1,"1901",2473,1633,1612,9,21,"VOX",86
26,"26092",104,82,81,3,1,"VOX",8
45,"45033",297,205,201,1,4,"VOX",52
44,"44026",100,73,72,0,1,"VOX",21
4,"4047",2224,1649,1627,13,22,"VOX",284
42,"42042",53,42,41,1,1,"VOX",9
4,"4048",1499,964,957,4,7,"VOX",237
44,"44027",144,113,113,2,0,"VOX",9
35,"35023",11742,7787,7651,95,136,"VOX",906
8,"8045",65,44,43,0,1,"VOX",0
17,"17151",179,131,130,0,1,"VOX",6
47,"47025",114,85,85,3,0,"VOX",13
1,"1902",723,485,478,8,7,"VOX",22
39,"39038",1512,992,983,5,9,"VOX",145
11,"11020",166773,111205,109956,1580,1249,"VOX",25219
23,"23096",2543,2029,1986,16,43,"VOX",199
33,"33001",1475,758,753,15,5,"VOX",140
47,"47026",50,37,37,1,0,"VOX",8
26,"26093",48,34,33,0,1,"VOX",5
17,"17152",11065,6959,6927,68,32,"VOX",801
39,"39039",540,355,355,1,0,"VOX",65
37,"37213",83,64,64,0,0,"VOX",15
2,"2001",687,513,505,1,8,"VOX",91
34,"34015",37,24,24,0,0,"VOX",5
40,"40216",785,633,621,9,12,"VOX",136
11,"11021",4914,3187,3069,61,118,"VOX",547
17,"17902",1294,992,990,9,2,"VOX",30
40,"40022",195,144,141,2,3,"VOX",17
17,"17153",189,150,149,1,1,"VOX",1
26,"26094",67,51,51,0,0,"VOX",2
37,"37214",120,70,68,2,2,"VOX",17
45,"45036",638,455,449,1,6,"VOX",93
33,"33002",9403,5920,5839,69,81,"VOX",777
49,"49275",51064,34471,34017,475,454,"VOX",5663
14,"14012",6046,4215,4120,56,95,"VOX",442
47,"47027",2799,2059,2025,12,34,"VOX",380
50,"50227",107,62,62,1,0,"VOX",15
11,"11022",48785,24758,24422,398,336,"VOX",5814
48,"48070",527,357,355,0,2,"VOX",0
45,"45037",1520,1072,1055,5,17,"VOX",175
2,"2002",427,340,337,2,3,"VOX",67
8,"8047",3751,2600,2578,26,22,"VOX",101
22,"22047",248,202,201,1,1,"VOX",38
26,"26096",257,198,193,2,5,"VOX",8
8,"8254",1766,1433,1427,16,6,"VOX",10
33,"33003",603,322,317,7,5,"VOX",79
34,"34018",199,151,149,4,2,"VOX",26
2,"2003",134196,96374,95521,913,853,"VOX",20478
39,"39041",1753,1285,1269,7,16,"VOX",187
11,"11023",9386,6363,6248,116,115,"VOX",999
8,"8255",133,100,100,2,0,"VOX",3
17,"17154",101,76,76,0,0,"VOX",0
23,"23101",351,238,238,3,0,"VOX",47
33,"33004",65304,43473,43153,563,320,"VOX",6389
47,"47029",50,37,35,1,2,"VOX",5
50,"50228",249,207,207,3,0,"VOX",59
45,"45039",201,157,157,0,0,"VOX",62
2,"2004",597,459,455,3,4,"VOX",92
17,"17155",14957,9519,9410,71,109,"VOX",830
8,"8048",580,427,426,1,1,"VOX",8
40,"40220",64,46,45,0,1,"VOX",8
11,"11024",6550,4500,4402,67,98,"VOX",525
18,"18193",14934,10301,10127,116,174,"VOX",2273
33,"33005",1357,832,825,11,7,"VOX",158
4,"4053",12545,8864,8744,67,120,"VOX",2056
47,"47030",935,680,669,5,11,"VOX",141
26,"26099",1220,956,931,7,25,"VOX",92
45,"45040",1247,727,715,3,12,"VOX",140
48,"48072",965,730,724,3,6,"VOX",2
14,"14015",2045,1465,1418,16,47,"VOX",268
22,"22049",73,62,62,0,0,"VOX",14
8,"8256",693,542,542,3,0,"VOX",27
17,"17157",122,104,103,0,1,"VOX",1
18,"18194",2038,1373,1348,12,25,"VOX",315
2,"2005",554,426,419,8,7,"VOX",94
25,"25072",5881,4059,4031,30,28,"VOX",228
39,"39043",1517,1167,1154,3,13,"VOX",195
2,"2006",573,425,424,1,1,"VOX",49
45,"45041",3967,2723,2689,18,34,"VOX",819
26,"26100",54,43,43,0,0,"VOX",11
4,"4054",363,279,278,2,1,"VOX",56
50,"50230",1140,771,767,11,4,"VOX",130
8,"8050",139,118,115,4,3,"VOX",1
22,"22050",93,77,77,0,0,"VOX",15
47,"47031",191,141,140,0,1,"VOX",41
50,"50004",475,360,356,2,4,"VOX",44
33,"33006",1476,862,857,9,5,"VOX",91
5,"5247",231,132,131,1,1,"VOX",15
39,"39044",3921,2805,2783,18,22,"VOX",456
17,"17158",565,296,295,2,1,"VOX",50
18,"18901",489,323,322,5,1,"VOX",56
2,"2007",1017,757,746,5,11,"VOX",52
44,"44034",124,90,90,0,0,"VOX",7
9,"9351",61,46,45,1,1,"VOX",14
47,"47032",147,102,102,0,0,"VOX",46
33,"33007",1382,804,795,4,9,"VOX",103
28,"28128",453,334,331,1,3,"VOX",57
50,"50231",253,199,195,4,4,"VOX",32
16,"16143",15,10,10,1,0,"VOX",5
2,"2008",1103,737,722,8,15,"VOX",178
17,"17159",622,459,459,1,0,"VOX",18
33,"33008",1679,1140,1133,10,7,"VOX",183
22,"22051",90,72,72,2,0,"VOX",9
47,"47033",205,151,150,2,1,"VOX",35
26,"26103",814,617,603,10,14,"VOX",47
19,"19278",24,20,20,0,0,"VOX",2
22,"22052",874,660,652,7,8,"VOX",94
8,"8051",18570,14112,14054,86,58,"VOX",845
44,"44035",102,82,80,1,2,"VOX",12
37,"37222",78,55,55,2,0,"VOX",7
14,"14018",3617,2632,2568,31,64,"VOX",478
2,"2009",19495,13877,13663,134,214,"VOX",2137
35,"35029",4415,2498,2472,29,26,"VOX",291
44,"44036",22,20,20,0,0,"VOX",2
5,"5251",56,35,34,0,1,"VOX",13
47,"47034",75,58,58,2,0,"VOX",7
45,"45046",2369,1679,1651,11,28,"VOX",405
17,"17160",14756,9892,9852,58,40,"VOX",556
33,"33009",878,545,542,4,3,"VOX",94
26,"26104",10,9,9,1,0,"VOX",1
14,"14019",6380,4933,4831,71,102,"VOX",621
42,"42192",36,22,22,2,0,"VOX",3
9,"9354",34,31,31,2,0,"VOX",4
24,"24108",348,247,246,4,1,"VOX",48
47,"47035",901,659,653,4,6,"VOX",111
2,"2010",1784,1374,1349,12,25,"VOX",232
8,"8052",140,102,102,1,0,"VOX",2
22,"22053",783,494,492,6,2,"VOX",44
50,"50233",96,78,78,0,0,"VOX",25
14,"14020",336,227,225,0,2,"VOX",27
28,"28131",13510,9647,9544,89,103,"VOX",2146
11,"11030",22999,14858,14586,207,272,"VOX",3590
2,"2011",556,429,427,1,2,"VOX",55
47,"47036",204,159,156,1,3,"VOX",37
18,"18905",15688,10406,10200,122,206,"VOX",2523
17,"17161",1023,844,843,5,1,"VOX",8
35,"35031",7456,4938,4868,39,70,"VOX",801
44,"44037",447,288,288,1,0,"VOX",24
33,"33010",1722,1085,1069,15,16,"VOX",168
26,"26106",79,67,67,0,0,"VOX",4
40,"40228",493,362,361,3,1,"VOX",51
9,"9356",43,31,30,0,1,"VOX",3
33,"33011",10563,5646,5578,92,68,"VOX",1042
22,"22054",1614,1029,1009,19,20,"VOX",144
5,"5253",75,54,54,0,0,"VOX",11
47,"47037",161,128,125,1,3,"VOX",22
11,"11031",76427,49773,49248,654,525,"VOX",11972
17,"17162",153,106,105,1,1,"VOX",3
2,"2012",1835,1462,1420,9,42,"VOX",225
25,"25077",435,312,312,1,0,"VOX",4
50,"50008",5187,3334,3288,37,46,"VOX",630
18,"18906",903,641,639,2,2,"VOX",137
9,"9036",31,24,24,4,0,"VOX",1
8,"8054",9215,6994,6943,38,51,"VOX",596
17,"17163",2868,2281,2268,13,13,"VOX",42
33,"33012",5085,3158,3142,27,16,"VOX",524
42,"42196",7,7,7,1,0,"VOX",0
44,"44039",204,144,143,1,1,"VOX",28
22,"22055",305,242,235,2,7,"VOX",39
2,"2013",125,90,88,0,2,"VOX",27
50,"50235",2421,1721,1702,18,19,"VOX",385
45,"45050",505,338,332,2,6,"VOX",69
46,"46108",420,328,324,1,4,"VOX",39
19,"19282",138,107,106,0,1,"VOX",17
8,"8055",542,426,424,3,2,"VOX",16
8,"8262",6945,4649,4599,38,50,"VOX",312
26,"26109",73,68,68,0,0,"VOX",0
24,"24005",342,218,217,0,1,"VOX",27
47,"47038",100,61,61,0,0,"VOX",10
50,"50236",95,77,75,0,2,"VOX",9
39,"39050",260,164,164,1,0,"VOX",29
22,"22057",364,253,248,4,5,"VOX",14
17,"17164",3918,2856,2838,17,18,"VOX",38
2,"2014",354,254,252,3,2,"VOX",25
33,"33013",430,294,292,1,2,"VOX",51
39,"39051",73,64,64,1,0,"VOX",7
25,"25079",276,202,202,0,0,"VOX",7
40,"40231",100,79,76,0,3,"VOX",11
47,"47039",162,119,117,0,2,"VOX",21
2,"2015",1432,1163,1148,8,15,"VOX",256
26,"26111",250,191,187,3,4,"VOX",13
17,"17165",645,502,502,2,0,"VOX",4
11,"11034",2319,1520,1487,17,33,"VOX",240
28,"28135",998,712,703,2,9,"VOX",175
4,"4064",2878,1937,1924,16,13,"VOX",380
22,"22058",193,141,141,0,0,"VOX",15
47,"47040",56,42,41,0,1,"VOX",5
37,"37229",138,103,101,0,2,"VOX",33
22,"22059",1135,765,752,2,13,"VOX",98
14,"14024",1849,1417,1391,5,26,"VOX",298
2,"2016",528,353,352,4,1,"VOX",97
11,"11035",13751,8535,8396,125,139,"VOX",1873
9,"9365",26,17,17,0,0,"VOX",4
39,"39052",19005,13859,13748,83,111,"VOX",2481
48,"48082",37358,25328,25167,125,161,"VOX",649
28,"28136",693,538,533,2,5,"VOX",166
31,"31055",267,192,191,0,1,"VOX",0
26,"26112",218,152,148,1,4,"VOX",15
40,"40234",375,278,269,3,9,"VOX",60
18,"18909",514,403,403,0,0,"VOX",80
33,"33015",1396,849,842,7,7,"VOX",138
14,"14025",2834,2352,2299,9,53,"VOX",120
4,"4065",365,273,271,1,2,"VOX",47
47,"47041",147,105,103,3,2,"VOX",15
50,"50238",84,65,65,0,0,"VOX",17
2,"2017",760,498,493,1,5,"VOX",85
17,"17166",547,442,440,0,2,"VOX",20
37,"37231",236,185,183,5,2,"VOX",32
8,"8264",4608,3459,3444,30,15,"VOX",229
45,"45055",1004,768,755,4,13,"VOX",142
33,"33016",18848,12845,12737,173,108,"VOX",2153
17,"17167",2585,2015,1998,11,17,"VOX",43
8,"8058",1808,1280,1262,6,18,"VOX",76
50,"50239",63,46,45,1,1,"VOX",9
44,"44043",86,60,60,0,0,"VOX",7
47,"47042",51,39,39,0,0,"VOX",6
36,"36002",3049,1994,1968,22,26,"VOX",213
28,"28138",60,43,42,0,1,"VOX",4
2,"2018",789,611,606,3,5,"VOX",95
40,"40901",413,320,315,7,5,"VOX",59
9,"9369",419,288,284,3,4,"VOX",22
39,"39054",4541,3271,3252,30,19,"VOX",513
2,"2019",2352,1806,1766,9,40,"VOX",343
18,"18911",7933,5464,5348,53,116,"VOX",1576
50,"50240",943,693,683,12,10,"VOX",93
22,"22061",6567,4446,4410,48,36,"VOX",749
39,"39055",1065,747,736,4,11,"VOX",148
47,"47043",306,241,240,4,1,"VOX",28
45,"45057",224,177,173,0,4,"VOX",38
33,"33017",2969,1787,1768,38,19,"VOX",226
50,"50013",199,158,158,0,0,"VOX",31
5,"5262",318,238,235,1,3,"VOX",16
17,"17168",373,309,308,3,1,"VOX",9
47,"47044",323,273,270,4,3,"VOX",40
2,"2020",425,336,332,4,4,"VOX",51
26,"26117",2105,1537,1500,17,37,"VOX",102
22,"22062",154,107,107,1,0,"VOX",7
4,"4069",4742,3364,3325,46,39,"VOX",696
39,"39056",2262,1683,1671,14,12,"VOX",277
11,"11039",9957,6134,6043,152,91,"VOX",965
33,"33018",2804,1830,1806,30,24,"VOX",213
14,"14028",302,241,240,3,1,"VOX",41
2,"2021",1013,806,798,6,8,"VOX",164
17,"17169",2511,1901,1890,8,11,"VOX",111
48,"48086",2024,1371,1358,5,13,"VOX",27
26,"26118",71,54,53,1,1,"VOX",14
47,"47045",732,558,549,3,9,"VOX",119
44,"44045",360,271,271,0,0,"VOX",41
37,"37234",314,194,192,3,2,"VOX",29
3,"3028",959,780,767,7,13,"VOX",97
34,"34042",294,224,221,1,3,"VOX",33
11,"11040",396,332,324,3,8,"VOX",39
36,"36005",8105,5258,5152,54,106,"VOX",365
8,"8060",139,110,108,1,2,"VOX",0
22,"22063",161,128,126,0,2,"VOX",22
33,"33019",2844,1702,1680,11,22,"VOX",279
18,"18913",771,530,514,2,16,"VOX",138
39,"39057",2366,1636,1607,10,29,"VOX",158
22,"22064",155,100,100,2,0,"VOX",9
8,"8061",1628,1154,1151,15,3,"VOX",93
33,"33020",12981,8550,8453,120,97,"VOX",1187
17,"17170",173,140,140,2,0,"VOX",0
47,"47046",124,99,99,1,0,"VOX",10
2,"2022",341,243,243,2,0,"VOX",50
42,"42208",20,12,12,1,0,"VOX",0
26,"26120",1441,1027,1011,11,16,"VOX",115
36,"36006",11502,8057,7927,53,130,"VOX",622
44,"44047",225,103,103,0,0,"VOX",5
31,"31062",1070,778,770,10,8,"VOX",44
2,"2023",504,419,412,0,7,"VOX",56
39,"39058",806,556,554,2,2,"VOX",52
24,"24016",488,244,243,0,1,"VOX",28
17,"17171",177,138,137,0,1,"VOX",5
45,"45061",2490,1690,1669,9,21,"VOX",305
47,"47047",199,136,135,4,1,"VOX",35
26,"26121",30,19,19,0,0,"VOX",5
2,"2024",3361,2444,2411,24,33,"VOX",474
39,"39059",7518,5327,5287,23,40,"VOX",691
47,"47048",175,124,122,0,2,"VOX",22
50,"50243",307,227,224,2,3,"VOX",45
36,"36007",1610,1047,1016,5,31,"VOX",78
33,"33021",4304,2643,2610,32,33,"VOX",380
5,"5266",100,79,79,1,0,"VOX",9
45,"45062",1075,816,808,11,8,"VOX",197
22,"22066",755,529,520,8,9,"VOX",68
17,"17172",452,336,335,5,1,"VOX",12
33,"33022",802,460,452,4,8,"VOX",44
50,"50244",192,131,130,1,1,"VOX",27
8,"8269",2729,2114,2105,9,9,"VOX",58
44,"44048",52,47,47,0,0,"VOX",12
4,"4073",327,224,223,0,1,"VOX",73
11,"11901",5739,3759,3686,99,73,"VOX",556
22,"22067",70,52,52,0,0,"VOX",3
45,"45063",375,268,264,0,4,"VOX",58
22,"22177",96,69,68,0,1,"VOX",12
39,"39060",6704,4959,4887,23,72,"VOX",722
2,"2025",7345,5388,5278,51,110,"VOX",1317
2,"2026",834,644,633,4,11,"VOX",68
17,"17173",181,143,143,1,0,"VOX",5
22,"22068",64,41,41,1,0,"VOX",4
33,"33023",3249,2127,2097,30,30,"VOX",282
4,"4074",2910,1813,1789,15,24,"VOX",514
8,"8063",469,390,390,4,0,"VOX",3
8,"8270",19014,13635,13594,74,41,"VOX",902
36,"36009",4401,2712,2649,33,63,"VOX",209
11,"11902",3664,2123,2094,46,29,"VOX",427
17,"17174",164,130,130,4,0,"VOX",3
44,"44049",784,539,532,3,7,"VOX",43
2,"2027",274,209,203,1,6,"VOX",31
8,"8064",1956,1439,1423,7,16,"VOX",42
8,"8271",66,48,47,2,1,"VOX",0
11,"11903",1769,1116,1101,22,15,"VOX",223
9,"9384",292,199,193,3,6,"VOX",48
39,"39061",3470,2605,2591,14,14,"VOX",490
24,"24020",436,230,228,0,2,"VOX",35
31,"31067",1887,1265,1249,6,16,"VOX",140
33,"33024",224741,151660,150461,1597,1199,"VOX",23761
41,"41003",2373,1747,1708,18,39,"VOX",292
22,"22069",423,296,294,4,2,"VOX",32
47,"47051",324,261,258,6,3,"VOX",56
36,"36013",2216,1298,1290,18,8,"VOX",97
2,"2028",111,81,81,0,0,"VOX",12
8,"8272",164,128,128,1,0,"VOX",0
4,"4076",1209,873,850,7,23,"VOX",144
50,"50246",37,24,24,0,0,"VOX",6
45,"45066",7815,5540,5447,25,93,"VOX",1343
17,"17175",559,348,343,5,5,"VOX",54
26,"26126",29,27,27,0,0,"VOX",0
8,"8065",1183,920,913,8,7,"VOX",27
47,"47052",6781,5213,5156,50,57,"VOX",1015
2,"2029",3333,2363,2320,13,43,"VOX",457
33,"33025",8956,5493,5453,81,40,"VOX",802
12,"12001",1028,783,768,6,15,"VOX",96
26,"26127",182,149,149,1,0,"VOX",10
36,"36014",1867,1265,1243,16,22,"VOX",73
50,"50247",852,600,594,8,6,"VOX",149
22,"22072",197,127,126,1,1,"VOX",22
44,"44051",2579,1924,1901,10,23,"VOX",241
44,"44052",75,54,54,0,0,"VOX",12
33,"33026",8201,5014,4974,74,40,"VOX",870
39,"39063",936,618,616,4,2,"VOX",117
17,"17176",128,111,111,0,0,"VOX",6
24,"24022",304,198,195,2,3,"VOX",30
14,"14036",3677,2619,2555,39,64,"VOX",371
47,"47053",123,101,97,3,4,"VOX",4
8,"8066",1466,1109,1104,7,5,"VOX",70
36,"36015",4079,2653,2606,29,47,"VOX",175
25,"25097",89,71,71,2,0,"VOX",2
37,"37242",82,59,59,1,0,"VOX",16
2,"2030",2949,2158,2122,16,36,"VOX",422
47,"47054",599,465,460,1,5,"VOX",81
39,"39064",1352,1007,990,3,17,"VOX",154
41,"41006",2733,1776,1742,17,34,"VOX",243
17,"17177",562,426,423,1,3,"VOX",12
8,"8067",5746,4299,4270,24,29,"VOX",108
33,"33027",752,412,405,11,7,"VOX",53
50,"50248",501,344,328,3,16,"VOX",37
19,"19299",100,72,71,1,1,"VOX",18
4,"4080",196,148,147,2,1,"VOX",26
22,"22075",116,71,69,1,2,"VOX",8
2,"2031",535,406,401,4,5,"VOX",52
50,"50249",283,202,200,0,2,"VOX",38
25,"25099",1285,908,904,6,4,"VOX",17
19,"19300",782,591,588,5,3,"VOX",164
16,"16170",646,451,449,5,2,"VOX",48
37,"37244",129,97,97,1,0,"VOX",17
6,"6001",664,474,460,3,14,"VOX",100
26,"26130",205,153,150,1,3,"VOX",17
47,"47055",188,147,147,2,0,"VOX",23
39,"39066",866,616,606,6,10,"VOX",86
2,"2032",259,183,178,2,5,"VOX",23
33,"33028",1143,519,518,7,1,"VOX",64
12,"12004",4149,2945,2910,25,35,"VOX",617
44,"44054",95,82,81,0,1,"VOX",9
36,"36017",17364,11771,11598,123,173,"VOX",799
17,"17178",1065,774,771,9,3,"VOX",23
19,"19006",755,506,494,4,12,"VOX",130
24,"24025",283,190,185,3,5,"VOX",42
8,"8068",6863,5064,5041,40,23,"VOX",384
47,"47056",81,57,57,0,0,"VOX",10
33,"33029",315,145,142,1,3,"VOX",11
4,"4082",275,185,182,2,3,"VOX",26
2,"2033",1864,1352,1315,12,37,"VOX",219
39,"39067",753,476,474,1,2,"VOX",36
50,"50024",543,400,397,3,3,"VOX",51
22,"22077",362,280,272,5,8,"VOX",36
33,"33030",876,632,630,8,2,"VOX",118
12,"12005",8049,5643,5552,71,91,"VOX",1103
14,"14040",3749,2905,2845,53,60,"VOX",275
17,"17180",8508,5977,5953,38,24,"VOX",261
17,"17181",3458,2454,2443,18,11,"VOX",138
47,"47057",272,200,199,0,1,"VOX",65
24,"24027",1214,841,828,6,13,"VOX",97
41,"41009",1148,750,732,5,18,"VOX",125
2,"2034",1323,1024,1018,6,6,"VOX",167
26,"26134",81,67,67,3,0,"VOX",10
2,"2035",1946,1494,1473,5,21,"VOX",365
47,"47058",199,126,125,3,1,"VOX",29
8,"8276",241,179,179,3,0,"VOX",8
8,"8069",3323,2555,2540,21,15,"VOX",147
39,"39068",642,442,438,1,4,"VOX",59
8,"8070",269,215,211,1,4,"VOX",5
19,"19008",36,30,30,0,0,"VOX",2
6,"6006",4479,2991,2934,27,57,"VOX",397
12,"12006",177,133,133,2,0,"VOX",18
33,"33031",33775,20484,20184,276,300,"VOX",2358
36,"36020",2172,1435,1418,19,17,"VOX",121
26,"26135",152,115,114,0,1,"VOX",16
31,"31076",2543,1965,1956,19,9,"VOX",258
22,"22078",431,285,285,4,0,"VOX",43
26,"26136",90,65,64,2,1,"VOX",7
2,"2036",93,66,66,0,0,"VOX",12
28,"28156",1082,788,784,3,4,"VOX",243
48,"48902",18987,12762,12670,88,92,"VOX",286
17,"17182",269,195,195,0,0,"VOX",29
6,"6007",1418,984,968,13,16,"VOX",118
39,"39069",1934,1475,1458,2,17,"VOX",214
22,"22079",118,85,84,1,1,"VOX",10
47,"47059",94,64,64,0,0,"VOX",9
33,"33032",11056,7052,6905,109,147,"VOX",944
41,"41011",15462,11019,10696,183,323,"VOX",1121
2,"2037",22963,14737,14588,68,149,"VOX",4032
4,"4085",360,291,289,0,2,"VOX",73
39,"39070",126,91,89,0,2,"VOX",20
50,"50253",379,294,290,1,4,"VOX",39
17,"17183",253,197,197,2,0,"VOX",3
22,"22080",263,188,184,3,4,"VOX",31
33,"33033",9381,5848,5770,88,78,"VOX",859
26,"26138",4504,2982,2930,32,52,"VOX",301
8,"8071",249,209,208,0,1,"VOX",3
44,"44060",32,25,25,0,0,"VOX",14
47,"47060",224,171,168,1,3,"VOX",22
8,"8278",4925,3820,3804,22,16,"VOX",63
12,"12008",228,195,194,1,1,"VOX",34
47,"47061",237,185,184,0,1,"VOX",30
2,"2038",262,197,193,0,4,"VOX",40
26,"26139",58,43,43,2,0,"VOX",4
36,"36023",8258,5504,5384,44,120,"VOX",385
17,"17184",1261,1016,1010,7,6,"VOX",26
8,"8072",10769,7632,7600,56,32,"VOX",520
33,"33034",9979,5937,5873,64,64,"VOX",811
2,"2039",945,745,734,8,11,"VOX",65
39,"39071",410,251,250,1,1,"VOX",29
9,"9073",964,713,706,3,7,"VOX",156
50,"50254",179,115,113,0,2,"VOX",17
48,"48904",3547,2563,2541,18,22,"VOX",27
22,"22081",247,173,171,3,2,"VOX",29
26,"26140",239,180,177,1,3,"VOX",9
12,"12009",17943,12389,12292,102,97,"VOX",2771
47,"47062",155,128,128,0,0,"VOX",26
26,"26141",98,70,70,0,0,"VOX",5
19,"19013",111,89,89,0,0,"VOX",9
50,"50255",199,152,147,3,5,"VOX",11
19,"19306",24,18,18,0,0,"VOX",1
17,"17185",2260,1657,1652,8,5,"VOX",31
41,"41014",2476,1852,1799,10,53,"VOX",120
33,"33035",11214,7359,7303,102,56,"VOX",1429
39,"39072",325,184,182,0,2,"VOX",19
2,"2040",548,476,474,1,2,"VOX",62
9,"9408",40,29,29,0,0,"VOX",7
8,"8073",62934,45699,45407,281,292,"VOX",3201
28,"28160",8709,6507,6460,62,47,"VOX",1646
26,"26142",789,572,564,6,8,"VOX",49
22,"22082",288,217,214,0,3,"VOX",47
50,"50029",594,432,431,3,1,"VOX",38
39,"39073",10260,7537,7482,42,55,"VOX",1369
2,"2041",316,238,236,0,2,"VOX",28
47,"47063",86,68,68,0,0,"VOX",16
22,"22083",447,360,355,6,5,"VOX",34
41,"41015",5426,3778,3639,41,139,"VOX",889
17,"17186",3834,2980,2954,17,26,"VOX",182
47,"47064",37,30,29,1,1,"VOX",2
19,"19016",57,40,40,0,0,"VOX",7
33,"33036",11281,7240,7153,96,87,"VOX",1232
45,"45081",19268,13690,13516,104,174,"VOX",4130
31,"31083",49,39,39,1,0,"VOX",1
4,"4090",298,229,225,1,4,"VOX",30
14,"14046",4442,3283,3190,34,93,"VOX",305
6,"6015",118127,79482,78553,855,929,"VOX",17474
2,"2042",810,581,577,1,4,"VOX",84
39,"39074",7050,5074,5029,26,45,"VOX",909
36,"36026",19890,13041,12891,169,150,"VOX",1178
44,"44064",62,46,46,0,0,"VOX",10
47,"47065",820,608,602,2,6,"VOX",95
6,"6016",2937,2042,1978,12,64,"VOX",296
26,"26144",187,147,143,1,4,"VOX",20
2,"2043",1165,872,858,6,14,"VOX",158
22,"22084",571,400,391,5,9,"VOX",54
33,"33037",33074,20693,20412,259,281,"VOX",2151
4,"4092",2791,2058,2023,4,35,"VOX",417
45,"45083",568,433,429,2,4,"VOX",127
26,"26145",239,194,187,3,7,"VOX",26
8,"8075",4144,2951,2943,20,8,"VOX",238
24,"24037",330,189,189,1,0,"VOX",32
39,"39075",136789,95707,95089,478,618,"VOX",14450
47,"47066",1482,1096,1086,14,10,"VOX",279
41,"41017",15907,11486,11302,158,184,"VOX",2548
9,"9412",750,484,482,4,2,"VOX",54
17,"17188",171,134,134,1,0,"VOX",0
33,"33038",2218,1501,1477,17,24,"VOX",199
44,"44065",55,33,32,0,1,"VOX",9
50,"50258",53,25,25,1,0,"VOX",5
36,"36028",4049,2783,2739,22,44,"VOX",209
45,"45084",2103,1533,1508,7,25,"VOX",270
2,"2044",1040,665,656,5,9,"VOX",152
37,"37256",191,123,123,1,0,"VOX",24
33,"33039",1646,1118,1110,8,8,"VOX",161
12,"12013",135,106,106,1,0,"VOX",11
39,"39076",3512,2517,2491,13,26,"VOX",398
17,"17189",1481,1228,1223,5,5,"VOX",23
36,"36029",16126,10936,10771,96,165,"VOX",562
2,"2045",3609,2797,2752,38,45,"VOX",315
47,"47067",153,112,112,3,0,"VOX",31
22,"22086",194,137,137,1,0,"VOX",22
48,"48910",2811,1952,1942,11,10,"VOX",44
25,"25113",1114,873,863,3,10,"VOX",20
26,"26147",34,26,25,0,1,"VOX",1
45,"45086",483,339,332,0,7,"VOX",88
50,"50259",82,55,55,2,0,"VOX",4
8,"8077",34690,25896,25767,164,129,"VOX",1744
17,"17190",834,624,619,1,5,"VOX",9
16,"16191",850,664,653,11,11,"VOX",108
47,"47068",29,21,21,0,0,"VOX",4
2,"2046",1125,892,870,12,22,"VOX",182
24,"24040",416,293,292,2,1,"VOX",55
12,"12014",164,111,111,0,0,"VOX",16
33,"33040",4556,2837,2784,58,53,"VOX",463
26,"26148",154,125,122,3,3,"VOX",13
36,"36030",3921,2516,2484,31,32,"VOX",209
2,"2047",110,83,81,0,2,"VOX",9
12,"12015",115,94,94,0,0,"VOX",10
8,"8078",216,154,154,2,0,"VOX",2
22,"22087",60,46,46,0,0,"VOX",12
47,"47069",115,87,87,0,0,"VOX",16
19,"19020",46,31,31,0,0,"VOX",8
33,"33041",7101,4564,4513,58,51,"VOX",523
17,"17191",163,140,140,1,0,"VOX",0
16,"16192",42,28,28,0,0,"VOX",8
41,"41020",13012,8148,7999,135,149,"VOX",1381
26,"26150",97,77,77,1,0,"VOX",3
36,"36031",563,426,420,7,6,"VOX",37
2,"2048",1173,912,901,9,11,"VOX",179
4,"4096",285,222,222,0,0,"VOX",36
17,"17192",143,107,104,0,3,"VOX",1
14,"14052",9039,5579,5478,79,101,"VOX",1236
43,"43014",14386,9542,9464,74,78,"VOX",484
33,"33042",4237,2862,2816,49,46,"VOX",470
8,"8079",333,260,258,2,2,"VOX",4
47,"47070",29,24,24,0,0,"VOX",7
39,"39080",3477,2404,2388,4,16,"VOX",333
37,"37259",39,28,28,1,0,"VOX",6
46,"46133",462,359,352,1,7,"VOX",25
44,"44070",55,49,49,0,0,"VOX",10
48,"48913",1236,899,890,8,9,"VOX",13
12,"12016",1549,1244,1234,9,10,"VOX",280
26,"26151",412,317,317,4,0,"VOX",35
47,"47071",396,321,316,5,5,"VOX",71
33,"33043",656,408,401,2,7,"VOX",59
2,"2049",778,506,496,1,10,"VOX",74
50,"50262",1161,849,832,11,17,"VOX",124
22,"22089",274,195,193,2,2,"VOX",27
36,"36033",12305,8759,8597,67,162,"VOX",547
45,"45090",370,262,261,2,1,"VOX",54
2,"2050",85,66,66,1,0,"VOX",20
47,"47073",116,80,79,2,1,"VOX",17
26,"26152",27,20,20,1,0,"VOX",3
48,"48914",332,276,275,0,1,"VOX",0
19,"19023",119,87,85,0,2,"VOX",15
12,"12017",145,111,110,2,1,"VOX",13
37,"37261",213,153,149,0,4,"VOX",38
49,"49109",561,419,415,6,4,"VOX",86
22,"22090",86,61,61,1,0,"VOX",9
44,"44071",585,419,418,6,1,"VOX",45
8,"8080",40,27,27,3,0,"VOX",0
39,"39081",440,330,327,1,3,"VOX",46
2,"2051",1654,1115,1101,13,14,"VOX",265
17,"17194",73,56,56,0,0,"VOX",2
43,"43016",3470,2547,2508,15,39,"VOX",159
47,"47169",62,52,52,0,0,"VOX",9
14,"14054",13775,10464,10165,105,299,"VOX",1316
28,"28170",2495,1714,1695,13,19,"VOX",551
22,"22094",102,69,69,3,0,"VOX",11
2,"2052",466,371,370,6,1,"VOX",88
48,"48915",339,245,243,0,2,"VOX",0
47,"47074",141,110,109,0,1,"VOX",6
8,"8288",1696,1103,1096,9,7,"VOX",66
17,"17195",338,274,272,1,2,"VOX",4
39,"39083",1063,619,611,2,8,"VOX",58
47,"47075",4772,3557,3512,34,45,"VOX",816
8,"8081",349,274,270,0,4,"VOX",6
50,"50264",151,111,110,0,1,"VOX",5
33,"33045",4359,2819,2787,32,32,"VOX",382
34,"34084",158,125,125,1,0,"VOX",43
19,"19027",129,97,95,1,2,"VOX",9
33,"33046",480,334,329,0,5,"VOX",86
24,"24047",708,462,459,1,3,"VOX",66
36,"36036",2546,1763,1742,14,21,"VOX",145
26,"26155",145,120,119,0,1,"VOX",2
22,"22095",66,52,51,1,1,"VOX",2
2,"2053",2888,2086,2042,14,44,"VOX",360
47,"47076",17787,13484,13306,179,178,"VOX",2490
8,"8082",1164,796,780,5,16,"VOX",81
24,"24049",1417,983,975,14,8,"VOX",107
39,"39084",868,608,605,3,3,"VOX",115
6,"6031",462,285,280,2,5,"VOX",52
17,"17196",252,200,200,1,0,"VOX",7
33,"33047",1068,771,759,9,12,"VOX",155
26,"26157",283,222,217,0,5,"VOX",39
44,"44076",2089,1577,1565,8,12,"VOX",128
50,"50265",74,54,54,1,0,"VOX",8
2,"2054",375,288,283,0,5,"VOX",33
49,"49004",110,74,71,3,3,"VOX",5
22,"22096",332,248,241,10,7,"VOX",44
47,"47077",234,172,170,1,2,"VOX",39
37,"37265",198,167,163,1,4,"VOX",20
17,"17197",128,97,97,0,0,"VOX",3
36,"36038",66807,46235,45781,493,454,"VOX",3713
14,"14057",6157,4773,4707,59,66,"VOX",467
2,"2055",1055,672,668,2,4,"VOX",139
4,"4103",1432,1003,993,10,10,"VOX",313
41,"41026",4302,3355,3288,26,67,"VOX",269
50,"50040",82,66,66,1,0,"VOX",13
39,"39085",7017,5029,4992,23,37,"VOX",765
50,"50266",120,77,76,3,1,"VOX",4
44,"44077",68,52,51,0,1,"VOX",3
26,"26160",731,539,533,4,6,"VOX",60
33,"33048",132,86,85,1,1,"VOX",10
49,"49005",125,80,80,1,0,"VOX",25
22,"22099",490,349,343,2,6,"VOX",50
19,"19325",154,86,86,1,0,"VOX",7
17,"17198",437,307,306,0,1,"VOX",21
8,"8084",1172,902,894,9,8,"VOX",30
26,"26161",8,8,8,0,0,"VOX",0
28,"28175",940,740,730,2,10,"VOX",208
47,"47078",157,114,107,0,7,"VOX",24
39,"39086",358,236,235,2,1,"VOX",35
2,"2056",1640,1204,1179,11,25,"VOX",222
45,"45098",2090,1488,1469,7,19,"VOX",413
47,"47079",55,44,43,1,1,"VOX",13
2,"2057",1947,1358,1333,15,25,"VOX",198
22,"22102",180,137,136,3,1,"VOX",16
4,"4902",45571,29423,29169,272,254,"VOX",10495
18,"18049",588,418,415,4,3,"VOX",51
8,"8085",986,769,767,6,2,"VOX",18
33,"33049",5973,3569,3518,48,51,"VOX",488
39,"39087",41241,29341,29084,152,257,"VOX",3478
45,"45099",3700,2524,2501,9,23,"VOX",764
33,"33050",548,316,314,1,2,"VOX",59
2,"2058",300,186,177,1,9,"VOX",7
41,"41029",13520,9849,9663,134,186,"VOX",1809
26,"26163",126,104,104,1,0,"VOX",16
47,"47080",33,25,24,0,1,"VOX",4
17,"17199",6984,4919,4894,39,25,"VOX",270
36,"36041",13691,9022,8916,85,106,"VOX",920
4,"4904",1900,1308,1299,4,9,"VOX",562
22,"22103",664,489,489,4,0,"VOX",61
37,"37268",106,62,61,1,1,"VOX",13
50,"50042",19,17,17,1,0,"VOX",1
9,"9432",170,125,123,0,2,"VOX",6
24,"24054",410,275,271,0,4,"VOX",76
19,"19036",242,202,200,1,2,"VOX",33
49,"49008",423,263,259,1,4,"VOX",68
43,"43022",1436,1028,1024,13,4,"VOX",67
39,"39088",59,40,40,2,0,"VOX",4
6,"6039",1802,1375,1343,9,32,"VOX",94
17,"17200",624,469,467,6,2,"VOX",2
2,"2059",320,225,217,0,8,"VOX",46
39,"39089",131,82,82,0,0,"VOX",5
49,"49009",382,251,251,0,0,"VOX",42
17,"17201",137,103,103,0,0,"VOX",4
33,"33051",6787,4318,4268,48,50,"VOX",905
12,"12026",828,577,566,11,11,"VOX",75
19,"19329",58,46,46,0,0,"VOX",8
22,"22105",102,65,65,0,0,"VOX",7
25,"25126",281,211,210,1,1,"VOX",0
33,"33052",681,418,416,3,2,"VOX",56
5,"5002",1905,1361,1329,11,32,"VOX",242
47,"47082",805,641,630,3,11,"VOX",138
22,"22106",20,13,13,2,0,"VOX",0
19,"19038",19,16,15,0,1,"VOX",7
2,"2060",1268,953,939,7,14,"VOX",205
39,"39090",773,557,553,2,4,"VOX",92
6,"6041",456,329,321,2,8,"VOX",52
36,"36043",4696,3038,3003,21,35,"VOX",323
43,"43024",1545,1019,1014,14,5,"VOX",111
2,"2061",605,464,458,3,6,"VOX",79
49,"49010",350,260,256,8,4,"VOX",44
46,"46141",433,340,337,6,3,"VOX",40
33,"33053",1078,602,599,10,3,"VOX",83
17,"17202",3848,2632,2615,16,17,"VOX",96
26,"26167",50,34,33,1,1,"VOX",2
19,"19039",56,48,48,2,0,"VOX",8
43,"43025",591,448,443,4,5,"VOX",22
2,"2062",382,261,256,2,5,"VOX",46
47,"47083",81,63,61,0,2,"VOX",14
24,"24167",703,436,430,3,6,"VOX",73
49,"49011",214,147,146,5,1,"VOX",44
8,"8088",12347,9316,9270,75,46,"VOX",324
44,"44086",410,302,298,3,4,"VOX",25
22,"22107",102,53,53,0,0,"VOX",4
39,"39091",1881,1297,1291,8,6,"VOX",227
40,"40082",104,84,84,2,0,"VOX",16
10,"10084",1266,755,717,7,38,"VOX",94
33,"33054",1601,1025,1010,17,15,"VOX",156
25,"25128",125,85,85,0,0,"VOX",1
26,"26168",5584,3757,3696,35,61,"VOX",594
37,"37272",132,97,95,0,2,"VOX",20
17,"17203",165,126,126,0,0,"VOX",0
50,"50272",13226,9250,9153,97,97,"VOX",2174
2,"2063",1358,987,973,3,14,"VOX",234
5,"5007",109,73,72,0,1,"VOX",9
8,"8089",34190,24548,24404,194,144,"VOX",2042
17,"17204",609,429,428,6,1,"VOX",29
22,"22109",261,184,183,1,1,"VOX",40
47,"47085",16330,11556,11419,121,137,"VOX",2283
43,"43026",756,576,574,1,2,"VOX",20
39,"39092",863,534,533,3,1,"VOX",81
24,"24059",804,466,463,5,3,"VOX",36
37,"37273",85,58,58,2,0,"VOX",1
14,"14065",1820,1374,1352,13,22,"VOX",202
47,"47086",3818,2835,2784,36,51,"VOX",556
22,"22110",700,476,473,3,3,"VOX",61
15,"15081",976,713,695,4,18,"VOX",37
37,"37274",118296,84144,83280,880,864,"VOX",12907
2,"2064",371,288,283,2,5,"VOX",29
8,"8297",138,99,99,0,0,"VOX",4
39,"39093",297,216,214,1,2,"VOX",23
24,"24060",561,297,296,2,1,"VOX",33
28,"28183",1162,823,813,9,10,"VOX",118
2,"2065",441,368,361,0,7,"VOX",52
31,"31109",1657,1165,1160,12,5,"VOX",58
49,"49015",198,156,155,0,1,"VOX",18
45,"45107",3463,2621,2585,23,36,"VOX",633
33,"33056",4850,3068,3044,25,24,"VOX",593
24,"24061",1753,1234,1223,10,11,"VOX",299
17,"17205",209,167,166,0,1,"VOX",3
47,"47087",362,272,268,1,4,"VOX",47
37,"37275",98,67,67,0,0,"VOX",5
50,"50274",64,46,43,1,3,"VOX",5
44,"44177",101,68,68,1,0,"VOX",5
19,"19042",22,18,17,0,1,"VOX",4
44,"44089",49,41,41,0,0,"VOX",7
33,"33057",1525,1005,988,17,17,"VOX",131
22,"22111",143,96,95,2,1,"VOX",25
8,"8091",5428,4048,4024,20,24,"VOX",211
5,"5012",117,88,88,1,0,"VOX",16
2,"2066",222,165,163,1,2,"VOX",21
43,"43028",2770,1784,1770,7,14,"VOX",160
47,"47088",101,79,79,0,0,"VOX",18
44,"44090",66,49,49,0,0,"VOX",14
37,"37370",316,238,237,2,1,"VOX",38
5,"5013",834,658,653,2,5,"VOX",46
17,"17206",158,111,109,0,2,"VOX",1
17,"17207",2420,1920,1901,9,19,"VOX",28
8,"8092",3713,2758,2745,9,13,"VOX",65
22,"22112",9525,6317,6245,91,72,"VOX",1325
50,"50275",111,50,50,0,0,"VOX",8
2,"2067",1137,808,794,2,14,"VOX",149
47,"47089",133,111,111,2,0,"VOX",23
26,"26174",134,100,99,3,1,"VOX",8
45,"45110",1685,1288,1274,5,14,"VOX",290
14,"14068",517,388,378,3,10,"VOX",46
40,"40088",272,192,192,0,0,"VOX",31
12,"12033",1953,1391,1368,6,23,"VOX",251
25,"25132",141,106,105,0,1,"VOX",3
50,"50276",118,91,91,0,0,"VOX",14
45,"45111",56,47,47,1,0,"VOX",1
39,"39096",669,451,450,1,1,"VOX",96
8,"8300",5927,4609,4589,41,20,"VOX",358
5,"5014",5263,3699,3648,35,51,"VOX",539
28,"28903",35555,28875,28671,341,204,"VOX",4784
36,"36050",7645,5137,5049,48,88,"VOX",378
33,"33059",4359,2651,2625,33,26,"VOX",454
24,"24064",1501,1030,1012,2,18,"VOX",98
2,"2069",11401,8055,7975,30,80,"VOX",1769
47,"47090",2447,1823,1784,15,39,"VOX",364
17,"17208",978,723,719,6,4,"VOX",16
22,"22114",124,75,72,1,3,"VOX",8
49,"49019",232,162,152,2,10,"VOX",13
49,"49128",520,384,378,7,6,"VOX",61
2,"2070",373,306,301,6,5,"VOX",20
16,"16224",72,60,58,0,2,"VOX",13
5,"5015",68,45,44,1,1,"VOX",6
17,"17209",615,472,471,5,1,"VOX",32
39,"39098",1381,1088,1080,5,8,"VOX",185
33,"33060",13991,8629,8481,109,148,"VOX",771
50,"50277",45,34,34,0,0,"VOX",4
26,"26176",56,43,43,0,0,"VOX",6
36,"36052",7266,4772,4685,43,87,"VOX",375
22,"22115",348,263,261,3,2,"VOX",41
44,"44094",127,103,103,0,0,"VOX",10
47,"47091",76,60,59,2,1,"VOX",7
26,"26177",306,233,229,2,4,"VOX",21
33,"33061",344,174,174,1,0,"VOX",42
2,"2071",1027,800,795,7,5,"VOX",159
47,"47092",101,81,79,0,2,"VOX",17
37,"37280",70,47,46,0,1,"VOX",6
18,"18064",366,289,286,0,3,"VOX",62
14,"14071",874,551,540,5,11,"VOX",118
25,"25135",997,675,671,3,4,"VOX",25
8,"8095",66,49,49,0,0,"VOX",1
46,"46148",1515,1131,1113,5,18,"VOX",292
31,"31116",57,27,27,3,0,"VOX",1
19,"19047",55,47,47,1,0,"VOX",6
2,"2072",1528,981,958,7,23,"VOX",201
39,"39099",3193,2363,2346,10,17,"VOX",288
26,"26178",72,56,56,1,0,"VOX",4
17,"17210",572,414,411,2,3,"VOX",12
33,"33062",385,194,187,4,7,"VOX",21
12,"12037",17,13,13,1,0,"VOX",0
22,"22116",1342,915,905,11,10,"VOX",145
50,"50279",74,49,49,0,0,"VOX",2
44,"44097",126,76,73,0,3,"VOX",16
12,"12038",157,101,100,3,1,"VOX",18
2,"2073",4825,3433,3394,35,39,"VOX",773
36,"36054",11107,7027,6894,57,133,"VOX",565
17,"17211",837,677,674,6,3,"VOX",16
29,"29004",283,222,218,3,4,"VOX",48
39,"39100",849,567,565,5,2,"VOX",72
40,"40093",74,62,62,1,0,"VOX",9
16,"16231",45,38,38,0,0,"VOX",7
6,"6058",1984,1372,1331,13,41,"VOX",191
43,"43034",465,365,365,5,0,"VOX",21
33,"33063",375,269,267,5,2,"VOX",24
39,"39101",231,134,132,2,2,"VOX",7
17,"17212",145,111,109,0,2,"VOX",0
22,"22117",2384,1606,1596,18,10,"VOX",235
33,"33064",240,151,151,0,0,"VOX",13
2,"2074",5890,4054,4010,39,44,"VOX",827
19,"19049",8,8,7,0,1,"VOX",3
8,"8096",43926,32120,31960,217,160,"VOX",1888
22,"22119",1267,880,871,4,9,"VOX",94
45,"45117",718,552,548,0,4,"VOX",96
50,"50280",290,220,216,1,4,"VOX",22
45,"45118",2124,1403,1380,8,23,"VOX",321
25,"25137",8684,5802,5757,48,45,"VOX",249
8,"8097",1103,845,840,4,5,"VOX",35
26,"26181",15,14,14,0,0,"VOX",0
6,"6060",5696,4006,3900,37,106,"VOX",520
47,"47095",41,29,28,0,1,"VOX",13
9,"9132",170,121,120,0,1,"VOX",22
24,"24071",947,618,611,6,7,"VOX",60
26,"26183",66,48,48,0,0,"VOX",4
2,"2075",1700,1357,1347,6,10,"VOX",231
5,"5022",1580,1202,1193,6,9,"VOX",266
19,"19050",15,13,13,0,0,"VOX",1
50,"50281",68,52,50,0,2,"VOX",5
47,"47096",127,94,93,1,1,"VOX",20
14,"14075",552,413,391,5,22,"VOX",44
22,"22232",88,61,61,2,0,"VOX",14
17,"17213",5567,3654,3630,19,24,"VOX",254
17,"17214",714,516,511,6,5,"VOX",29
2,"2076",313,233,230,2,3,"VOX",43
50,"50282",55,38,38,1,0,"VOX",12
12,"12040",119116,85613,84993,620,620,"VOX",15582
45,"45120",113,86,86,0,0,"VOX",15
27,"27001",2187,1111,1102,17,9,"VOX",142
40,"40001",708,544,536,3,8,"VOX",122
12,"12118",78,64,63,0,1,"VOX",14
25,"25139",477,348,346,3,2,"VOX",4
37,"37285",360,271,270,0,1,"VOX",48
47,"47097",305,239,237,0,2,"VOX",35
5,"5023",174,148,145,2,3,"VOX",25
8,"8098",2438,1781,1778,21,3,"VOX",137
2,"2077",52,41,41,0,0,"VOX",6
33,"33066",42818,27780,27466,425,314,"VOX",4917
41,"41045",5873,3901,3802,53,99,"VOX",595
44,"44101",55,41,40,1,1,"VOX",8
50,"50283",69,46,46,0,0,"VOX",14
47,"47098",567,452,446,4,6,"VOX",93
22,"22124",183,119,119,0,0,"VOX",27
12,"12041",92,69,69,2,0,"VOX",15
2,"2078",891,650,642,4,8,"VOX",129
17,"17215",2286,1855,1844,13,11,"VOX",73
33,"33067",751,543,538,7,5,"VOX",67
19,"19053",1906,1323,1304,12,19,"VOX",255
29,"29008",15249,10396,10234,108,162,"VOX",3251
27,"27003",1743,1161,1134,18,27,"VOX",102
15,"15901",3334,1948,1928,27,20,"VOX",118
3,"3077",1391,1052,1032,10,20,"VOX",221
47,"47099",154,123,118,0,5,"VOX",36
33,"33068",1031,518,510,5,8,"VOX",104
40,"40100",262,208,204,4,4,"VOX",46
44,"44103",122,96,96,3,0,"VOX",21
2,"2079",2807,2000,1978,17,22,"VOX",278
17,"17216",158,122,121,0,1,"VOX",1
8,"8100",2083,1707,1699,13,8,"VOX",25
50,"50284",129,98,98,0,0,"VOX",6
5,"5025",78,65,65,0,0,"VOX",16
22,"22126",89,64,64,0,0,"VOX",8
12,"12043",570,405,397,1,8,"VOX",104
18,"18070",287,216,216,3,0,"VOX",34
5,"5026",183,149,147,1,2,"VOX",18
45,"45123",3196,2252,2218,11,34,"VOX",707
40,"40004",436,330,319,2,11,"VOX",73
47,"47100",118,93,87,2,6,"VOX",11
41,"41048",2195,1445,1400,13,45,"VOX",239
2,"2080",498,358,352,0,6,"VOX",78
17,"17217",350,287,284,0,3,"VOX",5
50,"50285",657,448,442,4,6,"VOX",107
44,"44105",68,53,53,0,0,"VOX",8
36,"36061",8613,5822,5718,56,104,"VOX",493
33,"33069",3379,2249,2231,41,18,"VOX",371
8,"8101",175048,121359,120620,830,739,"VOX",8743
2,"2081",18287,12910,12675,130,235,"VOX",2841
31,"31126",352,223,223,3,0,"VOX",6
3,"3079",18422,13560,13378,152,182,"VOX",2189
19,"19055",44,32,31,2,1,"VOX",5
5,"5027",258,209,203,5,6,"VOX",38
22,"22127",521,353,352,5,1,"VOX",91
17,"17218",576,456,451,3,5,"VOX",2
47,"47101",1634,1278,1262,7,16,"VOX",188
9,"9472",52,40,38,0,2,"VOX",4
6,"6070",7668,5404,5228,59,176,"VOX",749
40,"40006",22,19,19,0,0,"VOX",2
50,"50286",75,54,53,0,1,"VOX",13
2,"2082",98,80,80,0,0,"VOX",11
33,"33070",3267,2211,2185,27,26,"VOX",250
47,"47102",257,212,210,2,2,"VOX",66
43,"43041",216,156,156,2,0,"VOX",10
34,"34127",80,62,62,0,0,"VOX",13
22,"22128",188,145,143,3,2,"VOX",18
8,"8901",240,200,195,2,5,"VOX",0
49,"49032",282,196,196,0,0,"VOX",29
29,"29012",9718,6664,6553,85,111,"VOX",1188
50,"50287",253,189,188,11,1,"VOX",21
2,"2083",209,181,181,0,0,"VOX",29
47,"47103",252,195,192,1,3,"VOX",38
17,"17220",801,649,647,2,2,"VOX",7
12,"12045",333,243,235,2,8,"VOX",19
33,"33071",546,385,383,7,2,"VOX",29
24,"24081",121,72,72,0,0,"VOX",15
45,"45127",775,510,502,1,8,"VOX",179
20,"20015",1245,880,876,5,4,"VOX",0
12,"12046",188,135,135,4,0,"VOX",18
44,"44107",212,135,135,0,0,"VOX",20
27,"27008",1326,865,853,5,12,"VOX",48
3,"3081",1492,1070,1044,12,26,"VOX",164
33,"33072",1443,816,814,8,2,"VOX",141
2,"2084",298,197,191,2,6,"VOX",46
8,"8103",652,476,474,1,2,"VOX",28
29,"29013",1613,1191,1154,9,37,"VOX",167
22,"22130",10146,6505,6436,57,69,"VOX",1056
45,"45128",2569,1676,1652,6,24,"VOX",437
50,"50288",3440,2513,2486,26,27,"VOX",679
24,"24082",847,615,608,16,7,"VOX",72
2,"2085",306,232,226,2,6,"VOX",27
37,"37002",125,64,63,0,1,"VOX",9
17,"17221",4138,2999,2988,23,11,"VOX",279
40,"40008",42,36,36,1,0,"VOX",6
8,"8104",657,496,493,4,3,"VOX",4
29,"29014",218,122,121,3,1,"VOX",23
38,"38004",4536,2914,2887,28,27,"VOX",353
45,"45129",98,77,77,1,0,"VOX",8
33,"33073",8096,4377,4320,59,57,"VOX",954
5,"5034",15,14,13,0,1,"VOX",4
25,"25148",224,158,158,0,0,"VOX",1
44,"44109",99,64,64,0,0,"VOX",11
17,"17222",104,87,87,1,0,"VOX",0
33,"33074",3366,2042,2011,35,31,"VOX",298
47,"47106",44,30,30,0,0,"VOX",6
12,"12048",243,159,155,4,4,"VOX",20
22,"22131",84,62,58,5,4,"VOX",4
50,"50289",53,42,42,1,0,"VOX",4
2,"2086",2389,1567,1554,10,13,"VOX",211
5,"5035",92,68,68,0,0,"VOX",5
8,"8105",9741,6946,6896,62,50,"VOX",581
24,"24193",363,264,264,1,0,"VOX",50
19,"19061",56,42,41,0,1,"VOX",12
34,"34132",106,73,72,0,1,"VOX",16
17,"17223",808,566,563,1,3,"VOX",33
25,"25149",1377,1034,1028,9,6,"VOX",9
20,"20018",11231,7640,7611,33,29,"VOX",45
31,"31133",34,27,27,1,0,"VOX",0
40,"40010",108,83,82,0,1,"VOX",22
44,"44110",37,30,30,0,0,"VOX",5
12,"12049",415,317,305,4,12,"VOX",43
8,"8905",2329,1872,1863,7,9,"VOX",85
24,"24086",258,197,196,1,1,"VOX",29
41,"41054",719,562,546,3,16,"VOX",88
47,"47109",161,120,120,1,0,"VOX",28
8,"8106",7500,5442,5410,43,32,"VOX",278
33,"33075",244,125,122,3,3,"VOX",9
22,"22133",108,71,71,3,0,"VOX",5
17,"17224",299,226,222,2,4,"VOX",5
50,"50291",95,76,76,0,0,"VOX",12
12,"12050",1226,904,891,3,13,"VOX",102
20,"20019",9892,6740,6717,40,23,"VOX",59
22,"22135",173,123,121,0,2,"VOX",29
33,"33076",12115,7519,7456,76,63,"VOX",1465
3,"3001",337,260,258,0,2,"VOX",43
15,"15010",1805,1047,1031,19,16,"VOX",52
9,"9155",25,23,23,0,0,"VOX",1
47,"47110",445,335,327,1,8,"VOX",67
41,"41055",14791,10197,10000,125,197,"VOX",1856
49,"49039",324,249,239,3,10,"VOX",64
19,"19065",109,86,85,1,1,"VOX",10
8,"8107",11965,8604,8554,67,50,"VOX",698
47,"47111",1001,738,732,5,6,"VOX",145
3,"3002",3649,2568,2542,11,26,"VOX",511
44,"44112",400,265,265,2,0,"VOX",29
27,"27013",3690,2811,2766,30,45,"VOX",105
9,"9159",62,49,47,0,2,"VOX",13
9,"9003",182,134,132,1,2,"VOX",15
12,"12051",437,297,295,3,2,"VOX",47
50,"50292",130,108,107,0,1,"VOX",32
22,"22136",749,524,518,5,6,"VOX",67
15,"15011",15501,9988,9846,78,142,"VOX",977
33,"33077",1097,688,683,4,5,"VOX",58
33,"33078",127,81,81,0,0,"VOX",13
49,"49040",109,89,87,2,2,"VOX",7
17,"17226",884,603,600,4,3,"VOX",84
25,"25152",148,106,106,0,0,"VOX",2
24,"24089",101036,71905,71305,744,600,"VOX",11304
15,"15012",3603,2484,2422,20,62,"VOX",207
40,"40014",56,39,38,0,1,"VOX",0
3,"3003",449,368,367,1,1,"VOX",55
9,"9006",57,30,29,0,1,"VOX",7
12,"12052",537,409,398,5,11,"VOX",102
22,"22137",1009,671,665,1,6,"VOX",105
37,"37008",4213,3092,3046,21,46,"VOX",761
45,"45136",5827,3908,3864,22,44,"VOX",934
8,"8108",5181,3880,3861,30,19,"VOX",278
19,"19067",68,46,44,0,2,"VOX",8
47,"47113",134,110,110,0,0,"VOX",16
27,"27015",3995,2518,2460,25,58,"VOX",192
15,"15013",6324,4132,4083,35,49,"VOX",327
37,"37009",197,145,144,1,1,"VOX",21
3,"3004",603,425,423,2,2,"VOX",79
50,"50293",392,257,255,2,2,"VOX",39
34,"34001",39,27,27,1,0,"VOX",2
8,"8109",207,176,174,0,2,"VOX",0
22,"22139",80,57,57,1,0,"VOX",6
50,"50294",65,45,45,0,0,"VOX",3
40,"40016",55,44,43,1,1,"VOX",11
47,"47114",3900,2549,2514,18,35,"VOX",571
29,"29021",155,111,109,1,2,"VOX",10
34,"34003",147,104,103,0,1,"VOX",20
9,"9010",33,25,25,2,0,"VOX",12
43,"43049",727,557,555,3,2,"VOX",7
17,"17228",285,218,217,0,1,"VOX",11
3,"3005",7937,5907,5869,40,38,"VOX",1825
16,"16258",172,124,119,0,5,"VOX",18
24,"24092",731,506,504,1,2,"VOX",88
40,"40017",83,71,68,2,3,"VOX",4
50,"50295",48,41,41,0,0,"VOX",5
40,"40115",142,100,100,0,0,"VOX",18
34,"34004",5517,3819,3769,36,50,"VOX",565
12,"12055",103,77,76,2,1,"VOX",11
22,"22141",115,94,93,0,1,"VOX",20
24,"24203",88,62,62,1,0,"VOX",5
47,"47115",276,212,211,1,1,"VOX",64
24,"24093",342,214,212,2,2,"VOX",36
34,"34005",786,601,593,3,8,"VOX",99
49,"49044",78,56,53,0,3,"VOX",8
44,"44203",9,9,9,0,0,"VOX",3
27,"27018",3211,1830,1800,17,30,"VOX",102
44,"44116",75,58,58,0,0,"VOX",12
17,"17230",504,383,382,3,1,"VOX",34
5,"5042",141,111,111,0,0,"VOX",15
10,"10002",360,239,236,1,3,"VOX",40
5,"5043",73,58,58,0,0,"VOX",3
17,"17232",146,111,111,0,0,"VOX",0
3,"3007",173,141,139,0,2,"VOX",21
24,"24094",1320,866,852,11,14,"VOX",179
50,"50296",385,240,235,3,5,"VOX",24
8,"8111",216,195,194,2,1,"VOX",4
34,"34006",79,73,69,2,4,"VOX",16
44,"44117",327,258,258,0,0,"VOX",50
37,"37304",156,97,96,1,1,"VOX",16
31,"31142",1389,909,900,9,9,"VOX",66
29,"29023",2330,1441,1429,11,12,"VOX",454
9,"9013",42,32,32,0,0,"VOX",4
5,"5044",244,170,170,1,0,"VOX",33
27,"27019",8188,5478,5395,88,83,"VOX",510
47,"47117",287,199,197,6,2,"VOX",62
3,"3008",158,120,118,1,2,"VOX",24
17,"17233",2347,1853,1840,11,13,"VOX",57
8,"8112",12926,9268,9230,61,38,"VOX",456
40,"40019",29,23,23,1,0,"VOX",1
22,"22143",190,118,115,1,3,"VOX",15
9,"9014",182,101,101,0,0,"VOX",14
8,"8251",5130,3719,3698,20,21,"VOX",250
34,"34010",550,407,399,7,8,"VOX",59
44,"44118",154,109,106,1,3,"VOX",17
47,"47118",147,97,97,2,0,"VOX",10
5,"5045",81,58,58,0,0,"VOX",17
10,"10005",527,325,301,1,24,"VOX",51
24,"24096",105,56,54,1,2,"VOX",6
40,"40020",149,112,111,1,1,"VOX",28
22,"22144",255,192,190,2,2,"VOX",25
25,"25158",1605,1193,1180,8,13,"VOX",36
15,"15018",1087,680,670,13,10,"VOX",28
3,"3009",46125,33613,33319,315,294,"VOX",4955
8,"8113",52589,36864,36690,244,174,"VOX",1815
40,"40021",18,15,15,0,0,"VOX",3
19,"19076",29,23,23,0,0,"VOX",8
37,"37306",238,140,136,3,4,"VOX",32
41,"41063",2735,1855,1797,30,58,"VOX",267
17,"17234",181,129,129,1,0,"VOX",8
44,"44119",116,80,79,1,1,"VOX",7
3,"3010",332,275,268,1,7,"VOX",31
47,"47119",89,59,58,2,1,"VOX",6
5,"5046",38,35,35,0,0,"VOX",5
37,"37015",198,127,125,2,2,"VOX",25
34,"34012",342,237,232,3,5,"VOX",28
27,"27022",4654,2760,2696,20,64,"VOX",198
22,"22149",301,211,210,1,1,"VOX",28
3,"3011",8014,5278,5212,50,66,"VOX",1105
22,"22150",459,325,321,8,4,"VOX",49
47,"47121",517,410,398,2,12,"VOX",60
41,"41064",5602,3520,3417,56,103,"VOX",508
17,"17901",987,733,725,5,8,"VOX",14
34,"34154",77,48,48,1,0,"VOX",6
49,"49053",919,676,661,8,15,"VOX",136
19,"19078",47,37,36,0,1,"VOX",2
40,"40122",524,398,392,2,6,"VOX",59
19,"19179",74,64,64,3,0,"VOX",11
24,"24099",153,111,110,1,1,"VOX",11
40,"40024",823,582,575,8,7,"VOX",85
34,"34017",889,676,665,7,11,"VOX",61
19,"19079",7,6,6,0,0,"VOX",1
27,"27023",2453,1674,1644,25,30,"VOX",95
5,"5048",107,89,88,2,1,"VOX",16
12,"12060",434,366,360,1,6,"VOX",81
3,"3012",1138,863,846,4,17,"VOX",193
47,"47122",2007,1520,1492,8,28,"VOX",253
22,"22151",85,60,60,0,0,"VOX",7
27,"27024",1447,1048,1032,6,16,"VOX",29
47,"47123",461,360,358,2,2,"VOX",62
37,"37310",166,116,115,3,1,"VOX",10
16,"16271",612,482,481,3,1,"VOX",83
20,"20031",185,113,112,3,1,"VOX",0
8,"8115",3826,2777,2770,31,7,"VOX",198
40,"40025",129,109,107,1,2,"VOX",7
5,"5049",403,261,253,1,8,"VOX",40
28,"28049",57814,44977,44559,385,418,"VOX",7038
3,"3013",1063,809,794,3,15,"VOX",146
17,"17903",883,681,676,3,5,"VOX",33
37,"37018",106,75,75,0,0,"VOX",21
6,"6098",530,379,376,4,3,"VOX",82
12,"12063",41,31,31,1,0,"VOX",0
27,"27025",2731,2047,2006,18,41,"VOX",121
24,"24101",370,219,213,4,6,"VOX",22
18,"18001",222,147,146,0,1,"VOX",34
34,"34019",111,87,86,1,1,"VOX",24
37,"37019",138,111,109,0,2,"VOX",17
8,"8116",557,449,449,1,0,"VOX",12
3,"3014",238937,161861,160809,1308,1052,"VOX",29671
47,"47124",383,302,300,3,2,"VOX",47
22,"22156",289,216,213,1,3,"VOX",47
34,"34020",49,37,37,1,0,"VOX",9
8,"8117",2489,1954,1941,21,13,"VOX",77
40,"40026",112,101,99,0,2,"VOX",12
9,"9024",150,100,99,1,1,"VOX",17
18,"18097",947,633,631,0,2,"VOX",137
16,"16274",97,76,75,1,1,"VOX",7
47,"47125",49,42,42,0,0,"VOX",7
27,"27027",1791,1198,1167,17,31,"VOX",107
40,"40028",103,88,87,2,1,"VOX",22
19,"19082",100,72,71,1,1,"VOX",20
3,"3015",12818,9127,9017,46,110,"VOX",2385
49,"49057",107,74,71,0,3,"VOX",11
24,"24103",274,134,134,0,0,"VOX",19
18,"18002",529,387,384,1,3,"VOX",38
22,"22157",181,122,121,2,1,"VOX",10
12,"12064",80,71,69,0,2,"VOX",4
25,"25166",170,131,130,2,1,"VOX",6
24,"24104",243,167,166,0,1,"VOX",38
34,"34023",5103,3585,3543,45,42,"VOX",445
44,"44124",71,57,57,0,0,"VOX",3
9,"9026",377,288,288,1,0,"VOX",66
34,"34160",133,107,106,0,1,"VOX",8
27,"27028",78725,52642,51965,642,677,"VOX",4527
18,"18003",14454,10162,9935,105,227,"VOX",2309
19,"19086",1371,1003,996,9,7,"VOX",159
47,"47127",138,89,88,2,1,"VOX",8
8,"8118",17634,13450,13402,80,48,"VOX",664
6,"6103",4756,3285,3224,38,61,"VOX",586
3,"3016",88,66,66,0,0,"VOX",14
34,"34024",25,14,14,0,0,"VOX",3
40,"40029",25,21,19,0,2,"VOX",2
22,"22158",11994,8115,8049,79,66,"VOX",1292
5,"5054",1192,871,856,6,15,"VOX",85
27,"27029",1425,925,910,11,15,"VOX",86
3,"3017",379,320,314,4,6,"VOX",49
24,"24105",1512,1054,1047,10,7,"VOX",220
20,"20036",13208,9102,9056,59,46,"VOX",185
18,"18004",669,467,466,6,1,"VOX",110
34,"34025",52,34,34,1,0,"VOX",8
22,"22160",207,149,149,1,0,"VOX",27
40,"40030",419,317,314,3,3,"VOX",29
44,"44126",314,222,221,0,1,"VOX",17
47,"47128",53,45,43,0,2,"VOX",8
40,"40031",546,410,406,3,4,"VOX",81
19,"19088",91,67,66,0,1,"VOX",22
3,"3018",12433,8582,8502,54,80,"VOX",1134
27,"27030",3117,1945,1898,19,47,"VOX",131
34,"34027",1049,677,665,15,12,"VOX",86
24,"24107",206,147,147,1,0,"VOX",33
6,"6106",407,261,258,4,3,"VOX",55
18,"18005",363,232,230,3,2,"VOX",42
37,"37128",235,169,168,0,1,"VOX",12
18,"18100",7997,5523,5367,66,156,"VOX",1004
22,"22162",125,94,94,0,0,"VOX",15
47,"47129",855,660,648,7,12,"VOX",112
15,"15029",5354,3082,3050,46,32,"VOX",285
3,"3019",15501,11261,11106,86,155,"VOX",2441
19,"19089",23,17,17,0,0,"VOX",4
12,"12068",41,22,21,0,1,"VOX",1
8,"8191",5302,3872,3860,21,12,"VOX",159
44,"44127",57,43,43,0,0,"VOX",5
34,"34028",132,95,92,2,3,"VOX",13
47,"47130",94,64,63,0,1,"VOX",16
10,"10019",1412,948,934,2,14,"VOX",245
40,"40032",368,247,244,5,3,"VOX",47
37,"37025",245,198,196,5,2,"VOX",40
45,"45156",3334,2561,2502,23,59,"VOX",482
18,"18006",4062,2765,2711,25,54,"VOX",810
15,"15030",199701,137611,136590,1540,1021,"VOX",11075
5,"5057",2418,1785,1748,9,37,"VOX",309
3,"3020",94,84,84,1,0,"VOX",8
27,"27032",3197,1979,1956,30,23,"VOX",161
8,"8121",87515,62961,62574,429,387,"VOX",5019
34,"34029",665,524,518,1,6,"VOX",82
18,"18007",730,490,478,3,12,"VOX",87
20,"20039",2126,1623,1618,9,5,"VOX",5
8,"8122",1733,1179,1175,4,4,"VOX",58
22,"22163",426,338,335,0,3,"VOX",80
34,"34031",26,26,26,1,0,"VOX",9
24,"24109",857,534,528,8,6,"VOX",65
19,"19091",23,17,17,0,0,"VOX",5
45,"45158",2545,1805,1786,9,19,"VOX",410
22,"22164",42,28,28,0,0,"VOX",3
24,"24110",1158,784,773,1,11,"VOX",63
9,"9035",284,191,190,2,1,"VOX",23
34,"34032",38,30,30,0,0,"VOX",2
3,"3021",5573,4423,4343,23,80,"VOX",775
46,"46039",2111,1657,1640,16,17,"VOX",232
49,"49065",1048,747,725,6,22,"VOX",132
47,"47132",39,32,32,1,0,"VOX",9
41,"41075",10320,7159,6972,88,187,"VOX",1677
12,"12071",1272,936,925,3,11,"VOX",121
8,"8123",19570,15378,15316,91,62,"VOX",672
43,"43064",2027,1456,1445,19,11,"VOX",52
49,"49066",437,276,272,2,4,"VOX",60
44,"44130",28,23,23,0,0,"VOX",3
6,"6112",379,295,293,0,2,"VOX",40
47,"47133",2776,2096,2073,28,23,"VOX",491
18,"18010",527,398,394,5,4,"VOX",64
6,"6113",2649,1889,1862,16,27,"VOX",299
29,"29038",18908,12122,11931,197,191,"VOX",3187
13,"13002",1415,966,950,3,16,"VOX",225
3,"3022",140,125,121,1,4,"VOX",19
34,"34033",18,14,14,0,0,"VOX",3
40,"40035",135,110,110,2,0,"VOX",21
18,"18011",4403,3002,2947,24,55,"VOX",600
22,"22165",449,305,300,3,5,"VOX",44
6,"6114",127,105,105,0,0,"VOX",8
49,"49067",329,200,198,4,2,"VOX",33
40,"40036",496,395,380,8,15,"VOX",98
27,"27035",183,110,110,3,0,"VOX",10
47,"47134",150,120,116,2,4,"VOX",21
34,"34034",112,82,82,1,0,"VOX",15
15,"15034",2712,1605,1585,15,20,"VOX",115
5,"5061",257,193,189,1,4,"VOX",42
8,"8124",37157,27139,26994,179,145,"VOX",1791
3,"3023",1377,1138,1122,9,16,"VOX",136
34,"34035",97,76,75,3,1,"VOX",6
12,"12072",1083,852,827,10,25,"VOX",124
22,"22167",465,358,356,8,2,"VOX",45
40,"40037",30,17,17,0,0,"VOX",0
3,"3024",3937,2992,2952,19,40,"VOX",623
27,"27037",1001,714,707,11,7,"VOX",50
44,"44132",54,49,49,0,0,"VOX",8
16,"16905",1302,951,934,10,17,"VOX",184
22,"22168",22,20,19,0,1,"VOX",3
9,"9041",25,21,21,2,0,"VOX",1
5,"5062",163,121,119,3,2,"VOX",28
29,"29040",1933,1260,1235,11,25,"VOX",310
45,"45163",8326,5835,5693,48,142,"VOX",1374
34,"34036",230,159,158,0,1,"VOX",18
12,"12073",133,97,97,0,0,"VOX",15
16,"16906",70,44,44,1,0,"VOX",7
49,"49069",337,210,201,0,9,"VOX",16
37,"37031",329,241,238,3,3,"VOX",50
9,"9043",172,112,111,1,1,"VOX",20
3,"3025",1304,944,934,4,10,"VOX",295
12,"12074",756,611,601,3,10,"VOX",138
8,"8125",25583,18334,18225,122,109,"VOX",1375
18,"18013",4154,2892,2812,28,80,"VOX",707
50,"50901",133,96,96,0,0,"VOX",21
34,"34037",301,206,204,1,2,"VOX",38
10,"10028",83,62,61,1,1,"VOX",3
44,"44133",15,12,12,0,0,"VOX",3
34,"34178",119,94,91,0,3,"VOX",12
45,"45164",166,143,142,1,1,"VOX",25
5,"5064",101,77,77,0,0,"VOX",11
47,"47138",224,169,166,0,3,"VOX",32
43,"43068",484,322,317,2,5,"VOX",37
34,"34038",259,183,178,0,5,"VOX",41
3,"3026",1331,987,975,7,12,"VOX",141
27,"27040",3008,2071,2046,21,25,"VOX",97
18,"18014",6938,4864,4742,64,122,"VOX",1208
47,"47139",997,728,719,4,9,"VOX",160
19,"19098",20,17,17,0,0,"VOX",3
44,"44135",99,73,73,1,0,"VOX",11
50,"50902",77,65,62,0,3,"VOX",10
40,"40040",2489,1766,1744,26,22,"VOX",370
34,"34039",58,48,47,0,1,"VOX",1
45,"45166",1575,1231,1210,5,21,"VOX",133
22,"22172",520,373,369,5,4,"VOX",88
18,"18015",424,331,330,4,1,"VOX",63
27,"27041",2216,1463,1445,19,18,"VOX",103
12,"12075",110,85,83,3,2,"VOX",4
24,"24118",101,72,72,0,0,"VOX",6
41,"41080",1231,832,815,14,17,"VOX",121
22,"22173",219,147,141,3,6,"VOX",18
49,"49076",330,230,226,9,4,"VOX",51
34,"34041",82,64,64,3,0,"VOX",7
3,"3027",167,142,138,1,4,"VOX",22
29,"29043",2463,1508,1460,20,48,"VOX",301
41,"41081",30061,21488,21059,331,429,"VOX",2996
15,"15039",1224,802,785,9,17,"VOX",49
9,"9047",52,42,41,1,1,"VOX",4
47,"47140",106,83,83,0,0,"VOX",10
12,"12076",72,54,54,0,0,"VOX",6
37,"37034",77,63,62,0,1,"VOX",23
31,"31169",2203,1429,1415,15,14,"VOX",103
44,"44137",187,139,139,0,0,"VOX",30
5,"5067",73,56,54,0,2,"VOX",3
51,"51001",59820,33614,33265,323,349,"VOX",11734
18,"18016",297,200,198,3,2,"VOX",20
47,"47141",112,90,89,0,1,"VOX",12
3,"3114",1593,1158,1142,4,16,"VOX",276
5,"5166",155,108,104,1,4,"VOX",26
38,"38030",1962,1332,1318,9,14,"VOX",83
29,"29044",749,477,473,1,4,"VOX",69
47,"47142",121,85,85,0,0,"VOX",29
34,"34045",72,62,62,0,0,"VOX",8
52,"52001",54293,31015,30776,185,239,"VOX",5671
22,"22174",462,352,350,0,2,"VOX",50
6,"6124",1635,1158,1119,10,39,"VOX",61
18,"18017",18201,11500,11358,94,142,"VOX",2605
40,"40044",134,101,101,3,0,"VOX",17
12,"12077",4828,3395,3357,28,38,"VOX",650
19,"19103",247,205,202,1,3,"VOX",34
3,"3029",236,174,172,2,2,"VOX",13
10,"10034",337,244,240,0,4,"VOX",18
17,"17002",578,477,474,2,3,"VOX",12
8,"8129",486,399,398,0,1,"VOX",7
18,"18018",542,384,377,2,7,"VOX",71
27,"27044",2703,1495,1463,15,32,"VOX",105
34,"34046",43,29,29,0,0,"VOX",2
49,"49080",622,440,437,4,3,"VOX",70
46,"46183",6036,4276,4213,21,63,"VOX",913
8,"8130",110,81,81,2,0,"VOX",2
40,"40045",119,93,93,1,0,"VOX",15
44,"44141",122,88,85,0,3,"VOX",12
19,"19104",19,15,14,0,1,"VOX",1
3,"3030",559,442,433,2,9,"VOX",54
34,"34047",1711,1275,1248,18,27,"VOX",206
47,"47143",104,67,67,0,0,"VOX",9
19,"19105",2550,1913,1889,10,24,"VOX",566
27,"27045",926,588,583,6,5,"VOX",34
5,"5070",30,29,29,0,0,"VOX",3
9,"9054",89,65,63,4,2,"VOX",12
37,"37038",756,531,517,4,14,"VOX",62
45,"45172",640,475,462,6,13,"VOX",55
47,"47144",72,54,53,2,1,"VOX",18
18,"18020",489,318,310,2,8,"VOX",89
46,"46184",26514,19610,19399,180,211,"VOX",2759
3,"3031",42046,25035,24819,168,216,"VOX",4595
34,"34048",62,51,51,1,0,"VOX",10
27,"27046",1444,945,921,7,24,"VOX",60
44,"44142",29,21,21,0,0,"VOX",2
20,"20052",1050,746,743,4,3,"VOX",5
18,"18021",17929,12165,11949,139,216,"VOX",2779
34,"34049",329,229,227,1,2,"VOX",27
12,"12080",1883,1472,1438,8,34,"VOX",162
28,"28069",58,44,42,1,2,"VOX",6
47,"47145",583,430,426,6,4,"VOX",79
24,"24124",338,196,195,2,1,"VOX",41
44,"44143",388,298,298,2,0,"VOX",52
45,"45173",9756,6811,6720,49,91,"VOX",1780
22,"22178",105,89,89,1,0,"VOX",34
40,"40047",37,23,23,0,0,"VOX",1
3,"3032",97,82,82,0,0,"VOX",18
37,"37039",279,202,197,2,5,"VOX",30
41,"41086",16199,10227,10105,137,122,"VOX",1878
25,"25183",520,372,370,4,2,"VOX",10
34,"34050",187,136,136,1,0,"VOX",13
37,"37040",376,291,288,0,3,"VOX",45
15,"15045",3610,2057,2044,15,13,"VOX",163
24,"24125",416,233,231,3,2,"VOX",34
49,"49083",47,37,37,1,0,"VOX",4
44,"44144",319,225,223,0,2,"VOX",12
47,"47146",275,215,214,1,1,"VOX",46
19,"19107",306,245,244,0,1,"VOX",51
18,"18022",13875,8948,8764,98,184,"VOX",2085
3,"3033",101,82,78,0,4,"VOX",17
8,"8132",356,265,265,1,0,"VOX",2
27,"27048",1992,1317,1285,21,32,"VOX",103
37,"37041",71,53,53,0,0,"VOX",15
3,"3034",1404,1028,1010,5,18,"VOX",193
47,"47147",103,86,82,0,4,"VOX",11
49,"49084",266,197,195,11,2,"VOX",45
27,"27049",1324,847,829,8,18,"VOX",70
22,"22181",86,55,54,2,1,"VOX",3
19,"19108",95,78,78,0,0,"VOX",13
24,"24129",114,79,78,2,1,"VOX",13
45,"45176",3859,2694,2662,24,32,"VOX",814
40,"40049",37,27,27,0,0,"VOX",1
40,"40051",34,25,25,0,0,"VOX",3
34,"34052",164,127,125,1,2,"VOX",10
10,"10042",85,58,58,0,0,"VOX",4
8,"8133",123,96,94,5,2,"VOX",4
12,"12082",9602,7323,7248,53,75,"VOX",1677
18,"18023",15717,10964,10751,132,213,"VOX",2628
27,"27050",2821,1980,1954,11,26,"VOX",82
3,"3035",627,485,485,2,0,"VOX",56
47,"47148",419,332,324,3,8,"VOX",70
37,"37042",36,27,27,1,0,"VOX",5
24,"24130",415,291,289,2,2,"VOX",49
18,"18024",837,651,639,11,12,"VOX",94
34,"34053",194,156,154,3,2,"VOX",28
45,"45177",1998,1557,1525,10,32,"VOX",354
25,"25189",2181,1468,1461,11,7,"VOX",55
47,"47149",46,33,32,1,1,"VOX",1
6,"6135",1101,860,849,2,11,"VOX",227
12,"12083",88,69,67,9,2,"VOX",9
34,"34201",171,131,130,1,1,"VOX",13
8,"8134",848,618,609,4,9,"VOX",21
34,"34055",254,185,184,3,1,"VOX",33
3,"3036",82,73,71,1,2,"VOX",4
9,"9061",147,119,119,0,0,"VOX",27
5,"5077",154,113,110,0,3,"VOX",16
19,"19110",51,39,39,0,0,"VOX",12
44,"44147",401,264,256,7,8,"VOX",21
22,"22184",167,132,130,4,2,"VOX",25
6,"6136",1489,1086,1060,11,26,"VOX",107
25,"25190",262,202,202,2,0,"VOX",4
8,"8135",6770,5187,5158,42,29,"VOX",351
47,"47150",253,193,187,3,6,"VOX",25
18,"18025",277,198,197,0,1,"VOX",38
34,"34056",1926,1335,1311,10,24,"VOX",163
3,"3037",340,261,255,3,6,"VOX",32
5,"5078",95,78,78,2,0,"VOX",12
47,"47151",26,22,22,0,0,"VOX",2
27,"27052",860,564,558,7,6,"VOX",22
19,"19111",160,128,125,0,3,"VOX",29
5,"5079",66,53,52,0,1,"VOX",13
18,"18027",2598,1730,1706,12,24,"VOX",229
34,"34057",464,308,302,4,6,"VOX",51
25,"25191",321,227,222,2,5,"VOX",6
27,"27053",497,342,334,2,8,"VOX",25
15,"15050",1732,931,917,15,14,"VOX",79
43,"43080",230,192,192,2,0,"VOX",5
8,"8136",11692,8527,8456,98,71,"VOX",713
44,"44148",74,56,54,0,2,"VOX",5
29,"29054",42538,28080,27814,225,266,"VOX",6389
40,"40054",108,79,78,3,1,"VOX",14
3,"3038",330,260,254,3,6,"VOX",48
9,"9064",305,225,219,6,6,"VOX",45
3,"3124",459,360,358,0,2,"VOX",32
34,"34058",182,152,152,0,0,"VOX",11
8,"8137",272,208,207,2,1,"VOX",1
22,"22187",288,220,220,2,0,"VOX",32
3,"3039",89,65,65,0,0,"VOX",11
18,"18028",898,723,718,3,5,"VOX",138
37,"37339",295,219,219,5,0,"VOX",39
34,"34059",411,304,292,6,12,"VOX",42
44,"44149",99,74,73,4,1,"VOX",9
27,"27054",1135,807,782,5,25,"VOX",48
40,"40055",31,26,26,0,0,"VOX",0
18,"18029",1812,1104,1065,7,39,"VOX",240
47,"47153",101,69,69,1,0,"VOX",12
12,"12087",26,16,16,0,0,"VOX",0
9,"9066",54,37,37,0,0,"VOX",3
45,"45184",204,123,122,0,1,"VOX",22
24,"24136",495,347,344,1,3,"VOX",76
47,"47154",146,115,111,6,4,"VOX",11
8,"8138",4461,3286,3259,27,27,"VOX",96
6,"6142",257,203,194,1,9,"VOX",16
34,"34060",133,109,107,0,2,"VOX",10
3,"3040",264,227,221,1,6,"VOX",25
34,"34061",91,70,69,1,1,"VOX",28
27,"27055",1191,773,764,7,9,"VOX",41
20,"20061",4427,3073,3053,13,20,"VOX",26
12,"12088",57,53,53,0,0,"VOX",6
40,"40057",1397,1081,1067,15,14,"VOX",121
27,"27056",1218,787,778,6,9,"VOX",84
37,"37050",66,52,52,1,0,"VOX",16
3,"3041",6132,4204,4167,22,37,"VOX",677
43,"43082",350,276,271,5,5,"VOX",8
18,"18030",566,382,380,2,2,"VOX",75
34,"34062",148,94,93,0,1,"VOX",22
47,"47155",3454,2445,2405,26,40,"VOX",587
31,"31186",283,183,182,1,1,"VOX",7
49,"49094",210,111,111,0,0,"VOX",11
6,"6144",504,391,382,6,9,"VOX",15
22,"22190",123,77,77,1,0,"VOX",7
18,"18032",247,164,163,1,1,"VOX",26
27,"27057",11047,7078,6941,64,137,"VOX",696
44,"44151",180,134,134,1,0,"VOX",6
47,"47156",150,117,117,0,0,"VOX",33
3,"3042",1475,1053,1043,7,10,"VOX",182
23,"23029",798,595,590,0,5,"VOX",97
45,"45187",3967,3133,3074,16,59,"VOX",502
34,"34063",84,74,74,1,0,"VOX",9
8,"8139",172,148,147,2,1,"VOX",1
44,"44152",70,46,46,0,0,"VOX",6
40,"40058",306,244,240,1,4,"VOX",45
8,"8140",4816,3541,3520,25,21,"VOX",154
18,"18033",279,179,174,0,5,"VOX",33
24,"24142",24715,16839,16616,159,223,"VOX",2976
34,"34066",54,47,47,1,0,"VOX",5
27,"27058",3283,2275,2241,12,34,"VOX",123
5,"5084",66,44,44,0,0,"VOX",8
29,"29059",2662,1950,1895,16,55,"VOX",192
40,"40059",109,92,91,2,1,"VOX",4
3,"3043",2906,2360,2334,27,26,"VOX",259
5,"5085",31,27,27,0,0,"VOX",4
47,"47157",490,398,397,2,1,"VOX",79
43,"43085",237,190,185,1,5,"VOX",4
22,"22195",238,190,186,0,4,"VOX",41
3,"3130",28,19,19,0,0,"VOX",0
6,"6148",957,682,665,1,17,"VOX",75
3,"3044",4608,3437,3391,13,46,"VOX",889
34,"34067",129,80,78,1,2,"VOX",5
31,"31189",1125,702,698,6,4,"VOX",13
20,"20065",2921,1983,1970,16,13,"VOX",29
27,"27059",2035,1356,1322,7,34,"VOX",78
37,"37055",117,97,93,0,4,"VOX",16
18,"18034",484,345,342,3,3,"VOX",55
44,"44154",240,164,161,1,3,"VOX",24
47,"47158",859,618,608,4,10,"VOX",119
40,"40060",67,40,40,1,0,"VOX",7
34,"34068",29,25,24,0,1,"VOX",6
48,"48018",854,563,560,5,3,"VOX",4
46,"46195",2000,1540,1532,3,8,"VOX",271
49,"49098",200,139,138,3,1,"VOX",12
19,"19119",76,65,65,0,0,"VOX",18
34,"34069",2184,1555,1517,17,38,"VOX",213
22,"22197",436,327,325,3,2,"VOX",57
37,"37056",39,28,28,0,0,"VOX",2
3,"3045",216,176,172,1,4,"VOX",27
27,"27061",1018,704,683,12,21,"VOX",68
47,"47159",825,672,661,0,11,"VOX",115
45,"45191",524,437,432,2,5,"VOX",61
40,"40061",63,47,44,0,3,"VOX",4
8,"8142",136,117,117,3,0,"VOX",1
44,"44155",1063,779,778,3,1,"VOX",62
49,"49099",96,67,67,0,0,"VOX",15
45,"45192",2380,1890,1854,8,36,"VOX",306
3,"3046",1636,1073,1061,7,12,"VOX",169
34,"34070",131,98,96,0,2,"VOX",5
37,"37057",208,151,149,0,2,"VOX",19
8,"8143",2727,1989,1977,19,12,"VOX",113
44,"44156",47,31,31,0,0,"VOX",4
47,"47160",395,296,294,3,2,"VOX",51
18,"18036",3986,2956,2917,22,39,"VOX",628
12,"12093",161,111,109,2,2,"VOX",24
47,"47161",3970,3111,3089,24,22,"VOX",744
22,"22200",239,165,164,2,1,"VOX",16
40,"40063",6913,4948,4838,57,110,"VOX",831
9,"9078",32,27,27,0,0,"VOX",3
6,"6153",20252,14183,13924,154,259,"VOX",2367
27,"27062",583,403,400,2,3,"VOX",21
37,"37348",100,76,76,0,0,"VOX",16
27,"27063",1699,1131,1109,7,22,"VOX",51
31,"31194",328,224,222,3,2,"VOX",2
18,"18135",4385,2882,2798,24,84,"VOX",486
46,"46197",1930,1430,1411,11,19,"VOX",189
12,"12094",871,671,661,1,10,"VOX",107
34,"34072",145,125,123,1,2,"VOX",24
3,"3047",9768,6220,6144,41,76,"VOX",926
49,"49101",144,88,82,1,6,"VOX",17
5,"5090",73,63,62,0,1,"VOX",16
22,"22201",264,188,186,3,2,"VOX",10
9,"9079",47,38,38,0,0,"VOX",4
18,"18037",535,417,410,2,7,"VOX",110
15,"15061",5149,3221,3168,44,53,"VOX",249
18,"18038",1042,782,760,5,22,"VOX",152
8,"8144",722,551,545,3,6,"VOX",8
19,"19122",81,62,60,2,2,"VOX",4
3,"3048",4993,3549,3502,13,47,"VOX",740
34,"34073",180,123,120,3,3,"VOX",17
47,"47163",277,208,205,3,3,"VOX",21
46,"46198",862,670,660,3,10,"VOX",65
8,"8145",2712,2060,2049,8,11,"VOX",93
22,"22202",147,128,128,3,0,"VOX",6
3,"3049",12103,8872,8785,57,87,"VOX",2574
40,"40068",22,21,21,0,0,"VOX",4
45,"45196",1382,1029,1005,7,24,"VOX",289
19,"19123",37,30,28,0,2,"VOX",6
37,"37060",283,205,202,1,3,"VOX",48
24,"24150",226,163,162,0,1,"VOX",27
34,"34074",690,502,490,13,12,"VOX",76
47,"47164",349,283,281,1,2,"VOX",53
34,"34076",532,443,438,1,5,"VOX",53
24,"24151",433,307,304,1,3,"VOX",45
5,"5093",362,251,249,0,2,"VOX",50
27,"27065",12055,7566,7379,119,187,"VOX",644
44,"44159",37,27,27,1,0,"VOX",4
40,"40069",68,59,59,0,0,"VOX",15
18,"18039",3343,2293,2252,22,41,"VOX",532
8,"8146",1384,1030,1027,8,3,"VOX",100
19,"19124",378,230,229,2,1,"VOX",44
3,"3050",19420,13210,13116,70,94,"VOX",2423
27,"27066",12588,8116,7954,109,162,"VOX",561
47,"47165",6823,4999,4906,48,93,"VOX",1322
34,"34077",395,282,278,7,4,"VOX",63
22,"22203",77,62,62,2,0,"VOX",7
44,"44160",438,287,285,4,2,"VOX",30
12,"12097",62,53,51,0,2,"VOX",10
49,"49105",135,94,94,2,0,"VOX",14
37,"37062",78,59,59,0,0,"VOX",18
45,"45198",1808,1442,1428,6,14,"VOX",329
40,"40070",143,94,92,1,2,"VOX",21
27,"27901",2249,1373,1360,22,13,"VOX",107
20,"20073",4707,3272,3260,14,12,"VOX",24
18,"18040",237,146,145,0,1,"VOX",7
50,"50110",340,248,238,1,10,"VOX",46
49,"49107",115,70,70,0,0,"VOX",10
3,"3051",342,288,286,4,2,"VOX",36
47,"47166",251,183,181,2,2,"VOX",40
37,"37063",58,47,47,0,0,"VOX",7
44,"44161",428,294,292,2,2,"VOX",44
40,"40071",39,32,26,0,6,"VOX",2
24,"24153",228,171,171,3,0,"VOX",29
47,"47167",245,198,198,1,0,"VOX",27
41,"41094",6496,4733,4628,47,105,"VOX",1161
34,"34080",5231,3207,3161,35,46,"VOX",487
3,"3052",959,747,735,4,12,"VOX",145
18,"18042",417,332,330,4,2,"VOX",62
19,"19126",1701,1223,1207,6,16,"VOX",366
5,"5096",76,62,62,0,0,"VOX",12
17,"17024",281,203,201,4,2,"VOX",12
22,"22205",448,294,292,0,2,"VOX",28
18,"18043",129,74,71,0,3,"VOX",20
15,"15067",7933,5329,5282,43,47,"VOX",410
34,"34081",60,45,44,0,1,"VOX",10
24,"24155",441,340,334,2,6,"VOX",40
45,"45201",3692,2198,2175,15,23,"VOX",758
20,"20075",4312,2848,2845,8,3,"VOX",48
41,"41095",40187,27090,26680,512,410,"VOX",5608
37,"37355",159,121,120,1,1,"VOX",11
34,"34082",78,59,58,0,1,"VOX",15
23,"23043",517,360,360,1,0,"VOX",73
47,"47168",30,26,26,1,0,"VOX",12
12,"12099",597,444,436,6,8,"VOX",99
3,"3053",7568,5551,5468,40,83,"VOX",1069
15,"15068",4824,2976,2937,54,39,"VOX",236
22,"22206",179,138,137,0,1,"VOX",13
19,"19129",25,21,21,0,0,"VOX",0
5,"5097",464,309,305,0,4,"VOX",66
50,"50263",171,110,108,1,2,"VOX",12
18,"18044",161,91,91,0,0,"VOX",29
24,"24156",220,135,133,0,2,"VOX",19
49,"49110",344,196,195,2,1,"VOX",34
28,"28002",3250,2261,2243,14,18,"VOX",623
34,"34083",1647,1089,1080,2,9,"VOX",191
40,"40073",387,327,323,1,4,"VOX",59
8,"8149",980,702,694,6,8,"VOX",9
3,"3054",334,248,245,2,3,"VOX",32
47,"47170",43,36,30,0,6,"VOX",4
37,"37068",337,240,236,1,4,"VOX",59
41,"41097",3131,2197,2140,13,57,"VOX",462
44,"44165",168,125,125,2,0,"VOX",19
19,"19130",61556,45926,45388,408,538,"VOX",10131
45,"45093",147,115,114,0,1,"VOX",19
7,"7001",3647,2430,2383,26,47,"VOX",248
22,"22208",192,150,147,1,3,"VOX",12
18,"18045",1065,720,690,11,30,"VOX",166
9,"9095",103,54,53,3,1,"VOX",7
41,"41098",5161,3792,3732,33,60,"VOX",713
45,"45204",630,453,449,1,4,"VOX",99
3,"3055",5265,3741,3697,16,44,"VOX",1199
5,"5100",260,193,192,3,1,"VOX",29
47,"47171",375,295,290,9,5,"VOX",60
18,"18046",1738,1042,1023,7,19,"VOX",337
15,"15071",7780,4937,4848,34,89,"VOX",405
5,"5101",266,206,205,1,1,"VOX",43
40,"40075",152,116,116,0,0,"VOX",14
34,"34086",102,81,81,2,0,"VOX",11
44,"44167",34,26,26,0,0,"VOX",3
20,"20079",18151,13106,13054,58,52,"VOX",175
25,"25211",680,470,470,3,0,"VOX",5
10,"10073",733,513,499,8,14,"VOX",84
13,"13057",1099,858,849,2,9,"VOX",153
3,"3056",8588,6219,6135,29,84,"VOX",951
45,"45901",779,542,534,5,8,"VOX",134
3,"3057",174,138,136,0,2,"VOX",27
8,"8151",450,351,346,5,5,"VOX",3
22,"22209",161,121,121,3,0,"VOX",12
34,"34087",125,99,99,2,0,"VOX",9
24,"24160",633,404,403,2,1,"VOX",80
28,"28006",80903,60936,60508,482,428,"VOX",11221
40,"40076",6576,4700,4607,32,93,"VOX",1125
37,"37071",76,64,62,1,2,"VOX",13
5,"5102",1681,1252,1228,8,24,"VOX",219
44,"44168",181,119,117,1,2,"VOX",10
19,"19134",23,14,14,0,0,"VOX",3
8,"8152",117,94,94,0,0,"VOX",3
34,"34088",265,195,191,1,4,"VOX",33
3,"3058",4976,3733,3669,20,64,"VOX",1128
18,"18048",2494,1708,1657,18,51,"VOX",383
7,"7004",4069,2652,2624,27,28,"VOX",456
44,"44169",298,216,216,0,0,"VOX",14
12,"12103",87,61,60,0,1,"VOX",12
47,"47173",879,627,622,9,5,"VOX",99
49,"49115",167,121,121,2,0,"VOX",21
47,"47174",271,215,213,4,2,"VOX",40
34,"34089",141,102,101,4,1,"VOX",20
40,"40077",966,718,704,10,14,"VOX",145
9,"9103",200,168,166,1,2,"VOX",8
22,"22213",2918,2084,2062,20,22,"VOX",382
34,"34091",118,82,82,1,0,"VOX",9
49,"49116",356,239,234,4,5,"VOX",41
16,"16204",237,179,177,1,2,"VOX",50
46,"46138",361,289,287,1,2,"VOX",59
37,"37073",613,448,440,4,8,"VOX",114
40,"40078",150,123,123,6,0,"VOX",17
3,"3059",20710,14788,14685,89,103,"VOX",3862
24,"24162",1753,1259,1245,12,14,"VOX",260
12,"12104",6843,5181,5111,32,70,"VOX",757
5,"5104",33,21,19,0,2,"VOX",2
28,"28008",2008,1333,1323,7,10,"VOX",385
24,"24163",4076,2979,2954,35,25,"VOX",607
34,"34092",257,189,189,1,0,"VOX",17
3,"3060",105,78,77,0,1,"VOX",17
18,"18050",1649,1113,1095,5,18,"VOX",269
22,"22214",117,92,89,0,3,"VOX",12
47,"47175",6755,4950,4870,49,80,"VOX",945
8,"8154",697,541,539,3,2,"VOX",21
37,"37074",136,93,90,1,3,"VOX",11
12,"12105",825,602,598,6,4,"VOX",147
7,"7007",416,277,275,4,2,"VOX",26
20,"20902",14282,9670,9618,52,52,"VOX",244
47,"47176",199,110,110,0,0,"VOX",23
34,"34241",17,17,16,3,1,"VOX",1
10,"10080",353,243,238,1,5,"VOX",33
34,"34093",83,61,60,0,1,"VOX",10
8,"8155",7056,5050,5011,38,39,"VOX",483
3,"3061",1060,793,787,5,6,"VOX",257
37,"37077",251,206,204,1,2,"VOX",21
12,"12106",1151,928,908,9,20,"VOX",65
47,"47177",104,78,78,0,0,"VOX",10
19,"19138",215,158,154,4,4,"VOX",16
49,"49119",217,158,156,2,2,"VOX",22
34,"34094",61,45,45,2,0,"VOX",12
18,"18051",1092,735,718,8,17,"VOX",103
44,"44173",103,81,79,0,2,"VOX",3
19,"19037",131,109,108,0,1,"VOX",41
19,"19139",26,19,19,2,0,"VOX",0
3,"3062",228,173,172,3,1,"VOX",43
37,"37078",781,626,603,9,23,"VOX",106
40,"40081",117,80,76,1,4,"VOX",9
24,"24166",1346,929,916,14,13,"VOX",191
18,"18053",1554,1001,985,9,16,"VOX",225
47,"47178",170,128,124,2,4,"VOX",20
44,"44263",373,267,267,2,0,"VOX",41
34,"34096",48,39,38,0,1,"VOX",7
15,"15078",78810,55693,55183,569,510,"VOX",3434
28,"28011",417,295,292,6,3,"VOX",84
41,"41903",6776,4616,4494,72,122,"VOX",894
12,"12107",350,299,295,3,4,"VOX",53
3,"3063",27209,18236,18101,164,135,"VOX",2545
18,"18151",261,167,166,4,1,"VOX",24
34,"34098",790,562,558,3,4,"VOX",102
40,"40181",4182,3102,3038,35,64,"VOX",443
12,"12108",443,354,352,4,2,"VOX",34
47,"47179",368,256,254,2,2,"VOX",31
22,"22218",39,34,34,0,0,"VOX",4
34,"34099",53,44,42,0,2,"VOX",13
44,"44175",112,76,75,1,1,"VOX",3
4,"4007",735,514,509,3,5,"VOX",123
19,"19234",44,30,30,0,0,"VOX",4
28,"28012",929,707,698,7,9,"VOX",210
10,"10206",196,135,133,0,2,"VOX",17
8,"8157",8574,6514,6472,47,42,"VOX",415
25,"25220",991,768,762,1,6,"VOX",20
9,"9274",1035,774,762,8,12,"VOX",91
18,"18054",820,573,569,2,4,"VOX",147
40,"40083",73,52,52,1,0,"VOX",19
3,"3064",5015,3514,3461,15,53,"VOX",1002
29,"29069",87188,54019,53240,633,779,"VOX",12537
22,"22220",147,106,105,1,1,"VOX",21
44,"44176",152,114,113,1,1,"VOX",8
28,"28013",41661,29431,29168,241,263,"VOX",6869
9,"9114",77,60,59,0,1,"VOX",9
34,"34100",132,96,95,1,1,"VOX",25
28,"28014",34522,25016,24748,229,268,"VOX",6084
47,"47180",57,41,41,1,0,"VOX",9
18,"18056",3382,2397,2350,30,47,"VOX",419
25,"25221",115,82,81,1,1,"VOX",0
3,"3065",169894,121210,120342,1045,868,"VOX",24954
5,"5008",202,158,155,0,3,"VOX",29
47,"47181",165,136,135,1,1,"VOX",27
25,"25222",69,58,58,0,0,"VOX",1
22,"22221",92,56,55,0,1,"VOX",9
34,"34101",48,36,36,1,0,"VOX",6
43,"43106",784,605,598,3,7,"VOX",21
5,"5112",95,59,58,0,1,"VOX",9
24,"24170",1806,1232,1220,9,12,"VOX",132
9,"9117",71,58,58,0,0,"VOX",7
13,"13072",727,518,510,3,8,"VOX",160
46,"46007",12333,8890,8803,79,87,"VOX",2059
34,"34102",197,158,156,1,2,"VOX",23
44,"44266",102,81,79,0,2,"VOX",4
3,"3066",41762,28723,28388,358,335,"VOX",5098
18,"18057",5584,4042,3958,51,84,"VOX",1022
47,"47182",1328,940,934,8,6,"VOX",232
12,"12110",222,156,155,3,1,"VOX",18
16,"16096",278,219,217,1,2,"VOX",46
40,"40086",656,513,496,7,17,"VOX",95
5,"5113",62,42,42,0,0,"VOX",7
28,"28016",79,55,55,0,0,"VOX",15
22,"22222",516,379,377,6,2,"VOX",72
25,"25223",890,673,666,7,7,"VOX",17
22,"22223",77,60,59,2,1,"VOX",3
47,"47183",135,100,100,1,0,"VOX",26
34,"34103",96,79,76,0,3,"VOX",19
29,"29072",3291,2360,2307,19,53,"VOX",373
18,"18059",4265,2960,2886,23,74,"VOX",545
25,"25039",259,197,196,7,1,"VOX",1
9,"9120",41,34,33,3,1,"VOX",3
3,"3067",91,78,78,0,0,"VOX",18
28,"28017",1280,975,963,10,12,"VOX",249
19,"19147",42,32,32,0,0,"VOX",3
18,"18061",999,781,770,5,11,"VOX",166
9,"9122",86,55,55,0,0,"VOX",7
23,"23060",19210,13677,13495,145,182,"VOX",3044
34,"34104",231,164,162,2,2,"VOX",17
44,"44179",324,201,201,2,0,"VOX",12
8,"8160",317,234,234,0,0,"VOX",3
47,"47184",537,411,402,1,9,"VOX",84
9,"9281",136,97,97,2,0,"VOX",15
3,"3068",41,38,37,0,1,"VOX",4
42,"42008",54,41,41,0,0,"VOX",6
34,"34106",110,92,92,3,0,"VOX",22
18,"18062",11226,7969,7777,88,192,"VOX",1953
49,"49127",2402,1640,1604,18,36,"VOX",354
15,"15084",3039,2002,1981,12,21,"VOX",150
22,"22225",2606,1638,1612,20,26,"VOX",211
43,"43109",2706,1751,1738,17,13,"VOX",289
34,"34107",73,47,46,1,1,"VOX",7
44,"44180",74,56,56,0,0,"VOX",7
47,"47185",82,62,61,1,1,"VOX",9
19,"19150",116,89,89,0,0,"VOX",24
28,"28018",4121,3174,3151,22,23,"VOX",801
3,"3069",3329,2102,2077,11,25,"VOX",435
9,"9124",1405,946,928,6,18,"VOX",122
37,"37184",289,178,177,1,1,"VOX",20
48,"48043",4591,3337,3325,20,12,"VOX",37
37,"37087",911,675,665,5,10,"VOX",199
22,"22226",761,537,530,13,7,"VOX",78
47,"47186",244314,182449,180833,1818,1616,"VOX",28788
12,"12113",90,59,59,1,0,"VOX",10
5,"5117",191,155,153,1,2,"VOX",33
31,"31224",884,637,630,7,7,"VOX",31
34,"34108",499,391,384,3,7,"VOX",47
19,"19151",1077,703,693,8,10,"VOX",175
15,"15086",2760,1829,1810,26,19,"VOX",145
22,"22227",200,140,140,2,0,"VOX",13
18,"18063",1232,687,678,9,9,"VOX",201
47,"47187",71,49,49,0,0,"VOX",12
3,"3070",2115,1399,1376,9,23,"VOX",339
40,"40091",109,87,85,0,2,"VOX",18
34,"34109",60,34,34,0,0,"VOX",8
12,"12114",200,144,140,0,4,"VOX",27
40,"40092",105,75,75,2,0,"VOX",4
9,"9289",1353,873,861,4,12,"VOX",144
19,"19152",540,377,374,2,3,"VOX",70
17,"17041",217,150,146,1,4,"VOX",0
9,"9128",76,56,56,0,0,"VOX",6
29,"29076",2354,1498,1444,21,54,"VOX",376
8,"8163",19672,13421,13364,70,57,"VOX",1231
37,"37089",60,44,43,0,1,"VOX",4
34,"34110",75,64,64,0,0,"VOX",6
42,"42012",29,22,22,0,0,"VOX",7
3,"3071",4000,2858,2813,27,45,"VOX",283
28,"28021",571,365,364,1,1,"VOX",58
3,"3072",352,281,277,3,4,"VOX",37
12,"12115",205,161,161,1,0,"VOX",40
22,"22228",532,371,364,4,7,"VOX",82
50,"50130",354,225,222,1,3,"VOX",55
46,"46012",965,689,675,4,14,"VOX",120
29,"29077",207,135,134,1,1,"VOX",34
47,"47188",98,73,70,0,3,"VOX",12
44,"44183",61,47,47,1,0,"VOX",14
34,"34112",39,31,31,0,0,"VOX",2
49,"49132",310,220,215,2,5,"VOX",49
18,"18065",588,464,451,2,13,"VOX",25
26,"26062",85,62,62,1,0,"VOX",2
5,"5120",33,26,26,0,0,"VOX",1
28,"28022",37338,30620,30455,229,165,"VOX",7149
34,"34113",40,38,38,0,0,"VOX",5
8,"8164",936,750,747,6,3,"VOX",27
22,"22229",107,70,70,2,0,"VOX",5
3,"3073",222,178,178,0,0,"VOX",25
31,"31228",496,356,354,1,2,"VOX",25
40,"40094",353,265,263,3,2,"VOX",62
8,"8165",1680,1177,1171,7,6,"VOX",50
22,"22230",291,209,207,4,2,"VOX",39
9,"9131",485,390,388,7,2,"VOX",63
18,"18066",2095,1401,1378,12,23,"VOX",241
15,"15090",1115,711,701,19,10,"VOX",47
4,"4019",236,174,172,0,2,"VOX",21
40,"40095",453,341,329,2,12,"VOX",119
28,"28023",5159,4052,4019,27,33,"VOX",947
34,"34114",200,134,134,0,0,"VOX",22
28,"28024",168,137,136,2,1,"VOX",31
3,"3074",1766,1347,1336,4,11,"VOX",367
21,"21010",15011,8812,8694,174,118,"VOX",1814
9,"9298",72,52,52,1,0,"VOX",4
47,"47191",111,81,81,0,0,"VOX",20
18,"18067",682,442,437,2,5,"VOX",90
12,"12117",3532,2512,2479,12,33,"VOX",471
34,"34116",54,35,35,0,0,"VOX",11
5,"5122",118,91,89,1,2,"VOX",10
24,"24180",1086,767,759,9,8,"VOX",174
7,"7024",7283,3574,3538,36,36,"VOX",414
31,"31231",104,65,65,1,0,"VOX",4
13,"13087",23255,15400,15127,213,273,"VOX",3199
49,"49135",576,368,366,3,2,"VOX",73
44,"44185",88,69,69,2,0,"VOX",6
8,"8166",964,700,697,7,3,"VOX",23
40,"40097",130,103,102,5,1,"VOX",19
18,"18068",1638,1197,1167,12,30,"VOX",228
34,"34120",63790,46117,45597,464,520,"VOX",6107
3,"3075",154,117,115,1,2,"VOX",27
47,"47192",89,78,76,3,2,"VOX",15
49,"49248",171,128,128,1,0,"VOX",19
28,"28025",405,294,291,5,3,"VOX",81
34,"34121",187,150,150,3,0,"VOX",45
5,"5123",106,78,78,0,0,"VOX",9
19,"19157",53,37,37,0,0,"VOX",4
49,"49136",313,218,217,5,1,"VOX",49
15,"15092",6220,3810,3756,30,54,"VOX",274
40,"40099",54,44,42,0,2,"VOX",4
18,"18069",484,356,356,5,0,"VOX",61
47,"47193",1625,1251,1236,10,15,"VOX",254
22,"22233",81,53,53,0,0,"VOX",2
8,"8167",6056,4520,4500,38,20,"VOX",448
42,"42018",127,94,94,1,0,"VOX",17
7,"7026",31129,17489,17342,178,147,"VOX",2417
3,"3076",8846,6105,6029,40,76,"VOX",1158
12,"12119",139,97,94,3,3,"VOX",21
25,"25233",289,219,218,6,1,"VOX",8
21,"21013",10626,6990,6807,99,183,"VOX",1371
34,"34122",83,56,56,0,0,"VOX",13
47,"47194",295,228,227,1,1,"VOX",23
45,"45012",623,482,472,0,10,"VOX",83
29,"29083",2063,1471,1444,14,27,"VOX",251
8,"8168",388,280,279,3,1,"VOX",14
34,"34123",1634,1274,1258,4,16,"VOX",176
29,"29009",1435,971,957,17,14,"VOX",71
28,"28027",1215,836,826,8,10,"VOX",151
31,"31234",146,101,101,0,0,"VOX",7
12,"12120",149,125,121,3,4,"VOX",21
42,"42020",4170,2732,2686,35,46,"VOX",348
44,"44190",63,45,45,0,0,"VOX",3
43,"43118",422,338,338,0,0,"VOX",20
34,"34124",60,45,45,0,0,"VOX",7
46,"46017",33041,23469,23277,173,192,"VOX",5001
35,"35009",20229,13378,13201,95,177,"VOX",1343
7,"7028",944,635,628,2,7,"VOX",88
3,"3078",468,340,336,0,4,"VOX",94
47,"47195",426,314,310,2,4,"VOX",55
22,"22235",88,69,68,1,1,"VOX",10
40,"40101",918,672,665,11,7,"VOX",185
37,"37194",229,161,160,0,1,"VOX",17
49,"49139",149,112,112,0,0,"VOX",28
28,"28029",576,443,443,4,0,"VOX",99
24,"24185",447,303,295,1,8,"VOX",55
25,"25238",212,161,160,0,1,"VOX",6
44,"44191",714,509,500,5,9,"VOX",42
49,"49141",290,191,191,1,0,"VOX",26
18,"18071",5636,3909,3807,45,102,"VOX",754
24,"24187",834,559,549,11,10,"VOX",69
49,"49252",312,240,236,7,4,"VOX",22
47,"47196",29,21,21,0,0,"VOX",4
34,"34125",105,80,80,2,0,"VOX",16
40,"40103",139,113,113,0,0,"VOX",32
21,"21016",985,703,680,5,23,"VOX",81
22,"22236",232,190,188,2,2,"VOX",31
47,"47197",875,659,656,9,3,"VOX",186
12,"12122",754,608,600,3,8,"VOX",101
44,"44192",341,274,272,2,2,"VOX",40
25,"25239",582,330,330,3,0,"VOX",12
34,"34126",248,177,176,3,1,"VOX",40
18,"18072",655,452,445,4,7,"VOX",88
8,"8170",442,322,320,0,2,"VOX",6
3,"3080",1330,1040,1032,4,8,"VOX",349
47,"47010",14718,11521,11392,137,129,"VOX",2818
40,"40104",283,203,200,0,3,"VOX",51
25,"25240",1366,1030,1021,4,9,"VOX",49
17,"17051",202,161,160,0,1,"VOX",6
47,"47198",64,43,43,0,0,"VOX",14
18,"18074",265,205,205,0,0,"VOX",51
9,"9143",28,17,17,0,0,"VOX",2
31,"31239",282,196,193,6,3,"VOX",7
21,"21017",2302,1469,1452,18,17,"VOX",218
19,"19163",60,49,49,0,0,"VOX",8
12,"12123",40,32,32,0,0,"VOX",6
8,"8171",2046,1520,1510,13,10,"VOX",33
7,"7032",21005,12039,11928,114,111,"VOX",1385
22,"22242",60,41,40,0,1,"VOX",5
49,"49143",201,119,118,1,1,"VOX",22
34,"34129",168,118,118,1,0,"VOX",21
40,"40105",43,35,35,0,0,"VOX",6
9,"9311",59,45,45,0,0,"VOX",1
5,"5129",111,70,69,0,1,"VOX",22
38,"38003",1517,899,890,5,9,"VOX",78
8,"8172",20543,15191,15140,85,51,"VOX",889
34,"34130",195,154,153,5,1,"VOX",16
28,"28032",5090,3716,3675,22,41,"VOX",1024
42,"42026",28,25,25,0,0,"VOX",2
47,"47199",71,57,57,2,0,"VOX",3
24,"24190",146,103,103,2,0,"VOX",16
18,"18076",789,534,532,2,2,"VOX",87
29,"29088",2689,1817,1747,15,70,"VOX",318
40,"40106",179,140,139,2,1,"VOX",17
3,"3082",12941,8399,8304,51,95,"VOX",1483
44,"44194",103,67,64,0,3,"VOX",13
7,"7034",1074,796,779,9,17,"VOX",119
28,"28108",3736,2681,2652,21,29,"VOX",640
34,"34131",56,46,46,0,0,"VOX",8
28,"28033",4177,2972,2936,20,36,"VOX",931
44,"44195",82,58,57,0,1,"VOX",11
49,"49146",265,183,181,4,2,"VOX",16
29,"29089",3138,2262,2186,13,76,"VOX",204
21,"21020",349,230,228,2,2,"VOX",37
8,"8174",388,322,318,2,4,"VOX",24
18,"18077",471,350,343,1,7,"VOX",72
47,"47203",54,40,40,0,0,"VOX",13
3,"3083",5479,3736,3674,39,62,"VOX",446
5,"5132",857,548,539,7,9,"VOX",103
9,"9151",446,352,346,3,6,"VOX",36
42,"42028",75,57,56,0,1,"VOX",10
40,"40108",109,85,85,2,0,"VOX",12
28,"28110",2029,1498,1478,9,20,"VOX",339
18,"18078",714,546,538,5,8,"VOX",87
45,"45021",2639,1798,1755,22,43,"VOX",471
37,"37107",10444,6997,6884,76,113,"VOX",1162
10,"10114",964,644,637,6,7,"VOX",61
46,"46022",15392,10624,10546,69,78,"VOX",1904
8,"8175",3369,2388,2372,18,16,"VOX",65
17,"17056",1780,1379,1374,13,5,"VOX",36
3,"3084",501,413,413,1,0,"VOX",52
22,"22245",303,222,213,3,9,"VOX",29
34,"34133",101,75,73,0,2,"VOX",11
28,"28035",1404,981,966,4,15,"VOX",237
18,"18079",3466,2391,2333,22,58,"VOX",287
21,"21021",12545,7816,7696,104,120,"VOX",2744
3,"3085",271,229,227,5,2,"VOX",24
47,"47204",235,159,157,3,2,"VOX",47
19,"19168",265,182,175,4,7,"VOX",15
22,"22246",63,43,43,0,0,"VOX",2
34,"34134",44,25,25,0,0,"VOX",3
28,"28036",2699,1977,1957,20,20,"VOX",602
10,"10116",3737,2579,2507,34,72,"VOX",403
49,"49149",368,270,266,1,4,"VOX",57
37,"37109",178,127,126,0,1,"VOX",24
43,"43125",884,658,645,12,13,"VOX",15
49,"49150",123,95,92,3,3,"VOX",9
48,"48059",402,299,297,0,2,"VOX",1
24,"24197",717,500,499,2,1,"VOX",129
34,"34135",398,267,264,4,3,"VOX",56
47,"47206",79,66,66,0,0,"VOX",6
31,"31245",76,51,48,2,3,"VOX",0
3,"3086",169,140,140,2,0,"VOX",18
18,"18082",810,503,500,3,3,"VOX",97
8,"8176",158,119,119,0,0,"VOX",7
44,"44198",182,138,135,0,3,"VOX",27
34,"34136",143,89,89,1,0,"VOX",9
16,"16123",66,42,41,0,1,"VOX",10
5,"5135",399,294,292,2,2,"VOX",73
22,"22247",28,18,18,0,0,"VOX",1
8,"8177",36,27,27,1,0,"VOX",2
18,"18083",232,181,179,1,2,"VOX",42
12,"12128",1365,990,972,16,18,"VOX",195
28,"28038",5213,3801,3753,24,48,"VOX",714
19,"19170",189,115,115,1,0,"VOX",17
49,"49151",591,389,388,3,1,"VOX",58
17,"17060",409,300,298,1,2,"VOX",22
5,"5136",83,55,55,0,0,"VOX",3
47,"47207",256,198,195,3,3,"VOX",46
3,"3088",5895,4030,3961,29,69,"VOX",1062
7,"7039",5019,3066,3017,23,49,"VOX",664
34,"34137",24,19,19,2,0,"VOX",1
22,"22248",103,73,73,0,0,"VOX",8
44,"44199",39,37,37,2,0,"VOX",4
3,"3089",9496,6617,6484,51,133,"VOX",1147
19,"19171",5380,3964,3919,22,45,"VOX",901
28,"28039",134,93,93,1,0,"VOX",14
12,"12129",1783,1207,1184,16,23,"VOX",76
25,"25249",176,129,127,2,2,"VOX",5
18,"18084",4533,3233,3178,35,55,"VOX",807
34,"34139",160,117,115,2,2,"VOX",21
37,"37113",404,286,285,13,1,"VOX",33
40,"40112",2813,2126,2087,26,39,"VOX",394
47,"47208",53,35,35,1,0,"VOX",3
24,"24201",1029,683,676,9,7,"VOX",146
9,"9163",573,436,432,7,4,"VOX",70
8,"8178",444,363,361,2,2,"VOX",17
40,"40113",404,308,304,2,4,"VOX",47
3,"3090",18095,12539,12412,75,127,"VOX",2340
47,"47209",32,23,23,0,0,"VOX",3
43,"43128",910,665,658,6,7,"VOX",28
34,"34140",93,57,57,1,0,"VOX",12
8,"8179",636,466,465,2,1,"VOX",26
19,"19172",51,38,38,0,0,"VOX",7
44,"44201",477,399,395,1,4,"VOX",36
35,"35019",32830,18390,18243,87,147,"VOX",2756
18,"18085",690,440,432,1,8,"VOX",95
49,"49154",111,63,59,0,4,"VOX",6
34,"34141",176,149,146,0,3,"VOX",27
31,"31250",2761,1776,1759,13,17,"VOX",20
3,"3091",244,194,193,2,1,"VOX",16
46,"46095",580,445,438,5,7,"VOX",103
20,"20024",395,245,245,4,0,"VOX",3
12,"12131",97,87,87,0,0,"VOX",11
18,"18086",338,253,247,1,6,"VOX",10
31,"31031",212,134,132,2,2,"VOX",3
28,"28041",4805,3666,3634,38,32,"VOX",910
46,"46027",924,746,737,2,9,"VOX",190
47,"47210",399,278,275,3,3,"VOX",69
12,"12132",477,391,385,3,6,"VOX",64
35,"35020",5941,3740,3702,27,38,"VOX",283
42,"42037",28,13,13,2,0,"VOX",0
47,"47211",48,37,37,1,0,"VOX",13
34,"34143",161,115,112,2,3,"VOX",19
34,"34146",53,43,43,0,0,"VOX",4
24,"24205",990,678,667,6,11,"VOX",116
3,"3092",6712,4924,4858,35,66,"VOX",722
19,"19174",90,65,64,0,1,"VOX",10
28,"28042",1261,918,908,9,10,"VOX",241
8,"8180",27198,19822,19704,160,118,"VOX",1785
28,"28043",6190,4031,3969,33,62,"VOX",1279
22,"22251",327,259,256,0,3,"VOX",40
31,"31253",121,100,100,0,0,"VOX",0
44,"44204",27,18,18,0,0,"VOX",4
47,"47212",356,289,287,4,2,"VOX",91
18,"18087",182877,131811,130184,1106,1627,"VOX",25428
34,"34147",164,120,120,1,0,"VOX",31
40,"40119",166,133,132,2,1,"VOX",37
9,"9169",97,72,70,1,2,"VOX",7
8,"8181",8133,5949,5924,31,25,"VOX",352
3,"3093",19702,13903,13728,113,175,"VOX",2626
7,"7045",1317,931,928,8,3,"VOX",86
12,"12133",59,46,45,0,1,"VOX",13
43,"43131",4827,3134,3116,32,18,"VOX",330
22,"22252",118,95,91,1,4,"VOX",18
47,"47213",104,78,78,0,0,"VOX",9
3,"3094",9795,6528,6481,37,47,"VOX",1345
20,"20027",2761,1866,1861,10,5,"VOX",7
44,"44205",619,420,415,5,5,"VOX",59
8,"8182",2922,2041,2031,10,10,"VOX",268
22,"22253",56,40,40,1,0,"VOX",2
18,"18088",1526,1000,993,10,7,"VOX",64
25,"25254",704,511,508,2,3,"VOX",11
42,"42041",31,23,23,0,0,"VOX",3
28,"28045",35523,26213,25966,212,247,"VOX",5407
9,"9335",86,66,66,3,0,"VOX",5
21,"21031",1166,773,736,11,37,"VOX",119
34,"34151",148,98,96,1,2,"VOX",8
24,"24209",2597,1651,1636,12,15,"VOX",139
31,"31255",103,79,79,0,0,"VOX",2
3,"3095",4807,3453,3410,31,43,"VOX",422
49,"49159",269,182,182,2,0,"VOX",19
17,"17066",27378,16755,16644,122,111,"VOX",1497
7,"7047",2399,1504,1477,20,27,"VOX",253
47,"47214",1349,1036,1019,5,17,"VOX",125
9,"9173",123,96,93,2,3,"VOX",26
18,"18089",14504,9854,9746,100,108,"VOX",2121
28,"28046",4824,3726,3707,33,19,"VOX",829
44,"44206",100,73,73,3,0,"VOX",16
40,"40121",249,188,178,1,10,"VOX",33
34,"34152",124,99,94,0,5,"VOX",10
38,"38014",1342,943,930,6,13,"VOX",72
50,"50151",607,450,449,12,1,"VOX",82
10,"10129",340,234,227,2,7,"VOX",33
3,"3096",5786,4355,4281,38,74,"VOX",728
44,"44207",125,98,97,2,1,"VOX",8
24,"24210",524,353,353,1,0,"VOX",50
31,"31257",915,654,642,9,12,"VOX",17
18,"18093",2751,1693,1674,18,19,"VOX",410
47,"47215",48,43,43,0,0,"VOX",2
31,"31038",1343,975,963,16,12,"VOX",56
22,"22901",714,433,423,6,10,"VOX",35
18,"18094",2299,1712,1652,20,60,"VOX",253
19,"19269",86,61,61,0,0,"VOX",5
45,"45146",101,79,79,0,0,"VOX",16
12,"12136",2603,2151,2119,20,32,"VOX",513
47,"47216",111,94,91,0,3,"VOX",50
3,"3097",1014,778,764,5,14,"VOX",80
31,"31258",7879,5668,5631,50,37,"VOX",129
22,"22902",206,147,144,1,3,"VOX",23
24,"24212",983,693,684,10,9,"VOX",70
42,"42045",273,175,174,4,1,"VOX",31
49,"49163",203,139,138,3,1,"VOX",35
34,"34155",122,95,95,0,0,"VOX",7
28,"28048",514,386,384,4,2,"VOX",67
25,"25902",536,406,403,1,3,"VOX",17
18,"18095",2054,1475,1433,14,42,"VOX",325
46,"46032",5719,4297,4262,35,35,"VOX",678
5,"5148",22,19,19,0,0,"VOX",6
8,"8185",197,162,162,1,0,"VOX",11
3,"3098",523,382,378,1,4,"VOX",63
44,"44209",799,584,573,2,11,"VOX",64
34,"34156",51,42,42,0,0,"VOX",4
20,"20032",8654,6000,5972,21,28,"VOX",83
21,"21035",9766,6114,5998,92,116,"VOX",791
38,"38017",30964,16228,16102,108,126,"VOX",2659
4,"4051",404,323,319,2,4,"VOX",59
12,"12137",40,28,28,0,0,"VOX",0
50,"50153",914,683,675,9,8,"VOX",106
40,"40124",234,169,164,0,5,"VOX",26
18,"18096",340,227,226,0,1,"VOX",35
37,"37123",159,124,123,2,1,"VOX",28
22,"22903",618,484,482,5,2,"VOX",57
34,"34157",2353,1697,1669,18,28,"VOX",308
3,"3099",43101,30222,29885,196,337,"VOX",7320
34,"34158",283,170,167,0,3,"VOX",19
12,"12138",19207,13018,12891,87,127,"VOX",1953
8,"8187",153822,113081,112470,758,611,"VOX",7672
47,"47219",39,31,28,1,3,"VOX",7
44,"44210",750,577,572,2,5,"VOX",65
9,"9347",140,111,107,1,4,"VOX",6
16,"16025",24,20,20,0,0,"VOX",2
42,"42185",24,20,20,0,0,"VOX",1
37,"37312",244,191,189,1,2,"VOX",41
24,"24215",149,116,115,0,1,"VOX",30
22,"22904",751,516,511,3,5,"VOX",93
37,"37124",195,137,137,2,0,"VOX",27
43,"43137",1890,1373,1353,8,20,"VOX",114
9,"9180",132,94,91,1,3,"VOX",16
28,"28051",1644,1231,1220,9,11,"VOX",311
34,"34159",375,221,214,4,7,"VOX",15
16,"16026",91,69,68,0,1,"VOX",16
38,"38018",4466,2867,2821,21,46,"VOX",294
8,"8049",1309,910,903,3,7,"VOX",15
12,"12139",299,202,200,3,2,"VOX",39
3,"3100",499,384,378,0,6,"VOX",16
40,"40127",36,25,23,0,2,"VOX",3
3,"3101",4933,3502,3462,16,40,"VOX",361
47,"47220",151,106,105,1,1,"VOX",17
8,"8188",115,89,89,0,0,"VOX",3
22,"22905",287,217,217,1,0,"VOX",43
23,"23903",3498,2633,2601,28,32,"VOX",498
24,"24216",666,453,445,4,8,"VOX",72
38,"38019",13884,7888,7809,49,79,"VOX",1102
47,"47221",97,85,84,1,1,"VOX",13
18,"18098",5959,3816,3749,33,67,"VOX",664
22,"22906",177,123,122,6,1,"VOX",10
28,"28052",3961,2700,2659,14,41,"VOX",853
42,"42052",16,14,14,0,0,"VOX",4
28,"28053",6956,5475,5414,44,61,"VOX",1355
49,"49168",89,68,68,0,0,"VOX",12
34,"34161",22,12,12,0,0,"VOX",5
44,"44212",41,29,29,0,0,"VOX",5
37,"37126",30,25,25,0,0,"VOX",4
3,"3102",7181,5126,5073,36,53,"VOX",678
49,"49169",38,33,32,0,1,"VOX",1
30,"30002",9701,6794,6717,27,77,"VOX",2291
19,"19185",26,15,15,1,0,"VOX",1
18,"18099",1582,1184,1156,13,28,"VOX",194
22,"22907",1463,1016,1006,21,10,"VOX",132
47,"47222",85,70,70,1,0,"VOX",25
44,"44213",68,47,47,0,0,"VOX",6
9,"9184",6,6,6,0,0,"VOX",0
34,"34163",46,37,37,0,0,"VOX",3
28,"28054",11943,8800,8731,72,69,"VOX",1960
10,"10140",1109,778,769,7,9,"VOX",214
5,"5154",31,23,23,0,0,"VOX",5
3,"3103",238,196,194,2,2,"VOX",27
47,"47223",148,105,102,4,3,"VOX",26
34,"34165",57,45,44,1,1,"VOX",6
9,"9189",123,83,78,0,5,"VOX",8
4,"4057",1261,886,872,6,14,"VOX",198
30,"30003",25200,16249,16120,159,129,"VOX",3946
8,"8259",6979,5362,5341,27,21,"VOX",212
16,"16030",24,18,18,1,0,"VOX",2
19,"19187",42,32,32,0,0,"VOX",3
38,"38021",1609,900,876,2,24,"VOX",70
28,"28055",944,636,627,4,9,"VOX",146
47,"47224",93,75,75,1,0,"VOX",19
9,"9190",86,58,54,2,4,"VOX",6
9,"9032",103,62,62,3,0,"VOX",8
24,"24221",738,492,485,9,7,"VOX",124
34,"34167",110,84,83,0,1,"VOX",32
22,"22908",190,135,134,0,1,"VOX",21
34,"34168",45,39,39,1,0,"VOX",7
3,"3104",27072,19732,19477,218,255,"VOX",3413
38,"38022",18630,11420,11284,87,136,"VOX",1310
22,"22909",307,219,217,0,2,"VOX",39
25,"25908",217,136,136,0,0,"VOX",6
43,"43142",1069,783,774,3,9,"VOX",26
45,"45047",2694,1733,1706,24,27,"VOX",604
12,"12901",3339,2583,2561,25,22,"VOX",479
18,"18101",9449,6688,6568,77,120,"VOX",1405
31,"31904",1559,989,972,11,17,"VOX",38
18,"18102",8233,5424,5266,46,158,"VOX",639
44,"44216",27003,19997,19909,80,88,"VOX",2324
42,"42056",28,25,24,0,1,"VOX",3
40,"40131",51,45,45,0,0,"VOX",9
34,"34169",371,263,259,5,4,"VOX",42
47,"47225",73,61,59,1,2,"VOX",14
30,"30005",30268,20979,20778,148,201,"VOX",6120
3,"3105",5510,3879,3792,27,87,"VOX",979
3,"3106",559,469,465,3,4,"VOX",46
40,"40132",45,26,25,0,1,"VOX",2
49,"49173",335,165,163,4,2,"VOX",13
23,"23001",912,723,712,2,11,"VOX",111
47,"47226",148,115,115,1,0,"VOX",13
28,"28057",1556,1155,1141,7,14,"VOX",323
34,"34170",50,30,30,1,0,"VOX",6
42,"42195",86,51,51,2,0,"VOX",2
30,"30006",833,699,695,1,4,"VOX",84
28,"28058",141836,104142,103011,896,1131,"VOX",20559
16,"16034",155,116,113,0,3,"VOX",15
49,"49174",127,86,85,1,1,"VOX",16
8,"8193",988,739,737,10,2,"VOX",28
3,"3107",2785,1766,1746,13,20,"VOX",309
21,"21044",18061,11170,11003,123,167,"VOX",3319
40,"40134",692,522,509,10,13,"VOX",70
47,"47227",53,36,35,0,1,"VOX",9
18,"18103",714,500,498,3,2,"VOX",114
34,"34171",928,572,562,2,10,"VOX",100
19,"19190",2284,1632,1613,16,19,"VOX",179
9,"9195",57,40,40,0,0,"VOX",5
50,"50009",97,61,61,1,0,"VOX",14
28,"28059",4516,3343,3299,30,44,"VOX",855
44,"44218",28,24,24,3,0,"VOX",1
5,"5159",224,133,132,3,1,"VOX",26
49,"49175",204,136,135,3,1,"VOX",27
50,"50162",135,100,99,3,1,"VOX",10
24,"24006",488,356,347,4,9,"VOX",63
30,"30007",6474,4354,4317,26,37,"VOX",1425
3,"3109",3003,2186,2151,14,35,"VOX",446
34,"34174",172,142,136,0,6,"VOX",10
47,"47228",432,324,320,2,4,"VOX",82
18,"18105",3827,2436,2392,22,44,"VOX",472
23,"23004",407,321,315,2,6,"VOX",75
9,"9197",144,105,103,2,2,"VOX",22
47,"47229",221,150,149,0,1,"VOX",25
40,"40135",277,212,210,3,2,"VOX",42
16,"16036",120,94,93,0,1,"VOX",10
40,"40136",102,79,77,3,2,"VOX",10
34,"34175",87,67,66,1,1,"VOX",15
24,"24227",1527,1036,1032,13,4,"VOX",237
44,"44220",113,82,82,1,0,"VOX",14
34,"34176",127,95,90,3,5,"VOX",24
18,"18106",413,270,261,3,9,"VOX",63
8,"8195",75,62,62,0,0,"VOX",1
3,"3110",312,258,258,0,0,"VOX",37
25,"25913",88,72,72,1,0,"VOX",1
21,"21047",1878,1144,1112,12,32,"VOX",169
43,"43146",40,32,32,0,0,"VOX",1
42,"42062",20,10,10,0,0,"VOX",0
5,"5162",76,47,45,1,2,"VOX",4
13,"13005",23256,16610,16367,132,243,"VOX",2852
49,"49178",748,520,505,7,15,"VOX",136
3,"3111",5579,3777,3737,23,40,"VOX",940
40,"40138",2102,1585,1565,13,20,"VOX",293
50,"50164",381,245,243,3,2,"VOX",56
47,"47230",285,209,206,1,3,"VOX",38
46,"46111",11367,7995,7908,66,87,"VOX",1882
24,"24228",619,370,364,2,6,"VOX",63
18,"18107",920,643,626,1,17,"VOX",128
34,"34177",178,149,149,1,0,"VOX",16
44,"44221",386,307,304,1,3,"VOX",35
5,"5163",1702,1258,1233,5,25,"VOX",165
19,"19193",22,21,21,1,0,"VOX",1
16,"16154",4739,3416,3379,33,37,"VOX",652
7,"7901",598,410,402,6,8,"VOX",75
13,"13007",1219,871,852,4,19,"VOX",88
49,"49179",337,210,209,3,1,"VOX",24
8,"8196",19542,14264,14185,123,79,"VOX",1486
3,"3112",650,503,497,3,6,"VOX",63
47,"47232",96,67,65,0,2,"VOX",18
18,"18108",822,604,599,2,5,"VOX",108
32,"32004",1608,835,824,5,11,"VOX",83
8,"8197",7986,5829,5805,37,24,"VOX",389
16,"16041",334,244,243,2,1,"VOX",59
28,"28063",252,188,187,1,1,"VOX",33
40,"40139",255,194,192,2,2,"VOX",21
37,"37137",98,60,59,2,1,"VOX",8
43,"43148",91182,65076,64756,441,320,"VOX",6583
34,"34179",25,18,16,0,2,"VOX",1
13,"13009",1383,1081,1070,3,11,"VOX",298
18,"18109",597,430,422,5,8,"VOX",68
48,"48001",5899,4094,4074,19,20,"VOX",85
28,"28064",125,98,95,3,3,"VOX",30
19,"19195",36,26,25,2,1,"VOX",3
3,"3113",4339,2978,2935,23,43,"VOX",664
46,"46044",4159,3062,2997,26,65,"VOX",417
46,"46249",9136,6538,6439,73,99,"VOX",1289
50,"50087",28,19,19,0,0,"VOX",4
34,"34180",68,54,54,1,0,"VOX",2
40,"40141",822,584,568,9,16,"VOX",115
19,"19196",89,70,67,1,3,"VOX",18
49,"49181",333,197,195,2,2,"VOX",22
23,"23009",12849,9722,9572,99,150,"VOX",2420
44,"44224",21,14,14,2,0,"VOX",2
8,"8198",4679,3491,3469,12,22,"VOX",157
34,"34181",422,289,285,0,4,"VOX",37
24,"24902",331,239,239,0,0,"VOX",39
48,"48002",7791,5510,5471,42,39,"VOX",96
49,"49183",90,67,65,2,2,"VOX",18
13,"13012",381,265,261,1,4,"VOX",30
28,"28065",131232,100864,99883,846,981,"VOX",16577
18,"18111",2863,2038,2001,29,37,"VOX",497
14,"14029",4001,2855,2821,30,34,"VOX",426
46,"46045",1245,984,961,3,23,"VOX",138
17,"17001",575,428,426,4,2,"VOX",17
26,"26005",2483,1589,1570,13,19,"VOX",187
9,"9209",4404,2997,2950,31,47,"VOX",542
18,"18112",104,68,66,2,2,"VOX",17
21,"21052",4403,2688,2631,26,57,"VOX",236
23,"23011",2138,1536,1507,17,29,"VOX",197
37,"37140",630,395,393,0,2,"VOX",102
8,"8199",648,509,508,3,1,"VOX",12
48,"48003",14518,10375,10310,49,65,"VOX",117
19,"19197",28,22,22,1,0,"VOX",0
40,"40142",52,39,37,0,2,"VOX",5
3,"3115",255,213,213,3,0,"VOX",28
50,"50168",29,20,20,0,0,"VOX",3
13,"13014",472,361,352,4,9,"VOX",38
34,"34184",49,37,35,0,2,"VOX",2
30,"30013",7421,5171,5094,32,77,"VOX",1128
49,"49185",156,120,116,0,4,"VOX",20
9,"9213",264,182,182,1,0,"VOX",30
18,"18914",1660,1255,1227,11,28,"VOX",140
18,"18114",585,425,424,7,1,"VOX",81
48,"48004",326,245,245,1,0,"VOX",0
40,"40143",82,68,67,2,1,"VOX",8
34,"34185",69,36,35,0,1,"VOX",7
37,"37141",149,101,100,0,1,"VOX",7
3,"3116",1155,819,805,5,14,"VOX",147
5,"5168",3503,2536,2511,29,25,"VOX",515
25,"25002",465,324,323,4,1,"VOX",9
44,"44226",123,85,84,0,1,"VOX",8
15,"15042",2928,1879,1853,11,26,"VOX",160
18,"18115",2635,1766,1738,13,28,"VOX",276
46,"46047",540,428,420,1,8,"VOX",43
19,"19199",19,15,15,0,0,"VOX",3
38,"38032",13579,8941,8880,92,61,"VOX",1407
34,"34186",49,44,44,0,0,"VOX",11
23,"23014",2535,1890,1861,28,29,"VOX",290
48,"48005",116,80,79,0,1,"VOX",2
13,"13017",240,178,176,0,2,"VOX",34
3,"3117",377,306,302,2,4,"VOX",42
19,"19200",66,53,52,0,1,"VOX",13
40,"40145",1098,824,820,4,4,"VOX",156
32,"32011",916,512,507,3,5,"VOX",26
8,"8004",208,177,177,1,0,"VOX",0
34,"34189",53,33,33,0,0,"VOX",1
23,"23015",1316,979,973,18,6,"VOX",124
6,"6129",577,438,416,1,22,"VOX",33
17,"17087",219,179,177,0,2,"VOX",2
25,"25004",582,437,432,3,5,"VOX",26
18,"18116",2856,2027,1979,13,48,"VOX",314
48,"48006",307,242,240,3,2,"VOX",0
34,"34190",50,33,33,1,0,"VOX",3
3,"3118",2446,1617,1598,8,19,"VOX",460
18,"18916",1815,1093,1086,6,7,"VOX",238
23,"23016",386,313,305,4,8,"VOX",47
43,"43154",126,104,104,0,0,"VOX",2
32,"32012",708,448,440,2,8,"VOX",37
42,"42078",1000,653,640,5,13,"VOX",64
13,"13019",5101,3502,3468,33,34,"VOX",635
28,"28070",105,80,80,3,0,"VOX",22
9,"9217",342,240,237,1,3,"VOX",29
44,"44229",141,99,98,1,1,"VOX",17
48,"48007",389,243,243,0,0,"VOX",2
23,"23017",1498,1153,1129,11,24,"VOX",120
13,"13020",4701,3114,3069,42,45,"VOX",602
3,"3119",17253,12346,12258,81,88,"VOX",2132
18,"18117",497,360,354,1,6,"VOX",40
34,"34192",76,59,59,0,0,"VOX",16
19,"19202",16,13,13,1,0,"VOX",1
8,"8203",2466,1678,1675,7,3,"VOX",90
3,"3120",2433,1688,1652,13,36,"VOX",344
43,"43155",22586,15295,15204,120,91,"VOX",722
25,"25005",269,193,193,3,0,"VOX",1
37,"37145",236,173,170,3,3,"VOX",28
18,"18119",1708,1264,1240,7,24,"VOX",244
32,"32014",1028,719,708,6,11,"VOX",50
34,"34196",87,67,67,3,0,"VOX",5
13,"13022",348,244,239,1,5,"VOX",38
23,"23018",2243,1606,1584,17,22,"VOX",208
48,"48008",609,415,407,4,8,"VOX",4
28,"28072",6176,4716,4673,44,43,"VOX",1024
46,"46050",185,141,141,1,0,"VOX",19
3,"3121",21997,14689,14572,103,117,"VOX",3249
43,"43156",3956,2812,2784,22,28,"VOX",215
8,"8204",3141,2395,2383,16,12,"VOX",126
34,"34199",1150,767,754,14,13,"VOX",105
38,"38036",6857,4170,4090,37,80,"VOX",370
23,"23019",1466,1117,1090,5,27,"VOX",193
40,"40149",479,345,338,3,7,"VOX",48
13,"13023",8944,6251,6165,50,86,"VOX",2073
49,"49191",265,192,188,2,4,"VOX",9
50,"50173",156,114,114,0,0,"VOX",26
37,"37147",184,126,124,1,2,"VOX",17
28,"28073",12707,9198,9080,94,118,"VOX",2347
18,"18120",266,204,204,4,0,"VOX",19
48,"48009",774,585,578,0,7,"VOX",2
3,"3122",43774,30060,29834,230,226,"VOX",6224
45,"45068",179,129,127,0,2,"VOX",16
40,"40150",60,42,42,0,0,"VOX",3
23,"23020",1510,1263,1253,16,10,"VOX",124
30,"30019",25911,17485,17264,157,221,"VOX",4920
48,"48010",476,343,343,1,0,"VOX",0
13,"13025",290,233,231,0,2,"VOX",28
34,"34202",28,23,23,2,0,"VOX",4
8,"8008",175,136,136,2,0,"VOX",8
40,"40151",43,31,31,0,0,"VOX",3
49,"49193",428,261,253,3,8,"VOX",60
8,"8205",61957,49325,49196,441,129,"VOX",2742
3,"3123",7579,5491,5416,50,75,"VOX",1203
26,"26016",28,20,18,0,2,"VOX",0
18,"18121",119,79,79,1,0,"VOX",8
23,"23021",512,406,399,2,7,"VOX",59
46,"46052",515,423,419,4,4,"VOX",61
44,"44232",364,255,255,3,0,"VOX",30
34,"34204",50,35,35,0,0,"VOX",0
5,"5176",221,163,159,0,4,"VOX",22
8,"8206",744,604,599,5,5,"VOX",10
9,"9225",80,55,55,0,0,"VOX",0
19,"19209",40,30,29,0,1,"VOX",9
28,"28075",6020,4521,4469,37,52,"VOX",1131
48,"48011",9640,6753,6722,41,31,"VOX",128
18,"18122",15994,11009,10773,109,236,"VOX",2278
28,"28153",816,547,544,3,3,"VOX",93
34,"34205",55,38,38,0,0,"VOX",4
44,"44234",71,49,49,0,0,"VOX",5
17,"17093",913,637,634,5,3,"VOX",15
9,"9226",54,45,45,2,0,"VOX",5
28,"28076",432,330,327,4,3,"VOX",66
40,"40152",732,575,565,10,10,"VOX",103
10,"10169",497,370,366,0,4,"VOX",41
10,"10047",938,710,694,1,16,"VOX",82
34,"34206",810,608,602,5,6,"VOX",87
50,"50023",199,145,143,2,2,"VOX",11
44,"44235",87,65,64,1,1,"VOX",6
3,"3125",332,226,226,2,0,"VOX",39
48,"48012",2057,1610,1600,1,10,"VOX",10
23,"23025",2725,1894,1870,11,24,"VOX",436
18,"18123",284,202,200,5,2,"VOX",36
49,"49199",236,159,157,3,2,"VOX",21
13,"13029",89,67,65,0,2,"VOX",17
19,"19210",18,16,16,0,0,"VOX",0
18,"18124",355,232,231,1,1,"VOX",68
38,"38039",11149,7375,7326,68,49,"VOX",1206
50,"50177",288,196,193,0,3,"VOX",35
16,"16057",62,45,45,0,0,"VOX",11
48,"48013",79353,53591,53205,331,386,"VOX",1561
44,"44236",60,38,38,0,0,"VOX",2
34,"34208",48,40,40,1,0,"VOX",13
3,"3127",350,260,255,1,5,"VOX",34
19,"19211",350,272,269,0,3,"VOX",47
25,"25011",5271,3529,3505,21,24,"VOX",197
9,"9228",155,129,129,0,0,"VOX",13
37,"37152",400,268,261,4,7,"VOX",57
8,"8208",5793,4267,4244,21,23,"VOX",292
34,"34210",98,82,82,1,0,"VOX",11
18,"18126",1436,1024,1002,9,22,"VOX",128
8,"8011",1739,1360,1353,10,7,"VOX",12
10,"10173",558,389,385,5,4,"VOX",117
42,"42088",62,45,44,0,1,"VOX",5
48,"48014",1229,845,843,8,2,"VOX",6
3,"3128",4285,2849,2819,18,30,"VOX",569
46,"46055",1298,992,977,9,15,"VOX",163
44,"44237",367,267,262,0,5,"VOX",30
8,"8012",1726,1323,1309,17,14,"VOX",31
23,"23028",6103,4369,4286,26,83,"VOX",747
34,"34211",171,154,153,2,1,"VOX",31
13,"13033",1544,1231,1196,5,35,"VOX",246
19,"19212",678,501,491,1,10,"VOX",118
18,"18127",17005,11790,11583,150,207,"VOX",2402
48,"48015",33077,22441,22295,145,146,"VOX",504
34,"34213",53,46,46,0,0,"VOX",8
49,"49202",173,103,101,0,2,"VOX",18
40,"40157",39,30,30,0,0,"VOX",6
3,"3129",1224,934,923,4,11,"VOX",194
25,"25103",133,88,87,0,1,"VOX",3
44,"44238",2278,1630,1620,3,10,"VOX",105
46,"46056",176,142,142,0,0,"VOX",19
42,"42090",83,65,64,1,1,"VOX",3
34,"34214",176,121,120,1,1,"VOX",22
4,"4086",1631,1128,1114,3,14,"VOX",216
19,"19213",67,53,52,1,1,"VOX",9
18,"18128",332,263,260,1,3,"VOX",41
23,"23030",1207,998,977,7,21,"VOX",79
25,"25013",2099,1430,1414,13,16,"VOX",69
48,"48016",5471,3964,3935,31,29,"VOX",99
5,"5181",46,34,34,0,0,"VOX",9
16,"16062",25,20,20,0,0,"VOX",0
26,"26024",204,157,156,1,1,"VOX",20
19,"19214",74,51,51,0,0,"VOX",13
34,"34215",161,126,125,6,1,"VOX",14
48,"48017",13121,8929,8886,45,43,"VOX",43
40,"40158",15,11,11,0,0,"VOX",1
10,"10177",1702,1241,1186,10,55,"VOX",188
37,"37054",233,190,186,2,4,"VOX",18
3,"3131",176,129,126,1,3,"VOX",14
30,"30026",16345,10049,9914,84,135,"VOX",3137
42,"42093",36,28,28,1,0,"VOX",6
17,"17098",308,232,230,4,2,"VOX",9
23,"23031",764,660,640,6,20,"VOX",53
37,"37157",76,64,63,1,1,"VOX",7
21,"21068",973,562,556,11,6,"VOX",117
18,"18132",3101,2418,2382,23,36,"VOX",233
19,"19215",135,109,109,0,0,"VOX",27
40,"40159",130,94,93,2,1,"VOX",21
49,"49205",359,252,251,7,1,"VOX",42
34,"34216",61,41,41,0,0,"VOX",8
23,"23032",529,427,419,5,8,"VOX",35
44,"44240",151,119,117,0,2,"VOX",8
25,"25105",105,88,87,4,1,"VOX",5
13,"13038",1589,1162,1136,21,26,"VOX",138
37,"37158",230,149,149,1,0,"VOX",16
3,"3132",512,376,373,2,3,"VOX",48
8,"8212",491,393,386,6,7,"VOX",7
10,"10179",272,209,209,2,0,"VOX",24
18,"18133",2101,1496,1477,6,19,"VOX",294
34,"34217",1269,999,983,14,16,"VOX",230
42,"42095",1909,1345,1326,32,19,"VOX",285
23,"23033",1325,1008,989,11,19,"VOX",247
9,"9239",47,31,31,0,0,"VOX",3
25,"25016",2083,1404,1399,3,5,"VOX",36
26,"26027",139,99,97,0,2,"VOX",2
3,"3133",41333,24527,24340,146,187,"VOX",5298
48,"48019",3429,2424,2411,14,13,"VOX",43
8,"8016",1803,1371,1363,11,8,"VOX",38
13,"13040",839,639,623,7,16,"VOX",114
34,"34218",437,313,309,3,4,"VOX",94
25,"25017",228,175,174,0,1,"VOX",1
19,"19217",43,36,36,0,0,"VOX",5
48,"48020",272771,184893,183922,1227,971,"VOX",5598
18,"18134",6104,4049,3972,39,77,"VOX",972
49,"49207",215,144,143,1,1,"VOX",18
9,"9242",66,53,52,3,1,"VOX",8
23,"23034",2480,1923,1882,15,41,"VOX",382
44,"44243",25,19,19,0,0,"VOX",3
34,"34220",152,133,132,1,1,"VOX",23
43,"43167",391,307,307,2,0,"VOX",14
37,"37160",597,380,370,3,10,"VOX",69
46,"46060",9278,6796,6724,49,72,"VOX",1306
49,"49208",352,223,214,1,9,"VOX",26
13,"13042",880,638,626,2,12,"VOX",181
9,"9411",153,105,104,0,1,"VOX",23
9,"9243",73,50,49,1,1,"VOX",5
48,"48021",1325,891,888,3,3,"VOX",4
34,"34221",168,129,127,2,2,"VOX",15
3,"3134",139,107,107,0,0,"VOX",13
13,"13043",205,163,162,1,1,"VOX",20
16,"16068",125,88,88,3,0,"VOX",14
42,"42098",8,7,7,0,0,"VOX",0
25,"25019",4606,2860,2829,19,31,"VOX",138
18,"18136",1778,1320,1284,14,36,"VOX",109
13,"13044",2582,1838,1804,13,34,"VOX",474
34,"34222",107,71,68,1,3,"VOX",10
23,"23037",518,403,398,10,5,"VOX",64
40,"40163",42,35,35,1,0,"VOX",2
5,"5187",1714,1247,1221,9,26,"VOX",214
32,"32033",667,439,436,4,3,"VOX",43
3,"3135",195,134,131,1,3,"VOX",4
48,"48022",2305,1434,1425,11,9,"VOX",28
16,"16070",29,27,27,0,0,"VOX",4
8,"8215",2617,1954,1946,22,8,"VOX",60
49,"49210",447,350,348,3,2,"VOX",68
6,"6019",2010,1367,1330,23,37,"VOX",156
34,"34223",203,147,143,1,4,"VOX",30
48,"48023",579,451,448,0,3,"VOX",4
9,"9246",599,381,372,2,9,"VOX",72
40,"40164",186,131,130,0,1,"VOX",24
13,"13046",686,524,521,6,3,"VOX",73
23,"23039",2170,1502,1460,10,42,"VOX",180
3,"3136",399,302,301,3,1,"VOX",26
16,"16071",20,16,16,0,0,"VOX",4
21,"21074",2736,1826,1790,19,36,"VOX",302
25,"25021",2513,1668,1662,17,6,"VOX",33
34,"34224",39,25,25,0,0,"VOX",2
44,"44246",1599,1012,1001,11,11,"VOX",83
18,"18137",968,733,731,3,2,"VOX",183
3,"3137",654,449,443,7,6,"VOX",37
23,"23040",1438,1175,1159,3,16,"VOX",107
40,"40165",73,53,52,0,1,"VOX",15
19,"19221",31,22,22,1,0,"VOX",2
8,"8216",25,17,17,0,0,"VOX",0
5,"5190",53,44,43,0,1,"VOX",17
48,"48024",1000,761,752,1,9,"VOX",2
34,"34225",5016,3708,3650,41,58,"VOX",525
19,"19222",95,70,70,2,0,"VOX",14
44,"44247",291,207,206,4,1,"VOX",17
38,"38049",2690,1406,1389,27,17,"VOX",146
18,"18138",2470,1597,1573,25,24,"VOX",271
3,"3138",3190,2244,2207,9,37,"VOX",475
32,"32036",1242,856,838,14,18,"VOX",54
34,"34227",70,56,52,1,4,"VOX",9
18,"18140",42474,26967,26648,225,319,"VOX",5680
26,"26034",606,457,440,5,17,"VOX",25
40,"40166",251,201,201,0,0,"VOX",18
49,"49219",7196,4613,4528,64,85,"VOX",853
16,"16074",30,25,25,0,0,"VOX",2
13,"13050",475,348,345,1,3,"VOX",102
48,"48025",874,667,662,2,5,"VOX",3
25,"25023",4560,3350,3334,24,16,"VOX",199
8,"8218",8091,5899,5869,50,30,"VOX",402
3,"3139",23126,14650,14522,127,128,"VOX",2675
9,"9251",362,258,256,3,2,"VOX",47
34,"34228",77,59,59,1,0,"VOX",8
48,"48026",1132,834,832,2,2,"VOX",6
19,"19223",99,66,65,1,1,"VOX",5
37,"37260",137,110,109,0,1,"VOX",29
18,"18141",382,240,237,0,3,"VOX",70
16,"16078",41384,28809,28500,322,309,"VOX",4774
19,"19224",106,83,83,1,0,"VOX",31
40,"40170",1302,962,948,6,14,"VOX",220
37,"37166",196,134,133,1,1,"VOX",33
30,"30034",1067,818,801,8,17,"VOX",189
46,"46065",1584,1199,1183,11,16,"VOX",220
13,"13052",6288,4360,4278,36,82,"VOX",1074
9,"9253",101,77,76,0,1,"VOX",12
48,"48027",22745,16240,16158,74,82,"VOX",262
8,"8219",15755,12235,12206,72,29,"VOX",531
28,"28169",1577,1214,1209,7,5,"VOX",370
9,"9421",240,180,180,3,0,"VOX",27
16,"16079",28,16,16,0,0,"VOX",2
13,"13053",14031,9930,9796,97,134,"VOX",1919
5,"5193",179,140,139,2,1,"VOX",11
34,"34230",16,11,11,0,0,"VOX",2
25,"25025",1362,909,898,15,11,"VOX",81
9,"9255",83,58,58,0,0,"VOX",6
45,"45202",3963,2806,2771,10,35,"VOX",732
41,"41023",7999,5500,5435,60,65,"VOX",873
13,"13054",4870,3630,3575,26,55,"VOX",646
34,"34231",211,157,153,3,4,"VOX",33
48,"48028",682,551,548,3,3,"VOX",4
44,"44251",239,187,183,1,4,"VOX",47
46,"46066",1274,972,970,4,2,"VOX",160
3,"3901",1137,783,776,9,7,"VOX",131
43,"43017",112,94,94,1,0,"VOX",1
36,"36035",14615,10011,9880,103,131,"VOX",804
37,"37168",397,271,266,3,5,"VOX",68
48,"48029",8681,6057,6027,41,30,"VOX",208
37,"37169",177,122,122,0,0,"VOX",35
37,"37263",339,215,210,0,5,"VOX",25
31,"31095",71,59,59,0,0,"VOX",1
30,"30036",15432,10030,9879,64,151,"VOX",3352
23,"23046",2334,1880,1855,9,25,"VOX",316
18,"18144",816,592,582,3,10,"VOX",156
8,"8220",2411,2010,2001,8,9,"VOX",25
3,"3902",10640,7024,6952,36,72,"VOX",2351
5,"5195",199,125,125,1,0,"VOX",22
43,"43175",534,363,359,5,4,"VOX",14
34,"34233",128,104,104,0,0,"VOX",11
16,"16083",44,24,24,0,0,"VOX",15
19,"19227",68,42,41,1,1,"VOX",3
48,"48030",591,449,447,2,2,"VOX",1
25,"25029",1590,1190,1185,4,5,"VOX",13
42,"42116",37,30,29,2,1,"VOX",3
3,"3903",2612,1838,1814,7,24,"VOX",461
9,"9259",230,178,176,2,2,"VOX",45
30,"30037",19407,13252,13120,99,132,"VOX",4988
37,"37264",56,39,39,0,0,"VOX",7
13,"13058",4026,2822,2766,29,56,"VOX",645
24,"24050",105,77,77,2,0,"VOX",12
34,"34234",66,48,45,0,3,"VOX",12
3,"3904",1434,1032,1022,8,10,"VOX",230
5,"5197",100,82,79,1,3,"VOX",11
19,"19324",164,122,120,4,2,"VOX",18
9,"9100",55,33,33,0,0,"VOX",8
18,"18146",930,645,629,10,16,"VOX",110
42,"42118",21,11,11,0,0,"VOX",1
40,"40174",319,229,227,3,2,"VOX",39
48,"48031",303,221,221,0,0,"VOX",0
18,"18147",3655,2273,2241,16,32,"VOX",366
4,"4001",1002,717,710,3,7,"VOX",122
23,"23049",1740,1215,1183,12,32,"VOX",124
44,"44258",53,46,46,0,0,"VOX",6
9,"9262",160,122,120,2,2,"VOX",22
19,"19229",58,53,53,0,0,"VOX",9
46,"46069",152,112,111,1,1,"VOX",17
48,"48032",5762,4287,4262,14,25,"VOX",39
49,"49006",139,98,95,3,3,"VOX",12
45,"45097",1037,834,819,7,15,"VOX",204
5,"5198",70,53,51,0,2,"VOX",9
34,"34238",294,238,236,1,2,"VOX",7
30,"30038",15752,10987,10904,39,83,"VOX",3479
19,"19230",558,409,406,1,3,"VOX",117
13,"13061",5616,3679,3634,51,45,"VOX",841
16,"16203",10221,6960,6883,42,77,"VOX",1446
37,"37173",1412,951,937,15,14,"VOX",133
50,"50118",2101,1484,1477,17,7,"VOX",245
43,"43100",3557,2666,2649,22,17,"VOX",278
9,"9266",97,71,68,1,3,"VOX",20
13,"13062",567,450,446,4,4,"VOX",100
4,"4002",1013,711,699,1,12,"VOX",147
18,"18148",787,618,605,5,13,"VOX",99
8,"8224",885,653,652,6,1,"VOX",27
28,"28176",13980,10765,10701,72,64,"VOX",2855
36,"36040",2505,1597,1563,15,34,"VOX",112
48,"48033",217,162,162,1,0,"VOX",1
19,"19231",10,6,6,0,0,"VOX",1
18,"18149",5408,3926,3859,42,67,"VOX",912
5,"5200",41,26,26,0,0,"VOX",2
9,"9267",117,95,93,1,2,"VOX",7
49,"49229",109,80,77,1,3,"VOX",11
4,"4003",17583,11062,10941,77,121,"VOX",3566
16,"16088",100,86,86,0,0,"VOX",11
28,"28080",49866,39769,39583,346,186,"VOX",8558
9,"9105",95,65,64,1,1,"VOX",7
26,"26046",1552,1056,1027,11,29,"VOX",92
42,"42123",157,103,102,6,1,"VOX",11
16,"16206",184,126,125,4,1,"VOX",20
4,"4004",405,282,272,2,10,"VOX",54
25,"25125",383,265,265,3,0,"VOX",7
45,"45101",3671,2842,2808,13,34,"VOX",621
44,"44261",713,553,549,3,4,"VOX",47
28,"28082",6110,4622,4581,41,41,"VOX",917
22,"22007",751,527,520,1,7,"VOX",86
34,"34242",91,65,62,2,3,"VOX",12
49,"49231",288,208,203,0,5,"VOX",38
4,"4005",534,422,419,3,3,"VOX",70
30,"30041",14040,8999,8876,94,123,"VOX",2439
8,"8225",94,83,82,1,1,"VOX",0
13,"13065",2777,1766,1728,10,38,"VOX",476
9,"9269",29,24,23,0,1,"VOX",1
24,"24165",317,202,199,1,3,"VOX",23
8,"8019",1122912,824423,821037,5287,3386,"VOX",43475
4,"4006",7192,4389,4335,39,54,"VOX",1007
40,"40180",276,215,210,2,5,"VOX",48
34,"34243",323,243,239,1,4,"VOX",28
26,"26166",144,125,124,0,1,"VOX",20
49,"49232",85,64,64,0,0,"VOX",8
28,"28083",9836,7278,7206,64,72,"VOX",1963
45,"45103",363,286,283,0,3,"VOX",32
9,"9437",266,207,203,4,4,"VOX",27
9,"9110",77,50,50,0,0,"VOX",7
48,"48036",24015,16501,16425,83,76,"VOX",356
34,"34245",307,212,212,0,0,"VOX",20
23,"23054",375,280,272,1,8,"VOX",58
25,"25035",364,257,256,0,1,"VOX",8
28,"28180",5317,4011,3959,35,52,"VOX",884
5,"5205",81,59,58,2,1,"VOX",7
50,"50044",224,159,159,2,0,"VOX",29
6,"6042",984,644,629,5,15,"VOX",57
42,"42127",37,26,26,1,0,"VOX",1
34,"34246",68,52,52,0,0,"VOX",11
44,"44264",254,170,170,0,0,"VOX",25
23,"23055",46314,30950,30506,279,444,"VOX",6285
19,"19331",2677,1892,1841,18,51,"VOX",446
9,"9113",453,321,315,8,6,"VOX",42
37,"37366",40,34,33,2,1,"VOX",3
46,"46142",778,536,524,3,12,"VOX",56
25,"25036",180,124,124,1,0,"VOX",5
34,"34901",1053,762,759,10,3,"VOX",140
24,"24058",189,115,114,1,1,"VOX",19
46,"46074",2687,2033,2020,18,13,"VOX",367
8,"8227",2420,1775,1769,11,6,"VOX",56
49,"49234",394,282,277,0,5,"VOX",31
16,"16094",121,86,84,0,2,"VOX",21
46,"46075",144,125,122,2,3,"VOX",17
36,"36046",4073,2887,2818,31,69,"VOX",281
13,"13070",747,575,556,7,19,"VOX",88
40,"40183",117,105,99,1,6,"VOX",13
34,"34902",123,91,91,0,0,"VOX",11
37,"37179",197,167,165,0,2,"VOX",42
49,"49235",415,300,290,4,10,"VOX",39
48,"48038",1151,829,829,1,0,"VOX",2
13,"13071",37945,24340,24091,227,249,"VOX",4410
18,"18153",8834,6174,6063,54,111,"VOX",1358
19,"19145",40,32,32,0,0,"VOX",5
49,"49014",116,83,83,1,0,"VOX",12
49,"49236",71,54,54,0,0,"VOX",8
23,"23058",8832,6528,6407,57,121,"VOX",1091
19,"19237",39,34,34,0,0,"VOX",8
5,"5010",142,102,100,2,2,"VOX",27
18,"18154",982,668,668,4,0,"VOX",202
37,"37180",68,45,44,1,1,"VOX",4
48,"48039",254,221,220,2,1,"VOX",6
42,"42131",50,39,39,2,0,"VOX",1
13,"13073",501,392,385,2,7,"VOX",70
25,"25038",1478,1057,1048,10,9,"VOX",41
14,"14066",5748,4116,4035,59,81,"VOX",580
9,"9277",103,84,82,1,2,"VOX",3
30,"30902",8294,5235,5174,29,61,"VOX",1401
34,"34904",300,188,186,0,2,"VOX",29
8,"8229",521,418,417,3,1,"VOX",4
9,"9443",151,113,112,0,1,"VOX",26
37,"37369",126,83,81,0,2,"VOX",16
13,"13074",943,759,749,5,10,"VOX",137
28,"28088",296,196,191,1,5,"VOX",29
46,"46076",610,500,494,1,6,"VOX",47
16,"16097",139,117,116,0,1,"VOX",10
40,"40185",800,560,553,4,7,"VOX",73
19,"19239",93,70,70,1,0,"VOX",19
4,"4012",184,151,150,3,1,"VOX",26
25,"25131",394,281,279,3,2,"VOX",10
5,"5210",81,56,56,0,0,"VOX",10
19,"19335",51,39,38,0,1,"VOX",4
36,"36049",6990,4877,4787,40,90,"VOX",399
18,"18158",7978,4861,4771,43,90,"VOX",748
8,"8230",7648,5797,5774,40,23,"VOX",414
19,"19240",49,36,36,0,0,"VOX",8
37,"37182",75,47,47,1,0,"VOX",18
42,"42134",2651,1875,1836,21,39,"VOX",249
24,"24063",362,247,245,2,2,"VOX",43
37,"37183",377,267,267,5,0,"VOX",44
40,"40186",35,29,29,0,0,"VOX",1
23,"23061",7711,5357,5231,44,126,"VOX",1141
44,"44268",32,30,30,0,0,"VOX",0
50,"50050",87,62,62,1,0,"VOX",13
8,"8299",380,301,300,4,1,"VOX",6
13,"13077",3383,2050,1997,20,53,"VOX",425
16,"16219",81,58,58,0,0,"VOX",6
49,"49239",599,393,384,6,9,"VOX",58
4,"4013",143819,93083,92383,893,700,"VOX",21086
35,"35002",24229,15311,15133,101,178,"VOX",2375
40,"40188",83,63,60,0,3,"VOX",6
19,"19241",35,26,25,2,1,"VOX",5
31,"31003",121,71,71,0,0,"VOX",0
45,"45001",1846,1213,1181,10,32,"VOX",258
28,"28090",9252,7216,7153,58,63,"VOX",1450
26,"26058",149,114,114,2,0,"VOX",9
23,"23062",1410,1094,1076,0,18,"VOX",197
37,"37278",793,570,567,6,3,"VOX",151
42,"42139",21,16,16,2,0,"VOX",1
41,"41038",102752,71545,70538,980,1007,"VOX",14352
26,"26175",47,40,38,1,2,"VOX",6
10,"10214",216,170,170,2,0,"VOX",21
18,"18159",989,765,762,2,3,"VOX",79
31,"31004",31,22,22,1,0,"VOX",1
20,"20002",359,234,231,7,3,"VOX",0
35,"35003",5644,2987,2943,20,44,"VOX",506
13,"13079",12233,8274,8138,93,136,"VOX",1661
4,"4015",113,81,81,0,0,"VOX",13
42,"42140",15,11,11,1,0,"VOX",4
23,"23063",3784,2699,2664,22,35,"VOX",692
5,"5213",94,72,70,0,2,"VOX",6
48,"48044",61957,45253,45063,299,190,"VOX",1600
46,"46079",314,244,240,0,4,"VOX",71
18,"18161",245,199,196,0,3,"VOX",24
49,"49242",439,342,336,2,6,"VOX",80
42,"42141",101,59,59,0,0,"VOX",17
31,"31006",1877,1328,1310,14,18,"VOX",150
45,"45003",554,398,393,2,5,"VOX",103
46,"46011",7523,5154,5077,34,77,"VOX",1218
45,"45114",549,400,394,1,6,"VOX",62
19,"19243",34,32,31,1,1,"VOX",4
13,"13081",584,412,405,0,7,"VOX",59
37,"37186",94,68,68,0,0,"VOX",3
8,"8302",9359,6483,6430,78,53,"VOX",573
42,"42011",16,11,11,0,0,"VOX",3
31,"31007",122,88,82,1,6,"VOX",9
9,"9292",72,55,55,3,0,"VOX",12
42,"42142",42,36,36,1,0,"VOX",6
46,"46080",979,720,712,2,8,"VOX",105
13,"13082",25917,16834,16670,137,164,"VOX",4549
8,"8027",724,584,582,1,2,"VOX",35
28,"28093",2177,1681,1658,11,23,"VOX",487
35,"35005",1009,680,668,2,12,"VOX",57
37,"37187",548,407,399,0,8,"VOX",90
45,"45005",225,170,167,3,3,"VOX",23
19,"19244",74,55,55,3,0,"VOX",12
49,"49022",282,230,229,2,1,"VOX",40
49,"49244",46,23,23,0,0,"VOX",5
9,"9294",99,81,78,0,3,"VOX",8
18,"18163",311,206,204,0,2,"VOX",34
24,"24068",430,289,281,0,8,"VOX",23
13,"13083",2382,1623,1587,12,36,"VOX",359
17,"17043",165,133,133,0,0,"VOX",3
4,"4018",245,202,197,2,5,"VOX",38
48,"48046",12626,9300,9250,31,50,"VOX",76
5,"5216",209,149,149,0,0,"VOX",25
9,"9454",41,34,33,1,1,"VOX",3
37,"37188",158,107,105,3,2,"VOX",22
16,"16104",53,42,42,0,0,"VOX",14
42,"42145",129,105,104,1,1,"VOX",5
40,"40192",134,106,105,1,1,"VOX",17
13,"13085",2265,1768,1735,5,33,"VOX",321
28,"28095",1719,1236,1226,5,10,"VOX",357
49,"49245",251,174,171,1,3,"VOX",30
21,"21009",834,527,508,4,19,"VOX",59
45,"45007",656,502,497,0,5,"VOX",74
8,"8235",3875,3004,2996,19,8,"VOX",73
35,"35006",31373,20764,20476,189,288,"VOX",2283
23,"23069",5240,4153,4065,26,88,"VOX",565
49,"49246",214,183,180,3,3,"VOX",16
42,"42148",9,9,9,0,0,"VOX",5
37,"37283",116,83,83,0,0,"VOX",15
36,"36056",4932,3368,3310,24,58,"VOX",281
35,"35007",517,347,345,2,2,"VOX",56
16,"16236",857,615,608,1,7,"VOX",172
18,"18165",4265,2870,2820,22,50,"VOX",655
9,"9458",490,388,385,6,3,"VOX",86
5,"5218",104,81,79,0,2,"VOX",17
31,"31011",715,483,481,5,2,"VOX",22
19,"19247",140,103,102,1,1,"VOX",16
46,"46151",757,560,552,2,8,"VOX",81
25,"25046",410,331,326,4,5,"VOX",3
36,"36057",238417,165843,164264,1641,1579,"VOX",10686
31,"31121",62,42,42,0,0,"VOX",1
28,"28097",126,87,87,2,0,"VOX",16
4,"4021",179,132,129,2,3,"VOX",14
44,"44008",1556,1109,1100,7,9,"VOX",183
9,"9301",658,497,488,5,9,"VOX",103
4,"4022",356,237,236,5,1,"VOX",69
50,"50056",399,296,296,3,0,"VOX",64
13,"13088",585,413,409,3,4,"VOX",74
48,"48049",543,415,414,1,1,"VOX",3
45,"45010",383,258,257,3,1,"VOX",63
19,"19248",73,54,54,0,0,"VOX",8
18,"18168",783,566,561,11,5,"VOX",56
8,"8305",27661,20346,20221,118,125,"VOX",834
36,"36058",4957,3043,2994,55,49,"VOX",219
13,"13089",1609,1248,1228,10,20,"VOX",246
40,"40195",776,573,565,4,8,"VOX",82
4,"4023",118,84,82,2,2,"VOX",18
8,"8237",1644,1263,1254,9,9,"VOX",27
8,"8238",14946,11911,11873,85,38,"VOX",718
23,"23072",1879,1389,1363,3,26,"VOX",290
45,"45011",279,235,233,4,2,"VOX",31
40,"40196",30,24,24,0,0,"VOX",5
49,"49249",61,45,45,1,0,"VOX",9
9,"9303",73,58,58,0,0,"VOX",16
31,"31014",268,168,168,2,0,"VOX",5
14,"14902",1113,877,851,15,26,"VOX",110
9,"9136",169,129,125,2,4,"VOX",21
25,"25234",4139,2786,2772,13,14,"VOX",99
20,"20010",1524,1057,1053,5,4,"VOX",8
13,"13091",537,466,464,3,2,"VOX",41
37,"37193",362,253,252,4,1,"VOX",68
45,"45122",5605,4321,4288,33,33,"VOX",1008
49,"49250",1191,844,824,8,20,"VOX",166
48,"48051",220,151,150,0,1,"VOX",2
31,"31015",1989,1399,1386,17,13,"VOX",106
40,"40198",24,20,19,0,1,"VOX",2
4,"4024",3241,2315,2290,34,25,"VOX",640
18,"18170",317,212,209,0,3,"VOX",35
28,"28101",226,174,172,1,2,"VOX",31
36,"36060",30431,19909,19673,206,236,"VOX",1457
11,"11002",4218,3176,3149,16,27,"VOX",101
5,"5222",140,118,118,0,0,"VOX",42
6,"6067",1897,1268,1242,14,26,"VOX",244
19,"19054",161,136,135,3,1,"VOX",29
49,"49251",159,116,109,2,7,"VOX",18
20,"20011",1624,1234,1225,3,9,"VOX",5
42,"42155",146,83,80,2,3,"VOX",13
31,"31016",7790,5541,5502,56,39,"VOX",170
16,"16112",1466,972,957,12,15,"VOX",102
18,"18171",2098,1521,1460,11,61,"VOX",287
46,"46086",80,66,65,1,1,"VOX",5
35,"35010",3853,2224,2194,18,30,"VOX",209
42,"42156",29,21,21,0,0,"VOX",7
15,"15003",1675,1029,1020,9,9,"VOX",54
46,"46109",6248,4516,4440,37,76,"VOX",781
4,"4027",218,130,130,0,0,"VOX",32
8,"8240",9469,7351,7327,39,24,"VOX",276
35,"35011",24859,15025,14833,149,192,"VOX",2339
45,"45015",656,449,438,2,11,"VOX",96
13,"13095",66,56,56,3,0,"VOX",20
48,"48053",926,704,702,6,2,"VOX",10
40,"40200",38,28,28,0,0,"VOX",1
4,"4028",207,175,171,1,4,"VOX",15
28,"28104",15528,12342,12234,103,108,"VOX",2993
37,"37196",70,50,50,0,0,"VOX",4
5,"5225",355,276,273,6,3,"VOX",28
19,"19057",69,51,51,0,0,"VOX",2
45,"45016",4486,3288,3251,19,37,"VOX",714
44,"44106",151,107,106,0,1,"VOX",11
6,"6071",238,192,187,2,5,"VOX",18
16,"16115",49,32,32,0,0,"VOX",2
9,"9310",15,14,11,0,3,"VOX",0
8,"8241",70,52,52,0,0,"VOX",1
42,"42158",97,73,73,1,0,"VOX",4
37,"37197",88,53,53,1,0,"VOX",9
24,"24080",207,155,154,1,1,"VOX",19
15,"15005",25347,15441,15211,226,230,"VOX",1505
31,"31019",1831,1231,1224,17,7,"VOX",41
35,"35012",10862,5617,5568,40,49,"VOX",879
42,"42159",39,34,33,0,1,"VOX",3
49,"49257",305,186,184,0,2,"VOX",30
40,"40201",42,37,37,0,0,"VOX",5
18,"18174",435,324,320,3,4,"VOX",74
13,"13098",1946,1404,1361,13,43,"VOX",328
31,"31020",435,224,222,1,2,"VOX",0
37,"37001",165,120,120,0,0,"VOX",5
49,"49145",208,113,113,1,0,"VOX",23
9,"9312",89,68,68,1,0,"VOX",9
39,"39025",8637,6256,6179,33,77,"VOX",988
4,"4030",1052,690,678,6,12,"VOX",145
11,"11006",24558,15334,15113,231,221,"VOX",3173
28,"28107",442,316,310,5,6,"VOX",61
18,"18175",11793,8099,7943,62,156,"VOX",1885
40,"40202",56,33,33,0,0,"VOX",0
13,"13901",875,628,619,1,9,"VOX",162
8,"8242",223,159,159,0,0,"VOX",8
42,"42160",246,177,175,3,2,"VOX",28
13,"13902",449,329,326,4,3,"VOX",80
31,"31021",59,42,42,1,0,"VOX",0
40,"40203",987,753,740,13,13,"VOX",161
47,"47200",70,60,60,0,0,"VOX",13
4,"4031",2238,1649,1645,15,4,"VOX",230
35,"35013",6593,4596,4516,47,80,"VOX",514
28,"28109",1651,1131,1116,8,15,"VOX",333
13,"13903",498,395,394,0,1,"VOX",88
24,"24083",997,659,647,9,12,"VOX",91
29,"29015",32093,22044,21716,253,328,"VOX",4414
23,"23081",1494,1084,1061,9,23,"VOX",209
5,"5228",168,99,98,0,1,"VOX",13
49,"49035",220,180,180,4,0,"VOX",42
5,"5229",75,61,61,1,0,"VOX",17
19,"19257",3279,2233,2206,21,27,"VOX",353
35,"35014",11962,5994,5888,60,106,"VOX",889
37,"37200",190,132,131,0,1,"VOX",34
20,"20017",8462,5944,5917,11,27,"VOX",94
49,"49036",503,319,316,5,3,"VOX",50
31,"31023",7778,5977,5948,106,29,"VOX",393
16,"16007",1153,857,847,3,10,"VOX",150
15,"15008",5646,3859,3836,52,23,"VOX",415
13,"13904",496,353,342,5,11,"VOX",65
46,"46091",110,100,100,0,0,"VOX",21
18,"18177",375,235,231,5,4,"VOX",37
48,"48058",947,682,679,2,3,"VOX",4
35,"35015",10752,5289,5222,39,67,"VOX",650
26,"26078",86,63,63,0,0,"VOX",8
4,"4034",169,91,91,1,0,"VOX",21
23,"23082",1850,1292,1279,13,13,"VOX",205
9,"9317",20,18,18,0,0,"VOX",0
15,"15009",10605,7245,7133,101,112,"VOX",570
23,"23084",902,627,621,4,6,"VOX",173
16,"16121",227,160,152,0,8,"VOX",23
5,"5230",65,57,56,1,1,"VOX",11
19,"19064",64,56,56,0,0,"VOX",7
31,"31025",762,497,490,1,7,"VOX",18
19,"19258",84,63,62,0,1,"VOX",10
11,"11010",6327,3998,3928,112,70,"VOX",687
18,"18178",664,474,467,1,7,"VOX",65
4,"4035",8439,5822,5768,45,54,"VOX",1496
32,"32081",2057,1466,1445,17,21,"VOX",116
9,"9318",56,33,33,0,0,"VOX",2
46,"46160",1922,1395,1381,4,14,"VOX",150
29,"29017",6404,4575,4468,48,107,"VOX",654
45,"45133",2798,1957,1922,11,35,"VOX",471
40,"40206",162,126,123,0,3,"VOX",10
14,"14002",10895,7599,7479,109,120,"VOX",1023
19,"19259",28,22,22,0,0,"VOX",0
18,"18179",493,315,309,8,6,"VOX",63
45,"45024",1034,742,733,1,9,"VOX",180
48,"48060",3625,2429,2418,12,11,"VOX",4
19,"19260",38,27,27,1,0,"VOX",0
45,"45134",1622,1187,1177,8,10,"VOX",289
46,"46024",454,343,339,1,4,"VOX",74
43,"43047",4234,2590,2564,19,26,"VOX",336
18,"18180",636,410,401,2,9,"VOX",73
19,"19066",51,42,42,0,0,"VOX",9
9,"9323",57,37,36,0,1,"VOX",4
5,"5232",104,86,83,1,3,"VOX",17
42,"42166",55,38,37,0,1,"VOX",3
5,"5233",223,174,173,0,1,"VOX",28
35,"35017",27498,15513,15240,121,273,"VOX",2709
8,"8246",1692,1345,1340,7,5,"VOX",18
40,"40207",802,593,590,11,3,"VOX",126
23,"23087",11169,8193,8045,79,148,"VOX",1315
45,"45025",1218,849,844,9,5,"VOX",252
14,"14004",1963,1465,1437,15,28,"VOX",338
26,"26082",101,79,79,0,0,"VOX",4
27,"27014",3144,2009,1985,24,24,"VOX",192
6,"6083",46577,31113,30748,338,365,"VOX",5432
4,"4037",1212,890,875,17,15,"VOX",150
44,"44113",74,51,51,0,0,"VOX",4
5,"5234",45,38,38,0,0,"VOX",8
25,"25060",71,42,42,0,0,"VOX",2
37,"37205",212,157,155,1,2,"VOX",41
41,"41057",258,174,170,3,4,"VOX",9
29,"29020",3278,2329,2260,22,69,"VOX",301
31,"31138",948,629,627,8,2,"VOX",4
18,"18181",194,134,133,0,1,"VOX",48
23,"23088",6017,4529,4427,61,102,"VOX",539
31,"31029",913,606,601,14,5,"VOX",21
4,"4038",3105,2020,1984,17,36,"VOX",410
18,"18182",1926,1222,1204,8,18,"VOX",232
35,"35018",13153,7742,7674,80,68,"VOX",1001
11,"11014",17203,10923,10805,222,118,"VOX",1923
25,"25061",80,51,51,0,0,"VOX",1
4,"4041",344,227,222,4,5,"VOX",51
48,"48063",354,256,252,1,4,"VOX",1
45,"45028",3613,2675,2647,22,28,"VOX",498
8,"8248",5687,4187,4165,21,22,"VOX",217
5,"5139",71,59,58,1,1,"VOX",17
16,"16128",50,38,38,0,0,"VOX",2
31,"31140",112,73,73,1,0,"VOX",3
37,"37301",84,64,64,1,0,"VOX",16
46,"46163",1883,1471,1460,8,11,"VOX",312
49,"49267",96,67,63,2,4,"VOX",3
49,"49043",256,191,189,1,2,"VOX",23
9,"9166",96,77,77,0,0,"VOX",16
43,"43050",2695,1742,1730,10,12,"VOX",158
9,"9329",113,76,75,5,1,"VOX",10
37,"37302",262,161,161,2,0,"VOX",35
29,"29022",177,137,136,1,1,"VOX",15
4,"4043",517,398,395,1,3,"VOX",129
18,"18183",623,380,376,0,4,"VOX",75
23,"23091",675,516,512,1,4,"VOX",83
50,"50069",66,33,33,1,0,"VOX",2
48,"48064",608,461,461,0,0,"VOX",2
45,"45029",186,154,154,2,0,"VOX",25
49,"49268",364,266,263,3,3,"VOX",51
31,"31032",1670,1158,1147,18,11,"VOX",61
9,"9330",1481,1050,1037,17,13,"VOX",131
9,"9012",93,70,68,0,2,"VOX",8
14,"14007",15016,10248,10043,99,205,"VOX",2066
37,"37012",144,111,111,0,0,"VOX",24
48,"48065",3285,2341,2326,8,15,"VOX",25
23,"23092",27717,19749,19490,217,259,"VOX",3964
28,"28118",61,52,50,0,2,"VOX",11
18,"18184",2193,1542,1511,16,31,"VOX",232
37,"37208",71,49,49,0,0,"VOX",7
9,"9332",137,93,91,2,2,"VOX",12
25,"25063",84,52,51,0,1,"VOX",6
31,"31033",45,25,25,2,0,"VOX",0
49,"49157",188,136,133,2,3,"VOX",21
14,"14008",2758,1880,1836,21,44,"VOX",361
45,"45031",2861,1894,1858,13,36,"VOX",489
4,"4045",1696,1268,1254,17,14,"VOX",275
16,"16131",123,84,84,0,0,"VOX",24
48,"48066",344,246,246,2,0,"VOX",0
40,"40213",93,78,78,1,0,"VOX",11
23,"23094",3739,2920,2876,29,44,"VOX",392
9,"9334",51,36,34,1,2,"VOX",8
19,"19074",67,57,57,1,0,"VOX",6
31,"31254",1916,1336,1322,9,14,"VOX",97
5,"5142",88,76,75,0,1,"VOX",22
37,"37211",208,148,148,0,0,"VOX",37
4,"4046",849,617,612,6,5,"VOX",131
14,"14009",2653,1658,1631,24,27,"VOX",294
37,"37305",219,177,175,2,2,"VOX",34
28,"28120",1220,910,897,5,13,"VOX",208
19,"19266",229,184,182,1,2,"VOX",51
49,"49048",113,88,88,0,0,"VOX",14
48,"48067",1133,810,805,0,5,"VOX",0
40,"40215",79,66,66,2,0,"VOX",10
46,"46098",2405,1778,1751,7,27,"VOX",287
16,"16132",33,25,25,1,0,"VOX",4
31,"31036",879,601,589,5,12,"VOX",30
9,"9017",89,61,60,3,1,"VOX",8
4,"4081",351,264,263,0,1,"VOX",44
34,"34011",379,290,284,2,6,"VOX",45
16,"16133",4399,3317,3256,34,61,"VOX",484
18,"18187",510,350,350,2,0,"VOX",45
19,"19267",20,15,14,0,1,"VOX",1
45,"45034",1290,968,948,7,20,"VOX",153
8,"8252",24885,18507,18383,162,124,"VOX",1569
48,"48068",1534,1154,1149,1,5,"VOX",1
31,"31037",91,70,70,0,0,"VOX",0
5,"5241",3062,2011,1977,21,34,"VOX",538
49,"49052",183,120,117,2,3,"VOX",31
12,"12059",220,183,183,2,0,"VOX",42
18,"18188",1646,1224,1202,10,22,"VOX",170
4,"4049",5711,3766,3732,25,34,"VOX",831
14,"14011",580,444,443,3,1,"VOX",78
23,"23097",6346,4243,4194,31,49,"VOX",1434
48,"48069",13131,9211,9162,55,49,"VOX",230
22,"22046",713,555,549,9,6,"VOX",72
5,"5047",4105,3004,2936,23,68,"VOX",559
37,"37307",146,94,91,1,3,"VOX",17
19,"19268",50,37,35,0,2,"VOX",3
31,"31147",110,79,78,1,1,"VOX",1
5,"5145",43,28,28,0,0,"VOX",3
37,"37016",563,419,411,4,8,"VOX",75
37,"37121",536,413,403,4,10,"VOX",86
44,"44028",171,136,136,0,0,"VOX",7
50,"50074",6156,4100,4022,33,78,"VOX",824
5,"5242",679,571,562,9,9,"VOX",52
35,"35024",14323,8360,8289,81,71,"VOX",1033
40,"40218",80,56,55,0,1,"VOX",9
46,"46100",281,190,187,1,3,"VOX",21
18,"18189",785,598,592,9,6,"VOX",103
23,"23098",847,704,700,0,4,"VOX",84
4,"4050",742,465,464,0,1,"VOX",102
31,"31039",92,70,69,1,1,"VOX",0
5,"5243",80,57,56,1,1,"VOX",13
23,"23099",4824,3523,3435,35,88,"VOX",644
25,"25070",817,619,617,11,2,"VOX",10
40,"40219",573,382,366,5,16,"VOX",78
9,"9343",92,66,65,0,1,"VOX",6
41,"41066",1307,927,898,7,29,"VOX",52
37,"37122",203,162,161,3,1,"VOX",37
25,"25164",353,259,255,0,4,"VOX",6
14,"14013",16619,11968,11719,153,249,"VOX",2849
50,"50075",70,55,55,1,0,"VOX",6
18,"18192",1462,1125,1103,3,22,"VOX",228
31,"31040",186,131,129,1,2,"VOX",0
48,"48071",6013,4240,4205,23,35,"VOX",74
9,"9345",111,87,86,2,1,"VOX",18
35,"35026",83172,48751,48109,449,642,"VOX",6944
42,"42184",55,36,33,0,3,"VOX",13
16,"16139",317,226,222,1,4,"VOX",29
50,"50002",125,91,86,0,5,"VOX",20
5,"5244",39,29,29,0,0,"VOX",1
16,"16140",18,14,14,1,0,"VOX",1
4,"4052",12882,8400,8322,93,78,"VOX",2641
26,"26098",92,63,63,1,0,"VOX",4
5,"5245",353,262,256,0,6,"VOX",40
29,"29030",770,618,611,4,7,"VOX",22
28,"28125",3208,2275,2252,5,23,"VOX",672
5,"5052",85,70,69,0,1,"VOX",21
6,"6100",845,626,624,2,2,"VOX",95
37,"37217",59,43,43,3,0,"VOX",3
42,"42187",58,44,39,1,5,"VOX",18
46,"46102",19696,14700,14579,125,121,"VOX",2189
19,"19272",66,55,55,2,0,"VOX",0
16,"16141",131,98,96,1,2,"VOX",14
10,"10013",265,184,182,0,2,"VOX",35
23,"23902",2219,1813,1770,6,43,"VOX",121
37,"37218",51,25,23,0,2,"VOX",4
40,"40221",50,38,35,0,3,"VOX",2
9,"9025",110,61,58,0,3,"VOX",8
41,"41069",29669,20316,19848,381,468,"VOX",5288
11,"11025",4374,2808,2759,30,49,"VOX",357
50,"50003",117,89,89,1,0,"VOX",20
42,"42188",46,35,35,1,0,"VOX",6
16,"16142",119,90,90,0,0,"VOX",18
28,"28127",66793,53258,53009,458,249,"VOX",11694
46,"46103",1354,993,978,8,15,"VOX",149
47,"47126",42,35,35,1,0,"VOX",7
35,"35027",10502,6831,6750,67,81,"VOX",749
14,"14016",1273,936,922,5,14,"VOX",91
25,"25073",559,377,377,2,0,"VOX",5
10,"10015",630,429,424,1,5,"VOX",46
45,"45152",545,402,393,1,9,"VOX",68
40,"40222",161,134,131,1,3,"VOX",19
37,"37219",169,88,85,1,3,"VOX",25
4,"4055",361,298,290,3,8,"VOX",32
19,"19277",15,10,10,0,0,"VOX",2
37,"37314",81,65,65,0,0,"VOX",9
48,"48074",3275,2308,2295,11,13,"VOX",56
31,"31045",510,347,345,8,2,"VOX",11
11,"11027",68774,45571,45137,567,434,"VOX",10412
8,"8258",815,636,632,5,4,"VOX",5
26,"26102",6076,4276,4205,52,71,"VOX",435
46,"46104",1906,1422,1409,5,13,"VOX",210
35,"35028",10156,5483,5425,56,58,"VOX",797
45,"45043",776,608,598,3,10,"VOX",98
37,"37023",1624,1233,1211,15,22,"VOX",294
4,"4056",165,120,120,0,0,"VOX",21
23,"23904",2570,1583,1562,10,21,"VOX",343
28,"28129",8589,6397,6338,46,59,"VOX",1401
37,"37221",391,259,257,2,2,"VOX",29
48,"48075",2066,1524,1508,9,16,"VOX",21
42,"42191",183,116,114,5,2,"VOX",12
29,"29033",1084,733,722,5,11,"VOX",150
16,"16145",413,333,326,6,7,"VOX",47
31,"31046",53,38,38,0,0,"VOX",3
25,"25075",132,101,101,0,0,"VOX",0
29,"29034",461,333,332,2,1,"VOX",117
9,"9077",26,21,21,0,0,"VOX",6
4,"4091",318,251,250,0,1,"VOX",29
5,"5155",46,33,31,1,2,"VOX",4
18,"18903",852,544,537,9,7,"VOX",169
28,"28130",28569,22050,21799,187,251,"VOX",3763
35,"35030",10046,5584,5505,44,79,"VOX",712
46,"46106",1471,1033,1028,8,5,"VOX",168
48,"48076",288,211,211,1,0,"VOX",4
31,"31902",4661,3228,3201,39,27,"VOX",261
49,"49062",103,58,58,0,0,"VOX",4
24,"24001",165,93,93,0,0,"VOX",13
4,"4058",342,238,236,3,2,"VOX",41
39,"39047",1998,1408,1392,8,16,"VOX",198
4,"4059",1000,676,666,3,10,"VOX",82
48,"48077",3366,2483,2467,9,16,"VOX",36
16,"16147",54,34,33,0,1,"VOX",11
19,"19280",3669,2622,2597,24,25,"VOX",813
9,"9355",85,67,67,1,0,"VOX",7
10,"10020",1571,1135,1117,2,18,"VOX",132
18,"18904",741,500,498,1,2,"VOX",94
42,"42193",14,7,7,0,0,"VOX",0
48,"48078",37858,25959,25819,157,140,"VOX",578
25,"25171",2117,1539,1534,5,5,"VOX",29
43,"43063",544,376,374,2,2,"VOX",30
4,"4060",416,286,282,2,4,"VOX",32
50,"50007",51,34,34,1,0,"VOX",2
42,"42194",144,101,100,2,1,"VOX",11
45,"45048",360,276,271,2,5,"VOX",36
24,"24003",603,374,372,0,2,"VOX",79
40,"40229",26,22,22,0,0,"VOX",2
14,"14021",260521,185270,183300,2192,1970,"VOX",37271
8,"8261",2405,1726,1718,11,8,"VOX",124
46,"46107",1857,1421,1402,4,19,"VOX",208
19,"19281",19,18,18,0,0,"VOX",1
45,"45049",419,303,295,1,8,"VOX",80
25,"25910",91,63,63,0,0,"VOX",1
37,"37027",239,182,179,2,3,"VOX",38
5,"5059",92,49,48,0,1,"VOX",11
6,"6111",487,318,314,2,4,"VOX",29
31,"31160",104,83,82,1,1,"VOX",6
45,"45159",83,71,69,0,2,"VOX",17
37,"37225",97,78,74,0,4,"VOX",9
44,"44038",101,85,83,1,2,"VOX",7
48,"48079",397,289,287,1,2,"VOX",1
4,"4061",625,489,479,5,10,"VOX",87
24,"24004",495,387,384,10,3,"VOX",80
37,"37226",152,113,113,2,0,"VOX",16
9,"9361",103,64,64,1,0,"VOX",8
24,"24112",288,188,186,2,2,"VOX",12
10,"10023",842,597,589,2,8,"VOX",71
35,"35032",3331,2293,2252,23,41,"VOX",207
38,"38024",15316,9131,9005,60,126,"VOX",1042
40,"40230",93,66,64,0,2,"VOX",12
5,"5060",108,79,79,2,0,"VOX",10
5,"5256",110,88,86,1,2,"VOX",13
4,"4062",4457,3241,3197,22,44,"VOX",630
18,"18907",1762,1358,1351,4,7,"VOX",259
9,"9038",109,87,86,1,1,"VOX",11
37,"37228",324,262,262,1,0,"VOX",32
35,"35033",6393,4147,4072,38,75,"VOX",630
9,"9362",198,156,156,4,0,"VOX",32
19,"19283",29,26,26,0,0,"VOX",3
25,"25173",1646,1180,1169,6,11,"VOX",49
25,"25114",96,83,82,1,1,"VOX",1
50,"50010",67,52,52,1,0,"VOX",16
25,"25081",281,195,193,3,2,"VOX",0
4,"4063",1058,766,750,6,16,"VOX",231
45,"45052",3132,2433,2416,29,17,"VOX",562
18,"18908",776,553,528,3,25,"VOX",106
33,"33014",8735,5744,5689,67,55,"VOX",691
31,"31054",453,279,276,2,3,"VOX",3
48,"48081",1903,1455,1447,7,8,"VOX",14
42,"42200",74,49,46,0,3,"VOX",10
19,"19096",105,72,70,0,2,"VOX",16
35,"35034",8392,3946,3908,27,38,"VOX",636
44,"44041",60,48,48,0,0,"VOX",6
45,"45053",7820,5814,5712,56,102,"VOX",1159
27,"27038",923,624,619,8,5,"VOX",25
25,"25175",173,119,119,2,0,"VOX",6
16,"16153",924,751,741,4,10,"VOX",82
46,"46110",21364,15132,15019,120,113,"VOX",2809
24,"24043",116,54,52,0,2,"VOX",7
24,"24115",53159,35203,34784,410,419,"VOX",4152
24,"24008",8931,6291,6214,79,77,"VOX",1067
50,"50011",117,90,89,3,1,"VOX",13
42,"42201",23,21,21,0,0,"VOX",4
37,"37230",220,169,168,1,1,"VOX",29
24,"24116",387,227,226,3,1,"VOX",34
26,"26113",29,28,28,0,0,"VOX",2
36,"36001",2397,1674,1651,6,23,"VOX",117
5,"5259",99,80,79,2,1,"VOX",11
48,"48083",6934,4800,4765,21,35,"VOX",86
39,"39053",212,133,133,4,0,"VOX",23
44,"44042",114,82,81,0,1,"VOX",4
15,"15037",4026,2375,2349,10,26,"VOX",223
16,"16040",91,76,76,2,0,"VOX",18
26,"26001",199,145,141,3,4,"VOX",13
4,"4066",13438,8615,8519,78,96,"VOX",2979
16,"16155",490,389,388,7,1,"VOX",93
24,"24009",274,136,135,1,1,"VOX",14
18,"18910",710,439,434,1,5,"VOX",92
8,"8265",1597,1262,1260,4,2,"VOX",23
19,"19286",772,585,575,3,10,"VOX",210
42,"42204",53,37,35,1,2,"VOX",6
48,"48084",21780,14368,14271,79,97,"VOX",319
5,"5261",32,25,25,0,0,"VOX",4
20,"20046",1243,822,816,1,6,"VOX",14
36,"36003",10023,6877,6789,66,88,"VOX",519
28,"28140",3156,2359,2331,16,28,"VOX",715
15,"15038",2126,1312,1296,12,16,"VOX",83
4,"4067",504,340,330,4,10,"VOX",23
26,"26115",23,22,21,3,1,"VOX",4
8,"8266",43422,32827,32696,241,131,"VOX",1994
14,"14027",7890,5841,5726,78,115,"VOX",512
9,"9372",204,175,169,2,6,"VOX",31
37,"37233",53,39,39,1,0,"VOX",6
46,"46113",2558,1791,1773,7,18,"VOX",286
31,"31058",199,134,133,2,1,"VOX",6
17,"17083",2971,2164,2154,13,10,"VOX",95
8,"8059",340,255,250,1,5,"VOX",6
48,"48085",10716,7707,7679,51,28,"VOX",110
4,"4068",170,129,128,0,1,"VOX",15
28,"28141",6284,4617,4570,42,47,"VOX",1190
31,"31059",182,121,121,1,0,"VOX",1
18,"18912",1352,926,912,7,14,"VOX",159
24,"24012",278,182,180,0,2,"VOX",44
45,"45058",344,245,236,1,9,"VOX",43
31,"31060",14323,9547,9434,79,113,"VOX",333
25,"25179",169,132,132,0,0,"VOX",3
8,"8267",6789,4975,4935,41,40,"VOX",398
25,"25087",54,45,45,0,0,"VOX",0
15,"15040",2647,1779,1762,15,17,"VOX",172
45,"45168",62836,46917,46353,424,564,"VOX",9283
9,"9048",1373,937,911,10,26,"VOX",108
42,"42207",48,42,41,0,1,"VOX",11
8,"8002",217,172,172,2,0,"VOX",4
43,"43071",896,652,647,3,5,"VOX",19
31,"31170",44,31,30,2,1,"VOX",0
37,"37035",162,115,115,1,0,"VOX",16
24,"24014",7152,4494,4448,47,46,"VOX",489
40,"40904",344,286,284,8,2,"VOX",45
4,"4070",1529,1088,1076,8,12,"VOX",291
9,"9375",42,35,35,0,0,"VOX",11
8,"8268",975,729,723,6,6,"VOX",29
46,"46114",552,417,412,6,5,"VOX",78
37,"37235",214,163,159,2,4,"VOX",47
4,"4071",362,286,281,2,5,"VOX",31
24,"24015",2193,1532,1500,12,32,"VOX",278
48,"48087",437,335,332,0,3,"VOX",3
40,"40905",130,95,95,0,0,"VOX",15
15,"15041",9569,6362,6269,104,93,"VOX",410
37,"37236",123,85,82,1,3,"VOX",22
5,"5265",83,59,58,1,1,"VOX",19
6,"6125",1644,1251,1222,7,29,"VOX",224
14,"14030",7761,5711,5588,84,123,"VOX",731
25,"25089",93,70,68,1,2,"VOX",1
19,"19290",851,551,550,4,1,"VOX",160
9,"9052",28,21,20,0,1,"VOX",7
48,"48088",134,95,95,0,0,"VOX",0
9,"9378",31,20,19,0,1,"VOX",0
46,"46115",330,219,213,0,6,"VOX",59
28,"28145",2671,1927,1895,21,32,"VOX",460
37,"37037",108,72,72,0,0,"VOX",23
9,"9214",632,409,407,2,2,"VOX",54
24,"24123",709,461,457,2,4,"VOX",67
4,"4072",311,212,211,0,1,"VOX",61
14,"14031",556,462,456,5,6,"VOX",124
37,"37331",186,115,114,2,1,"VOX",30
9,"9380",71,42,41,0,1,"VOX",0
48,"48089",3540,2561,2555,7,6,"VOX",37
18,"18915",726,474,467,4,7,"VOX",59
31,"31064",1398,1035,1031,5,4,"VOX",67
14,"14032",388,302,293,0,9,"VOX",42
25,"25092",125,93,92,0,1,"VOX",0
41,"41001",1558,1129,1104,6,25,"VOX",117
50,"50017",1773,1283,1265,13,18,"VOX",330
24,"24017",532,375,374,1,1,"VOX",59
36,"36008",21845,14553,14373,138,180,"VOX",764
5,"5170",47,34,34,1,0,"VOX",0
37,"37332",65,49,49,0,0,"VOX",5
24,"24018",172,129,128,0,1,"VOX",20
42,"42213",25,17,16,1,1,"VOX",0
48,"48090",6004,4305,4254,28,51,"VOX",87
41,"41002",1421,938,911,7,27,"VOX",125
19,"19294",26,18,18,0,0,"VOX",1
43,"43075",86,65,63,0,2,"VOX",0
50,"50245",74,51,51,0,0,"VOX",10
25,"25093",629,455,443,5,12,"VOX",18
9,"9382",27,22,22,0,0,"VOX",3
50,"50018",883,622,616,5,6,"VOX",100
45,"45065",264,211,206,1,5,"VOX",22
4,"4075",5462,3714,3676,19,38,"VOX",912
19,"19001",43,32,32,0,0,"VOX",2
24,"24019",338,259,256,4,3,"VOX",20
48,"48091",1078,758,757,5,1,"VOX",4
50,"50019",63,46,46,0,0,"VOX",10
28,"28148",89174,65500,64784,566,716,"VOX",12385
6,"6131",1057,809,800,6,9,"VOX",87
36,"36010",2825,1983,1947,19,36,"VOX",111
37,"37240",928,648,637,2,11,"VOX",161
9,"9058",394,286,284,6,2,"VOX",69
5,"5902",286,214,211,1,3,"VOX",28
19,"19296",29,24,24,0,0,"VOX",8
16,"16165",56,45,45,0,0,"VOX",2
5,"5075",96,76,76,0,0,"VOX",16
17,"17006",1178,826,818,9,8,"VOX",23
10,"10041",1022,720,706,2,14,"VOX",114
9,"9386",55,43,43,0,0,"VOX",7
25,"25096",885,597,591,2,6,"VOX",18
19,"19002",55,45,45,0,0,"VOX",4
42,"42216",26,20,20,0,0,"VOX",1
28,"28149",6298,4751,4699,35,52,"VOX",1360
41,"41004",57692,38578,37814,696,764,"VOX",7425
19,"19003",36,30,30,0,0,"VOX",3
37,"37241",167,121,119,3,2,"VOX",25
48,"48093",891,669,666,5,3,"VOX",6
42,"42217",33,25,25,0,0,"VOX",1
45,"45067",2267,1722,1675,14,47,"VOX",292
4,"4077",296,270,268,3,2,"VOX",26
50,"50020",795,548,545,4,3,"VOX",126
5,"5903",137,84,83,0,1,"VOX",14
46,"46119",761,587,580,6,7,"VOX",68
19,"19297",32,28,28,0,0,"VOX",7
31,"31069",823,596,595,1,1,"VOX",28
19,"19109",33,26,26,2,0,"VOX",9
9,"9388",31,26,25,0,1,"VOX",1
41,"41005",9285,6637,6497,83,140,"VOX",1266
16,"16167",288,225,217,0,8,"VOX",39
31,"31070",2633,1714,1682,16,32,"VOX",204
15,"15048",5087,3426,3383,40,43,"VOX",316
4,"4078",1127,725,718,8,7,"VOX",159
5,"5904",108,70,69,5,1,"VOX",8
31,"31179",486,315,312,3,3,"VOX",15
37,"37044",431,309,308,3,1,"VOX",46
24,"24023",264,188,185,1,3,"VOX",42
26,"26015",185,140,138,2,2,"VOX",27
37,"37337",137,104,103,0,1,"VOX",26
49,"49087",476,246,244,0,2,"VOX",36
19,"19004",59,44,44,0,0,"VOX",16
19,"19005",91,63,62,0,1,"VOX",6
4,"4079",54675,35691,35365,328,326,"VOX",10881
5,"5905",214,148,142,1,6,"VOX",16
43,"43001",708,510,507,0,3,"VOX",13
48,"48094",3121,2201,2188,7,13,"VOX",18
48,"48095",2324,1568,1555,13,13,"VOX",11
36,"36016",1069,639,633,5,6,"VOX",39
28,"28152",16986,13444,13366,111,78,"VOX",3192
26,"26129",939,657,644,2,13,"VOX",78
24,"24132",610,330,329,5,1,"VOX",49
10,"10046",184,144,140,0,4,"VOX",25
6,"6138",1021,677,658,5,19,"VOX",64
24,"24133",357,256,256,1,0,"VOX",56
31,"31072",5324,3733,3684,33,49,"VOX",471
19,"19238",43,30,28,0,2,"VOX",10
19,"19112",53,35,34,0,1,"VOX",9
48,"48096",6516,4862,4816,33,46,"VOX",81
26,"26131",34,33,33,0,0,"VOX",2
41,"41007",12488,7657,7421,126,236,"VOX",1264
37,"37245",331,221,220,4,1,"VOX",21
50,"50176",220,142,142,3,0,"VOX",26
37,"37046",10648,7396,7241,62,155,"VOX",1419
5,"5080",42,30,30,0,0,"VOX",4
46,"46053",525,433,428,2,5,"VOX",57
5,"5177",136,117,116,0,1,"VOX",8
37,"37047",215,89,89,0,0,"VOX",4
45,"45072",653,469,462,1,7,"VOX",78
31,"31073",298,207,206,1,1,"VOX",1
36,"36018",3033,1951,1926,9,25,"VOX",114
43,"43002",1890,1233,1210,12,23,"VOX",130
47,"47152",67,59,59,0,0,"VOX",10
48,"48097",1314,886,882,6,4,"VOX",16
19,"19007",433,316,310,1,6,"VOX",59
9,"9395",121,74,74,1,0,"VOX",11
46,"46122",2726,1957,1934,13,23,"VOX",242
36,"36019",1462,916,908,8,8,"VOX",62
45,"45073",288,214,210,2,4,"VOX",18
19,"19302",52,42,42,1,0,"VOX",7
37,"37049",125,76,76,0,0,"VOX",16
37,"37246",5146,3791,3737,42,54,"VOX",595
25,"25101",536,412,411,5,1,"VOX",14
16,"16173",175,128,127,0,1,"VOX",18
43,"43003",349,257,255,3,2,"VOX",20
45,"45074",397,300,293,2,7,"VOX",26
46,"46191",1956,1439,1414,8,25,"VOX",255
37,"37247",171,129,128,0,1,"VOX",39
4,"4083",1727,1265,1250,8,15,"VOX",215
44,"44056",446,327,325,1,2,"VOX",74
29,"29056",1047,708,696,5,12,"VOX",143
38,"38040",5482,3094,3060,14,34,"VOX",424
25,"25194",410,292,289,3,3,"VOX",9
24,"24028",367,275,273,5,2,"VOX",35
19,"19303",41,32,32,0,0,"VOX",6
48,"48901",5160,3705,3684,16,21,"VOX",80
15,"15053",7469,4622,4579,44,43,"VOX",256
37,"37342",250,190,189,3,1,"VOX",36
14,"14041",3113,2234,2160,43,74,"VOX",237
4,"4084",337,238,232,0,6,"VOX",34
50,"50252",5019,3486,3456,53,30,"VOX",571
44,"44059",562,411,407,2,4,"VOX",42
19,"19009",263,186,184,0,2,"VOX",37
41,"41010",4586,3218,3157,42,61,"VOX",547
8,"8277",168,148,146,1,2,"VOX",2
24,"24029",686,430,428,6,2,"VOX",57
6,"6008",615,522,507,2,15,"VOX",56
43,"43005",3677,2505,2493,17,12,"VOX",165
9,"9400",307,225,224,4,1,"VOX",14
36,"36021",12180,8188,8058,115,130,"VOX",698
5,"5083",137,92,91,0,1,"VOX",12
48,"48903",1800,1358,1353,4,5,"VOX",27
19,"19304",224,169,166,3,3,"VOX",52
45,"45076",574,361,357,1,4,"VOX",86
50,"50026",418,292,288,4,4,"VOX",35
6,"6145",900,683,669,7,14,"VOX",92
19,"19116",12,10,10,0,0,"VOX",0
10,"10053",279,171,169,1,2,"VOX",22
9,"9071",39,29,29,1,0,"VOX",10
36,"36022",9046,5834,5720,37,114,"VOX",337
31,"31079",65,46,46,2,0,"VOX",0
24,"24030",4158,2746,2696,18,50,"VOX",271
41,"41012",3375,2259,2214,26,45,"VOX",442
19,"19011",237,165,162,3,3,"VOX",13
14,"14043",7406,5323,5211,63,112,"VOX",908
25,"25104",120,88,88,0,0,"VOX",6
43,"43006",676,462,462,3,0,"VOX",15
24,"24031",207,160,158,0,2,"VOX",16
8,"8279",156327,112605,112030,952,575,"VOX",8649
5,"5182",721,457,436,3,21,"VOX",116
13,"13036",752,552,546,1,6,"VOX",93
45,"45189",633,462,459,7,3,"VOX",134
4,"4087",157,115,113,0,2,"VOX",36
16,"16181",54,40,40,0,0,"VOX",2
24,"24032",99,70,66,1,4,"VOX",13
41,"41013",4836,3174,3124,41,50,"VOX",272
28,"28159",589,455,447,4,8,"VOX",105
48,"48905",2496,1778,1766,12,12,"VOX",21
37,"37251",108,75,75,0,0,"VOX",28
6,"6012",3231,2306,2278,25,28,"VOX",366
36,"36024",16335,11431,11256,99,175,"VOX",939
44,"44062",31,20,20,0,0,"VOX",0
4,"4088",2444,1587,1574,17,13,"VOX",363
31,"31081",338,229,227,1,2,"VOX",1
5,"5086",76,58,58,1,0,"VOX",12
15,"15057",12077,8109,8018,83,91,"VOX",537
6,"6013",261,209,204,4,5,"VOX",6
5,"5184",238,163,160,2,3,"VOX",24
14,"14045",2997,2329,2287,30,42,"VOX",325
31,"31082",627,385,385,5,0,"VOX",11
45,"45080",3,3,3,0,0,"VOX",0
8,"8280",93,76,75,1,1,"VOX",0
27,"27060",2434,1458,1434,17,24,"VOX",86
48,"48906",736,550,548,2,2,"VOX",4
4,"4089",687,484,479,2,5,"VOX",122
24,"24033",209,149,149,0,0,"VOX",31
24,"24034",3466,2382,2359,25,23,"VOX",306
19,"19308",57,49,49,0,0,"VOX",10
37,"37253",135,109,109,1,0,"VOX",17
46,"46128",1569,1216,1179,7,37,"VOX",146
50,"50105",277,203,198,4,5,"VOX",14
28,"28161",52164,38607,38193,306,414,"VOX",10769
25,"25110",2745,1943,1927,13,16,"VOX",55
5,"5088",29,22,22,0,0,"VOX",11
50,"50030",197,124,124,1,0,"VOX",14
16,"16187",55,38,38,3,0,"VOX",5
50,"50055",3635,2298,2244,36,54,"VOX",435
17,"17046",709,537,531,2,6,"VOX",9
45,"45082",1145,904,893,7,11,"VOX",140
17,"17187",625,496,492,3,4,"VOX",9
28,"28162",2784,2143,2131,20,12,"VOX",577
19,"19121",265,205,204,0,1,"VOX",49
12,"12012",2622,2084,2056,12,28,"VOX",246
31,"31084",1946,1367,1362,9,5,"VOX",4
19,"19017",56,47,47,0,0,"VOX",2
48,"48908",250,212,210,1,2,"VOX",0
37,"37254",174,140,135,0,5,"VOX",22
6,"6017",250,202,198,0,4,"VOX",23
50,"50257",159,128,125,2,3,"VOX",10
25,"25203",8809,5813,5770,40,43,"VOX",268
43,"43010",334,262,262,2,0,"VOX",11
8,"8282",6731,5333,5317,40,16,"VOX",198
16,"16188",74,57,57,1,0,"VOX",7
36,"36027",4401,2940,2781,20,159,"VOX",296
28,"28163",429,332,326,0,6,"VOX",60
20,"20069",147446,102068,101696,564,372,"VOX",2857
29,"29063",305,244,242,2,2,"VOX",52
50,"50031",134,78,75,0,3,"VOX",8
14,"14048",1199,883,866,4,17,"VOX",116
43,"43011",1086,862,860,5,2,"VOX",42
4,"4093",1916,1143,1130,5,13,"VOX",349
50,"50032",243,167,164,3,3,"VOX",11
6,"6018",727,483,476,0,7,"VOX",53
28,"28164",3230,2371,2345,28,26,"VOX",700
44,"44066",85,62,62,0,0,"VOX",7
41,"41018",9432,6463,6368,86,95,"VOX",708
19,"19018",142,112,112,1,0,"VOX",41
48,"48909",201,158,157,0,1,"VOX",0
49,"49103",392,319,316,5,3,"VOX",66
31,"31087",179,124,124,3,0,"VOX",3
6,"6156",1170,829,814,12,15,"VOX",104
19,"19019",14,11,11,1,0,"VOX",1
28,"28165",1917,1339,1321,2,18,"VOX",440
37,"37162",212,139,137,3,2,"VOX",33
14,"14049",16185,11561,11323,145,238,"VOX",1640
8,"8284",12597,8244,8183,60,61,"VOX",634
5,"5092",145,111,107,1,4,"VOX",32
9,"9083",26,21,21,0,0,"VOX",3
6,"6020",1752,1330,1296,6,34,"VOX",151
4,"4094",215,156,156,0,0,"VOX",34
37,"37257",51,36,36,1,0,"VOX",7
43,"43012",3700,2882,2858,20,24,"VOX",170
41,"41019",4931,3323,3251,39,72,"VOX",721
43,"43013",4406,3004,2975,19,29,"VOX",163
28,"28166",357,281,276,1,5,"VOX",60
14,"14050",2350,1774,1720,20,54,"VOX",244
6,"6021",898,628,617,16,11,"VOX",88
50,"50033",61,44,44,1,0,"VOX",6
45,"45087",8180,5737,5628,41,109,"VOX",1258
39,"39078",1410,1004,997,5,7,"VOX",162
4,"4095",687,462,457,4,5,"VOX",130
32,"32035",1352,782,768,6,14,"VOX",50
6,"6022",2635,1920,1862,15,58,"VOX",195
50,"50260",35,31,31,0,0,"VOX",0
48,"48911",381,303,302,1,1,"VOX",0
8,"8285",10349,7630,7599,48,31,"VOX",234
28,"28167",8640,6564,6504,51,60,"VOX",1367
50,"50034",767,516,511,10,5,"VOX",83
19,"19317",124,83,82,0,1,"VOX",10
42,"42022",206,147,146,6,1,"VOX",38
19,"19021",978,678,662,3,16,"VOX",200
9,"9417",42,31,31,1,0,"VOX",9
4,"4097",231,173,173,1,0,"VOX",26
22,"22088",143,98,97,1,1,"VOX",8
43,"43093",3863,2728,2716,22,12,"VOX",90
19,"19318",26,18,18,0,0,"VOX",5
8,"8286",2943,2051,2042,12,9,"VOX",197
36,"36032",3527,2407,2369,24,38,"VOX",189
24,"24042",60,47,47,2,0,"VOX",4
45,"45089",1432,1076,1064,10,12,"VOX",192
9,"9418",73,54,51,0,3,"VOX",12
31,"31091",322,201,201,3,0,"VOX",0
49,"49108",446,312,309,2,3,"VOX",44
19,"19022",592,423,420,6,3,"VOX",112
28,"28168",1347,933,918,6,15,"VOX",243
6,"6025",5083,3543,3469,28,74,"VOX",392
10,"10067",10210,7090,6946,62,144,"VOX",1267
20,"20013",5433,3906,3893,24,13,"VOX",32
49,"49221",233,122,120,2,2,"VOX",25
6,"6026",804,578,562,5,16,"VOX",53
9,"9090",49,41,39,2,2,"VOX",3
19,"19319",4609,3303,3273,22,30,"VOX",999
43,"43015",115,92,91,1,1,"VOX",1
4,"4098",1424,890,885,0,5,"VOX",199
14,"14053",5918,4054,3968,92,86,"VOX",462
41,"41050",5173,3954,3878,36,76,"VOX",609
16,"16195",458,343,338,0,5,"VOX",56
41,"41022",4255,2735,2667,32,68,"VOX",265
37,"37067",3278,2568,2529,30,39,"VOX",442
46,"46202",17801,13010,12906,87,104,"VOX",2871
36,"36034",3299,2155,2132,15,23,"VOX",159
6,"6027",645,523,513,0,10,"VOX",80
6,"6902",1651,1198,1174,19,24,"VOX",219
8,"8287",1067,853,844,4,9,"VOX",13
4,"4099",4930,3526,3462,22,64,"VOX",933
26,"26153",10,10,10,1,0,"VOX",0
20,"20076",7013,5011,4991,16,20,"VOX",58
9,"9093",162,131,131,1,0,"VOX",35
19,"19321",34,28,28,0,0,"VOX",4
9,"9422",19,13,13,0,0,"VOX",8
19,"19024",8561,6015,5942,44,73,"VOX",1642
6,"6028",4098,3457,3350,22,107,"VOX",456
4,"4100",9433,5599,5556,48,43,"VOX",1635
6,"6903",2011,1443,1416,18,27,"VOX",252
4,"4101",4356,2818,2768,32,50,"VOX",810
14,"14055",18411,13054,12798,192,256,"VOX",3119
28,"28171",4410,2921,2889,8,32,"VOX",758
49,"49002",58,43,40,0,3,"VOX",1
25,"25210",1073,791,780,3,11,"VOX",21
44,"44075",321,255,252,1,3,"VOX",53
19,"19322",26,20,19,1,1,"VOX",4
43,"43018",384,297,297,2,0,"VOX",8
9,"9424",31,24,23,0,1,"VOX",2
25,"25120",92888,62740,62389,450,351,"VOX",4134
19,"19323",36,26,26,0,0,"VOX",6
41,"41025",2031,1409,1349,11,60,"VOX",268
49,"49003",860,534,530,5,4,"VOX",95
19,"19031",8,8,8,0,0,"VOX",0
9,"9425",472,311,309,3,2,"VOX",19
25,"25121",632,380,374,3,6,"VOX",34
14,"14056",23477,15826,15470,177,356,"VOX",3190
17,"17028",297,216,214,2,2,"VOX",3
28,"28173",523,384,381,1,3,"VOX",100
36,"36037",2538,1650,1625,12,25,"VOX",113
45,"45095",663,496,492,2,4,"VOX",122
4,"4102",14202,9264,9139,57,125,"VOX",3329
31,"31096",99,79,79,3,0,"VOX",0
49,"49037",174,139,136,1,3,"VOX",18
31,"31097",10559,6977,6919,71,58,"VOX",285
6,"6032",80,68,68,1,0,"VOX",15
12,"12102",518,424,417,4,7,"VOX",74
26,"26158",242,184,181,1,3,"VOX",21
50,"50039",462,339,333,1,6,"VOX",41
43,"43098",362,274,274,1,0,"VOX",20
18,"18047",6103,3992,3922,61,70,"VOX",859
42,"42030",91,69,69,2,0,"VOX",13
7,"7003",12521,6457,6381,60,76,"VOX",1162
43,"43019",1332,911,904,8,7,"VOX",34
19,"19032",145,94,93,2,1,"VOX",17
28,"28174",1858,1284,1273,1,11,"VOX",350
45,"45096",987,748,725,9,23,"VOX",130
25,"25122",1929,1408,1398,21,10,"VOX",25
46,"46137",248,201,197,3,4,"VOX",30
24,"24051",389,275,269,1,6,"VOX",35
41,"41100",954,670,635,7,35,"VOX",62
14,"14058",7866,5451,5334,69,117,"VOX",1003
9,"9102",33,22,22,0,0,"VOX",0
4,"4901",490,343,343,2,0,"VOX",80
36,"36039",15609,10562,10341,102,221,"VOX",716
7,"7005",6956,4042,3996,35,46,"VOX",687
37,"37072",144,121,118,5,3,"VOX",37
8,"8291",4972,3531,3519,23,12,"VOX",337
19,"19033",47,38,37,1,1,"VOX",7
9,"9429",53,34,34,1,0,"VOX",11
19,"19326",2463,1671,1650,13,21,"VOX",588
41,"41028",2108,1652,1632,22,20,"VOX",270
19,"19135",90,71,69,1,2,"VOX",10
9,"9430",25,21,21,0,0,"VOX",1
9,"9265",38,31,31,1,0,"VOX",6
29,"29018",2009,1421,1362,17,59,"VOX",237
25,"25216",244,186,186,0,0,"VOX",4
8,"8292",1074,796,790,2,6,"VOX",33
50,"50041",16,10,10,0,0,"VOX",0
41,"41101",6025,4299,4213,53,86,"VOX",708
19,"19034",25,22,21,0,1,"VOX",1
9,"9104",49,35,34,0,1,"VOX",12
20,"20901",1399,960,957,3,3,"VOX",6
49,"49007",361,241,233,7,8,"VOX",25
24,"24053",398,250,248,1,2,"VOX",46
4,"4903",4320,2907,2873,18,34,"VOX",1107
50,"50268",41,32,32,1,0,"VOX",6
19,"19327",385,313,308,2,5,"VOX",135
46,"46139",4520,3486,3457,18,29,"VOX",550
44,"44082",84,66,66,0,0,"VOX",14
16,"16205",106,73,73,1,0,"VOX",13
19,"19136",11,10,10,0,0,"VOX",0
40,"40079",229,160,159,2,1,"VOX",28
6,"6038",785,561,550,5,11,"VOX",91
28,"28177",10851,8550,8485,89,65,"VOX",2227
45,"45100",178,141,138,0,3,"VOX",26
17,"17032",1745,1139,1133,6,6,"VOX",21
46,"46071",471,355,349,1,6,"VOX",25
30,"30040",686,564,560,1,4,"VOX",88
7,"7008",6113,4003,3961,26,42,"VOX",538
5,"5001",182,139,138,1,1,"VOX",25
31,"31102",135,60,60,1,0,"VOX",0
14,"14061",687,536,523,1,13,"VOX",72
8,"8293",227,177,177,0,0,"VOX",2
28,"28178",1149,869,853,4,16,"VOX",268
41,"41030",501,376,366,9,10,"VOX",52
36,"36042",18125,11975,11775,126,200,"VOX",849
37,"37270",184,139,136,2,3,"VOX",30
9,"9109",1072,575,558,0,17,"VOX",65
19,"19330",69,62,62,0,0,"VOX",15
7,"7009",737,495,488,3,7,"VOX",77
24,"24056",2726,1803,1772,21,31,"VOX",207
26,"26165",336,248,242,3,6,"VOX",43
28,"28179",1451,1043,1033,6,10,"VOX",262
8,"8294",2093,1546,1534,11,12,"VOX",81
37,"37176",128,99,98,1,1,"VOX",15
25,"25127",217,145,145,1,0,"VOX",0
29,"29067",431757,290824,287855,3289,2969,"VOX",56349
46,"46004",1932,1530,1512,10,18,"VOX",244
16,"16211",335,228,227,1,1,"VOX",31
19,"19173",47,40,40,0,0,"VOX",9
37,"37365",162,125,121,0,4,"VOX",19
31,"31104",1751,1147,1125,8,22,"VOX",57
50,"50121",270,209,208,3,1,"VOX",35
25,"25219",146,111,111,1,0,"VOX",5
20,"20905",160,123,123,2,0,"VOX",0
37,"37271",349,262,258,2,4,"VOX",54
19,"19142",263,179,179,1,0,"VOX",37
7,"7010",5078,3353,3318,30,35,"VOX",499
50,"50045",1217,891,878,10,13,"VOX",165
24,"24057",1295,909,891,7,18,"VOX",109
5,"5005",165,127,119,0,8,"VOX",28
36,"36044",2527,1535,1499,12,36,"VOX",132
41,"41904",1789,1125,1109,31,16,"VOX",126
42,"42128",45,40,39,2,1,"VOX",0
50,"50198",47,32,32,0,0,"VOX",2
15,"15079",1437,887,868,8,19,"VOX",52
46,"46210",338,256,251,0,5,"VOX",36
49,"49012",70,34,34,0,0,"VOX",9
8,"8020",5243,4117,4100,29,17,"VOX",224
41,"41033",4958,3299,3250,38,49,"VOX",609
36,"36045",24459,16966,16735,124,231,"VOX",990
14,"14064",296,211,208,6,3,"VOX",35
15,"15080",1637,1009,992,11,17,"VOX",62
49,"49013",219,160,159,0,1,"VOX",37
17,"17035",544,447,447,2,0,"VOX",9
28,"28182",203,167,163,1,4,"VOX",39
19,"19040",53,43,42,1,1,"VOX",7
41,"41034",23576,15461,15214,264,247,"VOX",2922
8,"8296",1869,1412,1408,10,4,"VOX",69
9,"9440",80,61,61,0,0,"VOX",9
31,"31107",1671,1204,1182,12,22,"VOX",181
25,"25129",161,113,112,0,1,"VOX",2
42,"42130",51,42,40,1,2,"VOX",7
30,"30901",10556,7862,7775,58,87,"VOX",2004
40,"40084",52,41,41,2,0,"VOX",6
26,"26170",423,303,301,2,2,"VOX",34
19,"19041",163,118,117,1,1,"VOX",14
24,"24169",2777,1908,1880,10,28,"VOX",128
9,"9115",90,65,63,3,2,"VOX",4
16,"16215",237,162,158,1,4,"VOX",24
25,"25130",181,130,128,0,2,"VOX",3
36,"36047",2248,1379,1363,11,16,"VOX",103
16,"16216",272,207,204,0,3,"VOX",24
16,"16018",376,290,290,2,0,"VOX",104
46,"46212",1620,1130,1112,12,18,"VOX",155
50,"50200",479,389,383,5,6,"VOX",52
6,"6047",829,618,605,1,13,"VOX",71
41,"41035",1051,733,722,10,11,"VOX",123
36,"36048",5248,3429,3378,25,51,"VOX",177
12,"12031",3960,2913,2869,13,44,"VOX",599
7,"7014",7885,3934,3893,43,41,"VOX",520
46,"46144",628,483,478,4,5,"VOX",110
16,"16217",91,72,72,0,0,"VOX",16
15,"15082",15446,10821,10687,130,134,"VOX",873
8,"8298",27148,19655,19568,102,87,"VOX",582
28,"28901",890,624,618,5,6,"VOX",129
6,"6048",821,666,653,1,13,"VOX",86
43,"43107",387,285,285,3,0,"VOX",3
41,"41036",3903,2708,2645,35,63,"VOX",214
49,"49125",1392,883,871,11,12,"VOX",185
14,"14067",3842,2863,2800,42,63,"VOX",538
46,"46008",2617,1954,1931,17,23,"VOX",291
44,"44178",52,34,34,0,0,"VOX",3
43,"43108",1787,1293,1282,6,11,"VOX",69
24,"24062",126,79,79,0,0,"VOX",4
19,"19043",99,80,79,0,1,"VOX",15
37,"37276",125,92,92,0,0,"VOX",19
6,"6050",4031,3005,2934,38,71,"VOX",437
31,"31221",1228,823,815,6,8,"VOX",17
19,"19044",275,186,182,0,4,"VOX",21
49,"49017",247,176,176,1,0,"VOX",24
16,"16218",184,134,133,1,1,"VOX",9
6,"6051",1523,1147,1137,5,10,"VOX",210
31,"31222",57,35,34,3,1,"VOX",0
37,"37086",107,86,85,2,1,"VOX",17
9,"9446",10,7,7,0,0,"VOX",0
46,"46214",16637,12113,12014,84,99,"VOX",2130
49,"49018",277,197,190,2,7,"VOX",21
19,"19148",42,29,28,1,1,"VOX",4
10,"10091",351,275,271,2,4,"VOX",40
25,"25133",671,481,479,1,2,"VOX",15
6,"6052",3962,2728,2642,26,86,"VOX",491
31,"31113",130,77,76,0,1,"VOX",1
50,"50051",802,551,550,2,1,"VOX",85
43,"43030",483,356,351,2,5,"VOX",26
22,"22113",478,335,333,6,2,"VOX",42
19,"19045",122,97,96,0,1,"VOX",34
25,"25225",531,395,393,0,2,"VOX",9
43,"43031",1447,1085,1072,13,13,"VOX",42
28,"28019",1272,926,914,6,12,"VOX",214
39,"39097",666,342,335,2,7,"VOX",61
16,"16100",642,518,514,2,4,"VOX",81
36,"36051",14358,9408,9255,86,153,"VOX",820
5,"5116",96,68,68,0,0,"VOX",13
10,"10093",387,278,253,4,25,"VOX",21
45,"45112",1844,1121,1086,8,35,"VOX",268
5,"5016",6355,4677,4584,28,93,"VOX",1053
45,"45113",1770,1189,1171,5,18,"VOX",323
8,"8301",49348,36261,36045,292,216,"VOX",3148
14,"14070",1280,911,902,4,9,"VOX",123
46,"46147",17186,11507,11399,72,108,"VOX",2338
19,"19046",22204,16001,15752,156,249,"VOX",3676
49,"49020",253,189,187,0,2,"VOX",26
41,"41040",11183,8351,8253,71,98,"VOX",2064
9,"9449",91,78,76,1,2,"VOX",0
43,"43032",462,354,350,2,4,"VOX",14
49,"49130",155,116,112,1,4,"VOX",14
21,"21006",3321,2197,2125,19,72,"VOX",251
25,"25227",656,476,476,2,0,"VOX",5
5,"5118",64,41,41,1,0,"VOX",4
6,"6055",1976,1343,1313,11,30,"VOX",195
31,"31115",159,93,93,2,0,"VOX",1
49,"49021",14204,9429,9295,87,134,"VOX",1723
17,"17042",410,299,297,5,2,"VOX",14
40,"40126",67,44,42,0,2,"VOX",5
6,"6056",447,351,340,2,11,"VOX",49
9,"9450",23,18,18,1,0,"VOX",0
20,"20004",230,133,133,2,0,"VOX",0
5,"5017",84,70,67,2,3,"VOX",9
24,"24067",602,327,324,6,3,"VOX",79
41,"41041",9765,7172,6943,63,229,"VOX",1456
14,"14072",983,692,680,6,12,"VOX",53
31,"31117",583,373,372,3,1,"VOX",3
19,"19048",19,14,13,1,1,"VOX",2
6,"6057",530,409,400,0,9,"VOX",67
43,"43033",766,555,555,4,0,"VOX",28
37,"37375",678,539,523,8,16,"VOX",48
14,"14073",2768,1934,1880,33,54,"VOX",306
5,"5018",23,17,17,2,0,"VOX",1
16,"16103",235,183,181,2,2,"VOX",49
5,"5119",24,17,17,1,0,"VOX",1
19,"19153",22,20,20,2,0,"VOX",1
37,"37022",242,191,190,0,1,"VOX",45
37,"37376",2130,1446,1423,18,23,"VOX",269
25,"25230",1541,1105,1099,9,6,"VOX",43
31,"31118",156,104,104,3,0,"VOX",0
9,"9130",64,39,39,2,0,"VOX",6
6,"6059",1724,1084,1067,6,17,"VOX",116
36,"36055",13585,9177,8986,115,191,"VOX",835
5,"5019",44865,32917,32586,282,331,"VOX",6309
8,"8303",257,207,205,1,2,"VOX",5
49,"49023",899,627,620,3,7,"VOX",137
41,"41042",5872,4477,4424,42,53,"VOX",384
24,"24179",287,207,207,2,0,"VOX",18
46,"46013",17761,13652,13548,144,104,"VOX",2387
5,"5021",1861,1323,1304,22,19,"VOX",177
9,"9455",45,34,33,0,1,"VOX",13
49,"49024",626,432,426,3,6,"VOX",77
41,"41043",669,447,436,11,11,"VOX",61
9,"9456",130,86,86,1,0,"VOX",11
49,"49134",158,100,99,1,1,"VOX",13
10,"10099",563,369,358,3,11,"VOX",68
25,"25231",483,387,385,0,2,"VOX",12
25,"25907",500,366,364,5,2,"VOX",10
5,"5185",96,63,61,1,2,"VOX",16
37,"37096",203,144,144,2,0,"VOX",20
42,"42016",20,13,13,0,0,"VOX",2
6,"6061",1074,829,819,5,10,"VOX",62
49,"49025",157,121,118,0,3,"VOX",16
41,"41044",7753,5636,5547,55,89,"VOX",1135
37,"37190",189,141,139,1,2,"VOX",13
24,"24181",1404,944,925,7,19,"VOX",168
10,"10101",178,129,125,0,4,"VOX",15
16,"16237",98,82,82,1,0,"VOX",16
19,"19051",61,52,52,0,0,"VOX",2
20,"20008",713,424,424,5,0,"VOX",1
14,"14901",932,753,750,6,3,"VOX",37
6,"6062",564,394,391,0,3,"VOX",80
49,"49026",199,134,134,0,0,"VOX",13
37,"37097",42,29,29,0,0,"VOX",2
29,"29081",250,185,182,2,3,"VOX",56
21,"21011",3500,2371,2314,23,57,"VOX",299
45,"45009",455,277,274,2,3,"VOX",61
31,"31232",25687,17548,17304,243,244,"VOX",2223
9,"9463",246,174,174,4,0,"VOX",28
16,"16108",44,35,34,1,1,"VOX",6
50,"50134",120,85,82,4,3,"VOX",19
8,"8306",535,368,368,5,0,"VOX",20
20,"20009",11369,7402,7355,32,47,"VOX",110
19,"19052",21,16,16,0,0,"VOX",0
9,"9135",41,28,28,0,0,"VOX",6
5,"5024",193,127,125,2,2,"VOX",22
24,"24074",97,70,70,1,0,"VOX",13
45,"45121",7345,4949,4899,24,50,"VOX",1692
9,"9464",33,24,24,0,0,"VOX",10
41,"41046",3005,2241,2198,11,43,"VOX",207
31,"31123",615,350,347,4,3,"VOX",8
43,"43037",18216,11749,11672,70,77,"VOX",1126
5,"5124",87,67,67,2,0,"VOX",8
10,"10104",5123,3470,3396,21,74,"VOX",706
12,"12902",2250,1557,1532,16,25,"VOX",369
43,"43117",147,119,119,0,0,"VOX",2
49,"49028",108,90,89,1,1,"VOX",13
37,"37287",297,204,202,2,2,"VOX",52
5,"5125",56,47,46,0,1,"VOX",6
16,"16240",98,71,69,0,2,"VOX",9
15,"15001",4697,3069,3022,45,47,"VOX",278
41,"41047",10449,7884,7770,119,114,"VOX",1414
50,"50058",63,45,43,0,2,"VOX",7
50,"50135",85,59,59,0,0,"VOX",6
22,"22023",385,293,283,2,10,"VOX",44
49,"49029",609,435,419,6,16,"VOX",96
31,"31235",156,112,108,1,4,"VOX",3
37,"37382",162,127,124,0,3,"VOX",7
46,"46222",402,329,326,0,3,"VOX",37
5,"5126",60,47,45,0,2,"VOX",6
8,"8169",48478,35283,35114,278,169,"VOX",2580
24,"24077",212,166,162,0,4,"VOX",16
19,"19160",883,535,530,11,5,"VOX",179
6,"6068",427,298,294,5,4,"VOX",45
15,"15002",24040,16302,16117,183,185,"VOX",1403
31,"31125",271,173,171,3,2,"VOX",4
49,"49030",79,56,56,0,0,"VOX",13
9,"9471",140,108,107,1,1,"VOX",9
16,"16242",300,245,243,2,2,"VOX",32
46,"46155",972,731,716,3,15,"VOX",91
38,"38025",7065,4657,4590,34,67,"VOX",832
44,"44131",26,22,22,0,0,"VOX",0
46,"46018",562,442,436,2,6,"VOX",77
6,"6069",2985,1921,1874,17,47,"VOX",264
20,"20012",149,104,104,1,0,"VOX",0
24,"24079",861,601,595,9,6,"VOX",112
49,"49031",148,107,105,2,2,"VOX",14
43,"43040",325,268,267,1,1,"VOX",6
9,"9140",117,78,77,1,1,"VOX",6
16,"16243",376,316,309,4,7,"VOX",53
37,"37290",130,106,106,0,0,"VOX",15
12,"12044",442,371,368,1,3,"VOX",41
5,"5029",100,73,73,1,0,"VOX",10
5,"5128",339,258,253,5,5,"VOX",47
45,"45126",234,146,144,2,2,"VOX",27
37,"37102",375,260,260,4,0,"VOX",61
19,"19162",67,41,41,0,0,"VOX",10
25,"25145",75,59,59,0,0,"VOX",0
10,"10027",77,62,62,0,0,"VOX",5
15,"15004",4924,3333,3292,38,41,"VOX",240
46,"46019",8932,6721,6647,40,74,"VOX",1046
36,"36902",5028,3453,3396,19,57,"VOX",231
10,"10109",1714,1030,1006,4,24,"VOX",148
31,"31238",119,96,95,4,1,"VOX",1
31,"31128",349,217,215,4,2,"VOX",2
20,"20014",1161,699,693,0,6,"VOX",3
15,"15036",56053,36487,36175,501,312,"VOX",3152
37,"37291",269,186,185,1,1,"VOX",47
16,"16245",396,304,298,1,6,"VOX",55
24,"24189",5872,3915,3873,42,42,"VOX",958
19,"19058",7458,5705,5663,40,42,"VOX",1418
49,"49033",655,440,434,4,6,"VOX",64
10,"10110",2226,1431,1400,7,31,"VOX",324
22,"22028",358,237,233,1,4,"VOX",25
5,"5030",40,32,32,0,0,"VOX",0
25,"25146",223,158,155,3,3,"VOX",2
8,"8902",3941,2974,2962,16,12,"VOX",203
15,"15006",5159,3008,2960,44,48,"VOX",183
50,"50062",1885,1332,1308,15,24,"VOX",249
37,"37292",91,65,65,0,0,"VOX",10
5,"5033",169,135,134,0,1,"VOX",15
6,"6074",4720,3355,3271,24,84,"VOX",420
41,"41051",2317,1715,1688,4,27,"VOX",308
16,"16246",451,327,322,1,5,"VOX",51
19,"19059",73,47,47,0,0,"VOX",8
37,"37293",102,68,68,1,0,"VOX",14
8,"8903",201,181,181,1,0,"VOX",0
47,"47012",100,72,71,0,1,"VOX",14
17,"17054",342,250,250,2,0,"VOX",19
43,"43043",3317,2457,2445,12,12,"VOX",236
5,"5131",96,64,64,1,0,"VOX",22
37,"37106",248,161,160,4,1,"VOX",34
17,"17055",142,124,124,0,0,"VOX",1
10,"10113",2231,1534,1508,14,26,"VOX",185
41,"41052",3032,2162,2092,6,70,"VOX",264
45,"45130",294,222,222,1,0,"VOX",41
49,"49147",250,164,162,1,2,"VOX",39
15,"15007",3164,2081,2060,24,21,"VOX",127
37,"37294",11750,8395,8280,88,115,"VOX",1530
19,"19060",157,123,122,0,1,"VOX",11
37,"37003",104,75,75,2,0,"VOX",11
49,"49259",79,59,59,0,0,"VOX",10
19,"19167",129,104,103,1,1,"VOX",42
31,"31132",147,100,100,2,0,"VOX",8
42,"42162",2298,1493,1462,18,31,"VOX",177
49,"49148",259,119,115,1,4,"VOX",29
37,"37004",25,18,18,0,0,"VOX",2
16,"16249",1938,1422,1406,6,16,"VOX",218
31,"31243",300,216,213,6,3,"VOX",3
46,"46227",893,687,675,6,12,"VOX",88
42,"42069",1483,896,878,2,18,"VOX",101
46,"46159",23038,16719,16596,127,123,"VOX",3021
6,"6078",500,363,359,1,4,"VOX",33
9,"9485",55,41,41,0,0,"VOX",9
43,"43045",143,114,113,0,1,"VOX",0
42,"42029",131,94,94,4,0,"VOX",11
29,"29016",253,196,194,0,2,"VOX",41
37,"37005",65,44,44,1,0,"VOX",2
49,"49078",138,113,109,4,4,"VOX",11
10,"10115",3460,2584,2503,15,81,"VOX",338
31,"31134",172,106,106,1,0,"VOX",7
5,"5036",118,91,90,0,1,"VOX",24
6,"6079",649,451,445,3,6,"VOX",91
25,"25150",167,132,130,2,2,"VOX",11
21,"21022",187,121,116,0,5,"VOX",21
5,"5037",210,135,135,0,0,"VOX",18
24,"24087",582,431,427,3,4,"VOX",104
7,"7037",3448,1875,1856,18,19,"VOX",208
29,"29091",9490,6428,6304,61,124,"VOX",1417
25,"25247",142,89,89,2,0,"VOX",18
9,"9902",439,334,326,10,8,"VOX",47
37,"37297",394,298,297,0,1,"VOX",63
37,"37298",170,109,109,0,0,"VOX",24
37,"37006",116,71,70,3,1,"VOX",14
20,"20020",114,64,64,0,0,"VOX",0
6,"6080",1898,1336,1307,6,29,"VOX",180
5,"5038",114,83,82,0,1,"VOX",23
19,"19169",30,27,27,0,0,"VOX",6
50,"50066",2903,2095,2078,19,17,"VOX",634
29,"29092",576,375,366,7,9,"VOX",51
45,"45135",4152,3118,3066,21,52,"VOX",475
21,"21024",464,328,312,1,16,"VOX",29
17,"17003",103,85,85,0,0,"VOX",1
40,"40111",50,39,39,0,0,"VOX",11
37,"37007",391,289,281,7,8,"VOX",65
31,"31136",461,294,293,3,1,"VOX",14
31,"31137",198,83,83,1,0,"VOX",3
37,"37204",253,176,173,2,3,"VOX",33
38,"38008",5699,3719,3669,26,50,"VOX",279
9,"9904",464,344,339,3,5,"VOX",67
29,"29093",2150,1543,1520,8,23,"VOX",235
6,"6082",399,295,291,6,4,"VOX",40
29,"29019",853,604,588,2,16,"VOX",100
21,"21025",3886,2489,2431,31,58,"VOX",405
20,"20021",185,104,104,2,0,"VOX",1
5,"5039",47,43,43,0,0,"VOX",5
46,"46230",14116,10038,9946,63,92,"VOX",1731
49,"49041",409,287,282,1,5,"VOX",43
25,"25153",190,139,136,0,3,"VOX",7
46,"46162",1168,839,832,3,7,"VOX",205
46,"46026",1220,974,965,7,9,"VOX",132
29,"29094",59795,39350,38854,454,496,"VOX",9706
10,"10120",153,97,97,0,0,"VOX",11
45,"45137",1541,1007,998,8,9,"VOX",214
24,"24090",323,200,200,2,0,"VOX",27
37,"37300",540,355,352,7,3,"VOX",42
9,"9906",1185,883,877,16,6,"VOX",201
24,"24091",575,368,362,5,6,"VOX",50
5,"5040",64,47,46,0,1,"VOX",7
12,"12053",2040,1587,1579,8,8,"VOX",258
49,"49042",229,166,164,2,2,"VOX",27
41,"41058",17956,12890,12553,200,337,"VOX",2401
9,"9907",1526,1140,1119,18,21,"VOX",280
5,"5041",984,743,732,5,11,"VOX",142
6,"6085",3429,2439,2382,21,57,"VOX",296
9,"9328",70,37,37,3,0,"VOX",4
19,"19070",65,45,45,0,0,"VOX",10
16,"16013",26,24,24,0,0,"VOX",1
7,"7042",10846,6354,6299,77,55,"VOX",611
42,"42036",40,33,32,1,1,"VOX",3
41,"41059",35358,26408,26052,346,356,"VOX",4550
37,"37114",74,58,55,1,3,"VOX",7
15,"15014",3836,2191,2158,27,33,"VOX",205
27,"27017",952,568,562,3,6,"VOX",16
19,"19071",8277,5838,5763,53,75,"VOX",1704
37,"37115",108,67,65,0,2,"VOX",22
21,"21027",49,32,32,0,0,"VOX",11
43,"43076",454,336,335,1,1,"VOX",8
10,"10001",287,207,203,2,4,"VOX",31
6,"6087",1999,1472,1455,13,17,"VOX",269
49,"49155",81,60,59,0,1,"VOX",8
31,"31251",3144,2197,2164,18,33,"VOX",135
37,"37011",100,78,78,3,0,"VOX",7
43,"43130",169,131,130,2,1,"VOX",0
41,"41060",15058,10551,10302,122,249,"VOX",1982
9,"9167",53,36,36,0,0,"VOX",10
50,"50148",304,213,211,2,2,"VOX",21
6,"6088",12527,8326,8198,89,128,"VOX",1501
21,"21028",370,265,259,2,6,"VOX",28
49,"49046",246,174,169,0,5,"VOX",29
20,"20025",1110,791,788,4,3,"VOX",2
41,"41061",2141,1661,1621,7,40,"VOX",125
45,"45141",848,626,615,0,11,"VOX",114
19,"19073",16,15,15,1,0,"VOX",5
15,"15016",4558,2747,2705,16,42,"VOX",264
16,"16263",967,724,721,3,3,"VOX",106
19,"19175",29,18,17,1,1,"VOX",1
42,"42038",33,22,22,1,0,"VOX",1
20,"20026",207,172,171,4,1,"VOX",0
25,"25156",765,571,567,3,4,"VOX",20
46,"46166",8214,6093,6031,38,62,"VOX",1025
49,"49047",98,74,72,1,2,"VOX",19
45,"45142",7792,5717,5624,62,93,"VOX",1150
24,"24095",317,228,228,3,0,"VOX",65
37,"37013",104,72,70,2,2,"VOX",20
12,"12057",572,456,437,1,19,"VOX",44
42,"42039",216,144,141,1,3,"VOX",21
31,"31034",31,24,24,0,0,"VOX",0
5,"5239",215,163,163,3,0,"VOX",48
9,"9016",85,54,54,0,0,"VOX",6
37,"37014",1140,747,737,7,10,"VOX",90
43,"43053",186,135,134,0,1,"VOX",5
29,"29099",969,688,669,11,19,"VOX",132
45,"45143",1192,877,865,9,12,"VOX",163
6,"6092",558,438,426,2,12,"VOX",85
46,"46029",20448,14673,14556,99,117,"VOX",3593
31,"31145",160,121,120,2,1,"VOX",10
42,"42177",61,42,41,0,1,"VOX",1
50,"50072",183,131,129,0,2,"VOX",30
19,"19075",58,38,37,3,1,"VOX",5
45,"45144",736,562,557,1,5,"VOX",86
37,"37338",77,58,58,0,0,"VOX",10
22,"22186",189,148,145,3,3,"VOX",9
43,"43079",364,290,289,2,1,"VOX",18
6,"6093",4325,3176,3073,26,103,"VOX",684
27,"27021",1632,962,935,23,27,"VOX",74
49,"49050",498,305,305,2,0,"VOX",59
24,"24097",200,138,137,1,1,"VOX",18
49,"49160",42,27,27,0,0,"VOX",2
9,"9018",24624,17232,16983,192,249,"VOX",2468
10,"10006",1224,907,893,7,14,"VOX",133
31,"31146",30,22,22,1,0,"VOX",0
12,"12135",36287,25912,25655,184,257,"VOX",4886
46,"46167",342,240,239,0,1,"VOX",38
44,"44120",219,147,145,3,2,"VOX",16
29,"29026",1021,703,698,15,5,"VOX",109
45,"45035",286,206,204,2,2,"VOX",36
45,"45145",2631,1746,1707,12,39,"VOX",518
20,"20029",4264,3116,3104,14,12,"VOX",30
6,"6095",9506,6616,6425,109,191,"VOX",895
19,"19178",27,17,16,0,1,"VOX",3
7,"7049",1479,935,918,5,17,"VOX",137
50,"50073",2122,1559,1540,14,19,"VOX",289
38,"38015",4055,2635,2601,16,34,"VOX",322
42,"42181",384,281,278,3,3,"VOX",18
28,"28047",42984,30772,30486,270,286,"VOX",6097
20,"20030",21147,14598,14521,92,77,"VOX",204
41,"41065",22527,14684,14463,205,221,"VOX",2104
42,"42044",53,37,35,1,2,"VOX",2
9,"9020",233,170,166,3,4,"VOX",18
31,"31148",92,62,59,2,3,"VOX",2
45,"45147",592,449,443,2,6,"VOX",114
25,"25901",289,214,211,4,3,"VOX",4
9,"9176",58,46,45,2,1,"VOX",6
37,"37017",226,169,168,4,1,"VOX",35
49,"49054",847,576,569,8,7,"VOX",112
6,"6097",2258,1631,1602,10,29,"VOX",188
46,"46237",7172,5199,5146,53,53,"VOX",888
46,"46101",819,670,663,8,7,"VOX",57
24,"24213",158,127,126,1,1,"VOX",25
9,"9021",50,30,30,3,0,"VOX",1
42,"42183",102,74,74,1,0,"VOX",7
46,"46169",32403,23890,23698,222,192,"VOX",4101
49,"49164",141,95,92,1,3,"VOX",12
49,"49055",91,72,72,3,0,"VOX",21
43,"43136",10489,7029,6996,47,33,"VOX",245
12,"12061",374,263,261,4,2,"VOX",21
19,"19270",14,13,13,0,0,"VOX",3
9,"9022",58,46,46,1,0,"VOX",7
19,"19080",67,47,47,0,0,"VOX",7
31,"31150",200,120,119,1,1,"VOX",3
15,"15023",6277,4021,3968,34,53,"VOX",339
16,"16273",300,214,211,3,3,"VOX",66
6,"6099",1156,683,652,5,31,"VOX",97
19,"19081",27,21,21,0,0,"VOX",0
5,"5051",157,117,115,1,2,"VOX",17
22,"22155",66,52,52,0,0,"VOX",7
49,"49056",285,191,190,3,1,"VOX",34
20,"20033",858,644,638,1,6,"VOX",7
29,"29904",418,328,322,1,6,"VOX",11
24,"24102",587,403,399,7,4,"VOX",46
31,"31042",2707,1926,1900,11,26,"VOX",170
43,"43058",95,78,78,0,0,"VOX",3
49,"49166",1193,835,821,7,14,"VOX",99
44,"44032",17,13,13,0,0,"VOX",0
31,"31152",1255,826,817,8,9,"VOX",49
37,"37020",431,320,314,3,6,"VOX",43
42,"42049",108,71,71,1,0,"VOX",7
31,"31262",234,190,188,0,2,"VOX",5
46,"46034",1826,1345,1335,3,10,"VOX",232
6,"6101",437,355,346,1,9,"VOX",30
9,"9072",331,261,260,4,1,"VOX",48
44,"44211",33,22,22,0,0,"VOX",1
28,"28126",50,36,36,0,0,"VOX",8
10,"10014",1816,1285,1254,13,31,"VOX",236
21,"21037",462,320,313,1,7,"VOX",30
20,"20034",3200,2193,2180,8,13,"VOX",17
5,"5053",76,48,48,0,0,"VOX",9
50,"50077",201,140,140,1,0,"VOX",15
37,"37021",66,45,44,0,1,"VOX",9
9,"9181",276,194,191,7,3,"VOX",36
31,"31263",231,137,137,1,0,"VOX",2
16,"16275",12,12,12,1,0,"VOX",0
15,"15025",986,529,517,6,12,"VOX",31
9,"9182",74,54,54,0,0,"VOX",4
16,"16027",691,500,495,1,5,"VOX",122
49,"49058",301,222,221,1,1,"VOX",56
19,"19184",59,47,47,0,0,"VOX",6
49,"49059",84,61,58,0,3,"VOX",23
42,"42094",596,448,436,9,12,"VOX",80
17,"17073",1939,1649,1640,11,9,"VOX",42
9,"9027",47,38,34,1,4,"VOX",3
25,"25168",496,399,399,6,0,"VOX",16
29,"29032",6655,4900,4775,36,125,"VOX",735
31,"31154",217,107,104,0,3,"VOX",1
15,"15027",1563,1159,1140,23,19,"VOX",110
14,"14017",10953,7929,7791,84,138,"VOX",1435
42,"42190",94,61,61,1,0,"VOX",5
49,"49061",143,98,97,1,1,"VOX",14
21,"21039",303,211,210,6,1,"VOX",27
9,"9029",151,111,108,2,3,"VOX",18
41,"41071",5571,3608,3516,64,92,"VOX",438
5,"5055",532,417,413,3,4,"VOX",57
19,"19087",17,16,16,0,0,"VOX",6
9,"9030",116,81,81,1,0,"VOX",10
10,"10017",775,554,545,1,9,"VOX",94
21,"21040",3193,2219,2123,32,96,"VOX",423
46,"46173",1309,1029,1010,13,19,"VOX",152
37,"37316",711,546,541,7,5,"VOX",129
20,"20037",101,69,69,0,0,"VOX",0
19,"19120",107,86,86,1,0,"VOX",22
5,"5121",263,194,189,1,5,"VOX",15
10,"10058",979,628,599,6,29,"VOX",127
16,"16146",85,49,49,0,0,"VOX",3
45,"45155",311,240,240,0,0,"VOX",44
16,"16278",61,45,45,0,0,"VOX",8
10,"10018",1605,974,948,16,26,"VOX",190
5,"5056",91,71,70,0,1,"VOX",21
8,"8120",7129,5649,5621,51,28,"VOX",264
16,"16279",173,109,108,0,1,"VOX",39
42,"42055",158,113,113,1,0,"VOX",13
41,"41072",4031,2969,2933,15,36,"VOX",251
46,"46174",942,746,736,1,10,"VOX",105
49,"49063",303,228,227,3,1,"VOX",35
5,"5156",242,145,145,1,0,"VOX",36
43,"43062",269,229,226,5,3,"VOX",13
37,"37317",287,211,209,1,2,"VOX",29
6,"6108",2238,1524,1478,15,46,"VOX",232
9,"9033",80,64,63,1,1,"VOX",5
10,"10142",833,555,539,0,16,"VOX",52
16,"16280",163,122,119,2,3,"VOX",6
16,"16032",284,220,220,1,0,"VOX",27
9,"9034",291,227,224,1,3,"VOX",27
16,"16148",544,452,451,2,1,"VOX",79
38,"38023",126137,79423,78706,605,717,"VOX",7742
29,"29036",614,393,387,1,6,"VOX",58
49,"49064",478,297,296,6,1,"VOX",66
41,"41073",1684,1100,1074,7,26,"VOX",162
46,"46175",429,362,355,3,7,"VOX",51
16,"16901",624,443,438,5,5,"VOX",72
5,"5058",71,45,43,0,2,"VOX",6
20,"20040",15771,10549,10481,54,68,"VOX",121
37,"37319",88,68,64,2,4,"VOX",12
15,"15031",23868,16113,15954,207,159,"VOX",1449
37,"37026",180,148,147,5,1,"VOX",42
44,"44129",35,29,29,1,0,"VOX",3
7,"7060",2713,1796,1772,17,24,"VOX",216
25,"25204",1187,858,849,13,9,"VOX",40
37,"37131",175,125,125,0,0,"VOX",33
46,"46244",59910,42120,41826,338,294,"VOX",8727
50,"50161",98,75,74,2,1,"VOX",19
5,"5158",346,263,261,0,2,"VOX",54
40,"40034",74,59,58,0,1,"VOX",9
37,"37320",85,65,64,1,1,"VOX",18
15,"15032",3430,2243,2197,12,46,"VOX",174
27,"27034",1010,565,558,3,7,"VOX",53
31,"31161",350,261,256,1,5,"VOX",5
43,"43065",379,281,277,4,4,"VOX",7
39,"39049",304,198,195,2,3,"VOX",42
17,"17078",335,245,245,0,0,"VOX",0
23,"23002",17427,12837,12542,126,295,"VOX",2497
7,"7061",9451,5735,5666,60,69,"VOX",695
16,"16150",98,66,66,2,0,"VOX",1
46,"46040",993,745,733,3,12,"VOX",88
42,"42059",20,14,14,0,0,"VOX",4
19,"19092",395,286,279,2,7,"VOX",74
9,"9037",105,94,93,0,1,"VOX",11
37,"37028",131,96,93,2,3,"VOX",9
14,"14023",1999,1629,1593,11,36,"VOX",236
11,"11033",21804,13361,13133,213,228,"VOX",3161
50,"50083",81,64,64,2,0,"VOX",8
24,"24113",346,240,240,2,0,"VOX",30
37,"37133",101,73,69,1,4,"VOX",16
19,"19125",45,23,23,0,0,"VOX",5
17,"17106",142,114,114,0,0,"VOX",0
24,"24226",194,118,118,1,0,"VOX",24
37,"37321",150,118,115,0,3,"VOX",14
41,"41077",8631,5788,5598,51,190,"VOX",856
9,"9039",54,38,37,0,1,"VOX",9
37,"37029",186,125,124,1,1,"VOX",27
45,"45162",630,448,438,1,10,"VOX",67
47,"47135",82,65,65,3,0,"VOX",8
49,"49068",422,263,261,4,2,"VOX",37
29,"29039",2759,1900,1860,23,40,"VOX",271
19,"19192",1762,1251,1240,5,11,"VOX",391
37,"37030",82,60,60,0,0,"VOX",7
46,"46178",5001,3513,3477,26,36,"VOX",965
15,"15035",11189,7256,7165,104,91,"VOX",431
23,"23005",29876,20565,20268,254,297,"VOX",4734
32,"32001",5100,3377,3333,32,44,"VOX",203
43,"43067",526,426,424,3,2,"VOX",6
32,"32038",387,253,251,4,2,"VOX",12
50,"50111",181,130,130,1,0,"VOX",30
9,"9199",91,68,68,0,0,"VOX",19
32,"32002",2028,1349,1340,4,9,"VOX",124
50,"50085",182,121,121,0,0,"VOX",26
20,"20044",355,261,261,1,0,"VOX",3
13,"13006",552,411,406,0,5,"VOX",55
9,"9419",67,52,49,0,3,"VOX",7
6,"6901",2125,1549,1520,28,29,"VOX",282
37,"37323",474,335,325,5,10,"VOX",95
49,"49071",716,432,429,6,3,"VOX",77
19,"19097",14,14,13,0,1,"VOX",1
5,"5063",31,26,26,0,0,"VOX",2
27,"27039",4467,3179,3121,47,58,"VOX",296
46,"46179",2136,1624,1596,17,28,"VOX",338
22,"22170",672,460,456,5,4,"VOX",68
45,"45091",376,270,269,3,1,"VOX",54
20,"20045",47031,30933,30787,172,146,"VOX",1251
9,"9044",55,46,44,1,2,"VOX",6
29,"29041",3697,2406,2361,47,45,"VOX",555
16,"16908",166,133,132,2,1,"VOX",21
37,"37324",333,247,242,3,5,"VOX",41
50,"50086",176,106,102,1,4,"VOX",6
41,"41079",9285,6591,6446,101,145,"VOX",1195
37,"37032",553,388,388,2,0,"VOX",109
43,"43069",183,148,147,2,1,"VOX",6
25,"25085",141,109,108,2,1,"VOX",6
5,"5065",452,339,337,2,2,"VOX",68
49,"49075",130,100,97,1,3,"VOX",14
45,"45056",2341,1315,1295,11,20,"VOX",405
8,"8127",2254,1548,1544,10,4,"VOX",103
20,"20047",455,314,314,1,0,"VOX",1
37,"37033",94,67,67,0,0,"VOX",19
50,"50903",2268,1685,1670,16,15,"VOX",339
19,"19099",286,179,175,1,4,"VOX",19
21,"21050",12567,8522,8392,89,130,"VOX",2151
31,"31168",238,176,174,1,2,"VOX",9
37,"37327",179,148,147,2,1,"VOX",22
23,"23008",1422,1042,1020,9,22,"VOX",153
6,"6121",3276,2301,2256,30,45,"VOX",455
5,"5066",435,344,341,2,3,"VOX",51
44,"44223",73,48,48,0,0,"VOX",5
6,"6122",6535,4204,4110,47,94,"VOX",607
10,"10031",162,128,124,0,4,"VOX",12
43,"43149",690,512,509,3,3,"VOX",34
24,"24119",695,464,458,7,6,"VOX",60
19,"19102",88,75,73,0,2,"VOX",25
37,"37328",159,112,110,1,2,"VOX",12
10,"10154",177,117,116,0,1,"VOX",9
43,"43070",243,194,193,0,1,"VOX",3
5,"5263",162,117,115,1,2,"VOX",38
10,"10155",1073,735,717,6,18,"VOX",103
25,"25056",209,145,145,0,0,"VOX",3
20,"20048",183,112,112,0,0,"VOX",0
6,"6123",4502,2989,2894,29,95,"VOX",379
32,"32007",1413,873,862,2,11,"VOX",43
30,"30012",9085,6704,6599,46,105,"VOX",1018
17,"17084",228,163,162,1,1,"VOX",2
27,"27043",1222,746,737,12,9,"VOX",57
46,"46182",1312,908,904,5,4,"VOX",161
28,"28005",136518,101397,100485,871,912,"VOX",19342
10,"10033",397,269,268,0,1,"VOX",75
19,"19289",23,16,16,0,0,"VOX",5
41,"41082",3354,2545,2507,11,38,"VOX",418
5,"5069",73,59,59,0,0,"VOX",5
9,"9050",57,38,38,1,0,"VOX",6
31,"31171",670,466,462,1,4,"VOX",9
50,"50089",8616,6420,6364,50,56,"VOX",1876
41,"41083",1145,821,814,6,7,"VOX",122
5,"5167",223,177,172,0,5,"VOX",4
42,"42071",159,92,92,2,0,"VOX",8
49,"49079",104,79,76,0,3,"VOX",22
37,"37036",55,36,34,0,2,"VOX",2
46,"46046",901,623,609,2,14,"VOX",119
50,"50090",134,96,96,0,0,"VOX",19
10,"10035",1798,1201,1171,8,30,"VOX",103
20,"20050",275,174,174,2,0,"VOX",1
19,"19198",17,14,14,0,0,"VOX",2
37,"37330",314,227,223,2,4,"VOX",60
6,"6126",2121,1443,1429,14,14,"VOX",242
31,"31172",370,257,250,6,7,"VOX",6
10,"10036",304,194,192,4,2,"VOX",17
8,"8062",1009,778,776,9,2,"VOX",47
25,"25182",1043,763,760,8,3,"VOX",50
16,"16253",308,230,228,2,2,"VOX",64
45,"45171",1329,958,940,4,18,"VOX",230
11,"11042",1158,806,793,6,13,"VOX",167
6,"6127",2809,2105,2074,9,31,"VOX",362
16,"16161",51,44,44,1,0,"VOX",2
5,"5072",92,74,72,1,2,"VOX",22
22,"22176",171,140,138,2,2,"VOX",28
40,"40046",83,67,67,1,0,"VOX",11
49,"49081",1321,972,953,6,19,"VOX",174
41,"41085",4182,3258,3181,43,77,"VOX",649
9,"9055",47,33,32,0,1,"VOX",4
29,"29047",1082,860,846,0,14,"VOX",57
10,"10037",76966,54717,53914,546,803,"VOX",8428
17,"17004",529,411,410,3,1,"VOX",5
10,"10038",83,59,59,0,0,"VOX",17
42,"42212",57,45,45,2,0,"VOX",8
43,"43153",11197,7685,7649,53,36,"VOX",619
49,"49082",341,273,270,12,3,"VOX",40
43,"43074",1818,1341,1336,2,5,"VOX",65
19,"19106",77,57,57,0,0,"VOX",11
37,"37143",384,273,273,2,0,"VOX",51
31,"31175",66,46,46,0,0,"VOX",1
30,"30016",153034,101232,100202,776,1030,"VOX",31162
5,"5073",282,210,207,1,3,"VOX",36
10,"10039",400,256,217,0,39,"VOX",26
20,"20053",4856,3169,3153,15,16,"VOX",33
17,"17005",457,322,320,3,2,"VOX",9
10,"10161",81,50,50,0,0,"VOX",12
27,"27047",1517,955,940,12,15,"VOX",58
6,"6130",185,152,149,0,3,"VOX",15
50,"50092",290,218,214,0,4,"VOX",29
25,"25185",680,452,451,0,1,"VOX",9
20,"20054",461,294,294,1,0,"VOX",0
5,"5171",67,49,47,0,2,"VOX",4
19,"19201",60,44,44,0,0,"VOX",4
29,"29049",2890,2069,2034,12,35,"VOX",201
5,"5074",668,540,537,5,3,"VOX",98
5,"5172",111,83,83,1,0,"VOX",11
45,"45175",603,476,473,1,3,"VOX",74
31,"31176",2919,1974,1933,27,41,"VOX",245
15,"15046",6157,3965,3865,23,100,"VOX",300
40,"40148",231,165,163,4,2,"VOX",19
13,"13021",412,325,320,1,5,"VOX",48
10,"10163",348,239,238,2,1,"VOX",36
16,"16050",218,172,169,2,3,"VOX",30
46,"46209",1903,1406,1383,5,23,"VOX",307
26,"26012",37,28,28,1,0,"VOX",2
37,"37335",384,282,279,1,3,"VOX",64
42,"42080",153,108,108,1,0,"VOX",12
9,"9059",136870,99937,98641,1416,1296,"VOX",14607
49,"49085",904,583,579,5,4,"VOX",84
41,"41088",515,368,358,2,10,"VOX",34
25,"25186",207,162,161,0,1,"VOX",4
43,"43077",453,306,304,1,2,"VOX",28
20,"20055",17300,11784,11725,43,59,"VOX",126
46,"46187",1292,924,920,4,4,"VOX",155
50,"50094",1500,1041,1022,12,19,"VOX",130
5,"5076",468,376,367,1,9,"VOX",78
9,"9060",126,104,104,2,0,"VOX",13
46,"46188",693,565,560,2,5,"VOX",114
15,"15047",2256,1429,1405,25,24,"VOX",95
42,"42081",126,88,88,0,0,"VOX",13
20,"20056",4077,2796,2781,12,15,"VOX",9
44,"44146",164,133,133,2,0,"VOX",16
37,"37336",56,45,43,2,2,"VOX",7
40,"40052",72,55,55,0,0,"VOX",9
9,"9221",498,380,377,8,3,"VOX",70
49,"49192",123,93,90,2,3,"VOX",11
10,"10044",1405,968,955,11,13,"VOX",123
44,"44231",35,30,30,0,0,"VOX",4
9,"9223",42,36,36,0,0,"VOX",1
27,"27051",7986,5324,5241,58,83,"VOX",471
42,"42219",40,34,34,1,0,"VOX",3
10,"10167",301,198,198,0,0,"VOX",22
28,"28074",141137,106626,105602,885,1024,"VOX",16403
9,"9062",40,34,33,0,1,"VOX",5
43,"43157",339,279,279,1,0,"VOX",5
16,"16053",388,306,303,3,3,"VOX",44
49,"49088",80,51,51,0,0,"VOX",5
29,"29053",1717,1133,1116,12,17,"VOX",274
45,"45180",2850,2044,2023,15,21,"VOX",558
15,"15049",1068,752,747,7,5,"VOX",34
41,"41090",3489,2560,2467,27,93,"VOX",375
6,"6137",934,696,693,3,3,"VOX",116
9,"9063",215,184,181,2,3,"VOX",45
13,"13026",413,333,331,2,2,"VOX",37
37,"37149",60,50,50,0,0,"VOX",8
21,"21061",5083,3325,3255,36,70,"VOX",867
38,"38038",165135,101564,100807,709,757,"VOX",11057
9,"9276",390,256,244,4,12,"VOX",26
32,"32092",491,280,275,0,5,"VOX",28
26,"26053",191,144,140,2,4,"VOX",16
45,"45071",1779,1374,1342,7,32,"VOX",175
42,"42085",179,107,106,2,1,"VOX",9
45,"45182",996,760,754,5,6,"VOX",166
14,"14038",32742,23345,22974,242,371,"VOX",7200
43,"43159",76,60,60,0,0,"VOX",0
25,"25009",596,448,442,1,6,"VOX",12
50,"50098",162,119,118,1,1,"VOX",25
49,"49197",155,109,104,0,5,"VOX",21
9,"9065",136,112,111,0,1,"VOX",16
31,"31183",718,536,534,5,2,"VOX",43
25,"25192",727,527,524,4,3,"VOX",25
6,"6140",612,456,451,1,5,"VOX",75
25,"25010",194,138,136,0,2,"VOX",0
49,"49091",246,168,167,1,1,"VOX",20
24,"24134",3287,2278,2226,18,52,"VOX",315
10,"10048",202,141,139,0,2,"VOX",34
45,"45183",2378,1555,1525,16,30,"VOX",478
19,"19113",454,327,322,4,5,"VOX",76
46,"46123",1926,1392,1368,11,24,"VOX",217
37,"37340",141,97,97,1,0,"VOX",23
13,"13030",115,81,81,0,0,"VOX",20
5,"5178",340,261,255,3,6,"VOX",52
10,"10049",3752,2949,2864,25,85,"VOX",374
9,"9067",399,232,230,3,2,"VOX",39
31,"31075",113,69,69,2,0,"VOX",3
5,"5081",37,21,21,3,0,"VOX",0
24,"24137",1043,700,691,8,9,"VOX",61
19,"19114",30,22,21,1,1,"VOX",1
5,"5179",199,176,172,1,4,"VOX",34
21,"21064",6674,4503,4426,68,77,"VOX",949
23,"23027",711,547,539,5,8,"VOX",68
5,"5082",491,379,369,2,10,"VOX",71
45,"45185",7573,5422,5320,31,102,"VOX",892
31,"31185",461,291,290,1,1,"VOX",4
16,"16060",715,519,513,3,6,"VOX",95
20,"20062",941,688,683,1,5,"VOX",13
19,"19115",29,23,23,0,0,"VOX",6
9,"9068",23,16,16,0,0,"VOX",1
46,"46192",786,534,519,7,15,"VOX",99
12,"12089",4555,3070,3045,22,25,"VOX",648
49,"49201",283,232,228,3,4,"VOX",16
10,"10174",171,112,110,0,2,"VOX",18
29,"29057",330,222,218,2,4,"VOX",30
28,"28157",690,471,467,1,4,"VOX",113
24,"24139",2071,1371,1346,15,25,"VOX",245
37,"37051",79,58,58,0,0,"VOX",9
49,"49095",282,202,201,6,1,"VOX",39
37,"37154",129,97,94,1,3,"VOX",16
16,"16061",939,746,727,16,19,"VOX",114
20,"20063",8023,5611,5597,19,14,"VOX",34
37,"37052",287,192,191,2,1,"VOX",20
21,"21066",490,394,389,4,5,"VOX",28
31,"31078",2418,1752,1729,16,23,"VOX",173
10,"10175",1351,918,901,8,17,"VOX",133
9,"9232",139,100,97,1,3,"VOX",10
17,"17014",66,51,49,0,2,"VOX",2
31,"31188",319,197,191,3,6,"VOX",13
37,"37344",229,157,147,2,10,"VOX",31
19,"19117",1632,1187,1167,12,20,"VOX",360
50,"50027",223,166,161,2,5,"VOX",21
49,"49096",155,113,112,2,1,"VOX",19
10,"10054",523,389,380,1,9,"VOX",45
16,"16227",109,78,76,0,2,"VOX",17
15,"15056",5615,3697,3646,31,51,"VOX",283
25,"25197",140,109,109,0,0,"VOX",4
44,"44061",77,60,58,1,2,"VOX",9
32,"32026",2655,1762,1731,17,31,"VOX",163
46,"46057",463,308,304,1,4,"VOX",50
44,"44239",21,19,19,0,0,"VOX",4
25,"25200",318,245,245,0,0,"VOX",1
24,"24143",497,344,343,3,1,"VOX",39
46,"46058",1734,1245,1230,8,15,"VOX",167
50,"50104",320,251,251,1,0,"VOX",25
31,"31190",44,30,30,1,0,"VOX",0
46,"46126",5580,4361,4328,36,33,"VOX",751
10,"10055",697,488,473,3,15,"VOX",87
19,"19118",11,10,9,0,1,"VOX",0
29,"29060",665,454,450,1,4,"VOX",104
10,"10056",533,377,371,2,6,"VOX",34
45,"45190",462,361,353,3,8,"VOX",83
40,"40191",198,143,138,0,5,"VOX",36
25,"25015",336,234,233,3,1,"VOX",6
5,"5183",123,103,100,0,3,"VOX",18
8,"8015",156540,109145,108440,957,705,"VOX",9097
43,"43086",5252,3811,3790,28,21,"VOX",109
38,"38044",2215,1270,1257,5,13,"VOX",188
5,"5087",147,108,107,3,1,"VOX",30
24,"24144",621,419,412,4,7,"VOX",85
26,"26026",1268,986,970,4,16,"VOX",103
9,"9075",104,82,82,0,0,"VOX",26
10,"10057",126,90,89,1,1,"VOX",9
25,"25201",110,81,81,0,0,"VOX",1
50,"50182",3657,2499,2485,23,14,"VOX",769
12,"12011",4583,3228,3177,24,51,"VOX",461
37,"37347",463,349,345,9,4,"VOX",84
46,"46059",1244,1007,995,5,12,"VOX",75
43,"43088",2013,1429,1420,11,9,"VOX",103
24,"24145",612,338,337,1,1,"VOX",78
9,"9241",244,171,169,6,2,"VOX",40
46,"46196",134,111,110,0,1,"VOX",34
31,"31010",5719,3799,3770,22,29,"VOX",103
31,"31901",15487,11077,10991,117,86,"VOX",505
8,"8304",822,655,655,5,0,"VOX",20
17,"17019",1780,1403,1393,5,10,"VOX",13
43,"43089",279,201,201,1,0,"VOX",12
15,"15059",10229,6900,6734,85,166,"VOX",480
32,"32030",945,642,641,8,1,"VOX",44
10,"10059",329,202,201,1,1,"VOX",30
31,"31193",1440,1062,1055,11,7,"VOX",54
10,"10182",122,81,81,0,0,"VOX",24
20,"20068",179,119,119,2,0,"VOX",1
5,"5089",455,342,324,0,18,"VOX",64
19,"19156",917,686,679,2,7,"VOX",179
5,"5186",1564,1140,1125,5,15,"VOX",223
21,"21072",10233,7374,7183,116,191,"VOX",737
24,"24148",1602,1152,1140,11,12,"VOX",249
15,"15060",5871,4044,3978,58,66,"VOX",351
37,"37058",56,38,38,1,0,"VOX",6
47,"47162",70,57,57,2,0,"VOX",16
17,"17102",556,398,396,1,2,"VOX",9
38,"38046",9267,6652,6594,55,58,"VOX",574
44,"44157",61,37,37,0,0,"VOX",3
37,"37059",117,95,95,3,0,"VOX",18
37,"37161",123,86,86,0,0,"VOX",29
24,"24149",149,123,123,0,0,"VOX",24
6,"6155",1810,1172,1140,23,32,"VOX",211
9,"9082",36,32,32,0,0,"VOX",1
31,"31195",169,108,108,0,0,"VOX",3
49,"49102",182,130,130,2,0,"VOX",12
17,"17020",3677,2851,2835,14,16,"VOX",79
29,"29064",423,291,285,2,6,"VOX",65
40,"40065",467,338,329,1,9,"VOX",49
50,"50185",140,93,92,1,1,"VOX",17
46,"46199",5878,4217,4182,21,35,"VOX",808
10,"10184",734,520,511,4,9,"VOX",56
41,"41091",539590,389351,384943,4676,4408,"VOX",67265
44,"44102",26,19,19,0,0,"VOX",3
16,"16190",4930,3747,3688,26,59,"VOX",865
8,"8018",2540,1862,1855,7,7,"VOX",102
17,"17021",119,89,87,0,2,"VOX",0
17,"17103",5057,3196,3174,21,22,"VOX",234
5,"5189",397,293,291,3,2,"VOX",51
41,"41092",7681,5408,5299,79,109,"VOX",846
43,"43091",125,90,90,1,0,"VOX",2
50,"50109",95,65,62,2,3,"VOX",7
37,"37061",195,136,136,1,0,"VOX",25
45,"45197",1888,1446,1426,5,20,"VOX",279
49,"49104",326,218,216,0,2,"VOX",23
25,"25205",563,412,407,3,5,"VOX",14
12,"12096",732,526,519,4,7,"VOX",46
20,"20072",4762,3175,3153,21,22,"VOX",68
29,"29066",357,248,246,1,2,"VOX",47
26,"26033",162,133,132,3,1,"VOX",9
6,"6158",13367,9319,9131,90,188,"VOX",1271
41,"41093",19064,14867,14700,151,167,"VOX",2823
46,"46131",49805,35527,35231,298,296,"VOX",6146
9,"9085",481,349,342,2,7,"VOX",60
6,"6159",2329,1297,1273,22,24,"VOX",192
24,"24152",433,269,267,4,2,"VOX",51
46,"46063",1786,1270,1255,8,15,"VOX",217
5,"5094",133,105,105,0,0,"VOX",22
10,"10107",1019,766,755,12,11,"VOX",68
10,"10106",126,102,102,0,0,"VOX",7
9,"9086",652,479,471,3,8,"VOX",139
10,"10065",199,135,135,0,0,"VOX",30
42,"42107",70,48,47,1,1,"VOX",7
25,"25207",6443,4525,4492,31,33,"VOX",118
21,"21076",2153,1459,1426,31,33,"VOX",135
22,"22204",1117,728,723,14,5,"VOX",113
34,"34079",1729,1296,1275,19,21,"VOX",295
45,"45199",3188,2077,2055,20,22,"VOX",669
5,"5095",236,181,177,1,4,"VOX",41
15,"15066",3995,2746,2695,29,51,"VOX",234
6,"6161",289,199,197,1,2,"VOX",17
20,"20074",11520,8379,8357,19,22,"VOX",42
31,"31200",745,489,483,1,6,"VOX",10
37,"37065",276,167,167,2,0,"VOX",25
46,"46201",62,40,40,0,0,"VOX",1
38,"38002",971,577,570,8,7,"VOX",44
16,"16244",698,598,585,7,13,"VOX",77
16,"16194",219,169,161,0,8,"VOX",17
19,"19127",88,60,60,1,0,"VOX",8
31,"31201",151450,105649,104976,1004,673,"VOX",4901
43,"43094",2143,1558,1541,6,17,"VOX",65
50,"50113",587,471,461,2,10,"VOX",37
16,"16039",365,241,238,3,3,"VOX",58
40,"40007",68,55,55,1,0,"VOX",10
16,"16003",134,108,105,0,3,"VOX",16
43,"43095",2583,1864,1854,12,10,"VOX",180
42,"42110",54,43,43,0,0,"VOX",8
31,"31092",683,413,413,6,0,"VOX",1
44,"44250",20,15,15,0,0,"VOX",3
28,"28001",70,48,47,1,1,"VOX",4
12,"12124",1842,1343,1328,13,15,"VOX",252
10,"10069",786,566,554,3,12,"VOX",83
25,"25209",1586,1115,1102,6,13,"VOX",23
37,"37167",174,147,144,2,3,"VOX",18
31,"31093",275,201,198,3,3,"VOX",2
49,"49222",369,250,247,2,3,"VOX",30
46,"46134",2419,1697,1678,14,19,"VOX",333
50,"50114",132,108,108,0,0,"VOX",10
12,"12018",279,233,231,3,2,"VOX",32
5,"5099",451,350,344,3,6,"VOX",62
45,"45203",2777,1986,1961,18,25,"VOX",615
49,"49111",119,84,84,3,0,"VOX",10
16,"16081",50,37,36,0,1,"VOX",4
44,"44074",440,314,308,2,6,"VOX",50
9,"9094",53,42,42,0,0,"VOX",1
10,"10071",126,78,71,0,7,"VOX",7
17,"17026",549,421,415,3,6,"VOX",13
46,"46204",6625,4946,4882,52,64,"VOX",707
46,"46090",1631,1360,1339,6,21,"VOX",219
24,"24157",2542,1846,1809,16,37,"VOX",309
28,"28003",167,133,131,4,2,"VOX",29
20,"20077",5269,3845,3830,9,15,"VOX",40
25,"25027",978,695,690,3,5,"VOX",13
50,"50115",3279,2170,2131,27,39,"VOX",497
10,"10072",837,545,539,5,6,"VOX",32
31,"31204",36,25,25,0,0,"VOX",2
7,"7002",6678,4149,4108,31,41,"VOX",398
19,"19132",86,65,63,0,2,"VOX",14
49,"49112",118,72,72,2,0,"VOX",7
28,"28004",6618,4502,4457,28,45,"VOX",1227
28,"28172",9915,7715,7652,60,63,"VOX",2234
37,"37070",523,371,365,4,6,"VOX",103
24,"24159",1716,1238,1216,6,22,"VOX",264
49,"49113",162,131,131,2,0,"VOX",31
31,"31206",2077,1433,1417,15,16,"VOX",66
50,"50241",582,414,406,2,8,"VOX",76
12,"12126",24374,17741,17553,111,188,"VOX",3077
50,"50216",236,169,167,0,2,"VOX",23
42,"42117",129,98,95,1,3,"VOX",19
19,"19228",27,17,17,1,0,"VOX",2
12,"12021",4398,3314,3277,32,37,"VOX",622
9,"9261",446,279,271,2,8,"VOX",58
37,"37171",396,272,270,2,2,"VOX",51
42,"42164",1580,1043,1029,8,14,"VOX",188
25,"25057",208,151,149,4,2,"VOX",19
47,"47172",135,114,113,0,1,"VOX",19
41,"41099",3961,2448,2413,14,35,"VOX",431
19,"19133",78,64,64,2,0,"VOX",14
37,"37359",165,105,103,0,2,"VOX",10
50,"50117",123,93,93,4,0,"VOX",10
31,"31207",280,194,191,3,3,"VOX",7
25,"25215",339,249,249,5,0,"VOX",22
49,"49114",40,31,27,0,4,"VOX",1
16,"16202",733,533,526,4,7,"VOX",102
6,"6034",171,114,114,2,0,"VOX",22
50,"50193",664,487,475,4,12,"VOX",88
25,"25031",57,32,32,0,0,"VOX",5
25,"25123",189,135,133,0,2,"VOX",1
20,"20081",7690,5382,5363,31,19,"VOX",56
5,"5103",63,44,44,1,0,"VOX",8
46,"46001",771,562,560,3,2,"VOX",88
31,"31209",149,111,110,0,1,"VOX",6
46,"46206",555,417,408,0,9,"VOX",55
42,"42120",131,87,86,1,1,"VOX",9
10,"10077",626,444,441,5,3,"VOX",46
32,"32009",10558,6621,6549,50,72,"VOX",692
9,"9160",83,63,63,1,0,"VOX",11
10,"10118",278,232,231,1,1,"VOX",27
26,"26081",15,14,14,1,0,"VOX",2
22,"22004",123,83,83,0,0,"VOX",22
16,"16087",238,184,184,6,0,"VOX",49
46,"46070",17824,12888,12802,106,86,"VOX",2884
23,"23050",90664,65260,64519,581,741,"VOX",14022
6,"6037",1656,1033,1018,8,15,"VOX",176
41,"41102",14773,10377,10028,174,349,"VOX",1947
31,"31210",186,131,130,2,1,"VOX",9
46,"46207",6761,4966,4909,46,57,"VOX",895
46,"46002",1253,946,940,4,6,"VOX",108
25,"25217",10891,7651,7610,63,41,"VOX",229
15,"15075",12871,8751,8637,129,114,"VOX",878
50,"50119",876,633,625,11,8,"VOX",156
37,"37362",4783,3469,3420,44,49,"VOX",820
10,"10201",178,142,141,2,1,"VOX",14
9,"9326",156,111,110,1,1,"VOX",25
5,"5105",330,247,242,2,5,"VOX",42
43,"43101",146,112,112,2,0,"VOX",2
49,"49117",431,294,289,0,5,"VOX",37
42,"42034",41,25,25,0,0,"VOX",4
49,"49153",150,110,107,2,3,"VOX",23
50,"50146",189,149,149,3,0,"VOX",23
13,"13064",1845,1314,1298,10,16,"VOX",317
24,"24164",351,175,174,0,1,"VOX",61
5,"5106",27,14,14,0,0,"VOX",1
43,"43102",458,331,324,2,7,"VOX",4
49,"49118",193,151,151,2,0,"VOX",23
20,"20903",5033,3355,3341,18,14,"VOX",67
37,"37364",760,502,500,0,2,"VOX",61
19,"19232",56,40,40,0,0,"VOX",9
10,"10081",176,121,119,0,2,"VOX",18
40,"40179",620,500,490,3,10,"VOX",65
5,"5107",54,36,35,2,1,"VOX",7
40,"40211",66,54,54,1,0,"VOX",15
25,"25218",88,76,75,2,1,"VOX",1
17,"17033",5647,3879,3852,25,27,"VOX",250
15,"15077",8103,4893,4818,61,75,"VOX",440
19,"19233",79,65,65,2,0,"VOX",7
9,"9434",1279,966,956,11,10,"VOX",171
10,"10082",1793,1333,1305,11,28,"VOX",168
16,"16209",110,95,94,2,1,"VOX",9
43,"43103",908,705,701,9,4,"VOX",69
11,"11015",64414,39635,39220,776,415,"VOX",9992
22,"22250",346,241,241,0,0,"VOX",35
46,"46232",853,661,648,7,13,"VOX",112
49,"49120",54,35,35,0,0,"VOX",2
12,"12027",17506,11776,11649,84,127,"VOX",2364
37,"37207",336,244,240,4,4,"VOX",76
50,"50221",29,18,18,0,0,"VOX",3
37,"37177",259,198,197,3,1,"VOX",21
26,"26050",125,92,91,1,1,"VOX",6
46,"46073",1066,823,817,11,6,"VOX",75
49,"49121",372,239,233,1,6,"VOX",30
5,"5108",39,21,21,0,0,"VOX",2
9,"9112",102,73,73,0,0,"VOX",5
5,"5109",445,334,329,4,5,"VOX",47
5,"5206",26,17,17,0,0,"VOX",0
7,"7011",28971,17082,16964,164,118,"VOX",3296
16,"16212",233,186,184,0,2,"VOX",20
46,"46005",23129,16610,16437,148,173,"VOX",2910
31,"31215",4670,3270,3219,33,51,"VOX",399
19,"19143",1781,1278,1266,18,12,"VOX",352
6,"6044",29258,19865,19594,205,271,"VOX",3295
22,"22009",581,387,386,7,1,"VOX",37
37,"37080",221,164,163,1,1,"VOX",48
49,"49122",761,517,505,7,12,"VOX",128
19,"19332",85,59,57,4,2,"VOX",14
10,"10207",455,298,291,0,7,"VOX",45
28,"28181",20801,16353,16243,97,110,"VOX",3919
37,"37081",879,680,674,2,6,"VOX",141
24,"24168",430,325,322,6,3,"VOX",56
20,"20906",128,87,87,0,0,"VOX",0
42,"42001",250,172,172,3,0,"VOX",25
5,"5110",696,469,464,2,5,"VOX",106
50,"50123",430,304,297,3,7,"VOX",56
49,"49123",519,384,383,4,1,"VOX",58
37,"37368",17,12,11,0,1,"VOX",2
37,"37118",117,86,86,3,0,"VOX",29
6,"6046",1250,983,959,6,24,"VOX",152
37,"37082",733,468,456,7,12,"VOX",83
43,"43027",168,129,129,3,0,"VOX",4
31,"31108",1819,1348,1325,13,23,"VOX",110
7,"7013",7353,4725,4639,43,86,"VOX",918
19,"19334",43,35,35,0,0,"VOX",1
31,"31219",80,59,58,2,1,"VOX",4
42,"42003",65,49,47,0,2,"VOX",11
26,"26091",147,115,114,0,1,"VOX",14
26,"26017",364,274,269,2,5,"VOX",16
42,"42084",20,15,15,0,0,"VOX",2
16,"16095",82,70,70,1,0,"VOX",10
31,"31182",29,25,25,0,0,"VOX",0
50,"50124",394,269,266,0,3,"VOX",61
19,"19146",47,35,35,0,0,"VOX",1
49,"49124",238,170,164,2,6,"VOX",29
37,"37181",265,158,158,0,0,"VOX",32
28,"28015",20885,16237,16104,134,133,"VOX",4413
42,"42004",2290,1595,1565,30,30,"VOX",309
42,"42132",140,102,101,2,1,"VOX",14
24,"24171",337,136,134,4,2,"VOX",19
42,"42006",154,105,103,0,2,"VOX",10
50,"50125",340,230,229,2,1,"VOX",38
5,"5209",74,58,58,1,0,"VOX",8
15,"15083",1029,627,614,5,13,"VOX",32
6,"6049",956,625,604,8,21,"VOX",93
10,"10089",1334,864,837,8,27,"VOX",134
43,"43029",312,241,240,1,1,"VOX",0
26,"26172",25,16,15,0,1,"VOX",1
50,"50048",33,25,25,0,0,"VOX",0
5,"5114",1257,989,968,5,21,"VOX",163
37,"37085",5060,3732,3689,52,43,"VOX",940
21,"21003",684,476,452,4,24,"VOX",26
37,"37371",252,156,155,0,1,"VOX",33
49,"49238",273,205,200,4,5,"VOX",35
31,"31002",431,294,290,3,4,"VOX",4
24,"24172",389,208,202,1,6,"VOX",41
5,"5115",509,350,344,0,6,"VOX",59
49,"49126",260,153,150,1,3,"VOX",23
17,"17039",1726,1306,1297,7,9,"VOX",32
46,"46077",7338,5447,5356,44,91,"VOX",449
9,"9123",42,36,36,0,0,"VOX",8
44,"44092",70,53,52,0,1,"VOX",8
29,"29073",1657,1082,1069,15,13,"VOX",175
21,"21004",1586,994,964,23,30,"VOX",146
49,"49240",185,125,123,3,2,"VOX",27
37,"37372",133,99,98,0,1,"VOX",22
31,"31223",953,667,654,4,13,"VOX",37
10,"10213",533,397,385,0,12,"VOX",71
15,"15085",3176,2073,2047,29,26,"VOX",106
29,"29074",771,561,555,1,6,"VOX",115
9,"9283",39,25,24,1,1,"VOX",5
44,"44002",47,41,41,0,0,"VOX",4
46,"46078",28484,19694,19520,173,174,"VOX",3276
21,"21005",15754,9502,9340,84,162,"VOX",2882
8,"8093",25,22,22,0,0,"VOX",0
9,"9230",33,26,26,0,0,"VOX",2
47,"47028",30,17,17,0,0,"VOX",5
25,"25226",236,156,155,0,1,"VOX",0
24,"24214",626,438,433,8,5,"VOX",38
7,"7018",389,238,236,1,2,"VOX",17
49,"49129",810,541,527,4,14,"VOX",68
17,"17040",551,440,439,5,1,"VOX",11
37,"37185",539,372,363,2,9,"VOX",95
49,"49241",235,178,177,1,1,"VOX",65
7,"7019",161,104,102,0,2,"VOX",13
37,"37373",692,451,442,4,9,"VOX",45
9,"9125",555,386,382,4,4,"VOX",50
24,"24175",1821,1316,1305,15,11,"VOX",279
44,"44181",65,57,57,0,0,"VOX",3
9,"9127",52,36,35,0,1,"VOX",3
37,"37088",199,135,133,0,2,"VOX",22
40,"40189",471,344,329,1,15,"VOX",51
28,"28092",153631,112460,111341,913,1119,"VOX",20822
29,"29075",12886,8292,8191,63,101,"VOX",1678
31,"31225",35,29,28,0,1,"VOX",0
46,"46216",5277,4146,4111,42,35,"VOX",712
28,"28020",193,96,93,0,3,"VOX",8
7,"7020",3707,2522,2493,40,29,"VOX",270
5,"5151",83,60,60,0,0,"VOX",10
25,"25904",160,134,133,2,1,"VOX",1
17,"17071",1134,943,940,1,3,"VOX",17
15,"15024",4314,2859,2790,44,69,"VOX",265
6,"6102",1027,834,815,3,19,"VOX",100
24,"24177",467,265,263,2,2,"VOX",61
31,"31227",8118,5691,5636,65,55,"VOX",206
37,"37090",68,47,47,0,0,"VOX",6
49,"49131",231,149,145,1,4,"VOX",31
15,"15088",3396,2047,2022,22,25,"VOX",156
44,"44182",203,160,158,0,2,"VOX",18
46,"46217",900,672,667,7,5,"VOX",121
44,"44096",155,115,114,1,1,"VOX",8
45,"45115",2602,2013,1969,12,44,"VOX",500
42,"42013",34,22,22,2,0,"VOX",1
9,"9129",91,74,74,0,0,"VOX",7
37,"37282",193,132,131,3,1,"VOX",31
31,"31008",61,42,42,0,0,"VOX",1
21,"21038",1082,688,676,4,12,"VOX",80
25,"25905",366,281,276,4,5,"VOX",7
41,"41070",6451,4715,4632,70,83,"VOX",990
25,"25044",178,144,142,0,2,"VOX",5
42,"42014",57,35,35,0,0,"VOX",5
47,"47002",18,18,18,0,0,"VOX",1
7,"7022",11659,7045,6965,84,80,"VOX",1294
47,"47189",151,128,122,1,6,"VOX",26
15,"15089",4299,2924,2887,41,37,"VOX",177
19,"19154",58,45,45,0,0,"VOX",10
37,"37091",161,104,104,0,0,"VOX",11
10,"10098",387,272,267,0,5,"VOX",41
5,"5217",54,42,41,0,1,"VOX",11
37,"37127",205,139,139,1,0,"VOX",24
17,"17074",536,403,401,1,2,"VOX",22
37,"37092",1933,1342,1327,13,15,"VOX",381
19,"19155",64,49,49,0,0,"VOX",9
43,"43114",370,281,278,1,3,"VOX",2
31,"31230",90,66,66,0,0,"VOX",2
16,"16106",2701,2029,2001,6,28,"VOX",306
50,"50132",780,549,538,7,11,"VOX",169
49,"49170",99,68,68,1,0,"VOX",9
17,"17100",193,147,141,0,6,"VOX",2
50,"50106",123,78,78,0,0,"VOX",13
42,"42015",30,20,20,0,0,"VOX",5
42,"42149",386,273,270,2,3,"VOX",43
10,"10100",783,494,447,5,47,"VOX",37
9,"9133",38,33,33,0,0,"VOX",15
29,"29080",6940,4676,4617,36,59,"VOX",1056
31,"31120",376,211,209,7,2,"VOX",4
49,"49247",412,255,252,2,3,"VOX",48
16,"16107",94,56,56,0,0,"VOX",6
46,"46015",7519,5575,5532,34,43,"VOX",1090
7,"7025",443,313,310,5,3,"VOX",32
14,"14047",1644,1198,1183,14,15,"VOX",259
15,"15091",1097,705,686,17,19,"VOX",67
25,"25232",1357,1012,1007,6,5,"VOX",23
42,"42017",131,99,96,1,3,"VOX",15
25,"25047",956,745,736,14,9,"VOX",16
10,"10904",714,487,473,8,14,"VOX",129
5,"5219",33,23,23,0,0,"VOX",6
9,"9134",217,142,138,1,4,"VOX",11
37,"37255",43,33,31,1,2,"VOX",6
50,"50133",98,76,76,0,0,"VOX",11
46,"46038",302,221,220,1,1,"VOX",21
6,"6063",2924,2141,2108,8,33,"VOX",230
10,"10102",496,378,377,1,1,"VOX",33
24,"24182",410,273,270,7,3,"VOX",40
29,"29082",34683,24751,24495,263,256,"VOX",4893
31,"31013",615,371,365,1,6,"VOX",5
37,"37380",55,41,40,2,1,"VOX",10
28,"28026",6767,5058,5024,27,34,"VOX",1257
46,"46084",1487,1136,1123,4,13,"VOX",168
24,"24183",748,464,460,9,4,"VOX",80
37,"37098",290,197,197,1,0,"VOX",26
42,"42019",519,345,341,3,4,"VOX",49
37,"37192",361,200,198,3,2,"VOX",44
43,"43038",22070,15127,15018,113,109,"VOX",1585
24,"24038",3024,2121,2071,25,50,"VOX",204
43,"43143",50,40,39,0,1,"VOX",0
46,"46221",348,292,290,1,2,"VOX",41
49,"49137",167,123,121,0,2,"VOX",17
37,"37381",138,98,93,0,5,"VOX",17
6,"6066",1708,1180,1171,6,9,"VOX",111
24,"24184",177,106,105,0,1,"VOX",14
7,"7027",22101,13161,13028,140,133,"VOX",2943
9,"9137",187,129,127,0,2,"VOX",27
21,"21014",4066,3089,3029,30,60,"VOX",374
42,"42154",103,76,76,1,0,"VOX",7
25,"25049",156,110,109,1,1,"VOX",2
37,"37099",63,46,46,1,0,"VOX",4
50,"50210",37,26,26,0,0,"VOX",2
12,"12121",1043,878,856,5,22,"VOX",99
49,"49138",205,141,140,2,1,"VOX",26
13,"13001",1188,865,858,4,7,"VOX",97
29,"29010",1637,1263,1187,2,76,"VOX",195
37,"37100",74,59,58,1,1,"VOX",4
43,"43039",101,77,77,0,0,"VOX",0
9,"9307",102,76,74,1,2,"VOX",6
21,"21015",645,361,356,8,5,"VOX",68
29,"29084",27199,18102,17800,268,302,"VOX",4092
38,"38001",21069,10844,10777,63,67,"VOX",1685
44,"44012",303,215,215,2,0,"VOX",30
9,"9139",98,79,79,2,0,"VOX",12
46,"46177",4832,3592,3539,20,53,"VOX",578
16,"16151",61,51,51,1,0,"VOX",5
42,"42060",28,16,14,0,2,"VOX",1
23,"23041",489,378,376,1,2,"VOX",103
46,"46223",7776,5848,5798,36,50,"VOX",1116
19,"19161",212,158,157,3,1,"VOX",30
9,"9308",58,34,34,1,0,"VOX",8
28,"28030",1832,1319,1297,13,22,"VOX",256
37,"37101",138,101,100,1,1,"VOX",15
19,"19252",56,44,44,0,0,"VOX",7
5,"5127",600,472,469,7,3,"VOX",80
49,"49142",244,163,160,0,3,"VOX",15
42,"42157",10,9,9,0,0,"VOX",2
9,"9141",617,463,456,5,7,"VOX",65
10,"10108",203,116,116,1,0,"VOX",27
24,"24188",3795,2877,2825,40,52,"VOX",491
46,"46087",109,94,94,2,0,"VOX",6
8,"8034",820,644,640,0,4,"VOX",23
5,"5192",92,75,72,1,3,"VOX",8
27,"27902",7122,4472,4385,43,87,"VOX",358
45,"45200",4471,3351,3269,25,82,"VOX",696
44,"44249",40,30,30,0,0,"VOX",4
42,"42024",84,64,62,1,2,"VOX",9
9,"9476",60,46,46,0,0,"VOX",5
27,"27007",2723,1822,1776,23,46,"VOX",139
8,"8148",2344,1655,1646,13,9,"VOX",193
25,"25208",337,242,241,2,1,"VOX",5
8,"8057",61,47,47,1,0,"VOX",0
46,"46020",3757,2834,2783,16,51,"VOX",402
44,"44193",73,60,60,1,0,"VOX",6
45,"45017",264,199,196,4,3,"VOX",15
50,"50138",45,37,37,3,0,"VOX",7
37,"37103",409,295,294,2,1,"VOX",57
46,"46088",152,114,110,1,4,"VOX",4
50,"50036",100,76,76,1,0,"VOX",8
29,"29087",363,249,243,4,6,"VOX",48
6,"6073",703,451,441,6,10,"VOX",34
16,"16116",76,59,58,1,1,"VOX",9
9,"9144",44,31,31,0,0,"VOX",7
5,"5130",94,77,77,1,0,"VOX",1
31,"31240",514,352,352,3,0,"VOX",0
9,"9148",77,58,58,3,0,"VOX",4
50,"50139",318,237,237,1,0,"VOX",48
7,"7033",28539,15238,15070,187,168,"VOX",2541
43,"43122",112,91,91,1,0,"VOX",0
19,"19165",45,39,39,0,0,"VOX",6
37,"37104",24,16,16,0,0,"VOX",3
24,"24191",106,70,69,2,1,"VOX",8
44,"44108",306,209,205,1,4,"VOX",29
22,"22029",118,85,83,1,2,"VOX",29
9,"9149",36,29,29,0,0,"VOX",2
9,"9314",90,75,75,2,0,"VOX",9
49,"49180",135,82,81,5,1,"VOX",20
48,"48056",980,731,728,3,3,"VOX",6
16,"16005",234,163,160,1,3,"VOX",14
31,"31241",126,86,85,2,1,"VOX",0
43,"43123",71435,49166,48873,318,293,"VOX",4563
6,"6075",470,363,360,7,3,"VOX",18
19,"19166",154,110,108,0,2,"VOX",29
31,"31242",258,168,167,2,1,"VOX",6
45,"45020",1240,905,900,5,5,"VOX",201
9,"9315",384,245,242,3,3,"VOX",56
6,"6076",825,573,562,1,11,"VOX",74
41,"41053",21693,15843,15379,171,464,"VOX",2925
24,"24084",153,105,102,2,3,"VOX",9
16,"16248",862,710,700,6,10,"VOX",144
37,"37138",222,163,159,3,4,"VOX",29
7,"7035",1595,1095,1078,13,17,"VOX",122
42,"42163",50,27,27,1,0,"VOX",4
26,"26077",16,16,16,0,0,"VOX",4
37,"37170",1361,909,884,9,25,"VOX",176
24,"24120",305,182,181,1,1,"VOX",38
9,"9316",104,80,80,0,0,"VOX",16
24,"24194",267,178,177,1,1,"VOX",24
37,"37108",98,75,75,3,0,"VOX",14
9,"9152",244,161,161,0,0,"VOX",24
38,"38006",41593,20823,20624,127,199,"VOX",3549
44,"44196",121,88,88,0,0,"VOX",5
42,"42070",31,23,23,1,0,"VOX",1
46,"46068",345,283,279,2,4,"VOX",58
50,"50141",104,80,78,0,2,"VOX",4
25,"25245",427,312,308,4,4,"VOX",11
5,"5133",61,44,43,0,1,"VOX",1
9,"9154",123,90,90,7,0,"VOX",13
31,"31244",157,69,69,0,0,"VOX",2
5,"5231",150,123,122,2,1,"VOX",25
46,"46023",322,254,252,1,2,"VOX",53
46,"46228",2426,1819,1802,19,17,"VOX",468
44,"44111",78,61,61,0,0,"VOX",3
42,"42165",414,246,237,4,9,"VOX",37
25,"25151",731,555,549,1,6,"VOX",17
42,"42031",25,17,17,1,0,"VOX",2
21,"21023",2033,1215,1193,10,22,"VOX",125
40,"40110",316,237,234,4,3,"VOX",36
10,"10117",238,133,130,0,3,"VOX",10
5,"5134",47,40,40,0,0,"VOX",3
43,"43126",1230,937,933,3,4,"VOX",63
37,"37110",104,81,79,1,2,"VOX",22
23,"23086",11427,7984,7735,81,249,"VOX",1286
38,"38007",1619,1053,1043,3,10,"VOX",85
46,"46229",903,715,708,5,7,"VOX",156
16,"16010",134,92,88,0,4,"VOX",17
10,"10199",154,99,99,2,0,"VOX",30
26,"26008",1821,1310,1290,15,20,"VOX",151
5,"5169",218,171,171,1,0,"VOX",18
10,"10159",314,207,207,2,0,"VOX",59
50,"50143",541,373,367,2,6,"VOX",81
42,"42032",138,96,96,0,0,"VOX",11
47,"47112",2561,1960,1933,13,27,"VOX",460
31,"31027",811,527,521,1,6,"VOX",0
24,"24199",398,263,256,4,7,"VOX",41
25,"25059",800,546,534,5,12,"VOX",65
49,"49264",529,334,329,2,5,"VOX",53
9,"9162",130,102,100,1,2,"VOX",14
31,"31028",215,121,121,2,0,"VOX",3
16,"16254",199,159,159,0,0,"VOX",19
42,"42033",50,48,48,2,0,"VOX",4
37,"37299",230,148,147,0,1,"VOX",42
37,"37112",158,110,109,2,1,"VOX",19
49,"49152",474,289,282,2,7,"VOX",54
30,"30015",19344,13502,13347,107,155,"VOX",3503
16,"16011",20,14,14,0,0,"VOX",3
6,"6084",1061,780,769,11,11,"VOX",151
40,"40015",23,19,19,0,0,"VOX",2
16,"16048",404,300,298,2,2,"VOX",78
14,"14033",1239,875,856,8,19,"VOX",146
37,"37238",105,83,80,0,3,"VOX",9
21,"21026",262,172,168,2,4,"VOX",15
31,"31249",1798,1235,1227,13,8,"VOX",57
12,"12130",414,329,327,0,2,"VOX",62
5,"5138",283,218,217,1,1,"VOX",48
42,"42035",730,464,460,3,4,"VOX",65
28,"28040",16741,10717,10604,79,113,"VOX",2739
29,"29095",3285,2313,2224,39,89,"VOX",266
19,"19262",125,98,98,0,0,"VOX",16
37,"37206",87,65,54,0,11,"VOX",11
31,"31139",152,100,100,1,0,"VOX",6
19,"19263",21,15,15,0,0,"VOX",3
9,"9218",350,254,252,5,2,"VOX",28
8,"8110",13671,9362,9311,60,51,"VOX",651
26,"26125",2665,1885,1853,21,32,"VOX",236
38,"38010",3969,2463,2418,11,45,"VOX",248
9,"9908",423,254,253,4,1,"VOX",48
43,"43129",4607,3284,3261,21,23,"VOX",206
6,"6132",823,543,533,4,10,"VOX",48
29,"29096",2757,1847,1790,19,57,"VOX",191
44,"44115",102,91,91,0,0,"VOX",5
37,"37334",71,30,30,0,0,"VOX",7
39,"39062",1864,1395,1376,3,19,"VOX",270
44,"44050",3113,2173,2154,14,19,"VOX",313
5,"5140",99,83,81,0,2,"VOX",13
5,"5236",105,69,69,1,0,"VOX",5
9,"9219",27097,17874,17629,192,245,"VOX",1754
30,"30018",8399,6226,6148,28,78,"VOX",1774
19,"19264",33,25,25,0,0,"VOX",2
16,"16015",349,242,239,6,3,"VOX",46
16,"16129",88,72,72,0,0,"VOX",17
31,"31252",80,52,52,1,0,"VOX",2
5,"5141",95,79,78,1,1,"VOX",7
7,"7044",8812,5679,5569,67,110,"VOX",1043
37,"37116",70,50,50,0,0,"VOX",7
49,"49156",218,149,144,0,5,"VOX",18
22,"22142",94,72,70,0,2,"VOX",4
45,"45140",1075,788,772,10,16,"VOX",140
47,"47116",396,304,302,2,2,"VOX",54
24,"24206",1594,1104,1093,11,11,"VOX",135
29,"29097",4160,2872,2800,56,72,"VOX",465
26,"26088",39,35,34,0,1,"VOX",6
46,"46233",3766,2688,2650,14,38,"VOX",452
10,"10125",859,561,546,3,15,"VOX",104
50,"50149",34,25,25,0,0,"VOX",3
21,"21029",1514,1036,1003,14,33,"VOX",124
42,"42175",22,16,16,0,0,"VOX",0
6,"6090",827,570,553,3,17,"VOX",72
25,"25253",147,118,117,0,1,"VOX",0
17,"17064",324,249,247,2,2,"VOX",7
21,"21030",1887,1493,1458,12,35,"VOX",292
45,"45032",445,290,286,2,4,"VOX",55
34,"34009",30,26,26,0,0,"VOX",3
50,"50223",906,702,693,9,9,"VOX",91
5,"5143",59,52,51,1,1,"VOX",3
49,"49158",206,159,155,0,4,"VOX",11
22,"22074",303,209,208,5,1,"VOX",18
31,"31144",760,442,441,4,1,"VOX",3
40,"40120",195,169,163,0,6,"VOX",45
10,"10127",4691,3044,2974,34,70,"VOX",647
8,"8009",9531,7200,7171,47,29,"VOX",432
29,"29025",41540,27170,26897,271,273,"VOX",6149
16,"16265",22,18,18,0,0,"VOX",3
9,"9172",131,88,88,1,0,"VOX",11
12,"12134",135,95,95,1,0,"VOX",25
17,"17009",4068,3061,3050,16,11,"VOX",45
20,"20028",2254,1442,1441,6,1,"VOX",11
12,"12058",59,47,45,1,2,"VOX",8
43,"43158",74,52,50,0,2,"VOX",0
32,"32019",11469,7336,7225,98,111,"VOX",668
31,"31256",95,55,55,1,0,"VOX",0
10,"10128",5618,3799,3630,37,169,"VOX",650
46,"46030",810,641,625,7,16,"VOX",86
37,"37212",104,76,76,0,0,"VOX",14
37,"37119",99,78,78,1,0,"VOX",9
5,"5144",65,47,46,1,1,"VOX",4
19,"19177",60,45,45,0,0,"VOX",2
50,"50225",1532,983,971,12,12,"VOX",282
42,"42043",3816,2602,2540,23,62,"VOX",416
6,"6139",498,402,395,4,7,"VOX",53
29,"29100",2379,1582,1551,22,31,"VOX",245
43,"43133",5627,3794,3773,31,21,"VOX",240
25,"25068",515,359,358,0,1,"VOX",6
29,"29901",44757,29291,28960,307,331,"VOX",6598
9,"9174",768,536,522,6,14,"VOX",59
8,"8253",132,103,102,0,1,"VOX",0
15,"15020",3568,2226,2217,19,9,"VOX",123
49,"49162",170,117,116,1,1,"VOX",11
25,"25161",339,221,221,0,0,"VOX",0
43,"43055",1970,1548,1535,12,13,"VOX",31
37,"37309",36,21,21,0,0,"VOX",2
9,"9019",146,105,103,4,2,"VOX",9
9,"9175",120,78,76,1,2,"VOX",8
6,"6096",206,158,153,0,5,"VOX",26
40,"40123",141,98,94,4,4,"VOX",8
5,"5147",144,101,99,0,2,"VOX",26
42,"42182",49,39,39,1,0,"VOX",1
10,"10131",12803,8477,8347,77,130,"VOX",1994
16,"16135",115,76,76,0,0,"VOX",12
30,"30022",17108,11041,10851,100,190,"VOX",2366
50,"50152",1351,942,932,14,10,"VOX",155
50,"50001",89,68,68,0,0,"VOX",10
31,"31259",475,313,311,5,2,"VOX",5
16,"16137",37,27,25,0,2,"VOX",9
26,"26020",449,319,313,1,6,"VOX",29
39,"39040",4271,3103,3080,18,23,"VOX",509
42,"42046",46,32,32,0,0,"VOX",5
31,"31149",2285,1531,1520,10,11,"VOX",27
43,"43056",803,566,558,6,8,"VOX",15
15,"15022",5580,3508,3472,47,36,"VOX",294
47,"47217",1984,1460,1437,11,23,"VOX",360
10,"10010",2206,1308,1281,8,27,"VOX",232
45,"45148",263,184,184,0,0,"VOX",28
17,"17096",159,116,116,3,0,"VOX",0
43,"43162",4436,3191,3163,24,28,"VOX",248
19,"19181",50,34,34,0,0,"VOX",8
38,"38041",7025,4729,4684,42,45,"VOX",486
31,"31260",1265,817,815,7,2,"VOX",37
16,"16024",121,85,84,0,1,"VOX",8
9,"9178",39,24,24,0,0,"VOX",2
19,"19182",37,32,32,0,0,"VOX",8
42,"42048",60,52,52,0,0,"VOX",11
49,"49165",55,52,52,1,0,"VOX",12
9,"9179",39,30,30,1,0,"VOX",1
5,"5149",101,72,71,2,1,"VOX",8
50,"50229",65,46,46,1,0,"VOX",10
46,"46171",16446,11616,11499,94,117,"VOX",1990
27,"27026",2299,1385,1368,9,17,"VOX",109
10,"10012",553,427,421,1,6,"VOX",34
41,"41068",13963,9596,9407,96,189,"VOX",1144
31,"31151",53,37,37,0,0,"VOX",0
19,"19183",70,59,58,0,1,"VOX",4
10,"10135",1240,834,826,3,8,"VOX",109
23,"23901",1125,905,895,3,10,"VOX",171
50,"50102",815,594,584,7,10,"VOX",86
19,"19305",139,104,103,1,1,"VOX",25
42,"42092",61,40,39,0,1,"VOX",17
30,"30025",5016,3663,3623,22,40,"VOX",1131
8,"8013",1287,982,972,6,10,"VOX",46
37,"37156",4261,2928,2869,23,59,"VOX",703
50,"50180",107,85,85,1,0,"VOX",2
34,"34022",1022,813,798,7,15,"VOX",62
37,"37125",231,154,148,1,6,"VOX",31
49,"49167",180,131,131,2,0,"VOX",11
5,"5152",644,498,496,3,2,"VOX",130
30,"30001",4507,3357,3331,17,26,"VOX",760
26,"26101",31,18,17,0,1,"VOX",1
5,"5246",48,35,35,0,0,"VOX",1
11,"11026",4700,3387,3293,17,94,"VOX",666
31,"31044",291,227,227,1,0,"VOX",0
38,"38043",19365,12355,12212,126,143,"VOX",1320
43,"43138",2636,1761,1745,11,16,"VOX",139
46,"46035",6828,5155,5089,33,66,"VOX",828
19,"19274",953,693,676,9,17,"VOX",177
9,"9238",931,473,461,1,12,"VOX",58
50,"50028",78,53,53,0,0,"VOX",17
16,"16064",651,556,550,4,6,"VOX",104
46,"46036",558,339,331,6,8,"VOX",93
24,"24217",135,93,93,0,0,"VOX",13
50,"50156",212,156,151,2,5,"VOX",20
5,"5153",86,58,56,3,2,"VOX",8
5,"5249",96,63,63,0,0,"VOX",3
6,"6104",648,470,459,2,11,"VOX",45
25,"25074",179,155,151,2,4,"VOX",5
7,"7056",5271,3429,3386,44,43,"VOX",470
9,"9352",102,74,74,0,0,"VOX",9
10,"10139",92,66,65,1,1,"VOX",2
8,"8074",11190,7698,7651,51,47,"VOX",686
25,"25109",211,155,154,1,1,"VOX",3
42,"42053",21,17,17,0,0,"VOX",1
8,"8190",255,184,182,1,2,"VOX",3
12,"12141",92,72,72,0,0,"VOX",11
11,"11028",32829,21934,21654,310,280,"VOX",2270
24,"24219",489,334,329,7,5,"VOX",54
42,"42054",18,12,12,0,0,"VOX",0
26,"26028",135,111,110,3,1,"VOX",17
25,"25138",558,427,424,2,3,"VOX",12
39,"39102",2229,1524,1514,10,10,"VOX",257
16,"16066",2280,1765,1734,18,31,"VOX",455
13,"13041",236,155,155,3,0,"VOX",33
44,"44215",167,113,113,2,0,"VOX",17
10,"10141",284,207,205,1,2,"VOX",41
17,"17075",340,257,256,2,1,"VOX",10
16,"16031",35,26,26,0,0,"VOX",5
49,"49171",603,433,427,4,6,"VOX",51
50,"50159",640,493,486,3,7,"VOX",92
37,"37024",89,60,60,0,0,"VOX",14
50,"50183",316,227,223,1,4,"VOX",53
45,"45119",3499,2217,2190,3,27,"VOX",702
5,"5252",56,46,45,0,1,"VOX",5
40,"40225",1085,822,809,5,13,"VOX",189
37,"37129",248,181,181,1,0,"VOX",28
37,"37223",106,75,74,0,1,"VOX",7
9,"9191",33,23,23,1,0,"VOX",1
43,"43141",109,85,84,0,1,"VOX",6
49,"49209",451,274,269,7,5,"VOX",56
23,"23071",1704,1278,1258,10,20,"VOX",363
8,"8053",2896,1939,1929,13,10,"VOX",172
6,"6154",2799,1851,1782,20,69,"VOX",346
29,"29035",1478,1054,1040,3,14,"VOX",90
12,"12069",50,38,38,0,0,"VOX",11
24,"24222",14499,10219,10076,99,143,"VOX",2082
50,"50160",2140,1421,1394,14,27,"VOX",197
49,"49172",474,278,271,1,7,"VOX",25
9,"9192",54,46,45,1,1,"VOX",0
19,"19188",36,31,31,0,0,"VOX",11
17,"17077",565,395,394,2,1,"VOX",17
19,"19189",114,87,84,0,3,"VOX",23
5,"5157",227,146,146,3,0,"VOX",18
42,"42057",145,70,70,0,0,"VOX",9
37,"37130",173,135,134,2,1,"VOX",25
9,"9194",1970,1376,1359,15,17,"VOX",179
16,"16239",118,88,87,0,1,"VOX",11
10,"10185",558,376,374,2,2,"VOX",60
25,"25172",1762,1332,1323,8,9,"VOX",26
16,"16149",147,105,105,2,0,"VOX",16
29,"29037",215,156,153,1,3,"VOX",25
10,"10022",409,301,291,1,10,"VOX",13
42,"42103",543,383,374,2,9,"VOX",52
10,"10145",123,90,84,0,6,"VOX",8
42,"42058",103,74,72,1,2,"VOX",9
16,"16902",124,86,86,1,0,"VOX",14
9,"9360",26,19,19,0,0,"VOX",3
24,"24224",564,381,375,5,6,"VOX",52
31,"31906",2707,1800,1781,22,19,"VOX",160
31,"31051",241,169,167,3,2,"VOX",25
20,"20041",241,143,142,2,1,"VOX",0
9,"9248",80,62,61,1,1,"VOX",9
31,"31198",36,30,30,0,0,"VOX",2
7,"7062",7972,3946,3896,42,50,"VOX",598
24,"24225",979,678,668,5,10,"VOX",128
16,"16035",224,177,174,2,3,"VOX",22
9,"9196",133,95,95,2,0,"VOX",7
16,"16903",992,750,732,8,18,"VOX",180
50,"50297",503800,365284,362768,3385,2516,"VOX",62872
44,"44040",189,153,150,1,3,"VOX",21
49,"49176",605,360,353,0,7,"VOX",46
31,"31089",236,168,167,1,1,"VOX",7
37,"37164",232,176,175,3,1,"VOX",43
14,"14051",1323,975,951,7,24,"VOX",104
13,"13003",448,329,319,1,10,"VOX",47
7,"7063",1434,1025,1016,10,9,"VOX",127
5,"5160",289,220,213,0,7,"VOX",33
42,"42061",270,188,186,5,2,"VOX",23
46,"46246",1049,808,793,3,15,"VOX",234
46,"46041",313,229,228,1,1,"VOX",28
37,"37134",209,143,141,3,2,"VOX",39
50,"50163",3846,2863,2840,25,23,"VOX",789
5,"5161",545,395,395,0,0,"VOX",109
40,"40233",399,279,273,0,6,"VOX",51
38,"38026",33585,24091,23889,170,202,"VOX",2185
49,"49177",255,145,144,1,1,"VOX",16
7,"7064",5566,3232,3204,18,28,"VOX",370
50,"50084",67,47,47,1,0,"VOX",6
10,"10149",432,284,280,2,4,"VOX",28
27,"27006",2441,1479,1460,11,19,"VOX",196
25,"25115",803,601,593,4,8,"VOX",7
22,"22239",85,67,65,0,2,"VOX",12
12,"12098",529,417,413,3,4,"VOX",109
31,"31164",542,410,408,5,2,"VOX",42
37,"37135",1146,849,837,5,12,"VOX",173
28,"28061",22757,17091,16965,115,126,"VOX",3791
29,"29086",770,479,476,5,3,"VOX",95
25,"25251",708,526,524,1,2,"VOX",19
26,"26037",125,98,98,3,0,"VOX",13
6,"6117",1388,982,958,11,24,"VOX",167
42,"42063",45,31,30,1,1,"VOX",2
9,"9200",48,29,29,0,0,"VOX",3
21,"21048",318,234,229,3,5,"VOX",39
43,"43147",528,425,420,3,5,"VOX",4
28,"28062",306,232,227,0,5,"VOX",80
6,"6072",2211,1610,1586,11,24,"VOX",302
40,"40072",224,175,171,1,4,"VOX",54
30,"30010",6852,5161,5106,25,55,"VOX",1563
10,"10151",189,145,142,2,3,"VOX",13
37,"37136",625,388,387,7,1,"VOX",53
9,"9368",29,19,19,1,0,"VOX",2
24,"24229",376,275,269,2,6,"VOX",37
10,"10152",444,312,309,2,3,"VOX",65
23,"23007",3015,2252,2229,14,23,"VOX",437
9,"9201",27,17,17,0,0,"VOX",2
50,"50165",1768,1255,1222,20,33,"VOX",208
25,"25176",307,241,238,3,3,"VOX",11
19,"19194",91,69,69,0,0,"VOX",9
17,"17082",435,308,307,1,1,"VOX",20
6,"6120",3370,2507,2460,11,47,"VOX",338
10,"10030",455,311,305,2,6,"VOX",52
10,"10153",281,183,181,0,2,"VOX",15
9,"9202",22,16,16,2,0,"VOX",1
49,"49223",701,498,494,7,4,"VOX",53
42,"42065",23,18,18,1,0,"VOX",2
40,"40902",113,78,76,1,2,"VOX",13
5,"5164",18,12,12,0,0,"VOX",1
32,"32005",810,576,568,9,8,"VOX",45
8,"8289",4473,3379,3371,25,8,"VOX",153
26,"26003",379,311,306,1,5,"VOX",23
30,"30011",4702,3390,3324,8,66,"VOX",939
19,"19288",21,20,20,2,0,"VOX",5
8,"8001",9097,6860,6818,39,42,"VOX",615
26,"26004",69,47,46,0,1,"VOX",7
44,"44044",82,65,65,2,0,"VOX",12
9,"9208",176,121,120,4,1,"VOX",19
5,"5165",361,266,261,4,5,"VOX",33
45,"45205",7438,4772,4701,27,71,"VOX",1557
27,"27042",1639,1120,1107,8,13,"VOX",50
37,"37139",189,150,148,1,2,"VOX",34
44,"44256",36,30,30,2,0,"VOX",3
9,"9483",189,156,155,2,1,"VOX",29
16,"16119",175,117,115,0,2,"VOX",22
9,"9374",93,75,72,2,3,"VOX",9
37,"37296",297,215,210,0,5,"VOX",21
8,"8083",1672,1433,1430,6,3,"VOX",16
23,"23010",14264,9801,9635,120,166,"VOX",2476
8,"8128",579,428,423,4,5,"VOX",17
34,"34182",746,558,553,9,5,"VOX",67
7,"7036",28132,18650,18510,222,140,"VOX",3949
45,"45132",2387,1765,1754,13,11,"VOX",536
43,"43150",1233,954,941,6,13,"VOX",24
10,"10156",97,71,69,0,2,"VOX",3
49,"49184",172,110,107,2,3,"VOX",21
25,"25001",143,102,102,1,0,"VOX",0
17,"17085",293,239,238,0,1,"VOX",2
21,"21053",3306,2161,2106,11,55,"VOX",420
44,"44225",105,82,81,2,1,"VOX",6
9,"9377",626,468,460,6,8,"VOX",102
5,"5264",54,32,31,4,1,"VOX",12
11,"11041",9869,6438,6295,100,143,"VOX",1343
10,"10157",246,163,161,0,2,"VOX",24
9,"9051",164,125,125,0,0,"VOX",11
50,"50016",44,31,31,0,0,"VOX",10
43,"43151",107,88,88,0,0,"VOX",2
8,"8200",62225,45235,44991,306,244,"VOX",3280
45,"45170",194,146,140,0,6,"VOX",21
8,"8003",7213,5425,5409,41,16,"VOX",283
43,"43152",435,348,342,2,6,"VOX",7
49,"49186",230,172,170,0,2,"VOX",32
16,"16046",213,142,142,0,0,"VOX",20
42,"42073",73,56,55,0,1,"VOX",13
28,"28007",127491,96937,96102,810,835,"VOX",15705
24,"24198",541,346,344,6,2,"VOX",26
17,"17030",654,460,459,1,1,"VOX",37
25,"25181",172,137,137,1,0,"VOX",2
13,"13016",656,463,454,3,9,"VOX",144
32,"32010",364,271,267,2,4,"VOX",21
25,"25003",3717,2577,2561,15,16,"VOX",111
49,"49187",1197,839,819,12,20,"VOX",169
9,"9215",359,217,216,2,1,"VOX",34
42,"42211",84,67,67,0,0,"VOX",13
38,"38033",3593,2277,2242,15,35,"VOX",157
8,"8201",455,319,318,12,1,"VOX",4
37,"37142",554,396,394,5,2,"VOX",113
9,"9381",28,19,19,0,0,"VOX",0
28,"28146",1806,1232,1218,3,14,"VOX",301
9,"9216",370,245,241,3,4,"VOX",51
10,"10160",240,179,177,2,2,"VOX",24
31,"31174",100,55,55,0,0,"VOX",4
50,"50219",4283,3034,2990,30,44,"VOX",797
46,"46048",3504,2609,2576,17,33,"VOX",336
26,"26123",128,110,110,0,0,"VOX",7
43,"43127",775,607,606,3,1,"VOX",17
46,"46231",2403,1670,1652,11,18,"VOX",198
13,"13018",774,625,622,0,3,"VOX",135
26,"26010",85,66,63,1,3,"VOX",8
17,"17088",599,467,465,3,2,"VOX",14
49,"49266",66,46,45,1,1,"VOX",7
29,"29048",1364,1053,1039,8,14,"VOX",39
38,"38034",3997,2687,2648,19,39,"VOX",362
49,"49189",186,104,104,1,0,"VOX",12
10,"10162",519,401,394,4,7,"VOX",28
37,"37144",327,233,233,2,0,"VOX",60
42,"42079",21,17,17,1,0,"VOX",1
47,"47050",3908,2713,2673,39,40,"VOX",625
14,"14034",302,222,215,1,7,"VOX",28
8,"8005",6425,4830,4816,28,14,"VOX",259
28,"28071",63,46,45,0,1,"VOX",17
40,"40080",51,31,31,0,0,"VOX",8
17,"17089",5749,3973,3949,17,24,"VOX",169
30,"30017",11428,8196,8113,44,83,"VOX",2004
49,"49190",50,42,42,3,0,"VOX",5
42,"42125",71,55,55,0,0,"VOX",11
31,"31177",245,161,159,1,2,"VOX",10
29,"29050",392,229,227,3,2,"VOX",32
6,"6147",329,234,234,1,0,"VOX",17
31,"31213",99,50,50,0,0,"VOX",3
8,"8006",11774,8375,8329,53,46,"VOX",360
10,"10164",707,391,382,4,9,"VOX",56
46,"46096",263,204,202,0,2,"VOX",49
20,"20904",87,56,55,1,1,"VOX",0
12,"12056",257,205,199,1,6,"VOX",28
16,"16051",128,96,96,3,0,"VOX",14
9,"9387",107,89,88,0,1,"VOX",3
32,"32015",817,454,452,2,2,"VOX",35
31,"31068",2816,2028,1989,20,39,"VOX",178
45,"45104",419,328,324,1,4,"VOX",65
5,"5173",60,54,54,0,0,"VOX",22
37,"37146",106,82,76,0,6,"VOX",18
19,"19203",29,25,25,0,0,"VOX",7
10,"10165",252,204,201,3,3,"VOX",16
10,"10043",746,525,520,4,5,"VOX",74
29,"29051",42179,27231,26724,282,507,"VOX",7111
19,"19204",150,105,104,3,1,"VOX",27
21,"21059",221,169,163,1,6,"VOX",1
42,"42082",8,8,8,0,0,"VOX",0
42,"42218",68,44,43,0,1,"VOX",1
13,"13069",613,438,419,2,19,"VOX",116
5,"5174",62,51,51,1,0,"VOX",8
26,"26128",94,71,71,1,0,"VOX",8
8,"8273",2390,1871,1855,14,16,"VOX",56
10,"10166",307,197,195,0,2,"VOX",21
26,"26169",66,51,50,0,1,"VOX",4
17,"17091",391,296,290,3,6,"VOX",3
29,"29052",213,129,128,0,1,"VOX",32
50,"50174",80,58,57,0,1,"VOX",9
9,"9390",554,455,450,6,5,"VOX",54
46,"46120",1179,903,880,5,23,"VOX",132
38,"38037",12817,7582,7494,55,88,"VOX",584
42,"42129",678,485,480,6,5,"VOX",49
37,"37148",399,295,291,0,4,"VOX",60
30,"30020",6503,4521,4484,35,37,"VOX",1386
10,"10168",320,210,206,1,4,"VOX",33
12,"12029",670,524,514,5,10,"VOX",67
5,"5175",144,109,109,0,0,"VOX",24
20,"20058",740,523,522,3,1,"VOX",8
37,"37045",27,19,19,0,0,"VOX",6
45,"45181",2330,1693,1661,10,32,"VOX",416
28,"28087",3301,2539,2519,20,20,"VOX",631
49,"49194",331,198,197,0,1,"VOX",35
46,"46189",469,374,367,2,7,"VOX",56
49,"49090",190,135,134,3,1,"VOX",28
31,"31035",50,30,29,0,1,"VOX",1
6,"6002",4313,2914,2804,37,110,"VOX",620
23,"23024",12215,8702,8447,69,255,"VOX",1510
13,"13027",3185,2112,2055,12,57,"VOX",386
12,"12085",5081,3271,3235,17,36,"VOX",774
16,"16171",1728,1334,1313,10,21,"VOX",244
16,"16056",442,275,270,4,5,"VOX",69
26,"26018",10443,7664,7538,80,126,"VOX",679
17,"17037",112,86,86,1,0,"VOX",5
21,"21062",1403,849,838,10,11,"VOX",197
9,"9279",166,116,114,1,2,"VOX",12
6,"6003",768,579,557,4,22,"VOX",59
50,"50250",54,44,44,2,0,"VOX",12
37,"37150",34,31,31,0,0,"VOX",6
22,"22076",285,207,203,4,4,"VOX",24
26,"26019",346,260,251,2,9,"VOX",39
8,"8010",4224,3109,3090,22,19,"VOX",129
42,"42086",33,19,19,1,0,"VOX",2
43,"43160",1324,967,956,6,11,"VOX",81
21,"21063",2611,1948,1891,23,57,"VOX",233
40,"40154",22,18,18,1,0,"VOX",1
17,"17094",1058,757,747,3,10,"VOX",35
44,"44055",75,52,50,0,2,"VOX",4
46,"46054",11389,8266,8190,54,76,"VOX",1420
28,"28155",487,374,369,0,5,"VOX",58
8,"8023",7029,5027,5000,39,27,"VOX",349
37,"37151",142,109,109,1,0,"VOX",18
42,"42087",51,45,42,1,3,"VOX",6
37,"37341",47,29,29,0,0,"VOX",4
32,"32022",1238,840,835,10,5,"VOX",38
50,"50126",2240,1528,1509,24,19,"VOX",292
16,"16058",94,71,71,1,0,"VOX",8
9,"9396",149,121,121,4,0,"VOX",26
22,"22189",175,142,142,1,0,"VOX",11
16,"16099",179,108,105,0,3,"VOX",21
43,"43161",17103,11905,11838,82,67,"VOX",549
26,"26021",2742,1967,1932,14,35,"VOX",368
43,"43004",6288,4314,4262,36,52,"VOX",227
5,"5212",197,117,117,0,0,"VOX",20
40,"40156",272,194,190,4,4,"VOX",25
50,"50025",4541,3110,3083,39,27,"VOX",647
32,"32023",1130,787,782,2,5,"VOX",35
25,"25012",2349,1563,1556,17,7,"VOX",76
44,"44093",78,62,61,0,1,"VOX",4
50,"50178",269,165,163,6,2,"VOX",16
21,"21065",259,178,175,0,3,"VOX",41
45,"45002",2619,1676,1663,14,13,"VOX",410
10,"10051",421,316,308,0,8,"VOX",62
5,"5180",76,55,53,0,2,"VOX",8
26,"26022",177,130,128,0,2,"VOX",16
37,"37249",37,28,28,0,0,"VOX",2
9,"9070",33,28,27,0,1,"VOX",1
9,"9231",57,35,35,2,0,"VOX",9
32,"32025",1014,731,718,5,13,"VOX",37
50,"50179",255,197,197,0,0,"VOX",26
22,"22193",272,199,194,4,5,"VOX",20
15,"15055",4446,2829,2762,50,67,"VOX",209
50,"50101",833,557,550,5,7,"VOX",93
24,"24141",96,74,74,0,0,"VOX",21
37,"37155",68,48,48,0,0,"VOX",9
21,"21067",406,274,271,3,3,"VOX",20
43,"43163",26162,17276,17128,98,148,"VOX",1608
17,"17097",200,170,167,2,3,"VOX",2
31,"31226",572,347,343,4,4,"VOX",7
45,"45077",546,413,409,0,4,"VOX",112
26,"26060",78,51,50,2,1,"VOX",5
16,"16102",1159,815,767,9,48,"VOX",164
9,"9405",122,94,91,0,3,"VOX",18
42,"42050",27,17,17,0,0,"VOX",3
16,"16177",83,65,65,1,0,"VOX",18
10,"10176",344,223,213,2,10,"VOX",45
30,"30009",12728,9487,9365,46,122,"VOX",2353
17,"17015",12829,9612,9580,51,32,"VOX",196
46,"46149",350,252,249,3,3,"VOX",65
6,"6011",24731,16786,16538,167,248,"VOX",4216
26,"26025",84,69,65,2,4,"VOX",3
13,"13037",776,573,563,2,10,"VOX",83
14,"14044",1613,1186,1164,10,22,"VOX",206
9,"9350",421,316,311,5,5,"VOX",73
8,"8211",33934,26136,26000,198,136,"VOX",1671
9,"9236",34,25,25,1,0,"VOX",5
8,"8014",2013,1526,1521,4,5,"VOX",57
45,"45116",666,492,489,4,3,"VOX",132
50,"50054",55,37,37,2,0,"VOX",6
45,"45042",172,122,121,0,1,"VOX",23
12,"12010",232,191,187,3,4,"VOX",19
24,"24178",60,54,54,1,0,"VOX",5
17,"17099",78,55,55,0,0,"VOX",2
37,"37252",99,65,65,1,0,"VOX",20
49,"49206",776,515,504,7,11,"VOX",67
13,"13039",14195,10104,9933,122,171,"VOX",1885
43,"43008",305,171,171,7,0,"VOX",16
19,"19216",127,88,88,0,0,"VOX",9
32,"32029",441,286,283,2,3,"VOX",8
21,"21070",6294,4232,4124,64,108,"VOX",626
24,"24069",37,26,25,0,1,"VOX",2
37,"37315",89,65,64,0,1,"VOX",9
30,"30027",50067,36417,36074,242,343,"VOX",9948
43,"43009",1384,966,959,5,7,"VOX",52
50,"50206",457,349,345,5,4,"VOX",51
43,"43166",1646,1183,1176,4,7,"VOX",109
44,"44063",63,52,52,0,0,"VOX",5
17,"17132",1344,1019,1009,12,10,"VOX",47
40,"40129",159,119,117,2,2,"VOX",28
40,"40161",32,24,23,1,1,"VOX",8
37,"37378",92,54,54,0,0,"VOX",13
25,"25202",108,72,72,2,0,"VOX",0
17,"17101",566,389,382,1,7,"VOX",23
42,"42097",14,9,9,1,0,"VOX",1
6,"6152",1273,888,867,7,21,"VOX",133
40,"40162",380,273,265,1,8,"VOX",62
45,"45193",586,478,469,0,9,"VOX",111
22,"22122",69,52,50,2,2,"VOX",8
19,"19218",43,31,31,0,0,"VOX",6
12,"12142",142,113,113,0,0,"VOX",30
20,"20078",1143,819,816,1,3,"VOX",0
43,"43036",869,565,557,7,8,"VOX",61
41,"41016",7820,5523,5407,57,116,"VOX",1135
40,"40194",39173,28641,28260,353,381,"VOX",4132
46,"46083",15372,10939,10815,78,124,"VOX",2604
26,"26029",34,26,26,1,0,"VOX",1
19,"19219",9,8,7,0,1,"VOX",1
37,"37379",169,133,132,0,1,"VOX",36
31,"31903",6950,4430,4394,39,36,"VOX",238
23,"23035",1111,877,856,2,21,"VOX",137
9,"9302",96,66,66,0,0,"VOX",10
46,"46129",511,389,379,9,10,"VOX",32
16,"16189",264,196,194,4,2,"VOX",50
32,"32032",7900,5186,5091,48,95,"VOX",540
8,"8017",2808,2033,2016,16,17,"VOX",78
46,"46061",351,276,272,6,4,"VOX",47
9,"9244",45,31,31,2,0,"VOX",6
43,"43168",83,55,55,1,0,"VOX",0
25,"25020",270,202,201,2,1,"VOX",6
23,"23038",3786,2934,2900,21,34,"VOX",705
9,"9413",405,267,263,0,4,"VOX",53
38,"38047",1755,1132,1110,9,22,"VOX",115
26,"26031",95,83,83,0,0,"VOX",6
10,"10021",4987,3574,3475,31,99,"VOX",380
44,"44158",1153,879,872,6,7,"VOX",124
12,"12095",950,723,712,5,11,"VOX",96
38,"38048",3952,2543,2519,22,24,"VOX",242
5,"5188",39,33,33,0,0,"VOX",4
9,"9414",180,137,135,1,2,"VOX",12
24,"24076",1283,926,913,10,13,"VOX",171
19,"19220",2608,1673,1653,10,20,"VOX",596
37,"37163",34,24,24,0,0,"VOX",8
17,"17105",248,187,186,2,1,"VOX",6
49,"49214",666,486,477,6,9,"VOX",87
10,"10186",951,756,735,6,21,"VOX",89
30,"30031",497,387,382,1,5,"VOX",84
43,"43092",7308,4703,4679,33,24,"VOX",551
42,"42105",47,40,40,2,0,"VOX",6
50,"50186",37,26,26,1,0,"VOX",5
9,"9138",84,67,66,1,1,"VOX",9
13,"13047",5782,4232,4160,27,72,"VOX",762
43,"43170",877,664,661,4,3,"VOX",27
49,"49216",147,115,109,0,6,"VOX",16
10,"10064",1400,998,972,3,26,"VOX",138
10,"10187",431,288,281,0,7,"VOX",19
37,"37352",209,157,155,3,2,"VOX",39
30,"30032",2864,2154,2129,18,25,"VOX",542
37,"37258",134,92,92,1,0,"VOX",14
40,"40199",101,76,72,2,4,"VOX",10
25,"25050",3256,2260,2249,20,11,"VOX",50
31,"31236",1319,815,808,8,7,"VOX",29
25,"25206",247,188,188,2,0,"VOX",4
9,"9249",47,35,35,3,0,"VOX",4
24,"24041",513,312,305,4,7,"VOX",46
6,"6023",4138,2811,2749,12,62,"VOX",217
31,"31090",139,67,67,0,0,"VOX",4
13,"13049",742,509,500,4,9,"VOX",169
9,"9250",264,195,193,3,2,"VOX",24
5,"5191",121,99,99,0,0,"VOX",6
30,"30033",10377,7330,7215,59,115,"VOX",1871
49,"49220",146,102,98,3,4,"VOX",14
26,"26035",16,12,11,0,1,"VOX",0
37,"37165",31,22,22,0,0,"VOX",3
8,"8147",17389,12679,12601,102,78,"VOX",815
23,"23042",292,219,219,0,0,"VOX",52
42,"42108",10,7,7,0,0,"VOX",0
37,"37322",2462,1580,1537,14,43,"VOX",331
42,"42023",57,48,48,0,0,"VOX",8
40,"40168",27,20,20,0,0,"VOX",3
43,"43172",334,248,243,4,5,"VOX",7
25,"25118",326,223,218,0,5,"VOX",7
44,"44013",11232,7872,7801,64,71,"VOX",1364
6,"6162",2885,2067,2032,19,35,"VOX",293
9,"9011",70,42,40,0,2,"VOX",9
46,"46186",19689,14688,14576,118,112,"VOX",3066
25,"25155",616,446,443,2,3,"VOX",17
28,"28106",78872,54111,53443,412,668,"VOX",11781
11,"11005",4508,2978,2900,34,78,"VOX",392
46,"46156",2017,1538,1524,9,14,"VOX",208
11,"11036",683,401,395,15,6,"VOX",45
10,"10068",707,532,521,4,11,"VOX",82
17,"17025",1182,943,938,5,5,"VOX",34
10,"10150",339,279,275,3,4,"VOX",23
50,"50061",190,157,155,2,2,"VOX",14
19,"19254",43,34,34,0,0,"VOX",7
19,"19225",851,618,611,2,7,"VOX",203
25,"25119",2258,1701,1686,11,15,"VOX",26
45,"45092",223,193,190,1,3,"VOX",48
23,"23079",3624,2661,2630,19,31,"VOX",470
50,"50012",94,76,72,0,4,"VOX",11
37,"37356",84,58,58,0,0,"VOX",5
10,"10111",1297,888,872,11,16,"VOX",168
42,"42113",510,370,366,2,4,"VOX",44
39,"39082",1611,1108,1102,8,6,"VOX",210
9,"9423",27,24,24,1,0,"VOX",4
44,"44164",19,16,16,1,0,"VOX",2
46,"46203",3546,2717,2689,28,28,"VOX",374
5,"5194",132,105,104,1,1,"VOX",21
30,"30035",19432,13174,13013,114,161,"VOX",4134
50,"50140",153,96,95,1,1,"VOX",35
21,"21019",592,397,389,6,8,"VOX",42
46,"46226",29,20,19,0,1,"VOX",1
50,"50037",125,85,80,0,5,"VOX",27
46,"46021",24053,17331,17194,159,137,"VOX",3298
31,"31022",477,303,301,2,2,"VOX",2
19,"19226",37,22,22,0,0,"VOX",2
49,"49224",166,102,100,0,2,"VOX",22
16,"16082",272,194,192,1,2,"VOX",33
44,"44252",73,56,55,0,1,"VOX",12
9,"9258",165,128,127,0,1,"VOX",20
16,"16198",1281,938,928,6,10,"VOX",199
5,"5196",57,43,43,0,0,"VOX",5
31,"31205",419,290,289,4,1,"VOX",17
36,"36004",10109,6611,6502,79,109,"VOX",387
49,"49225",122,68,68,0,0,"VOX",6
23,"23047",1558,1203,1186,8,17,"VOX",184
50,"50064",439,348,346,1,2,"VOX",43
46,"46136",2598,1875,1851,14,24,"VOX",366
43,"43132",375,295,291,1,4,"VOX",7
23,"23095",8571,6159,6101,37,58,"VOX",1464
16,"16266",356,269,265,4,4,"VOX",54
27,"27011",2341,1387,1362,7,25,"VOX",113
8,"8290",1549,1254,1248,6,6,"VOX",56
16,"16199",27,18,18,0,0,"VOX",5
8,"8244",6099,4733,4706,39,27,"VOX",251
23,"23059",5736,4245,4119,51,126,"VOX",674
31,"31024",100,52,52,0,0,"VOX",0
29,"29090",1649,1138,1124,10,14,"VOX",343
16,"16158",513,371,366,5,5,"VOX",64
15,"15072",9434,6304,6228,48,76,"VOX",514
20,"20080",7705,5276,5244,21,32,"VOX",100
17,"17029",207,154,154,1,0,"VOX",13
46,"46205",14237,10641,10533,77,108,"VOX",1814
25,"25030",117,76,76,0,0,"VOX",2
10,"10197",106,74,74,0,0,"VOX",17
22,"22003",135,107,107,0,0,"VOX",8
43,"43099",284,214,214,4,0,"VOX",2
49,"49227",317,245,244,4,1,"VOX",51
31,"31208",2568,1855,1835,24,20,"VOX",147
10,"10076",791,537,525,10,12,"VOX",88
43,"43020",2291,1712,1688,19,24,"VOX",137
37,"37266",68,44,44,0,0,"VOX",9
31,"31099",51,38,38,0,0,"VOX",4
6,"6035",851,630,620,0,10,"VOX",103
42,"42119",141,78,78,1,0,"VOX",13
40,"40176",372,288,287,2,1,"VOX",20
49,"49228",53,36,36,0,0,"VOX",9
37,"37267",177,130,129,0,1,"VOX",22
31,"31135",111,73,72,3,1,"VOX",7
14,"14059",679,527,521,11,6,"VOX",99
31,"31063",84,59,59,0,0,"VOX",1
26,"26007",482,360,348,0,12,"VOX",36
17,"17058",176,128,128,0,0,"VOX",2
6,"6036",4930,3492,3394,20,98,"VOX",434
16,"16086",872,699,690,7,9,"VOX",85
17,"17031",178,117,117,0,0,"VOX",6
31,"31173",845,642,636,4,6,"VOX",65
7,"7006",5393,3257,3220,34,37,"VOX",330
31,"31100",256,166,165,0,1,"VOX",8
25,"25032",65,53,52,0,1,"VOX",0
26,"26045",11,10,10,1,0,"VOX",0
37,"37174",975,716,705,2,11,"VOX",110
13,"13063",3648,2464,2406,28,58,"VOX",501
40,"40178",85,61,60,0,1,"VOX",12
10,"10079",848,641,632,2,9,"VOX",130
42,"42121",54,39,39,0,0,"VOX",9
26,"26009",394,282,278,1,4,"VOX",20
38,"38009",4315,2846,2817,27,29,"VOX",266
28,"28009",14593,11026,10913,73,113,"VOX",2657
31,"31248",272,142,138,3,4,"VOX",4
15,"15044",1194,806,788,7,18,"VOX",46
44,"44228",96,75,74,0,1,"VOX",14
43,"43048",768,564,554,7,10,"VOX",15
16,"16125",1607,1166,1150,11,16,"VOX",309
26,"26083",337,255,250,3,5,"VOX",28
9,"9056",4833,3191,3156,37,35,"VOX",564
37,"37175",412,298,293,4,5,"VOX",43
16,"16089",381,292,289,8,3,"VOX",51
25,"25033",1120,838,831,5,7,"VOX",27
5,"5201",497,404,401,0,3,"VOX",49
23,"23053",9451,6038,5975,60,63,"VOX",474
47,"47081",39,32,32,0,0,"VOX",4
46,"46140",383,321,321,2,0,"VOX",66
41,"41902",4599,2906,2868,50,38,"VOX",495
31,"31103",40,28,27,0,1,"VOX",1
6,"6086",1174,767,750,6,17,"VOX",88
10,"10122",219,159,157,2,2,"VOX",35
6,"6040",993,679,668,3,11,"VOX",171
5,"5204",578,445,442,3,3,"VOX",66
41,"41031",1204,780,769,5,11,"VOX",85
45,"45138",1058,813,802,5,11,"VOX",165
14,"14062",945,700,693,2,7,"VOX",62
9,"9235",144,107,105,0,2,"VOX",11
45,"45151",544,413,409,0,4,"VOX",55
10,"10096",3311,2248,2201,15,47,"VOX",218
49,"49243",107,74,74,0,0,"VOX",10
37,"37313",535,395,394,1,1,"VOX",99
16,"16166",240,173,171,0,2,"VOX",36
15,"15015",2877,1845,1821,26,24,"VOX",147
48,"48092",872,614,608,3,6,"VOX",16
8,"8042",2390,1772,1764,12,8,"VOX",136
17,"17034",7289,4880,4862,23,18,"VOX",296
39,"39035",9142,6574,6517,24,57,"VOX",717
12,"12028",13004,9801,9732,74,69,"VOX",1926
10,"10205",1934,1071,1042,4,29,"VOX",134
38,"38011",21655,13974,13831,106,143,"VOX",1825
9,"9273",48,40,39,0,1,"VOX",12
16,"16092",149,108,108,1,0,"VOX",45
6,"6043",677,493,488,5,5,"VOX",83
50,"50271",246,179,173,4,6,"VOX",25
41,"41089",6621,4650,4549,64,101,"VOX",720
46,"46165",7349,5460,5412,39,48,"VOX",1018
6,"6089",610,470,463,2,7,"VOX",70
43,"43051",9194,6133,6048,44,85,"VOX",611
16,"16016",217,157,157,1,0,"VOX",46
28,"28150",3191,2423,2401,13,22,"VOX",738
38,"38012",2286,1520,1510,8,10,"VOX",157
37,"37178",98,70,70,0,0,"VOX",18
31,"31216",3867,2592,2566,37,26,"VOX",98
47,"47084",1077,794,784,11,10,"VOX",106
50,"50222",1574,1024,1008,12,16,"VOX",227
37,"37209",415,276,275,2,1,"VOX",63
5,"5207",645,485,478,4,7,"VOX",56
22,"22011",98,80,79,0,1,"VOX",12
28,"28086",5446,3643,3600,19,43,"VOX",1022
26,"26052",146,106,105,0,1,"VOX",10
25,"25037",361,270,269,4,1,"VOX",5
9,"9275",167,114,114,1,0,"VOX",23
10,"10004",692,482,473,8,9,"VOX",78
42,"42176",27,21,21,0,0,"VOX",3
24,"24207",276,215,215,2,0,"VOX",33
19,"19333",96,68,67,0,1,"VOX",5
19,"19176",227,172,172,0,0,"VOX",50
46,"46143",4274,3027,2995,19,32,"VOX",390
9,"9441",94,76,76,0,0,"VOX",29
10,"10087",1588,1105,1093,10,12,"VOX",205
5,"5208",39,32,32,0,0,"VOX",8
40,"40214",198,160,154,0,6,"VOX",28
20,"20007",337,223,221,2,2,"VOX",0
37,"37358",159,124,124,0,0,"VOX",24
32,"32031",997,684,680,5,4,"VOX",52
42,"42151",38,27,27,0,0,"VOX",2
20,"20038",387,294,293,2,1,"VOX",1
8,"8090",142,116,116,0,0,"VOX",0
9,"9442",368,265,262,1,3,"VOX",32
9,"9460",162,141,140,0,1,"VOX",25
45,"45108",465,343,341,0,2,"VOX",67
5,"5240",3346,2259,2232,11,27,"VOX",456
29,"29071",980,580,564,11,16,"VOX",98
21,"21032",1827,1337,1314,13,23,"VOX",173
49,"49237",142,78,78,0,0,"VOX",12
16,"16269",378,287,285,2,2,"VOX",52
13,"13028",10230,7682,7559,65,123,"VOX",1571
39,"39094",840,611,611,2,0,"VOX",56
39,"39011",1587,1178,1178,6,0,"VOX",243
21,"21002",16070,11301,11137,132,164,"VOX",2744
31,"31220",742,551,539,6,12,"VOX",29
40,"40087",85,70,70,0,0,"VOX",7
7,"7015",22248,12375,12286,202,89,"VOX",1115
46,"46213",15499,10610,10482,173,128,"VOX",2428
24,"24098",1149,753,741,8,12,"VOX",108
9,"9444",63,40,40,1,0,"VOX",9
31,"31111",91,52,52,0,0,"VOX",5
25,"25040",10651,7041,6987,57,54,"VOX",306
46,"46145",22215,15688,15538,127,150,"VOX",2437
19,"19901",35,27,27,0,0,"VOX",8
17,"17067",704,551,549,6,2,"VOX",10
42,"42135",69,40,40,1,0,"VOX",4
10,"10212",1658,1113,1068,19,45,"VOX",132
13,"13076",455,359,356,0,3,"VOX",27
44,"44121",52,42,42,1,0,"VOX",14
10,"10009",255,165,162,1,3,"VOX",18
25,"25193",768,567,563,4,4,"VOX",3
28,"28123",62178,49883,49515,397,368,"VOX",7501
16,"16022",76,63,63,0,0,"VOX",10
7,"7017",899,604,596,10,8,"VOX",101
13,"13031",2475,1855,1834,9,21,"VOX",429
12,"12034",1389,1022,1002,5,20,"VOX",221
31,"31112",91,56,56,0,0,"VOX",1
46,"46146",1647,1241,1229,12,12,"VOX",241
21,"21034",1155,768,748,5,20,"VOX",114
40,"40089",209,155,148,2,7,"VOX",28
22,"22015",299,218,215,1,3,"VOX",26
9,"9447",43,37,36,0,1,"VOX",5
14,"14069",7340,5100,5000,69,100,"VOX",530
12,"12007",724,622,614,2,8,"VOX",61
9,"9398",73,52,52,0,0,"VOX",13
44,"44031",83,50,50,0,0,"VOX",8
45,"45038",3528,2556,2521,26,35,"VOX",842
35,"35025",1752,1113,1095,5,18,"VOX",166
19,"19271",41,22,21,1,1,"VOX",2
24,"24174",457,294,289,3,5,"VOX",40
25,"25042",204,149,149,5,0,"VOX",2
31,"31114",388,272,271,3,1,"VOX",18
16,"16225",55,30,30,0,0,"VOX",8
6,"6054",5452,3773,3657,34,116,"VOX",604
19,"19242",74,53,53,1,0,"VOX",15
42,"42010",21,15,14,0,1,"VOX",2
50,"50204",2396,1723,1712,17,11,"VOX",217
22,"22017",826,613,608,2,5,"VOX",97
9,"9288",87,64,64,0,0,"VOX",13
8,"8233",1872,1428,1420,15,8,"VOX",29
12,"12036",541,401,395,6,6,"VOX",73
24,"24176",302,232,226,0,6,"VOX",32
6,"6009",221,166,166,2,0,"VOX",35
7,"7053",1209,870,864,10,6,"VOX",123
6,"6010",1063,760,732,2,28,"VOX",88
10,"10095",317,245,239,0,6,"VOX",39
12,"12090",102,79,78,1,1,"VOX",17
31,"31043",29,23,23,0,0,"VOX",0
46,"46239",446,357,352,1,5,"VOX",68
45,"45078",1333,1084,1077,6,7,"VOX",254
44,"44153",1733,1131,1125,0,6,"VOX",109
46,"46224",156,125,124,0,1,"VOX",30
41,"41087",10557,7217,7029,67,188,"VOX",1732
45,"45139",144,111,111,0,0,"VOX",15
29,"29031",1555,1015,986,6,29,"VOX",95
9,"9348",131,103,101,0,2,"VOX",7
5,"5215",156,120,113,0,7,"VOX",12
26,"26061",1542,1104,1079,12,25,"VOX",69
10,"10218",1074,685,672,0,13,"VOX",73
43,"43112",245,179,179,3,0,"VOX",0
26,"26179",39,27,27,0,0,"VOX",3
9,"9451",237,196,189,1,7,"VOX",11
16,"16228",173,147,145,2,2,"VOX",12
20,"20035",480,361,361,0,0,"VOX",4
50,"50078",227,168,166,0,2,"VOX",10
31,"31264",179,91,90,2,1,"VOX",6
6,"6149",10177,7582,7455,64,127,"VOX",1430
50,"50181",999,748,732,3,16,"VOX",153
8,"8119",6897,5096,5052,31,44,"VOX",500
19,"19245",1138,798,778,6,20,"VOX",174
20,"20005",1274,822,822,1,0,"VOX",9
50,"50131",212,152,147,4,5,"VOX",26
43,"43139",2007,1432,1419,9,13,"VOX",31
25,"25045",57,26,26,2,0,"VOX",0
47,"47094",120,100,100,0,0,"VOX",13
9,"9295",52,36,35,1,1,"VOX",8
37,"37189",114,75,74,1,1,"VOX",12
6,"6105",592,367,363,1,4,"VOX",66
31,"31191",3024,2156,2133,23,23,"VOX",153
50,"50232",160,93,92,1,1,"VOX",3
19,"19246",42,27,27,1,0,"VOX",2
46,"46105",16126,10958,10847,76,111,"VOX",1983
10,"10902",744,514,498,4,16,"VOX",82
9,"9297",310,233,233,6,0,"VOX",50
44,"44099",644,422,421,2,1,"VOX",48
9,"9353",74,56,54,1,2,"VOX",10
6,"6151",1049,746,741,5,5,"VOX",65
47,"47190",95,75,75,1,0,"VOX",11
42,"42096",244,132,129,2,3,"VOX",9
31,"31119",35,24,24,1,0,"VOX",0
29,"29062",658,557,551,2,6,"VOX",65
13,"13086",158,122,120,0,2,"VOX",13
23,"23905",1828,1320,1302,12,18,"VOX",340
37,"37284",317,229,222,2,7,"VOX",41
43,"43035",233,182,182,5,0,"VOX",3
50,"50080",34,27,27,0,0,"VOX",1
46,"46220",49112,33766,33424,312,342,"VOX",5085
45,"45131",259,219,216,1,3,"VOX",46
32,"32018",1181,883,871,5,12,"VOX",54
50,"50224",61,44,44,2,0,"VOX",1
16,"16055",669,429,426,0,3,"VOX",97
12,"12003",954,710,702,6,8,"VOX",151
19,"19279",54,42,42,0,0,"VOX",18
29,"29007",28907,20371,20129,254,242,"VOX",5064
25,"25170",262,210,210,1,0,"VOX",3
16,"16019",187,141,141,1,0,"VOX",23
30,"30004",1129,838,833,1,5,"VOX",185
14,"14001",3423,2563,2515,11,48,"VOX",375
39,"39048",1772,1311,1295,8,16,"VOX",178
31,"31012",763,550,542,7,8,"VOX",28
6,"6064",847,616,601,3,15,"VOX",51
42,"42152",67,47,44,1,3,"VOX",14
25,"25048",1641,1207,1194,13,13,"VOX",34
16,"16238",461,380,378,1,2,"VOX",50
26,"26067",22,18,18,3,0,"VOX",1
42,"42153",12,10,10,0,0,"VOX",0
17,"17047",5016,3087,3068,22,19,"VOX",310
5,"5220",364,277,274,0,3,"VOX",54
19,"19249",29,26,26,0,0,"VOX",4
6,"6065",293,230,228,2,2,"VOX",19
8,"8099",753,529,529,4,0,"VOX",14
40,"40002",32,22,21,0,1,"VOX",3
44,"44189",44,35,35,0,0,"VOX",6
19,"19311",85,60,59,0,1,"VOX",4
22,"22234",743,498,491,5,7,"VOX",93
19,"19159",87,73,72,1,1,"VOX",20
31,"31233",91,62,60,2,2,"VOX",17
15,"15062",5597,3406,3360,16,46,"VOX",222
40,"40003",116,82,79,3,3,"VOX",13
25,"25141",154,105,104,3,1,"VOX",0
9,"9306",94,69,69,1,0,"VOX",12
9,"9304",198,152,149,1,3,"VOX",33
12,"12042",574,459,446,9,13,"VOX",91
11,"11032",54731,31560,31284,492,276,"VOX",7084
32,"32071",1351,821,814,6,7,"VOX",42
10,"10105",2442,1541,1515,11,26,"VOX",303
8,"8239",467,362,361,3,1,"VOX",21
15,"15064",2103,1458,1447,20,11,"VOX",115
17,"17022",7043,4940,4903,34,37,"VOX",150
31,"31247",141,99,96,1,3,"VOX",0
37,"37288",281,220,218,4,2,"VOX",62
17,"17049",3246,2527,2502,12,25,"VOX",91
45,"45124",2080,1628,1595,15,33,"VOX",301
13,"13093",3901,2617,2569,16,48,"VOX",510
25,"25142",359,283,283,2,0,"VOX",14
45,"45014",4039,2606,2552,35,54,"VOX",603
50,"50059",757,556,551,5,5,"VOX",117
5,"5257",132,98,95,4,3,"VOX",6
31,"31907",11272,8478,8421,97,57,"VOX",439
10,"10147",1277,873,837,6,36,"VOX",45
26,"26149",42,34,34,0,0,"VOX",0
8,"8217",25466,19864,19773,129,91,"VOX",1289
17,"17050",664,554,550,10,4,"VOX",10
19,"19251",39,30,30,0,0,"VOX",4
39,"39023",6563,4788,4753,14,35,"VOX",523
5,"5224",102,85,84,2,1,"VOX",21
37,"37195",39,31,31,0,0,"VOX",1
40,"40005",25,23,23,1,0,"VOX",2
49,"49255",387,304,298,3,6,"VOX",57
16,"16113",3065,2142,2108,13,34,"VOX",403
31,"31127",131,90,86,0,4,"VOX",4
31,"31018",426,287,283,2,4,"VOX",16
23,"23076",774,606,595,6,11,"VOX",135
50,"50060",171,126,125,1,1,"VOX",23
9,"9473",85,68,64,0,4,"VOX",14
50,"50187",55,42,42,0,0,"VOX",3
16,"16002",192,160,158,2,2,"VOX",44
37,"37354",5479,3969,3905,37,64,"VOX",868
17,"17062",5982,4025,4001,19,24,"VOX",244
24,"24154",952,625,618,5,7,"VOX",105
34,"34051",91,72,70,0,2,"VOX",8
50,"50270",38,26,25,0,1,"VOX",2
12,"12081",606,454,446,2,8,"VOX",73
10,"10203",4421,2810,2764,15,46,"VOX",557
45,"45102",3613,2495,2464,27,31,"VOX",682
49,"49204",58,44,43,1,1,"VOX",6
25,"25082",292,197,197,2,0,"VOX",0
28,"28137",1770,1300,1289,6,11,"VOX",405
47,"47137",29,25,25,0,0,"VOX",2
19,"19285",20,16,16,0,0,"VOX",3
5,"5226",63,43,42,0,1,"VOX",9
43,"43042",2215,1723,1710,18,13,"VOX",98
9,"9091",686,479,467,4,12,"VOX",84
31,"31202",4360,2806,2767,30,39,"VOX",252
17,"17052",135,93,92,0,1,"VOX",1
22,"22129",162,110,110,0,0,"VOX",13
5,"5227",341,230,228,1,2,"VOX",39
42,"42064",83,65,65,1,0,"VOX",8
31,"31130",321,203,203,0,0,"VOX",1
49,"49258",111,93,93,2,0,"VOX",12
11,"11037",5656,4374,4273,24,101,"VOX",232
37,"37198",202,147,144,2,3,"VOX",11
25,"25053",1100,819,811,7,8,"VOX",24
16,"16117",1018,723,715,9,8,"VOX",105
42,"42161",136,99,99,0,0,"VOX",17
10,"10112",1495,1071,1049,7,22,"VOX",196
44,"44222",125,92,92,0,0,"VOX",13
9,"9045",269,159,158,0,1,"VOX",14
19,"19256",46,36,36,0,0,"VOX",1
31,"31167",833,581,573,2,8,"VOX",24
16,"16156",84,64,64,0,0,"VOX",13
46,"46112",533,435,432,7,3,"VOX",57
40,"40107",90,67,67,0,0,"VOX",16
16,"16042",1091,832,823,4,9,"VOX",103
7,"7902",1091,663,645,13,18,"VOX",36
17,"17027",2857,2236,2229,9,7,"VOX",43
9,"9482",34,22,22,0,0,"VOX",6
46,"46158",1047,771,763,7,8,"VOX",115
16,"16006",113,100,100,1,0,"VOX",6
27,"27010",4378,2719,2670,49,49,"VOX",292
42,"42206",8,5,5,2,0,"VOX",0
40,"40009",41,35,34,0,1,"VOX",5
50,"50014",119,81,81,0,0,"VOX",10
50,"50191",446,327,326,1,1,"VOX",45
40,"40043",1773,1376,1345,21,31,"VOX",224
6,"6077",319,234,229,2,5,"VOX",9
13,"13011",4439,2762,2694,16,68,"VOX",495
19,"19208",39,32,32,0,0,"VOX",7
10,"10032",1588,1114,1099,6,15,"VOX",105
31,"31181",133,87,84,1,3,"VOX",4
17,"17092",3462,2414,2389,14,25,"VOX",106
42,"42068",77,58,57,0,1,"VOX",10
37,"37201",238,170,168,0,2,"VOX",41
44,"44018",16,16,16,0,0,"VOX",0
8,"8275",247,218,218,3,0,"VOX",2
14,"14010",3992,2786,2723,14,63,"VOX",422
8,"8214",7007,5390,5371,25,19,"VOX",229
9,"9119",42,24,24,0,0,"VOX",4
42,"42178",99,71,71,0,0,"VOX",14
9,"9901",334,228,226,4,2,"VOX",25
16,"16008",80,63,63,1,0,"VOX",3
39,"39029",629,476,469,1,7,"VOX",67
16,"16122",244,184,182,1,2,"VOX",29
50,"50290",360,260,255,5,5,"VOX",47
8,"8245",77841,53719,53443,430,276,"VOX",4276
45,"45169",179,114,111,1,3,"VOX",17
31,"31061",48,45,45,2,0,"VOX",0
40,"40013",57,47,47,0,0,"VOX",1
49,"49038",88,63,58,1,5,"VOX",9
16,"16045",180,128,127,0,1,"VOX",17
37,"37202",1004,773,763,12,10,"VOX",176
25,"25058",4345,3058,3045,13,13,"VOX",95
17,"17057",968,770,769,7,1,"VOX",10
49,"49263",44,32,32,1,0,"VOX",3
31,"31026",130,108,107,0,1,"VOX",2
37,"37203",151,114,113,1,1,"VOX",12
16,"16251",1805,1318,1302,9,16,"VOX",352
43,"43046",88,69,68,1,1,"VOX",3
16,"16009",54,44,44,2,0,"VOX",7
41,"41084",2799,2029,1937,9,92,"VOX",294
50,"50169",333,231,230,0,1,"VOX",34
24,"24052",139,94,93,0,1,"VOX",12
16,"16098",521,418,415,2,3,"VOX",68
17,"17086",1769,1116,1109,6,7,"VOX",103
10,"10050",987,707,704,4,3,"VOX",95
28,"28113",36951,27912,27604,241,308,"VOX",5649
26,"26162",108,90,89,1,1,"VOX",5
49,"49200",936,679,670,9,9,"VOX",93
9,"9325",177,103,101,2,2,"VOX",14
25,"25248",870,676,675,5,1,"VOX",8
17,"17012",1175,845,842,4,3,"VOX",68
19,"19261",33,23,23,0,0,"VOX",1
50,"50067",13928,9831,9699,92,132,"VOX",1930
46,"46093",2151,1652,1640,10,12,"VOX",290
42,"42167",235,163,161,4,2,"VOX",26
50,"50144",31,24,24,0,0,"VOX",1
9,"9905",373,239,238,2,1,"VOX",28
44,"44171",176,115,115,0,0,"VOX",8
42,"42076",200,149,143,2,6,"VOX",8
19,"19293",1945,1402,1388,19,14,"VOX",355
8,"8131",745,552,550,3,2,"VOX",18
16,"16047",214,154,148,3,6,"VOX",23
9,"9007",54,37,35,0,2,"VOX",3
7,"7052",4853,2765,2743,33,22,"VOX",262
21,"21056",2914,2148,2046,29,102,"VOX",269
45,"45064",3987,2918,2880,33,38,"VOX",701
44,"44114",233,161,159,0,2,"VOX",28
42,"42171",111,72,71,1,1,"VOX",12
32,"32085",10584,6687,6611,58,76,"VOX",613
23,"23090",1204,953,938,6,15,"VOX",159
25,"25250",327,269,265,1,4,"VOX",6
9,"9327",26,20,20,0,0,"VOX",6
27,"27016",6958,4697,4616,50,81,"VOX",429
25,"25154",117,86,85,0,1,"VOX",0
45,"45027",315,249,246,2,3,"VOX",40
50,"50068",1943,1299,1287,10,12,"VOX",242
10,"10040",426,301,289,2,12,"VOX",30
40,"40048",35,27,27,0,0,"VOX",2
37,"37250",325,212,211,0,1,"VOX",29
24,"24202",7504,4607,4538,51,69,"VOX",441
46,"46125",852,660,650,5,10,"VOX",90
46,"46072",3522,2792,2741,25,51,"VOX",324
50,"50172",174,125,123,2,2,"VOX",23
8,"8087",144,120,120,0,0,"VOX",1
46,"46049",268,221,217,2,4,"VOX",30
50,"50175",907,638,632,11,6,"VOX",78
9,"9406",239,165,162,2,3,"VOX",29
42,"42051",15,9,9,0,0,"VOX",1
16,"16014",558,419,417,6,2,"VOX",76
50,"50147",744,508,506,5,2,"VOX",64
6,"6133",1795,1308,1294,11,14,"VOX",242
46,"46164",12145,8373,8248,44,125,"VOX",1486
25,"25006",319,229,229,2,0,"VOX",9
37,"37303",179,118,117,1,1,"VOX",20
40,"40118",46,32,32,1,0,"VOX",6
30,"30042",2218,1645,1625,10,20,"VOX",519
31,"31214",87,55,54,0,1,"VOX",2
9,"9168",270,211,210,5,1,"VOX",31
50,"50070",50,30,29,0,1,"VOX",7
40,"40018",73,50,50,0,0,"VOX",12
29,"29068",7833,4897,4806,50,91,"VOX",1509
32,"32016",714,494,493,12,1,"VOX",31
45,"45153",1568,1168,1162,8,6,"VOX",296
22,"22182",227,132,131,3,1,"VOX",11
50,"50021",25,21,21,0,0,"VOX",9
26,"26014",443,278,273,3,5,"VOX",14
49,"49269",218,126,124,1,2,"VOX",9
10,"10003",543,350,335,0,15,"VOX",45
15,"15017",19866,13497,13344,195,153,"VOX",1280
16,"16093",54,45,45,0,0,"VOX",15
43,"43078",835,610,605,7,5,"VOX",41
19,"19265",134,97,97,5,0,"VOX",21
5,"5238",728,529,525,1,4,"VOX",69
41,"41062",2151,1619,1589,12,30,"VOX",82
28,"28119",2294,1760,1738,12,22,"VOX",436
46,"46097",948,670,663,1,7,"VOX",155
7,"7046",16884,9184,9097,97,87,"VOX",1410
50,"50022",504,373,369,12,4,"VOX",62
45,"45069",1820,1370,1355,1,15,"VOX",376
45,"45070",1412,1158,1136,7,22,"VOX",226
50,"50071",126,84,84,0,0,"VOX",20
9,"9391",347,247,246,2,1,"VOX",37
37,"37243",89,66,66,0,0,"VOX",12
39,"39065",222,166,163,0,3,"VOX",35
25,"25069",426,296,294,0,2,"VOX",7
9,"9337",113,80,77,2,3,"VOX",11
31,"31157",3447,2182,2160,29,22,"VOX",171
31,"31217",327,204,196,1,8,"VOX",4
7,"7057",7471,4430,4392,41,38,"VOX",683
16,"16067",123,91,90,1,1,"VOX",13
14,"14037",3161,2233,2158,22,75,"VOX",362
44,"44100",177,136,135,1,1,"VOX",10
33,"33065",1077,670,657,11,13,"VOX",106
21,"21041",113074,73295,72313,1063,982,"VOX",15738
25,"25076",131,91,91,0,0,"VOX",2
9,"9392",49,28,28,0,0,"VOX",1
50,"50047",38,24,24,0,0,"VOX",1
8,"8159",14343,10656,10603,87,53,"VOX",666
43,"43054",2807,1972,1957,14,15,"VOX",44
15,"15019",25981,15866,15672,207,194,"VOX",1444
21,"21001",621,431,418,0,13,"VOX",48
31,"31110",83,61,61,1,0,"VOX",6
46,"46099",744,539,535,2,4,"VOX",78
15,"15051",4545,2978,2945,47,33,"VOX",185
9,"9394",668,432,429,6,3,"VOX",49
9,"9339",128,106,105,0,1,"VOX",15
49,"49273",165,90,90,0,0,"VOX",7
7,"7048",18455,9929,9858,116,71,"VOX",1544
25,"25255",390,301,301,0,0,"VOX",11
16,"16172",325,233,228,1,5,"VOX",35
43,"43134",281,217,215,5,2,"VOX",13
21,"21033",569,410,405,3,5,"VOX",29
10,"10130",1754,1199,1189,10,10,"VOX",90
50,"50251",8209,5732,5658,66,74,"VOX",678
16,"16020",9,5,5,1,0,"VOX",0
15,"15052",4070,2512,2488,18,24,"VOX",214
10,"10008",1274,921,908,1,13,"VOX",116
9,"9340",74,49,49,1,0,"VOX",5
15,"15021",5254,3473,3422,58,51,"VOX",263
40,"40155",3897,2920,2880,56,40,"VOX",543
44,"44150",28,17,17,0,0,"VOX",1
25,"25078",995,746,743,7,3,"VOX",17
6,"6005",1694,1167,1139,9,28,"VOX",155
46,"46062",4552,3402,3362,27,40,"VOX",696
39,"39046",1342,910,902,3,8,"VOX",112
46,"46009",3144,2473,2449,22,24,"VOX",407
32,"32034",1062,763,753,6,10,"VOX",36
6,"6143",3389,2430,2371,24,59,"VOX",304
37,"37215",133,93,90,1,3,"VOX",16
42,"42075",78,50,50,1,0,"VOX",4
10,"10132",360,251,243,1,8,"VOX",40
43,"43135",339,255,255,0,0,"VOX",5
24,"24100",737,506,502,9,4,"VOX",82
16,"16023",513,367,367,3,0,"VOX",68
42,"42197",68,54,53,0,1,"VOX",5
9,"9467",59,46,46,2,0,"VOX",12
13,"13032",1076,772,765,0,7,"VOX",192
8,"8209",6925,4976,4948,39,28,"VOX",382
37,"37248",150,116,116,1,0,"VOX",26
16,"16175",5071,3807,3732,43,75,"VOX",878
22,"22048",12635,8889,8807,98,82,"VOX",1454
44,"44122",1277,939,934,5,5,"VOX",153
23,"23003",8639,6296,6226,41,70,"VOX",1202
9,"9346",90,61,60,1,1,"VOX",4
31,"31041",1671,1118,1105,15,13,"VOX",64
39,"39042",5910,4354,4315,14,39,"VOX",752
14,"14014",2496,1962,1907,20,55,"VOX",208
25,"25903",226,169,169,1,0,"VOX",1
31,"31261",240,161,158,2,3,"VOX",20
44,"44123",95,68,68,0,0,"VOX",3
9,"9403",103,79,78,1,1,"VOX",7
45,"45150",428,322,319,3,3,"VOX",49
6,"6146",1039,764,752,7,12,"VOX",60
8,"8162",2118,1581,1576,13,5,"VOX",103
20,"20064",12395,7959,7916,42,43,"VOX",145
13,"13035",947,704,690,6,14,"VOX",88
45,"45188",2770,1925,1886,12,39,"VOX",451
37,"37343",66,44,43,1,1,"VOX",9
16,"16126",720,552,545,3,7,"VOX",120
28,"28158",694,501,495,2,6,"VOX",125
50,"50093",87,66,64,1,2,"VOX",18
44,"44085",49,29,29,0,0,"VOX",8
31,"31030",135,94,94,0,0,"VOX",3
16,"16049",137,98,98,2,0,"VOX",14
31,"31184",65,41,40,0,1,"VOX",1
50,"50006",913,670,654,13,16,"VOX",91
16,"16063",112,81,81,1,0,"VOX",9
50,"50053",643,476,466,3,10,"VOX",52
43,"43059",250,193,192,1,1,"VOX",2
50,"50155",95,65,65,0,0,"VOX",8
10,"10137",394,297,296,3,1,"VOX",27
44,"44033",243,165,165,3,0,"VOX",30
45,"45079",355,250,250,0,0,"VOX",40
43,"43007",631,479,474,1,5,"VOX",23
9,"9407",25,19,17,0,2,"VOX",0
37,"37345",150,117,113,0,4,"VOX",24
19,"19307",25,23,23,0,0,"VOX",8
10,"10219",1184,698,686,9,12,"VOX",100
8,"8141",4578,3369,3357,28,12,"VOX",129
32,"32028",1537,1012,1004,5,8,"VOX",75
42,"42189",57,43,43,0,0,"VOX",16
39,"39045",352,238,234,0,4,"VOX",25
31,"31166",242,172,172,2,0,"VOX",2
16,"16065",370,287,287,3,0,"VOX",62
9,"9183",42,32,32,0,0,"VOX",4
10,"10138",527,386,379,2,7,"VOX",24
37,"37346",251,208,207,1,1,"VOX",30
10,"10016",329,242,232,2,10,"VOX",38
16,"16186",403,309,305,3,4,"VOX",70
44,"44184",44,37,37,0,0,"VOX",12
22,"22199",6884,4438,4384,71,54,"VOX",519
16,"16029",104,76,74,0,2,"VOX",16
36,"36025",2127,1235,1221,5,14,"VOX",126
50,"50005",228,185,184,2,1,"VOX",35
12,"12067",514,381,373,3,8,"VOX",51
31,"31156",238,175,174,2,1,"VOX",8
20,"20067",30609,20017,19927,111,90,"VOX",369
43,"43061",40,27,27,3,0,"VOX",0
17,"17044",6938,5245,5212,33,33,"VOX",152
9,"9373",399,254,251,5,3,"VOX",51
10,"10181",676,470,462,2,8,"VOX",63
31,"31047",238,163,163,2,0,"VOX",3
9,"9410",3019,1924,1898,21,26,"VOX",182
50,"50038",1404,1024,1007,15,17,"VOX",127
29,"29065",191,145,143,3,2,"VOX",52
25,"25169",170,117,117,5,0,"VOX",0
24,"24158",296,197,192,0,5,"VOX",58
29,"29006",679,461,452,4,9,"VOX",122
45,"45167",1370,1078,1065,1,13,"VOX",158
9,"9098",470,318,309,3,9,"VOX",62
12,"12079",414,310,305,2,5,"VOX",76
19,"19314",44,33,33,0,0,"VOX",12
20,"20042",3180,2056,2053,7,3,"VOX",23
9,"9427",1363,854,842,7,12,"VOX",133
40,"40205",228,159,157,1,2,"VOX",19
25,"25111",114,86,86,2,0,"VOX",1
40,"40130",127,95,87,1,8,"VOX",9
17,"17010",332,252,251,2,1,"VOX",0
50,"50150",624,387,384,2,3,"VOX",91
44,"44138",120,92,92,0,0,"VOX",16
21,"21042",15610,8112,8011,164,101,"VOX",2268
8,"8260",18515,13563,13487,84,76,"VOX",1164
47,"47131",167,122,120,2,2,"VOX",21
44,"44128",58,39,37,0,2,"VOX",2
6,"6109",3821,2943,2813,16,130,"VOX",276
37,"37318",196,132,132,0,0,"VOX",20
37,"37224",189,156,153,2,3,"VOX",41
31,"31050",6016,3675,3612,41,63,"VOX",61
40,"40033",70,55,52,1,3,"VOX",12
5,"5254",184,149,147,1,2,"VOX",25
9,"9358",247,165,161,3,4,"VOX",14
25,"25909",138,99,98,2,1,"VOX",1
31,"31159",1097,813,812,2,1,"VOX",32
45,"45085",1535,1061,1052,11,9,"VOX",436
31,"31905",2992,1994,1984,9,10,"VOX",175
50,"50082",82,57,57,0,0,"VOX",9
27,"27033",591,334,328,0,6,"VOX",17
24,"24039",1949,1420,1412,33,8,"VOX",305
25,"25112",269,205,200,2,5,"VOX",11
26,"26108",309,240,231,2,9,"VOX",16
37,"37351",268,229,226,0,3,"VOX",44
9,"9415",275,178,178,3,0,"VOX",28
46,"46168",2004,1463,1447,12,16,"VOX",233
24,"24901",853,517,513,4,4,"VOX",77
28,"28133",6146,4245,4180,25,65,"VOX",1008
41,"41056",3687,2836,2779,37,57,"VOX",383
9,"9084",165,116,111,1,5,"VOX",19
31,"31197",67,51,51,2,0,"VOX",4
50,"50100",304,215,212,1,3,"VOX",20
31,"31165",2772,1946,1930,16,16,"VOX",165
9,"9366",76,55,55,2,0,"VOX",7
41,"41078",2445,1722,1689,12,33,"VOX",238
10,"10024",672,492,480,6,12,"VOX",82
15,"15043",4944,3184,3117,27,67,"VOX",222
5,"5267",103,67,67,1,0,"VOX",13
31,"31052",101,78,75,0,3,"VOX",1
45,"45051",1678,1238,1209,13,29,"VOX",367
25,"25022",105,80,79,0,1,"VOX",0
39,"39079",8850,6247,6175,28,72,"VOX",969
31,"31199",138,86,84,0,2,"VOX",0
28,"28134",63936,48022,47631,421,391,"VOX",8987
43,"43083",146,110,109,0,1,"VOX",12
44,"44219",173,118,115,1,3,"VOX",16
50,"50237",100,75,75,2,0,"VOX",11
42,"42198",19,9,9,1,0,"VOX",1
19,"19284",10,10,10,0,0,"VOX",1
5,"5258",107,80,80,1,0,"VOX",16
9,"9363",906,660,655,5,5,"VOX",137
25,"25912",841,620,619,5,1,"VOX",17
24,"24007",735,500,496,8,4,"VOX",52
10,"10148",33054,21731,21379,231,352,"VOX",3319
6,"6115",1243,808,798,8,10,"VOX",171
6,"6116",1500,1015,998,7,17,"VOX",143
31,"31163",2011,1422,1404,6,18,"VOX",145
30,"30008",14560,9974,9840,79,134,"VOX",2689
7,"7031",24972,14866,14757,127,109,"VOX",3366
10,"10026",647,464,452,6,12,"VOX",98
49,"49203",280,218,212,1,6,"VOX",40
24,"24127",263,183,181,1,2,"VOX",21
22,"22217",370,274,269,4,5,"VOX",37
40,"40146",260,206,204,0,2,"VOX",53
15,"15076",2490,1539,1517,25,22,"VOX",112
40,"40053",79,56,56,1,0,"VOX",7
31,"31124",207,134,134,2,0,"VOX",5
12,"12101",354,274,270,5,4,"VOX",32
21,"21051",222,171,168,3,3,"VOX",40
25,"25014",246,184,178,0,6,"VOX",0
31,"31129",388,239,238,3,1,"VOX",5
46,"46225",351,267,262,1,5,"VOX",42
42,"42083",26,20,20,0,0,"VOX",1
7,"7050",3513,2036,2013,25,23,"VOX",230
46,"46116",13606,10262,10200,87,62,"VOX",1787
25,"25242",688,494,488,5,6,"VOX",11
28,"28031",2129,1501,1486,8,15,"VOX",348
16,"16004",228,175,174,0,1,"VOX",24
26,"26114",72,61,61,0,0,"VOX",9
22,"22060",1167,817,808,14,9,"VOX",80
9,"9478",45,34,34,1,0,"VOX",1
6,"6134",526,306,301,1,5,"VOX",28
5,"5260",95,73,73,0,0,"VOX",17
16,"16196",589,490,476,3,14,"VOX",37
44,"44145",974,698,697,3,1,"VOX",109
37,"37232",377,303,303,2,0,"VOX",39
24,"24010",8251,5357,5275,40,82,"VOX",1158
29,"29042",14586,9793,9649,95,144,"VOX",2899
25,"25086",525,410,407,3,3,"VOX",3
37,"37325",88,63,63,0,0,"VOX",8
38,"38028",22144,14312,14174,89,138,"VOX",1490
19,"19287",134,100,98,2,2,"VOX",25
6,"6029",1174,873,865,5,8,"VOX",54
16,"16197",67,44,43,0,1,"VOX",3
11,"11007",18032,9872,9745,213,127,"VOX",1872
40,"40041",966,729,716,8,13,"VOX",110
25,"25243",3729,2370,2349,33,21,"VOX",263
42,"42027",72,48,47,1,1,"VOX",6
43,"43044",3962,2751,2719,33,32,"VOX",237
50,"50095",12149,8322,8239,91,83,"VOX",1376
26,"26040",64,47,47,1,0,"VOX",2
16,"16910",75,44,44,1,0,"VOX",4
43,"43105",155,126,123,4,3,"VOX",1
6,"6030",168,131,128,1,3,"VOX",16
9,"9206",52,43,43,0,0,"VOX",6
13,"13015",5220,3665,3629,25,36,"VOX",495
29,"29070",43686,27672,27323,290,349,"VOX",6980
38,"38016",1174,595,589,2,6,"VOX",51
9,"9229",178,127,127,1,0,"VOX",16
25,"25244",374,275,270,1,5,"VOX",8
24,"24024",636,407,403,6,4,"VOX",76
21,"21054",8175,6014,5887,41,127,"VOX",1500
21,"21007",6379,4268,4178,66,90,"VOX",670
10,"10123",575,450,438,1,12,"VOX",47
26,"26122",115,81,80,4,1,"VOX",10
26,"26105",2188,1564,1536,24,28,"VOX",174
7,"7058",2866,2013,1996,24,17,"VOX",293
24,"24073",437,285,282,1,3,"VOX",42
11,"11029",5442,2826,2765,44,61,"VOX",617
31,"31048",166,121,119,1,2,"VOX",16
30,"30021",9498,6251,6193,36,58,"VOX",2076
46,"46235",21229,15171,15011,126,160,"VOX",2010
26,"26119",178,132,132,0,0,"VOX",2
25,"25180",227,158,155,1,3,"VOX",1
44,"44046",44,33,33,0,0,"VOX",2
29,"29045",1679,1162,1144,5,18,"VOX",339
50,"50015",81,57,56,0,1,"VOX",1
9,"9428",102,73,73,1,0,"VOX",12
31,"31098",1984,1443,1428,11,15,"VOX",74
38,"38031",29301,20926,20701,157,225,"VOX",1858
32,"32008",8647,5570,5495,56,75,"VOX",581
25,"25088",96,73,73,0,0,"VOX",0
41,"41027",4007,2628,2546,33,82,"VOX",498
24,"24122",1292,818,810,7,8,"VOX",92
12,"12078",334,224,221,2,3,"VOX",31
24,"24121",599,422,418,3,4,"VOX",95
37,"37360",206,135,135,1,0,"VOX",26
43,"43073",80,67,65,0,2,"VOX",0
19,"19291",1143,803,794,2,9,"VOX",178
40,"40906",2149,1701,1662,18,39,"VOX",316
16,"16160",58,41,41,1,0,"VOX",7
8,"8153",573,457,452,3,5,"VOX",13
37,"37172",846,530,524,6,6,"VOX",136
9,"9321",1576,1151,1135,10,16,"VOX",201
46,"46003",948,770,757,8,13,"VOX",134
6,"6157",389,277,271,1,6,"VOX",56
46,"46234",317,247,245,1,2,"VOX",31
45,"45106",7418,5380,5306,34,74,"VOX",916
26,"26095",93,71,68,0,3,"VOX",3
8,"8161",11826,8001,7951,58,50,"VOX",715
37,"37237",296,212,204,1,8,"VOX",44
46,"46194",15852,11124,11009,86,115,"VOX",2089
32,"32006",1418,986,970,14,16,"VOX",53
20,"20051",6736,4829,4804,22,25,"VOX",68
31,"31178",476,323,320,7,3,"VOX",47
6,"6128",4457,2996,2934,28,62,"VOX",491
25,"25102",647,484,482,5,2,"VOX",21
7,"7029",4393,2888,2855,37,33,"VOX",431
15,"15033",2421,1673,1655,6,18,"VOX",117
13,"13048",495,392,391,4,1,"VOX",30
20,"20022",849,574,571,8,3,"VOX",1
44,"44227",72,58,58,0,0,"VOX",6
50,"50091",39,32,32,0,0,"VOX",2
31,"31077",5416,3840,3794,38,46,"VOX",452
10,"10133",1159,914,893,4,21,"VOX",43
46,"46124",786,638,625,1,13,"VOX",78
10,"10052",172,114,113,3,1,"VOX",27
16,"16012",76,66,66,0,0,"VOX",10
46,"46185",361,301,299,5,2,"VOX",21
17,"17227",147,104,104,0,0,"VOX",0
37,"37269",424,280,277,2,3,"VOX",45
28,"28147",991,702,698,4,4,"VOX",185
25,"25094",138,96,93,2,3,"VOX",0
37,"37239",203,175,174,2,1,"VOX",14
46,"46118",3649,2730,2701,20,29,"VOX",372
5,"5901",247,154,152,3,2,"VOX",20
31,"31066",819,577,559,4,18,"VOX",32
37,"37333",203,125,124,2,1,"VOX",37
44,"44262",141,104,103,0,1,"VOX",15
8,"8041",10698,7324,7258,57,66,"VOX",826
8,"8202",12943,9408,9358,58,50,"VOX",366
26,"26011",7251,4807,4711,47,96,"VOX",575
18,"18012",2114,1519,1492,9,27,"VOX",328
46,"46247",972,649,646,3,3,"VOX",119
41,"41024",22819,14767,14455,169,312,"VOX",2659
16,"16118",1351,1022,1009,13,13,"VOX",169
43,"43169",445,388,388,3,0,"VOX",7
9,"9247",21,18,18,0,0,"VOX",0
12,"12084",17785,12557,12422,108,135,"VOX",2235
34,"34071",158,128,128,2,0,"VOX",24
10,"10217",506,378,377,3,1,"VOX",61
50,"50167",208,166,163,1,3,"VOX",38
24,"24173",896,590,583,2,7,"VOX",108
37,"37281",39,28,27,0,1,"VOX",1
20,"20001",253,163,163,1,0,"VOX",0
40,"40212",26,19,19,1,0,"VOX",3
17,"17007",1763,1367,1359,9,8,"VOX",18
24,"24021",1595,1037,1025,7,12,"VOX",101
8,"8226",929,748,747,10,1,"VOX",18
32,"32027",989,670,660,5,10,"VOX",37
14,"14035",5774,4076,4017,35,59,"VOX",794
8,"8295",11290,8091,8054,72,37,"VOX",746
12,"12002",114,96,94,1,2,"VOX",3
9,"9220",69,52,52,3,0,"VOX",7
10,"10178",724,499,494,3,5,"VOX",53
21,"21008",2604,1663,1626,10,37,"VOX",233
46,"46081",9999,7486,7412,47,74,"VOX",1530
25,"25252",553,380,379,2,1,"VOX",12
6,"6150",777,592,588,0,4,"VOX",64
46,"46051",8469,6120,6070,40,50,"VOX",1437
31,"31106",721,547,545,1,2,"VOX",75
19,"19298",53,43,41,0,2,"VOX",9
13,"13024",875,587,577,7,10,"VOX",119
24,"24106",218,139,139,1,0,"VOX",21
45,"45105",376,277,268,5,9,"VOX",58
43,"43052",927,680,674,7,6,"VOX",29
44,"44087",67,52,50,0,2,"VOX",3
6,"6045",467,347,346,6,1,"VOX",53
20,"20057",198,148,147,1,1,"VOX",0
40,"40193",219,156,155,3,1,"VOX",30
24,"24131",684,416,415,2,1,"VOX",112
12,"12109",646,489,482,4,7,"VOX",82
31,"31192",160,125,123,0,2,"VOX",4
6,"6091",3669,2581,2525,20,56,"VOX",469
30,"30014",1587,1150,1134,4,16,"VOX",303
25,"25163",230,162,161,0,1,"VOX",5
19,"19309",20,15,14,0,1,"VOX",3
49,"49100",281,164,157,2,7,"VOX",16
10,"10063",159,130,130,0,0,"VOX",18
31,"31088",5656,3929,3893,56,36,"VOX",311
17,"17036",2639,1944,1934,21,10,"VOX",65
12,"12112",102,79,79,1,0,"VOX",18
7,"7054",23257,12613,12464,111,149,"VOX",1772
44,"44067",106,75,71,0,4,"VOX",14
31,"31080",486,362,361,4,1,"VOX",4
26,"26057",50,45,45,2,0,"VOX",3
29,"29028",1215,803,779,9,24,"VOX",99
43,"43115",128,106,106,0,0,"VOX",0
10,"10200",336,243,242,0,1,"VOX",44
21,"21045",231,177,174,4,3,"VOX",11
27,"27004",1143,640,625,2,15,"VOX",66
44,"44068",634,497,493,2,4,"VOX",72
26,"26171",155,109,107,2,2,"VOX",9
28,"28121",209,156,152,1,4,"VOX",37
9,"9338",225,174,172,3,2,"VOX",32
49,"49272",73,49,46,2,3,"VOX",9
20,"20059",8892,6505,6490,18,15,"VOX",21
37,"37083",181,155,153,1,2,"VOX",39
50,"50201",449,345,344,4,1,"VOX",74
46,"46190",50042,35290,35066,284,224,"VOX",6668
28,"28154",5570,3999,3961,29,38,"VOX",995
19,"19301",37,26,26,0,0,"VOX",9
25,"25100",184,137,136,1,1,"VOX",3
16,"16134",4368,3143,3102,22,41,"VOX",767
32,"32021",872,555,550,6,5,"VOX",38
6,"6004",1561,1130,1111,7,19,"VOX",106
17,"17011",645,518,514,10,4,"VOX",13
33,"33058",1668,1050,1035,13,15,"VOX",113
20,"20060",87,75,75,0,0,"VOX",0
49,"49016",230,155,155,0,0,"VOX",28
9,"9445",41,28,27,1,1,"VOX",2
37,"37277",74,55,55,0,0,"VOX",10
10,"10172",696,447,443,5,4,"VOX",69
16,"16270",154,123,122,1,1,"VOX",32
9,"9164",147,112,111,0,1,"VOX",16
28,"28044",6266,4693,4642,36,51,"VOX",953
9,"9466",113,84,83,1,1,"VOX",13
37,"37120",98,78,76,0,2,"VOX",11
21,"21071",206,148,144,4,4,"VOX",22
30,"30028",6390,4054,3973,25,81,"VOX",634
13,"13092",1703,1327,1307,4,20,"VOX",265
31,"31071",13,11,11,0,0,"VOX",0
25,"25098",227,160,158,1,2,"VOX",0
15,"15087",5710,3436,3392,31,44,"VOX",270
25,"25228",3143,2261,2250,18,11,"VOX",118
12,"12140",1147,849,841,5,8,"VOX",136
42,"42106",13,11,11,0,0,"VOX",3
12,"12116",61,49,49,0,0,"VOX",7
46,"46240",200,167,155,1,12,"VOX",47
44,"44163",115,79,78,0,1,"VOX",17
25,"25167",223,165,164,3,1,"VOX",5
43,"43057",38,32,32,1,0,"VOX",0
16,"16272",201,149,147,2,2,"VOX",36
50,"50136",532,366,361,3,5,"VOX",115
26,"26110",149,116,114,0,2,"VOX",6
42,"42009",77,58,58,0,0,"VOX",10
16,"16193",55,50,49,0,1,"VOX",6
13,"13034",58768,42473,42028,359,445,"VOX",8775
16,"16176",29,20,20,0,0,"VOX",0
19,"19010",9,9,9,0,0,"VOX",2
30,"30024",60389,42200,41831,281,369,"VOX",11621
26,"26023",433,316,314,3,2,"VOX",33
37,"37279",713,488,480,4,8,"VOX",79
25,"25196",108,75,75,1,0,"VOX",0
37,"37374",1138,889,872,2,17,"VOX",170
10,"10216",1518,1082,1056,11,26,"VOX",149
43,"43084",514,388,383,2,5,"VOX",5
8,"8210",4640,3226,3200,24,26,"VOX",131
29,"29058",1542,994,979,5,15,"VOX",329
46,"46193",8959,6880,6824,66,56,"VOX",1102
46,"46117",493,386,380,2,6,"VOX",59
41,"41021",21410,14369,14139,195,230,"VOX",2507
49,"49270",139,93,92,0,1,"VOX",17
9,"9280",26,18,18,0,0,"VOX",1
28,"28151",3274,2344,2310,16,34,"VOX",512
46,"46067",1753,1356,1341,8,15,"VOX",270
12,"12070",505,407,398,2,9,"VOX",56
40,"40056",31,21,20,0,1,"VOX",1
37,"37069",981,669,657,3,12,"VOX",145
19,"19186",76,60,60,0,0,"VOX",11
44,"44011",47,34,34,0,0,"VOX",5
49,"49093",280,226,223,5,3,"VOX",32
17,"17068",253,191,191,0,0,"VOX",1
12,"12025",116,82,79,1,3,"VOX",8
9,"9431",116,85,84,2,1,"VOX",12
36,"36053",5783,3955,3899,39,56,"VOX",352
25,"25124",160,102,101,1,1,"VOX",1
9,"9177",1140,790,780,7,10,"VOX",213
21,"21055",7326,5395,5309,43,86,"VOX",1018
37,"37132",317,211,207,0,4,"VOX",19
12,"12091",171,110,108,4,2,"VOX",14
49,"49097",67,44,44,0,0,"VOX",9
9,"9074",844,610,609,12,1,"VOX",149
21,"21049",3262,2028,1977,15,51,"VOX",181
50,"50214",18,18,14,1,4,"VOX",0
42,"42025",1125,741,732,12,9,"VOX",111
20,"20066",437,288,286,1,2,"VOX",0
31,"31203",30,19,19,2,0,"VOX",2
46,"46218",1043,842,829,6,13,"VOX",145
6,"6014",6503,4235,4181,35,54,"VOX",710
7,"7023",3776,2425,2386,34,39,"VOX",187
8,"8189",119,96,96,1,0,"VOX",0
45,"45019",7560,5216,5135,50,81,"VOX",971
19,"19015",82,74,73,1,1,"VOX",12
46,"46150",1794,1276,1272,8,4,"VOX",262
24,"24070",3886,2677,2625,18,52,"VOX",202
40,"40062",56,43,42,0,1,"VOX",10
9,"9409",117,80,80,0,0,"VOX",19
33,"33055",1485,992,966,14,26,"VOX",161
17,"17018",494,377,372,4,5,"VOX",6
10,"10180",4206,2609,2574,13,35,"VOX",862
45,"45094",365,274,271,3,3,"VOX",71
50,"50267",565,380,375,4,5,"VOX",28
24,"24055",674,484,482,8,2,"VOX",62
37,"37361",84,55,54,1,1,"VOX",9
47,"47205",355,248,244,2,4,"VOX",63
40,"40903",75,61,59,0,2,"VOX",14
15,"15070",8778,5802,5656,131,146,"VOX",344
17,"17095",20044,12638,12576,88,62,"VOX",1237
16,"16174",166,130,129,2,1,"VOX",30
16,"16043",88,60,60,3,0,"VOX",13
16,"16017",336,276,270,1,6,"VOX",57
20,"20071",15062,10442,10407,47,35,"VOX",93
10,"10136",274,205,202,1,3,"VOX",20
24,"24044",150,91,89,2,2,"VOX",10
9,"9416",52,30,30,0,0,"VOX",6
43,"43121",593,404,403,1,1,"VOX",5
31,"31056",186,128,124,2,4,"VOX",6
40,"40039",180,133,133,0,0,"VOX",21
42,"42173",29860,19581,19206,337,375,"VOX",2271
16,"16111",168,114,111,2,3,"VOX",9
46,"46154",795,619,608,5,11,"VOX",140
20,"20049",4195,2918,2901,12,17,"VOX",24
43,"43090",1199,689,686,5,3,"VOX",99
45,"45194",64,45,44,1,1,"VOX",11
50,"50184",87,70,70,0,0,"VOX",19
37,"37349",100,61,58,0,3,"VOX",9
45,"45195",2064,1519,1481,9,38,"VOX",236
10,"10061",1591,1010,992,9,18,"VOX",109
19,"19310",7,7,7,0,0,"VOX",0
50,"50108",50,37,37,0,0,"VOX",9
13,"13090",1005,754,733,4,21,"VOX",196
31,"31086",13781,10133,10054,114,79,"VOX",640
26,"26146",84,56,55,0,1,"VOX",1
37,"37350",403,281,274,1,7,"VOX",43
13,"13045",622,459,451,0,8,"VOX",108
8,"8283",6165,4546,4524,33,22,"VOX",153
28,"28132",12197,8622,8537,75,85,"VOX",2238
8,"8076",16526,11988,11893,90,95,"VOX",845
39,"39077",237,151,148,1,3,"VOX",22
26,"26032",43,36,35,0,1,"VOX",4
41,"41074",2994,2154,2105,19,49,"VOX",229
43,"43145",4209,3193,3170,17,23,"VOX",152
43,"43140",2433,1685,1674,11,11,"VOX",210
48,"48047",147,105,105,2,0,"VOX",0
8,"8904",10516,7068,7025,54,43,"VOX",772
46,"46092",262,176,174,2,2,"VOX",23
50,"50065",56,37,37,0,0,"VOX",4
50,"50088",274,195,191,2,4,"VOX",21
25,"25008",1081,803,799,4,4,"VOX",7
14,"14022",3881,2888,2853,15,35,"VOX",228
42,"42205",77,59,57,3,2,"VOX",8
24,"24036",252,146,146,1,0,"VOX",18
30,"30030",321454,235061,233183,1744,1878,"VOX",63457
31,"31153",2174,1417,1415,12,2,"VOX",17
17,"17081",252,186,185,2,1,"VOX",3
31,"31101",1428,986,981,6,5,"VOX",50
15,"15902",4507,2885,2837,34,48,"VOX",249
43,"43144",1245,975,966,1,9,"VOX",73
14,"14060",3715,2714,2641,41,73,"VOX",501
42,"42111",274,183,181,0,2,"VOX",27
38,"38027",5581,3577,3533,22,44,"VOX",280
24,"24078",324,228,225,0,3,"VOX",28
42,"42089",57,44,43,0,1,"VOX",4
28,"28124",73,51,50,0,1,"VOX",5
17,"17069",359,270,267,2,3,"VOX",10
6,"6053",592,441,428,7,13,"VOX",38
15,"15065",7134,4869,4785,53,84,"VOX",428
10,"10188",483,354,340,0,14,"VOX",57
48,"48912",2321,1684,1670,8,14,"VOX",34
41,"41049",9515,6961,6843,115,118,"VOX",988
46,"46132",2176,1725,1708,5,17,"VOX",272
50,"50261",201,154,151,0,3,"VOX",16
50,"50035",74,57,57,0,0,"VOX",1
6,"6024",1123,876,849,3,27,"VOX",100
10,"10066",161,121,120,1,1,"VOX",18
10,"10189",2499,1747,1700,15,47,"VOX",250
46,"46064",532,395,387,3,8,"VOX",76
50,"50188",26,23,23,0,0,"VOX",1
13,"13004",976,698,694,6,4,"VOX",91
46,"46250",582242,437146,434438,3315,2708,"VOX",72855
31,"31237",182,138,135,2,3,"VOX",5
16,"16213",34,27,26,0,1,"VOX",2
44,"44208",27,17,17,0,0,"VOX",9
46,"46130",862,633,625,6,8,"VOX",83
20,"20070",1084,798,795,7,3,"VOX",1
27,"27020",3365,2544,2500,42,44,"VOX",131
38,"38013",3011,1850,1829,14,21,"VOX",174
46,"46153",443,353,349,2,4,"VOX",48
10,"10045",971,686,682,4,4,"VOX",81
27,"27031",15107,9759,9593,87,166,"VOX",915
16,"16157",183,150,148,0,2,"VOX",32
9,"9224",147,113,112,0,1,"VOX",27
40,"40172",47,33,32,0,1,"VOX",4
29,"29024",371,216,204,3,12,"VOX",39
44,"44029",585,454,451,2,3,"VOX",57
31,"31141",106,66,61,1,5,"VOX",12
17,"17090",539,440,440,2,0,"VOX",9
28,"28117",99,87,86,0,1,"VOX",6
10,"10083",96,76,74,0,2,"VOX",30
11,"11013",2352,1564,1522,13,42,"VOX",322
10,"10146",1494,924,903,1,21,"VOX",179
9,"9438",562,447,437,6,10,"VOX",60
32,"32003",863,632,619,3,13,"VOX",23
14,"14063",994,731,719,8,12,"VOX",114
8,"8156",11254,8440,8411,58,29,"VOX",655
44,"44125",63,41,41,0,0,"VOX",3
26,"26154",10,10,9,1,1,"VOX",1
49,"49086",111,89,89,1,0,"VOX",13
22,"22207",121,66,65,0,1,"VOX",8
23,"23045",2054,1423,1412,10,11,"VOX",288
41,"41096",6178,4739,4655,60,84,"VOX",806
37,"37262",69,51,51,0,0,"VOX",15
30,"30043",25449,18839,18477,180,362,"VOX",3632
8,"8150",258,207,207,1,0,"VOX",7
44,"44136",48,43,43,1,0,"VOX",2
22,"22243",43,32,31,0,1,"VOX",6
50,"50166",235,186,186,0,0,"VOX",21
40,"40140",76,54,54,0,0,"VOX",5
49,"49133",287,206,203,1,3,"VOX",31
50,"50046",162,125,125,6,0,"VOX",22
38,"38005",5646,3302,3283,24,19,"VOX",389
49,"49092",115,72,72,0,0,"VOX",4
31,"31211",17,15,14,3,1,"VOX",0
45,"45161",15469,10281,10167,68,114,"VOX",3180
22,"22244",42,33,32,1,1,"VOX",4
26,"26173",8,8,8,1,0,"VOX",0
11,"11038",13632,10047,9812,99,235,"VOX",2064
50,"50096",34,22,22,0,0,"VOX",6
6,"6107",1555,980,969,8,11,"VOX",178
29,"29098",1228,902,876,11,26,"VOX",106
44,"44088",24,23,23,0,0,"VOX",4
26,"26143",260,197,192,1,5,"VOX",28
24,"24011",182,104,102,3,2,"VOX",9
38,"38035",10518,5870,5819,37,51,"VOX",1048
28,"28068",11740,8615,8543,72,72,"VOX",2216
10,"10092",260,201,200,1,1,"VOX",25
16,"16124",1807,1367,1347,14,20,"VOX",258
7,"7040",289448,169300,167908,1594,1392,"VOX",32200
7,"7043",3431,2196,2166,21,30,"VOX",388
23,"23006",4582,3536,3461,43,75,"VOX",372
27,"27005",2560,1691,1662,19,29,"VOX",150
10,"10088",198,112,112,1,0,"VOX",17
40,"40109",69,51,50,3,1,"VOX",8
45,"45059",1702,1315,1303,1,12,"VOX",411
10,"10075",238,150,148,0,2,"VOX",25
25,"25212",219,176,176,1,0,"VOX",2
6,"6033",1276,986,972,5,14,"VOX",144
24,"24196",1907,1322,1299,4,23,"VOX",103
50,"50242",99,74,74,0,0,"VOX",7
16,"16159",198,135,135,2,0,"VOX",15
9,"9101",72,52,52,0,0,"VOX",6
8,"8046",13541,10510,10455,73,55,"VOX",410
43,"43081",629,500,499,2,1,"VOX",28
22,"22212",69,52,52,1,0,"VOX",7
16,"16085",131,106,106,0,0,"VOX",16
12,"12022",323,257,254,5,3,"VOX",42
9,"9001",32,25,25,0,0,"VOX",3
24,"24161",294,208,204,3,4,"VOX",30
43,"43021",349,245,243,2,2,"VOX",12
44,"44080",281,202,199,0,3,"VOX",11
17,"17080",144,113,113,1,0,"VOX",2
31,"31229",39,32,32,0,0,"VOX",3
45,"45179",493,362,357,5,5,"VOX",48
23,"23012",4004,2726,2689,21,37,"VOX",637
32,"32017",1193,735,724,3,11,"VOX",88
28,"28067",4416,3359,3311,18,48,"VOX",786
37,"37159",74,59,59,0,0,"VOX",7
24,"24146",254,202,201,1,1,"VOX",36
12,"12020",118,104,103,1,1,"VOX",37
42,"42115",89,68,66,0,2,"VOX",13
44,"44241",500,361,357,0,4,"VOX",47
13,"13010",872,615,601,3,14,"VOX",100
8,"8274",4640,3385,3363,24,22,"VOX",134
10,"10126",1455,966,948,9,18,"VOX",143
25,"25136",95,74,74,2,0,"VOX",0
12,"12065",167,142,141,0,1,"VOX",21
48,"48045",5207,3851,3817,9,34,"VOX",74
47,"47231",4439,3359,3323,36,36,"VOX",755
10,"10078",365,271,263,7,8,"VOX",23
25,"25062",691,498,491,4,7,"VOX",19
8,"8007",6795,5099,5081,29,18,"VOX",161
46,"46025",2445,1875,1853,16,22,"VOX",309
31,"31162",48,28,27,1,1,"VOX",0
41,"41076",2134,1246,1230,11,16,"VOX",108
21,"21075",338,243,235,3,8,"VOX",29
46,"46033",196,155,153,0,2,"VOX",23
31,"31187",99,53,52,0,1,"VOX",3
9,"9023",1190,891,879,17,12,"VOX",184
31,"31005",279,183,183,4,0,"VOX",11
31,"31065",1843,1311,1300,12,11,"VOX",96
39,"39032",1420,1032,1027,7,5,"VOX",246
44,"44084",54,46,46,1,0,"VOX",2
43,"43023",211,171,169,2,2,"VOX",2
50,"50269",287,172,167,2,5,"VOX",26
9,"9433",52,40,40,0,0,"VOX",4
28,"28010",10649,8167,8098,76,69,"VOX",1854
42,"42124",56,27,27,0,0,"VOX",3
21,"21057",995,600,590,8,10,"VOX",48
42,"42215",723,468,452,10,16,"VOX",87
31,"31212",128,91,91,1,0,"VOX",2
47,"47023",3057,2369,2359,20,10,"VOX",609
31,"31196",31,23,23,0,0,"VOX",0
46,"46016",1070,827,814,10,13,"VOX",94
45,"45154",1491,1033,1024,11,9,"VOX",272
31,"31246",130,89,87,2,2,"VOX",2
48,"48907",343,274,273,0,1,"VOX",0
44,"44053",103,87,85,1,2,"VOX",11
49,"49077",157,80,80,0,0,"VOX",14
31,"31180",202,144,143,1,1,"VOX",4
31,"31155",246,165,161,3,4,"VOX",2
44,"44265",175,138,136,1,2,"VOX",15
28,"28034",368,258,255,0,3,"VOX",59
17,"17065",321,264,263,3,1,"VOX",0
37,"37117",1572,1103,1092,12,11,"VOX",275
50,"50063",64,49,49,0,0,"VOX",4
7,"7021",229,154,150,3,4,"VOX",26
10,"10119",574,417,414,2,3,"VOX",61
29,"29902",2593,1561,1533,15,28,"VOX",182
43,"43164",310,235,231,3,4,"VOX",28
26,"26013",330,243,242,2,1,"VOX",22
45,"45054",3798,2612,2587,10,25,"VOX",704
28,"28084",16243,11562,11408,90,154,"VOX",2423
44,"44174",402,289,288,1,1,"VOX",44
21,"21018",1719,1048,1029,12,19,"VOX",92
10,"10097",107,84,80,0,4,"VOX",18
8,"8126",8906,6673,6646,41,27,"VOX",356
31,"31265",76,43,40,0,3,"VOX",4
8,"8257",103,82,82,0,0,"VOX",5
43,"43113",387,305,303,1,2,"VOX",16
43,"43165",571,469,467,2,2,"VOX",7
9,"9389",63,45,45,0,0,"VOX",8
9,"9439",1061,801,790,2,11,"VOX",168
12,"12092",123,95,95,0,0,"VOX",3
46,"46127",2748,2035,2009,6,26,"VOX",230
16,"16277",105,74,74,0,0,"VOX",14
16,"16169",49,28,28,0,0,"VOX",13
16,"16264",385,311,305,1,6,"VOX",48
25,"25157",159,127,126,1,1,"VOX",5
25,"25055",163,114,114,0,0,"VOX",3
45,"45045",1338,926,915,9,11,"VOX",226
10,"10062",389,303,299,2,4,"VOX",30
41,"41901",2692,2101,2051,47,50,"VOX",115
16,"16038",27,20,20,0,0,"VOX",6
29,"29046",2494,1727,1693,13,34,"VOX",340
17,"17008",3605,2595,2577,8,18,"VOX",88
45,"45109",2791,2123,2072,20,51,"VOX",505
28,"28112",160,129,129,0,0,"VOX",20
43,"43097",407,331,328,4,3,"VOX",9
8,"8158",3094,2261,2251,11,10,"VOX",109
29,"29005",4507,3012,2965,29,47,"VOX",947
46,"46037",1120,891,879,7,12,"VOX",136
47,"47105",169,138,137,2,1,"VOX",17
8,"8228",292,234,233,0,1,"VOX",6
9,"9257",85,67,67,2,0,"VOX",19
9,"9170",207,151,150,1,1,"VOX",39
6,"6118",155,114,112,0,2,"VOX",4
21,"21058",2567,1806,1766,32,40,"VOX",194
16,"16072",132,84,84,1,0,"VOX",22
40,"40144",16,15,15,0,0,"VOX",6
29,"29003",916,677,666,4,11,"VOX",88
42,"42021",65,46,45,2,1,"VOX",5
46,"46121",106,91,90,1,1,"VOX",8
22,"22254",1084,744,735,10,9,"VOX",72
25,"25067",702,500,494,8,6,"VOX",20
8,"8183",4573,3406,3398,14,8,"VOX",103
8,"8022",12213,8594,8558,42,36,"VOX",211
10,"10170",231,164,162,2,2,"VOX",17
49,"49027",125,82,81,0,1,"VOX",10
31,"31001",79,56,56,0,0,"VOX",0
44,"44001",65,43,43,1,0,"VOX",5
8,"8114",18838,13519,13442,81,77,"VOX",963
50,"50081",487,355,349,5,6,"VOX",65
50,"50057",1331,933,922,10,11,"VOX",270
24,"24211",259,199,198,3,1,"VOX",54
7,"7016",2970,1891,1865,22,26,"VOX",289
10,"10090",489,307,302,1,5,"VOX",46
28,"28902",521,394,389,3,5,"VOX",96
17,"17038",377,303,301,0,2,"VOX",12
26,"26132",106,73,70,2,3,"VOX",1
8,"8086",14137,9971,9912,77,59,"VOX",829
46,"46242",326,260,257,3,3,"VOX",49
46,"46211",1862,1395,1381,12,14,"VOX",264
10,"10202",583,457,453,1,4,"VOX",42
42,"42007",108,80,80,1,0,"VOX",9
8,"8213",6600,4925,4906,30,19,"VOX",264
16,"16247",63,51,50,1,1,"VOX",6
7,"7012",1908,1301,1282,12,19,"VOX",137
46,"46014",3156,2324,2294,13,30,"VOX",390
18,"18164",1790,1135,1108,11,27,"VOX",234
18,"18902",752,589,568,3,21,"VOX",92
10,"10901",1161,758,753,1,5,"VOX",199
26,"26074",107,87,86,2,1,"VOX",3
31,"31131",913,672,664,8,8,"VOX",52
10,"10086",304,228,225,4,3,"VOX",38
6,"6160",3005,2083,2056,9,27,"VOX",301
12,"12125",215,179,179,2,0,"VOX",17
50,"50170",357,245,242,6,3,"VOX",31
16,"16259",28,22,22,0,0,"VOX",1
26,"26087",180,123,123,3,0,"VOX",3
20,"20003",549,360,355,1,5,"VOX",0
44,"44230",149,111,110,2,1,"VOX",0
46,"46245",527,407,404,2,3,"VOX",68
10,"10124",867,622,612,1,10,"VOX",113
46,"46903",6306,4762,4743,44,19,"VOX",1184
30,"30023",3874,2831,2788,18,43,"VOX",739
7,"7051",5484,3133,3094,43,39,"VOX",469
24,"24088",996,750,745,9,5,"VOX",110
29,"29085",138,98,93,1,5,"VOX",23
50,"50052",81,61,61,0,0,"VOX",9
9,"9448",203,159,157,0,2,"VOX",22
25,"25134",605,457,456,5,1,"VOX",15
20,"20907",118,82,82,0,0,"VOX",0
40,"40125",76,48,46,0,2,"VOX",3
8,"8094",1588,1258,1252,7,6,"VOX",40
46,"46170",3417,2618,2577,11,41,"VOX",536
8,"8026",195,148,146,0,2,"VOX",3
24,"24218",451,310,308,3,2,"VOX",50
43,"43120",421,256,254,1,2,"VOX",32
50,"50079",226,162,160,1,2,"VOX",16
42,"42202",19,11,10,0,1,"VOX",2
9,"9903",3112,2087,2058,24,29,"VOX",380
9,"9076",24,19,19,1,0,"VOX",6
10,"10144",915,618,614,0,4,"VOX",88
47,"47093",795,585,573,7,12,"VOX",68
28,"28085",4194,3126,3091,24,35,"VOX",624
42,"42209",134,86,84,4,2,"VOX",9
31,"31143",91,44,41,1,3,"VOX",2
8,"8307",49499,35471,35312,199,159,"VOX",1858
46,"46243",124,93,90,1,3,"VOX",10
46,"46172",5488,3724,3674,26,50,"VOX",882
8,"8184",55053,38519,38323,298,196,"VOX",3278
49,"49034",408,282,281,2,1,"VOX",55
27,"27009",2005,1324,1303,11,21,"VOX",74
48,"48073",6827,4614,4591,38,23,"VOX",25
15,"15074",3902,2629,2589,23,40,"VOX",228
17,"17016",737,570,563,2,7,"VOX",10
24,"24230",403,268,265,3,3,"VOX",30
46,"46180",659,509,500,7,9,"VOX",65
24,"24117",410,302,301,1,1,"VOX",52
38,"38020",16057,9921,9809,66,112,"VOX",1295
16,"16234",23,17,17,0,0,"VOX",0
10,"10085",310,219,219,1,0,"VOX",54
24,"24002",224,165,162,1,3,"VOX",28
29,"29002",1143,777,766,6,11,"VOX",138
26,"26072",287,239,235,3,4,"VOX",25
20,"20016",1529,887,883,3,4,"VOX",7
20,"20006",261,154,153,1,1,"VOX",0
28,"28096",20022,14440,14238,115,202,"VOX",3988
31,"31074",394,293,292,5,1,"VOX",5
7,"7038",2046,1416,1406,12,10,"VOX",144
40,"40224",18,15,15,0,0,"VOX",0
26,"26164",50,36,35,0,1,"VOX",2
10,"10025",377,308,299,3,9,"VOX",26
28,"28028",1836,1374,1363,3,11,"VOX",220
43,"43072",90,69,67,1,2,"VOX",3
31,"31122",4981,3539,3504,38,35,"VOX",124
37,"37286",204,140,137,2,3,"VOX",13
41,"41037",3201,2306,2260,22,46,"VOX",217
25,"25224",122,94,94,0,0,"VOX",1
7,"7065",2319,1429,1411,15,18,"VOX",243
16,"16109",41,30,30,0,0,"VOX",5
44,"44257",149,92,91,0,1,"VOX",8
50,"50099",3036,2137,2113,17,24,"VOX",433
45,"45125",2256,1711,1689,16,22,"VOX",248
45,"45160",1097,838,824,4,14,"VOX",228
31,"31105",1471,1144,1124,10,20,"VOX",213
16,"16033",1633,1199,1174,8,25,"VOX",143
25,"25143",82,63,62,0,1,"VOX",1
45,"45174",300,218,217,2,1,"VOX",66
38,"38029",1475,752,744,10,8,"VOX",109
12,"12127",63,45,44,1,1,"VOX",2
21,"21012",285,224,221,0,3,"VOX",8
43,"43116",465,356,352,0,4,"VOX",4
10,"10158",344,247,246,7,1,"VOX",33
8,"8043",3414,2429,2422,15,7,"VOX",233
46,"46219",125,107,104,0,3,"VOX",11
25,"25140",779,540,539,2,1,"VOX",23
17,"17048",6284,4077,4048,34,29,"VOX",285
46,"46085",11089,7581,7503,60,78,"VOX",1619
37,"37216",294,234,227,5,7,"VOX",38
15,"15069",6604,4587,4520,55,67,"VOX",273
17,"17063",179,153,149,0,4,"VOX",0
48,"48080",9916,6849,6793,44,56,"VOX",146
46,"46181",16967,11951,11835,98,116,"VOX",2032
32,"32013",1985,1242,1230,16,12,"VOX",100
28,"28060",1585,1160,1146,5,14,"VOX",211
25,"25174",390,312,312,1,0,"VOX",3
20,"20043",1718,1189,1183,2,6,"VOX",2
37,"37289",210,147,144,0,3,"VOX",27
22,"22188",75,50,50,1,0,"VOX",4
19,"19095",11,7,6,0,1,"VOX",4
8,"8263",21208,15014,14890,111,124,"VOX",1431
25,"25911",419,298,297,3,1,"VOX",14
6,"6110",138,105,102,0,3,"VOX",12
9,"9198",100,75,74,2,1,"VOX",7
50,"50256",70,43,43,0,0,"VOX",8
45,"45075",120,77,74,0,3,"VOX",16
43,"43110",247,178,178,2,0,"VOX",5
15,"15054",31805,19579,19321,335,258,"VOX",1835
46,"46006",4454,3527,3486,27,41,"VOX",571
50,"50043",241,155,154,1,1,"VOX",51
12,"12111",327,259,255,8,4,"VOX",22
50,"50137",958,740,731,8,9,"VOX",81
31,"31017",375,250,250,10,0,"VOX",5
43,"43119",849,591,588,8,3,"VOX",39
7,"7030",1598,1127,1098,14,29,"VOX",168
37,"37363",104,81,80,0,1,"VOX",12
9,"9046",23,17,17,0,0,"VOX",0
8,"8243",154,125,125,2,0,"VOX",0
6,"6141",1678,1183,1158,15,25,"VOX",145
39,"39095",2266,1637,1619,8,18,"VOX",234
18,"18185",545,434,424,5,10,"VOX",113
16,"16276",20,17,17,1,0,"VOX",3
21,"21069",1681,1073,1056,9,17,"VOX",139
46,"46157",2959,2145,2126,11,19,"VOX",376
28,"28037",1570,1135,1123,4,12,"VOX",262
16,"16152",32,26,26,3,0,"VOX",5
7,"7041",2090,1454,1434,17,20,"VOX",235
29,"29079",2326,1609,1582,12,27,"VOX",283
8,"8308",139,109,109,1,0,"VOX",1
15,"15073",21725,13008,12820,126,188,"VOX",1747
46,"46161",1467,1129,1113,5,16,"VOX",196
43,"43104",1767,1285,1271,4,14,"VOX",23
7,"7055",8062,4546,4492,40,54,"VOX",888
23,"23066",4274,3517,3460,16,57,"VOX",746
28,"28078",40,38,38,0,0,"VOX",4
26,"26043",346,243,235,2,8,"VOX",11
38,"38045",3542,1825,1801,7,24,"VOX",209
25,"25007",1378,1010,999,12,11,"VOX",67
46,"46028",383,305,299,8,6,"VOX",50
21,"21060",12287,7761,7638,134,123,"VOX",2120
10,"10011",518,385,370,2,15,"VOX",55
29,"29061",1043,803,773,9,30,"VOX",159
9,"9009",158,127,124,5,3,"VOX",35
46,"46094",20805,15353,15211,122,142,"VOX",3125
29,"29027",2325,1543,1516,13,27,"VOX",433
50,"50128",26,23,23,0,0,"VOX",0
32,"32037",679,454,446,6,8,"VOX",34
27,"27012",1264,658,650,6,8,"VOX",49
31,"31049",679,461,453,2,8,"VOX",4
28,"28143",77,58,58,0,0,"VOX",8
43,"43066",158,108,108,1,0,"VOX",3
44,"44172",296,216,216,1,0,"VOX",25
48,"48062",295,236,236,0,0,"VOX",2
21,"21073",1902,1073,1043,13,30,"VOX",180
43,"43171",14849,10140,10081,76,59,"VOX",1574
26,"26063",118,88,88,2,0,"VOX",9
28,"28144",6525,5032,4987,39,45,"VOX",1130
44,"44197",51,35,35,1,0,"VOX",2
16,"16250",67,52,52,1,0,"VOX",8
50,"50157",289,199,196,1,3,"VOX",16
39,"39005",1419,1039,1030,9,9,"VOX",204
21,"21077",1739,1266,1235,13,31,"VOX",182
13,"13059",193,150,150,0,0,"VOX",26
50,"50116",169,124,123,0,1,"VOX",15
8,"8207",2026,1667,1659,12,8,"VOX",39
9,"9268",89,62,62,0,0,"VOX",4
17,"17076",119,95,94,2,1,"VOX",1
29,"29903",485,326,324,2,2,"VOX",42
27,"27064",1505,972,951,9,21,"VOX",58
20,"20023",441,254,251,1,3,"VOX",2
43,"43111",2129,1412,1401,8,11,"VOX",125
45,"45165",62598,43750,43259,329,491,"VOX",10171
37,"37079",77,59,59,1,0,"VOX",16
31,"31057",1741,1237,1219,6,18,"VOX",127
46,"46043",135,119,118,0,1,"VOX",18
29,"29055",1892,1425,1394,3,31,"VOX",335
25,"25177",356,252,250,1,2,"VOX",11
43,"43060",2672,2032,2015,7,17,"VOX",42
10,"10121",7882,5294,5183,42,111,"VOX",847
15,"15028",1392,944,936,4,8,"VOX",47
6,"6094",1457,868,858,5,10,"VOX",108
31,"31053",509,354,350,4,4,"VOX",13
37,"37357",248,193,192,1,1,"VOX",33
26,"26124",768,603,590,4,13,"VOX",50
50,"50122",68,43,42,1,1,"VOX",12
46,"46176",2077,1362,1348,14,14,"VOX",298
28,"28100",4482,3146,3113,21,33,"VOX",827
40,"40074",246,193,189,2,4,"VOX",26
46,"46238",13117,9172,9088,50,84,"VOX",1192
37,"37311",201,157,156,1,1,"VOX",15
22,"22249",125,93,92,1,1,"VOX",15
29,"29011",2893,1763,1736,12,27,"VOX",301
25,"25906",205,133,131,2,2,"VOX",0
47,"47218",981,728,723,4,5,"VOX",130
25,"25165",271,210,208,0,2,"VOX",6
22,"22045",65,52,52,0,0,"VOX",5
8,"8281",4858,3783,3762,19,21,"VOX",121
24,"24046",893,595,583,6,12,"VOX",84
19,"19090",90,69,68,1,1,"VOX",4
37,"37353",122,82,80,0,2,"VOX",13
10,"10060",921,615,596,4,19,"VOX",128
37,"37377",215,174,173,0,1,"VOX",25
50,"50171",99,69,69,2,0,"VOX",21
46,"46031",10574,7233,7158,58,75,"VOX",1237
26,"26038",76,52,52,0,0,"VOX",5
17,"17061",180,141,139,1,2,"VOX",6
50,"50234",242,159,154,4,5,"VOX",23
50,"50076",70,56,56,0,0,"VOX",11
15,"15093",4012,2413,2386,24,27,"VOX",198
40,"40128",123,88,87,1,1,"VOX",16
46,"46236",929,723,716,2,7,"VOX",103
17,"17079",65572,47740,47502,279,238,"VOX",2488
46,"46042",3335,2655,2620,12,35,"VOX",363
26,"26006",1833,1358,1335,7,23,"VOX",131
6,"6119",674,516,511,1,5,"VOX",133
10,"10070",667,493,489,1,4,"VOX",69
45,"45149",517,400,393,2,7,"VOX",53
41,"41039",31538,22078,21717,278,361,"VOX",4714
24,"24026",1085,724,712,14,12,"VOX",91
10,"10029",380,284,276,0,8,"VOX",32
46,"46241",388,288,283,5,5,"VOX",37
10,"10171",347,238,219,1,19,"VOX",13
10,"10094",220,167,165,0,2,"VOX",17
13,"13080",316,226,225,0,1,"VOX",48
15,"15058",28761,20250,20098,261,152,"VOX",1833
10,"10007",627,457,447,3,10,"VOX",70
9,"9227",112,89,89,1,0,"VOX",15
43,"43096",97,76,76,0,0,"VOX",2
7,"7059",3074,1973,1948,17,25,"VOX",287
16,"16101",137,111,109,1,2,"VOX",20
44,"44245",240,177,174,0,3,"VOX",39
24,"24066",439,274,273,3,1,"VOX",44
25,"25071",41,31,30,0,1,"VOX",0
31,"31094",105,70,70,1,0,"VOX",2
28,"28050",4406,3202,3167,29,35,"VOX",1008
23,"23056",3052,2279,2207,26,72,"VOX",446
37,"37367",179,147,143,2,4,"VOX",20
40,"40223",235,177,174,1,3,"VOX",30
18,"18035",1179,882,870,7,12,"VOX",118
9,"9108",433,315,311,3,4,"VOX",58
37,"37329",38,29,28,1,1,"VOX",11
24,"24223",2533,1727,1705,40,22,"VOX",248
8,"8192",5701,4366,4349,15,17,"VOX",172
14,"14074",2225,1775,1743,17,32,"VOX",158
36,"36901",4154,3094,3029,21,65,"VOX",193
28,"28066",7575,5771,5718,58,53,"VOX",1864
40,"40012",241,160,156,7,4,"VOX",29
40,"40160",93,65,62,0,3,"VOX",8
9,"9211",1369,938,921,14,17,"VOX",138
28,"28099",1950,1409,1404,16,5,"VOX",442
12,"12100",1273,1069,1052,5,17,"VOX",163
28,"28122",578,404,401,1,3,"VOX",124
14,"14039",2577,1858,1801,29,57,"VOX",262
38,"38050",2417,1288,1273,9,15,"VOX",125
26,"26107",86,65,64,1,1,"VOX",9
31,"31085",500,365,362,2,3,"VOX",7
23,"23026",3431,2430,2375,25,55,"VOX",361
46,"46208",1071,854,845,2,9,"VOX",123
29,"29029",383,256,254,4,2,"VOX",33
10,"10143",141,109,105,0,4,"VOX",12
17,"17023",27314,18677,18546,117,131,"VOX",1294
16,"16073",190,153,153,1,0,"VOX",34
41,"41008",1044,788,766,3,22,"VOX",85
44,"44217",32,25,25,0,0,"VOX",7
16,"16163",64,51,51,0,0,"VOX",4
16,"16909",655,493,488,4,5,"VOX",46
10,"10103",422,290,286,1,4,"VOX",20
31,"31908",1076,763,762,5,1,"VOX",15
41,"41067",7273,5114,5036,59,78,"VOX",908
25,"25051",1522,1066,1059,6,7,"VOX",34
26,"26180",221,164,162,4,2,"VOX",25
50,"50107",988,758,755,8,3,"VOX",123
46,"46010",943,691,681,7,10,"VOX",116
22,"22085",94,78,76,0,2,"VOX",3
26,"26002",821,611,597,1,14,"VOX",122
50,"50298",5439,4053,4007,41,46,"VOX",809
21,"21043",1853,1354,1325,23,29,"VOX",180
50,"50120",55,42,42,1,0,"VOX",6
9,"9057",147,110,108,0,2,"VOX",13
16,"16185",36,31,31,0,0,"VOX",5
16,"16255",132,99,99,0,0,"VOX",10
23,"23075",3222,2513,2475,19,38,"VOX",395
10,"10183",950,696,684,3,12,"VOX",93
9,"9088",63,31,30,0,1,"VOX",3
45,"45157",2288,1490,1472,5,18,"VOX",469
21,"21046",1729,1212,1187,14,25,"VOX",424
8,"8056",42897,30873,30757,259,116,"VOX",2616
17,"17070",110,87,87,0,0,"VOX",0
9,"9480",105,84,84,0,0,"VOX",11
16,"16904",453,348,345,11,3,"VOX",72
24,"24114",2866,1753,1742,15,11,"VOX",224
44,"44244",67,40,40,0,0,"VOX",7
32,"32024",4817,3064,3014,34,50,"VOX",223
26,"26030",18,18,17,1,1,"VOX",2
10,"10134",550,361,354,1,7,"VOX",67
50,"50154",114,92,92,1,0,"VOX",25
14,"14042",18695,13788,13514,206,274,"VOX",1545
44,"44187",193,147,146,0,1,"VOX",20
22,"22215",127,81,81,0,0,"VOX",7
27,"27002",1535,990,968,13,22,"VOX",62
50,"50129",212,129,127,0,2,"VOX",18
42,"42100",30,24,24,1,0,"VOX",0
23,"23044",4697,3495,3400,31,95,"VOX",448
8,"8030",5208,4045,4033,25,12,"VOX",153
28,"28056",946,664,660,2,4,"VOX",101
21,"21036",204,128,121,1,7,"VOX",10
30,"30029",12122,8231,8125,54,106,"VOX",2031
31,"31158",248,156,151,0,5,"VOX",4
38,"38042",3778,2410,2386,11,24,"VOX",172
19,"19191",13,12,12,0,0,"VOX",0
29,"29001",4207,3002,2959,40,43,"VOX",234
44,"44200",39,26,26,0,0,"VOX",2
8,"8194",25680,16465,16376,131,89,"VOX",1745
46,"46200",1840,1475,1455,5,20,"VOX",230
49,"49188",111,75,73,0,2,"VOX",18
22,"22175",184,129,128,0,1,"VOX",17
32,"32020",2428,1728,1714,10,14,"VOX",64
16,"16052",539,422,419,3,3,"VOX",53
46,"46152",90,63,63,0,0,"VOX",15
8,"8247",982,799,798,4,1,"VOX",14
24,"24065",2164,1524,1492,12,32,"VOX",308
16,"16044",43,29,28,0,1,"VOX",1
44,"44009",798,593,589,4,4,"VOX",69
13,"13008",422,280,272,2,8,"VOX",49
46,"46215",1407,1088,1068,10,20,"VOX",101
45,"45186",2943,2142,2121,12,21,"VOX",438
16,"16162",39,31,31,0,0,"VOX",7
47,"47049",91,58,58,0,0,"VOX",12
43,"43124",468,343,339,3,4,"VOX",6
45,"45060",152,109,109,1,0,"VOX",12
13,"13013",7056,5041,4945,52,96,"VOX",1186
16,"16001",62,45,45,0,0,"VOX",6
45,"45088",2366,1526,1501,8,25,"VOX",430
46,"46248",4868,3434,3374,16,60,"VOX",801
17,"17013",2765,1999,1985,15,14,"VOX",114
14,"14026",2000,1294,1253,20,41,"VOX",204
50,"50142",23,16,16,1,0,"VOX",1
5,"5127",600,472,469,7,3,"XAV",0
5,"5121",263,194,189,1,5,"XAV",11
5,"5040",64,47,46,0,1,"XAV",0
5,"5067",73,56,54,0,2,"XAV",19
5,"5030",40,32,32,0,0,"XAV",2
5,"5244",39,29,29,0,0,"XAV",0
5,"5062",163,121,119,3,2,"XAV",0
5,"5169",218,171,171,1,0,"XAV",22
5,"5010",142,102,100,2,2,"XAV",2
5,"5239",215,163,163,3,0,"XAV",14
5,"5110",696,469,464,2,5,"XAV",8
5,"5044",244,170,170,1,0,"XAV",4
5,"5082",491,379,369,2,10,"XAV",0
5,"5196",57,43,43,0,0,"XAV",1
5,"5132",857,548,539,7,9,"XAV",20
5,"5035",92,68,68,0,0,"XAV",4
5,"5131",96,64,64,1,0,"XAV",4
5,"5251",56,35,34,0,1,"XAV",2
5,"5249",96,63,63,0,0,"XAV",2
5,"5144",65,47,46,1,1,"XAV",0
5,"5224",102,85,84,2,1,"XAV",16
5,"5225",355,276,273,6,3,"XAV",0
5,"5162",76,47,45,1,2,"XAV",0
5,"5189",397,293,291,3,2,"XAV",1
5,"5218",104,81,79,0,2,"XAV",0
5,"5266",100,79,79,1,0,"XAV",1
5,"5101",266,206,205,1,1,"XAV",3
5,"5178",340,261,255,3,6,"XAV",9
5,"5905",214,148,142,1,6,"XAV",4
5,"5100",260,193,192,3,1,"XAV",1
5,"5217",54,42,41,0,1,"XAV",1
5,"5138",283,218,217,1,1,"XAV",6
5,"5088",29,22,22,0,0,"XAV",2
5,"5209",74,58,58,1,0,"XAV",2
5,"5258",107,80,80,1,0,"XAV",1
5,"5061",257,193,189,1,4,"XAV",23
5,"5259",99,80,79,2,1,"XAV",0
5,"5063",31,26,26,0,0,"XAV",0
5,"5143",59,52,51,1,1,"XAV",2
5,"5056",91,71,70,0,1,"XAV",0
5,"5208",39,32,32,0,0,"XAV",0
5,"5165",361,266,261,4,5,"XAV",6
5,"5262",318,238,235,1,3,"XAV",10
5,"5190",53,44,43,0,1,"XAV",6
5,"5171",67,49,47,0,2,"XAV",4
5,"5080",42,30,30,0,0,"XAV",7
5,"5073",282,210,207,1,3,"XAV",6
5,"5201",497,404,401,0,3,"XAV",7
5,"5065",452,339,337,2,2,"XAV",14
5,"5257",132,98,95,4,3,"XAV",8
5,"5113",62,42,42,0,0,"XAV",0
5,"5267",103,67,67,1,0,"XAV",0
5,"5079",66,53,52,0,1,"XAV",5
5,"5066",435,344,341,2,3,"XAV",7
5,"5238",728,529,525,1,4,"XAV",25
5,"5045",81,58,58,0,0,"XAV",1
5,"5195",199,125,125,1,0,"XAV",10
5,"5212",197,117,117,0,0,"XAV",0
5,"5022",1580,1202,1193,6,9,"XAV",62
5,"5083",137,92,91,0,1,"XAV",1
5,"5174",62,51,51,1,0,"XAV",3
5,"5094",133,105,105,0,0,"XAV",2
5,"5106",27,14,14,0,0,"XAV",1
5,"5167",223,177,172,0,5,"XAV",23
5,"5234",45,38,38,0,0,"XAV",0
5,"5008",202,158,155,0,3,"XAV",0
5,"5179",199,176,172,1,4,"XAV",9
5,"5164",18,12,12,0,0,"XAV",0
5,"5117",191,155,153,1,2,"XAV",0
5,"5228",168,99,98,0,1,"XAV",1
5,"5034",15,14,13,0,1,"XAV",0
5,"5015",68,45,44,1,1,"XAV",0
5,"5151",83,60,60,0,0,"XAV",0
5,"5136",83,55,55,0,0,"XAV",4
5,"5074",668,540,537,5,3,"XAV",10
5,"5114",1257,989,968,5,21,"XAV",11
5,"5060",108,79,79,2,0,"XAV",2
5,"5157",227,146,146,3,0,"XAV",8
5,"5089",455,342,324,0,18,"XAV",3
5,"5126",60,47,45,0,2,"XAV",1
5,"5158",346,263,261,0,2,"XAV",7
5,"5155",46,33,31,1,2,"XAV",0
5,"5229",75,61,61,1,0,"XAV",9
5,"5170",47,34,34,1,0,"XAV",0
5,"5264",54,32,31,4,1,"XAV",1
5,"5105",330,247,242,2,5,"XAV",11
5,"5185",96,63,61,1,2,"XAV",1
5,"5246",48,35,35,0,0,"XAV",0
5,"5204",578,445,442,3,3,"XAV",5
5,"5161",545,395,395,0,0,"XAV",11
5,"5240",3346,2259,2232,11,27,"XAV",43
5,"5166",155,108,104,1,4,"XAV",9
5,"5108",39,21,21,0,0,"XAV",0
5,"5175",144,109,109,0,0,"XAV",10
5,"5200",41,26,26,0,0,"XAV",0
5,"5027",258,209,203,5,6,"XAV",11
5,"5901",247,154,152,3,2,"XAV",11
5,"5214",28,18,18,0,0,"XAV",0
5,"5191",121,99,99,0,0,"XAV",17
5,"5197",100,82,79,1,3,"XAV",15
5,"5085",31,27,27,0,0,"XAV",0
5,"5233",223,174,173,0,1,"XAV",14
5,"5903",137,84,83,0,1,"XAV",1
5,"5133",61,44,43,0,1,"XAV",3
5,"5180",76,55,53,0,2,"XAV",1
5,"5134",47,40,40,0,0,"XAV",0
5,"5263",162,117,115,1,2,"XAV",12
5,"5147",144,101,99,0,2,"XAV",2
5,"5078",95,78,78,2,0,"XAV",0
5,"5084",66,44,44,0,0,"XAV",0
5,"5116",96,68,68,0,0,"XAV",2
5,"5039",47,43,43,0,0,"XAV",1
5,"5087",147,108,107,3,1,"XAV",10
5,"5256",110,88,86,1,2,"XAV",4
5,"5192",92,75,72,1,3,"XAV",2
5,"5051",157,117,115,1,2,"XAV",12
5,"5119",24,17,17,1,0,"XAV",2
5,"5230",65,57,56,1,1,"XAV",3
5,"5123",106,78,78,0,0,"XAV",8
5,"5186",1564,1140,1125,5,15,"XAV",12
5,"5176",221,163,159,0,4,"XAV",33
5,"5026",183,149,147,1,2,"XAV",0
5,"5222",140,118,118,0,0,"XAV",7
5,"5145",43,28,28,0,0,"XAV",1
5,"5194",132,105,104,1,1,"XAV",1
5,"5159",224,133,132,3,1,"XAV",3
5,"5107",54,36,35,2,1,"XAV",5
5,"5152",644,498,496,3,2,"XAV",4
5,"5055",532,417,413,3,4,"XAV",0
5,"5120",33,26,26,0,0,"XAV",3
5,"5129",111,70,69,0,1,"XAV",1
5,"5048",107,89,88,2,1,"XAV",0
5,"5160",289,220,213,0,7,"XAV",7
5,"5103",63,44,44,1,0,"XAV",0
5,"5122",118,91,89,1,2,"XAV",1
5,"5232",104,86,83,1,3,"XAV",21
5,"5112",95,59,58,0,1,"XAV",0
5,"5021",1861,1323,1304,22,19,"XAV",19
5,"5118",64,41,41,1,0,"XAV",0
5,"5053",76,48,48,0,0,"XAV",4
5,"5902",286,214,211,1,3,"XAV",6
5,"5054",1192,871,856,6,15,"XAV",2
5,"5173",60,54,54,0,0,"XAV",2
5,"5206",26,17,17,0,0,"XAV",1
5,"5153",86,58,56,3,2,"XAV",1
5,"5041",984,743,732,5,11,"XAV",50
5,"5156",242,145,145,1,0,"XAV",0
5,"5038",114,83,82,0,1,"XAV",3
5,"5252",56,46,45,0,1,"XAV",6
5,"5219",33,23,23,0,0,"XAV",0
5,"5049",403,261,253,1,8,"XAV",8
5,"5243",80,57,56,1,1,"XAV",3
5,"5046",38,35,35,0,0,"XAV",0
5,"5052",85,70,69,0,1,"XAV",7
5,"5019",44865,32917,32586,282,331,"XAV",3865
5,"5012",117,88,88,1,0,"XAV",13
5,"5904",108,70,69,5,1,"XAV",3
5,"5005",165,127,119,0,8,"XAV",1
5,"5177",136,117,116,0,1,"XAV",2
5,"5037",210,135,135,0,0,"XAV",3
5,"5036",118,91,90,0,1,"XAV",0
5,"5069",73,59,59,0,0,"XAV",2
5,"5128",339,258,253,5,5,"XAV",12
5,"5007",109,73,72,0,1,"XAV",0
5,"5253",75,54,54,0,0,"XAV",1
5,"5130",94,77,77,1,0,"XAV",12
5,"5086",76,58,58,1,0,"XAV",0
5,"5090",73,63,62,0,1,"XAV",1
5,"5254",184,149,147,1,2,"XAV",1
5,"5231",150,123,122,2,1,"XAV",0
5,"5033",169,135,134,0,1,"XAV",5
5,"5096",76,62,62,0,0,"XAV",0
5,"5184",238,163,160,2,3,"XAV",0
5,"5172",111,83,83,1,0,"XAV",24
5,"5002",1905,1361,1329,11,32,"XAV",7
5,"5018",23,17,17,2,0,"XAV",0
5,"5095",236,181,177,1,4,"XAV",0
5,"5001",182,139,138,1,1,"XAV",4
5,"5148",22,19,19,0,0,"XAV",1
5,"5109",445,334,329,4,5,"XAV",4
5,"5081",37,21,21,3,0,"XAV",0
5,"5220",364,277,274,0,3,"XAV",5
5,"5023",174,148,145,2,3,"XAV",15
5,"5216",209,149,149,0,0,"XAV",3
5,"5140",99,83,81,0,2,"XAV",5
5,"5265",83,59,58,1,1,"XAV",2
5,"5093",362,251,249,0,2,"XAV",23
5,"5029",100,73,73,1,0,"XAV",2
5,"5059",92,49,48,0,1,"XAV",0
5,"5187",1714,1247,1221,9,26,"XAV",9
5,"5247",231,132,131,1,1,"XAV",13
5,"5141",95,79,78,1,1,"XAV",8
5,"5154",31,23,23,0,0,"XAV",0
5,"5242",679,571,562,9,9,"XAV",3
5,"5213",94,72,70,0,2,"XAV",5
5,"5261",32,25,25,0,0,"XAV",0
5,"5024",193,127,125,2,2,"XAV",1
5,"5097",464,309,305,0,4,"XAV",5
5,"5237",153,125,123,0,2,"XAV",8
5,"5181",46,34,34,0,0,"XAV",0
5,"5226",63,43,42,0,1,"XAV",0
5,"5236",105,69,69,1,0,"XAV",2
5,"5017",84,70,67,2,3,"XAV",4
5,"5077",154,113,110,0,3,"XAV",1
5,"5207",645,485,478,4,7,"XAV",7
5,"5042",141,111,111,0,0,"XAV",1
5,"5013",834,658,653,2,5,"XAV",2
5,"5057",2418,1785,1748,9,37,"XAV",11
5,"5193",179,140,139,2,1,"XAV",1
5,"5124",87,67,67,2,0,"XAV",0
5,"5215",156,120,113,0,7,"XAV",2
5,"5025",78,65,65,0,0,"XAV",0
5,"5149",101,72,71,2,1,"XAV",2
5,"5135",399,294,292,2,2,"XAV",26
5,"5104",33,21,19,0,2,"XAV",0
5,"5075",96,76,76,0,0,"XAV",0
5,"5043",73,58,58,0,0,"XAV",0
5,"5183",123,103,100,0,3,"XAV",2
5,"5142",88,76,75,0,1,"XAV",2
5,"5245",353,262,256,0,6,"XAV",44
5,"5182",721,457,436,3,21,"XAV",6
5,"5241",3062,2011,1977,21,34,"XAV",53
5,"5168",3503,2536,2511,29,25,"XAV",23
5,"5163",1702,1258,1233,5,25,"XAV",22
5,"5260",95,73,73,0,0,"XAV",6
5,"5070",30,29,29,0,0,"XAV",0
5,"5139",71,59,58,1,1,"XAV",0
5,"5076",468,376,367,1,9,"XAV",43
5,"5047",4105,3004,2936,23,68,"XAV",22
5,"5198",70,53,51,0,2,"XAV",0
5,"5227",341,230,228,1,2,"XAV",0
5,"5058",71,45,43,0,2,"XAV",2
5,"5235",141,97,97,2,0,"XAV",0
5,"5014",5263,3699,3648,35,51,"XAV",41
5,"5125",56,47,46,0,1,"XAV",10
5,"5199",37,31,31,0,0,"XAV",1
5,"5072",92,74,72,1,2,"XAV",0
5,"5205",81,59,58,2,1,"XAV",4
5,"5210",81,56,56,0,0,"XAV",10
5,"5064",101,77,77,0,0,"XAV",1
5,"5102",1681,1252,1228,8,24,"XAV",2
5,"5211",425,336,330,2,6,"XAV",4
5,"5115",509,350,344,0,6,"XAV",5
5,"5188",39,33,33,0,0,"XAV",15
5,"5221",322,231,231,0,0,"XAV",3
5,"5099",451,350,344,3,6,"XAV",1
5,"5092",145,111,107,1,4,"XAV",1
5,"5016",6355,4677,4584,28,93,"XAV",56
